,Unnamed: 0,difference,transition_time,match_num,entrance_index,departure_index,camera,departure,entrance,frame_num,h,hour,index,max_track_len,next_cam,next_cam_framenum,track,track_length,w,x1,x2,y1,y2
25,0,0.0012240039053819565,5,1,24163,258,1,1,0,988,112,11,258,22,2,993,21,22,39,1634,1673,156,268
0,11,0.000582299316689775,36,12,34341,2211,10,1,0,743,231,11,2211,29,6,779,8,29,80,587,667,292,523
1,12,0.0005904190283028043,39,13,34389,2233,10,1,0,756,244,11,2233,21,6,795,9,21,89,593,682,289,533
2,13,0.0011953392061311912,3,14,40109,2852,10,1,0,2102,406,11,2852,20,9,2105,35,20,160,833,993,674,1080
3,14,0.0012398212981142307,26,15,40293,3255,10,1,0,2592,186,11,3255,81,9,2618,48,81,84,488,572,320,506
4,18,0.0012486782296574116,3,19,32190,3547,10,1,0,2753,137,11,3547,35,5,2756,64,35,40,49,89,215,352
55,26,0.0007945178878751688,6,27,11508,6219,11,1,0,4321,498,11,6219,246,12,4327,38,246,481,1196,1677,576,1074
40,28,0.0011958674212727346,15,29,38092,10811,12,1,0,2898,191,11,10811,40,7,2913,64,40,60,406,466,175,366
41,29,0.0011477306300321664,7,30,15453,11223,12,1,0,3124,371,11,11223,63,13,3131,76,63,184,0,184,709,1080
43,31,0.0013181172659611218,4,32,15592,11312,12,1,0,3304,461,11,11312,86,13,3308,78,86,182,0,182,619,1080
48,38,0.0014927928109755625,2,39,9674,14004,13,1,0,170,246,11,14004,22,12,172,4,22,143,1521,1664,834,1080
49,40,0.0011637046572356862,6,41,11066,15417,13,1,0,2987,394,11,15417,20,12,2993,66,20,184,1330,1514,686,1080
50,43,0.0013389461369645685,9,44,36855,17141,13,1,0,5629,357,11,17141,22,6,5638,130,22,196,1261,1457,723,1080
51,44,0.0012430634512148064,32,45,13616,17453,13,1,0,5859,352,11,17453,23,12,5891,152,23,111,684,795,251,603
52,45,0.0008790269693293147,12,46,13616,17518,13,1,0,5879,272,11,17518,37,12,5891,155,37,123,1400,1523,808,1080
53,48,0.0009018018999382932,18,49,30100,17778,13,1,0,5942,153,11,17778,77,3,5960,167,77,120,1145,1265,927,1080
54,49,0.0014505156486955876,23,50,13912,17836,13,1,0,5947,255,11,17836,52,12,5970,172,52,137,554,691,825,1080
44,52,0.0009270972234636588,13,53,16171,21118,14,1,0,4357,428,11,21118,49,13,4370,54,49,199,1721,1920,630,1058
45,53,0.0010051684302001453,1,54,11934,21290,14,1,0,4735,152,11,21290,49,12,4736,69,49,146,978,1124,922,1074
46,55,0.0009082685842137953,32,56,16932,21769,14,1,0,5457,343,11,21769,415,13,5489,73,415,206,802,1008,737,1080
47,62,0.0010410252963544571,20,63,29780,22324,14,1,0,5933,289,11,22324,28,3,5953,128,28,164,1015,1179,791,1080
30,65,0.001093819195194429,1,66,30198,24065,2,1,0,120,238,11,24065,70,4,121,1,70,132,1293,1425,842,1080
31,66,0.001076686460929291,2,67,30435,24305,2,1,0,1140,149,11,24305,70,4,1142,19,70,88,1003,1091,931,1080
32,67,0.0010756280092250876,1,68,30772,24672,2,1,0,2304,393,11,24672,68,4,2305,37,68,188,1166,1354,687,1080
33,68,0.0012386176604379814,20,69,14902,24800,2,1,0,2474,292,11,24800,52,13,2494,43,52,86,374,460,261,553
34,69,0.0008549376179856626,1,70,31046,25079,2,1,0,3071,519,11,25079,69,4,3072,50,69,213,1174,1387,561,1080
35,70,0.0009907590830017193,2,71,31178,25231,2,1,0,4141,237,11,25231,76,4,4143,56,76,146,703,849,843,1080
36,75,0.0009419460051934224,16,76,29465,25724,2,1,0,5663,314,11,25724,79,3,5679,82,79,177,843,1020,766,1080
37,77,0.0012384442817519625,34,78,29901,25839,2,1,0,5855,254,11,25839,102,3,5889,84,102,241,832,1073,823,1077
39,79,0.0008389547854577014,2,80,30100,26131,2,1,0,5958,641,11,26131,77,3,5960,103,77,274,128,402,439,1080
26,96,0.0008446163296041864,18,97,13616,29613,3,1,0,5873,122,11,29613,34,12,5891,165,34,35,394,429,174,296
27,101,0.0010997523071641052,38,102,13866,29934,3,1,0,5922,185,11,29934,33,12,5960,181,33,66,349,415,206,391
28,104,0.0005258430716068472,3,105,24677,30762,4,1,0,2309,235,11,30762,70,2,2312,28,70,140,1014,1154,845,1080
29,105,0.0010899259655521396,2,106,25583,31487,4,1,0,5284,262,11,31487,58,2,5286,81,58,156,1055,1211,818,1080
6,107,0.001376781005478364,1,108,34598,31834,5,1,0,1319,491,11,31834,67,6,1320,11,67,202,14,216,589,1080
7,108,0.0004764219706650199,2,109,37642,32027,5,1,0,2115,443,11,32027,54,7,2117,19,54,220,970,1190,637,1080
8,109,0.001446857401435507,9,110,35403,32289,5,1,0,2874,423,11,32289,26,6,2883,40,26,75,0,75,657,1080
9,110,0.0012479872295334661,10,111,35528,32343,5,1,0,3687,352,11,32343,32,6,3697,43,32,54,0,54,724,1076
10,113,0.0014393817393923932,3,114,36524,33652,5,1,0,5160,484,11,33652,27,6,5163,69,27,158,0,158,596,1080
11,114,0.0011079430540239749,35,115,36593,33674,5,1,0,5273,141,11,33674,21,6,5308,70,21,121,1394,1515,939,1080
12,115,0.0005403431730438206,37,116,2234,34316,6,1,0,735,302,11,34316,51,10,772,18,51,104,194,298,186,488
13,116,0.0008717557199455716,40,117,2303,34340,6,1,0,750,269,11,34340,23,10,790,20,23,91,193,284,160,429
14,117,0.001405618299373335,4,118,37260,34422,6,1,0,828,227,11,34422,33,7,832,22,33,142,1327,1469,853,1080
15,119,0.0013604764511200296,5,120,31926,34730,6,1,0,1857,281,11,34730,65,5,1862,40,65,127,1171,1298,799,1080
16,120,0.0011266691451664575,2,121,32028,34852,6,1,0,2119,314,11,34852,43,5,2121,45,43,171,1102,1273,766,1080
18,123,0.0012376816409850465,16,124,3174,35039,6,1,0,2495,208,11,35039,29,10,2511,48,29,66,231,297,194,402
19,125,0.0011948851442350153,1,126,32088,35255,6,1,0,2643,510,11,35255,53,5,2644,52,53,239,1442,1681,570,1080
20,129,0.0011635115619349195,9,130,32133,35396,6,1,0,2745,509,11,35396,33,5,2754,61,33,224,1150,1374,571,1080
21,132,0.0012120199422870671,3,133,38602,36352,6,1,0,4618,309,11,36352,40,7,4621,99,40,196,967,1163,771,1080
22,141,0.0011142797313181477,4,142,35297,37991,7,1,0,2679,452,11,37991,78,6,2683,37,78,214,1661,1875,628,1080
23,142,0.0011589209314842909,11,143,35528,38148,7,1,0,3686,310,11,38148,32,6,3697,57,32,154,1766,1920,770,1080
24,144,0.0012451196466966743,11,145,36593,38825,7,1,0,5297,348,11,38825,51,6,5308,86,51,146,1774,1920,732,1080
5,145,0.0010787879225588775,5,146,2683,40084,9,1,0,1792,491,11,40084,64,10,1797,26,64,207,162,369,589,1080
56,169,0.0011569596291488553,4,170,49128,45922,10,1,0,1151,191,13,45922,37,11,1155,63,37,136,720,856,889,1080
57,172,0.0010995808637358424,2,173,49166,46265,10,1,0,2817,196,13,46265,74,11,2819,88,74,133,773,906,882,1078
93,188,0.0009403183838755207,3,189,63886,51419,13,1,0,169,119,13,51419,27,2,172,19,27,38,358,396,137,256
94,192,0.0012962814459526947,3,193,49801,55478,13,1,0,2658,158,13,55478,78,12,2661,79,78,78,1842,1920,922,1080
91,194,0.0010669932482099767,4,195,73910,59713,14,1,0,2961,498,13,59713,30,3,2965,46,30,130,1790,1920,563,1061
92,196,0.0011099841650471962,38,197,75025,60324,14,1,0,5052,385,13,60324,35,3,5090,69,35,80,1840,1920,695,1080
87,205,0.0010727736691228608,1,206,76213,64504,2,1,0,1231,415,13,64504,77,4,1232,56,77,167,618,785,665,1080
88,207,0.0014260242214794055,46,208,78873,67111,2,1,0,4966,227,13,67111,719,4,5012,162,719,223,71,294,851,1078
89,208,0.0010142381085901377,3,209,78583,68526,2,1,0,4692,526,13,68526,78,4,4695,169,78,157,678,835,349,875
90,209,0.0012595022586848392,4,210,78697,68603,2,1,0,4940,303,13,68603,62,4,4944,171,62,96,559,655,243,546
67,212,0.001295458500291123,21,213,49801,73426,3,1,0,2640,190,13,73426,56,12,2661,66,56,62,420,482,179,369
68,220,0.0009121849598242805,1,221,64505,75998,4,1,0,1259,297,13,75998,86,2,1260,49,86,169,631,800,783,1080
69,221,0.0006125878293445992,3,222,64876,76808,4,1,0,2024,113,13,76808,142,2,2027,105,142,85,1095,1180,967,1080
71,223,0.0012806898450660616,15,224,70357,76885,4,1,0,2142,354,13,76885,72,3,2157,120,72,167,1440,1607,726,1080
72,224,0.0010025241632180505,20,225,65214,76977,4,1,0,2561,89,13,76977,71,2,2581,143,71,70,1198,1268,991,1080
73,225,0.0010846987425655098,5,226,65269,77056,4,1,0,2628,238,13,77056,73,2,2633,155,73,150,646,796,842,1080
74,226,0.0012871964141028575,6,227,65402,77208,4,1,0,3021,255,13,77208,47,2,3027,175,47,155,1018,1173,825,1080
76,228,0.0007348473274004848,4,229,65864,77543,4,1,0,3579,419,13,77543,81,2,3583,201,81,202,975,1177,661,1080
77,229,0.0006746263635830643,8,230,65961,77624,4,1,0,3581,120,13,77624,80,2,3589,211,80,106,97,203,960,1080
78,230,0.0009086833708144967,42,231,50139,77680,4,1,0,3526,129,13,77680,55,12,3568,223,55,38,1627,1665,170,299
79,231,0.0009249554977002423,6,232,66264,77830,4,1,0,4122,201,13,77830,58,2,4128,258,58,128,1263,1391,879,1080
80,233,0.0009319154570739922,5,234,68722,79027,4,1,0,5176,151,13,79027,76,2,5181,338,76,101,1243,1344,929,1080
81,234,0.0006044032182475772,8,235,68845,79110,4,1,0,5259,169,13,79110,79,2,5267,341,79,111,1277,1388,911,1080
82,235,0.0005256039612736278,6,236,68648,79170,4,1,0,5272,80,13,79170,53,2,5278,343,53,65,1013,1078,1000,1080
84,237,0.0007375830579667115,8,238,69053,79264,4,1,0,5513,154,13,79264,87,2,5521,354,87,95,1077,1172,926,1080
85,238,0.0013402701585677526,15,239,75444,79602,4,1,0,5679,418,13,79602,86,3,5694,372,86,199,1632,1831,662,1080
86,239,0.0012026137061912196,1,240,69138,79714,4,1,0,5759,183,13,79714,88,2,5760,375,88,127,1098,1225,897,1080
58,245,0.0009034844234252293,16,246,85673,80235,5,1,0,654,340,13,80235,60,7,670,30,60,167,998,1165,740,1080
60,254,0.0014564905757744806,47,255,48155,81585,5,1,0,4964,621,13,81585,62,10,5011,160,62,255,59,314,416,1037
61,261,0.0012152835049478086,2,262,80817,83153,6,1,0,3229,361,13,83153,40,5,3231,104,40,163,1230,1393,719,1080
62,270,0.0012929797618798215,4,271,81964,85243,7,1,0,297,614,13,85243,35,6,301,16,35,298,1365,1663,466,1080
63,272,0.0010851477633135199,12,273,83001,86943,7,1,0,2841,459,13,86943,36,6,2853,129,36,119,1801,1920,600,1059
64,273,0.0012727972726309668,23,274,80795,87066,7,1,0,3200,590,13,87066,48,5,3223,133,48,217,771,988,403,993
65,274,0.001303832833854822,13,275,83191,87443,7,1,0,3395,571,13,87443,34,6,3408,157,34,254,1510,1764,482,1053
66,279,0.0010524741658489746,45,280,81413,88461,7,1,0,4412,239,13,88461,82,5,4457,214,82,41,0,41,307,546
95,293,0.0012190880425760346,3,294,121077,92412,10,1,0,1663,179,15,92412,68,9,1666,20,68,125,871,996,901,1080
96,295,0.0010842197049826733,2,296,121398,94957,10,1,0,3373,291,15,94957,22,9,3375,65,22,159,371,530,789,1080
111,297,0.0012915501632957795,48,298,92152,97694,11,1,0,913,564,15,97694,912,10,961,1,912,165,1755,1920,365,929
110,302,0.0014795558006677136,6,303,98388,100867,13,1,0,2821,110,15,100867,20,12,2827,47,20,42,1878,1920,968,1078
108,304,0.0010723901567152561,9,305,99897,104282,14,1,0,711,500,15,104282,27,13,720,7,27,142,1778,1920,580,1080
109,307,0.0013029035186832726,13,308,103383,105016,14,1,0,5002,244,15,105016,38,13,5015,55,38,112,1808,1920,836,1080
106,310,0.0011975972267626047,39,311,109428,107269,2,1,0,4463,289,15,107269,53,3,4502,41,53,141,53,194,791,1080
107,311,0.000929733111210702,1,312,112261,107524,2,1,0,4967,525,15,107524,59,4,4968,49,59,211,987,1198,555,1080
105,316,0.0014725627110153522,15,317,110318,112743,4,1,0,5941,483,15,112743,38,3,5956,131,38,149,1771,1920,575,1058
98,317,0.0012344510533175675,10,318,115168,113059,5,1,0,1608,512,15,113059,27,6,1618,24,27,243,0,243,568,1080
99,319,0.0014443959858601455,26,320,115428,113199,5,1,0,2561,591,15,113199,55,6,2587,31,55,287,32,319,487,1078
100,321,0.0005821773420946608,27,322,119468,113309,5,1,0,2680,323,15,113309,87,7,2707,36,87,183,1573,1756,757,1080
101,338,0.0012206807605131182,13,339,115168,119182,7,1,0,1605,374,15,119182,25,6,1618,30,25,260,1308,1568,706,1080
102,339,0.0008918589627297568,49,340,107014,119527,7,1,0,2766,108,15,119527,59,2,2815,51,59,35,1640,1675,59,167
103,341,0.0006253860930725854,1,342,113459,119742,7,1,0,3138,294,15,119742,74,5,3139,68,74,219,724,943,786,1080
104,344,0.0011059191784639046,14,345,117767,120232,7,1,0,4722,200,15,120232,108,6,4736,105,108,96,1824,1920,880,1080
97,348,0.0014746640437889196,16,349,95234,121387,9,1,0,3455,324,15,121387,120,10,3471,44,120,167,207,374,756,1080
133,354,0.0013030727377089505,6,355,122736,124379,11,1,0,757,789,17,124379,23,10,763,2,23,254,1666,1920,167,956
134,355,0.001105645220911947,11,356,123272,124526,11,1,0,2093,636,17,124526,92,10,2104,7,92,234,1686,1920,244,880
123,357,0.0013648848257690428,3,358,126908,125225,12,1,0,1548,491,17,125225,67,13,1551,38,67,197,41,238,589,1080
124,359,0.00080582131244277,22,360,126982,125249,12,1,0,1704,440,17,125249,23,13,1726,40,23,214,538,752,640,1080
129,361,0.0013974862044303401,3,362,128495,126346,13,1,0,126,179,17,126346,57,14,129,5,57,119,1105,1224,901,1080
130,362,0.001080763245472628,13,363,125269,127354,13,1,0,2052,212,17,127354,25,12,2065,60,25,144,1770,1914,868,1080
131,366,0.0014464589771899616,9,367,125533,127588,13,1,0,2798,550,17,127588,21,12,2807,92,21,214,1096,1310,530,1080
132,367,0.0012162054293813785,14,368,130460,127627,13,1,0,3013,100,17,127627,32,2,3027,94,32,43,461,504,144,244
125,369,0.0014854220780850752,16,370,131068,128444,14,1,0,60,547,17,128444,55,3,76,1,55,220,1636,1856,533,1080
126,371,0.0011461642641724132,23,372,126982,128682,14,1,0,1703,373,17,128682,25,13,1726,24,25,183,1123,1306,707,1080
127,373,0.0011495668253388186,9,374,127494,128866,14,1,0,2340,515,17,128866,30,13,2349,39,30,100,1820,1920,565,1080
128,376,0.0006956453191995025,9,377,127650,128900,14,1,0,2992,557,17,128900,29,13,3001,41,29,127,1793,1920,516,1073
112,377,0.0010076045618869242,5,378,135423,129542,15,1,0,2873,307,17,129542,38,5,2878,20,38,99,1339,1438,200,507
119,386,0.0012726517770716846,9,387,134251,132925,3,1,0,4100,213,17,132925,30,4,4109,65,30,150,713,863,867,1080
120,387,0.0012050047708502768,5,388,130062,133451,4,1,0,311,219,17,133451,82,2,316,1,82,135,902,1037,861,1080
121,388,0.0014579179703479665,3,389,130742,133948,4,1,0,3254,183,17,133948,73,2,3257,36,73,136,482,618,897,1080
122,390,0.0013325361284233102,10,391,132969,134399,4,1,0,4626,440,17,134399,70,3,4636,56,70,170,1748,1918,626,1066
114,393,0.0012320749391570955,1,394,136742,135263,5,1,0,2379,428,17,135263,28,6,2380,45,28,114,0,114,652,1080
115,397,0.0007645237706709808,28,398,138498,135459,5,1,0,2914,242,17,135459,36,7,2942,51,36,60,1860,1920,352,594
116,401,0.0013727631375096074,8,402,135079,136230,6,1,0,1954,497,17,136230,26,5,1962,17,26,190,676,866,583,1080
117,404,0.0012271414081231093,8,405,136742,138299,7,1,0,2372,558,17,138299,25,6,2380,44,25,238,993,1231,522,1080
118,405,0.0006363368497976237,29,406,135460,138497,7,1,0,2910,264,17,138497,29,5,2939,56,29,65,0,65,373,637
139,413,0.0007935206937927727,5,414,141795,143063,14,1,0,200,348,19,143063,82,12,205,1,82,179,389,568,732,1080
140,414,0.0013051133511108929,2,415,141719,143224,14,1,0,201,249,19,143224,79,12,203,5,79,144,1238,1382,831,1080
138,433,0.0012393187075224956,5,434,147698,148677,6,1,0,2674,257,19,148677,71,5,2679,26,71,160,682,842,823,1080
135,434,0.0013269729502561447,23,435,140989,150607,9,1,0,2609,489,19,150607,96,10,2632,29,96,179,0,179,591,1080
136,436,0.0014330767824828373,16,437,140897,150674,9,1,0,2606,487,19,150674,66,10,2622,32,66,203,651,854,593,1080
137,438,0.001053038391359477,3,439,148678,150745,9,1,0,2607,461,19,150745,70,6,2610,35,70,183,517,700,619,1080
141,446,0.0010118293314240866,6,447,159945,155253,10,1,0,1836,208,9,155253,45,11,1842,58,45,140,518,658,872,1080
180,458,0.0009758346528111679,8,459,152274,159892,11,1,0,169,520,9,159892,27,10,177,1,27,174,1746,1920,288,808
169,465,0.0012622019638875786,11,466,181854,168848,12,1,0,412,389,9,168848,26,3,423,2,26,201,308,509,691,1080
170,470,0.0010428321111080443,3,471,174426,170957,12,1,0,4959,442,9,170957,69,13,4962,148,69,187,42,229,638,1080
174,473,0.0012574458237236408,3,474,175540,171907,13,1,0,1392,124,9,171907,111,14,1395,40,111,110,1182,1292,956,1080
175,476,0.0014790165515129485,3,477,176351,172919,13,1,0,2591,409,9,172919,34,14,2594,94,34,205,894,1099,671,1080
176,482,0.001332664016161849,9,483,170706,174085,13,1,0,4332,393,9,174085,23,12,4341,141,23,186,871,1057,687,1080
177,483,0.0010260774684680107,6,484,170958,174397,13,1,0,4834,469,9,174397,47,12,4840,146,47,209,1057,1266,611,1080
178,484,0.001160537598373168,13,485,185359,174594,13,1,0,5056,147,9,174594,22,3,5069,163,22,91,1398,1489,933,1080
179,486,0.0009924613146097177,7,487,171054,174748,13,1,0,5145,525,9,174748,48,12,5152,168,48,249,1056,1305,555,1080
171,488,0.0012889867115709055,10,489,172001,176116,14,1,0,1971,463,9,176116,576,13,1981,52,576,144,1776,1920,592,1055
172,489,0.0012005392166081108,11,490,173168,176598,14,1,0,2859,473,9,176598,103,13,2870,85,103,239,1506,1745,600,1073
173,491,0.0014218577951905945,2,492,173902,177423,14,1,0,3991,528,9,177423,60,13,3993,100,60,302,1584,1886,547,1075
165,503,0.0010561793833735148,4,504,185816,179696,2,1,0,1463,253,9,179696,72,4,1467,42,72,159,1018,1177,827,1080
167,505,0.0007892429836866454,20,506,172885,180434,2,1,0,2537,447,9,180434,76,13,2557,93,76,183,90,273,633,1080
168,507,0.0012928195974472702,6,508,185006,181267,2,1,0,4420,427,9,181267,70,3,4426,142,70,169,0,169,653,1080
159,509,0.0013071727408964795,48,510,172923,183381,3,1,0,2529,201,9,183381,69,13,2577,48,69,127,1089,1216,879,1080
160,510,0.0013450599855271636,1,511,186501,183427,3,1,0,2515,135,9,183427,45,4,2516,49,45,104,1473,1577,945,1080
161,513,0.000702494456061195,3,514,180778,184283,3,1,0,2969,463,9,184283,31,2,2972,72,31,197,1190,1387,617,1080
162,517,0.0014004441037438714,42,518,173902,184898,3,1,0,3951,280,9,184898,20,13,3993,88,20,99,205,304,252,532
163,520,0.0009726865460161317,10,521,180069,186185,4,1,0,2013,508,9,186185,141,2,2023,30,141,194,1499,1693,444,952
164,523,0.0011434071124223784,15,524,180897,186836,4,1,0,3371,440,9,186836,61,2,3386,61,61,249,1634,1883,626,1066
143,524,0.0010187246693053368,7,525,194057,187512,5,1,0,1242,374,9,187512,35,6,1249,16,35,100,0,100,706,1080
144,525,0.0006959497008972469,21,526,155208,187908,5,1,0,1770,433,9,187908,75,10,1791,29,75,174,5,179,647,1080
145,527,0.0010982183949978868,4,528,197180,188200,5,1,0,2831,519,9,188200,37,6,2835,49,37,149,0,149,552,1071
146,528,0.0011561298312251765,3,529,157453,188248,5,1,0,3062,611,9,188248,45,10,3065,51,45,248,76,324,469,1080
147,532,0.0013384208807192485,9,533,200597,189205,5,1,0,4072,606,9,189205,30,6,4081,78,30,323,17,340,474,1080
148,533,0.001176117810218884,3,534,204177,192489,6,1,0,77,318,9,192489,29,7,80,1,29,161,1028,1189,762,1080
149,535,0.0012963590621122313,2,536,204487,193672,6,1,0,585,124,9,193672,45,7,587,11,45,112,1175,1287,956,1080
150,537,0.0013760422400929866,1,538,205014,195230,6,1,0,1797,164,9,195230,25,7,1798,34,25,100,1328,1428,916,1080
151,549,0.0013281151392242033,2,550,208838,203542,6,1,0,5383,359,9,203542,40,7,5385,168,40,190,1078,1268,721,1080
152,550,0.001347443564642948,2,551,209207,204002,6,1,0,5782,214,9,204002,38,7,5784,193,38,169,1114,1283,866,1080
153,552,0.0006650631137737714,8,553,192628,204282,7,1,0,198,448,9,204282,37,6,206,2,37,196,1317,1513,632,1080
154,554,0.001036965644420273,9,555,194057,204601,7,1,0,1240,258,9,204601,45,6,1249,20,45,169,1726,1895,822,1080
155,557,0.0011025954243338225,8,558,195843,205220,7,1,0,2278,346,9,205220,74,6,2286,49,74,162,1755,1917,734,1080
156,558,0.0012089345212841205,40,559,180358,205500,7,1,0,2421,102,9,205500,109,2,2461,61,109,35,1654,1689,75,177
157,559,0.001222845280426968,11,560,197180,205635,7,1,0,2824,570,9,205635,21,6,2835,74,21,255,719,974,510,1080
158,563,0.0008460468751894,39,564,181343,208569,7,1,0,4993,109,9,208569,62,2,5032,134,62,35,1662,1697,71,180
142,565,0.0014707095286406989,2,566,153335,212783,9,1,0,1109,518,9,212783,83,10,1111,25,83,128,0,128,562,1080
