,Unnamed: 0,difference,transition_time,match_num,entrance_index,departure_index,camera,departure,entrance,frame_num,h,hour,index,max_track_len,next_cam,next_cam_framenum,track,track_length,w,x1,x2,y1,y2
12,8,0.0010697470524764553,22,9,10086,4848,12,1,0,3496,467,11,4848,39,15,3518,52,39,166,0,166,574,1041
16,9,0.0010056071139953578,5,10,10651,6057,13,1,0,530,160,11,6057,35,2,535,24,35,55,430,485,130,290
17,10,0.0012446921529341293,5,11,4234,6815,13,1,0,1740,331,11,6815,643,12,1745,30,643,193,1452,1645,749,1080
18,16,0.0010735755261867589,10,17,5623,7991,13,1,0,5284,347,11,7991,21,12,5294,122,21,165,1293,1458,733,1080
13,17,0.0010587591361745502,5,18,3903,8122,14,1,0,59,193,11,8122,58,12,64,1,58,138,1208,1346,887,1080
14,18,0.0012081018833751058,3,19,4108,8456,14,1,0,1157,189,11,8456,64,12,1160,12,64,133,1146,1279,891,1080
15,19,0.0012374627823479422,30,20,10086,8701,14,1,0,3488,201,11,8701,25,15,3518,27,25,161,1250,1411,876,1077
6,20,0.0007760515787950089,38,21,19389,10715,2,1,0,599,111,11,10715,64,7,637,5,64,35,289,324,128,239
7,21,0.0005972518511132965,7,22,15063,11224,2,1,0,2205,388,11,11224,59,4,2212,37,59,180,869,1049,692,1080
8,22,0.0009892292604531967,9,23,15119,11319,2,1,0,2301,213,11,11319,93,4,2310,43,93,133,676,809,867,1080
9,23,0.0014835145183000164,15,24,13071,11648,2,1,0,2946,571,11,11648,58,3,2961,65,58,234,166,400,509,1080
10,25,0.0010576645349160366,1,26,15580,11857,2,1,0,3221,180,11,11857,80,4,3222,73,80,107,1030,1137,900,1080
11,26,0.0012267564665338466,6,27,15646,11948,2,1,0,3220,140,11,11948,90,4,3226,76,90,96,558,654,940,1080
5,41,0.0007802832207318606,1,42,12121,15956,4,1,0,4984,399,11,15956,54,2,4985,169,54,183,1015,1198,681,1080
2,46,0.000985102103767504,45,47,2600,18367,6,1,0,2966,195,11,18367,42,10,3011,51,42,71,766,837,187,382
3,49,0.0006506185025292856,9,50,18011,19576,7,1,0,1302,623,11,19576,87,6,1311,20,87,240,1673,1913,452,1075
4,52,0.000861886990336664,9,53,18476,20943,7,1,0,3075,402,11,20943,33,6,3084,75,33,95,1825,1920,678,1080
0,56,0.0013005332050285555,3,57,1683,21773,9,1,0,1064,520,11,21773,68,10,1067,10,68,225,404,629,560,1080
1,57,0.0008383931700531683,1,58,1653,21848,9,1,0,1060,534,11,21848,69,10,1061,12,69,213,182,395,546,1080
19,69,0.0007258759923703265,2,70,65955,25197,10,1,0,306,467,13,25197,50,9,308,10,50,191,786,977,613,1080
45,74,0.0013709084981948876,13,75,25914,30129,11,1,0,2436,610,13,30129,75,10,2449,5,75,166,1754,1920,279,889
35,77,0.0014106427861062126,5,78,33463,31118,12,1,0,2070,597,13,31118,72,13,2075,35,72,257,79,336,483,1080
36,79,0.0007594600775835987,7,80,33631,31283,12,1,0,2231,487,13,31283,25,13,2238,56,25,239,672,911,593,1080
37,83,0.0011552969434692893,11,84,34400,31743,12,1,0,3697,345,13,31743,32,13,3708,79,32,207,242,449,735,1080
44,88,0.0010876961597732775,5,89,36324,33747,13,1,0,2280,337,13,33747,32,14,2285,101,32,159,634,793,743,1080
38,91,0.001401199109825001,10,92,32405,35988,14,1,0,387,465,13,35988,39,13,397,3,39,119,1801,1920,611,1076
39,92,0.0009109259744403645,3,93,33631,36242,14,1,0,2235,297,13,36242,24,13,2238,26,24,88,1832,1920,783,1080
40,93,0.001455715103608094,42,94,52006,36347,14,1,0,2308,438,13,36347,23,5,2350,30,23,77,0,77,393,831
41,94,0.0009210949668716973,1,95,31389,36434,14,1,0,2528,105,13,36434,84,12,2529,33,84,76,1236,1312,975,1080
42,96,0.0008822541115793693,11,97,34400,36554,14,1,0,3697,422,13,36554,31,13,3708,48,31,153,1767,1920,639,1061
43,97,0.0011983734044242855,4,98,35824,37674,14,1,0,5545,415,13,37674,35,13,5549,99,35,80,1840,1920,661,1076
30,104,0.000703245103939879,2,105,47636,39972,2,1,0,344,75,13,39972,58,4,346,2,58,54,487,541,1005,1080
31,105,0.0007788130894947075,1,106,47945,40503,2,1,0,893,113,13,40503,80,4,894,35,80,77,745,822,967,1080
33,108,0.0004980185418987815,2,109,48274,40974,2,1,0,1882,379,13,40974,62,4,1884,59,62,186,1104,1290,701,1080
34,110,0.0009556994301697703,1,111,48749,41558,2,1,0,2540,93,13,41558,81,4,2541,88,81,68,1304,1372,987,1080
26,116,0.0012867701707001227,4,117,40511,48102,4,1,0,1360,357,13,48102,66,2,1364,42,66,203,1068,1271,723,1080
27,118,0.001352645784654606,4,119,41184,48418,4,1,0,1982,281,13,48418,91,2,1986,58,91,162,1298,1460,794,1075
28,119,0.0006259754973028192,3,120,41254,48575,4,1,0,2142,250,13,48575,69,2,2145,69,69,167,958,1125,830,1080
29,120,0.0005720431570341273,2,121,41406,48736,4,1,0,2347,104,13,48736,69,2,2349,95,69,74,1221,1295,976,1080
22,154,0.001337488185818731,4,155,58298,55599,6,1,0,475,372,13,55599,52,7,479,18,52,169,857,1026,708,1080
23,176,0.0010870799230211768,16,177,56601,61387,7,1,0,3411,412,13,61387,148,6,3427,133,148,109,1811,1920,552,964
24,177,0.0005919743855105769,2,178,52865,61457,7,1,0,3419,433,13,61457,69,5,3421,135,69,213,951,1164,647,1080
25,184,0.0007583066465294897,5,185,55117,65315,7,1,0,5359,320,13,65315,94,5,5364,252,94,193,1154,1347,760,1080
20,185,0.0010743972002504095,7,186,25209,66072,9,1,0,420,585,13,66072,57,10,427,8,57,209,324,533,495,1080
21,188,0.0010040765262094408,4,189,28709,67066,9,1,0,4210,430,13,67066,73,10,4214,111,73,207,24,231,650,1080
46,193,0.0011464130889670481,4,194,86261,69022,10,1,0,179,503,15,69022,55,9,183,4,55,186,685,871,577,1080
47,195,0.0013456500646524794,2,196,86525,70049,10,1,0,2338,528,15,70049,74,9,2340,36,74,204,586,790,552,1080
59,201,0.0006457540821437698,22,202,86701,72044,11,1,0,3967,782,15,72044,28,9,3989,12,28,331,1491,1822,298,1080
58,202,0.0011753238551385544,7,203,73716,72639,12,1,0,2099,506,15,72639,85,13,2106,19,85,212,161,373,574,1080
54,215,0.0007381327972387018,3,216,79614,77184,2,1,0,1814,123,15,77184,70,4,1817,9,70,96,820,916,957,1080
55,216,0.0008660052086616691,3,217,79819,77391,2,1,0,2353,247,15,77391,81,4,2356,14,81,144,946,1090,833,1080
56,217,0.0008488336578249701,3,218,80656,77828,2,1,0,5602,285,15,77828,60,4,5605,40,60,171,508,679,795,1080
57,218,0.000557242774358228,2,219,80720,77895,2,1,0,5663,78,15,77895,65,4,5665,43,65,56,650,706,1002,1080
51,221,0.0008734148101107184,3,222,77590,80035,4,1,0,4438,196,15,80035,67,2,4441,111,67,110,1142,1252,884,1080
52,222,0.0007843003294460709,1,223,77648,80150,4,1,0,4651,190,15,80150,67,2,4652,118,67,133,970,1103,890,1080
53,223,0.000751048650970724,3,224,77937,80650,4,1,0,5753,197,15,80650,124,2,5756,150,124,117,522,639,883,1080
48,224,0.0011116830650961457,27,225,68967,80905,5,1,0,97,330,15,80905,27,10,124,1,27,118,0,118,750,1080
49,228,0.0014546913753840473,2,229,81857,84477,7,1,0,95,592,15,84477,28,6,97,4,28,296,1352,1648,488,1080
50,229,0.0012621289126262686,12,230,82731,85176,7,1,0,2286,581,15,85176,34,6,2298,29,34,178,1742,1920,499,1080
60,231,0.0010865436998788644,4,232,107828,87979,10,1,0,829,551,17,87979,41,9,833,23,41,201,681,882,529,1080
84,241,0.001461403052956263,42,242,95304,92306,13,1,0,1673,133,17,92306,176,2,1715,22,176,41,523,564,136,269
83,245,0.001284715048627932,6,246,90690,93831,14,1,0,2442,220,17,93831,85,12,2448,27,85,153,1163,1316,860,1080
79,246,0.0008710689116313662,10,247,96283,94914,2,1,0,71,502,17,94914,64,3,81,1,64,206,149,355,578,1080
80,247,0.0011626238472641722,28,248,97730,95085,2,1,0,640,154,17,95085,82,4,668,8,82,95,51,146,926,1080
81,248,0.0004623693033200091,8,249,98389,95736,2,1,0,2683,415,17,95736,89,4,2691,32,89,220,650,870,665,1080
82,249,0.0008308313589897378,7,250,98791,96132,2,1,0,3486,113,17,96132,82,4,3493,40,82,90,721,811,967,1080
73,250,0.0011279001382737282,10,251,88151,96654,3,1,0,1367,210,17,96654,57,10,1377,27,57,66,222,288,211,421
74,254,0.0005235066225515987,1,255,94928,97707,4,1,0,389,304,17,97707,80,2,390,5,80,178,802,980,776,1080
75,255,0.0013801735333113393,21,256,95457,98348,4,1,0,1721,245,17,98348,214,2,1742,37,214,175,431,606,825,1070
76,257,0.0011919587786065214,16,258,97047,99069,4,1,0,5648,460,17,99069,86,3,5664,123,86,191,1729,1920,620,1080
77,258,0.000757318316529641,3,259,96202,99179,4,1,0,5646,173,17,99179,102,2,5649,136,102,123,1151,1274,907,1080
78,259,0.0010756285894988663,15,260,97390,99388,4,1,0,5749,436,17,99388,74,3,5764,148,74,176,1650,1826,644,1080
63,261,0.0010723374354057538,1,262,101777,99473,5,1,0,319,617,17,99473,36,6,320,9,36,264,95,359,463,1080
64,264,0.0011443024594780644,5,265,102511,100088,5,1,0,2098,345,17,100088,38,6,2103,50,38,60,0,60,734,1079
66,269,0.0009571799949613523,2,270,106586,102685,6,1,0,2834,265,17,102685,37,7,2836,48,37,162,1045,1207,815,1080
67,272,0.001418332919802207,2,273,101803,105300,7,1,0,360,262,17,105300,27,6,362,4,27,158,1555,1713,818,1080
68,273,0.001400293809300758,2,274,88151,105588,7,1,0,1375,635,17,105588,20,10,1377,28,20,221,742,963,409,1044
69,274,0.0011264751555095905,29,275,99912,105748,7,1,0,1954,271,17,105748,92,5,1983,37,92,175,1019,1194,809,1080
70,275,0.0010363680115497431,7,276,102511,105898,7,1,0,2096,283,17,105898,28,6,2103,47,28,136,1784,1920,796,1079
71,276,0.0010766772109932537,46,277,108267,106638,7,1,0,2906,605,17,106638,27,9,2952,63,27,260,1660,1920,475,1080
72,277,0.0012816483981018256,4,278,89868,107309,7,1,0,5166,468,17,107309,22,10,5170,87,22,213,859,1072,612,1080
61,279,0.0010803643793963473,5,280,88065,107981,9,1,0,1125,388,17,107981,82,10,1130,19,82,216,29,245,692,1080
87,280,0.0006789842909505006,17,281,110091,110856,11,1,0,3112,694,19,110856,145,10,3129,19,145,189,1731,1920,130,824
86,291,0.0010337360866177134,5,292,111637,113449,3,1,0,3624,186,19,113449,59,13,3629,26,59,150,341,491,894,1080
85,294,0.0013535620095966447,3,295,115227,116052,6,1,0,2724,535,19,116052,34,5,2727,17,34,228,1202,1430,545,1080
88,299,0.0013160441950390315,2,300,131765,119102,10,1,0,419,209,9,119102,101,9,421,5,101,134,1239,1373,863,1072
89,300,0.0011775743236662512,4,301,131291,120092,10,1,0,3907,139,9,120092,46,7,3911,36,46,48,158,206,246,385
90,301,0.0009797529269392968,5,302,132339,120244,10,1,0,4058,358,9,120244,60,9,4063,44,60,152,781,933,722,1080
113,303,0.0009842469816557467,8,304,120410,121185,11,1,0,4822,685,9,121185,36,10,4830,19,36,192,1728,1920,186,871
104,304,0.0008081685634651454,17,305,122509,121371,12,1,0,1344,145,9,121371,27,13,1361,9,27,115,1550,1665,935,1080
105,305,0.00128620780579669,3,306,122567,121411,12,1,0,1606,437,9,121411,39,13,1609,11,39,128,0,128,643,1080
106,307,0.001038911680838933,8,308,122630,121444,12,1,0,2396,463,9,121444,32,13,2404,12,32,231,214,445,616,1079
111,308,0.001273957971218927,5,309,123673,122461,13,1,0,715,164,9,122461,51,14,720,9,51,112,1340,1452,916,1080
112,309,0.001357076857209942,23,310,126915,123097,13,1,0,5152,457,9,123097,146,3,5175,34,146,133,286,419,276,733
107,310,0.0010188124814092476,13,311,122410,123669,14,1,0,651,402,9,123669,73,13,664,2,73,147,1773,1920,678,1080
108,311,0.0009115756617653065,10,312,122509,123730,14,1,0,1351,562,9,123730,31,13,1361,7,31,193,1727,1920,487,1049
109,312,0.0007911614400516061,7,313,122630,123780,14,1,0,2397,511,9,123780,28,13,2404,13,28,137,1783,1920,555,1066
110,313,0.0010219848115662488,3,314,121568,123944,14,1,0,2854,162,9,123944,80,12,2857,18,80,102,1185,1287,918,1080
102,314,0.0011656054445845301,3,315,126463,125576,2,1,0,3803,621,9,125576,69,3,3806,22,69,261,106,367,459,1080
103,315,0.001411938260546179,4,316,126684,125652,2,1,0,4964,580,9,125652,72,3,4968,25,72,227,202,429,500,1080
99,316,0.001271520635356517,2,317,127328,125930,3,1,0,608,178,9,125930,23,4,610,4,23,111,1104,1215,902,1080
100,318,0.0007935732234810813,37,319,125406,127467,4,1,0,2388,281,9,127467,42,2,2425,39,42,153,999,1152,799,1080
101,319,0.0007818655040456606,6,320,125442,127553,4,1,0,3348,222,9,127553,65,2,3354,62,65,144,663,807,858,1080
92,321,0.0013597471933757595,6,322,130178,128712,5,1,0,5826,639,9,128712,32,6,5832,86,32,282,14,296,441,1080
93,324,0.0008261071468788964,2,325,127883,130500,7,1,0,264,102,9,130500,109,5,266,3,109,89,1168,1257,978,1080
94,325,0.0011889208347779054,9,326,128742,130677,7,1,0,322,483,9,130677,78,6,331,7,78,199,1689,1888,597,1080
95,327,0.001142262028670542,5,328,129315,131015,7,1,0,2517,366,9,131015,41,6,2522,28,41,114,1806,1920,707,1073
96,329,0.001285671705698102,16,330,129613,131382,7,1,0,3996,488,9,131382,27,6,4012,46,27,216,1187,1403,592,1080
98,331,0.001163543708291707,10,332,130178,131729,7,1,0,5822,326,9,131729,34,6,5832,68,34,205,1694,1899,754,1080
91,333,0.0005709537219804763,2,334,121115,132523,9,1,0,4364,248,9,132523,118,11,4366,50,118,156,1344,1500,832,1080
