frame_num,x1,y1,x2,y2,track,hour,camera,w,h,track_length,max_track_len,departure,entrance
97,1263,188,1321,438,1,11,1,58,250,0,31,0,1
98,1269,182,1327,431,1,11,1,58,249,1,31,0,0
99,1292,188,1351,434,1,11,1,59,246,2,31,0,0
100,1313,195,1374,444,1,11,1,61,249,3,31,0,0
101,1333,193,1400,457,1,11,1,67,264,4,31,0,0
102,1349,199,1419,474,1,11,1,70,275,5,31,0,0
103,1356,200,1430,482,1,11,1,74,282,6,31,0,0
104,1359,209,1436,499,1,11,1,77,290,7,31,0,0
105,1367,216,1449,517,1,11,1,82,301,8,31,0,0
106,1379,218,1467,531,1,11,1,88,313,9,31,0,0
107,1383,229,1477,553,1,11,1,94,324,10,31,0,0
108,1379,234,1476,560,1,11,1,97,326,11,31,0,0
109,1374,244,1477,588,1,11,1,103,344,12,31,0,0
110,1375,253,1483,610,1,11,1,108,357,13,31,0,0
111,1376,260,1489,625,1,11,1,113,365,14,31,0,0
112,1372,276,1493,657,1,11,1,121,381,15,31,0,0
113,1360,281,1488,679,1,11,1,128,398,16,31,0,0
114,1351,298,1488,722,1,11,1,137,424,17,31,0,0
115,1351,310,1496,755,1,11,1,145,445,18,31,0,0
116,1349,318,1507,792,1,11,1,158,474,19,31,0,0
117,1339,338,1508,838,1,11,1,169,500,20,31,0,0
118,1325,348,1498,854,1,11,1,173,506,21,31,0,0
119,1296,373,1488,932,1,11,1,192,559,22,31,0,0
120,1274,396,1480,981,1,11,1,206,585,23,31,0,0
121,1257,424,1483,1045,1,11,1,226,621,24,31,0,0
122,1243,466,1473,1072,1,11,1,230,606,25,31,0,0
123,1192,494,1428,1080,1,11,1,236,586,26,31,0,0
124,1153,560,1383,1080,1,11,1,230,520,27,31,0,0
125,1156,627,1373,1080,1,11,1,217,453,28,31,0,0
126,1138,696,1347,1080,1,11,1,209,384,29,31,0,0
127,1115,817,1283,1078,1,11,1,168,261,30,31,0,0
128,1080,954,1184,1080,1,11,1,104,126,31,31,1,0
225,1607,156,1645,271,2,11,1,38,115,0,0,0,0
227,1591,156,1626,267,3,11,1,35,111,0,25,0,1
228,1577,156,1616,280,3,11,1,39,124,1,25,0,0
229,1566,157,1607,289,3,11,1,41,132,2,25,0,0
230,1559,158,1602,294,3,11,1,43,136,3,25,0,0
231,1546,155,1590,292,3,11,1,44,137,4,25,0,0
232,1537,157,1582,296,3,11,1,45,139,5,25,0,0
233,1529,158,1575,300,3,11,1,46,142,6,25,0,0
234,1519,158,1566,301,3,11,1,47,143,7,25,0,0
235,1508,159,1556,305,3,11,1,48,146,8,25,0,0
236,1500,161,1548,308,3,11,1,48,147,9,25,0,0
237,1495,164,1541,306,3,11,1,46,142,10,25,0,0
238,1488,166,1535,311,3,11,1,47,145,11,25,0,0
239,1478,167,1526,312,3,11,1,48,145,12,25,0,0
240,1464,166,1513,314,3,11,1,49,148,13,25,0,0
241,1448,165,1500,320,3,11,1,52,155,14,25,0,0
242,1437,166,1491,325,3,11,1,54,159,15,25,0,0
243,1427,169,1479,325,3,11,1,52,156,16,25,0,0
244,1414,170,1468,327,3,11,1,54,157,17,25,0,0
245,1404,171,1458,330,3,11,1,54,159,18,25,0,0
246,1378,169,1433,331,3,11,1,55,162,19,25,0,0
247,1359,169,1415,332,3,11,1,56,163,20,25,0,0
248,1344,169,1399,332,3,11,1,55,163,21,25,0,0
249,1323,167,1379,331,3,11,1,56,164,22,25,0,0
250,1307,167,1363,331,3,11,1,56,164,23,25,0,0
251,1283,166,1338,331,3,11,1,55,165,24,25,0,0
252,1268,166,1323,332,3,11,1,55,166,25,25,1,0
417,1441,147,1476,293,4,11,1,35,146,0,3,0,0
418,1453,146,1489,293,4,11,1,36,147,1,3,0,0
419,1467,146,1502,293,4,11,1,35,147,2,3,0,0
422,1509,150,1544,286,4,11,1,35,136,0,3,0,0
423,1524,150,1560,285,4,11,1,36,135,1,3,0,0
424,1539,150,1574,286,4,11,1,35,136,2,3,0,0
425,1553,149,1588,283,4,11,1,35,134,3,3,0,0
427,1580,150,1616,280,4,11,1,36,130,0,3,0,0
428,1595,152,1630,279,4,11,1,35,127,1,3,0,0
429,1608,152,1643,278,4,11,1,35,126,2,3,0,0
494,1608,151,1644,275,5,11,1,36,124,0,25,0,1
495,1595,157,1631,281,5,11,1,36,124,1,25,0,0
496,1583,152,1621,281,5,11,1,38,129,2,25,0,0
497,1571,150,1608,275,5,11,1,37,125,3,25,0,0
498,1556,152,1594,280,5,11,1,38,128,4,25,0,0
499,1542,151,1582,288,5,11,1,40,137,5,25,0,0
500,1531,156,1572,293,5,11,1,41,137,6,25,0,0
501,1521,155,1564,298,5,11,1,43,143,7,25,0,0
502,1513,155,1557,300,5,11,1,44,145,8,25,0,0
503,1504,159,1548,303,5,11,1,44,144,9,25,0,0
504,1494,161,1538,305,5,11,1,44,144,10,25,0,0
505,1481,160,1529,313,5,11,1,48,153,11,25,0,0
506,1473,161,1523,318,5,11,1,50,157,12,25,0,0
507,1464,162,1513,320,5,11,1,49,158,13,25,0,0
508,1453,164,1503,323,5,11,1,50,159,14,25,0,0
509,1440,164,1491,325,5,11,1,51,161,15,25,0,0
510,1421,162,1473,330,5,11,1,52,168,16,25,0,0
511,1406,166,1460,333,5,11,1,54,167,17,25,0,0
512,1386,166,1441,341,5,11,1,55,175,18,25,0,0
513,1366,165,1423,342,5,11,1,57,177,19,25,0,0
514,1345,166,1400,335,5,11,1,55,169,20,25,0,0
515,1321,164,1374,332,5,11,1,53,168,21,25,0,0
516,1299,168,1353,333,5,11,1,54,165,22,25,0,0
517,1271,168,1324,333,5,11,1,53,165,23,25,0,0
518,1251,170,1305,341,5,11,1,54,171,24,25,0,0
519,1234,171,1288,344,5,11,1,54,173,25,25,1,0
509,1595,157,1650,286,6,11,1,55,129,0,26,0,1
510,1587,155,1642,285,6,11,1,55,130,1,26,0,0
511,1578,154,1633,283,6,11,1,55,129,2,26,0,0
512,1565,155,1620,284,6,11,1,55,129,3,26,0,0
513,1548,152,1607,294,6,11,1,59,142,4,26,0,0
514,1538,154,1599,297,6,11,1,61,143,5,26,0,0
515,1531,153,1592,299,6,11,1,61,146,6,26,0,0
516,1524,155,1585,301,6,11,1,61,146,7,26,0,0
517,1514,157,1575,303,6,11,1,61,146,8,26,0,0
518,1501,156,1566,311,6,11,1,65,155,9,26,0,0
519,1493,157,1559,315,6,11,1,66,158,10,26,0,0
520,1487,159,1551,313,6,11,1,64,154,11,26,0,0
521,1479,162,1543,317,6,11,1,64,155,12,26,0,0
522,1466,162,1530,320,6,11,1,64,158,13,26,0,0
523,1446,161,1514,326,6,11,1,68,165,14,26,0,0
524,1436,165,1503,328,6,11,1,67,163,15,26,0,0
525,1424,163,1492,332,6,11,1,68,169,16,26,0,0
526,1411,168,1479,337,6,11,1,68,169,17,26,0,0
527,1394,169,1461,338,6,11,1,67,169,18,26,0,0
528,1373,168,1441,341,6,11,1,68,173,19,26,0,0
529,1353,169,1419,340,6,11,1,66,171,20,26,0,0
530,1336,168,1400,335,6,11,1,64,167,21,26,0,0
531,1316,169,1380,335,6,11,1,64,166,22,26,0,0
532,1291,170,1356,344,6,11,1,65,174,23,26,0,0
533,1268,170,1329,338,6,11,1,61,168,24,26,0,0
534,1252,173,1313,344,6,11,1,61,171,25,26,0,0
535,1235,174,1297,346,6,11,1,62,172,26,26,1,0
607,1260,175,1339,425,7,11,1,79,250,0,38,0,1
608,1262,178,1339,420,7,11,1,77,242,1,38,0,0
609,1266,178,1342,419,7,11,1,76,241,2,38,0,0
610,1273,185,1351,431,7,11,1,78,246,3,38,0,0
611,1283,188,1365,446,7,11,1,82,258,4,38,0,0
612,1293,188,1376,448,7,11,1,83,260,5,38,0,0
613,1304,192,1391,465,7,11,1,87,273,6,38,0,0
614,1309,195,1399,475,7,11,1,90,280,7,38,0,0
615,1311,197,1405,489,7,11,1,94,292,8,38,0,0
616,1312,204,1411,511,7,11,1,99,307,9,38,0,0
617,1315,207,1417,520,7,11,1,102,313,10,38,0,0
618,1316,208,1423,536,7,11,1,107,328,11,38,0,0
619,1321,218,1430,553,7,11,1,109,335,12,38,0,0
620,1326,221,1436,559,7,11,1,110,338,13,38,0,0
621,1326,224,1441,578,7,11,1,115,354,14,38,0,0
622,1322,233,1442,601,7,11,1,120,368,15,38,0,0
623,1317,235,1440,611,7,11,1,123,376,16,38,0,0
624,1309,240,1439,640,7,11,1,130,400,17,38,0,0
625,1306,247,1440,663,7,11,1,134,416,18,38,0,0
626,1304,253,1441,675,7,11,1,137,422,19,38,0,0
627,1300,263,1445,710,7,11,1,145,447,20,38,0,0
628,1295,275,1445,735,7,11,1,150,460,21,38,0,0
629,1291,280,1442,742,7,11,1,151,462,22,38,0,0
630,1281,290,1445,793,7,11,1,164,503,23,38,0,0
631,1275,301,1447,827,7,11,1,172,526,24,38,0,0
632,1267,312,1443,844,7,11,1,176,532,25,38,0,0
633,1254,330,1447,911,7,11,1,193,581,26,38,0,0
634,1238,350,1437,948,7,11,1,199,598,27,38,0,0
635,1212,356,1421,980,7,11,1,209,624,28,38,0,0
636,1185,386,1407,1041,7,11,1,222,655,29,38,0,0
637,1166,403,1396,1072,7,11,1,230,669,30,38,0,0
638,1152,430,1381,1080,7,11,1,229,650,31,38,0,0
639,1133,477,1352,1080,7,11,1,219,603,32,38,0,0
640,1093,521,1305,1080,7,11,1,212,559,33,38,0,0
641,1030,560,1244,1080,7,11,1,214,520,34,38,0,0
642,993,640,1196,1079,7,11,1,203,439,35,38,0,0
643,972,713,1161,1077,7,11,1,189,364,36,38,0,0
644,938,820,1096,1076,7,11,1,158,256,37,38,0,0
645,923,868,1058,1080,7,11,1,135,212,38,38,1,0
737,1262,167,1304,359,8,11,1,42,192,0,29,0,1
738,1280,169,1323,361,8,11,1,43,192,1,29,0,0
739,1295,166,1338,358,8,11,1,43,192,2,29,0,0
740,1268,164,1310,353,8,11,1,42,189,3,29,0,0
741,1279,163,1322,351,8,11,1,43,188,4,29,0,0
742,1293,162,1335,341,8,11,1,42,179,5,29,0,0
743,1314,157,1356,334,8,11,1,42,177,6,29,0,0
744,1336,157,1380,333,8,11,1,44,176,7,29,0,0
745,1355,153,1401,336,8,11,1,46,183,8,29,0,0
746,1378,153,1427,343,8,11,1,49,190,9,29,0,0
747,1398,153,1447,338,8,11,1,49,185,10,29,0,0
748,1416,150,1466,335,8,11,1,50,185,11,29,0,0
749,1432,151,1481,331,8,11,1,49,180,12,29,0,0
750,1444,152,1491,327,8,11,1,47,175,13,29,0,0
751,1453,148,1501,326,8,11,1,48,178,14,29,0,0
752,1464,149,1511,323,8,11,1,47,174,15,29,0,0
753,1474,152,1520,321,8,11,1,46,169,16,29,0,0
754,1482,151,1528,320,8,11,1,46,169,17,29,0,0
755,1490,152,1535,315,8,11,1,45,163,18,29,0,0
756,1496,150,1541,309,8,11,1,45,159,19,29,0,0
757,1501,148,1545,303,8,11,1,44,155,20,29,0,0
758,1507,148,1550,302,8,11,1,43,154,21,29,0,0
759,1515,145,1557,296,8,11,1,42,151,22,29,0,0
760,1521,144,1564,295,8,11,1,43,151,23,29,0,0
761,1526,145,1568,296,8,11,1,42,151,24,29,0,0
762,1529,144,1570,293,8,11,1,41,149,25,29,0,0
763,1534,143,1573,283,8,11,1,39,140,26,29,0,0
764,1539,144,1577,281,8,11,1,38,137,27,29,0,0
765,1548,143,1584,273,8,11,1,36,130,28,29,0,0
766,1557,140,1595,276,8,11,1,38,136,29,29,1,0
740,1318,166,1377,356,9,11,1,59,190,0,29,0,1
741,1340,163,1398,349,9,11,1,58,186,1,29,0,0
742,1360,165,1418,352,9,11,1,58,187,2,29,0,0
743,1388,163,1449,356,9,11,1,61,193,3,29,0,0
744,1406,164,1467,352,9,11,1,61,188,4,29,0,0
745,1427,160,1488,351,9,11,1,61,191,5,29,0,0
746,1448,160,1507,344,9,11,1,59,184,6,29,0,0
747,1466,160,1526,343,9,11,1,60,183,7,29,0,0
748,1488,160,1548,339,9,11,1,60,179,8,29,0,0
749,1506,160,1567,335,9,11,1,61,175,9,29,0,0
750,1518,158,1579,331,9,11,1,61,173,10,29,0,0
751,1533,160,1593,327,9,11,1,60,167,11,29,0,0
752,1539,158,1601,325,9,11,1,62,167,12,29,0,0
753,1546,153,1609,323,9,11,1,63,170,13,29,0,0
754,1553,154,1616,320,9,11,1,63,166,14,29,0,0
755,1561,153,1623,313,9,11,1,62,160,15,29,0,0
756,1563,153,1624,308,9,11,1,61,155,16,29,0,0
757,1562,154,1624,312,9,11,1,62,158,17,29,0,0
758,1563,153,1621,302,9,11,1,58,149,18,29,0,0
759,1565,153,1622,297,9,11,1,57,144,19,29,0,0
760,1568,152,1622,292,9,11,1,54,140,20,29,0,0
761,1573,150,1625,286,9,11,1,52,136,21,29,0,0
762,1574,149,1628,291,9,11,1,54,142,22,29,0,0
763,1576,150,1628,288,9,11,1,52,138,23,29,0,0
764,1581,147,1630,279,9,11,1,49,132,24,29,0,0
765,1587,149,1635,278,9,11,1,48,129,25,29,0,0
766,1594,148,1644,280,9,11,1,50,132,26,29,0,0
767,1608,148,1653,273,9,11,1,45,125,27,29,0,0
768,1621,154,1661,268,9,11,1,40,114,28,29,0,0
769,1628,154,1668,265,9,11,1,40,111,29,29,1,0
1162,1002,462,1210,998,11,11,1,208,536,0,29,0,1
1163,1021,443,1228,978,11,11,1,207,535,1,29,0,0
1164,1038,417,1226,900,11,11,1,188,483,2,29,0,0
1165,1054,402,1235,865,11,11,1,181,463,3,29,0,0
1166,1079,381,1255,833,11,11,1,176,452,4,29,0,0
1167,1108,359,1274,783,11,11,1,166,424,5,29,0,0
1168,1127,347,1290,765,11,11,1,163,418,6,29,0,0
1169,1145,332,1299,723,11,11,1,154,391,7,29,0,0
1170,1157,316,1305,693,11,11,1,148,377,8,29,0,0
1171,1170,308,1316,678,11,11,1,146,370,9,29,0,0
1172,1192,293,1331,645,11,11,1,139,352,10,29,0,0
1173,1212,286,1347,633,11,11,1,135,347,11,29,0,0
1174,1223,280,1354,617,11,11,1,131,337,12,29,0,0
1175,1237,268,1362,589,11,11,1,125,321,13,29,0,0
1176,1244,265,1367,577,11,11,1,123,312,14,29,0,0
1177,1259,261,1373,552,11,11,1,114,291,15,29,0,0
1178,1270,253,1380,530,11,11,1,110,277,16,29,0,0
1179,1280,249,1389,523,11,11,1,109,274,17,29,0,0
1180,1281,243,1385,503,11,11,1,104,260,18,29,0,0
1181,1280,236,1382,491,11,11,1,102,255,19,29,0,0
1182,1285,234,1381,477,11,11,1,96,243,20,29,0,0
1183,1286,227,1378,462,11,11,1,92,235,21,29,0,0
1184,1288,223,1378,452,11,11,1,90,229,22,29,0,0
1185,1285,220,1373,445,11,11,1,88,225,23,29,0,0
1186,1278,214,1364,437,11,11,1,86,223,24,29,0,0
1187,1270,212,1354,431,11,11,1,84,219,25,29,0,0
1188,1264,209,1344,425,11,11,1,80,216,26,29,0,0
1189,1259,203,1336,416,11,11,1,77,213,27,29,0,0
1190,1255,208,1328,416,11,11,1,73,208,28,29,0,0
1191,1254,204,1325,405,11,11,1,71,201,29,29,1,0
1666,1265,151,1312,337,12,11,1,47,186,0,25,0,1
1667,1286,149,1334,337,12,11,1,48,188,1,25,0,0
1668,1307,147,1355,337,12,11,1,48,190,2,25,0,0
1669,1331,144,1382,337,12,11,1,51,193,3,25,0,0
1670,1348,142,1400,337,12,11,1,52,195,4,25,0,0
1671,1367,143,1420,339,12,11,1,53,196,5,25,0,0
1672,1392,144,1447,340,12,11,1,55,196,6,25,0,0
1673,1406,148,1460,337,12,11,1,54,189,7,25,0,0
1674,1420,145,1475,334,12,11,1,55,189,8,25,0,0
1675,1429,146,1484,335,12,11,1,55,189,9,25,0,0
1676,1438,145,1493,334,12,11,1,55,189,10,25,0,0
1677,1445,144,1500,329,12,11,1,55,185,11,25,0,0
1678,1451,144,1505,326,12,11,1,54,182,12,25,0,0
1679,1458,144,1510,318,12,11,1,52,174,13,25,0,0
1680,1459,144,1509,314,12,11,1,50,170,14,25,0,0
1681,1457,143,1508,311,12,11,1,51,168,15,25,0,0
1682,1454,140,1505,306,12,11,1,51,166,16,25,0,0
1683,1452,140,1503,306,12,11,1,51,166,17,25,0,0
1684,1450,139,1501,304,12,11,1,51,165,18,25,0,0
1685,1446,138,1497,300,12,11,1,51,162,19,25,0,0
1686,1442,137,1492,298,12,11,1,50,161,20,25,0,0
1687,1433,136,1484,297,12,11,1,51,161,21,25,0,0
1688,1426,136,1478,299,12,11,1,52,163,22,25,0,0
1689,1420,138,1468,295,12,11,1,48,157,23,25,0,0
1690,1422,160,1463,293,12,11,1,41,133,24,25,0,0
1691,1423,162,1462,291,12,11,1,39,129,25,25,1,0
1747,1600,149,1663,281,13,11,1,63,132,0,26,0,1
1748,1589,149,1649,274,13,11,1,60,125,1,26,0,0
1749,1570,142,1636,283,13,11,1,66,141,2,26,0,0
1750,1561,146,1625,285,13,11,1,64,139,3,26,0,0
1751,1547,145,1611,285,13,11,1,64,140,4,26,0,0
1752,1535,143,1599,284,13,11,1,64,141,5,26,0,0
1753,1524,146,1587,288,13,11,1,63,142,6,26,0,0
1754,1513,147,1576,291,13,11,1,63,144,7,26,0,0
1755,1504,145,1570,297,13,11,1,66,152,8,26,0,0
1756,1498,148,1564,301,13,11,1,66,153,9,26,0,0
1757,1490,150,1556,303,13,11,1,66,153,10,26,0,0
1758,1480,151,1545,306,13,11,1,65,155,11,26,0,0
1759,1470,153,1536,311,13,11,1,66,158,12,26,0,0
1760,1456,151,1523,313,13,11,1,67,162,13,26,0,0
1761,1445,151,1513,319,13,11,1,68,168,14,26,0,0
1762,1437,151,1506,324,13,11,1,69,173,15,26,0,0
1763,1426,150,1495,326,13,11,1,69,176,16,26,0,0
1764,1413,151,1484,332,13,11,1,71,181,17,26,0,0
1765,1405,158,1473,332,13,11,1,68,174,18,26,0,0
1766,1385,152,1456,337,13,11,1,71,185,19,26,0,0
1767,1372,155,1442,339,13,11,1,70,184,20,26,0,0
1768,1353,159,1421,340,13,11,1,68,181,21,26,0,0
1769,1333,154,1400,337,13,11,1,67,183,22,26,0,0
1770,1314,160,1381,336,13,11,1,67,176,23,26,0,0
1771,1293,167,1357,334,13,11,1,64,167,24,26,0,0
1772,1263,162,1330,344,13,11,1,67,182,25,26,0,0
1773,1247,163,1315,346,13,11,1,68,183,26,26,1,0
1826,1193,381,1433,982,16,11,1,240,601,0,51,0,1
1827,1223,354,1476,988,16,11,1,253,634,1,51,0,0
1828,1266,344,1511,958,16,11,1,245,614,2,51,0,0
1829,1324,321,1541,869,16,11,1,217,548,3,51,0,0
1830,1365,314,1573,838,16,11,1,208,524,4,51,0,0
1831,1406,304,1593,778,16,11,1,187,474,5,51,0,0
1832,1436,288,1619,754,16,11,1,183,466,6,51,0,0
1833,1459,281,1637,735,16,11,1,178,454,7,51,0,0
1834,1479,265,1642,684,16,11,1,163,419,8,51,0,0
1835,1493,259,1651,667,16,11,1,158,408,9,51,0,0
1836,1510,253,1660,644,16,11,1,150,391,10,51,0,0
1837,1520,244,1662,618,16,11,1,142,374,11,51,0,0
1838,1527,241,1664,604,16,11,1,137,363,12,51,0,0
1839,1534,229,1663,578,16,11,1,129,349,13,51,0,0
1840,1541,224,1662,552,16,11,1,121,328,14,51,0,0
1841,1551,223,1665,537,16,11,1,114,314,15,51,0,0
1842,1558,210,1668,518,16,11,1,110,308,16,51,0,0
1843,1565,208,1667,496,16,11,1,102,288,17,51,0,0
1844,1567,205,1668,489,16,11,1,101,284,18,51,0,0
1845,1569,198,1665,472,16,11,1,96,274,19,51,0,0
1846,1572,199,1665,468,16,11,1,93,269,20,51,0,0
1847,1576,194,1665,455,16,11,1,89,261,21,51,0,0
1848,1579,193,1665,448,16,11,1,86,255,22,51,0,0
1849,1579,190,1660,431,16,11,1,81,241,23,51,0,0
1850,1577,183,1655,417,16,11,1,78,234,24,51,0,0
1851,1576,183,1653,416,16,11,1,77,233,25,51,0,0
1852,1577,182,1650,407,16,11,1,73,225,26,51,0,0
1853,1576,176,1647,395,16,11,1,71,219,27,51,0,0
1854,1575,175,1641,383,16,11,1,66,208,28,51,0,0
1855,1571,169,1636,373,16,11,1,65,204,29,51,0,0
1856,1570,168,1630,356,16,11,1,60,188,30,51,0,0
1857,1569,167,1630,358,16,11,1,61,191,31,51,0,0
1858,1570,164,1629,350,16,11,1,59,186,32,51,0,0
1859,1569,165,1625,345,16,11,1,56,180,33,51,0,0
1860,1564,163,1621,346,16,11,1,57,183,34,51,0,0
1861,1559,161,1616,343,16,11,1,57,182,35,51,0,0
1862,1555,160,1610,339,16,11,1,55,179,36,51,0,0
1863,1549,155,1604,337,16,11,1,55,182,37,51,0,0
1864,1542,152,1594,326,16,11,1,52,174,38,51,0,0
1865,1533,151,1586,324,16,11,1,53,173,39,51,0,0
1866,1524,148,1576,318,16,11,1,52,170,40,51,0,0
1867,1515,148,1568,315,16,11,1,53,167,41,51,0,0
1868,1502,148,1552,309,16,11,1,50,161,42,51,0,0
1869,1489,146,1538,305,16,11,1,49,159,43,51,0,0
1870,1479,152,1528,304,16,11,1,49,152,44,51,0,0
1871,1464,146,1513,301,16,11,1,49,155,45,51,0,0
1872,1449,144,1498,295,16,11,1,49,151,46,51,0,0
1873,1438,141,1488,294,16,11,1,50,153,47,51,0,0
1874,1427,141,1476,296,16,11,1,49,155,48,51,0,0
1875,1420,142,1468,292,16,11,1,48,150,49,51,0,0
1876,1420,157,1463,289,16,11,1,43,132,50,51,0,0
1877,1412,158,1453,285,16,11,1,41,127,51,51,1,0
2097,1460,142,1495,305,18,11,1,35,163,0,19,0,1
2098,1462,144,1498,307,18,11,1,36,163,1,19,0,0
2099,1456,144,1496,307,18,11,1,40,163,2,19,0,0
2100,1453,143,1494,307,18,11,1,41,164,3,19,0,0
2101,1450,145,1494,314,18,11,1,44,169,4,19,0,0
2102,1447,144,1494,318,18,11,1,47,174,5,19,0,0
2103,1441,143,1491,323,18,11,1,50,180,6,19,0,0
2104,1434,145,1485,327,18,11,1,51,182,7,19,0,0
2105,1422,146,1476,330,18,11,1,54,184,8,19,0,0
2106,1409,146,1465,335,18,11,1,56,189,9,19,0,0
2107,1398,148,1455,339,18,11,1,57,191,10,19,0,0
2108,1386,146,1445,338,18,11,1,59,192,11,19,0,0
2109,1368,146,1429,339,18,11,1,61,193,12,19,0,0
2110,1352,147,1416,342,18,11,1,64,195,13,19,0,0
2111,1328,147,1392,340,18,11,1,64,193,14,19,0,0
2112,1305,149,1370,338,18,11,1,65,189,15,19,0,0
2113,1280,150,1345,341,18,11,1,65,191,16,19,0,0
2114,1261,149,1327,346,18,11,1,66,197,17,19,0,0
2115,1259,197,1310,349,18,11,1,51,152,18,19,0,0
2116,1248,202,1298,351,18,11,1,50,149,19,19,0,0
2129,1426,145,1462,294,19,11,1,36,149,0,6,0,0
2130,1441,140,1476,287,19,11,1,35,147,1,6,0,0
2131,1455,142,1491,285,19,11,1,36,143,2,6,0,0
2133,1490,142,1525,281,19,11,1,35,139,0,6,0,0
2134,1503,143,1539,283,19,11,1,36,140,1,6,0,0
2135,1522,139,1559,286,19,11,1,37,147,2,6,0,0
2136,1542,143,1578,280,19,11,1,36,137,3,6,0,0
2137,1558,141,1594,279,19,11,1,36,138,4,6,0,0
2138,1574,140,1611,279,19,11,1,37,139,5,6,0,0
2139,1591,146,1627,277,19,11,1,36,131,6,6,0,0
2219,1432,185,1468,291,20,11,1,36,106,0,23,0,1
2220,1433,151,1480,290,20,11,1,47,139,1,23,0,0
2221,1441,143,1491,291,20,11,1,50,148,2,23,0,0
2222,1453,148,1504,296,20,11,1,51,148,3,23,0,0
2223,1466,147,1518,298,20,11,1,52,151,4,23,0,0
2224,1478,150,1524,285,20,11,1,46,135,5,23,0,0
2225,1487,162,1534,295,20,11,1,47,133,6,23,0,0
2226,1494,169,1539,299,20,11,1,45,130,7,23,0,0
2227,1490,161,1542,309,20,11,1,52,148,8,23,0,0
2228,1484,155,1540,316,20,11,1,56,161,9,23,0,0
2229,1479,154,1536,320,20,11,1,57,166,10,23,0,0
2230,1468,156,1527,326,20,11,1,59,170,11,23,0,0
2231,1453,154,1514,331,20,11,1,61,177,12,23,0,0
2232,1435,151,1496,332,20,11,1,61,181,13,23,0,0
2233,1417,150,1480,333,20,11,1,63,183,14,23,0,0
2234,1402,152,1464,334,20,11,1,62,182,15,23,0,0
2235,1379,151,1442,335,20,11,1,63,184,16,23,0,0
2236,1358,153,1421,336,20,11,1,63,183,17,23,0,0
2237,1337,153,1398,335,20,11,1,61,182,18,23,0,0
2238,1312,151,1374,337,20,11,1,62,186,19,23,0,0
2239,1292,153,1356,338,20,11,1,64,185,20,23,0,0
2240,1271,154,1333,335,20,11,1,62,181,21,23,0,0
2241,1250,152,1313,343,20,11,1,63,191,22,23,0,0
2242,1237,152,1301,346,20,11,1,64,194,23,23,1,0
2285,610,871,795,1069,22,11,1,185,198,0,0,0,0
2286,695,783,966,1074,24,11,1,271,291,0,34,0,1
2287,722,708,1065,1078,24,11,1,343,370,1,34,0,0
2288,747,634,1152,1073,24,11,1,405,439,2,34,0,0
2289,776,571,1232,1074,24,11,1,456,503,3,34,0,0
2290,803,510,1306,1078,24,11,1,503,568,4,34,0,0
2291,844,476,1360,1077,24,11,1,516,601,5,34,0,0
2292,892,444,1410,1068,24,11,1,518,624,6,34,0,0
2293,926,400,1446,1052,24,11,1,520,652,7,34,0,0
2294,974,382,1468,1024,24,11,1,494,642,8,34,0,0
2295,1027,347,1470,949,24,11,1,443,602,9,34,0,0
2296,1064,334,1460,896,24,11,1,396,562,10,34,0,0
2297,1113,322,1469,849,24,11,1,356,527,11,34,0,0
2298,1149,304,1467,795,24,11,1,318,491,12,34,0,0
2299,1182,311,1458,755,24,11,1,276,444,13,34,0,0
2300,1215,295,1461,707,24,11,1,246,412,14,34,0,0
2301,1228,274,1468,696,24,11,1,240,422,15,34,0,0
2302,1263,268,1473,651,24,11,1,210,383,16,34,0,0
2303,1286,258,1486,636,24,11,1,200,378,17,34,0,0
2304,1305,255,1489,616,24,11,1,184,361,18,34,0,0
2305,1320,241,1491,585,24,11,1,171,344,19,34,0,0
2306,1334,237,1496,574,24,11,1,162,337,20,34,0,0
2307,1353,238,1500,554,24,11,1,147,316,21,34,0,0
2308,1365,229,1503,534,24,11,1,138,305,22,34,0,0
2309,1371,228,1500,524,24,11,1,129,296,23,34,0,0
2310,1376,220,1498,504,24,11,1,122,284,24,34,0,0
2311,1379,216,1493,489,24,11,1,114,273,25,34,0,0
2312,1382,214,1490,479,24,11,1,108,265,26,34,0,0
2313,1383,202,1487,463,24,11,1,104,261,27,34,0,0
2314,1383,200,1482,456,24,11,1,99,256,28,34,0,0
2315,1383,194,1477,441,24,11,1,94,247,29,34,0,0
2316,1382,191,1472,431,24,11,1,90,240,30,34,0,0
2317,1379,190,1465,425,24,11,1,86,235,31,34,0,0
2318,1374,186,1456,414,24,11,1,82,228,32,34,0,0
2319,1370,187,1449,406,24,11,1,79,219,33,34,0,0
2320,1372,183,1447,393,24,11,1,75,210,34,34,1,0
2286,251,792,514,1078,25,11,1,263,286,0,36,0,1
2287,323,734,639,1079,25,11,1,316,345,1,36,0,0
2288,381,661,761,1079,25,11,1,380,418,2,36,0,0
2289,457,595,886,1071,25,11,1,429,476,3,36,0,0
2290,528,543,991,1065,25,11,1,463,522,4,36,0,0
2291,572,488,1076,1071,25,11,1,504,583,5,36,0,0
2292,639,454,1135,1045,25,11,1,496,591,6,36,0,0
2293,702,418,1192,1024,25,11,1,490,606,7,36,0,0
2294,768,391,1232,989,25,11,1,464,598,8,36,0,0
2295,842,372,1259,929,25,11,1,417,557,9,36,0,0
2296,901,354,1279,880,25,11,1,378,526,10,36,0,0
2297,947,337,1299,847,25,11,1,352,510,11,36,0,0
2298,1003,320,1314,789,25,11,1,311,469,12,36,0,0
2299,1034,308,1325,767,25,11,1,291,459,13,36,0,0
2300,1079,296,1338,718,25,11,1,259,422,14,36,0,0
2301,1111,284,1351,690,25,11,1,240,406,15,36,0,0
2302,1138,274,1363,672,25,11,1,225,398,16,36,0,0
2303,1169,262,1375,640,25,11,1,206,378,17,36,0,0
2304,1184,255,1382,629,25,11,1,198,374,18,36,0,0
2305,1209,244,1389,595,25,11,1,180,351,19,36,0,0
2306,1226,237,1397,582,25,11,1,171,345,20,36,0,0
2307,1249,235,1410,571,25,11,1,161,336,21,36,0,0
2308,1270,230,1417,544,25,11,1,147,314,22,36,0,0
2309,1285,227,1423,530,25,11,1,138,303,23,36,0,0
2310,1294,222,1425,515,25,11,1,131,293,24,36,0,0
2311,1299,217,1425,507,25,11,1,126,290,25,36,0,0
2312,1306,214,1424,494,25,11,1,118,280,26,36,0,0
2313,1308,207,1419,475,25,11,1,111,268,27,36,0,0
2314,1307,204,1414,467,25,11,1,107,263,28,36,0,0
2315,1306,200,1407,455,25,11,1,101,255,29,36,0,0
2316,1307,197,1405,446,25,11,1,98,249,30,36,0,0
2317,1311,197,1402,434,25,11,1,91,237,31,36,0,0
2318,1313,191,1402,425,25,11,1,89,234,32,36,0,0
2319,1313,188,1399,416,25,11,1,86,228,33,36,0,0
2320,1319,183,1400,401,25,11,1,81,218,34,36,0,0
2321,1321,182,1402,399,25,11,1,81,217,35,36,0,0
2322,1326,177,1405,388,25,11,1,79,211,36,36,1,0
2319,1266,200,1312,414,26,11,1,46,214,0,37,0,1
2320,1269,195,1321,434,26,11,1,52,239,1,37,0,0
2321,1277,195,1333,446,26,11,1,56,251,2,37,0,0
2322,1285,184,1348,453,26,11,1,63,269,3,37,0,0
2323,1296,194,1361,466,26,11,1,65,272,4,37,0,0
2324,1309,203,1378,478,26,11,1,69,275,5,37,0,0
2325,1310,209,1382,487,26,11,1,72,278,6,37,0,0
2326,1311,213,1386,496,26,11,1,75,283,7,37,0,0
2327,1312,222,1390,508,26,11,1,78,286,8,37,0,0
2328,1315,224,1398,520,26,11,1,83,296,9,37,0,0
2329,1321,230,1409,534,26,11,1,88,304,10,37,0,0
2330,1318,235,1411,549,26,11,1,93,314,11,37,0,0
2331,1304,236,1402,559,26,11,1,98,323,12,37,0,0
2332,1290,242,1396,586,26,11,1,106,344,13,37,0,0
2333,1283,245,1395,604,26,11,1,112,359,14,37,0,0
2334,1278,251,1392,612,26,11,1,114,361,15,37,0,0
2335,1267,264,1387,638,26,11,1,120,374,16,37,0,0
2336,1249,268,1374,656,26,11,1,125,388,17,37,0,0
2337,1219,278,1351,685,26,11,1,132,407,18,37,0,0
2338,1197,287,1338,715,26,11,1,141,428,19,37,0,0
2339,1193,295,1338,728,26,11,1,145,433,20,37,0,0
2340,1184,311,1334,756,26,11,1,150,445,21,37,0,0
2341,1165,323,1320,782,26,11,1,155,459,22,37,0,0
2342,1139,336,1298,802,26,11,1,159,466,23,37,0,0
2343,1106,352,1282,859,26,11,1,176,507,24,37,0,0
2344,1102,363,1289,891,26,11,1,187,528,25,37,0,0
2345,1097,378,1297,934,26,11,1,200,556,26,37,0,0
2346,1071,403,1276,971,26,11,1,205,568,27,37,0,0
2347,1032,426,1237,993,26,11,1,205,567,28,37,0,0
2348,983,457,1201,1058,26,11,1,218,601,29,37,0,0
2349,957,497,1173,1080,26,11,1,216,583,30,37,0,0
2350,939,530,1148,1080,26,11,1,209,550,31,37,0,0
2351,919,584,1116,1080,26,11,1,197,496,32,37,0,0
2352,874,626,1065,1080,26,11,1,191,454,33,37,0,0
2353,806,682,997,1080,26,11,1,191,398,34,37,0,0
2354,757,773,929,1078,26,11,1,172,305,35,37,0,0
2355,722,860,869,1077,26,11,1,147,217,36,37,0,0
2356,700,906,824,1080,26,11,1,124,174,37,37,1,0
2323,1261,178,1313,353,27,11,1,52,175,0,3,0,0
2324,1260,205,1313,385,27,11,1,53,180,1,3,0,0
2325,1259,224,1304,378,27,11,1,45,154,2,3,0,0
2326,1259,235,1301,380,27,11,1,42,145,3,3,0,0
2704,1598,157,1641,278,28,11,1,43,121,0,28,0,1
2705,1590,161,1630,274,28,11,1,40,113,1,28,0,0
2706,1577,159,1622,285,28,11,1,45,126,2,28,0,0
2707,1569,162,1614,287,28,11,1,45,125,3,28,0,0
2708,1559,161,1605,288,28,11,1,46,127,4,28,0,0
2709,1547,159,1594,288,28,11,1,47,129,5,28,0,0
2710,1537,162,1585,294,28,11,1,48,132,6,28,0,0
2711,1527,160,1575,296,28,11,1,48,136,7,28,0,0
2712,1517,162,1566,299,28,11,1,49,137,8,28,0,0
2713,1507,163,1558,303,28,11,1,51,140,9,28,0,0
2714,1499,165,1550,305,28,11,1,51,140,10,28,0,0
2715,1489,163,1540,307,28,11,1,51,144,11,28,0,0
2716,1481,167,1533,312,28,11,1,52,145,12,28,0,0
2717,1471,167,1523,314,28,11,1,52,147,13,28,0,0
2718,1462,167,1516,319,28,11,1,54,152,14,28,0,0
2719,1452,168,1508,322,28,11,1,56,154,15,28,0,0
2720,1443,168,1499,322,28,11,1,56,154,16,28,0,0
2721,1433,168,1491,327,28,11,1,58,159,17,28,0,0
2722,1424,169,1482,332,28,11,1,58,163,18,28,0,0
2723,1411,170,1469,333,28,11,1,58,163,19,28,0,0
2724,1395,171,1453,336,28,11,1,58,165,20,28,0,0
2725,1379,173,1438,335,28,11,1,59,162,21,28,0,0
2726,1358,174,1415,333,28,11,1,57,159,22,28,0,0
2727,1343,176,1401,335,28,11,1,58,159,23,28,0,0
2728,1325,179,1383,335,28,11,1,58,156,24,28,0,0
2729,1300,179,1357,334,28,11,1,57,155,25,28,0,0
2730,1278,179,1336,332,28,11,1,58,153,26,28,0,0
2731,1261,180,1318,333,28,11,1,57,153,27,28,0,0
2732,1246,181,1303,335,28,11,1,57,154,28,28,1,0
4344,680,856,893,1073,29,11,1,213,217,0,8,0,0
4345,702,758,1009,1070,29,11,1,307,312,1,8,0,0
4346,720,689,1092,1068,29,11,1,372,379,2,8,0,0
4347,740,590,1200,1067,29,11,1,460,477,3,8,0,0
4348,776,523,1293,1070,29,11,1,517,547,4,8,0,0
4349,820,477,1367,1071,29,11,1,547,594,5,8,0,0
4350,848,420,1424,1070,29,11,1,576,650,6,8,0,0
4351,890,388,1453,1051,29,11,1,563,663,7,8,0,0
4352,910,337,1516,1049,29,11,1,606,712,8,8,0,0
4352,1116,361,1309,924,30,11,1,193,563,0,21,0,1
4353,1157,350,1343,892,30,11,1,186,542,1,21,0,0
4354,1193,336,1369,847,30,11,1,176,511,2,21,0,0
4355,1227,307,1392,787,30,11,1,165,480,3,21,0,0
4356,1249,299,1407,763,30,11,1,158,464,4,21,0,0
4357,1276,280,1419,697,30,11,1,143,417,5,21,0,0
4358,1299,271,1436,668,30,11,1,137,397,6,21,0,0
4359,1323,262,1453,640,30,11,1,130,378,7,21,0,0
4360,1335,246,1459,610,30,11,1,124,364,8,21,0,0
4361,1336,240,1457,596,30,11,1,121,356,9,21,0,0
4362,1342,229,1455,561,30,11,1,113,332,10,21,0,0
4363,1346,224,1456,544,30,11,1,110,320,11,21,0,0
4364,1352,220,1455,521,30,11,1,103,301,12,21,0,0
4365,1348,208,1449,502,30,11,1,101,294,13,21,0,0
4366,1337,209,1434,489,30,11,1,97,280,14,21,0,0
4367,1326,201,1418,469,30,11,1,92,268,15,21,0,0
4368,1316,198,1405,457,30,11,1,89,259,16,21,0,0
4369,1306,197,1392,442,30,11,1,86,245,17,21,0,0
4370,1286,192,1366,426,30,11,1,80,234,18,21,0,0
4371,1269,192,1351,426,30,11,1,82,234,19,21,0,0
4372,1256,188,1335,420,30,11,1,79,232,20,21,0,0
4373,1249,183,1325,405,30,11,1,76,222,21,21,1,0
4455,763,859,934,1071,32,11,1,171,212,0,32,0,1
4456,770,786,1000,1070,32,11,1,230,284,1,32,0,0
4457,766,690,1074,1070,32,11,1,308,380,2,32,0,0
4458,785,619,1149,1071,32,11,1,364,452,3,32,0,0
4459,832,554,1243,1072,32,11,1,411,518,4,32,0,0
4460,873,498,1318,1074,32,11,1,445,576,5,32,0,0
4461,911,466,1367,1073,32,11,1,456,607,6,32,0,0
4462,950,422,1394,1035,32,11,1,444,613,7,32,0,0
4463,990,393,1412,996,32,11,1,422,603,8,32,0,0
4464,1047,373,1435,947,32,11,1,388,574,9,32,0,0
4465,1105,341,1459,883,32,11,1,354,542,10,32,0,0
4466,1146,330,1476,856,32,11,1,330,526,11,32,0,0
4467,1185,320,1476,800,32,11,1,291,480,12,32,0,0
4468,1214,302,1479,755,32,11,1,265,453,13,32,0,0
4469,1244,295,1488,728,32,11,1,244,433,14,32,0,0
4470,1276,276,1498,686,32,11,1,222,410,15,32,0,0
4471,1295,273,1501,666,32,11,1,206,393,16,32,0,0
4472,1309,264,1499,639,32,11,1,190,375,17,32,0,0
4473,1324,248,1502,610,32,11,1,178,362,18,32,0,0
4474,1336,248,1501,594,32,11,1,165,346,19,32,0,0
4475,1350,239,1501,564,32,11,1,151,325,20,32,0,0
4476,1358,236,1499,547,32,11,1,141,311,21,32,0,0
4477,1357,234,1489,534,32,11,1,132,300,22,32,0,0
4478,1351,221,1478,516,32,11,1,127,295,23,32,0,0
4479,1346,218,1468,509,32,11,1,122,291,24,32,0,0
4480,1342,213,1458,493,32,11,1,116,280,25,32,0,0
4481,1336,209,1442,470,32,11,1,106,261,26,32,0,0
4482,1324,207,1427,467,32,11,1,103,260,27,32,0,0
4483,1308,200,1406,451,32,11,1,98,251,28,32,0,0
4484,1286,199,1381,443,32,11,1,95,244,29,32,0,0
4485,1268,197,1358,430,32,11,1,90,233,30,32,0,0
4486,1252,193,1338,424,32,11,1,86,231,31,32,0,0
4487,1244,187,1327,410,32,11,1,83,223,32,32,1,0
4746,1264,189,1330,362,33,11,1,66,173,0,33,0,1
4747,1252,175,1321,358,33,11,1,69,183,1,33,0,0
4748,1253,180,1314,344,33,11,1,61,164,2,33,0,0
4749,1275,184,1335,347,33,11,1,60,163,3,33,0,0
4750,1297,183,1353,332,33,11,1,56,149,4,33,0,0
4751,1312,183,1370,338,33,11,1,58,155,5,33,0,0
4752,1331,180,1390,338,33,11,1,59,158,6,33,0,0
4753,1351,181,1410,338,33,11,1,59,157,7,33,0,0
4754,1371,179,1433,343,33,11,1,62,164,8,33,0,0
4755,1394,174,1454,336,33,11,1,60,162,9,33,0,0
4756,1411,176,1471,332,33,11,1,60,156,10,33,0,0
4757,1426,177,1488,337,33,11,1,62,160,11,33,0,0
4758,1443,176,1498,324,33,11,1,55,148,12,33,0,0
4759,1458,178,1514,328,33,11,1,56,150,13,33,0,0
4760,1465,178,1520,328,33,11,1,55,150,14,33,0,0
4761,1472,177,1525,326,33,11,1,53,149,15,33,0,0
4762,1478,176,1531,326,33,11,1,53,150,16,33,0,0
4763,1485,173,1537,322,33,11,1,52,149,17,33,0,0
4764,1488,173,1539,322,33,11,1,51,149,18,33,0,0
4765,1490,173,1538,316,33,11,1,48,143,19,33,0,0
4766,1493,173,1540,312,33,11,1,47,139,20,33,0,0
4767,1498,172,1544,309,33,11,1,46,137,21,33,0,0
4768,1504,168,1549,304,33,11,1,45,136,22,33,0,0
4769,1509,168,1553,303,33,11,1,44,135,23,33,0,0
4770,1513,166,1556,298,33,11,1,43,132,24,33,0,0
4771,1520,165,1562,293,33,11,1,42,128,25,33,0,0
4772,1528,165,1570,290,33,11,1,42,125,26,33,0,0
4773,1534,164,1575,289,33,11,1,41,125,27,33,0,0
4774,1539,166,1578,287,33,11,1,39,121,28,33,0,0
4775,1542,161,1581,281,33,11,1,39,120,29,33,0,0
4776,1549,161,1585,274,33,11,1,36,113,30,33,0,0
4777,1557,164,1592,270,33,11,1,35,106,31,33,0,0
4778,1565,159,1601,270,33,11,1,36,111,32,33,0,0
4779,1575,160,1611,271,33,11,1,36,111,33,33,1,0
4747,1294,176,1343,358,34,11,1,49,182,0,32,0,1
4748,1309,176,1358,356,34,11,1,49,180,1,32,0,0
4749,1334,179,1383,355,34,11,1,49,176,2,32,0,0
4750,1352,179,1401,350,34,11,1,49,171,3,32,0,0
4751,1377,180,1427,352,34,11,1,50,172,4,32,0,0
4752,1399,181,1448,351,34,11,1,49,170,5,32,0,0
4753,1419,180,1470,349,34,11,1,51,169,6,32,0,0
4754,1443,181,1494,351,34,11,1,51,170,7,32,0,0
4755,1458,178,1511,352,34,11,1,53,174,8,32,0,0
4756,1474,178,1524,340,34,11,1,50,162,9,32,0,0
4757,1482,176,1532,338,34,11,1,50,162,10,32,0,0
4758,1489,171,1540,334,34,11,1,51,163,11,32,0,0
4759,1499,174,1548,332,34,11,1,49,158,12,32,0,0
4760,1507,172,1556,328,34,11,1,49,156,13,32,0,0
4761,1513,169,1562,327,34,11,1,49,158,14,32,0,0
4762,1520,169,1568,321,34,11,1,48,152,15,32,0,0
4763,1526,167,1574,321,34,11,1,48,154,16,32,0,0
4764,1533,164,1582,318,34,11,1,49,154,17,32,0,0
4765,1541,163,1591,320,34,11,1,50,157,18,32,0,0
4766,1549,161,1599,320,34,11,1,50,159,19,32,0,0
4767,1555,159,1604,312,34,11,1,49,153,20,32,0,0
4768,1561,160,1609,309,34,11,1,48,149,21,32,0,0
4769,1569,157,1616,306,34,11,1,47,149,22,32,0,0
4770,1574,156,1620,303,34,11,1,46,147,23,32,0,0
4771,1577,157,1624,306,34,11,1,47,149,24,32,0,0
4772,1581,156,1627,302,34,11,1,46,146,25,32,0,0
4773,1585,154,1630,300,34,11,1,45,146,26,32,0,0
4774,1590,155,1633,294,34,11,1,43,139,27,32,0,0
4775,1594,152,1637,293,34,11,1,43,141,28,32,0,0
4776,1597,153,1640,292,34,11,1,43,139,29,32,0,0
4777,1600,155,1641,285,34,11,1,41,130,30,32,0,0
4778,1602,157,1641,281,34,11,1,39,124,31,32,0,0
4779,1608,159,1645,278,34,11,1,37,119,32,32,1,0
4748,1286,178,1322,307,35,11,1,36,129,0,0,0,0
5236,898,400,1130,1034,38,11,1,232,634,0,25,0,1
5237,926,392,1155,1019,38,11,1,229,627,1,25,0,0
5238,972,364,1181,938,38,11,1,209,574,2,25,0,0
5239,1021,340,1222,894,38,11,1,201,554,3,25,0,0
5240,1057,328,1251,865,38,11,1,194,537,4,25,0,0
5241,1081,299,1261,796,38,11,1,180,497,5,25,0,0
5242,1103,294,1273,765,38,11,1,170,471,6,25,0,0
5243,1127,272,1290,727,38,11,1,163,455,7,25,0,0
5244,1160,257,1316,694,38,11,1,156,437,8,25,0,0
5245,1186,252,1339,683,38,11,1,153,431,9,25,0,0
5246,1204,236,1346,638,38,11,1,142,402,10,25,0,0
5247,1216,229,1354,622,38,11,1,138,393,11,25,0,0
5248,1230,227,1361,606,38,11,1,131,379,12,25,0,0
5249,1253,221,1375,574,38,11,1,122,353,13,25,0,0
5250,1271,222,1388,561,38,11,1,117,339,14,25,0,0
5251,1279,215,1388,532,38,11,1,109,317,15,25,0,0
5252,1282,207,1388,517,38,11,1,106,310,16,25,0,0
5253,1289,205,1389,499,38,11,1,100,294,17,25,0,0
5254,1296,198,1392,481,38,11,1,96,283,18,25,0,0
5255,1301,198,1394,468,38,11,1,93,270,19,25,0,0
5256,1293,191,1381,448,38,11,1,88,257,20,25,0,0
5257,1283,187,1370,443,38,11,1,87,256,21,25,0,0
5258,1275,187,1359,436,38,11,1,84,249,22,25,0,0
5259,1267,181,1349,421,38,11,1,82,240,23,25,0,0
5260,1260,180,1342,422,38,11,1,82,242,24,25,0,0
5261,1262,176,1340,408,38,11,1,78,232,25,25,1,0
5495,1022,580,1501,1070,39,11,1,479,490,0,6,0,0
5496,1035,535,1541,1073,39,11,1,506,538,1,6,0,0
5497,1046,499,1564,1073,39,11,1,518,574,2,6,0,0
5498,1065,474,1578,1070,39,11,1,513,596,3,6,0,0
5499,1087,442,1579,1041,39,11,1,492,599,4,6,0,0
5500,1101,421,1571,1024,39,11,1,470,603,5,6,0,0
5501,1108,381,1607,1020,39,11,1,499,639,6,6,0,0
5501,1220,399,1393,929,40,11,1,173,530,0,32,0,1
5502,1210,391,1383,921,40,11,1,173,530,1,32,0,0
5503,1209,378,1380,903,40,11,1,171,525,2,32,0,0
5504,1216,363,1373,848,40,11,1,157,485,3,32,0,0
5505,1218,351,1370,820,40,11,1,152,469,4,32,0,0
5506,1221,338,1364,780,40,11,1,143,442,5,32,0,0
5507,1224,325,1361,749,40,11,1,137,424,6,32,0,0
5508,1236,324,1369,736,40,11,1,133,412,7,32,0,0
5509,1255,307,1383,705,40,11,1,128,398,8,32,0,0
5510,1271,301,1395,692,40,11,1,124,391,9,32,0,0
5511,1283,293,1403,672,40,11,1,120,379,10,32,0,0
5512,1299,283,1414,648,40,11,1,115,365,11,32,0,0
5513,1316,284,1425,634,40,11,1,109,350,12,32,0,0
5514,1334,274,1438,610,40,11,1,104,336,13,32,0,0
5515,1348,266,1451,601,40,11,1,103,335,14,32,0,0
5516,1359,262,1460,595,40,11,1,101,333,15,32,0,0
5517,1370,254,1466,574,40,11,1,96,320,16,32,0,0
5518,1380,250,1473,559,40,11,1,93,309,17,32,0,0
5519,1391,247,1480,543,40,11,1,89,296,18,32,0,0
5520,1398,241,1483,526,40,11,1,85,285,19,32,0,0
5521,1398,240,1479,510,40,11,1,81,270,20,32,0,0
5522,1391,236,1473,507,40,11,1,82,271,21,32,0,0
5523,1383,233,1462,500,40,11,1,79,267,22,32,0,0
5524,1376,232,1452,491,40,11,1,76,259,23,32,0,0
5525,1366,225,1442,481,40,11,1,76,256,24,32,0,0
5526,1354,224,1428,472,40,11,1,74,248,25,32,0,0
5527,1339,220,1411,462,40,11,1,72,242,26,32,0,0
5528,1324,216,1395,456,40,11,1,71,240,27,32,0,0
5529,1310,214,1378,443,40,11,1,68,229,28,32,0,0
5530,1292,207,1358,430,40,11,1,66,223,29,32,0,0
5531,1273,206,1341,430,40,11,1,68,224,30,32,0,0
5532,1263,202,1331,429,40,11,1,68,227,31,32,0,0
5533,1254,198,1321,420,40,11,1,67,222,32,32,1,0
5612,1589,168,1626,286,41,11,1,37,118,0,28,0,1
5613,1579,169,1615,286,41,11,1,36,117,1,28,0,0
5614,1568,167,1604,284,41,11,1,36,117,2,28,0,0
5615,1559,168,1595,286,41,11,1,36,118,3,28,0,0
5616,1549,170,1585,287,41,11,1,36,117,4,28,0,0
5617,1538,171,1576,295,41,11,1,38,124,5,28,0,0
5618,1530,171,1569,299,41,11,1,39,128,6,28,0,0
5619,1522,171,1561,297,41,11,1,39,126,7,28,0,0
5620,1515,171,1555,300,41,11,1,40,129,8,28,0,0
5621,1506,174,1547,304,41,11,1,41,130,9,28,0,0
5622,1498,174,1540,306,41,11,1,42,132,10,28,0,0
5623,1491,176,1533,312,41,11,1,42,136,11,28,0,0
5624,1485,177,1528,316,41,11,1,43,139,12,28,0,0
5625,1477,177,1521,316,41,11,1,44,139,13,28,0,0
5626,1469,178,1514,319,41,11,1,45,141,14,28,0,0
5627,1459,179,1504,321,41,11,1,45,142,15,28,0,0
5628,1450,180,1495,323,41,11,1,45,143,16,28,0,0
5629,1439,181,1486,330,41,11,1,47,149,17,28,0,0
5630,1429,181,1475,329,41,11,1,46,148,18,28,0,0
5631,1416,184,1464,334,41,11,1,48,150,19,28,0,0
5632,1403,182,1454,338,41,11,1,51,156,20,28,0,0
5633,1380,183,1430,336,41,11,1,50,153,21,28,0,0
5634,1361,186,1410,333,41,11,1,49,147,22,28,0,0
5635,1342,187,1391,330,41,11,1,49,143,23,28,0,0
5636,1320,188,1368,327,41,11,1,48,139,24,28,0,0
5637,1300,190,1350,328,41,11,1,50,138,25,28,0,0
5638,1272,188,1325,333,41,11,1,53,145,26,28,0,0
5639,1256,192,1306,336,41,11,1,50,144,27,28,0,0
5640,1240,193,1291,337,41,11,1,51,144,28,28,1,0
5782,1262,162,1297,336,42,11,1,35,174,0,25,0,0
5784,1287,161,1322,331,42,11,1,35,170,0,25,0,1
5785,1304,163,1339,327,42,11,1,35,164,1,25,0,0
5786,1326,160,1362,327,42,11,1,36,167,2,25,0,0
5787,1343,159,1382,329,42,11,1,39,170,3,25,0,0
5788,1357,154,1398,331,42,11,1,41,177,4,25,0,0
5789,1375,153,1418,337,42,11,1,43,184,5,25,0,0
5790,1394,151,1439,338,42,11,1,45,187,6,25,0,0
5791,1408,149,1454,336,42,11,1,46,187,7,25,0,0
5792,1422,150,1468,333,42,11,1,46,183,8,25,0,0
5793,1436,149,1484,335,42,11,1,48,186,9,25,0,0
5794,1446,146,1495,331,42,11,1,49,185,10,25,0,0
5795,1455,146,1505,330,42,11,1,50,184,11,25,0,0
5796,1462,147,1512,324,42,11,1,50,177,12,25,0,0
5797,1465,146,1515,318,42,11,1,50,172,13,25,0,0
5798,1467,146,1517,317,42,11,1,50,171,14,25,0,0
5799,1467,146,1517,312,42,11,1,50,166,15,25,0,0
5800,1466,144,1517,308,42,11,1,51,164,16,25,0,0
5801,1464,147,1514,304,42,11,1,50,157,17,25,0,0
5802,1457,144,1508,301,42,11,1,51,157,18,25,0,0
5803,1450,144,1502,301,42,11,1,52,157,19,25,0,0
5804,1442,145,1495,301,42,11,1,53,156,20,25,0,0
5805,1437,146,1487,295,42,11,1,50,149,21,25,0,0
5806,1429,145,1479,293,42,11,1,50,148,22,25,0,0
5807,1425,150,1474,294,42,11,1,49,144,23,25,0,0
5808,1425,161,1471,294,42,11,1,46,133,24,25,0,0
5809,1425,162,1470,293,42,11,1,45,131,25,25,1,0
1,51,258,117,500,1,11,10,66,242,0,98,0,1
2,54,252,122,501,1,11,10,68,249,1,98,0,0
3,59,249,126,494,1,11,10,67,245,2,98,0,0
4,64,249,131,491,1,11,10,67,242,3,98,0,0
5,70,250,134,486,1,11,10,64,236,4,98,0,0
6,72,246,135,478,1,11,10,63,232,5,98,0,0
7,73,246,134,467,1,11,10,61,221,6,98,0,0
8,74,245,134,462,1,11,10,60,217,7,98,0,0
9,78,241,137,458,1,11,10,59,217,8,98,0,0
10,79,236,139,455,1,11,10,60,219,9,98,0,0
11,79,238,136,447,1,11,10,57,209,10,98,0,0
12,73,234,131,443,1,11,10,58,209,11,98,0,0
13,65,230,125,446,1,11,10,60,216,12,98,0,0
14,63,228,121,440,1,11,10,58,212,13,98,0,0
15,64,229,120,433,1,11,10,56,204,14,98,0,0
16,67,229,122,428,1,11,10,55,199,15,98,0,0
17,67,230,121,426,1,11,10,54,196,16,98,0,0
18,66,228,120,420,1,11,10,54,192,17,98,0,0
19,64,226,117,416,1,11,10,53,190,18,98,0,0
20,65,227,116,412,1,11,10,51,185,19,98,0,0
21,69,228,119,406,1,11,10,50,178,20,98,0,0
22,73,227,123,401,1,11,10,50,174,21,98,0,0
23,75,228,124,398,1,11,10,49,170,22,98,0,0
24,73,223,122,397,1,11,10,49,174,23,98,0,0
25,71,222,120,392,1,11,10,49,170,24,98,0,0
26,70,221,117,387,1,11,10,47,166,25,98,0,0
27,70,220,116,387,1,11,10,46,167,26,98,0,0
28,71,218,117,384,1,11,10,46,166,27,98,0,0
29,71,218,118,384,1,11,10,47,166,28,98,0,0
30,69,218,115,381,1,11,10,46,163,29,98,0,0
31,66,218,110,374,1,11,10,44,156,30,98,0,0
32,64,219,107,373,1,11,10,43,154,31,98,0,0
33,63,220,106,371,1,11,10,43,151,32,98,0,0
34,64,218,106,368,1,11,10,42,150,33,98,0,0
35,64,217,107,364,1,11,10,43,147,34,98,0,0
36,64,218,105,363,1,11,10,41,145,35,98,0,0
37,62,215,104,362,1,11,10,42,147,36,98,0,0
38,62,215,103,360,1,11,10,41,145,37,98,0,0
39,63,213,104,358,1,11,10,41,145,38,98,0,0
40,66,212,107,358,1,11,10,41,146,39,98,0,0
41,69,213,109,356,1,11,10,40,143,40,98,0,0
42,67,212,109,357,1,11,10,42,145,41,98,0,0
43,64,212,105,357,1,11,10,41,145,42,98,0,0
44,59,215,100,357,1,11,10,41,142,43,98,0,0
45,56,215,97,357,1,11,10,41,142,44,98,0,0
46,55,214,96,357,1,11,10,41,143,45,98,0,0
47,54,214,95,357,1,11,10,41,143,46,98,0,0
48,54,214,95,357,1,11,10,41,143,47,98,0,0
49,53,214,95,357,1,11,10,42,143,48,98,0,0
50,53,214,95,357,1,11,10,42,143,49,98,0,0
51,53,213,95,358,1,11,10,42,145,50,98,0,0
52,53,213,95,357,1,11,10,42,144,51,98,0,0
53,53,214,95,357,1,11,10,42,143,52,98,0,0
54,53,214,95,358,1,11,10,42,144,53,98,0,0
55,53,214,95,358,1,11,10,42,144,54,98,0,0
56,53,213,95,358,1,11,10,42,145,55,98,0,0
57,53,213,95,358,1,11,10,42,145,56,98,0,0
58,53,214,95,358,1,11,10,42,144,57,98,0,0
59,53,214,95,358,1,11,10,42,144,58,98,0,0
60,53,214,95,358,1,11,10,42,144,59,98,0,0
61,53,214,95,358,1,11,10,42,144,60,98,0,0
62,53,215,95,358,1,11,10,42,143,61,98,0,0
63,53,215,94,357,1,11,10,41,142,62,98,0,0
64,53,215,94,357,1,11,10,41,142,63,98,0,0
65,53,215,94,357,1,11,10,41,142,64,98,0,0
66,54,215,95,358,1,11,10,41,143,65,98,0,0
67,54,215,95,358,1,11,10,41,143,66,98,0,0
68,54,215,95,358,1,11,10,41,143,67,98,0,0
69,54,215,95,358,1,11,10,41,143,68,98,0,0
70,54,215,95,358,1,11,10,41,143,69,98,0,0
71,54,215,95,358,1,11,10,41,143,70,98,0,0
72,54,215,94,358,1,11,10,40,143,71,98,0,0
73,54,215,94,358,1,11,10,40,143,72,98,0,0
74,54,215,94,358,1,11,10,40,143,73,98,0,0
75,53,215,94,358,1,11,10,41,143,74,98,0,0
76,54,215,94,357,1,11,10,40,142,75,98,0,0
77,54,215,94,357,1,11,10,40,142,76,98,0,0
78,54,216,95,356,1,11,10,41,140,77,98,0,0
79,55,216,95,356,1,11,10,40,140,78,98,0,0
80,55,216,95,357,1,11,10,40,141,79,98,0,0
81,54,217,94,357,1,11,10,40,140,80,98,0,0
82,53,217,93,357,1,11,10,40,140,81,98,0,0
83,53,217,93,358,1,11,10,40,141,82,98,0,0
84,52,217,93,358,1,11,10,41,141,83,98,0,0
85,53,217,93,358,1,11,10,40,141,84,98,0,0
86,53,217,93,358,1,11,10,40,141,85,98,0,0
87,53,217,93,358,1,11,10,40,141,86,98,0,0
88,53,217,93,358,1,11,10,40,141,87,98,0,0
89,52,216,93,359,1,11,10,41,143,88,98,0,0
90,51,215,91,362,1,11,10,40,147,89,98,0,0
91,51,217,90,358,1,11,10,39,141,90,98,0,0
92,53,217,90,354,1,11,10,37,137,91,98,0,0
93,55,215,91,351,1,11,10,36,136,92,98,0,0
94,56,215,92,352,1,11,10,36,137,93,98,0,0
95,55,213,93,353,1,11,10,38,140,94,98,0,0
96,57,213,93,349,1,11,10,36,136,95,98,0,0
97,57,214,93,347,1,11,10,36,133,96,98,0,0
98,55,213,91,346,1,11,10,36,133,97,98,0,0
99,55,213,91,345,1,11,10,36,132,98,98,1,0
1,232,235,277,377,2,11,10,45,142,0,15,0,0
2,235,239,280,383,2,11,10,45,144,1,15,0,0
3,240,240,286,386,2,11,10,46,146,2,15,0,0
4,246,238,295,391,2,11,10,49,153,3,15,0,0
5,251,238,301,398,2,11,10,50,160,4,15,0,0
6,257,239,306,396,2,11,10,49,157,5,15,0,0
7,264,240,313,396,2,11,10,49,156,6,15,0,0
8,270,242,318,397,2,11,10,48,155,7,15,0,0
9,275,236,328,405,2,11,10,53,169,8,15,0,0
10,282,238,334,407,2,11,10,52,169,9,15,0,0
11,289,242,339,406,2,11,10,50,164,10,15,0,0
12,293,243,342,407,2,11,10,49,164,11,15,0,0
13,296,244,345,407,2,11,10,49,163,12,15,0,0
14,300,240,349,405,2,11,10,49,165,13,15,0,0
15,302,242,352,412,2,11,10,50,170,14,15,0,0
16,306,242,358,414,2,11,10,52,172,15,15,0,0
40,917,403,952,542,3,11,10,35,139,0,1,0,0
41,915,387,956,546,3,11,10,41,159,1,1,0,0
42,897,386,987,738,4,11,10,90,352,0,101,0,1
43,899,396,985,731,4,11,10,86,335,1,101,0,0
44,897,392,983,730,4,11,10,86,338,2,101,0,0
45,892,392,980,732,4,11,10,88,340,3,101,0,0
46,871,394,963,738,4,11,10,92,344,4,101,0,0
47,837,397,934,749,4,11,10,97,352,5,101,0,0
48,801,397,900,749,4,11,10,99,352,6,101,0,0
49,750,390,852,745,4,11,10,102,355,7,101,0,0
50,687,386,794,743,4,11,10,107,357,8,101,0,0
51,645,380,754,740,4,11,10,109,360,9,101,0,0
52,603,374,711,730,4,11,10,108,356,10,101,0,0
53,556,371,665,722,4,11,10,109,351,11,101,0,0
54,517,362,626,719,4,11,10,109,357,12,101,0,0
55,469,358,579,708,4,11,10,110,350,13,101,0,0
56,436,359,542,690,4,11,10,106,331,14,101,0,0
57,401,347,506,677,4,11,10,105,330,15,101,0,0
58,368,342,474,671,4,11,10,106,329,16,101,0,0
59,343,339,452,666,4,11,10,109,327,17,101,0,0
60,315,332,423,656,4,11,10,108,324,18,101,0,0
61,289,324,397,650,4,11,10,108,326,19,101,0,0
62,269,316,378,643,4,11,10,109,327,20,101,0,0
63,256,313,364,634,4,11,10,108,321,21,101,0,0
64,252,312,355,619,4,11,10,103,307,22,101,0,0
65,254,311,357,613,4,11,10,103,302,23,101,0,0
66,254,307,354,599,4,11,10,100,292,24,101,0,0
67,250,308,347,595,4,11,10,97,287,25,101,0,0
68,248,305,344,589,4,11,10,96,284,26,101,0,0
69,257,300,356,582,4,11,10,99,282,27,101,0,0
70,265,299,366,575,4,11,10,101,276,28,101,0,0
71,278,300,380,570,4,11,10,102,270,29,101,0,0
72,289,298,393,560,4,11,10,104,262,30,101,0,0
73,297,298,403,557,4,11,10,106,259,31,101,0,0
74,300,298,406,551,4,11,10,106,253,32,101,0,0
75,289,293,393,550,4,11,10,104,257,33,101,0,0
76,287,290,389,549,4,11,10,102,259,34,101,0,0
77,286,289,387,549,4,11,10,101,260,35,101,0,0
78,288,291,385,548,4,11,10,97,257,36,101,0,0
79,291,293,384,544,4,11,10,93,251,37,101,0,0
80,292,292,383,544,4,11,10,91,252,38,101,0,0
81,292,292,383,546,4,11,10,91,254,39,101,0,0
82,294,292,383,546,4,11,10,89,254,40,101,0,0
83,298,291,387,548,4,11,10,89,257,41,101,0,0
84,301,296,388,548,4,11,10,87,252,42,101,0,0
85,299,293,388,550,4,11,10,89,257,43,101,0,0
86,298,294,385,549,4,11,10,87,255,44,101,0,0
87,297,295,383,549,4,11,10,86,254,45,101,0,0
88,298,294,383,548,4,11,10,85,254,46,101,0,0
89,296,290,381,548,4,11,10,85,258,47,101,0,0
90,295,287,380,549,4,11,10,85,262,48,101,0,0
91,295,286,380,549,4,11,10,85,263,49,101,0,0
92,296,292,377,548,4,11,10,81,256,50,101,0,0
93,298,292,378,546,4,11,10,80,254,51,101,0,0
94,297,294,376,546,4,11,10,79,252,52,101,0,0
95,296,292,376,549,4,11,10,80,257,53,101,0,0
96,301,292,380,548,4,11,10,79,256,54,101,0,0
97,302,292,380,545,4,11,10,78,253,55,101,0,0
98,303,291,381,543,4,11,10,78,252,56,101,0,0
99,304,290,382,545,4,11,10,78,255,57,101,0,0
100,303,292,380,545,4,11,10,77,253,58,101,0,0
101,300,290,379,548,4,11,10,79,258,59,101,0,0
102,298,291,376,548,4,11,10,78,257,60,101,0,0
103,300,289,378,547,4,11,10,78,258,61,101,0,0
104,299,291,378,545,4,11,10,79,254,62,101,0,0
105,299,292,376,542,4,11,10,77,250,63,101,0,0
106,300,293,377,539,4,11,10,77,246,64,101,0,0
107,298,291,376,541,4,11,10,78,250,65,101,0,0
108,302,291,382,541,4,11,10,80,250,66,101,0,0
109,316,290,398,537,4,11,10,82,247,67,101,0,0
110,330,293,414,538,4,11,10,84,245,68,101,0,0
111,332,293,417,536,4,11,10,85,243,69,101,0,0
112,331,289,415,531,4,11,10,84,242,70,101,0,0
113,331,284,412,518,4,11,10,81,234,71,101,0,0
114,335,281,416,512,4,11,10,81,231,72,101,0,0
115,337,279,419,509,4,11,10,82,230,73,101,0,0
116,336,274,415,497,4,11,10,79,223,74,101,0,0
117,331,272,408,489,4,11,10,77,217,75,101,0,0
118,326,276,397,478,4,11,10,71,202,76,101,0,0
119,319,269,388,464,4,11,10,69,195,77,101,0,0
120,314,271,379,458,4,11,10,65,187,78,101,0,0
121,307,261,371,442,4,11,10,64,181,79,101,0,0
122,298,259,363,442,4,11,10,65,183,80,101,0,0
123,288,257,353,444,4,11,10,65,187,81,101,0,0
124,279,253,344,438,4,11,10,65,185,82,101,0,0
125,274,251,334,426,4,11,10,60,175,83,101,0,0
126,269,248,329,421,4,11,10,60,173,84,101,0,0
127,266,247,325,419,4,11,10,59,172,85,101,0,0
128,259,243,317,413,4,11,10,58,170,86,101,0,0
129,254,240,313,411,4,11,10,59,171,87,101,0,0
130,252,238,311,408,4,11,10,59,170,88,101,0,0
131,249,236,307,404,4,11,10,58,168,89,101,0,0
132,245,237,301,399,4,11,10,56,162,90,101,0,0
133,243,235,296,389,4,11,10,53,154,91,101,0,0
134,242,233,293,379,4,11,10,51,146,92,101,0,0
135,242,231,292,371,4,11,10,50,140,93,101,0,0
136,239,229,287,367,4,11,10,48,138,94,101,0,0
137,236,231,282,363,4,11,10,46,132,95,101,0,0
138,232,226,279,359,4,11,10,47,133,96,101,0,0
139,232,226,278,357,4,11,10,46,131,97,101,0,0
140,234,226,279,351,4,11,10,45,125,98,101,0,0
141,240,222,284,345,4,11,10,44,123,99,101,0,0
142,244,218,289,347,4,11,10,45,129,100,101,0,0
143,243,215,288,343,4,11,10,45,128,101,101,1,0
47,878,438,1027,798,5,11,10,149,360,0,65,0,1
48,861,427,1017,804,5,11,10,156,377,1,65,0,0
49,830,421,994,818,5,11,10,164,397,2,65,0,0
50,761,423,932,836,5,11,10,171,413,3,65,0,0
51,716,416,889,838,5,11,10,173,422,4,65,0,0
52,653,405,831,842,5,11,10,178,437,5,65,0,0
53,605,398,788,841,5,11,10,183,443,6,65,0,0
54,573,388,747,817,5,11,10,174,429,7,65,0,0
55,527,377,700,802,5,11,10,173,425,8,65,0,0
56,503,372,673,789,5,11,10,170,417,9,65,0,0
57,485,364,647,764,5,11,10,162,400,10,65,0,0
58,469,363,627,752,5,11,10,158,389,11,65,0,0
59,466,357,618,736,5,11,10,152,379,12,65,0,0
60,467,345,612,708,5,11,10,145,363,13,65,0,0
61,469,342,607,693,5,11,10,138,351,14,65,0,0
62,465,352,589,668,5,11,10,124,316,15,65,0,0
63,464,346,583,650,5,11,10,119,304,16,65,0,0
64,463,335,584,643,5,11,10,121,308,17,65,0,0
65,465,328,585,638,5,11,10,120,310,18,65,0,0
66,470,320,585,620,5,11,10,115,300,19,65,0,0
67,475,315,588,614,5,11,10,113,299,20,65,0,0
68,479,314,589,606,5,11,10,110,292,21,65,0,0
69,477,313,582,593,5,11,10,105,280,22,65,0,0
70,478,309,580,582,5,11,10,102,273,23,65,0,0
71,484,305,584,580,5,11,10,100,275,24,65,0,0
72,491,301,591,579,5,11,10,100,278,25,65,0,0
73,499,300,597,572,5,11,10,98,272,26,65,0,0
74,505,302,602,570,5,11,10,97,268,27,65,0,0
75,504,301,603,571,5,11,10,99,270,28,65,0,0
76,505,302,606,574,5,11,10,101,272,29,65,0,0
77,506,302,608,576,5,11,10,102,274,30,65,0,0
78,505,300,608,577,5,11,10,103,277,31,65,0,0
79,501,297,605,577,5,11,10,104,280,32,65,0,0
80,497,293,600,576,5,11,10,103,283,33,65,0,0
81,498,294,598,575,5,11,10,100,281,34,65,0,0
82,497,293,596,575,5,11,10,99,282,35,65,0,0
83,498,294,595,576,5,11,10,97,282,36,65,0,0
84,499,294,594,576,5,11,10,95,282,37,65,0,0
85,501,293,594,576,5,11,10,93,283,38,65,0,0
86,501,296,592,576,5,11,10,91,280,39,65,0,0
87,502,297,592,578,5,11,10,90,281,40,65,0,0
88,502,297,591,577,5,11,10,89,280,41,65,0,0
89,503,297,590,575,5,11,10,87,278,42,65,0,0
90,503,297,590,576,5,11,10,87,279,43,65,0,0
91,504,295,590,576,5,11,10,86,281,44,65,0,0
92,504,295,589,576,5,11,10,85,281,45,65,0,0
93,504,295,589,576,5,11,10,85,281,46,65,0,0
94,505,298,588,575,5,11,10,83,277,47,65,0,0
95,505,300,587,576,5,11,10,82,276,48,65,0,0
96,503,295,587,579,5,11,10,84,284,49,65,0,0
97,503,293,586,580,5,11,10,83,287,50,65,0,0
98,503,292,585,578,5,11,10,82,286,51,65,0,0
99,503,293,585,579,5,11,10,82,286,52,65,0,0
100,503,291,585,580,5,11,10,82,289,53,65,0,0
101,504,296,585,578,5,11,10,81,282,54,65,0,0
102,505,298,585,578,5,11,10,80,280,55,65,0,0
103,505,300,585,579,5,11,10,80,279,56,65,0,0
104,505,301,584,579,5,11,10,79,278,57,65,0,0
105,504,301,584,580,5,11,10,80,279,58,65,0,0
106,503,303,582,580,5,11,10,79,277,59,65,0,0
107,505,307,584,580,5,11,10,79,273,60,65,0,0
108,512,308,594,585,5,11,10,82,277,61,65,0,0
109,514,309,601,588,5,11,10,87,279,62,65,0,0
110,532,308,620,590,5,11,10,88,282,63,65,0,0
111,546,315,630,589,5,11,10,84,274,64,65,0,0
112,550,316,634,590,5,11,10,84,274,65,65,1,0
234,113,197,148,289,7,11,10,35,92,0,68,0,1
235,112,195,148,290,7,11,10,36,95,1,68,0,0
236,111,196,148,294,7,11,10,37,98,2,68,0,0
237,112,195,149,295,7,11,10,37,100,3,68,0,0
238,112,195,149,296,7,11,10,37,101,4,68,0,0
239,112,195,150,296,7,11,10,38,101,5,68,0,0
240,111,195,150,300,7,11,10,39,105,6,68,0,0
241,112,198,150,301,7,11,10,38,103,7,68,0,0
242,111,199,149,303,7,11,10,38,104,8,68,0,0
243,111,200,149,304,7,11,10,38,104,9,68,0,0
244,111,200,148,303,7,11,10,37,103,10,68,0,0
245,111,201,149,305,7,11,10,38,104,11,68,0,0
246,110,202,149,309,7,11,10,39,107,12,68,0,0
247,111,200,149,309,7,11,10,38,109,13,68,0,0
248,110,203,150,314,7,11,10,40,111,14,68,0,0
249,111,202,150,315,7,11,10,39,113,15,68,0,0
250,110,204,150,319,7,11,10,40,115,16,68,0,0
251,111,204,152,322,7,11,10,41,118,17,68,0,0
252,113,204,154,326,7,11,10,41,122,18,68,0,0
253,115,207,155,328,7,11,10,40,121,19,68,0,0
254,115,207,155,329,7,11,10,40,122,20,68,0,0
255,116,208,155,332,7,11,10,39,124,21,68,0,0
256,118,210,157,333,7,11,10,39,123,22,68,0,0
257,120,212,158,333,7,11,10,38,121,23,68,0,0
258,119,214,157,336,7,11,10,38,122,24,68,0,0
259,119,213,158,340,7,11,10,39,127,25,68,0,0
260,119,216,158,343,7,11,10,39,127,26,68,0,0
261,121,218,159,343,7,11,10,38,125,27,68,0,0
262,121,221,160,344,7,11,10,39,123,28,68,0,0
263,122,226,160,346,7,11,10,38,120,29,68,0,0
264,122,225,161,350,7,11,10,39,125,30,68,0,0
265,124,228,164,355,7,11,10,40,127,31,68,0,0
266,126,224,169,359,7,11,10,43,135,32,68,0,0
267,128,226,172,365,7,11,10,44,139,33,68,0,0
268,128,227,172,364,7,11,10,44,137,34,68,0,0
269,129,226,176,372,7,11,10,47,146,35,68,0,0
270,130,228,178,377,7,11,10,48,149,36,68,0,0
271,131,228,180,377,7,11,10,49,149,37,68,0,0
272,132,230,182,380,7,11,10,50,150,38,68,0,0
273,133,231,182,379,7,11,10,49,148,39,68,0,0
274,133,232,184,388,7,11,10,51,156,40,68,0,0
275,135,234,187,392,7,11,10,52,158,41,68,0,0
276,138,234,191,397,7,11,10,53,163,42,68,0,0
277,138,236,193,400,7,11,10,55,164,43,68,0,0
278,138,236,194,404,7,11,10,56,168,44,68,0,0
279,137,237,195,411,7,11,10,58,174,45,68,0,0
280,139,238,197,413,7,11,10,58,175,46,68,0,0
281,140,239,200,419,7,11,10,60,180,47,68,0,0
282,140,243,199,423,7,11,10,59,180,48,68,0,0
283,141,241,203,430,7,11,10,62,189,49,68,0,0
284,140,242,205,441,7,11,10,65,199,50,68,0,0
285,139,234,207,446,7,11,10,68,212,51,68,0,0
286,133,217,207,452,7,11,10,74,235,52,68,0,0
287,133,229,204,457,7,11,10,71,228,53,68,0,0
288,134,241,202,462,7,11,10,68,221,54,68,0,0
289,133,253,201,474,7,11,10,68,221,55,68,0,0
290,131,256,200,482,7,11,10,69,226,56,68,0,0
291,128,260,197,486,7,11,10,69,226,57,68,0,0
292,122,262,191,487,7,11,10,69,225,58,68,0,0
293,115,260,188,498,7,11,10,73,238,59,68,0,0
294,108,263,183,511,7,11,10,75,248,60,68,0,0
295,100,265,176,516,7,11,10,76,251,61,68,0,0
296,90,275,166,523,7,11,10,76,248,62,68,0,0
297,77,275,153,526,7,11,10,76,251,63,68,0,0
298,62,278,141,538,7,11,10,79,260,64,68,0,0
299,50,278,130,548,7,11,10,80,270,65,68,0,0
300,35,280,115,556,7,11,10,80,276,66,68,0,0
301,26,290,105,563,7,11,10,79,273,67,68,0,0
302,19,292,99,570,7,11,10,80,278,68,68,1,0
278,251,222,286,335,8,11,10,35,113,0,4,0,0
279,236,215,274,334,8,11,10,38,119,1,4,0,0
280,222,216,260,336,8,11,10,38,120,2,4,0,0
281,207,213,246,336,8,11,10,39,123,3,4,0,0
282,194,212,234,335,8,11,10,40,123,4,4,0,0
287,145,206,187,282,9,11,10,42,76,0,23,0,1
288,139,200,184,282,9,11,10,45,82,1,23,0,0
289,133,201,181,289,9,11,10,48,88,2,23,0,0
290,124,200,178,300,9,11,10,54,100,3,23,0,0
291,118,199,172,303,9,11,10,54,104,4,23,0,0
292,115,201,167,302,9,11,10,52,101,5,23,0,0
293,115,197,164,292,9,11,10,49,95,6,23,0,0
294,115,195,160,286,9,11,10,45,91,7,23,0,0
295,111,194,157,286,9,11,10,46,92,8,23,0,0
296,110,194,153,281,9,11,10,43,87,9,23,0,0
297,108,193,152,287,9,11,10,44,94,10,23,0,0
298,107,192,152,289,9,11,10,45,97,11,23,0,0
299,108,190,152,288,9,11,10,44,98,12,23,0,0
300,108,191,151,288,9,11,10,43,97,13,23,0,0
301,107,189,149,286,9,11,10,42,97,14,23,0,0
302,107,188,147,283,9,11,10,40,95,15,23,0,0
303,108,187,147,281,9,11,10,39,94,16,23,0,0
304,109,186,147,278,9,11,10,38,92,17,23,0,0
305,110,185,147,278,9,11,10,37,93,18,23,0,0
306,109,184,147,277,9,11,10,38,93,19,23,0,0
307,108,185,145,276,9,11,10,37,91,20,23,0,0
308,108,185,144,274,9,11,10,36,89,21,23,0,0
309,109,184,144,272,9,11,10,35,88,22,23,0,0
310,108,185,143,272,9,11,10,35,87,23,23,1,0
469,127,228,162,368,10,11,10,35,140,0,151,0,1
470,135,228,172,374,10,11,10,37,146,1,151,0,0
471,142,229,178,368,10,11,10,36,139,2,151,0,0
472,147,229,184,374,10,11,10,37,145,3,151,0,0
473,153,230,192,386,10,11,10,39,156,4,151,0,0
474,162,228,203,390,10,11,10,41,162,5,151,0,0
475,170,230,211,395,10,11,10,41,165,6,151,0,0
476,176,232,217,394,10,11,10,41,162,7,151,0,0
477,182,232,223,397,10,11,10,41,165,8,151,0,0
478,186,234,229,403,10,11,10,43,169,9,151,0,0
479,193,234,237,408,10,11,10,44,174,10,151,0,0
480,199,234,245,413,10,11,10,46,179,11,151,0,0
481,203,235,250,423,10,11,10,47,188,12,151,0,0
482,206,236,254,423,10,11,10,48,187,13,151,0,0
483,209,237,257,427,10,11,10,48,190,14,151,0,0
484,214,241,263,438,10,11,10,49,197,15,151,0,0
485,219,241,270,441,10,11,10,51,200,16,151,0,0
486,223,242,276,449,10,11,10,53,207,17,151,0,0
487,225,250,278,456,10,11,10,53,206,18,151,0,0
488,225,251,280,459,10,11,10,55,208,19,151,0,0
489,225,255,280,464,10,11,10,55,209,20,151,0,0
490,226,256,283,469,10,11,10,57,213,21,151,0,0
491,228,255,288,483,10,11,10,60,228,22,151,0,0
492,229,260,292,494,10,11,10,63,234,23,151,0,0
493,229,263,293,503,10,11,10,64,240,24,151,0,0
494,229,265,294,509,10,11,10,65,244,25,151,0,0
495,230,271,296,521,10,11,10,66,250,26,151,0,0
496,231,269,301,530,10,11,10,70,261,27,151,0,0
497,232,273,305,546,10,11,10,73,273,28,151,0,0
498,232,280,307,560,10,11,10,75,280,29,151,0,0
499,235,281,311,562,10,11,10,76,281,30,151,0,0
500,239,290,317,575,10,11,10,78,285,31,151,0,0
501,247,293,329,593,10,11,10,82,300,32,151,0,0
502,258,298,344,611,10,11,10,86,313,33,151,0,0
503,267,303,359,634,10,11,10,92,331,34,151,0,0
504,277,304,373,652,10,11,10,96,348,35,151,0,0
505,292,308,391,664,10,11,10,99,356,36,151,0,0
506,306,316,408,681,10,11,10,102,365,37,151,0,0
507,326,318,431,688,10,11,10,105,370,38,151,0,0
508,349,327,459,708,10,11,10,110,381,39,151,0,0
509,369,338,484,735,10,11,10,115,397,40,151,0,0
510,391,342,507,745,10,11,10,116,403,41,151,0,0
511,420,354,542,767,10,11,10,122,413,42,151,0,0
512,441,365,567,789,10,11,10,126,424,43,151,0,0
513,478,369,609,810,10,11,10,131,441,44,151,0,0
514,515,382,653,838,10,11,10,138,456,45,151,0,0
515,551,394,692,859,10,11,10,141,465,46,151,0,0
516,596,395,742,872,10,11,10,146,477,47,151,0,0
517,633,409,788,894,10,11,10,155,485,48,151,0,0
518,673,422,839,913,10,11,10,166,491,49,151,0,0
519,735,430,909,923,10,11,10,174,493,50,151,0,0
520,773,437,958,946,10,11,10,185,509,51,151,0,0
521,789,446,982,954,10,11,10,193,508,52,151,0,0
522,790,452,988,960,10,11,10,198,508,53,151,0,0
523,787,456,987,960,10,11,10,200,504,54,151,0,0
524,782,454,985,959,10,11,10,203,505,55,151,0,0
525,775,457,978,958,10,11,10,203,501,56,151,0,0
526,758,451,965,960,10,11,10,207,509,57,151,0,0
527,743,447,948,955,10,11,10,205,508,58,151,0,0
528,730,440,931,949,10,11,10,201,509,59,151,0,0
529,715,436,912,942,10,11,10,197,506,60,151,0,0
530,697,429,889,928,10,11,10,192,499,61,151,0,0
531,678,420,872,932,10,11,10,194,512,62,151,0,0
532,657,420,847,927,10,11,10,190,507,63,151,0,0
533,644,414,825,907,10,11,10,181,493,64,151,0,0
534,618,401,794,887,10,11,10,176,486,65,151,0,0
535,568,402,742,872,10,11,10,174,470,66,151,0,0
536,546,393,720,861,10,11,10,174,468,67,151,0,0
537,528,387,701,854,10,11,10,173,467,68,151,0,0
538,497,381,670,852,10,11,10,173,471,69,151,0,0
539,475,378,645,847,10,11,10,170,469,70,151,0,0
540,460,375,626,842,10,11,10,166,467,71,151,0,0
541,448,370,608,825,10,11,10,160,455,72,151,0,0
542,429,366,587,816,10,11,10,158,450,73,151,0,0
543,413,364,570,810,10,11,10,157,446,74,151,0,0
544,397,361,553,806,10,11,10,156,445,75,151,0,0
545,387,359,541,805,10,11,10,154,446,76,151,0,0
546,387,358,541,806,10,11,10,154,448,77,151,0,0
547,388,358,542,808,10,11,10,154,450,78,151,0,0
548,391,358,543,808,10,11,10,152,450,79,151,0,0
549,396,360,546,809,10,11,10,150,449,80,151,0,0
550,399,361,547,809,10,11,10,148,448,81,151,0,0
551,401,363,548,811,10,11,10,147,448,82,151,0,0
552,402,364,548,812,10,11,10,146,448,83,151,0,0
553,404,361,549,809,10,11,10,145,448,84,151,0,0
554,406,364,549,811,10,11,10,143,447,85,151,0,0
555,408,365,550,811,10,11,10,142,446,86,151,0,0
556,412,364,553,810,10,11,10,141,446,87,151,0,0
557,416,368,556,810,10,11,10,140,442,88,151,0,0
558,425,371,565,808,10,11,10,140,437,89,151,0,0
559,440,373,581,810,10,11,10,141,437,90,151,0,0
560,460,372,599,805,10,11,10,139,433,91,151,0,0
561,473,374,612,804,10,11,10,139,430,92,151,0,0
562,484,374,626,804,10,11,10,142,430,93,151,0,0
563,492,371,638,804,10,11,10,146,433,94,151,0,0
564,510,369,660,803,10,11,10,150,434,95,151,0,0
565,535,370,686,814,10,11,10,151,444,96,151,0,0
566,549,372,701,820,10,11,10,152,448,97,151,0,0
567,557,370,708,822,10,11,10,151,452,98,151,0,0
568,562,372,712,825,10,11,10,150,453,99,151,0,0
569,568,374,718,832,10,11,10,150,458,100,151,0,0
570,570,376,720,837,10,11,10,150,461,101,151,0,0
571,572,381,719,839,10,11,10,147,458,102,151,0,0
572,572,385,716,841,10,11,10,144,456,103,151,0,0
573,572,388,713,841,10,11,10,141,453,104,151,0,0
574,574,393,719,854,10,11,10,145,461,105,151,0,0
575,576,402,720,866,10,11,10,144,464,106,151,0,0
576,582,403,732,886,10,11,10,150,483,107,151,0,0
577,596,407,745,888,10,11,10,149,481,108,151,0,0
578,608,411,760,894,10,11,10,152,483,109,151,0,0
579,613,415,773,913,10,11,10,160,498,110,151,0,0
580,616,423,784,936,10,11,10,168,513,111,151,0,0
581,612,429,788,963,10,11,10,176,534,112,151,0,0
582,606,436,783,967,10,11,10,177,531,113,151,0,0
583,601,441,779,970,10,11,10,178,529,114,151,0,0
584,597,448,778,986,10,11,10,181,538,115,151,0,0
585,599,456,787,1012,10,11,10,188,556,116,151,0,0
586,603,458,795,1021,10,11,10,192,563,117,151,0,0
587,606,460,799,1020,10,11,10,193,560,118,151,0,0
588,603,465,801,1027,10,11,10,198,562,119,151,0,0
589,577,469,782,1033,10,11,10,205,564,120,151,0,0
590,539,469,751,1035,10,11,10,212,566,121,151,0,0
591,511,479,721,1035,10,11,10,210,556,122,151,0,0
592,473,464,689,1039,10,11,10,216,575,123,151,0,0
593,431,463,650,1051,10,11,10,219,588,124,151,0,0
594,386,470,600,1041,10,11,10,214,571,125,151,0,0
595,359,456,578,1035,10,11,10,219,579,126,151,0,0
596,340,444,563,1030,10,11,10,223,586,127,151,0,0
597,317,441,538,1027,10,11,10,221,586,128,151,0,0
598,294,434,516,1029,10,11,10,222,595,129,151,0,0
599,290,430,511,1027,10,11,10,221,597,130,151,0,0
600,307,431,524,1020,10,11,10,217,589,131,151,0,0
601,337,434,542,994,10,11,10,205,560,132,151,0,0
602,361,433,559,979,10,11,10,198,546,133,151,0,0
603,374,428,572,981,10,11,10,198,553,134,151,0,0
604,392,427,582,969,10,11,10,190,542,135,151,0,0
605,410,413,597,953,10,11,10,187,540,136,151,0,0
606,438,404,617,924,10,11,10,179,520,137,151,0,0
607,473,401,646,899,10,11,10,173,498,138,151,0,0
608,498,405,667,887,10,11,10,169,482,139,151,0,0
609,518,401,684,873,10,11,10,166,472,140,151,0,0
610,563,395,726,864,10,11,10,163,469,141,151,0,0
611,599,394,760,856,10,11,10,161,462,142,151,0,0
612,619,396,780,850,10,11,10,161,454,143,151,0,0
613,665,388,816,823,10,11,10,151,435,144,151,0,0
614,700,389,848,808,10,11,10,148,419,145,151,0,0
615,723,399,869,799,10,11,10,146,400,146,151,0,0
616,770,396,917,794,10,11,10,147,398,147,151,0,0
617,825,395,970,791,10,11,10,145,396,148,151,0,0
618,850,397,997,791,10,11,10,147,394,149,151,0,0
619,866,396,1015,797,10,11,10,149,401,150,151,0,0
620,894,395,1041,790,10,11,10,147,395,151,151,1,0
620,966,401,1017,662,12,11,10,51,261,0,0,0,0
1121,250,231,286,342,13,11,10,36,111,0,7,0,0
1122,249,231,284,336,13,11,10,35,105,1,7,0,0
1123,242,230,277,338,13,11,10,35,108,2,7,0,0
1124,231,229,266,335,13,11,10,35,106,3,7,0,0
1128,194,226,231,333,13,11,10,37,107,0,7,0,0
1129,186,225,222,330,13,11,10,36,105,1,7,0,0
1130,182,226,217,328,13,11,10,35,102,2,7,0,0
1131,178,222,214,327,13,11,10,36,105,3,7,0,0
1132,174,219,210,325,13,11,10,36,106,4,7,0,0
1133,170,218,205,322,13,11,10,35,104,5,7,0,0
1134,165,215,201,322,13,11,10,36,107,6,7,0,0
1135,162,213,198,320,13,11,10,36,107,7,7,0,0
1140,250,212,292,341,14,11,10,42,129,0,26,0,1
1141,247,212,288,339,14,11,10,41,127,1,26,0,0
1142,233,215,274,338,14,11,10,41,123,2,26,0,0
1143,223,213,264,336,14,11,10,41,123,3,26,0,0
1144,215,211,256,337,14,11,10,41,126,4,26,0,0
1145,205,211,247,337,14,11,10,42,126,5,26,0,0
1146,198,209,240,337,14,11,10,42,128,6,26,0,0
1147,190,209,232,333,14,11,10,42,124,7,26,0,0
1148,186,209,227,330,14,11,10,41,121,8,26,0,0
1149,183,208,225,329,14,11,10,42,121,9,26,0,0
1150,180,207,220,325,14,11,10,40,118,10,26,0,0
1151,177,206,218,327,14,11,10,41,121,11,26,0,0
1152,177,206,217,324,14,11,10,40,118,12,26,0,0
1153,176,205,216,320,14,11,10,40,115,13,26,0,0
1154,177,206,215,316,14,11,10,38,110,14,26,0,0
1155,175,204,214,315,14,11,10,39,111,15,26,0,0
1156,174,202,213,313,14,11,10,39,111,16,26,0,0
1157,174,199,212,312,14,11,10,38,113,17,26,0,0
1158,173,199,211,308,14,11,10,38,109,18,26,0,0
1159,175,198,211,305,14,11,10,36,107,19,26,0,0
1160,174,198,211,304,14,11,10,37,106,20,26,0,0
1161,173,197,209,302,14,11,10,36,105,21,26,0,0
1162,172,197,207,298,14,11,10,35,101,22,26,0,0
1163,171,196,206,299,14,11,10,35,103,23,26,0,0
1164,171,195,206,296,14,11,10,35,101,24,26,0,0
1165,169,194,204,294,14,11,10,35,100,25,26,0,0
1166,166,194,201,294,14,11,10,35,100,26,26,1,0
1143,917,403,1016,616,15,11,10,99,213,0,89,0,1
1144,891,395,1005,641,15,11,10,114,246,1,89,0,0
1145,872,396,996,660,15,11,10,124,264,2,89,0,0
1146,851,401,994,711,15,11,10,143,310,3,89,0,0
1147,818,399,973,737,15,11,10,155,338,4,89,0,0
1148,786,388,947,748,15,11,10,161,360,5,89,0,0
1149,756,397,917,757,15,11,10,161,360,6,89,0,0
1150,725,401,882,751,15,11,10,157,350,7,89,0,0
1151,668,397,824,744,15,11,10,156,347,8,89,0,0
1152,622,392,780,742,15,11,10,158,350,9,89,0,0
1153,573,387,736,743,15,11,10,163,356,10,89,0,0
1154,520,378,689,746,15,11,10,169,368,11,89,0,0
1155,484,374,659,747,15,11,10,175,373,12,89,0,0
1156,441,368,612,730,15,11,10,171,362,13,89,0,0
1157,409,363,578,717,15,11,10,169,354,14,89,0,0
1158,389,360,558,712,15,11,10,169,352,15,89,0,0
1159,357,354,521,692,15,11,10,164,338,16,89,0,0
1160,327,348,484,676,15,11,10,157,328,17,89,0,0
1161,312,344,466,671,15,11,10,154,327,18,89,0,0
1162,300,332,449,655,15,11,10,149,323,19,89,0,0
1163,290,327,435,648,15,11,10,145,321,20,89,0,0
1164,280,326,421,642,15,11,10,141,316,21,89,0,0
1165,271,321,399,616,15,11,10,128,295,22,89,0,0
1166,264,317,389,609,15,11,10,125,292,23,89,0,0
1167,260,312,380,600,15,11,10,120,288,24,89,0,0
1168,258,306,372,585,15,11,10,114,279,25,89,0,0
1169,253,302,365,577,15,11,10,112,275,26,89,0,0
1170,250,298,356,560,15,11,10,106,262,27,89,0,0
1171,240,292,340,546,15,11,10,100,254,28,89,0,0
1172,237,291,335,542,15,11,10,98,251,29,89,0,0
1173,239,287,330,524,15,11,10,91,237,30,89,0,0
1174,236,285,326,522,15,11,10,90,237,31,89,0,0
1175,235,283,322,515,15,11,10,87,232,32,89,0,0
1176,227,281,308,498,15,11,10,81,217,33,89,0,0
1177,222,279,300,488,15,11,10,78,209,34,89,0,0
1178,220,275,296,482,15,11,10,76,207,35,89,0,0
1179,215,269,293,480,15,11,10,78,211,36,89,0,0
1180,212,267,288,470,15,11,10,76,203,37,89,0,0
1181,212,267,285,464,15,11,10,73,197,38,89,0,0
1182,208,266,279,459,15,11,10,71,193,39,89,0,0
1183,203,266,273,460,15,11,10,70,194,40,89,0,0
1184,199,264,267,453,15,11,10,68,189,41,89,0,0
1185,196,265,264,448,15,11,10,68,183,42,89,0,0
1186,195,265,261,443,15,11,10,66,178,43,89,0,0
1187,186,261,250,434,15,11,10,64,173,44,89,0,0
1188,178,259,242,431,15,11,10,64,172,45,89,0,0
1189,172,259,236,431,15,11,10,64,172,46,89,0,0
1190,172,259,235,429,15,11,10,63,170,47,89,0,0
1191,172,258,233,424,15,11,10,61,166,48,89,0,0
1192,170,257,229,418,15,11,10,59,161,49,89,0,0
1193,166,253,225,415,15,11,10,59,162,50,89,0,0
1194,163,249,222,411,15,11,10,59,162,51,89,0,0
1195,163,247,222,409,15,11,10,59,162,52,89,0,0
1196,164,245,221,407,15,11,10,57,162,53,89,0,0
1197,163,246,219,401,15,11,10,56,155,54,89,0,0
1198,157,243,213,395,15,11,10,56,152,55,89,0,0
1199,154,241,209,392,15,11,10,55,151,56,89,0,0
1200,153,241,207,388,15,11,10,54,147,57,89,0,0
1201,153,239,206,388,15,11,10,53,149,58,89,0,0
1202,152,240,205,386,15,11,10,53,146,59,89,0,0
1203,150,239,203,382,15,11,10,53,143,60,89,0,0
1204,149,238,201,377,15,11,10,52,139,61,89,0,0
1205,150,238,199,374,15,11,10,49,136,62,89,0,0
1206,149,238,198,373,15,11,10,49,135,63,89,0,0
1207,150,237,199,372,15,11,10,49,135,64,89,0,0
1208,151,237,200,369,15,11,10,49,132,65,89,0,0
1209,150,236,199,370,15,11,10,49,134,66,89,0,0
1210,150,235,197,364,15,11,10,47,129,67,89,0,0
1211,147,234,193,363,15,11,10,46,129,68,89,0,0
1212,147,234,192,361,15,11,10,45,127,69,89,0,0
1213,149,231,192,356,15,11,10,43,125,70,89,0,0
1214,148,231,190,353,15,11,10,42,122,71,89,0,0
1215,145,230,187,350,15,11,10,42,120,72,89,0,0
1216,144,229,184,348,15,11,10,40,119,73,89,0,0
1217,143,228,182,346,15,11,10,39,118,74,89,0,0
1218,142,227,181,344,15,11,10,39,117,75,89,0,0
1219,141,226,179,341,15,11,10,38,115,76,89,0,0
1220,139,227,176,339,15,11,10,37,112,77,89,0,0
1221,138,226,174,336,15,11,10,36,110,78,89,0,0
1222,137,226,174,336,15,11,10,37,110,79,89,0,0
1223,137,226,174,335,15,11,10,37,109,80,89,0,0
1224,136,224,173,333,15,11,10,37,109,81,89,0,0
1225,136,224,172,331,15,11,10,36,107,82,89,0,0
1226,136,225,171,328,15,11,10,35,103,83,89,0,0
1227,135,220,171,326,15,11,10,36,106,84,89,0,0
1228,134,217,172,325,15,11,10,38,108,85,89,0,0
1229,134,216,172,325,15,11,10,38,109,86,89,0,0
1230,134,214,172,323,15,11,10,38,109,87,89,0,0
1231,134,213,172,321,15,11,10,38,108,88,89,0,0
1232,135,213,172,319,15,11,10,37,106,89,89,1,0
1235,135,210,171,311,15,11,10,36,101,0,89,0,0
1236,135,208,171,310,15,11,10,36,102,1,89,0,0
1237,134,206,171,309,15,11,10,37,103,2,89,0,0
1238,135,206,171,307,15,11,10,36,101,3,89,0,0
1248,117,189,154,292,15,11,10,37,103,0,89,0,0
1249,116,185,153,289,15,11,10,37,104,1,89,0,0
1250,114,177,153,288,15,11,10,39,111,2,89,0,0
1251,113,180,150,286,15,11,10,37,106,3,89,0,0
1252,113,178,150,286,15,11,10,37,108,4,89,0,0
1253,113,180,149,284,15,11,10,36,104,5,89,0,0
1254,114,182,149,281,15,11,10,35,99,6,89,0,0
1285,158,190,193,284,16,11,10,35,94,0,58,0,0
1287,158,191,195,293,16,11,10,37,102,0,58,0,1
1288,159,194,196,294,16,11,10,37,100,1,58,0,0
1289,161,196,198,298,16,11,10,37,102,2,58,0,0
1290,163,198,200,301,16,11,10,37,103,3,58,0,0
1291,163,199,202,306,16,11,10,39,107,4,58,0,0
1292,164,198,204,313,16,11,10,40,115,5,58,0,0
1293,167,200,208,318,16,11,10,41,118,6,58,0,0
1294,168,200,211,319,16,11,10,43,119,7,58,0,0
1295,170,201,213,321,16,11,10,43,120,8,58,0,0
1296,171,201,213,324,16,11,10,42,123,9,58,0,0
1297,172,201,216,327,16,11,10,44,126,10,58,0,0
1298,177,207,219,329,16,11,10,42,122,11,58,0,0
1299,180,208,222,331,16,11,10,42,123,12,58,0,0
1300,183,212,225,334,16,11,10,42,122,13,58,0,0
1301,185,214,226,334,16,11,10,41,120,14,58,0,0
1302,187,213,230,339,16,11,10,43,126,15,58,0,0
1303,190,213,235,343,16,11,10,45,130,16,58,0,0
1304,193,210,242,350,16,11,10,49,140,17,58,0,0
1305,195,211,246,354,16,11,10,51,143,18,58,0,0
1306,194,211,247,360,16,11,10,53,149,19,58,0,0
1307,196,214,251,363,16,11,10,55,149,20,58,0,0
1308,199,213,255,365,16,11,10,56,152,21,58,0,0
1309,200,212,258,368,16,11,10,58,156,22,58,0,0
1310,203,215,260,371,16,11,10,57,156,23,58,0,0
1311,206,218,263,376,16,11,10,57,158,24,58,0,0
1312,209,217,270,384,16,11,10,61,167,25,58,0,0
1313,213,218,275,390,16,11,10,62,172,26,58,0,0
1314,216,217,281,396,16,11,10,65,179,27,58,0,0
1315,221,216,286,399,16,11,10,65,183,28,58,0,0
1316,231,217,296,400,16,11,10,65,183,29,58,0,0
1317,240,223,303,399,16,11,10,63,176,30,58,0,0
1318,241,224,307,408,16,11,10,66,184,31,58,0,0
1319,242,225,309,414,16,11,10,67,189,32,58,0,0
1320,246,227,312,414,16,11,10,66,187,33,58,0,0
1321,250,226,319,416,16,11,10,69,190,34,58,0,0
1322,250,227,322,423,16,11,10,72,196,35,58,0,0
1323,246,229,318,422,16,11,10,72,193,36,58,0,0
1324,242,229,315,428,16,11,10,73,199,37,58,0,0
1325,239,230,310,428,16,11,10,71,198,38,58,0,0
1326,241,230,309,423,16,11,10,68,193,39,58,0,0
1327,241,228,307,425,16,11,10,66,197,40,58,0,0
1328,239,226,303,420,16,11,10,64,194,41,58,0,0
1329,233,229,296,417,16,11,10,63,188,42,58,0,0
1330,224,224,288,413,16,11,10,64,189,43,58,0,0
1331,218,220,283,409,16,11,10,65,189,44,58,0,0
1332,216,218,281,401,16,11,10,65,183,45,58,0,0
1333,214,217,277,397,16,11,10,63,180,46,58,0,0
1334,212,219,274,394,16,11,10,62,175,47,58,0,0
1335,208,216,269,389,16,11,10,61,173,48,58,0,0
1336,208,214,266,381,16,11,10,58,167,49,58,0,0
1337,207,215,264,377,16,11,10,57,162,50,58,0,0
1338,210,216,263,366,16,11,10,53,150,51,58,0,0
1339,213,215,264,358,16,11,10,51,143,52,58,0,0
1340,214,213,265,358,16,11,10,51,145,53,58,0,0
1341,217,212,269,358,16,11,10,52,146,54,58,0,0
1342,223,209,275,355,16,11,10,52,146,55,58,0,0
1343,234,208,285,352,16,11,10,51,144,56,58,0,0
1344,240,206,292,355,16,11,10,52,149,57,58,0,0
1345,243,205,294,352,16,11,10,51,147,58,58,1,0
1656,115,181,150,255,17,11,10,35,74,0,123,0,0
1657,116,181,151,257,17,11,10,35,76,1,123,0,0
1658,116,182,151,258,17,11,10,35,76,2,123,0,0
1659,116,182,151,259,17,11,10,35,77,3,123,0,0
1662,116,183,151,261,17,11,10,35,78,0,123,0,0
1684,106,200,141,284,17,11,10,35,84,0,123,0,1
1685,109,198,145,285,17,11,10,36,87,1,123,0,0
1686,110,198,147,288,17,11,10,37,90,2,123,0,0
1687,112,202,147,290,17,11,10,35,88,3,123,0,0
1688,113,201,149,293,17,11,10,36,92,4,123,0,0
1689,114,201,150,296,17,11,10,36,95,5,123,0,0
1690,117,200,154,296,17,11,10,37,96,6,123,0,0
1691,120,200,157,298,17,11,10,37,98,7,123,0,0
1692,123,202,160,300,17,11,10,37,98,8,123,0,0
1693,126,201,163,301,17,11,10,37,100,9,123,0,0
1694,127,202,165,305,17,11,10,38,103,10,123,0,0
1695,128,203,166,306,17,11,10,38,103,11,123,0,0
1696,129,202,166,307,17,11,10,37,105,12,123,0,0
1697,131,206,167,309,17,11,10,36,103,13,123,0,0
1698,133,206,169,310,17,11,10,36,104,14,123,0,0
1699,134,208,172,315,17,11,10,38,107,15,123,0,0
1700,134,209,175,320,17,11,10,41,111,16,123,0,0
1701,133,210,173,321,17,11,10,40,111,17,123,0,0
1702,133,213,171,320,17,11,10,38,107,18,123,0,0
1703,133,214,171,322,17,11,10,38,108,19,123,0,0
1704,132,214,172,326,17,11,10,40,112,20,123,0,0
1705,129,217,168,327,17,11,10,39,110,21,123,0,0
1706,127,220,165,329,17,11,10,38,109,22,123,0,0
1707,126,224,164,330,17,11,10,38,106,23,123,0,0
1708,124,221,163,331,17,11,10,39,110,24,123,0,0
1709,122,221,162,335,17,11,10,40,114,25,123,0,0
1710,119,229,158,339,17,11,10,39,110,26,123,0,0
1711,118,231,157,341,17,11,10,39,110,27,123,0,0
1712,115,228,155,341,17,11,10,40,113,28,123,0,0
1713,115,229,156,343,17,11,10,41,114,29,123,0,0
1714,115,228,157,345,17,11,10,42,117,30,123,0,0
1715,113,233,157,351,17,11,10,44,118,31,123,0,0
1716,115,234,159,353,17,11,10,44,119,32,123,0,0
1717,118,235,163,353,17,11,10,45,118,33,123,0,0
1718,122,237,168,359,17,11,10,46,122,34,123,0,0
1719,124,235,172,360,17,11,10,48,125,35,123,0,0
1720,126,236,177,367,17,11,10,51,131,36,123,0,0
1721,126,237,179,371,17,11,10,53,134,37,123,0,0
1722,128,236,183,374,17,11,10,55,138,38,123,0,0
1723,130,239,184,376,17,11,10,54,137,39,123,0,0
1724,133,238,186,375,17,11,10,53,137,40,123,0,0
1725,133,239,189,380,17,11,10,56,141,41,123,0,0
1726,130,239,188,383,17,11,10,58,144,42,123,0,0
1727,130,239,186,378,17,11,10,56,139,43,123,0,0
1728,130,243,186,384,17,11,10,56,141,44,123,0,0
1729,130,244,187,388,17,11,10,57,144,45,123,0,0
1730,125,243,186,397,17,11,10,61,154,46,123,0,0
1731,121,244,185,404,17,11,10,64,160,47,123,0,0
1732,119,244,184,406,17,11,10,65,162,48,123,0,0
1733,118,245,185,412,17,11,10,67,167,49,123,0,0
1734,120,250,187,417,17,11,10,67,167,50,123,0,0
1735,120,246,190,422,17,11,10,70,176,51,123,0,0
1736,119,251,192,429,17,11,10,73,178,52,123,0,0
1737,119,253,194,434,17,11,10,75,181,53,123,0,0
1738,120,253,197,442,17,11,10,77,189,54,123,0,0
1739,122,255,202,450,17,11,10,80,195,55,123,0,0
1740,124,257,205,453,17,11,10,81,196,56,123,0,0
1741,125,258,207,458,17,11,10,82,200,57,123,0,0
1742,125,261,207,460,17,11,10,82,199,58,123,0,0
1743,125,262,209,462,17,11,10,84,200,59,123,0,0
1744,128,267,213,472,17,11,10,85,205,60,123,0,0
1745,133,271,221,482,17,11,10,88,211,61,123,0,0
1746,133,271,223,488,17,11,10,90,217,62,123,0,0
1747,134,274,227,493,17,11,10,93,219,63,123,0,0
1748,132,280,225,496,17,11,10,93,216,64,123,0,0
1749,136,284,232,507,17,11,10,96,223,65,123,0,0
1750,139,291,236,516,17,11,10,97,225,66,123,0,0
1751,140,290,239,520,17,11,10,99,230,67,123,0,0
1752,145,298,248,535,17,11,10,103,237,68,123,0,0
1753,152,299,260,547,17,11,10,108,248,69,123,0,0
1754,154,290,270,555,17,11,10,116,265,70,123,0,0
1755,168,293,288,567,17,11,10,120,274,71,123,0,0
1756,172,293,295,575,17,11,10,123,282,72,123,0,0
1757,186,303,309,587,17,11,10,123,284,73,123,0,0
1758,189,314,317,608,17,11,10,128,294,74,123,0,0
1759,198,316,324,611,17,11,10,126,295,75,123,0,0
1760,212,324,342,633,17,11,10,130,309,76,123,0,0
1761,243,331,379,647,17,11,10,136,316,77,123,0,0
1762,258,331,396,648,17,11,10,138,317,78,123,0,0
1763,281,339,424,657,17,11,10,143,318,79,123,0,0
1764,296,345,444,665,17,11,10,148,320,80,123,0,0
1765,313,352,464,677,17,11,10,151,325,81,123,0,0
1766,333,356,495,700,17,11,10,162,344,82,123,0,0
1767,359,355,529,709,17,11,10,170,354,83,123,0,0
1768,373,363,547,717,17,11,10,174,354,84,123,0,0
1769,398,373,579,733,17,11,10,181,360,85,123,0,0
1770,420,382,603,744,17,11,10,183,362,86,123,0,0
1771,441,388,632,769,17,11,10,191,381,87,123,0,0
1772,456,398,648,786,17,11,10,192,388,88,123,0,0
1773,481,404,674,801,17,11,10,193,397,89,123,0,0
1774,502,415,697,824,17,11,10,195,409,90,123,0,0
1775,523,425,722,851,17,11,10,199,426,91,123,0,0
1776,557,429,753,863,17,11,10,196,434,92,123,0,0
1777,597,436,795,872,17,11,10,198,436,93,123,0,0
1778,623,448,830,899,17,11,10,207,451,94,123,0,0
1779,662,463,878,913,17,11,10,216,450,95,123,0,0
1780,689,474,915,923,17,11,10,226,449,96,123,0,0
1781,704,486,937,926,17,11,10,233,440,97,123,0,0
1782,700,483,945,934,17,11,10,245,451,98,123,0,0
1783,700,487,943,934,17,11,10,243,447,99,123,0,0
1784,691,485,934,943,17,11,10,243,458,100,123,0,0
1785,683,476,926,950,17,11,10,243,474,101,123,0,0
1786,681,476,920,957,17,11,10,239,481,102,123,0,0
1787,679,476,913,961,17,11,10,234,485,103,123,0,0
1788,680,483,911,975,17,11,10,231,492,104,123,0,0
1789,686,494,921,1006,17,11,10,235,512,105,123,0,0
1790,701,507,935,1023,17,11,10,234,516,106,123,0,0
1791,727,514,957,1028,17,11,10,230,514,107,123,0,0
1792,755,531,986,1056,17,11,10,231,525,108,123,0,0
1793,782,536,1013,1072,17,11,10,231,536,109,123,0,0
1794,803,557,1025,1079,17,11,10,222,522,110,123,0,0
1795,832,574,1045,1077,17,11,10,213,503,111,123,0,0
1796,859,595,1065,1080,17,11,10,206,485,112,123,0,0
1797,913,623,1109,1074,17,11,10,196,451,113,123,0,0
1798,980,644,1173,1080,17,11,10,193,436,114,123,0,0
1799,1042,672,1226,1080,17,11,10,184,408,115,123,0,0
1800,1099,713,1270,1076,17,11,10,171,363,116,123,0,0
1801,1162,747,1325,1075,17,11,10,163,328,117,123,0,0
1802,1233,785,1389,1080,17,11,10,156,295,118,123,0,0
1803,1321,822,1466,1075,17,11,10,145,253,119,123,0,0
1804,1407,852,1542,1072,17,11,10,135,220,120,123,0,0
1805,1482,895,1604,1074,17,11,10,122,179,121,123,0,0
1806,1579,952,1674,1076,17,11,10,95,124,122,123,0,0
1807,1699,998,1766,1078,17,11,10,67,80,123,123,1,0
1680,894,386,963,638,18,11,10,69,252,0,31,0,1
1681,883,385,968,695,18,11,10,85,310,1,31,0,0
1682,862,374,967,755,18,11,10,105,381,2,31,0,0
1683,839,373,954,781,18,11,10,115,408,3,31,0,0
1684,813,371,935,794,18,11,10,122,423,4,31,0,0
1685,778,364,903,791,18,11,10,125,427,5,31,0,0
1686,736,364,863,791,18,11,10,127,427,6,31,0,0
1687,685,364,815,789,18,11,10,130,425,7,31,0,0
1688,664,362,773,718,18,11,10,109,356,8,31,0,0
1689,633,358,732,680,18,11,10,99,322,9,31,0,0
1690,591,352,712,748,18,11,10,121,396,10,31,0,0
1691,561,349,672,707,18,11,10,111,358,11,31,0,0
1692,519,340,640,732,18,11,10,121,392,12,31,0,0
1693,488,337,611,737,18,11,10,123,400,13,31,0,0
1694,462,334,581,716,18,11,10,119,382,14,31,0,0
1695,439,328,559,711,18,11,10,120,383,15,31,0,0
1696,425,322,547,704,18,11,10,122,382,16,31,0,0
1697,408,312,529,682,18,11,10,121,370,17,31,0,0
1698,393,307,514,668,18,11,10,121,361,18,31,0,0
1699,384,303,506,658,18,11,10,122,355,19,31,0,0
1700,389,298,510,645,18,11,10,121,347,20,31,0,0
1701,395,295,515,638,18,11,10,120,343,21,31,0,0
1702,406,293,522,614,18,11,10,116,321,22,31,0,0
1703,394,288,509,606,18,11,10,115,318,23,31,0,0
1704,442,291,553,594,18,11,10,111,303,24,31,0,0
1705,456,280,567,576,18,11,10,111,296,25,31,0,0
1706,486,278,572,495,18,11,10,86,217,26,31,0,0
1707,494,279,598,541,18,11,10,104,262,27,31,0,0
1708,507,280,615,550,18,11,10,108,270,28,31,0,0
1709,524,279,631,550,18,11,10,107,271,29,31,0,0
1710,530,279,632,537,18,11,10,102,258,30,31,0,0
1711,537,277,637,532,18,11,10,100,255,31,31,1,0
1732,550,270,624,469,18,11,10,74,199,0,31,0,1
1733,535,264,607,471,18,11,10,72,207,1,31,0,0
1734,512,268,580,465,18,11,10,68,197,2,31,0,0
1735,489,272,557,468,18,11,10,68,196,3,31,0,0
1736,461,271,524,453,18,11,10,63,182,4,31,0,0
1737,436,268,494,436,18,11,10,58,168,5,31,0,0
1738,407,262,475,465,18,11,10,68,203,6,31,0,0
1739,381,260,454,484,18,11,10,73,224,7,31,0,0
1740,363,259,439,493,18,11,10,76,234,8,31,0,0
1741,348,256,422,483,18,11,10,74,227,9,31,0,0
1742,330,253,406,488,18,11,10,76,235,10,31,0,0
1743,320,254,391,473,18,11,10,71,219,11,31,0,0
1744,304,253,376,473,18,11,10,72,220,12,31,0,0
1745,300,247,370,459,18,11,10,70,212,13,31,0,0
1746,287,249,356,451,18,11,10,69,202,14,31,0,0
1747,273,243,344,451,18,11,10,71,208,15,31,0,0
1748,263,243,333,444,18,11,10,70,201,16,31,0,0
1749,250,237,322,439,18,11,10,72,202,17,31,0,0
1750,242,237,313,430,18,11,10,71,193,18,31,0,0
1751,236,236,307,426,18,11,10,71,190,19,31,0,0
1752,230,231,300,420,18,11,10,70,189,20,31,0,0
1753,229,235,285,382,18,11,10,56,147,21,31,0,0
1754,226,233,274,354,18,11,10,48,121,22,31,0,0
1755,217,231,268,353,18,11,10,51,122,23,31,0,0
1756,208,231,260,348,18,11,10,52,117,24,31,0,0
1757,200,229,248,340,18,11,10,48,111,25,31,0,0
1760,198,227,243,330,18,11,10,45,103,0,31,0,1
1761,190,231,236,331,18,11,10,46,100,1,31,0,0
1762,173,227,235,364,18,11,10,62,137,2,31,0,0
1763,164,228,231,376,18,11,10,67,148,3,31,0,0
1764,160,224,228,375,18,11,10,68,151,4,31,0,0
1765,159,223,223,367,18,11,10,64,144,5,31,0,0
1766,157,222,223,371,18,11,10,66,149,6,31,0,0
1767,158,220,222,366,18,11,10,64,146,7,31,0,0
1768,158,218,222,364,18,11,10,64,146,8,31,0,0
1769,158,217,220,363,18,11,10,62,146,9,31,0,0
1770,157,216,219,362,18,11,10,62,146,10,31,0,0
1771,159,218,218,357,18,11,10,59,139,11,31,0,0
1772,161,215,219,352,18,11,10,58,137,12,31,0,0
1773,161,213,219,350,18,11,10,58,137,13,31,0,0
1774,162,212,220,350,18,11,10,58,138,14,31,0,0
1775,161,211,221,353,18,11,10,60,142,15,31,0,0
1776,161,213,218,348,18,11,10,57,135,16,31,0,0
1777,164,214,220,346,18,11,10,56,132,17,31,0,0
1778,168,216,225,347,18,11,10,57,131,18,31,0,0
1779,178,218,233,344,18,11,10,55,126,19,31,0,0
1780,188,219,240,339,18,11,10,52,120,20,31,0,0
1781,190,218,243,340,18,11,10,53,122,21,31,0,0
1782,195,218,247,340,18,11,10,52,122,22,31,0,0
1783,199,218,252,339,18,11,10,53,121,23,31,0,0
1784,204,216,258,340,18,11,10,54,124,24,31,0,0
1785,210,218,263,339,18,11,10,53,121,25,31,0,0
1786,218,214,273,340,18,11,10,55,126,26,31,0,0
1787,224,220,278,342,18,11,10,54,122,27,31,0,0
1788,231,220,285,341,18,11,10,54,121,28,31,0,0
1789,242,218,294,338,18,11,10,52,120,29,31,0,0
1790,247,218,299,338,18,11,10,52,120,30,31,0,0
1703,438,297,554,466,20,11,10,116,169,0,0,0,0
1731,566,268,630,508,21,11,10,64,240,0,0,0,0
1758,183,227,256,385,22,11,10,73,158,0,1,0,0
1759,174,230,250,395,22,11,10,76,165,1,1,0,0
1793,62,209,98,341,24,11,10,36,132,0,12,0,0
1794,77,210,112,341,24,11,10,35,131,1,12,0,0
1795,90,211,125,338,24,11,10,35,127,2,12,0,0
1796,107,211,142,338,24,11,10,35,127,3,12,0,0
1797,128,209,164,339,24,11,10,36,130,4,12,0,0
1798,143,211,180,339,24,11,10,37,128,5,12,0,0
1799,164,209,202,341,24,11,10,38,132,6,12,0,0
1800,180,209,218,340,24,11,10,38,131,7,12,0,0
1801,200,219,239,340,24,11,10,39,121,8,12,0,0
1802,221,220,258,338,24,11,10,37,118,9,12,0,0
1803,233,226,271,337,24,11,10,38,111,10,12,0,0
1804,250,221,288,335,24,11,10,38,114,11,12,0,0
1805,267,222,304,334,24,11,10,37,112,12,12,0,0
1802,37,272,86,532,25,11,10,49,260,0,39,0,1
1803,49,278,96,526,25,11,10,47,248,1,39,0,0
1804,72,276,119,521,25,11,10,47,245,2,39,0,0
1805,91,275,140,521,25,11,10,49,246,3,39,0,0
1806,113,275,160,503,25,11,10,47,228,4,39,0,0
1807,132,273,181,502,25,11,10,49,229,5,39,0,0
1808,152,271,201,494,25,11,10,49,223,6,39,0,0
1809,168,265,219,490,25,11,10,51,225,7,39,0,0
1810,180,267,230,486,25,11,10,50,219,8,39,0,0
1811,188,265,237,476,25,11,10,49,211,9,39,0,0
1812,194,262,243,466,25,11,10,49,204,10,39,0,0
1813,198,260,249,471,25,11,10,51,211,11,39,0,0
1814,202,255,253,464,25,11,10,51,209,12,39,0,0
1815,203,257,252,457,25,11,10,49,200,13,39,0,0
1816,203,250,251,445,25,11,10,48,195,14,39,0,0
1817,204,248,253,440,25,11,10,49,192,15,39,0,0
1818,204,244,254,435,25,11,10,50,191,16,39,0,0
1819,203,239,253,430,25,11,10,50,191,17,39,0,0
1820,202,240,251,426,25,11,10,49,186,18,39,0,0
1821,201,237,250,420,25,11,10,49,183,19,39,0,0
1822,203,236,250,413,25,11,10,47,177,20,39,0,0
1823,205,239,250,404,25,11,10,45,165,21,39,0,0
1824,205,239,250,402,25,11,10,45,163,22,39,0,0
1825,205,239,249,397,25,11,10,44,158,23,39,0,0
1826,206,240,248,391,25,11,10,42,151,24,39,0,0
1827,206,238,248,384,25,11,10,42,146,25,39,0,0
1828,207,235,249,380,25,11,10,42,145,26,39,0,0
1829,208,234,250,378,25,11,10,42,144,27,39,0,0
1830,209,234,250,373,25,11,10,41,139,28,39,0,0
1831,210,231,251,369,25,11,10,41,138,29,39,0,0
1832,213,231,252,362,25,11,10,39,131,30,39,0,0
1833,214,228,254,363,25,11,10,40,135,31,39,0,0
1834,219,226,259,357,25,11,10,40,131,32,39,0,0
1835,224,227,263,353,25,11,10,39,126,33,39,0,0
1836,229,227,268,354,25,11,10,39,127,34,39,0,0
1837,235,226,274,352,25,11,10,39,126,35,39,0,0
1838,239,224,278,350,25,11,10,39,126,36,39,0,0
1839,245,225,284,348,25,11,10,39,123,37,39,0,0
1840,252,224,290,346,25,11,10,38,122,38,39,0,0
1841,256,223,293,343,25,11,10,37,120,39,39,1,0
1806,31,311,74,532,26,11,10,43,221,0,33,0,1
1807,40,287,85,521,26,11,10,45,234,1,33,0,0
1808,56,275,105,522,26,11,10,49,247,2,33,0,0
1809,74,269,123,512,26,11,10,49,243,3,33,0,0
1810,91,267,140,502,26,11,10,49,235,4,33,0,0
1811,101,262,150,491,26,11,10,49,229,5,33,0,0
1812,114,261,164,493,26,11,10,50,232,6,33,0,0
1813,127,263,177,483,26,11,10,50,220,7,33,0,0
1814,138,260,186,469,26,11,10,48,209,8,33,0,0
1815,144,258,192,460,26,11,10,48,202,9,33,0,0
1816,147,252,197,457,26,11,10,50,205,10,33,0,0
1817,151,251,200,451,26,11,10,49,200,11,33,0,0
1818,152,249,200,442,26,11,10,48,193,12,33,0,0
1819,150,249,198,440,26,11,10,48,191,13,33,0,0
1820,148,244,197,436,26,11,10,49,192,14,33,0,0
1821,147,239,196,426,26,11,10,49,187,15,33,0,0
1822,148,238,194,417,26,11,10,46,179,16,33,0,0
1823,147,238,193,411,26,11,10,46,173,17,33,0,0
1824,147,237,192,406,26,11,10,45,169,18,33,0,0
1825,147,236,191,398,26,11,10,44,162,19,33,0,0
1826,149,237,192,395,26,11,10,43,158,20,33,0,0
1827,152,237,194,391,26,11,10,42,154,21,33,0,0
1828,155,235,196,385,26,11,10,41,150,22,33,0,0
1829,158,235,199,381,26,11,10,41,146,23,33,0,0
1830,161,232,201,374,26,11,10,40,142,24,33,0,0
1831,163,229,203,371,26,11,10,40,142,25,33,0,0
1832,165,227,206,374,26,11,10,41,147,26,33,0,0
1833,170,227,211,372,26,11,10,41,145,27,33,0,0
1834,173,226,214,366,26,11,10,41,140,28,33,0,0
1835,179,227,218,360,26,11,10,39,133,29,33,0,0
1836,186,226,223,352,26,11,10,37,126,30,33,0,0
1837,193,227,230,351,26,11,10,37,124,31,33,0,0
1838,205,224,243,350,26,11,10,38,126,32,33,0,0
1839,213,225,251,349,26,11,10,38,124,33,33,1,0
1841,235,226,272,340,26,11,10,37,114,0,33,0,0
1847,253,215,291,341,27,11,10,38,126,0,27,0,1
1848,250,208,289,336,27,11,10,39,128,1,27,0,0
1849,238,213,275,335,27,11,10,37,122,2,27,0,0
1850,227,213,262,328,27,11,10,35,115,3,27,0,0
1851,219,210,255,329,27,11,10,36,119,4,27,0,0
1852,210,209,247,332,27,11,10,37,123,5,27,0,0
1853,197,209,235,331,27,11,10,38,122,6,27,0,0
1854,189,207,226,327,27,11,10,37,120,7,27,0,0
1855,180,207,218,327,27,11,10,38,120,8,27,0,0
1856,175,206,214,328,27,11,10,39,122,9,27,0,0
1857,169,202,210,327,27,11,10,41,125,10,27,0,0
1858,166,200,206,322,27,11,10,40,122,11,27,0,0
1859,163,200,203,320,27,11,10,40,120,12,27,0,0
1860,160,199,199,317,27,11,10,39,118,13,27,0,0
1861,156,197,195,315,27,11,10,39,118,14,27,0,0
1862,153,197,193,315,27,11,10,40,118,15,27,0,0
1863,154,196,193,310,27,11,10,39,114,16,27,0,0
1864,154,196,192,307,27,11,10,38,111,17,27,0,0
1865,155,196,192,305,27,11,10,37,109,18,27,0,0
1866,155,195,193,305,27,11,10,38,110,19,27,0,0
1867,155,195,192,302,27,11,10,37,107,20,27,0,0
1868,155,194,191,300,27,11,10,36,106,21,27,0,0
1869,155,194,191,299,27,11,10,36,105,22,27,0,0
1870,156,192,192,297,27,11,10,36,105,23,27,0,0
1871,156,191,192,296,27,11,10,36,105,24,27,0,0
1872,157,192,192,294,27,11,10,35,102,25,27,0,0
1873,158,191,193,294,27,11,10,35,103,26,27,0,0
1874,158,190,193,292,27,11,10,35,102,27,27,1,0
1865,1538,926,1684,1078,29,11,10,146,152,0,0,0,0
1867,1309,860,1487,1074,31,11,10,178,214,0,138,0,1
1868,1208,820,1423,1078,31,11,10,215,258,1,138,0,0
1869,1118,792,1350,1070,31,11,10,232,278,2,138,0,0
1870,1012,752,1278,1073,31,11,10,266,321,3,138,0,0
1871,924,698,1231,1071,31,11,10,307,373,4,138,0,0
1872,851,666,1182,1071,31,11,10,331,405,5,138,0,0
1873,775,648,1117,1073,31,11,10,342,425,6,138,0,0
1874,702,620,1063,1074,31,11,10,361,454,7,138,0,0
1875,648,600,1018,1071,31,11,10,370,471,8,138,0,0
1876,611,576,991,1071,31,11,10,380,495,9,138,0,0
1877,587,555,966,1066,31,11,10,379,511,10,138,0,0
1878,534,541,916,1070,31,11,10,382,529,11,138,0,0
1879,500,527,880,1069,31,11,10,380,542,12,138,0,0
1880,463,511,842,1071,31,11,10,379,560,13,138,0,0
1881,428,499,801,1069,31,11,10,373,570,14,138,0,0
1882,402,493,768,1071,31,11,10,366,578,15,138,0,0
1883,387,483,735,1050,31,11,10,348,567,16,138,0,0
1884,384,474,702,1007,31,11,10,318,533,17,138,0,0
1885,361,466,662,981,31,11,10,301,515,18,138,0,0
1886,342,461,630,965,31,11,10,288,504,19,138,0,0
1887,316,446,591,937,31,11,10,275,491,20,138,0,0
1888,291,433,561,928,31,11,10,270,495,21,138,0,0
1889,271,427,536,923,31,11,10,265,496,22,138,0,0
1890,266,416,515,893,31,11,10,249,477,23,138,0,0
1891,264,409,494,862,31,11,10,230,453,24,138,0,0
1892,249,404,469,849,31,11,10,220,445,25,138,0,0
1893,228,399,441,837,31,11,10,213,438,26,138,0,0
1894,194,386,402,825,31,11,10,208,439,27,138,0,0
1895,172,380,379,820,31,11,10,207,440,28,138,0,0
1896,169,375,367,807,31,11,10,198,432,29,138,0,0
1897,163,366,348,780,31,11,10,185,414,30,138,0,0
1898,144,364,321,767,31,11,10,177,403,31,138,0,0
1899,133,364,309,767,31,11,10,176,403,32,138,0,0
1900,103,360,271,755,31,11,10,168,395,33,138,0,0
1901,78,356,242,748,31,11,10,164,392,34,138,0,0
1902,70,355,228,740,31,11,10,158,385,35,138,0,0
1903,68,350,216,719,31,11,10,148,369,36,138,0,0
1904,62,350,201,704,31,11,10,139,354,37,138,0,0
1905,52,347,191,702,31,11,10,139,355,38,138,0,0
1906,38,341,178,699,31,11,10,140,358,39,138,0,0
1907,31,340,169,694,31,11,10,138,354,40,138,0,0
1908,20,336,154,688,31,11,10,134,352,41,138,0,0
1909,14,336,144,689,31,11,10,130,353,42,138,0,0
1910,12,336,138,689,31,11,10,126,353,43,138,0,0
1911,14,339,136,692,31,11,10,122,353,44,138,0,0
1912,17,340,137,695,31,11,10,120,355,45,138,0,0
1913,18,339,135,696,31,11,10,117,357,46,138,0,0
1914,17,340,131,697,31,11,10,114,357,47,138,0,0
1915,18,342,126,695,31,11,10,108,353,48,138,0,0
1916,18,342,123,696,31,11,10,105,354,49,138,0,0
1917,19,343,121,696,31,11,10,102,353,50,138,0,0
1918,21,342,121,695,31,11,10,100,353,51,138,0,0
1919,22,339,120,696,31,11,10,98,357,52,138,0,0
1920,23,338,120,697,31,11,10,97,359,53,138,0,0
1921,24,340,118,695,31,11,10,94,355,54,138,0,0
1922,26,341,118,696,31,11,10,92,355,55,138,0,0
1923,29,340,120,696,31,11,10,91,356,56,138,0,0
1924,31,340,121,696,31,11,10,90,356,57,138,0,0
1925,33,339,122,697,31,11,10,89,358,58,138,0,0
1926,34,341,122,698,31,11,10,88,357,59,138,0,0
1927,37,341,124,698,31,11,10,87,357,60,138,0,0
1928,38,340,125,698,31,11,10,87,358,61,138,0,0
1929,40,341,127,697,31,11,10,87,356,62,138,0,0
1930,39,343,126,698,31,11,10,87,355,63,138,0,0
1931,38,342,124,698,31,11,10,86,356,64,138,0,0
1932,36,341,122,698,31,11,10,86,357,65,138,0,0
1933,33,345,116,698,31,11,10,83,353,66,138,0,0
1934,34,345,116,699,31,11,10,82,354,67,138,0,0
1935,34,342,116,697,31,11,10,82,355,68,138,0,0
1936,36,338,117,696,31,11,10,81,358,69,138,0,0
1937,36,338,117,696,31,11,10,81,358,70,138,0,0
1938,35,343,115,699,31,11,10,80,356,71,138,0,0
1939,36,341,115,697,31,11,10,79,356,72,138,0,0
1940,36,341,114,697,31,11,10,78,356,73,138,0,0
1941,36,346,112,698,31,11,10,76,352,74,138,0,0
1942,35,345,111,698,31,11,10,76,353,75,138,0,0
1943,35,345,111,699,31,11,10,76,354,76,138,0,0
1944,35,343,111,699,31,11,10,76,356,77,138,0,0
1945,35,343,110,698,31,11,10,75,355,78,138,0,0
1946,35,346,109,697,31,11,10,74,351,79,138,0,0
1947,35,343,108,698,31,11,10,73,355,80,138,0,0
1948,34,341,108,699,31,11,10,74,358,81,138,0,0
1949,35,343,108,699,31,11,10,73,356,82,138,0,0
1950,35,339,108,698,31,11,10,73,359,83,138,0,0
1951,35,338,107,696,31,11,10,72,358,84,138,0,0
1952,41,341,114,697,31,11,10,73,356,85,138,0,0
1953,56,344,135,707,31,11,10,79,363,86,138,0,0
1954,62,348,143,708,31,11,10,81,360,87,138,0,0
1955,90,351,172,708,31,11,10,82,357,88,138,0,0
1956,122,354,206,700,31,11,10,84,346,89,138,0,0
1957,140,352,232,707,31,11,10,92,355,90,138,0,0
1958,162,345,259,709,31,11,10,97,364,91,138,0,0
1959,188,343,284,709,31,11,10,96,366,92,138,0,0
1960,219,345,319,716,31,11,10,100,371,93,138,0,0
1961,234,347,338,720,31,11,10,104,373,94,138,0,0
1962,269,349,374,722,31,11,10,105,373,95,138,0,0
1963,306,355,411,721,31,11,10,105,366,96,138,0,0
1964,328,360,439,732,31,11,10,111,372,97,138,0,0
1965,350,359,466,733,31,11,10,116,374,98,138,0,0
1966,384,361,503,748,31,11,10,119,387,99,138,0,0
1967,413,370,535,761,31,11,10,122,391,100,138,0,0
1968,450,377,571,767,31,11,10,121,390,101,138,0,0
1969,497,378,621,768,31,11,10,124,390,102,138,0,0
1970,529,387,660,771,31,11,10,131,384,103,138,0,0
1971,552,392,694,781,31,11,10,142,389,104,138,0,0
1972,578,398,725,776,31,11,10,147,378,105,138,0,0
1973,599,402,747,777,31,11,10,148,375,106,138,0,0
1974,618,405,770,790,31,11,10,152,385,107,138,0,0
1975,630,407,788,800,31,11,10,158,393,108,138,0,0
1976,658,410,822,808,31,11,10,164,398,109,138,0,0
1977,700,414,868,817,31,11,10,168,403,110,138,0,0
1978,726,426,898,821,31,11,10,172,395,111,138,0,0
1979,760,420,933,809,31,11,10,173,389,112,138,0,0
1980,809,420,977,806,31,11,10,168,386,113,138,0,0
1981,831,415,998,798,31,11,10,167,383,114,138,0,0
1982,848,385,1022,788,31,11,10,174,403,115,138,0,0
1983,870,370,1025,728,31,11,10,155,358,116,138,0,0
1984,881,366,1027,703,31,11,10,146,337,117,138,0,0
1985,885,365,1027,695,31,11,10,142,330,118,138,0,0
1986,892,365,1031,695,31,11,10,139,330,119,138,0,0
1987,896,367,1031,689,31,11,10,135,322,120,138,0,0
1988,893,366,1027,688,31,11,10,134,322,121,138,0,0
1989,884,364,1020,687,31,11,10,136,323,122,138,0,0
1990,882,365,1018,689,31,11,10,136,324,123,138,0,0
1991,881,367,1018,692,31,11,10,137,325,124,138,0,0
1992,878,365,1016,692,31,11,10,138,327,125,138,0,0
1993,871,364,1008,693,31,11,10,137,329,126,138,0,0
1994,864,364,999,695,31,11,10,135,331,127,138,0,0
1995,863,367,993,695,31,11,10,130,328,128,138,0,0
1996,865,368,991,695,31,11,10,126,327,129,138,0,0
1997,866,368,989,697,31,11,10,123,329,130,138,0,0
1998,868,367,989,696,31,11,10,121,329,131,138,0,0
1999,871,367,989,694,31,11,10,118,327,132,138,0,0
2000,874,369,989,693,31,11,10,115,324,133,138,0,0
2001,874,374,986,693,31,11,10,112,319,134,138,0,0
2002,874,372,983,694,31,11,10,109,322,135,138,0,0
2003,871,369,979,701,31,11,10,108,332,136,138,0,0
2004,864,369,970,708,31,11,10,106,339,137,138,0,0
2005,864,369,970,708,31,11,10,106,339,138,138,1,0
1966,895,371,985,680,32,11,10,90,309,0,16,0,0
1967,886,365,981,691,32,11,10,95,326,1,16,0,0
1968,887,368,981,687,32,11,10,94,319,2,16,0,0
1969,886,365,985,698,32,11,10,99,333,3,16,0,0
1970,887,365,987,695,32,11,10,100,330,4,16,0,0
1971,894,365,996,694,32,11,10,102,329,5,16,0,0
1972,893,364,997,693,32,11,10,104,329,6,16,0,0
1973,892,364,998,694,32,11,10,106,330,7,16,0,0
1974,883,363,993,695,32,11,10,110,332,8,16,0,0
1975,886,367,997,691,32,11,10,111,324,9,16,0,0
1976,889,365,1003,696,32,11,10,114,331,10,16,0,0
1977,894,367,1008,696,32,11,10,114,329,11,16,0,0
1978,897,367,1011,697,32,11,10,114,330,12,16,0,0
1979,914,369,1011,650,32,11,10,97,281,13,16,0,0
1980,927,366,1016,622,32,11,10,89,256,14,16,0,0
1981,944,364,1006,537,32,11,10,62,173,15,16,0,0
1982,951,364,1006,517,32,11,10,55,153,16,16,0,0
1986,854,388,947,681,33,11,10,93,293,0,3,0,0
1987,854,395,946,687,33,11,10,92,292,1,3,0,0
1988,849,386,942,681,33,11,10,93,295,2,3,0,0
1989,846,383,940,679,33,11,10,94,296,3,3,0,0
1995,840,373,930,669,33,11,10,90,296,0,3,0,0
1996,838,371,929,667,33,11,10,91,296,1,3,0,0
2086,222,228,257,333,35,11,10,35,105,0,0,0,0
2122,228,214,270,336,37,11,10,42,122,0,16,0,0
2123,216,216,255,328,37,11,10,39,112,1,16,0,0
2124,205,216,244,328,37,11,10,39,112,2,16,0,0
2125,187,213,228,329,37,11,10,41,116,3,16,0,0
2126,180,214,222,329,37,11,10,42,115,4,16,0,0
2127,171,208,213,323,37,11,10,42,115,5,16,0,0
2128,164,205,207,324,37,11,10,43,119,6,16,0,0
2129,158,204,201,323,37,11,10,43,119,7,16,0,0
2130,152,204,193,320,37,11,10,41,116,8,16,0,0
2131,147,203,187,317,37,11,10,40,114,9,16,0,0
2132,143,199,183,313,37,11,10,40,114,10,16,0,0
2133,137,197,177,311,37,11,10,40,114,11,16,0,0
2134,131,194,171,309,37,11,10,40,115,12,16,0,0
2135,128,191,168,307,37,11,10,40,116,13,16,0,0
2136,127,191,165,305,37,11,10,38,114,14,16,0,0
2137,125,193,162,303,37,11,10,37,110,15,16,0,0
2138,123,193,159,300,37,11,10,36,107,16,16,0,0
2198,61,218,101,356,38,11,10,40,138,0,56,0,1
2199,73,218,113,356,38,11,10,40,138,1,56,0,0
2200,82,220,122,358,38,11,10,40,138,2,56,0,0
2201,94,218,136,360,38,11,10,42,142,3,56,0,0
2202,106,224,147,362,38,11,10,41,138,4,56,0,0
2203,112,221,154,358,38,11,10,42,137,5,56,0,0
2204,117,221,161,364,38,11,10,44,143,6,56,0,0
2205,123,221,169,370,38,11,10,46,149,7,56,0,0
2206,130,219,179,374,38,11,10,49,155,8,56,0,0
2207,135,219,186,377,38,11,10,51,158,9,56,0,0
2208,139,220,190,376,38,11,10,51,156,10,56,0,0
2209,139,220,194,382,38,11,10,55,162,11,56,0,0
2210,143,225,199,391,38,11,10,56,166,12,56,0,0
2211,150,226,207,394,38,11,10,57,168,13,56,0,0
2212,156,227,215,400,38,11,10,59,173,14,56,0,0
2213,158,227,218,400,38,11,10,60,173,15,56,0,0
2214,158,227,220,408,38,11,10,62,181,16,56,0,0
2215,160,229,225,416,38,11,10,65,187,17,56,0,0
2216,165,229,229,413,38,11,10,64,184,18,56,0,0
2217,170,231,238,426,38,11,10,68,195,19,56,0,0
2218,174,232,243,435,38,11,10,69,203,20,56,0,0
2219,176,233,247,440,38,11,10,71,207,21,56,0,0
2220,180,232,252,444,38,11,10,72,212,22,56,0,0
2221,186,234,258,447,38,11,10,72,213,23,56,0,0
2222,195,235,270,455,38,11,10,75,220,24,56,0,0
2223,202,242,278,463,38,11,10,76,221,25,56,0,0
2224,206,243,284,468,38,11,10,78,225,26,56,0,0
2225,212,248,291,475,38,11,10,79,227,27,56,0,0
2226,220,249,301,481,38,11,10,81,232,28,56,0,0
2227,233,249,317,488,38,11,10,84,239,29,56,0,0
2228,242,253,328,497,38,11,10,86,244,30,56,0,0
2229,250,253,337,501,38,11,10,87,248,31,56,0,0
2230,259,257,350,514,38,11,10,91,257,32,56,0,0
2231,269,260,363,524,38,11,10,94,264,33,56,0,0
2232,281,259,377,531,38,11,10,96,272,34,56,0,0
2233,291,266,391,547,38,11,10,100,281,35,56,0,0
2234,302,269,404,555,38,11,10,102,286,36,56,0,0
2235,310,272,416,566,38,11,10,106,294,37,56,0,0
2236,323,277,432,583,38,11,10,109,306,38,56,0,0
2237,338,276,449,591,38,11,10,111,315,39,56,0,0
2238,357,284,471,606,38,11,10,114,322,40,56,0,0
2239,369,289,487,622,38,11,10,118,333,41,56,0,0
2240,376,290,497,633,38,11,10,121,343,42,56,0,0
2241,388,296,513,654,38,11,10,125,358,43,56,0,0
2242,398,298,527,666,38,11,10,129,368,44,56,0,0
2243,397,301,530,673,38,11,10,133,372,45,56,0,0
2244,383,309,515,678,38,11,10,132,369,46,56,0,0
2245,352,305,484,683,38,11,10,132,378,47,56,0,0
2246,303,310,441,694,38,11,10,138,384,48,56,0,0
2247,273,312,413,697,38,11,10,140,385,49,56,0,0
2248,212,304,354,697,38,11,10,142,393,50,56,0,0
2249,162,308,305,692,38,11,10,143,384,51,56,0,0
2250,118,310,256,680,38,11,10,138,370,52,56,0,0
2251,79,308,213,675,38,11,10,134,367,53,56,0,0
2252,49,307,183,672,38,11,10,134,365,54,56,0,0
2253,12,307,138,666,38,11,10,126,359,55,56,0,0
2254,0,308,116,668,38,11,10,116,360,56,56,1,0
2288,248,221,288,350,39,11,10,40,129,0,11,0,0
2289,241,221,280,346,39,11,10,39,125,1,11,0,0
2290,219,222,258,349,39,11,10,39,127,2,11,0,0
2291,201,222,240,347,39,11,10,39,125,3,11,0,0
2292,178,216,220,350,39,11,10,42,134,4,11,0,0
2293,161,217,202,348,39,11,10,41,131,5,11,0,0
2294,138,217,179,349,39,11,10,41,132,6,11,0,0
2295,114,220,156,351,39,11,10,42,131,7,11,0,0
2296,96,220,137,351,39,11,10,41,131,8,11,0,0
2297,76,217,116,346,39,11,10,40,129,9,11,0,0
2298,60,220,102,356,39,11,10,42,136,10,11,0,0
2299,41,220,84,357,39,11,10,43,137,11,11,0,0
2304,249,210,291,354,40,11,10,42,144,0,162,0,1
2305,247,212,287,349,40,11,10,40,137,1,162,0,0
2306,241,212,283,353,40,11,10,42,141,2,162,0,0
2307,236,213,277,356,40,11,10,41,143,3,162,0,0
2308,231,214,272,352,40,11,10,41,138,4,162,0,0
2309,226,216,268,356,40,11,10,42,140,5,162,0,0
2310,221,217,265,363,40,11,10,44,146,6,162,0,0
2311,216,219,259,362,40,11,10,43,143,7,162,0,0
2312,213,219,257,365,40,11,10,44,146,8,162,0,0
2313,210,222,256,369,40,11,10,46,147,9,162,0,0
2314,209,221,256,371,40,11,10,47,150,10,162,0,0
2315,208,220,258,380,40,11,10,50,160,11,162,0,0
2316,208,220,259,383,40,11,10,51,163,12,162,0,0
2317,210,222,260,382,40,11,10,50,160,13,162,0,0
2318,210,225,260,388,40,11,10,50,163,14,162,0,0
2319,211,228,261,392,40,11,10,50,164,15,162,0,0
2320,215,227,267,395,40,11,10,52,168,16,162,0,0
2321,221,226,277,402,40,11,10,56,176,17,162,0,0
2322,223,228,280,404,40,11,10,57,176,18,162,0,0
2323,223,229,281,406,40,11,10,58,177,19,162,0,0
2324,222,232,282,415,40,11,10,60,183,20,162,0,0
2325,224,233,284,419,40,11,10,60,186,21,162,0,0
2326,233,232,294,422,40,11,10,61,190,22,162,0,0
2327,243,232,306,427,40,11,10,63,195,23,162,0,0
2328,249,233,314,431,40,11,10,65,198,24,162,0,0
2329,248,233,314,436,40,11,10,66,203,25,162,0,0
2330,251,234,318,443,40,11,10,67,209,26,162,0,0
2331,259,237,325,445,40,11,10,66,208,27,162,0,0
2332,270,237,337,448,40,11,10,67,211,28,162,0,0
2333,282,236,351,452,40,11,10,69,216,29,162,0,0
2334,286,239,352,447,40,11,10,66,208,30,162,0,0
2335,289,240,354,445,40,11,10,65,205,31,162,0,0
2336,294,243,362,463,40,11,10,68,220,32,162,0,0
2337,301,241,371,471,40,11,10,70,230,33,162,0,0
2338,314,245,380,461,40,11,10,66,216,34,162,0,0
2339,326,252,393,476,40,11,10,67,224,35,162,0,0
2340,338,253,406,483,40,11,10,68,230,36,162,0,0
2341,351,254,419,488,40,11,10,68,234,37,162,0,0
2342,364,257,434,493,40,11,10,70,236,38,162,0,0
2343,374,257,447,498,40,11,10,73,241,39,162,0,0
2344,384,256,455,495,40,11,10,71,239,40,162,0,0
2345,390,255,462,499,40,11,10,72,244,41,162,0,0
2346,395,256,467,501,40,11,10,72,245,42,162,0,0
2347,400,256,471,501,40,11,10,71,245,43,162,0,0
2348,401,255,473,504,40,11,10,72,249,44,162,0,0
2349,404,254,474,500,40,11,10,70,246,45,162,0,0
2350,403,255,472,497,40,11,10,69,242,46,162,0,0
2351,402,256,470,497,40,11,10,68,241,47,162,0,0
2352,404,256,473,502,40,11,10,69,246,48,162,0,0
2353,403,259,470,498,40,11,10,67,239,49,162,0,0
2354,402,259,469,501,40,11,10,67,242,50,162,0,0
2355,400,258,468,505,40,11,10,68,247,51,162,0,0
2356,401,259,466,500,40,11,10,65,241,52,162,0,0
2357,401,258,467,501,40,11,10,66,243,53,162,0,0
2358,401,257,467,502,40,11,10,66,245,54,162,0,0
2359,401,259,465,498,40,11,10,64,239,55,162,0,0
2360,401,260,464,497,40,11,10,63,237,56,162,0,0
2361,400,258,464,499,40,11,10,64,241,57,162,0,0
2362,400,258,464,500,40,11,10,64,242,58,162,0,0
2363,400,257,464,502,40,11,10,64,245,59,162,0,0
2364,400,257,464,501,40,11,10,64,244,60,162,0,0
2365,400,257,464,500,40,11,10,64,243,61,162,0,0
2366,400,256,464,502,40,11,10,64,246,62,162,0,0
2367,400,256,464,503,40,11,10,64,247,63,162,0,0
2368,400,256,464,504,40,11,10,64,248,64,162,0,0
2369,400,255,463,504,40,11,10,63,249,65,162,0,0
2370,400,256,463,504,40,11,10,63,248,66,162,0,0
2371,399,256,462,505,40,11,10,63,249,67,162,0,0
2372,399,256,462,504,40,11,10,63,248,68,162,0,0
2373,399,257,461,504,40,11,10,62,247,69,162,0,0
2374,399,256,461,503,40,11,10,62,247,70,162,0,0
2375,399,256,461,503,40,11,10,62,247,71,162,0,0
2376,399,257,461,504,40,11,10,62,247,72,162,0,0
2377,400,257,462,504,40,11,10,62,247,73,162,0,0
2378,400,257,461,504,40,11,10,61,247,74,162,0,0
2379,400,257,461,504,40,11,10,61,247,75,162,0,0
2380,400,257,461,504,40,11,10,61,247,76,162,0,0
2381,400,257,461,503,40,11,10,61,246,77,162,0,0
2382,400,257,462,502,40,11,10,62,245,78,162,0,0
2383,400,258,462,502,40,11,10,62,244,79,162,0,0
2384,401,257,463,502,40,11,10,62,245,80,162,0,0
2385,400,257,463,503,40,11,10,63,246,81,162,0,0
2386,400,257,462,503,40,11,10,62,246,82,162,0,0
2387,400,257,462,504,40,11,10,62,247,83,162,0,0
2388,399,256,461,504,40,11,10,62,248,84,162,0,0
2389,399,256,461,504,40,11,10,62,248,85,162,0,0
2390,398,256,460,504,40,11,10,62,248,86,162,0,0
2391,398,255,459,502,40,11,10,61,247,87,162,0,0
2392,399,258,459,500,40,11,10,60,242,88,162,0,0
2393,398,258,459,502,40,11,10,61,244,89,162,0,0
2394,399,257,460,500,40,11,10,61,243,90,162,0,0
2395,399,257,460,502,40,11,10,61,245,91,162,0,0
2396,400,256,461,500,40,11,10,61,244,92,162,0,0
2397,399,256,460,502,40,11,10,61,246,93,162,0,0
2398,398,256,460,504,40,11,10,62,248,94,162,0,0
2399,398,255,460,504,40,11,10,62,249,95,162,0,0
2400,400,256,461,501,40,11,10,61,245,96,162,0,0
2401,399,256,460,503,40,11,10,61,247,97,162,0,0
2402,399,256,461,504,40,11,10,62,248,98,162,0,0
2403,399,257,461,504,40,11,10,62,247,99,162,0,0
2404,399,256,461,503,40,11,10,62,247,100,162,0,0
2405,399,257,461,504,40,11,10,62,247,101,162,0,0
2406,399,257,460,504,40,11,10,61,247,102,162,0,0
2407,400,256,461,501,40,11,10,61,245,103,162,0,0
2408,400,255,461,500,40,11,10,61,245,104,162,0,0
2409,399,255,461,500,40,11,10,62,245,105,162,0,0
2410,399,254,461,502,40,11,10,62,248,106,162,0,0
2411,399,254,462,502,40,11,10,63,248,107,162,0,0
2412,399,254,461,504,40,11,10,62,250,108,162,0,0
2413,400,254,462,503,40,11,10,62,249,109,162,0,0
2414,399,255,461,504,40,11,10,62,249,110,162,0,0
2415,399,255,461,505,40,11,10,62,250,111,162,0,0
2416,399,255,461,503,40,11,10,62,248,112,162,0,0
2417,399,255,461,505,40,11,10,62,250,113,162,0,0
2418,401,255,462,502,40,11,10,61,247,114,162,0,0
2419,401,255,462,500,40,11,10,61,245,115,162,0,0
2420,401,256,463,502,40,11,10,62,246,116,162,0,0
2421,401,258,462,502,40,11,10,61,244,117,162,0,0
2422,401,258,462,502,40,11,10,61,244,118,162,0,0
2423,401,259,462,501,40,11,10,61,242,119,162,0,0
2424,400,255,462,503,40,11,10,62,248,120,162,0,0
2425,400,256,462,503,40,11,10,62,247,121,162,0,0
2426,400,258,461,502,40,11,10,61,244,122,162,0,0
2427,400,258,461,502,40,11,10,61,244,123,162,0,0
2428,400,257,462,502,40,11,10,62,245,124,162,0,0
2429,400,257,462,502,40,11,10,62,245,125,162,0,0
2430,401,257,462,501,40,11,10,61,244,126,162,0,0
2431,402,258,462,500,40,11,10,60,242,127,162,0,0
2432,401,258,461,502,40,11,10,60,244,128,162,0,0
2433,402,259,462,500,40,11,10,60,241,129,162,0,0
2434,401,259,461,497,40,11,10,60,238,130,162,0,0
2435,400,257,461,501,40,11,10,61,244,131,162,0,0
2436,401,259,461,498,40,11,10,60,239,132,162,0,0
2437,401,260,461,498,40,11,10,60,238,133,162,0,0
2438,401,260,460,497,40,11,10,59,237,134,162,0,0
2439,401,261,460,496,40,11,10,59,235,135,162,0,0
2440,402,261,460,496,40,11,10,58,235,136,162,0,0
2441,401,260,461,499,40,11,10,60,239,137,162,0,0
2442,401,260,461,500,40,11,10,60,240,138,162,0,0
2443,401,259,461,500,40,11,10,60,241,139,162,0,0
2444,401,259,462,500,40,11,10,61,241,140,162,0,0
2445,401,258,462,501,40,11,10,61,243,141,162,0,0
2446,401,258,461,501,40,11,10,60,243,142,162,0,0
2447,399,257,460,503,40,11,10,61,246,143,162,0,0
2448,399,258,459,503,40,11,10,60,245,144,162,0,0
2449,398,257,458,503,40,11,10,60,246,145,162,0,0
2450,398,256,458,501,40,11,10,60,245,146,162,0,0
2451,398,256,458,499,40,11,10,60,243,147,162,0,0
2452,398,257,457,496,40,11,10,59,239,148,162,0,0
2453,398,258,457,497,40,11,10,59,239,149,162,0,0
2454,397,257,457,500,40,11,10,60,243,150,162,0,0
2455,399,258,459,500,40,11,10,60,242,151,162,0,0
2456,404,259,463,494,40,11,10,59,235,152,162,0,0
2457,413,264,469,492,40,11,10,56,228,153,162,0,0
2458,420,266,481,498,40,11,10,61,232,154,162,0,0
2459,431,275,493,504,40,11,10,62,229,155,162,0,0
2460,454,270,520,499,40,11,10,66,229,156,162,0,0
2461,475,259,546,501,40,11,10,71,242,157,162,0,0
2462,486,263,561,507,40,11,10,75,244,158,162,0,0
2463,505,261,584,510,40,11,10,79,249,159,162,0,0
2464,538,261,620,516,40,11,10,82,255,160,162,0,0
2465,553,268,633,519,40,11,10,80,251,161,162,0,0
2466,565,269,646,521,40,11,10,81,252,162,162,1,0
2752,879,392,964,690,41,11,10,85,298,0,31,0,1
2753,849,393,951,749,41,11,10,102,356,1,31,0,0
2754,816,390,920,754,41,11,10,104,364,2,31,0,0
2755,769,379,882,775,41,11,10,113,396,3,31,0,0
2756,711,376,827,772,41,11,10,116,396,4,31,0,0
2757,682,372,798,761,41,11,10,116,389,5,31,0,0
2758,643,362,759,752,41,11,10,116,390,6,31,0,0
2759,597,359,713,747,41,11,10,116,388,7,31,0,0
2760,564,354,674,718,41,11,10,110,364,8,31,0,0
2761,520,348,629,702,41,11,10,109,354,9,31,0,0
2762,496,339,607,692,41,11,10,111,353,10,31,0,0
2763,475,332,583,674,41,11,10,108,342,11,31,0,0
2764,457,332,563,663,41,11,10,106,331,12,31,0,0
2765,436,322,541,649,41,11,10,105,327,13,31,0,0
2766,417,309,520,629,41,11,10,103,320,14,31,0,0
2767,403,302,505,616,41,11,10,102,314,15,31,0,0
2768,383,296,482,597,41,11,10,99,301,16,31,0,0
2769,368,294,465,588,41,11,10,97,294,17,31,0,0
2770,347,294,442,578,41,11,10,95,284,18,31,0,0
2771,327,288,418,562,41,11,10,91,274,19,31,0,0
2772,302,287,394,555,41,11,10,92,268,20,31,0,0
2773,278,284,367,547,41,11,10,89,263,21,31,0,0
2774,247,277,335,539,41,11,10,88,262,22,31,0,0
2775,226,280,314,538,41,11,10,88,258,23,31,0,0
2776,196,272,279,521,41,11,10,83,249,24,31,0,0
2777,163,273,249,523,41,11,10,86,250,25,31,0,0
2778,136,269,222,520,41,11,10,86,251,26,31,0,0
2779,99,275,179,514,41,11,10,80,239,27,31,0,0
2780,66,277,151,521,41,11,10,85,244,28,31,0,0
2781,31,273,115,521,41,11,10,84,248,29,31,0,0
2782,15,299,90,526,41,11,10,75,227,30,31,0,0
2783,0,300,61,523,41,11,10,61,223,31,31,1,0
2820,197,441,805,1071,43,11,10,608,630,0,22,0,1
2821,173,419,746,1040,43,11,10,573,621,1,22,0,0
2822,163,403,703,1015,43,11,10,540,612,2,22,0,0
2823,169,393,665,980,43,11,10,496,587,3,22,0,0
2824,170,375,618,926,43,11,10,448,551,4,22,0,0
2825,149,367,566,904,43,11,10,417,537,5,22,0,0
2826,138,363,508,864,43,11,10,370,501,6,22,0,0
2827,139,347,481,832,43,11,10,342,485,7,22,0,0
2828,137,343,458,816,43,11,10,321,473,8,22,0,0
2829,142,329,436,777,43,11,10,294,448,9,22,0,0
2830,125,330,397,763,43,11,10,272,433,10,22,0,0
2831,116,328,367,746,43,11,10,251,418,11,22,0,0
2832,93,319,329,728,43,11,10,236,409,12,22,0,0
2833,78,316,301,721,43,11,10,223,405,13,22,0,0
2834,70,318,276,705,43,11,10,206,387,14,22,0,0
2835,53,311,249,694,43,11,10,196,383,15,22,0,0
2836,45,307,226,679,43,11,10,181,372,16,22,0,0
2837,30,306,203,679,43,11,10,173,373,17,22,0,0
2838,20,301,178,652,43,11,10,158,351,18,22,0,0
2839,13,301,166,652,43,11,10,153,351,19,22,0,0
2840,5,298,146,632,43,11,10,141,334,20,22,0,0
2841,0,295,127,620,43,11,10,127,325,21,22,0,0
2842,0,289,106,606,43,11,10,106,317,22,22,1,0
2869,250,221,292,340,44,11,10,42,119,0,18,0,0
2870,246,224,286,338,44,11,10,40,114,1,18,0,0
2871,233,224,274,338,44,11,10,41,114,2,18,0,0
2872,219,226,259,338,44,11,10,40,112,3,18,0,0
2873,208,223,249,338,44,11,10,41,115,4,18,0,0
2874,195,225,236,336,44,11,10,41,111,5,18,0,0
2875,187,222,227,333,44,11,10,40,111,6,18,0,0
2876,178,218,218,331,44,11,10,40,113,7,18,0,0
2877,169,216,210,329,44,11,10,41,113,8,18,0,0
2878,163,214,204,328,44,11,10,41,114,9,18,0,0
2879,156,213,197,328,44,11,10,41,115,10,18,0,0
2880,151,213,192,327,44,11,10,41,114,11,18,0,0
2881,148,213,187,324,44,11,10,39,111,12,18,0,0
2882,144,212,182,321,44,11,10,38,109,13,18,0,0
2883,139,209,176,317,44,11,10,37,108,14,18,0,0
2884,135,208,172,316,44,11,10,37,108,15,18,0,0
2885,134,207,170,316,44,11,10,36,109,16,18,0,0
2886,133,206,169,313,44,11,10,36,107,17,18,0,0
2887,133,204,168,311,44,11,10,35,107,18,18,0,0
2889,131,200,166,307,44,11,10,35,107,0,18,0,0
2891,130,195,165,303,44,11,10,35,108,0,18,0,0
3089,27,320,124,646,45,11,10,97,326,0,80,0,1
3090,16,320,116,657,45,11,10,100,337,1,80,0,0
3091,42,322,147,673,45,11,10,105,351,2,80,0,0
3092,64,330,168,675,45,11,10,104,345,3,80,0,0
3093,101,334,209,687,45,11,10,108,353,4,80,0,0
3094,117,341,236,712,45,11,10,119,371,5,80,0,0
3095,127,345,250,725,45,11,10,123,380,6,80,0,0
3096,133,353,264,754,45,11,10,131,401,7,80,0,0
3097,140,360,275,775,45,11,10,135,415,8,80,0,0
3098,153,362,298,795,45,11,10,145,433,9,80,0,0
3099,119,371,275,818,45,11,10,156,447,10,80,0,0
3100,94,381,254,829,45,11,10,160,448,11,80,0,0
3101,81,380,253,862,45,11,10,172,482,12,80,0,0
3102,93,391,263,880,45,11,10,170,489,13,80,0,0
3103,79,390,252,885,45,11,10,173,495,14,80,0,0
3104,66,390,246,891,45,11,10,180,501,15,80,0,0
3105,64,400,246,893,45,11,10,182,493,16,80,0,0
3106,70,396,252,886,45,11,10,182,490,17,80,0,0
3107,101,357,292,882,45,11,10,191,525,18,80,0,0
3108,113,385,287,876,45,11,10,174,491,19,80,0,0
3109,115,407,282,886,45,11,10,167,479,20,80,0,0
3110,118,403,282,886,45,11,10,164,483,21,80,0,0
3111,118,403,280,890,45,11,10,162,487,22,80,0,0
3112,119,401,279,888,45,11,10,160,487,23,80,0,0
3113,123,398,283,889,45,11,10,160,491,24,80,0,0
3114,136,396,293,888,45,11,10,157,492,25,80,0,0
3115,139,401,293,887,45,11,10,154,486,26,80,0,0
3116,141,403,293,883,45,11,10,152,480,27,80,0,0
3117,140,402,292,883,45,11,10,152,481,28,80,0,0
3118,139,405,289,881,45,11,10,150,476,29,80,0,0
3119,139,405,288,880,45,11,10,149,475,30,80,0,0
3120,138,405,288,880,45,11,10,150,475,31,80,0,0
3121,137,407,287,884,45,11,10,150,477,32,80,0,0
3122,137,407,288,884,45,11,10,151,477,33,80,0,0
3123,136,406,288,884,45,11,10,152,478,34,80,0,0
3124,135,407,287,883,45,11,10,152,476,35,80,0,0
3125,137,402,290,880,45,11,10,153,478,36,80,0,0
3126,136,403,290,881,45,11,10,154,478,37,80,0,0
3127,135,402,289,883,45,11,10,154,481,38,80,0,0
3128,132,406,286,884,45,11,10,154,478,39,80,0,0
3129,132,401,287,882,45,11,10,155,481,40,80,0,0
3130,131,398,288,882,45,11,10,157,484,41,80,0,0
3131,132,398,289,882,45,11,10,157,484,42,80,0,0
3132,132,397,289,882,45,11,10,157,485,43,80,0,0
3133,132,399,289,882,45,11,10,157,483,44,80,0,0
3134,133,399,289,882,45,11,10,156,483,45,80,0,0
3135,133,399,290,882,45,11,10,157,483,46,80,0,0
3136,131,400,287,883,45,11,10,156,483,47,80,0,0
3137,130,394,287,884,45,11,10,157,490,48,80,0,0
3138,130,395,286,883,45,11,10,156,488,49,80,0,0
3139,130,396,285,891,45,11,10,155,495,50,80,0,0
3140,128,396,283,898,45,11,10,155,502,51,80,0,0
3141,126,400,277,897,45,11,10,151,497,52,80,0,0
3142,119,400,269,899,45,11,10,150,499,53,80,0,0
3143,115,404,262,898,45,11,10,147,494,54,80,0,0
3144,113,401,259,897,45,11,10,146,496,55,80,0,0
3145,111,400,257,895,45,11,10,146,495,56,80,0,0
3146,109,400,254,897,45,11,10,145,497,57,80,0,0
3147,112,402,254,892,45,11,10,142,490,58,80,0,0
3148,111,400,253,896,45,11,10,142,496,59,80,0,0
3149,113,398,255,893,45,11,10,142,495,60,80,0,0
3150,116,404,257,896,45,11,10,141,492,61,80,0,0
3151,118,404,258,894,45,11,10,140,490,62,80,0,0
3152,120,404,258,892,45,11,10,138,488,63,80,0,0
3153,121,404,259,892,45,11,10,138,488,64,80,0,0
3154,121,404,259,892,45,11,10,138,488,65,80,0,0
3155,121,405,259,893,45,11,10,138,488,66,80,0,0
3156,123,405,260,890,45,11,10,137,485,67,80,0,0
3157,123,406,260,891,45,11,10,137,485,68,80,0,0
3158,123,406,260,891,45,11,10,137,485,69,80,0,0
3159,117,405,255,895,45,11,10,138,490,70,80,0,0
3160,110,407,248,894,45,11,10,138,487,71,80,0,0
3161,99,402,238,897,45,11,10,139,495,72,80,0,0
3162,97,394,230,865,45,11,10,133,471,73,80,0,0
3163,99,387,230,849,45,11,10,131,462,74,80,0,0
3164,98,376,222,817,45,11,10,124,441,75,80,0,0
3165,102,363,221,785,45,11,10,119,422,76,80,0,0
3166,120,354,237,768,45,11,10,117,414,77,80,0,0
3167,147,351,241,678,45,11,10,94,327,78,80,0,0
3168,159,344,247,645,45,11,10,88,301,79,80,0,0
3169,165,339,248,621,45,11,10,83,282,80,80,1,0
3100,35,297,103,544,46,11,10,68,247,0,4,0,0
3101,46,303,130,604,46,11,10,84,301,1,4,0,0
3102,58,309,146,623,46,11,10,88,314,2,4,0,0
3103,76,315,156,592,46,11,10,80,277,3,4,0,0
3104,86,319,165,595,46,11,10,79,276,4,4,0,0
3104,112,309,207,476,47,11,10,95,167,0,611,0,0
3105,122,322,256,558,47,11,10,134,236,1,611,0,0
3106,117,326,313,676,47,11,10,196,350,2,611,0,0
3107,117,329,340,727,47,11,10,223,398,3,611,0,0
3109,152,333,393,772,47,11,10,241,439,0,611,0,1
3110,172,344,405,777,47,11,10,233,433,1,611,0,0
3111,183,346,419,796,47,11,10,236,450,2,611,0,0
3112,190,355,424,809,47,11,10,234,454,3,611,0,0
3113,190,358,424,823,47,11,10,234,465,4,611,0,0
3114,183,358,419,842,47,11,10,236,484,5,611,0,0
3115,187,362,415,845,47,11,10,228,483,6,611,0,0
3116,188,365,412,851,47,11,10,224,486,7,611,0,0
3117,188,369,408,853,47,11,10,220,484,8,611,0,0
3118,191,375,401,849,47,11,10,210,474,9,611,0,0
3119,192,375,398,849,47,11,10,206,474,10,611,0,0
3120,196,379,394,840,47,11,10,198,461,11,611,0,0
3121,197,374,391,836,47,11,10,194,462,12,611,0,0
3122,199,379,385,824,47,11,10,186,445,13,611,0,0
3123,199,379,383,824,47,11,10,184,445,14,611,0,0
3124,199,379,382,827,47,11,10,183,448,15,611,0,0
3125,205,379,380,815,47,11,10,175,436,16,611,0,0
3126,202,380,379,826,47,11,10,177,446,17,611,0,0
3127,205,380,378,820,47,11,10,173,440,18,611,0,0
3128,200,372,379,833,47,11,10,179,461,19,611,0,0
3129,201,369,379,833,47,11,10,178,464,20,611,0,0
3130,202,367,379,834,47,11,10,177,467,21,611,0,0
3131,203,366,378,832,47,11,10,175,466,22,611,0,0
3132,204,365,377,829,47,11,10,173,464,23,611,0,0
3133,204,365,376,831,47,11,10,172,466,24,611,0,0
3134,202,360,375,835,47,11,10,173,475,25,611,0,0
3135,202,358,375,835,47,11,10,173,477,26,611,0,0
3136,202,359,374,841,47,11,10,172,482,27,611,0,0
3137,202,359,373,843,47,11,10,171,484,28,611,0,0
3138,207,362,371,833,47,11,10,164,471,29,611,0,0
3139,206,361,370,837,47,11,10,164,476,30,611,0,0
3140,208,363,369,836,47,11,10,161,473,31,611,0,0
3141,209,363,368,832,47,11,10,159,469,32,611,0,0
3142,210,362,367,827,47,11,10,157,465,33,611,0,0
3143,208,362,363,820,47,11,10,155,458,34,611,0,0
3144,206,361,361,818,47,11,10,155,457,35,611,0,0
3145,206,361,361,816,47,11,10,155,455,36,611,0,0
3146,205,361,361,814,47,11,10,156,453,37,611,0,0
3147,205,361,361,813,47,11,10,156,452,38,611,0,0
3148,204,361,362,813,47,11,10,158,452,39,611,0,0
3149,204,360,362,814,47,11,10,158,454,40,611,0,0
3150,204,361,363,813,47,11,10,159,452,41,611,0,0
3151,204,361,363,813,47,11,10,159,452,42,611,0,0
3152,204,360,363,813,47,11,10,159,453,43,611,0,0
3153,204,360,364,813,47,11,10,160,453,44,611,0,0
3154,206,359,365,813,47,11,10,159,454,45,611,0,0
3155,208,361,366,814,47,11,10,158,453,46,611,0,0
3156,210,362,368,816,47,11,10,158,454,47,611,0,0
3157,212,360,369,817,47,11,10,157,457,48,611,0,0
3158,213,360,369,816,47,11,10,156,456,49,611,0,0
3159,217,360,370,815,47,11,10,153,455,50,611,0,0
3160,220,357,373,816,47,11,10,153,459,51,611,0,0
3161,220,357,370,818,47,11,10,150,461,52,611,0,0
3162,229,358,372,805,47,11,10,143,447,53,611,0,0
3163,238,351,357,725,47,11,10,119,374,54,611,0,0
3164,243,350,355,708,47,11,10,112,358,55,611,0,0
3165,254,351,358,683,47,11,10,104,332,56,611,0,0
3166,243,345,372,761,47,11,10,129,416,57,611,0,0
3167,231,342,371,788,47,11,10,140,446,58,611,0,0
3168,212,339,356,791,47,11,10,144,452,59,611,0,0
3169,191,332,339,787,47,11,10,148,455,60,611,0,0
3170,170,327,320,779,47,11,10,150,452,61,611,0,0
3171,148,337,295,772,47,11,10,147,435,62,611,0,0
3172,133,345,278,765,47,11,10,145,420,63,611,0,0
3173,120,350,265,764,47,11,10,145,414,64,611,0,0
3174,113,360,257,764,47,11,10,144,404,65,611,0,0
3175,111,371,254,767,47,11,10,143,396,66,611,0,0
3176,112,374,256,768,47,11,10,144,394,67,611,0,0
3177,110,362,258,762,47,11,10,148,400,68,611,0,0
3178,106,344,259,760,47,11,10,153,416,69,611,0,0
3179,110,335,267,761,47,11,10,157,426,70,611,0,0
3180,119,333,277,761,47,11,10,158,428,71,611,0,0
3181,129,333,287,764,47,11,10,158,431,72,611,0,0
3182,137,333,296,764,47,11,10,159,431,73,611,0,0
3183,139,329,299,764,47,11,10,160,435,74,611,0,0
3184,142,328,304,764,47,11,10,162,436,75,611,0,0
3185,139,329,300,764,47,11,10,161,435,76,611,0,0
3186,136,335,295,764,47,11,10,159,429,77,611,0,0
3187,134,339,291,764,47,11,10,157,425,78,611,0,0
3188,135,341,290,764,47,11,10,155,423,79,611,0,0
3189,138,340,293,762,47,11,10,155,422,80,611,0,0
3190,143,340,295,762,47,11,10,152,422,81,611,0,0
3191,147,338,299,762,47,11,10,152,424,82,611,0,0
3192,148,336,299,761,47,11,10,151,425,83,611,0,0
3193,147,334,297,759,47,11,10,150,425,84,611,0,0
3194,146,331,294,757,47,11,10,148,426,85,611,0,0
3195,146,328,292,755,47,11,10,146,427,86,611,0,0
3196,149,326,292,751,47,11,10,143,425,87,611,0,0
3197,152,325,293,743,47,11,10,141,418,88,611,0,0
3198,165,327,303,739,47,11,10,138,412,89,611,0,0
3199,174,325,311,735,47,11,10,137,410,90,611,0,0
3200,187,325,320,725,47,11,10,133,400,91,611,0,0
3201,199,324,331,722,47,11,10,132,398,92,611,0,0
3202,205,321,339,729,47,11,10,134,408,93,611,0,0
3203,209,320,344,729,47,11,10,135,409,94,611,0,0
3204,211,320,346,731,47,11,10,135,411,95,611,0,0
3205,211,322,346,733,47,11,10,135,411,96,611,0,0
3206,212,326,344,732,47,11,10,132,406,97,611,0,0
3207,215,326,346,732,47,11,10,131,406,98,611,0,0
3208,214,326,344,731,47,11,10,130,405,99,611,0,0
3209,215,328,343,731,47,11,10,128,403,100,611,0,0
3210,215,326,344,734,47,11,10,129,408,101,611,0,0
3211,216,311,349,733,47,11,10,133,422,102,611,0,0
3212,217,306,351,732,47,11,10,134,426,103,611,0,0
3213,215,308,348,729,47,11,10,133,421,104,611,0,0
3214,214,318,345,730,47,11,10,131,412,105,611,0,0
3215,218,326,347,730,47,11,10,129,404,106,611,0,0
3216,219,330,347,731,47,11,10,128,401,107,611,0,0
3217,219,333,347,733,47,11,10,128,400,108,611,0,0
3218,219,332,347,732,47,11,10,128,400,109,611,0,0
3219,219,333,347,733,47,11,10,128,400,110,611,0,0
3220,218,333,347,734,47,11,10,129,401,111,611,0,0
3221,218,332,347,732,47,11,10,129,400,112,611,0,0
3222,218,331,347,732,47,11,10,129,401,113,611,0,0
3223,217,331,346,732,47,11,10,129,401,114,611,0,0
3224,216,331,345,731,47,11,10,129,400,115,611,0,0
3225,216,330,345,732,47,11,10,129,402,116,611,0,0
3226,216,330,345,733,47,11,10,129,403,117,611,0,0
3227,215,330,345,733,47,11,10,130,403,118,611,0,0
3228,215,330,345,732,47,11,10,130,402,119,611,0,0
3229,215,330,344,732,47,11,10,129,402,120,611,0,0
3230,215,330,345,732,47,11,10,130,402,121,611,0,0
3231,215,330,345,732,47,11,10,130,402,122,611,0,0
3232,216,330,346,732,47,11,10,130,402,123,611,0,0
3233,216,331,346,732,47,11,10,130,401,124,611,0,0
3234,217,331,347,732,47,11,10,130,401,125,611,0,0
3235,216,332,347,732,47,11,10,131,400,126,611,0,0
3236,216,331,347,733,47,11,10,131,402,127,611,0,0
3237,216,331,347,733,47,11,10,131,402,128,611,0,0
3238,216,331,346,730,47,11,10,130,399,129,611,0,0
3239,217,329,347,732,47,11,10,130,403,130,611,0,0
3240,217,328,348,732,47,11,10,131,404,131,611,0,0
3241,214,328,345,730,47,11,10,131,402,132,611,0,0
3242,209,327,339,728,47,11,10,130,401,133,611,0,0
3243,201,323,330,726,47,11,10,129,403,134,611,0,0
3244,194,322,323,723,47,11,10,129,401,135,611,0,0
3245,195,322,324,723,47,11,10,129,401,136,611,0,0
3246,201,321,330,722,47,11,10,129,401,137,611,0,0
3247,208,316,337,722,47,11,10,129,406,138,611,0,0
3248,215,315,341,714,47,11,10,126,399,139,611,0,0
3249,221,314,346,713,47,11,10,125,399,140,611,0,0
3250,230,314,349,701,47,11,10,119,387,141,611,0,0
3251,236,314,354,702,47,11,10,118,388,142,611,0,0
3252,244,316,360,703,47,11,10,116,387,143,611,0,0
3253,249,318,365,715,47,11,10,116,397,144,611,0,0
3254,253,320,368,719,47,11,10,115,399,145,611,0,0
3255,251,324,365,721,47,11,10,114,397,146,611,0,0
3256,251,326,364,722,47,11,10,113,396,147,611,0,0
3257,252,327,366,722,47,11,10,114,395,148,611,0,0
3258,257,326,371,722,47,11,10,114,396,149,611,0,0
3259,257,327,370,723,47,11,10,113,396,150,611,0,0
3260,254,327,366,724,47,11,10,112,397,151,611,0,0
3261,245,325,358,724,47,11,10,113,399,152,611,0,0
3262,237,325,352,724,47,11,10,115,399,153,611,0,0
3263,233,325,348,723,47,11,10,115,398,154,611,0,0
3264,233,329,346,721,47,11,10,113,392,155,611,0,0
3265,228,324,343,724,47,11,10,115,400,156,611,0,0
3266,219,328,335,726,47,11,10,116,398,157,611,0,0
3267,216,328,332,729,47,11,10,116,401,158,611,0,0
3268,211,331,326,732,47,11,10,115,401,159,611,0,0
3269,202,331,317,735,47,11,10,115,404,160,611,0,0
3270,196,334,309,732,47,11,10,113,398,161,611,0,0
3271,182,341,297,738,47,11,10,115,397,162,611,0,0
3272,165,342,284,741,47,11,10,119,399,163,611,0,0
3273,149,342,273,743,47,11,10,124,401,164,611,0,0
3274,122,342,250,747,47,11,10,128,405,165,611,0,0
3275,108,343,244,766,47,11,10,136,423,166,611,0,0
3276,85,344,230,778,47,11,10,145,434,167,611,0,0
3277,61,347,216,789,47,11,10,155,442,168,611,0,0
3278,51,349,213,797,47,11,10,162,448,169,611,0,0
3279,43,352,209,800,47,11,10,166,448,170,611,0,0
3280,36,355,208,807,47,11,10,172,452,171,611,0,0
3281,34,357,210,810,47,11,10,176,453,172,611,0,0
3282,35,354,216,810,47,11,10,181,456,173,611,0,0
3283,40,353,225,805,47,11,10,185,452,174,611,0,0
3284,36,354,224,808,47,11,10,188,454,175,611,0,0
3285,34,353,226,809,47,11,10,192,456,176,611,0,0
3286,38,358,231,808,47,11,10,193,450,177,611,0,0
3287,33,354,232,811,47,11,10,199,457,178,611,0,0
3288,32,356,231,807,47,11,10,199,451,179,611,0,0
3289,30,357,232,808,47,11,10,202,451,180,611,0,0
3290,29,357,233,806,47,11,10,204,449,181,611,0,0
3291,30,358,235,804,47,11,10,205,446,182,611,0,0
3292,30,357,236,802,47,11,10,206,445,183,611,0,0
3293,29,356,238,803,47,11,10,209,447,184,611,0,0
3294,29,357,239,802,47,11,10,210,445,185,611,0,0
3295,28,358,239,801,47,11,10,211,443,186,611,0,0
3296,28,357,241,802,47,11,10,213,445,187,611,0,0
3297,27,356,242,803,47,11,10,215,447,188,611,0,0
3298,27,357,241,799,47,11,10,214,442,189,611,0,0
3299,27,358,242,798,47,11,10,215,440,190,611,0,0
3300,27,359,243,798,47,11,10,216,439,191,611,0,0
3301,26,358,243,798,47,11,10,217,440,192,611,0,0
3302,26,357,245,798,47,11,10,219,441,193,611,0,0
3303,24,354,246,803,47,11,10,222,449,194,611,0,0
3304,24,356,246,801,47,11,10,222,445,195,611,0,0
3305,23,354,247,804,47,11,10,224,450,196,611,0,0
3306,22,353,247,806,47,11,10,225,453,197,611,0,0
3307,21,352,247,808,47,11,10,226,456,198,611,0,0
3308,23,355,248,808,47,11,10,225,453,199,611,0,0
3309,24,354,248,807,47,11,10,224,453,200,611,0,0
3310,24,353,248,805,47,11,10,224,452,201,611,0,0
3311,23,353,248,807,47,11,10,225,454,202,611,0,0
3312,23,355,246,803,47,11,10,223,448,203,611,0,0
3313,22,355,245,803,47,11,10,223,448,204,611,0,0
3314,21,354,246,805,47,11,10,225,451,205,611,0,0
3315,24,357,248,803,47,11,10,224,446,206,611,0,0
3316,21,354,247,807,47,11,10,226,453,207,611,0,0
3317,21,355,246,806,47,11,10,225,451,208,611,0,0
3318,26,361,246,801,47,11,10,220,440,209,611,0,0
3319,23,357,245,805,47,11,10,222,448,210,611,0,0
3320,19,354,245,810,47,11,10,226,456,211,611,0,0
3321,18,357,242,810,47,11,10,224,453,212,611,0,0
3322,17,357,241,810,47,11,10,224,453,213,611,0,0
3323,17,357,240,810,47,11,10,223,453,214,611,0,0
3324,20,355,241,805,47,11,10,221,450,215,611,0,0
3325,20,356,241,807,47,11,10,221,451,216,611,0,0
3326,21,356,241,804,47,11,10,220,448,217,611,0,0
3327,20,354,242,808,47,11,10,222,454,218,611,0,0
3328,19,353,240,806,47,11,10,221,453,219,611,0,0
3329,19,353,242,809,47,11,10,223,456,220,611,0,0
3330,23,354,242,802,47,11,10,219,448,221,611,0,0
3331,20,354,242,809,47,11,10,222,455,222,611,0,0
3332,21,357,240,806,47,11,10,219,449,223,611,0,0
3333,20,354,243,813,47,11,10,223,459,224,611,0,0
3334,25,353,246,807,47,11,10,221,454,225,611,0,0
3335,41,355,254,799,47,11,10,213,444,226,611,0,0
3336,64,356,272,804,47,11,10,208,448,227,611,0,0
3337,68,356,274,811,47,11,10,206,455,228,611,0,0
3338,65,356,268,815,47,11,10,203,459,229,611,0,0
3339,59,357,258,817,47,11,10,199,460,230,611,0,0
3340,51,359,246,819,47,11,10,195,460,231,611,0,0
3341,41,360,234,823,47,11,10,193,463,232,611,0,0
3342,34,361,224,823,47,11,10,190,462,233,611,0,0
3343,33,361,218,822,47,11,10,185,461,234,611,0,0
3344,44,362,224,819,47,11,10,180,457,235,611,0,0
3345,54,362,229,817,47,11,10,175,455,236,611,0,0
3346,64,363,235,814,47,11,10,171,451,237,611,0,0
3347,76,363,245,816,47,11,10,169,453,238,611,0,0
3348,85,361,253,814,47,11,10,168,453,239,611,0,0
3349,97,357,264,810,47,11,10,167,453,240,611,0,0
3350,107,356,272,809,47,11,10,165,453,241,611,0,0
3351,118,360,283,814,47,11,10,165,454,242,611,0,0
3352,128,360,294,820,47,11,10,166,460,243,611,0,0
3353,130,359,301,843,47,11,10,171,484,244,611,0,0
3354,132,361,308,864,47,11,10,176,503,245,611,0,0
3355,137,362,306,853,47,11,10,169,491,246,611,0,0
3356,140,360,301,829,47,11,10,161,469,247,611,0,0
3357,140,357,299,826,47,11,10,159,469,248,611,0,0
3358,141,360,299,831,47,11,10,158,471,249,611,0,0
3359,141,361,299,834,47,11,10,158,473,250,611,0,0
3360,141,356,297,832,47,11,10,156,476,251,611,0,0
3361,145,364,298,837,47,11,10,153,473,252,611,0,0
3362,150,365,302,834,47,11,10,152,469,253,611,0,0
3363,154,365,302,821,47,11,10,148,456,254,611,0,0
3364,148,363,293,814,47,11,10,145,451,255,611,0,0
3365,134,357,289,843,47,11,10,155,486,256,611,0,0
3366,121,352,293,895,47,11,10,172,543,257,611,0,0
3367,116,349,285,884,47,11,10,169,535,258,611,0,0
3368,122,348,277,837,47,11,10,155,489,259,611,0,0
3369,133,347,279,802,47,11,10,146,455,260,611,0,0
3370,141,339,285,790,47,11,10,144,451,261,611,0,0
3371,151,335,290,772,47,11,10,139,437,262,611,0,0
3372,158,335,292,760,47,11,10,134,425,263,611,0,0
3373,158,332,291,756,47,11,10,133,424,264,611,0,0
3374,154,332,288,758,47,11,10,134,426,265,611,0,0
3375,147,333,283,763,47,11,10,136,430,266,611,0,0
3376,142,334,276,758,47,11,10,134,424,267,611,0,0
3377,139,333,272,751,47,11,10,133,418,268,611,0,0
3378,139,331,272,747,47,11,10,133,416,269,611,0,0
3379,147,328,277,736,47,11,10,130,408,270,611,0,0
3380,153,324,281,729,47,11,10,128,405,271,611,0,0
3381,158,322,284,721,47,11,10,126,399,272,611,0,0
3382,159,320,285,719,47,11,10,126,399,273,611,0,0
3383,159,320,284,719,47,11,10,125,399,274,611,0,0
3384,159,323,283,717,47,11,10,124,394,275,611,0,0
3385,160,325,283,718,47,11,10,123,393,276,611,0,0
3386,161,325,285,721,47,11,10,124,396,277,611,0,0
3387,160,323,284,720,47,11,10,124,397,278,611,0,0
3388,155,318,279,711,47,11,10,124,393,279,611,0,0
3389,145,315,270,713,47,11,10,125,398,280,611,0,0
3390,136,314,261,713,47,11,10,125,399,281,611,0,0
3391,132,312,255,702,47,11,10,123,390,282,611,0,0
3392,135,310,258,695,47,11,10,123,385,283,611,0,0
3393,140,308,261,690,47,11,10,121,382,284,611,0,0
3394,143,304,265,692,47,11,10,122,388,285,611,0,0
3395,147,303,266,685,47,11,10,119,382,286,611,0,0
3396,147,300,266,684,47,11,10,119,384,287,611,0,0
3397,146,300,265,686,47,11,10,119,386,288,611,0,0
3398,145,300,264,686,47,11,10,119,386,289,611,0,0
3399,146,300,263,684,47,11,10,117,384,290,611,0,0
3400,147,300,263,683,47,11,10,116,383,291,611,0,0
3401,148,301,263,683,47,11,10,115,382,292,611,0,0
3402,149,302,264,683,47,11,10,115,381,293,611,0,0
3403,150,302,264,684,47,11,10,114,382,294,611,0,0
3404,151,302,265,684,47,11,10,114,382,295,611,0,0
3405,152,302,266,685,47,11,10,114,383,296,611,0,0
3406,153,302,266,684,47,11,10,113,382,297,611,0,0
3407,153,302,266,683,47,11,10,113,381,298,611,0,0
3408,154,302,266,682,47,11,10,112,380,299,611,0,0
3409,154,302,266,682,47,11,10,112,380,300,611,0,0
3410,154,302,266,683,47,11,10,112,381,301,611,0,0
3411,154,302,267,684,47,11,10,113,382,302,611,0,0
3412,154,302,267,684,47,11,10,113,382,303,611,0,0
3413,153,302,265,682,47,11,10,112,380,304,611,0,0
3414,147,303,260,686,47,11,10,113,383,305,611,0,0
3415,140,304,253,689,47,11,10,113,385,306,611,0,0
3416,136,303,249,688,47,11,10,113,385,307,611,0,0
3417,128,305,239,678,47,11,10,111,373,308,611,0,0
3418,120,308,226,666,47,11,10,106,358,309,611,0,0
3419,113,308,220,669,47,11,10,107,361,310,611,0,0
3420,113,306,222,678,47,11,10,109,372,311,611,0,0
3421,112,305,220,676,47,11,10,108,371,312,611,0,0
3422,112,304,220,673,47,11,10,108,369,313,611,0,0
3423,112,304,220,672,47,11,10,108,368,314,611,0,0
3424,112,304,219,669,47,11,10,107,365,315,611,0,0
3425,114,303,220,669,47,11,10,106,366,316,611,0,0
3426,115,306,218,663,47,11,10,103,357,317,611,0,0
3427,116,307,218,659,47,11,10,102,352,318,611,0,0
3428,117,307,218,658,47,11,10,101,351,319,611,0,0
3429,117,308,218,657,47,11,10,101,349,320,611,0,0
3430,118,305,220,661,47,11,10,102,356,321,611,0,0
3431,118,303,220,660,47,11,10,102,357,322,611,0,0
3432,118,303,220,660,47,11,10,102,357,323,611,0,0
3433,118,303,220,661,47,11,10,102,358,324,611,0,0
3434,118,303,220,662,47,11,10,102,359,325,611,0,0
3435,118,302,220,661,47,11,10,102,359,326,611,0,0
3436,119,302,221,664,47,11,10,102,362,327,611,0,0
3437,119,301,222,665,47,11,10,103,364,328,611,0,0
3438,119,301,222,665,47,11,10,103,364,329,611,0,0
3439,119,302,222,665,47,11,10,103,363,330,611,0,0
3440,119,302,222,665,47,11,10,103,363,331,611,0,0
3441,120,302,222,664,47,11,10,102,362,332,611,0,0
3442,121,305,220,657,47,11,10,99,352,333,611,0,0
3443,121,303,221,656,47,11,10,100,353,334,611,0,0
3444,122,306,221,661,47,11,10,99,355,335,611,0,0
3445,125,310,222,661,47,11,10,97,351,336,611,0,0
3446,128,308,227,663,47,11,10,99,355,337,611,0,0
3447,138,308,237,661,47,11,10,99,353,338,611,0,0
3448,143,306,243,657,47,11,10,100,351,339,611,0,0
3449,148,305,249,658,47,11,10,101,353,340,611,0,0
3450,153,306,257,663,47,11,10,104,357,341,611,0,0
3451,156,304,263,668,47,11,10,107,364,342,611,0,0
3452,157,302,264,669,47,11,10,107,367,343,611,0,0
3453,153,300,262,672,47,11,10,109,372,344,611,0,0
3454,147,302,257,672,47,11,10,110,370,345,611,0,0
3455,143,303,254,674,47,11,10,111,371,346,611,0,0
3456,141,303,253,675,47,11,10,112,372,347,611,0,0
3457,141,303,253,676,47,11,10,112,373,348,611,0,0
3458,140,303,253,677,47,11,10,113,374,349,611,0,0
3459,140,303,253,678,47,11,10,113,375,350,611,0,0
3460,140,303,253,679,47,11,10,113,376,351,611,0,0
3461,139,304,253,680,47,11,10,114,376,352,611,0,0
3462,139,304,253,680,47,11,10,114,376,353,611,0,0
3463,139,304,253,681,47,11,10,114,377,354,611,0,0
3464,139,305,254,681,47,11,10,115,376,355,611,0,0
3465,138,305,254,682,47,11,10,116,377,356,611,0,0
3466,137,305,253,684,47,11,10,116,379,357,611,0,0
3467,137,305,254,685,47,11,10,117,380,358,611,0,0
3468,137,305,254,686,47,11,10,117,381,359,611,0,0
3469,137,305,254,685,47,11,10,117,380,360,611,0,0
3470,137,305,254,685,47,11,10,117,380,361,611,0,0
3471,137,304,254,685,47,11,10,117,381,362,611,0,0
3472,137,304,254,683,47,11,10,117,379,363,611,0,0
3473,137,304,254,683,47,11,10,117,379,364,611,0,0
3474,137,304,254,682,47,11,10,117,378,365,611,0,0
3475,138,304,254,682,47,11,10,116,378,366,611,0,0
3476,139,304,255,680,47,11,10,116,376,367,611,0,0
3477,140,306,255,680,47,11,10,115,374,368,611,0,0
3478,140,307,254,680,47,11,10,114,373,369,611,0,0
3479,140,308,254,680,47,11,10,114,372,370,611,0,0
3480,140,309,254,680,47,11,10,114,371,371,611,0,0
3481,140,310,253,680,47,11,10,113,370,372,611,0,0
3482,141,312,253,680,47,11,10,112,368,373,611,0,0
3483,141,314,253,680,47,11,10,112,366,374,611,0,0
3484,141,315,253,679,47,11,10,112,364,375,611,0,0
3485,141,316,253,679,47,11,10,112,363,376,611,0,0
3486,141,317,253,681,47,11,10,112,364,377,611,0,0
3487,141,317,253,681,47,11,10,112,364,378,611,0,0
3488,141,317,254,681,47,11,10,113,364,379,611,0,0
3489,141,317,254,681,47,11,10,113,364,380,611,0,0
3490,141,317,254,681,47,11,10,113,364,381,611,0,0
3491,142,316,255,680,47,11,10,113,364,382,611,0,0
3492,142,315,255,680,47,11,10,113,365,383,611,0,0
3493,143,314,256,680,47,11,10,113,366,384,611,0,0
3494,143,314,256,680,47,11,10,113,366,385,611,0,0
3495,144,312,257,680,47,11,10,113,368,386,611,0,0
3496,147,311,261,679,47,11,10,114,368,387,611,0,0
3497,152,310,265,676,47,11,10,113,366,388,611,0,0
3498,156,306,270,671,47,11,10,114,365,389,611,0,0
3499,158,305,272,672,47,11,10,114,367,390,611,0,0
3500,157,305,273,676,47,11,10,116,371,391,611,0,0
3501,154,308,272,676,47,11,10,118,368,392,611,0,0
3502,146,312,266,680,47,11,10,120,368,393,611,0,0
3503,134,316,254,681,47,11,10,120,365,394,611,0,0
3504,126,324,242,677,47,11,10,116,353,395,611,0,0
3505,124,326,240,677,47,11,10,116,351,396,611,0,0
3506,127,338,240,677,47,11,10,113,339,397,611,0,0
3507,123,353,233,682,47,11,10,110,329,398,611,0,0
3508,124,374,231,695,47,11,10,107,321,399,611,0,0
3509,125,391,227,698,47,11,10,102,307,400,611,0,0
3510,117,388,222,702,47,11,10,105,314,401,611,0,0
3511,106,376,218,704,47,11,10,112,328,402,611,0,0
3512,102,361,222,716,47,11,10,120,355,403,611,0,0
3513,107,348,233,725,47,11,10,126,377,404,611,0,0
3514,115,339,245,727,47,11,10,130,388,405,611,0,0
3515,130,334,262,729,47,11,10,132,395,406,611,0,0
3516,149,332,289,748,47,11,10,140,416,407,611,0,0
3517,175,334,320,763,47,11,10,145,429,408,611,0,0
3518,211,337,355,767,47,11,10,144,430,409,611,0,0
3519,249,337,394,767,47,11,10,145,430,410,611,0,0
3520,295,340,441,770,47,11,10,146,430,411,611,0,0
3521,339,343,484,770,47,11,10,145,427,412,611,0,0
3522,382,345,532,793,47,11,10,150,448,413,611,0,0
3523,427,358,579,812,47,11,10,152,454,414,611,0,0
3524,475,359,623,807,47,11,10,148,448,415,611,0,0
3525,520,362,672,825,47,11,10,152,463,416,611,0,0
3526,570,373,718,825,47,11,10,148,452,417,611,0,0
3527,629,385,751,751,47,11,10,122,366,418,611,0,0
3528,679,400,791,727,47,11,10,112,327,419,611,0,0
3529,711,411,831,748,47,11,10,120,337,420,611,0,0
3530,723,429,867,813,47,11,10,144,384,421,611,0,0
3531,734,447,893,849,47,11,10,159,402,422,611,0,0
3532,748,447,924,876,47,11,10,176,429,423,611,0,0
3533,746,452,933,883,47,11,10,187,431,424,611,0,0
3534,741,454,939,895,47,11,10,198,441,425,611,0,0
3535,734,453,943,907,47,11,10,209,454,426,611,0,0
3536,744,446,961,899,47,11,10,217,453,427,611,0,0
3537,750,440,978,896,47,11,10,228,456,428,611,0,0
3538,751,434,988,893,47,11,10,237,459,429,611,0,0
3539,741,429,988,894,47,11,10,247,465,430,611,0,0
3540,704,422,957,895,47,11,10,253,473,431,611,0,0
3541,656,418,904,889,47,11,10,248,471,432,611,0,0
3542,624,412,867,885,47,11,10,243,473,433,611,0,0
3543,603,403,844,888,47,11,10,241,485,434,611,0,0
3544,589,394,830,895,47,11,10,241,501,435,611,0,0
3545,587,392,824,901,47,11,10,237,509,436,611,0,0
3546,588,396,821,906,47,11,10,233,510,437,611,0,0
3547,598,398,827,906,47,11,10,229,508,438,611,0,0
3548,602,403,826,904,47,11,10,224,501,439,611,0,0
3549,598,403,819,904,47,11,10,221,501,440,611,0,0
3550,591,398,808,905,47,11,10,217,507,441,611,0,0
3551,585,395,798,905,47,11,10,213,510,442,611,0,0
3552,581,392,787,901,47,11,10,206,509,443,611,0,0
3553,578,388,780,899,47,11,10,202,511,444,611,0,0
3554,582,392,780,897,47,11,10,198,505,445,611,0,0
3555,577,392,774,898,47,11,10,197,506,446,611,0,0
3556,574,395,766,897,47,11,10,192,502,447,611,0,0
3557,573,393,763,896,47,11,10,190,503,448,611,0,0
3558,578,392,766,899,47,11,10,188,507,449,611,0,0
3559,586,389,772,901,47,11,10,186,512,450,611,0,0
3560,592,391,776,901,47,11,10,184,510,451,611,0,0
3561,603,390,784,900,47,11,10,181,510,452,611,0,0
3562,615,399,792,904,47,11,10,177,505,453,611,0,0
3563,623,402,797,906,47,11,10,174,504,454,611,0,0
3564,625,404,796,907,47,11,10,171,503,455,611,0,0
3565,630,406,797,905,47,11,10,167,499,456,611,0,0
3566,633,407,797,904,47,11,10,164,497,457,611,0,0
3567,634,407,797,904,47,11,10,163,497,458,611,0,0
3568,633,408,793,900,47,11,10,160,492,459,611,0,0
3569,632,413,789,900,47,11,10,157,487,460,611,0,0
3570,632,410,790,904,47,11,10,158,494,461,611,0,0
3571,630,412,785,900,47,11,10,155,488,462,611,0,0
3572,629,409,785,904,47,11,10,156,495,463,611,0,0
3573,628,408,783,905,47,11,10,155,497,464,611,0,0
3574,628,406,780,900,47,11,10,152,494,465,611,0,0
3575,627,406,779,903,47,11,10,152,497,466,611,0,0
3576,626,407,775,898,47,11,10,149,491,467,611,0,0
3577,626,405,775,902,47,11,10,149,497,468,611,0,0
3578,626,406,775,903,47,11,10,149,497,469,611,0,0
3579,626,406,776,905,47,11,10,150,499,470,611,0,0
3580,628,406,777,904,47,11,10,149,498,471,611,0,0
3581,629,404,777,904,47,11,10,148,500,472,611,0,0
3582,630,404,778,904,47,11,10,148,500,473,611,0,0
3583,636,409,783,904,47,11,10,147,495,474,611,0,0
3584,640,414,787,904,47,11,10,147,490,475,611,0,0
3585,643,416,789,895,47,11,10,146,479,476,611,0,0
3586,645,417,795,900,47,11,10,150,483,477,611,0,0
3587,646,417,798,902,47,11,10,152,485,478,611,0,0
3588,645,418,799,903,47,11,10,154,485,479,611,0,0
3589,645,417,801,903,47,11,10,156,486,480,611,0,0
3590,645,417,802,903,47,11,10,157,486,481,611,0,0
3591,644,416,804,905,47,11,10,160,489,482,611,0,0
3592,644,415,805,905,47,11,10,161,490,483,611,0,0
3593,643,414,805,906,47,11,10,162,492,484,611,0,0
3594,641,414,804,906,47,11,10,163,492,485,611,0,0
3595,639,414,801,905,47,11,10,162,491,486,611,0,0
3596,637,415,799,905,47,11,10,162,490,487,611,0,0
3597,636,415,797,905,47,11,10,161,490,488,611,0,0
3598,637,416,798,905,47,11,10,161,489,489,611,0,0
3599,636,416,798,905,47,11,10,162,489,490,611,0,0
3600,634,416,796,905,47,11,10,162,489,491,611,0,0
3601,635,415,796,905,47,11,10,161,490,492,611,0,0
3602,634,415,796,905,47,11,10,162,490,493,611,0,0
3603,634,415,795,905,47,11,10,161,490,494,611,0,0
3604,633,415,794,906,47,11,10,161,491,495,611,0,0
3605,630,414,792,906,47,11,10,162,492,496,611,0,0
3606,624,416,785,906,47,11,10,161,490,497,611,0,0
3607,624,414,785,907,47,11,10,161,493,498,611,0,0
3608,626,413,786,907,47,11,10,160,494,499,611,0,0
3609,627,413,786,906,47,11,10,159,493,500,611,0,0
3610,629,414,786,906,47,11,10,157,492,501,611,0,0
3611,628,413,785,906,47,11,10,157,493,502,611,0,0
3612,628,412,785,906,47,11,10,157,494,503,611,0,0
3613,624,406,780,900,47,11,10,156,494,504,611,0,0
3614,623,402,777,902,47,11,10,154,500,505,611,0,0
3615,627,403,779,904,47,11,10,152,501,506,611,0,0
3616,633,404,784,906,47,11,10,151,502,507,611,0,0
3617,642,405,798,904,47,11,10,156,499,508,611,0,0
3618,622,406,783,901,47,11,10,161,495,509,611,0,0
3619,588,406,752,903,47,11,10,164,497,510,611,0,0
3620,570,401,735,901,47,11,10,165,500,511,611,0,0
3621,557,402,725,903,47,11,10,168,501,512,611,0,0
3622,548,396,718,898,47,11,10,170,502,513,611,0,0
3623,542,397,714,899,47,11,10,172,502,514,611,0,0
3624,542,400,714,896,47,11,10,172,496,515,611,0,0
3625,544,398,718,898,47,11,10,174,500,516,611,0,0
3626,546,399,719,897,47,11,10,173,498,517,611,0,0
3627,547,398,723,902,47,11,10,176,504,518,611,0,0
3628,556,401,734,903,47,11,10,178,502,519,611,0,0
3629,581,400,757,901,47,11,10,176,501,520,611,0,0
3630,604,400,776,899,47,11,10,172,499,521,611,0,0
3631,613,399,782,901,47,11,10,169,502,522,611,0,0
3632,618,401,783,900,47,11,10,165,499,523,611,0,0
3633,621,400,784,901,47,11,10,163,501,524,611,0,0
3634,624,400,785,902,47,11,10,161,502,525,611,0,0
3635,625,400,784,902,47,11,10,159,502,526,611,0,0
3636,626,397,783,903,47,11,10,157,506,527,611,0,0
3637,627,396,782,898,47,11,10,155,502,528,611,0,0
3638,629,394,782,895,47,11,10,153,501,529,611,0,0
3639,629,395,779,892,47,11,10,150,497,530,611,0,0
3640,629,394,778,898,47,11,10,149,504,531,611,0,0
3641,631,397,777,898,47,11,10,146,501,532,611,0,0
3642,633,397,778,898,47,11,10,145,501,533,611,0,0
3643,636,399,780,903,47,11,10,144,504,534,611,0,0
3644,638,397,782,905,47,11,10,144,508,535,611,0,0
3645,645,396,792,918,47,11,10,147,522,536,611,0,0
3646,655,402,805,924,47,11,10,150,522,537,611,0,0
3647,667,415,821,933,47,11,10,154,518,538,611,0,0
3648,686,419,845,939,47,11,10,159,520,539,611,0,0
3649,694,426,855,937,47,11,10,161,511,540,611,0,0
3650,684,435,848,939,47,11,10,164,504,541,611,0,0
3651,656,434,833,959,47,11,10,177,525,542,611,0,0
3652,630,436,813,971,47,11,10,183,535,543,611,0,0
3653,612,434,798,971,47,11,10,186,537,544,611,0,0
3654,591,431,778,973,47,11,10,187,542,545,611,0,0
3655,576,432,765,980,47,11,10,189,548,546,611,0,0
3656,570,430,760,981,47,11,10,190,551,547,611,0,0
3657,572,427,761,976,47,11,10,189,549,548,611,0,0
3658,583,426,771,973,47,11,10,188,547,549,611,0,0
3659,599,424,787,969,47,11,10,188,545,550,611,0,0
3660,616,420,805,959,47,11,10,189,539,551,611,0,0
3661,625,420,811,950,47,11,10,186,530,552,611,0,0
3662,630,414,816,949,47,11,10,186,535,553,611,0,0
3663,630,408,814,939,47,11,10,184,531,554,611,0,0
3664,627,400,809,934,47,11,10,182,534,555,611,0,0
3665,623,395,800,921,47,11,10,177,526,556,611,0,0
3666,630,397,804,916,47,11,10,174,519,557,611,0,0
3667,639,400,816,920,47,11,10,177,520,558,611,0,0
3668,652,405,829,919,47,11,10,177,514,559,611,0,0
3669,669,416,847,917,47,11,10,178,501,560,611,0,0
3670,686,423,866,922,47,11,10,180,499,561,611,0,0
3671,690,428,868,914,47,11,10,178,486,562,611,0,0
3672,686,428,867,921,47,11,10,181,493,563,611,0,0
3673,683,430,862,919,47,11,10,179,489,564,611,0,0
3674,682,427,864,921,47,11,10,182,494,565,611,0,0
3675,682,424,865,922,47,11,10,183,498,566,611,0,0
3676,677,422,858,917,47,11,10,181,495,567,611,0,0
3677,679,423,858,916,47,11,10,179,493,568,611,0,0
3678,683,423,862,915,47,11,10,179,492,569,611,0,0
3679,683,424,863,916,47,11,10,180,492,570,611,0,0
3680,682,421,862,914,47,11,10,180,493,571,611,0,0
3681,683,426,863,917,47,11,10,180,491,572,611,0,0
3682,684,428,863,918,47,11,10,179,490,573,611,0,0
3683,684,428,863,918,47,11,10,179,490,574,611,0,0
3684,683,429,862,918,47,11,10,179,489,575,611,0,0
3685,683,427,862,918,47,11,10,179,491,576,611,0,0
3686,682,422,864,920,47,11,10,182,498,577,611,0,0
3687,683,425,863,918,47,11,10,180,493,578,611,0,0
3688,683,423,865,920,47,11,10,182,497,579,611,0,0
3689,684,425,866,921,47,11,10,182,496,580,611,0,0
3690,684,425,867,920,47,11,10,183,495,581,611,0,0
3691,683,425,866,919,47,11,10,183,494,582,611,0,0
3692,682,425,864,919,47,11,10,182,494,583,611,0,0
3693,680,421,862,917,47,11,10,182,496,584,611,0,0
3694,678,415,862,920,47,11,10,184,505,585,611,0,0
3695,678,413,863,918,47,11,10,185,505,586,611,0,0
3696,674,414,857,916,47,11,10,183,502,587,611,0,0
3697,664,410,850,922,47,11,10,186,512,588,611,0,0
3698,661,410,845,917,47,11,10,184,507,589,611,0,0
3699,665,415,842,902,47,11,10,177,487,590,611,0,0
3700,677,428,854,903,47,11,10,177,475,591,611,0,0
3701,698,455,872,903,47,11,10,174,448,592,611,0,0
3702,713,472,891,908,47,11,10,178,436,593,611,0,0
3703,709,464,895,904,47,11,10,186,440,594,611,0,0
3704,702,446,900,908,47,11,10,198,462,595,611,0,0
3705,695,427,897,898,47,11,10,202,471,596,611,0,0
3706,681,412,887,895,47,11,10,206,483,597,611,0,0
3707,671,401,875,886,47,11,10,204,485,598,611,0,0
3708,664,401,866,881,47,11,10,202,480,599,611,0,0
3709,666,397,863,872,47,11,10,197,475,600,611,0,0
3710,676,396,868,862,47,11,10,192,466,601,611,0,0
3711,695,397,883,855,47,11,10,188,458,602,611,0,0
3712,717,386,899,838,47,11,10,182,452,603,611,0,0
3713,736,387,915,837,47,11,10,179,450,604,611,0,0
3714,755,383,932,830,47,11,10,177,447,605,611,0,0
3715,782,373,949,803,47,11,10,167,430,606,611,0,0
3716,804,375,966,794,47,11,10,162,419,607,611,0,0
3717,824,378,984,788,47,11,10,160,410,608,611,0,0
3718,849,367,1009,778,47,11,10,160,411,609,611,0,0
3719,873,365,1026,769,47,11,10,153,404,610,611,0,0
3720,887,361,1039,761,47,11,10,152,400,611,611,1,0
3108,202,333,323,807,48,11,10,121,474,0,0,0,0
3171,263,322,367,650,49,11,10,104,328,0,40,0,1
3172,267,321,376,663,49,11,10,109,342,1,40,0,0
3173,289,314,397,657,49,11,10,108,343,2,40,0,0
3174,311,314,416,648,49,11,10,105,334,3,40,0,0
3175,340,310,439,626,49,11,10,99,316,4,40,0,0
3176,370,311,464,611,49,11,10,94,300,5,40,0,0
3177,388,309,482,606,49,11,10,94,297,6,40,0,0
3178,425,305,518,597,49,11,10,93,292,7,40,0,0
3179,448,300,540,592,49,11,10,92,292,8,40,0,0
3180,471,298,558,579,49,11,10,87,281,9,40,0,0
3181,490,300,573,569,49,11,10,83,269,10,40,0,0
3182,503,295,585,561,49,11,10,82,266,11,40,0,0
3183,520,286,603,555,49,11,10,83,269,12,40,0,0
3184,529,281,613,555,49,11,10,84,274,13,40,0,0
3185,534,281,618,556,49,11,10,84,275,14,40,0,0
3186,540,281,620,547,49,11,10,80,266,15,40,0,0
3187,544,282,622,541,49,11,10,78,259,16,40,0,0
3188,548,283,624,536,49,11,10,76,253,17,40,0,0
3189,551,281,628,535,49,11,10,77,254,18,40,0,0
3190,552,282,627,531,49,11,10,75,249,19,40,0,0
3191,544,281,621,531,49,11,10,77,250,20,40,0,0
3192,536,280,614,534,49,11,10,78,254,21,40,0,0
3193,528,270,608,535,49,11,10,80,265,22,40,0,0
3194,513,288,587,532,49,11,10,74,244,23,40,0,0
3195,487,291,565,531,49,11,10,78,240,24,40,0,0
3196,474,285,557,535,49,11,10,83,250,25,40,0,0
3197,457,286,539,536,49,11,10,82,250,26,40,0,0
3198,441,289,523,539,49,11,10,82,250,27,40,0,0
3199,432,292,515,546,49,11,10,83,254,28,40,0,0
3200,418,292,501,543,49,11,10,83,251,29,40,0,0
3201,399,292,486,552,49,11,10,87,260,30,40,0,0
3202,384,290,475,557,49,11,10,91,267,31,40,0,0
3203,375,290,467,558,49,11,10,92,268,32,40,0,0
3204,360,288,452,561,49,11,10,92,273,33,40,0,0
3205,348,293,441,573,49,11,10,93,280,34,40,0,0
3206,343,296,435,579,49,11,10,92,283,35,40,0,0
3207,332,298,424,585,49,11,10,92,287,36,40,0,0
3208,320,299,413,591,49,11,10,93,292,37,40,0,0
3209,310,302,404,597,49,11,10,94,295,38,40,0,0
3210,292,303,385,604,49,11,10,93,301,39,40,0,0
3211,281,303,375,607,49,11,10,94,304,40,40,1,0
3215,159,309,255,623,49,11,10,96,314,0,40,0,0
3216,120,308,223,644,49,11,10,103,336,1,40,0,0
3217,91,308,193,629,49,11,10,102,321,2,40,0,0
3218,74,314,161,582,49,11,10,87,268,3,40,0,0
3219,45,315,140,609,49,11,10,95,294,4,40,0,0
3220,24,318,118,619,49,11,10,94,301,5,40,0,0
3221,14,344,104,631,49,11,10,90,287,6,40,0,0
3222,0,348,84,635,49,11,10,84,287,7,40,0,0
3213,208,293,275,540,50,11,10,67,247,0,1,0,0
3214,180,301,260,596,50,11,10,80,295,1,1,0,0
3710,863,355,999,673,51,11,10,136,318,0,19,0,0
3711,891,362,1023,673,51,11,10,132,311,1,19,0,0
3712,891,364,1023,676,51,11,10,132,312,2,19,0,0
3713,893,367,1027,685,51,11,10,134,318,3,19,0,0
3714,899,372,1024,670,51,11,10,125,298,4,19,0,0
3715,904,373,1028,674,51,11,10,124,301,5,19,0,0
3716,917,368,1032,652,51,11,10,115,284,6,19,0,0
3717,937,363,1040,626,51,11,10,103,263,7,19,0,0
3718,945,363,1045,617,51,11,10,100,254,8,19,0,0
3720,898,362,1008,633,51,11,10,110,271,0,19,0,1
3721,887,357,1013,667,51,11,10,126,310,1,19,0,0
3722,883,357,1013,675,51,11,10,130,318,2,19,0,0
3723,881,358,1014,679,51,11,10,133,321,3,19,0,0
3724,879,355,1014,680,51,11,10,135,325,4,19,0,0
3725,875,353,1013,682,51,11,10,138,329,5,19,0,0
3726,871,352,1011,682,51,11,10,140,330,6,19,0,0
3727,870,352,1012,682,51,11,10,142,330,7,19,0,0
3728,867,351,1012,683,51,11,10,145,332,8,19,0,0
3729,866,352,1012,681,51,11,10,146,329,9,19,0,0
3730,866,352,1013,681,51,11,10,147,329,10,19,0,0
3731,866,351,1014,682,51,11,10,148,331,11,19,0,0
3732,866,351,1016,681,51,11,10,150,330,12,19,0,0
3733,868,352,1017,679,51,11,10,149,327,13,19,0,0
3734,867,351,1018,679,51,11,10,151,328,14,19,0,0
3735,867,352,1017,679,51,11,10,150,327,15,19,0,0
3736,863,351,1015,682,51,11,10,152,331,16,19,0,0
3737,864,340,1019,683,51,11,10,155,343,17,19,0,0
3738,882,352,1011,645,51,11,10,129,293,18,19,0,0
3739,882,352,1010,641,51,11,10,128,289,19,19,0,0
3721,512,281,632,561,52,11,10,120,280,0,26,0,1
3722,509,280,625,549,52,11,10,116,269,1,26,0,0
3723,492,281,607,553,52,11,10,115,272,2,26,0,0
3724,465,287,586,573,52,11,10,121,286,3,26,0,0
3725,451,292,572,580,52,11,10,121,288,4,26,0,0
3726,439,296,561,588,52,11,10,122,292,5,26,0,0
3727,423,299,551,609,52,11,10,128,310,6,26,0,0
3728,408,300,539,621,52,11,10,131,321,7,26,0,0
3729,396,300,530,634,52,11,10,134,334,8,26,0,0
3730,393,306,530,653,52,11,10,137,347,9,26,0,0
3731,398,313,536,666,52,11,10,138,353,10,26,0,0
3732,404,328,544,693,52,11,10,140,365,11,26,0,0
3733,418,342,563,719,52,11,10,145,377,12,26,0,0
3734,444,349,589,734,52,11,10,145,385,13,26,0,0
3735,473,353,626,761,52,11,10,153,408,14,26,0,0
3736,500,364,659,783,52,11,10,159,419,15,26,0,0
3737,555,372,717,807,52,11,10,162,435,16,26,0,0
3738,574,397,747,854,52,11,10,173,457,17,26,0,0
3739,612,416,792,886,52,11,10,180,470,18,26,0,0
3740,665,425,850,916,52,11,10,185,491,19,26,0,0
3741,704,447,898,964,52,11,10,194,517,20,26,0,0
3742,757,464,956,995,52,11,10,199,531,21,26,0,0
3743,785,491,1002,1056,52,11,10,217,565,22,26,0,0
3744,830,520,1052,1079,52,11,10,222,559,23,26,0,0
3745,909,532,1130,1080,52,11,10,221,548,24,26,0,0
3746,976,576,1189,1080,52,11,10,213,504,25,26,0,0
3747,1008,592,1223,1080,52,11,10,215,488,26,26,1,0
3739,922,387,979,540,53,11,10,57,153,0,0,0,0
3747,1131,629,1344,1075,54,11,10,213,446,0,3,0,0
3748,1188,654,1389,1072,54,11,10,201,418,1,3,0,0
3749,1281,706,1462,1071,54,11,10,181,365,2,3,0,0
3750,1330,732,1498,1071,54,11,10,168,339,3,3,0,0
3750,1412,755,1672,1070,55,11,10,260,315,0,0,0,0
3751,1554,785,1790,1073,56,11,10,236,288,0,0,0,0
3752,1681,838,1883,1075,57,11,10,202,237,0,1,0,0
3753,1750,851,1920,1071,57,11,10,170,220,1,1,0,0
3921,109,196,145,292,60,11,10,36,96,0,19,0,1
3922,113,195,149,292,60,11,10,36,97,1,19,0,0
3923,117,195,153,296,60,11,10,36,101,2,19,0,0
3924,118,201,155,303,60,11,10,37,102,3,19,0,0
3925,122,202,157,301,60,11,10,35,99,4,19,0,0
3926,127,202,162,305,60,11,10,35,103,5,19,0,0
3927,133,203,170,308,60,11,10,37,105,6,19,0,0
3928,140,204,176,311,60,11,10,36,107,7,19,0,0
3929,145,209,181,314,60,11,10,36,105,8,19,0,0
3930,152,210,187,312,60,11,10,35,102,9,19,0,0
3931,158,209,194,316,60,11,10,36,107,10,19,0,0
3932,166,210,203,320,60,11,10,37,110,11,19,0,0
3933,175,211,212,318,60,11,10,37,107,12,19,0,0
3934,182,215,220,322,60,11,10,38,107,13,19,0,0
3935,195,216,230,317,60,11,10,35,101,14,19,0,0
3936,205,221,242,326,60,11,10,37,105,15,19,0,0
3937,217,223,256,332,60,11,10,39,109,16,19,0,0
3938,232,222,272,335,60,11,10,40,113,17,19,0,0
3939,244,219,286,336,60,11,10,42,117,18,19,0,0
3940,253,220,295,338,60,11,10,42,118,19,19,0,0
4159,552,276,612,505,61,11,10,60,229,0,30,0,1
4160,519,270,581,506,61,11,10,62,236,1,30,0,0
4161,486,264,547,495,61,11,10,61,231,2,30,0,0
4162,440,266,501,491,61,11,10,61,225,3,30,0,0
4163,401,265,461,483,61,11,10,60,218,4,30,0,0
4164,366,259,428,480,61,11,10,62,221,5,30,0,0
4165,339,260,400,478,61,11,10,61,218,6,30,0,0
4166,315,254,374,464,61,11,10,59,210,7,30,0,0
4167,287,253,346,458,61,11,10,59,205,8,30,0,0
4168,262,247,322,455,61,11,10,60,208,9,30,0,0
4169,243,240,304,449,61,11,10,61,209,10,30,0,0
4170,229,241,287,441,61,11,10,58,200,11,30,0,0
4171,209,241,269,439,61,11,10,60,198,12,30,0,0
4172,197,238,255,434,61,11,10,58,196,13,30,0,0
4173,185,239,242,426,61,11,10,57,187,14,30,0,0
4174,176,239,231,422,61,11,10,55,183,15,30,0,0
4175,166,235,221,415,61,11,10,55,180,16,30,0,0
4176,156,235,210,413,61,11,10,54,178,17,30,0,0
4177,149,233,202,404,61,11,10,53,171,18,30,0,0
4178,143,233,194,398,61,11,10,51,165,19,30,0,0
4179,132,232,182,393,61,11,10,50,161,20,30,0,0
4180,124,232,171,386,61,11,10,47,154,21,30,0,0
4181,114,230,161,384,61,11,10,47,154,22,30,0,0
4182,110,233,154,378,61,11,10,44,145,23,30,0,0
4183,102,234,143,370,61,11,10,41,136,24,30,0,0
4184,94,234,134,367,61,11,10,40,133,25,30,0,0
4185,83,230,123,365,61,11,10,40,135,26,30,0,0
4186,72,225,112,358,61,11,10,40,133,27,30,0,0
4187,62,226,102,360,61,11,10,40,134,28,30,0,0
4188,49,225,88,356,61,11,10,39,131,29,30,0,0
4189,38,224,76,351,61,11,10,38,127,30,30,1,0
4281,947,418,1016,685,62,11,10,69,267,0,20,0,0
4282,904,409,994,753,62,11,10,90,344,1,20,0,0
4283,868,407,971,797,62,11,10,103,390,2,20,0,0
4284,849,407,949,784,62,11,10,100,377,3,20,0,0
4285,813,405,917,792,62,11,10,104,387,4,20,0,0
4286,791,404,899,806,62,11,10,108,402,5,20,0,0
4288,695,406,804,793,62,11,10,109,387,0,20,0,0
4289,659,410,770,796,62,11,10,111,386,1,20,0,0
4290,633,410,748,810,62,11,10,115,400,2,20,0,0
4291,588,416,714,840,62,11,10,126,424,3,20,0,0
4292,561,419,690,847,62,11,10,129,428,4,20,0,0
4293,519,428,658,866,62,11,10,139,438,5,20,0,0
4294,493,452,635,896,62,11,10,142,444,6,20,0,0
4295,456,446,607,912,62,11,10,151,466,7,20,0,0
4296,429,455,584,929,62,11,10,155,474,8,20,0,0
4297,410,455,568,932,62,11,10,158,477,9,20,0,0
4298,394,454,554,931,62,11,10,160,477,10,20,0,0
4299,390,455,546,920,62,11,10,156,465,11,20,0,0
4300,378,450,533,920,62,11,10,155,470,12,20,0,0
4301,354,452,511,928,62,11,10,157,476,13,20,0,0
4304,362,443,512,920,62,11,10,150,477,0,20,0,1
4305,364,443,503,904,62,11,10,139,461,1,20,0,0
4306,368,447,491,868,62,11,10,123,421,2,20,0,0
4307,354,448,476,867,62,11,10,122,419,3,20,0,0
4308,310,438,417,794,62,11,10,107,356,4,20,0,0
4309,282,447,419,892,62,11,10,137,445,5,20,0,0
4310,263,456,414,938,62,11,10,151,482,6,20,0,0
4311,261,469,420,979,62,11,10,159,510,7,20,0,0
4312,265,483,430,999,62,11,10,165,516,8,20,0,0
4313,252,496,432,1048,62,11,10,180,552,9,20,0,0
4314,244,509,431,1063,62,11,10,187,554,10,20,0,0
4315,252,528,442,1076,62,11,10,190,548,11,20,0,0
4316,287,561,470,1076,62,11,10,183,515,12,20,0,0
4317,318,580,497,1075,62,11,10,179,495,13,20,0,0
4318,352,604,530,1078,62,11,10,178,474,14,20,0,0
4319,388,653,558,1074,62,11,10,170,421,15,20,0,0
4320,452,693,613,1076,62,11,10,161,383,16,20,0,0
4321,513,728,664,1075,62,11,10,151,347,17,20,0,0
4322,594,772,734,1075,62,11,10,140,303,18,20,0,0
4323,691,810,824,1074,62,11,10,133,264,19,20,0,0
4324,736,838,858,1079,62,11,10,122,241,20,20,1,0
4283,979,393,1019,501,63,11,10,40,108,0,0,0,0
4283,960,394,1019,695,64,11,10,59,301,0,50,0,1
4284,921,389,1002,797,64,11,10,81,408,1,50,0,0
4285,895,390,981,814,64,11,10,86,424,2,50,0,0
4286,854,390,948,833,64,11,10,94,443,3,50,0,0
4287,825,399,926,854,64,11,10,101,455,4,50,0,0
4288,805,396,916,869,64,11,10,111,473,5,50,0,0
4289,785,399,902,885,64,11,10,117,486,6,50,0,0
4290,761,394,885,891,64,11,10,124,497,7,50,0,0
4291,731,403,861,909,64,11,10,130,506,8,50,0,0
4292,712,400,846,913,64,11,10,134,513,9,50,0,0
4293,677,403,817,924,64,11,10,140,521,10,50,0,0
4294,635,411,783,938,64,11,10,148,527,11,50,0,0
4295,599,404,757,950,64,11,10,158,546,12,50,0,0
4296,574,414,734,953,64,11,10,160,539,13,50,0,0
4297,545,424,720,1000,64,11,10,175,576,14,50,0,0
4298,522,426,703,1015,64,11,10,181,589,15,50,0,0
4299,496,424,682,1022,64,11,10,186,598,16,50,0,0
4300,467,426,657,1031,64,11,10,190,605,17,50,0,0
4301,419,419,613,1039,64,11,10,194,620,18,50,0,0
4302,371,416,565,1035,64,11,10,194,619,19,50,0,0
4303,332,418,527,1025,64,11,10,195,607,20,50,0,0
4304,274,414,466,1005,64,11,10,192,591,21,50,0,0
4305,218,404,419,997,64,11,10,201,593,22,50,0,0
4306,229,400,432,992,64,11,10,203,592,23,50,0,0
4307,277,407,481,993,64,11,10,204,586,24,50,0,0
4308,296,418,504,1002,64,11,10,208,584,25,50,0,0
4309,336,427,543,1021,64,11,10,207,594,26,50,0,0
4310,376,435,591,1054,64,11,10,215,619,27,50,0,0
4311,401,434,622,1060,64,11,10,221,626,28,50,0,0
4312,424,444,645,1058,64,11,10,221,614,29,50,0,0
4313,441,451,667,1064,64,11,10,226,613,30,50,0,0
4314,470,458,701,1072,64,11,10,231,614,31,50,0,0
4315,468,466,703,1074,64,11,10,235,608,32,50,0,0
4316,478,466,717,1076,64,11,10,239,610,33,50,0,0
4317,497,471,737,1077,64,11,10,240,606,34,50,0,0
4318,529,487,762,1079,64,11,10,233,592,35,50,0,0
4319,564,501,790,1076,64,11,10,226,575,36,50,0,0
4320,627,526,846,1074,64,11,10,219,548,37,50,0,0
4321,705,544,925,1075,64,11,10,220,531,38,50,0,0
4322,786,587,997,1073,64,11,10,211,486,39,50,0,0
4323,883,623,1087,1075,64,11,10,204,452,40,50,0,0
4324,906,655,1115,1073,64,11,10,209,418,41,50,0,0
4325,1011,696,1214,1073,64,11,10,203,377,42,50,0,0
4326,1141,718,1341,1071,64,11,10,200,353,43,50,0,0
4327,1269,732,1469,1075,64,11,10,200,343,44,50,0,0
4328,1396,779,1578,1072,64,11,10,182,293,45,50,0,0
4329,1529,811,1696,1066,64,11,10,167,255,46,50,0,0
4330,1627,827,1798,1071,64,11,10,171,244,47,50,0,0
4331,1712,847,1876,1068,64,11,10,164,221,48,50,0,0
4332,1764,847,1920,1071,64,11,10,156,224,49,50,0,0
4333,1853,866,1920,1072,64,11,10,67,206,50,50,1,0
4333,1800,935,1920,1076,65,11,10,120,141,0,0,0,0
4339,36,273,109,514,66,11,10,73,241,0,19,0,1
4340,57,273,129,511,66,11,10,72,238,1,19,0,0
4341,80,276,153,513,66,11,10,73,237,2,19,0,0
4342,118,265,190,500,66,11,10,72,235,3,19,0,0
4343,151,267,223,494,66,11,10,72,227,4,19,0,0
4344,173,262,245,488,66,11,10,72,226,5,19,0,0
4345,185,259,256,482,66,11,10,71,223,6,19,0,0
4346,201,259,271,481,66,11,10,70,222,7,19,0,0
4347,224,256,292,467,66,11,10,68,211,8,19,0,0
4348,240,259,304,460,66,11,10,64,201,9,19,0,0
4349,247,256,312,457,66,11,10,65,201,10,19,0,0
4350,258,248,326,453,66,11,10,68,205,11,19,0,0
4351,262,250,329,449,66,11,10,67,199,12,19,0,0
4352,267,245,335,444,66,11,10,68,199,13,19,0,0
4353,272,245,337,435,66,11,10,65,190,14,19,0,0
4354,269,247,332,429,66,11,10,63,182,15,19,0,0
4355,268,246,328,425,66,11,10,60,179,16,19,0,0
4356,271,243,330,423,66,11,10,59,180,17,19,0,0
4357,275,242,332,418,66,11,10,57,176,18,19,0,0
4358,283,240,338,413,66,11,10,55,173,19,19,0,0
4459,179,206,214,300,69,11,10,35,94,0,5,0,0
4460,181,205,216,301,69,11,10,35,96,1,5,0,0
4461,182,207,217,304,69,11,10,35,97,2,5,0,0
4463,184,211,219,307,69,11,10,35,96,0,5,0,0
4465,191,213,226,311,69,11,10,35,98,0,5,0,0
4466,194,214,230,314,69,11,10,36,100,1,5,0,0
4468,203,217,241,325,69,11,10,38,108,0,5,0,0
4469,210,222,249,329,69,11,10,39,107,1,5,0,0
4470,217,219,259,333,69,11,10,42,114,2,5,0,0
4471,229,218,271,335,69,11,10,42,117,3,5,0,0
4472,240,220,282,334,69,11,10,42,114,4,5,0,0
4473,245,221,287,337,69,11,10,42,116,5,5,0,0
4954,128,246,163,361,75,11,10,35,115,0,45,0,1
4955,126,246,161,363,75,11,10,35,117,1,45,0,0
4956,125,249,161,366,75,11,10,36,117,2,45,0,0
4957,126,247,162,366,75,11,10,36,119,3,45,0,0
4958,129,247,165,366,75,11,10,36,119,4,45,0,0
4959,130,249,167,374,75,11,10,37,125,5,45,0,0
4960,134,251,169,370,75,11,10,35,119,6,45,0,0
4961,135,253,173,379,75,11,10,38,126,7,45,0,0
4962,136,258,174,385,75,11,10,38,127,8,45,0,0
4963,136,256,176,390,75,11,10,40,134,9,45,0,0
4964,135,256,178,397,75,11,10,43,141,10,45,0,0
4965,134,259,177,400,75,11,10,43,141,11,45,0,0
4966,134,262,176,402,75,11,10,42,140,12,45,0,0
4967,132,265,176,408,75,11,10,44,143,13,45,0,0
4968,132,256,178,410,75,11,10,46,154,14,45,0,0
4969,128,256,176,412,75,11,10,48,156,15,45,0,0
4970,127,266,175,422,75,11,10,48,156,16,45,0,0
4971,130,269,178,425,75,11,10,48,156,17,45,0,0
4972,132,268,182,435,75,11,10,50,167,18,45,0,0
4973,134,270,184,438,75,11,10,50,168,19,45,0,0
4974,139,273,186,434,75,11,10,47,161,20,45,0,0
4975,142,277,189,437,75,11,10,47,160,21,45,0,0
4976,146,279,194,440,75,11,10,48,161,22,45,0,0
4977,147,278,197,446,75,11,10,50,168,23,45,0,0
4978,147,264,204,455,75,11,10,57,191,24,45,0,0
4979,141,259,202,458,75,11,10,61,199,25,45,0,0
4980,137,255,203,466,75,11,10,66,211,26,45,0,0
4981,140,266,206,473,75,11,10,66,207,27,45,0,0
4982,141,267,207,476,75,11,10,66,209,28,45,0,0
4983,128,256,190,457,75,11,10,62,201,29,45,0,0
4984,115,257,175,451,75,11,10,60,194,30,45,0,0
4985,103,251,163,443,75,11,10,60,192,31,45,0,0
4986,95,250,157,441,75,11,10,62,191,32,45,0,0
4987,96,253,159,444,75,11,10,63,191,33,45,0,0
4988,93,256,158,454,75,11,10,65,198,34,45,0,0
4989,87,261,153,469,75,11,10,66,208,35,45,0,0
4990,74,260,142,474,75,11,10,68,214,36,45,0,0
4991,65,262,135,483,75,11,10,70,221,37,45,0,0
4992,60,266,131,489,75,11,10,71,223,38,45,0,0
4993,66,269,135,490,75,11,10,69,221,39,45,0,0
4994,63,274,131,497,75,11,10,68,223,40,45,0,0
4995,56,275,127,507,75,11,10,71,232,41,45,0,0
4996,39,273,112,512,75,11,10,73,239,42,45,0,0
4997,30,275,102,516,75,11,10,72,241,43,45,0,0
4998,19,287,88,524,75,11,10,69,237,44,45,0,0
4999,13,289,82,529,75,11,10,69,240,45,45,1,0
4963,249,223,288,345,76,11,10,39,122,0,4,0,0
4964,229,215,272,347,76,11,10,43,132,1,4,0,0
4965,215,216,258,350,76,11,10,43,134,2,4,0,0
4966,193,216,235,347,76,11,10,42,131,3,4,0,0
4967,174,216,216,347,76,11,10,42,131,4,4,0,0
4970,108,227,143,337,76,11,10,35,110,0,4,0,0
4971,84,221,124,348,76,11,10,40,127,1,4,0,0
4972,67,219,108,350,76,11,10,41,131,2,4,0,0
4973,46,221,87,356,76,11,10,41,135,3,4,0,0
4974,26,222,68,359,76,11,10,42,137,4,4,0,0
4971,249,241,300,424,77,11,10,51,183,0,47,0,0
4972,245,256,289,413,77,11,10,44,157,1,47,0,0
4973,230,242,278,416,77,11,10,48,174,2,47,0,0
4974,217,235,268,418,77,11,10,51,183,3,47,0,0
4975,204,237,254,418,77,11,10,50,181,4,47,0,0
4976,188,242,237,419,77,11,10,49,177,5,47,0,0
4977,177,248,226,422,77,11,10,49,174,6,47,0,0
4978,166,248,214,423,77,11,10,48,175,7,47,0,0
4983,155,296,208,483,77,11,10,53,187,0,47,0,1
4984,152,299,209,498,77,11,10,57,199,1,47,0,0
4985,153,302,210,498,77,11,10,57,196,2,47,0,0
4986,153,307,211,507,77,11,10,58,200,3,47,0,0
4987,151,309,212,516,77,11,10,61,207,4,47,0,0
4988,153,311,215,521,77,11,10,62,210,5,47,0,0
4989,158,317,220,528,77,11,10,62,211,6,47,0,0
4990,166,317,229,527,77,11,10,63,210,7,47,0,0
4991,173,319,238,539,77,11,10,65,220,8,47,0,0
4992,178,323,244,547,77,11,10,66,224,9,47,0,0
4993,184,325,252,556,77,11,10,68,231,10,47,0,0
4994,190,330,259,563,77,11,10,69,233,11,47,0,0
4995,195,334,266,575,77,11,10,71,241,12,47,0,0
4996,197,333,271,580,77,11,10,74,247,13,47,0,0
4997,198,342,274,599,77,11,10,76,257,14,47,0,0
4998,199,346,277,609,77,11,10,78,263,15,47,0,0
4999,200,350,282,623,77,11,10,82,273,16,47,0,0
5000,203,357,287,640,77,11,10,84,283,17,47,0,0
5001,209,361,294,646,77,11,10,85,285,18,47,0,0
5002,213,365,302,666,77,11,10,89,301,19,47,0,0
5003,215,370,309,689,77,11,10,94,319,20,47,0,0
5004,219,375,313,697,77,11,10,94,322,21,47,0,0
5005,224,381,324,719,77,11,10,100,338,22,47,0,0
5006,231,393,333,738,77,11,10,102,345,23,47,0,0
5007,240,402,343,749,77,11,10,103,347,24,47,0,0
5008,247,408,357,780,77,11,10,110,372,25,47,0,0
5009,259,417,371,797,77,11,10,112,380,26,47,0,0
5010,271,427,386,812,77,11,10,115,385,27,47,0,0
5011,288,438,409,839,77,11,10,121,401,28,47,0,0
5012,308,453,429,850,77,11,10,121,397,29,47,0,0
5013,325,466,453,887,77,11,10,128,421,30,47,0,0
5014,346,483,478,916,77,11,10,132,433,31,47,0,0
5015,370,497,503,929,77,11,10,133,432,32,47,0,0
5016,404,517,547,962,77,11,10,143,445,33,47,0,0
5017,423,533,571,990,77,11,10,148,457,34,47,0,0
5018,445,542,598,1014,77,11,10,153,472,35,47,0,0
5019,471,562,633,1057,77,11,10,162,495,36,47,0,0
5020,507,588,670,1079,77,11,10,163,491,37,47,0,0
5021,547,610,708,1080,77,11,10,161,470,38,47,0,0
5022,591,638,747,1080,77,11,10,156,442,39,47,0,0
5023,644,662,801,1080,77,11,10,157,418,40,47,0,0
5024,709,691,864,1080,77,11,10,155,389,41,47,0,0
5025,780,743,925,1080,77,11,10,145,337,42,47,0,0
5026,859,776,998,1075,77,11,10,139,299,43,47,0,0
5027,955,799,1099,1076,77,11,10,144,277,44,47,0,0
5028,1041,825,1182,1077,77,11,10,141,252,45,47,0,0
5029,1147,849,1285,1076,77,11,10,138,227,46,47,0,0
5030,1218,873,1345,1080,77,11,10,127,207,47,47,1,0
5344,254,213,291,333,81,11,10,37,120,0,12,0,0
5348,215,216,250,329,81,11,10,35,113,0,12,0,0
5349,207,217,243,331,81,11,10,36,114,1,12,0,0
5350,199,214,235,329,81,11,10,36,115,2,12,0,0
5351,193,213,228,323,81,11,10,35,110,3,12,0,0
5352,183,211,219,321,81,11,10,36,110,4,12,0,0
5353,179,207,215,318,81,11,10,36,111,5,12,0,0
5354,173,204,209,316,81,11,10,36,112,6,12,0,0
5355,168,203,205,315,81,11,10,37,112,7,12,0,0
5356,165,202,202,313,81,11,10,37,111,8,12,0,0
5357,161,200,199,312,81,11,10,38,112,9,12,0,0
5358,158,200,194,307,81,11,10,36,107,10,12,0,0
5359,153,198,188,305,81,11,10,35,107,11,12,0,0
5360,149,198,184,305,81,11,10,35,107,12,12,0,0
5348,1564,938,1700,1080,84,11,10,136,142,0,0,0,0
5349,1453,914,1605,1076,85,11,10,152,162,0,1,0,0
5350,1377,869,1574,1079,85,11,10,197,210,1,1,0,0
5350,1075,903,1232,1072,86,11,10,157,169,0,0,0,0
5351,1222,840,1449,1074,90,11,10,227,234,0,172,0,1
5352,1141,800,1399,1067,90,11,10,258,267,1,172,0,0
5353,1053,771,1342,1073,90,11,10,289,302,2,172,0,0
5354,966,743,1279,1076,90,11,10,313,333,3,172,0,0
5355,867,697,1212,1071,90,11,10,345,374,4,172,0,0
5356,794,668,1156,1071,90,11,10,362,403,5,172,0,0
5357,781,703,1111,1074,90,11,10,330,371,6,172,0,0
5358,689,616,1082,1067,90,11,10,393,451,7,172,0,0
5359,681,600,1012,988,90,11,10,331,388,8,172,0,0
5360,626,622,968,1034,90,11,10,342,412,9,172,0,0
5361,585,616,936,1051,90,11,10,351,435,10,172,0,0
5362,506,590,876,1067,90,11,10,370,477,11,172,0,0
5363,450,561,831,1072,90,11,10,381,511,12,172,0,0
5364,418,545,797,1075,90,11,10,379,530,13,172,0,0
5365,395,529,767,1072,90,11,10,372,543,14,172,0,0
5366,382,512,725,1032,90,11,10,343,520,15,172,0,0
5367,363,500,683,1004,90,11,10,320,504,16,172,0,0
5368,349,496,652,994,90,11,10,303,498,17,172,0,0
5369,335,482,617,965,90,11,10,282,483,18,172,0,0
5370,329,475,596,949,90,11,10,267,474,19,172,0,0
5371,330,467,588,939,90,11,10,258,472,20,172,0,0
5372,342,452,587,915,90,11,10,245,463,21,172,0,0
5373,353,443,580,885,90,11,10,227,442,22,172,0,0
5374,358,438,577,878,90,11,10,219,440,23,172,0,0
5375,356,451,557,865,90,11,10,201,414,24,172,0,0
5376,352,441,547,851,90,11,10,195,410,25,172,0,0
5377,349,433,541,846,90,11,10,192,413,26,172,0,0
5378,348,428,536,841,90,11,10,188,413,27,172,0,0
5379,357,423,542,841,90,11,10,185,418,28,172,0,0
5380,367,421,549,842,90,11,10,182,421,29,172,0,0
5381,370,427,547,845,90,11,10,177,418,30,172,0,0
5382,371,428,545,848,90,11,10,174,420,31,172,0,0
5383,375,429,545,846,90,11,10,170,417,32,172,0,0
5384,376,428,544,847,90,11,10,168,419,33,172,0,0
5385,377,430,542,849,90,11,10,165,419,34,172,0,0
5386,377,426,538,840,90,11,10,161,414,35,172,0,0
5387,375,423,531,830,90,11,10,156,407,36,172,0,0
5388,368,420,520,825,90,11,10,152,405,37,172,0,0
5389,363,414,512,820,90,11,10,149,406,38,172,0,0
5390,355,402,499,798,90,11,10,144,396,39,172,0,0
5391,346,393,487,776,90,11,10,141,383,40,172,0,0
5392,333,390,471,771,90,11,10,138,381,41,172,0,0
5393,323,381,459,756,90,11,10,136,375,42,172,0,0
5394,311,375,445,748,90,11,10,134,373,43,172,0,0
5395,306,373,435,738,90,11,10,129,365,44,172,0,0
5396,302,370,431,741,90,11,10,129,371,45,172,0,0
5397,302,368,430,744,90,11,10,128,376,46,172,0,0
5398,301,368,428,747,90,11,10,127,379,47,172,0,0
5399,303,371,428,747,90,11,10,125,376,48,172,0,0
5400,308,374,431,748,90,11,10,123,374,49,172,0,0
5401,310,380,429,750,90,11,10,119,370,50,172,0,0
5402,311,383,428,751,90,11,10,117,368,51,172,0,0
5403,316,387,430,752,90,11,10,114,365,52,172,0,0
5404,317,394,428,752,90,11,10,111,358,53,172,0,0
5405,316,383,431,755,90,11,10,115,372,54,172,0,0
5406,315,374,432,753,90,11,10,117,379,55,172,0,0
5407,315,373,433,755,90,11,10,118,382,56,172,0,0
5408,315,375,430,752,90,11,10,115,377,57,172,0,0
5409,315,379,428,753,90,11,10,113,374,58,172,0,0
5410,316,375,429,752,90,11,10,113,377,59,172,0,0
5411,317,375,429,753,90,11,10,112,378,60,172,0,0
5412,316,374,428,753,90,11,10,112,379,61,172,0,0
5413,316,375,427,753,90,11,10,111,378,62,172,0,0
5414,316,375,426,752,90,11,10,110,377,63,172,0,0
5415,317,380,425,752,90,11,10,108,372,64,172,0,0
5416,315,384,422,752,90,11,10,107,368,65,172,0,0
5417,317,382,423,753,90,11,10,106,371,66,172,0,0
5418,318,383,424,753,90,11,10,106,370,67,172,0,0
5419,318,379,425,753,90,11,10,107,374,68,172,0,0
5420,319,379,426,753,90,11,10,107,374,69,172,0,0
5421,319,379,425,753,90,11,10,106,374,70,172,0,0
5422,318,380,424,754,90,11,10,106,374,71,172,0,0
5423,317,381,423,754,90,11,10,106,373,72,172,0,0
5424,317,381,423,753,90,11,10,106,372,73,172,0,0
5425,317,382,422,753,90,11,10,105,371,74,172,0,0
5426,314,380,421,754,90,11,10,107,374,75,172,0,0
5427,314,379,421,755,90,11,10,107,376,76,172,0,0
5428,313,378,420,755,90,11,10,107,377,77,172,0,0
5429,312,377,420,755,90,11,10,108,378,78,172,0,0
5430,313,379,420,754,90,11,10,107,375,79,172,0,0
5431,312,380,419,755,90,11,10,107,375,80,172,0,0
5432,312,379,419,755,90,11,10,107,376,81,172,0,0
5433,312,379,419,755,90,11,10,107,376,82,172,0,0
5434,311,379,417,755,90,11,10,106,376,83,172,0,0
5435,308,376,416,756,90,11,10,108,380,84,172,0,0
5436,307,374,416,755,90,11,10,109,381,85,172,0,0
5437,308,373,417,754,90,11,10,109,381,86,172,0,0
5438,309,374,418,754,90,11,10,109,380,87,172,0,0
5439,311,376,419,753,90,11,10,108,377,88,172,0,0
5440,312,378,419,753,90,11,10,107,375,89,172,0,0
5441,312,376,420,753,90,11,10,108,377,90,172,0,0
5442,313,382,420,753,90,11,10,107,371,91,172,0,0
5443,315,385,421,754,90,11,10,106,369,92,172,0,0
5444,323,386,432,757,90,11,10,109,371,93,172,0,0
5445,331,387,442,755,90,11,10,111,368,94,172,0,0
5446,330,386,443,757,90,11,10,113,371,95,172,0,0
5447,330,387,445,757,90,11,10,115,370,96,172,0,0
5448,330,391,444,755,90,11,10,114,364,97,172,0,0
5449,324,393,436,756,90,11,10,112,363,98,172,0,0
5450,322,398,431,756,90,11,10,109,358,99,172,0,0
5451,324,393,433,755,90,11,10,109,362,100,172,0,0
5452,325,392,432,755,90,11,10,107,363,101,172,0,0
5453,326,392,432,755,90,11,10,106,363,102,172,0,0
5454,328,393,432,754,90,11,10,104,361,103,172,0,0
5455,328,392,431,756,90,11,10,103,364,104,172,0,0
5456,329,392,431,757,90,11,10,102,365,105,172,0,0
5457,329,392,430,757,90,11,10,101,365,106,172,0,0
5458,329,391,428,756,90,11,10,99,365,107,172,0,0
5459,328,390,428,758,90,11,10,100,368,108,172,0,0
5460,329,391,428,757,90,11,10,99,366,109,172,0,0
5461,328,391,426,756,90,11,10,98,365,110,172,0,0
5462,328,392,425,756,90,11,10,97,364,111,172,0,0
5463,329,390,426,754,90,11,10,97,364,112,172,0,0
5464,328,402,423,755,90,11,10,95,353,113,172,0,0
5465,326,404,423,758,90,11,10,97,354,114,172,0,0
5466,325,393,426,760,90,11,10,101,367,115,172,0,0
5467,323,387,427,760,90,11,10,104,373,116,172,0,0
5468,321,383,428,760,90,11,10,107,377,117,172,0,0
5469,321,382,429,760,90,11,10,108,378,118,172,0,0
5470,321,383,430,760,90,11,10,109,377,119,172,0,0
5471,322,386,431,763,90,11,10,109,377,120,172,0,0
5472,324,387,432,765,90,11,10,108,378,121,172,0,0
5473,323,387,432,766,90,11,10,109,379,122,172,0,0
5474,323,387,431,766,90,11,10,108,379,123,172,0,0
5475,326,393,431,764,90,11,10,105,371,124,172,0,0
5476,326,390,431,763,90,11,10,105,373,125,172,0,0
5477,326,390,431,761,90,11,10,105,371,126,172,0,0
5478,325,388,430,759,90,11,10,105,371,127,172,0,0
5479,323,384,430,761,90,11,10,107,377,128,172,0,0
5480,329,397,431,760,90,11,10,102,363,129,172,0,0
5481,335,398,437,761,90,11,10,102,363,130,172,0,0
5482,345,398,450,767,90,11,10,105,369,131,172,0,0
5483,355,390,466,770,90,11,10,111,380,132,172,0,0
5484,403,378,515,752,90,11,10,112,374,133,172,0,0
5485,412,366,534,774,90,11,10,122,408,134,172,0,0
5486,433,420,548,797,90,11,10,115,377,135,172,0,0
5487,449,414,566,803,90,11,10,117,389,136,172,0,0
5488,473,412,593,806,90,11,10,120,394,137,172,0,0
5489,490,413,612,806,90,11,10,122,393,138,172,0,0
5490,504,413,628,804,90,11,10,124,391,139,172,0,0
5491,536,416,657,789,90,11,10,121,373,140,172,0,0
5492,564,412,688,787,90,11,10,124,375,141,172,0,0
5493,596,420,723,783,90,11,10,127,363,142,172,0,0
5494,658,418,785,781,90,11,10,127,363,143,172,0,0
5495,702,416,832,781,90,11,10,130,365,144,172,0,0
5496,750,419,873,766,90,11,10,123,347,145,172,0,0
5497,786,410,911,760,90,11,10,125,350,146,172,0,0
5498,815,414,936,751,90,11,10,121,337,147,172,0,0
5499,850,415,965,737,90,11,10,115,322,148,172,0,0
5500,870,419,980,728,90,11,10,110,309,149,172,0,0
5501,876,412,985,724,90,11,10,109,312,150,172,0,0
5502,876,408,985,720,90,11,10,109,312,151,172,0,0
5503,878,402,987,714,90,11,10,109,312,152,172,0,0
5504,874,399,983,709,90,11,10,109,310,153,172,0,0
5505,873,399,984,708,90,11,10,111,309,154,172,0,0
5506,872,395,985,708,90,11,10,113,313,155,172,0,0
5507,871,393,986,706,90,11,10,115,313,156,172,0,0
5508,876,392,989,702,90,11,10,113,310,157,172,0,0
5509,872,388,987,704,90,11,10,115,316,158,172,0,0
5510,872,385,990,706,90,11,10,118,321,159,172,0,0
5511,871,385,989,705,90,11,10,118,320,160,172,0,0
5512,874,389,989,704,90,11,10,115,315,161,172,0,0
5513,872,391,987,706,90,11,10,115,315,162,172,0,0
5514,875,393,989,707,90,11,10,114,314,163,172,0,0
5515,882,393,993,707,90,11,10,111,314,164,172,0,0
5516,880,395,991,713,90,11,10,111,318,165,172,0,0
5517,883,400,990,714,90,11,10,107,314,166,172,0,0
5518,881,407,983,710,90,11,10,102,303,167,172,0,0
5519,884,418,975,695,90,11,10,91,277,168,172,0,0
5520,885,420,969,683,90,11,10,84,263,169,172,0,0
5521,880,421,961,683,90,11,10,81,262,170,172,0,0
5522,886,421,956,657,90,11,10,70,236,171,172,0,0
5523,888,423,955,651,90,11,10,67,228,172,172,1,0
5354,1159,866,1341,1078,93,11,10,182,212,0,0,0,0
5355,1048,797,1262,1075,94,11,10,214,278,0,1,0,0
5356,971,757,1212,1071,94,11,10,241,314,1,1,0,0
5357,848,639,1018,916,95,11,10,170,277,0,0,0,0
5358,652,516,847,1001,96,11,10,195,485,0,136,0,1
5359,669,496,841,926,96,11,10,172,430,1,136,0,0
5360,741,494,888,853,96,11,10,147,359,2,136,0,0
5361,773,485,942,882,96,11,10,169,397,3,136,0,0
5362,767,478,993,1008,96,11,10,226,530,4,136,0,0
5363,750,453,1007,1052,96,11,10,257,599,5,136,0,0
5364,728,504,958,1047,96,11,10,230,543,6,136,0,0
5365,706,525,917,1024,96,11,10,211,499,7,136,0,0
5366,700,536,900,1009,96,11,10,200,473,8,136,0,0
5367,697,531,894,1002,96,11,10,197,471,9,136,0,0
5368,692,529,889,1000,96,11,10,197,471,10,136,0,0
5369,691,532,885,999,96,11,10,194,467,11,136,0,0
5370,688,536,879,998,96,11,10,191,462,12,136,0,0
5371,687,540,874,995,96,11,10,187,455,13,136,0,0
5372,687,541,873,999,96,11,10,186,458,14,136,0,0
5373,690,543,874,998,96,11,10,184,455,15,136,0,0
5374,690,539,873,996,96,11,10,183,457,16,136,0,0
5375,690,536,873,997,96,11,10,183,461,17,136,0,0
5376,690,535,873,997,96,11,10,183,462,18,136,0,0
5377,693,536,874,994,96,11,10,181,458,19,136,0,0
5378,692,535,872,993,96,11,10,180,458,20,136,0,0
5379,693,536,871,992,96,11,10,178,456,21,136,0,0
5380,678,540,858,994,96,11,10,180,454,22,136,0,0
5381,668,533,847,991,96,11,10,179,458,23,136,0,0
5382,653,529,825,969,96,11,10,172,440,24,136,0,0
5383,636,515,809,961,96,11,10,173,446,25,136,0,0
5384,624,512,795,959,96,11,10,171,447,26,136,0,0
5385,613,512,782,957,96,11,10,169,445,27,136,0,0
5386,604,499,769,941,96,11,10,165,442,28,136,0,0
5387,602,494,759,916,96,11,10,157,422,29,136,0,0
5388,588,486,742,897,96,11,10,154,411,30,136,0,0
5389,585,480,737,887,96,11,10,152,407,31,136,0,0
5390,584,405,767,883,96,11,10,183,478,32,136,0,0
5391,590,375,781,855,96,11,10,191,480,33,136,0,0
5392,594,368,792,846,96,11,10,198,478,34,136,0,0
5393,592,356,802,848,96,11,10,210,492,35,136,0,0
5394,566,425,746,855,96,11,10,180,430,36,136,0,0
5395,566,467,729,858,96,11,10,163,391,37,136,0,0
5396,563,453,729,860,96,11,10,166,407,38,136,0,0
5397,566,436,736,862,96,11,10,170,426,39,136,0,0
5398,571,446,736,864,96,11,10,165,418,40,136,0,0
5399,572,466,728,866,96,11,10,156,400,41,136,0,0
5400,572,477,722,866,96,11,10,150,389,42,136,0,0
5401,572,469,721,863,96,11,10,149,394,43,136,0,0
5402,571,468,718,855,96,11,10,147,387,44,136,0,0
5403,573,458,723,850,96,11,10,150,392,45,136,0,0
5404,573,457,723,846,96,11,10,150,389,46,136,0,0
5405,573,464,722,845,96,11,10,149,381,47,136,0,0
5406,565,427,728,844,96,11,10,163,417,48,136,0,0
5407,571,458,723,842,96,11,10,152,384,49,136,0,0
5408,570,470,720,843,96,11,10,150,373,50,136,0,0
5409,571,473,720,841,96,11,10,149,368,51,136,0,0
5410,570,470,722,844,96,11,10,152,374,52,136,0,0
5411,567,449,728,843,96,11,10,161,394,53,136,0,0
5412,566,437,731,842,96,11,10,165,405,54,136,0,0
5413,559,407,738,847,96,11,10,179,440,55,136,0,0
5414,556,391,739,844,96,11,10,183,453,56,136,0,0
5415,558,403,736,845,96,11,10,178,442,57,136,0,0
5416,563,431,729,844,96,11,10,166,413,58,136,0,0
5417,565,443,724,841,96,11,10,159,398,59,136,0,0
5418,562,443,719,839,96,11,10,157,396,60,136,0,0
5419,563,438,720,837,96,11,10,157,399,61,136,0,0
5420,565,455,716,839,96,11,10,151,384,62,136,0,0
5421,564,459,713,836,96,11,10,149,377,63,136,0,0
5422,561,463,708,834,96,11,10,147,371,64,136,0,0
5423,556,430,714,831,96,11,10,158,401,65,136,0,0
5424,560,420,723,836,96,11,10,163,416,66,136,0,0
5425,560,408,726,834,96,11,10,166,426,67,136,0,0
5426,560,410,722,833,96,11,10,162,423,68,136,0,0
5427,560,425,717,835,96,11,10,157,410,69,136,0,0
5428,562,435,714,835,96,11,10,152,400,70,136,0,0
5429,563,437,714,835,96,11,10,151,398,71,136,0,0
5430,563,432,715,836,96,11,10,152,404,72,136,0,0
5431,565,459,709,838,96,11,10,144,379,73,136,0,0
5432,564,455,711,838,96,11,10,147,383,74,136,0,0
5433,565,468,708,839,96,11,10,143,371,75,136,0,0
5434,564,452,711,835,96,11,10,147,383,76,136,0,0
5435,564,468,707,837,96,11,10,143,369,77,136,0,0
5436,564,472,707,838,96,11,10,143,366,78,136,0,0
5437,563,460,710,836,96,11,10,147,376,79,136,0,0
5438,562,462,709,836,96,11,10,147,374,80,136,0,0
5439,563,479,705,839,96,11,10,142,360,81,136,0,0
5440,564,484,705,839,96,11,10,141,355,82,136,0,0
5441,564,439,720,834,96,11,10,156,395,83,136,0,0
5442,562,459,712,837,96,11,10,150,378,84,136,0,0
5443,558,460,708,840,96,11,10,150,380,85,136,0,0
5444,555,458,705,842,96,11,10,150,384,86,136,0,0
5445,562,442,718,842,96,11,10,156,400,87,136,0,0
5446,573,438,733,850,96,11,10,160,412,88,136,0,0
5447,582,422,748,853,96,11,10,166,431,89,136,0,0
5448,588,394,764,859,96,11,10,176,465,90,136,0,0
5449,599,408,769,859,96,11,10,170,451,91,136,0,0
5450,606,398,780,857,96,11,10,174,459,92,136,0,0
5451,605,400,778,858,96,11,10,173,458,93,136,0,0
5452,607,446,765,859,96,11,10,158,413,94,136,0,0
5453,587,428,752,860,96,11,10,165,432,95,136,0,0
5454,579,428,744,860,96,11,10,165,432,96,136,0,0
5455,569,429,732,859,96,11,10,163,430,97,136,0,0
5456,554,458,709,865,96,11,10,155,407,98,136,0,0
5457,537,474,688,874,96,11,10,151,400,99,136,0,0
5458,515,499,661,884,96,11,10,146,385,100,136,0,0
5459,497,501,643,890,96,11,10,146,389,101,136,0,0
5460,483,512,625,892,96,11,10,142,380,102,136,0,0
5461,486,518,623,885,96,11,10,137,367,103,136,0,0
5462,478,512,620,892,96,11,10,142,380,104,136,0,0
5463,481,508,623,893,96,11,10,142,385,105,136,0,0
5464,484,506,622,891,96,11,10,138,385,106,136,0,0
5465,488,509,617,872,96,11,10,129,363,107,136,0,0
5466,495,509,625,870,96,11,10,130,361,108,136,0,0
5467,500,511,630,871,96,11,10,130,360,109,136,0,0
5468,500,515,627,866,96,11,10,127,351,110,136,0,0
5469,502,490,637,867,96,11,10,135,377,111,136,0,0
5470,494,487,627,864,96,11,10,133,377,112,136,0,0
5471,496,443,646,876,96,11,10,150,433,113,136,0,0
5472,492,403,655,886,96,11,10,163,483,114,136,0,0
5473,491,376,661,887,96,11,10,170,511,115,136,0,0
5474,491,371,661,892,96,11,10,170,521,116,136,0,0
5475,503,434,652,891,96,11,10,149,457,117,136,0,0
5476,519,465,661,897,96,11,10,142,432,118,136,0,0
5477,533,472,675,903,96,11,10,142,431,119,136,0,0
5478,552,482,692,902,96,11,10,140,420,120,136,0,0
5479,581,472,723,892,96,11,10,142,420,121,136,0,0
5480,610,469,754,882,96,11,10,144,413,122,136,0,0
5481,629,478,768,869,96,11,10,139,391,123,136,0,0
5482,657,474,798,871,96,11,10,141,397,124,136,0,0
5483,688,479,825,866,96,11,10,137,387,125,136,0,0
5484,706,473,844,862,96,11,10,138,389,126,136,0,0
5485,734,466,867,840,96,11,10,133,374,127,136,0,0
5486,758,461,889,825,96,11,10,131,364,128,136,0,0
5487,777,464,909,818,96,11,10,132,354,129,136,0,0
5488,820,456,955,806,96,11,10,135,350,130,136,0,0
5489,855,453,992,808,96,11,10,137,355,131,136,0,0
5490,874,455,1010,810,96,11,10,136,355,132,136,0,0
5491,884,448,1016,795,96,11,10,132,347,133,136,0,0
5492,907,450,1025,766,96,11,10,118,316,134,136,0,0
5493,916,444,1029,755,96,11,10,113,311,135,136,0,0
5494,935,441,1046,746,96,11,10,111,305,136,136,1,0
5498,963,436,1028,624,96,11,10,65,188,0,136,0,0
5499,958,421,1023,615,96,11,10,65,194,1,136,0,0
5500,963,430,1020,603,96,11,10,57,173,2,136,0,0
5501,964,427,1019,599,96,11,10,55,172,3,136,0,0
5502,962,421,1019,605,96,11,10,57,184,4,136,0,0
5503,965,421,1019,596,96,11,10,54,175,5,136,0,0
5504,971,418,1022,587,96,11,10,51,169,6,136,0,0
5364,727,437,857,680,97,11,10,130,243,0,26,0,1
5365,729,427,857,666,97,11,10,128,239,1,26,0,0
5366,724,420,854,661,97,11,10,130,241,2,26,0,0
5367,700,408,838,666,97,11,10,138,258,3,26,0,0
5368,698,401,834,657,97,11,10,136,256,4,26,0,0
5369,668,399,827,702,97,11,10,159,303,5,26,0,0
5370,630,398,812,754,97,11,10,182,356,6,26,0,0
5371,608,393,798,775,97,11,10,190,382,7,26,0,0
5372,603,390,790,779,97,11,10,187,389,8,26,0,0
5373,586,392,766,776,97,11,10,180,384,9,26,0,0
5374,579,391,754,775,97,11,10,175,384,10,26,0,0
5375,557,386,732,776,97,11,10,175,390,11,26,0,0
5376,564,385,733,774,97,11,10,169,389,12,26,0,0
5377,568,385,732,774,97,11,10,164,389,13,26,0,0
5378,570,386,730,774,97,11,10,160,388,14,26,0,0
5379,572,388,727,772,97,11,10,155,384,15,26,0,0
5380,576,389,728,772,97,11,10,152,383,16,26,0,0
5381,579,391,726,767,97,11,10,147,376,17,26,0,0
5382,580,391,721,757,97,11,10,141,366,18,26,0,0
5383,578,389,713,748,97,11,10,135,359,19,26,0,0
5384,579,384,713,748,97,11,10,134,364,20,26,0,0
5385,584,383,710,728,97,11,10,126,345,21,26,0,0
5386,587,383,701,697,97,11,10,114,314,22,26,0,0
5387,589,388,689,662,97,11,10,100,274,23,26,0,0
5388,597,382,690,632,97,11,10,93,250,24,26,0,0
5389,617,375,716,601,97,11,10,99,226,25,26,0,0
5390,621,373,714,586,97,11,10,93,213,26,26,1,0
5404,640,388,724,572,97,11,10,84,184,0,26,0,0
5405,642,389,724,570,97,11,10,82,181,1,26,0,0
5407,623,388,720,580,97,11,10,97,192,0,26,0,0
5408,620,383,716,568,97,11,10,96,185,1,26,0,0
5409,609,378,711,569,97,11,10,102,191,2,26,0,0
5410,608,377,709,559,97,11,10,101,182,3,26,0,0
5411,608,377,707,557,97,11,10,99,180,4,26,0,0
5399,641,400,748,723,99,11,10,107,323,0,17,0,0
5400,644,406,757,749,99,11,10,113,343,1,17,0,0
5401,643,405,751,727,99,11,10,108,322,2,17,0,0
5402,644,405,750,723,99,11,10,106,318,3,17,0,0
5417,640,393,756,743,99,11,10,116,350,0,17,0,0
5418,643,392,757,740,99,11,10,114,348,1,17,0,0
5419,647,401,755,740,99,11,10,108,339,2,17,0,0
5420,639,391,747,735,99,11,10,108,344,3,17,0,0
5421,638,391,746,735,99,11,10,108,344,4,17,0,0
5428,635,392,736,705,99,11,10,101,313,0,17,0,0
5429,637,393,738,706,99,11,10,101,313,1,17,0,0
5430,636,393,738,704,99,11,10,102,311,2,17,0,0
5431,635,393,741,719,99,11,10,106,326,3,17,0,0
5432,634,392,740,719,99,11,10,106,327,4,17,0,0
5433,627,382,743,741,99,11,10,116,359,5,17,0,0
5434,635,390,741,723,99,11,10,106,333,6,17,0,0
5435,629,383,739,729,99,11,10,110,346,7,17,0,0
5436,636,392,740,721,99,11,10,104,329,8,17,0,0
5437,639,394,739,713,99,11,10,100,319,9,17,0,0
5438,642,397,740,714,99,11,10,98,317,10,17,0,0
5439,636,388,738,714,99,11,10,102,326,11,17,0,0
5440,634,388,739,725,99,11,10,105,337,12,17,0,0
5441,634,387,738,725,99,11,10,104,338,13,17,0,0
5442,635,385,745,746,99,11,10,110,361,14,17,0,0
5443,642,392,751,755,99,11,10,109,363,15,17,0,0
5444,651,396,755,746,99,11,10,104,350,16,17,0,0
5445,652,396,756,748,99,11,10,104,352,17,17,0,0
5455,646,382,743,712,99,11,10,97,330,0,17,0,0
5456,633,383,738,743,99,11,10,105,360,1,17,0,0
5457,627,379,732,743,99,11,10,105,364,2,17,0,0
5458,622,376,728,743,99,11,10,106,367,3,17,0,0
5459,614,376,721,744,99,11,10,107,368,4,17,0,0
5460,604,375,711,744,99,11,10,107,369,5,17,0,0
5461,589,374,700,745,99,11,10,111,371,6,17,0,0
5462,592,376,700,742,99,11,10,108,366,7,17,0,0
5463,592,377,699,742,99,11,10,107,365,8,17,0,0
5464,589,376,696,741,99,11,10,107,365,9,17,0,0
5465,581,372,689,740,99,11,10,108,368,10,17,0,0
5466,581,374,686,736,99,11,10,105,362,11,17,0,0
5467,569,372,681,751,99,11,10,112,379,12,17,0,0
5468,556,371,678,773,99,11,10,122,402,13,17,0,0
5469,561,374,670,737,99,11,10,109,363,14,17,0,0
5470,564,379,655,677,99,11,10,91,298,15,17,0,0
5471,561,382,638,621,99,11,10,77,239,16,17,0,0
5472,559,383,630,607,99,11,10,71,224,17,17,0,0
5452,632,385,758,599,100,11,10,126,214,0,0,0,0
5475,911,378,992,685,101,11,10,81,307,0,13,0,0
5476,909,378,991,688,101,11,10,82,310,1,13,0,0
5477,913,377,997,692,101,11,10,84,315,2,13,0,0
5478,915,376,1001,695,101,11,10,86,319,3,13,0,0
5479,916,378,1002,694,101,11,10,86,316,4,13,0,0
5480,916,380,1003,695,101,11,10,87,315,5,13,0,0
5481,918,382,1005,694,101,11,10,87,312,6,13,0,0
5482,920,383,1008,695,101,11,10,88,312,7,13,0,0
5483,927,381,1015,693,101,11,10,88,312,8,13,0,0
5484,934,385,1020,687,101,11,10,86,302,9,13,0,0
5485,938,386,1022,681,101,11,10,84,295,10,13,0,0
5486,946,384,1027,673,101,11,10,81,289,11,13,0,0
5487,952,399,1022,656,101,11,10,70,257,12,13,0,0
5488,956,402,1024,651,101,11,10,68,249,13,13,0,0
5475,515,368,631,600,102,11,10,116,232,0,11,0,0
5476,480,367,649,708,102,11,10,169,341,1,11,0,0
5477,469,365,645,723,102,11,10,176,358,2,11,0,0
5478,461,365,639,732,102,11,10,178,367,3,11,0,0
5479,441,364,619,732,102,11,10,178,368,4,11,0,0
5480,444,368,616,731,102,11,10,172,363,5,11,0,0
5481,441,370,610,731,102,11,10,169,361,6,11,0,0
5482,437,374,601,731,102,11,10,164,357,7,11,0,0
5483,428,367,591,730,102,11,10,163,363,8,11,0,0
5484,419,367,586,738,102,11,10,167,371,9,11,0,0
5487,331,358,492,717,102,11,10,161,359,0,11,0,0
5488,291,359,456,721,102,11,10,165,362,1,11,0,0
5489,286,360,445,715,102,11,10,159,355,2,11,0,0
5490,274,356,431,709,102,11,10,157,353,3,11,0,0
5491,238,349,391,698,102,11,10,153,349,4,11,0,0
5492,208,352,357,696,102,11,10,149,344,5,11,0,0
5493,166,347,311,687,102,11,10,145,340,6,11,0,0
5494,128,341,268,672,102,11,10,140,331,7,11,0,0
5495,94,346,227,661,102,11,10,133,315,8,11,0,0
5496,51,336,181,649,102,11,10,130,313,9,11,0,0
5497,22,332,151,647,102,11,10,129,315,10,11,0,0
5498,0,330,122,642,102,11,10,122,312,11,11,0,0
5486,306,360,538,764,103,11,10,232,404,0,0,0,0
5537,254,231,289,335,104,11,10,35,104,0,16,0,0
5538,245,229,280,335,104,11,10,35,106,1,16,0,0
5539,232,226,269,335,104,11,10,37,109,2,16,0,0
5540,218,228,254,335,104,11,10,36,107,3,16,0,0
5541,210,227,247,336,104,11,10,37,109,4,16,0,0
5542,196,229,232,332,104,11,10,36,103,5,16,0,0
5543,186,224,223,330,104,11,10,37,106,6,16,0,0
5544,177,217,215,328,104,11,10,38,111,7,16,0,0
5545,170,214,210,329,104,11,10,40,115,8,16,0,0
5546,168,210,208,326,104,11,10,40,116,9,16,0,0
5547,166,210,205,323,104,11,10,39,113,10,16,0,0
5548,164,208,203,321,104,11,10,39,113,11,16,0,0
5549,162,207,200,317,104,11,10,38,110,12,16,0,0
5550,162,209,198,315,104,11,10,36,106,13,16,0,0
5551,161,209,197,315,104,11,10,36,106,14,16,0,0
5552,161,208,196,311,104,11,10,35,103,15,16,0,0
5553,159,208,194,309,104,11,10,35,101,16,16,0,0
5783,557,291,628,547,105,11,10,71,256,0,20,0,1
5784,527,292,599,551,105,11,10,72,259,1,20,0,0
5785,507,300,580,552,105,11,10,73,252,2,20,0,0
5786,475,296,549,554,105,11,10,74,258,3,20,0,0
5787,440,297,518,564,105,11,10,78,267,4,20,0,0
5788,408,296,488,572,105,11,10,80,276,5,20,0,0
5789,371,293,454,576,105,11,10,83,283,6,20,0,0
5790,338,293,426,582,105,11,10,88,289,7,20,0,0
5791,311,293,400,581,105,11,10,89,288,8,20,0,0
5792,289,295,378,583,105,11,10,89,288,9,20,0,0
5793,264,295,353,587,105,11,10,89,292,10,20,0,0
5794,234,291,323,587,105,11,10,89,296,11,20,0,0
5795,204,292,297,595,105,11,10,93,303,12,20,0,0
5796,190,294,284,596,105,11,10,94,302,13,20,0,0
5797,163,292,253,588,105,11,10,90,296,14,20,0,0
5798,134,297,224,590,105,11,10,90,293,15,20,0,0
5799,115,304,210,604,105,11,10,95,300,16,20,0,0
5800,82,301,176,608,105,11,10,94,307,17,20,0,0
5801,48,304,142,610,105,11,10,94,306,18,20,0,0
5802,29,307,123,609,105,11,10,94,302,19,20,0,0
5803,2,308,97,612,105,11,10,95,304,20,20,1,0
744,1504,2,1558,105,1,11,11,54,103,0,0,0,0
746,1490,0,1562,118,2,11,11,72,118,0,0,0,0
749,1456,0,1555,174,3,11,11,99,174,0,24,0,1
750,1448,0,1557,192,3,11,11,109,192,1,24,0,0
751,1447,0,1557,195,3,11,11,110,195,2,24,0,0
752,1438,1,1558,213,3,11,11,120,212,3,24,0,0
753,1432,2,1562,233,3,11,11,130,231,4,24,0,0
754,1427,2,1566,251,3,11,11,139,249,5,24,0,0
755,1415,0,1571,285,3,11,11,156,285,6,24,0,0
756,1410,1,1572,300,3,11,11,162,299,7,24,0,0
757,1398,0,1578,339,3,11,11,180,339,8,24,0,0
758,1389,2,1580,371,3,11,11,191,369,9,24,0,0
759,1379,2,1578,394,3,11,11,199,392,10,24,0,0
760,1358,6,1579,450,3,11,11,221,444,11,24,0,0
761,1343,7,1571,476,3,11,11,228,469,12,24,0,0
762,1326,12,1574,532,3,11,11,248,520,13,24,0,0
763,1309,35,1571,596,3,11,11,262,561,14,24,0,0
764,1294,48,1561,631,3,11,11,267,583,15,24,0,0
765,1265,79,1556,729,3,11,11,291,650,16,24,0,0
766,1240,106,1537,783,3,11,11,297,677,17,24,0,0
767,1200,135,1528,899,3,11,11,328,764,18,24,0,0
768,1173,204,1509,998,3,11,11,336,794,19,24,0,0
769,1148,249,1487,1051,3,11,11,339,802,20,24,0,0
770,1132,345,1450,1077,3,11,11,318,732,21,24,0,0
771,1086,464,1368,1079,3,11,11,282,615,22,24,0,0
772,1021,611,1265,1080,3,11,11,244,469,23,24,0,0
773,999,651,1241,1080,3,11,11,242,429,24,24,1,0
1804,1725,562,1919,1077,4,11,11,194,515,0,58,0,1
1805,1677,482,1900,1070,4,11,11,223,588,1,58,0,0
1806,1595,475,1823,1069,4,11,11,228,594,2,58,0,0
1807,1480,458,1721,1075,4,11,11,241,617,3,58,0,0
1808,1375,444,1623,1066,4,11,11,248,622,4,58,0,0
1809,1294,427,1551,1069,4,11,11,257,642,5,58,0,0
1810,1194,400,1462,1070,4,11,11,268,670,6,58,0,0
1811,1119,384,1401,1076,4,11,11,282,692,7,58,0,0
1812,1056,404,1342,1076,4,11,11,286,672,8,58,0,0
1813,970,408,1262,1072,4,11,11,292,664,9,58,0,0
1814,880,398,1184,1076,4,11,11,304,678,10,58,0,0
1815,834,387,1150,1076,4,11,11,316,689,11,58,0,0
1816,784,367,1107,1069,4,11,11,323,702,12,58,0,0
1817,742,353,1063,1049,4,11,11,321,696,13,58,0,0
1818,717,349,1036,1029,4,11,11,319,680,14,58,0,0
1819,682,356,1003,1015,4,11,11,321,659,15,58,0,0
1820,653,369,961,977,4,11,11,308,608,16,58,0,0
1821,624,391,909,932,4,11,11,285,541,17,58,0,0
1822,601,383,895,934,4,11,11,294,551,18,58,0,0
1823,615,374,899,896,4,11,11,284,522,19,58,0,0
1824,626,357,895,852,4,11,11,269,495,20,58,0,0
1825,633,344,916,867,4,11,11,283,523,21,58,0,0
1826,646,338,933,869,4,11,11,287,531,22,58,0,0
1827,650,328,950,887,4,11,11,300,559,23,58,0,0
1828,649,333,936,870,4,11,11,287,537,24,58,0,0
1829,652,335,948,893,4,11,11,296,558,25,58,0,0
1830,655,335,922,838,4,11,11,267,503,26,58,0,0
1831,655,337,930,858,4,11,11,275,521,27,58,0,0
1832,654,340,917,838,4,11,11,263,498,28,58,0,0
1833,653,340,911,831,4,11,11,258,491,29,58,0,0
1834,648,340,907,834,4,11,11,259,494,30,58,0,0
1835,649,342,918,857,4,11,11,269,515,31,58,0,0
1836,649,344,914,852,4,11,11,265,508,32,58,0,0
1837,650,344,918,862,4,11,11,268,518,33,58,0,0
1838,651,343,916,860,4,11,11,265,517,34,58,0,0
1839,654,340,936,897,4,11,11,282,557,35,58,0,0
1840,674,342,945,874,4,11,11,271,532,36,58,0,0
1841,675,341,988,950,4,11,11,313,609,37,58,0,0
1842,694,342,988,896,4,11,11,294,554,38,58,0,0
1843,715,334,1047,949,4,11,11,332,615,39,58,0,0
1844,738,344,1075,969,4,11,11,337,625,40,58,0,0
1845,742,340,1086,978,4,11,11,344,638,41,58,0,0
1846,748,348,1111,1031,4,11,11,363,683,42,58,0,0
1847,753,374,1117,1061,4,11,11,364,687,43,58,0,0
1848,736,395,1098,1071,4,11,11,362,676,44,58,0,0
1849,727,408,1093,1075,4,11,11,366,667,45,58,0,0
1850,763,418,1141,1080,4,11,11,378,662,46,58,0,0
1851,810,419,1193,1080,4,11,11,383,661,47,58,0,0
1852,849,406,1235,1074,4,11,11,386,668,48,58,0,0
1853,902,403,1288,1072,4,11,11,386,669,49,58,0,0
1854,968,429,1340,1073,4,11,11,372,644,50,58,0,0
1855,1063,442,1421,1068,4,11,11,358,626,51,58,0,0
1856,1172,453,1518,1066,4,11,11,346,613,52,58,0,0
1857,1281,459,1618,1067,4,11,11,337,608,53,58,0,0
1858,1397,444,1734,1067,4,11,11,337,623,54,58,0,0
1859,1498,428,1840,1073,4,11,11,342,645,55,58,0,0
1860,1583,439,1918,1075,4,11,11,335,636,56,58,0,0
1861,1678,529,1920,1079,4,11,11,242,550,57,58,0,0
1862,1743,541,1920,1080,4,11,11,177,539,58,58,1,0
1820,844,671,1054,993,5,11,11,210,322,0,0,0,0
1820,602,388,741,528,6,11,11,139,140,0,0,0,0
1862,1855,671,1918,1080,7,11,11,63,409,0,0,0,0
2773,1431,1,1479,98,8,11,11,48,97,0,0,0,0
2776,1418,0,1466,118,9,11,11,48,118,0,31,0,1
2777,1421,0,1480,144,9,11,11,59,144,1,31,0,0
2778,1415,0,1476,147,9,11,11,61,147,2,31,0,0
2779,1417,0,1478,147,9,11,11,61,147,3,31,0,0
2780,1426,2,1496,170,9,11,11,70,168,4,31,0,0
2781,1422,3,1498,181,9,11,11,76,178,5,31,0,0
2782,1407,6,1492,206,9,11,11,85,200,6,31,0,0
2783,1403,3,1494,217,9,11,11,91,214,7,31,0,0
2784,1404,4,1498,225,9,11,11,94,221,8,31,0,0
2785,1393,6,1501,255,9,11,11,108,249,9,31,0,0
2786,1381,5,1494,266,9,11,11,113,261,10,31,0,0
2787,1371,3,1498,294,9,11,11,127,291,11,31,0,0
2788,1352,3,1487,316,9,11,11,135,313,12,31,0,0
2789,1345,1,1494,340,9,11,11,149,339,13,31,0,0
2790,1329,0,1494,374,9,11,11,165,374,14,31,0,0
2791,1322,5,1494,391,9,11,11,172,386,15,31,0,0
2792,1318,7,1505,424,9,11,11,187,417,16,31,0,0
2793,1307,5,1514,467,9,11,11,207,462,17,31,0,0
2794,1294,8,1510,482,9,11,11,216,474,18,31,0,0
2795,1285,13,1521,534,9,11,11,236,521,19,31,0,0
2796,1287,23,1533,566,9,11,11,246,543,20,31,0,0
2797,1281,30,1545,616,9,11,11,264,586,21,31,0,0
2798,1271,42,1556,675,9,11,11,285,633,22,31,0,0
2799,1277,56,1570,701,9,11,11,293,645,23,31,0,0
2800,1305,69,1611,747,9,11,11,306,678,24,31,0,0
2801,1347,80,1663,791,9,11,11,316,711,25,31,0,0
2802,1396,89,1710,814,9,11,11,314,725,26,31,0,0
2803,1440,115,1763,872,9,11,11,323,757,27,31,0,0
2804,1533,146,1849,912,9,11,11,316,766,28,31,0,0
2805,1620,171,1920,920,9,11,11,300,749,29,31,0,0
2806,1677,279,1920,916,9,11,11,243,637,30,31,0,0
2807,1699,298,1920,942,9,11,11,221,644,31,31,1,0
2776,1435,2,1536,120,10,11,11,101,118,0,0,0,0
3749,1718,843,1912,1075,12,11,11,194,232,0,1,0,0
3750,1668,808,1894,1076,12,11,11,226,268,1,1,0,0
4323,1773,888,1917,1066,13,11,11,144,178,0,0,0,0
4324,1699,434,1919,1068,14,11,11,220,634,0,8,0,0
4325,1664,374,1904,1064,14,11,11,240,690,1,8,0,0
4326,1604,398,1841,1072,14,11,11,237,674,2,8,0,0
4327,1533,423,1761,1063,14,11,11,228,640,3,8,0,0
4328,1381,484,1600,1064,14,11,11,219,580,4,8,0,0
4329,1260,567,1466,1066,14,11,11,206,499,5,8,0,0
4330,1187,639,1374,1073,14,11,11,187,434,6,8,0,0
4331,1043,762,1187,1070,14,11,11,144,308,7,8,0,0
4332,952,827,1066,1070,14,11,11,114,243,8,8,0,0
4327,1614,663,1913,1058,15,11,11,299,395,0,4,0,0
4328,1592,624,1920,1074,15,11,11,328,450,1,4,0,0
4329,1611,668,1920,1079,15,11,11,309,411,2,4,0,0
4330,1580,781,1810,1075,15,11,11,230,294,3,4,0,0
4331,1575,826,1770,1076,15,11,11,195,250,4,4,0,0
4328,1806,605,1919,1014,16,11,11,113,409,0,0,0,0
5030,1805,850,1919,1075,18,11,11,114,225,0,1,0,0
5031,1784,860,1895,1077,18,11,11,111,217,1,1,0,0
5032,1595,832,1836,1074,19,11,11,241,242,0,0,0,0
5033,1448,770,1728,1077,20,11,11,280,307,0,4,0,0
5034,1396,745,1689,1067,20,11,11,293,322,1,4,0,0
5035,1342,774,1610,1065,20,11,11,268,291,2,4,0,0
5036,1241,859,1445,1072,20,11,11,204,213,3,4,0,0
5037,1189,894,1360,1073,20,11,11,171,179,4,4,0,0
5336,717,724,999,1080,24,11,11,282,356,0,0,0,0
5342,1308,358,1920,1066,25,11,11,612,708,0,1,0,0
5343,1373,315,1920,1066,25,11,11,547,751,1,1,0,0
5343,1679,360,1920,999,28,11,11,241,639,0,0,0,0
5344,1779,809,1919,1022,29,11,11,140,213,0,0,0,0
258,1862,511,1920,751,3,11,12,58,240,0,114,0,1
259,1851,484,1917,757,3,11,12,66,273,1,114,0,0
260,1842,469,1917,778,3,11,12,75,309,2,114,0,0
261,1831,468,1911,795,3,11,12,80,327,3,114,0,0
262,1805,445,1895,800,3,11,12,90,355,4,114,0,0
263,1778,447,1875,808,3,11,12,97,361,5,114,0,0
264,1758,437,1865,820,3,11,12,107,383,6,114,0,0
265,1725,440,1840,836,3,11,12,115,396,7,114,0,0
266,1693,440,1819,852,3,11,12,126,412,8,114,0,0
267,1636,439,1775,869,3,11,12,139,430,9,114,0,0
268,1586,440,1737,882,3,11,12,151,442,10,114,0,0
269,1544,437,1708,905,3,11,12,164,468,11,114,0,0
270,1483,437,1658,919,3,11,12,175,482,12,114,0,0
271,1435,434,1617,931,3,11,12,182,497,13,114,0,0
272,1346,431,1539,933,3,11,12,193,502,14,114,0,0
273,1283,425,1483,931,3,11,12,200,506,15,114,0,0
274,1205,420,1421,953,3,11,12,216,533,16,114,0,0
275,1127,422,1347,955,3,11,12,220,533,17,114,0,0
276,1073,413,1288,939,3,11,12,215,526,18,114,0,0
277,971,401,1196,944,3,11,12,225,543,19,114,0,0
278,914,396,1135,940,3,11,12,221,544,20,114,0,0
279,837,389,1059,932,3,11,12,222,543,21,114,0,0
280,778,380,1002,930,3,11,12,224,550,22,114,0,0
281,702,363,919,906,3,11,12,217,543,23,114,0,0
282,634,357,852,904,3,11,12,218,547,24,114,0,0
283,575,344,784,875,3,11,12,209,531,25,114,0,0
284,514,334,715,846,3,11,12,201,512,26,114,0,0
285,478,329,673,825,3,11,12,195,496,27,114,0,0
286,440,313,628,791,3,11,12,188,478,28,114,0,0
287,419,303,608,780,3,11,12,189,477,29,114,0,0
288,400,292,586,755,3,11,12,186,463,30,114,0,0
289,371,280,546,720,3,11,12,175,440,31,114,0,0
290,356,275,522,698,3,11,12,166,423,32,114,0,0
291,347,264,503,667,3,11,12,156,403,33,114,0,0
292,347,262,503,658,3,11,12,156,396,34,114,0,0
293,344,254,490,625,3,11,12,146,371,35,114,0,0
294,327,249,467,608,3,11,12,140,359,36,114,0,0
295,314,242,449,592,3,11,12,135,350,37,114,0,0
296,310,236,439,573,3,11,12,129,337,38,114,0,0
297,309,234,437,565,3,11,12,128,331,39,114,0,0
298,303,223,429,544,3,11,12,126,321,40,114,0,0
299,288,214,410,530,3,11,12,122,316,41,114,0,0
300,281,200,402,523,3,11,12,121,323,42,114,0,0
301,278,206,390,506,3,11,12,112,300,43,114,0,0
302,277,210,387,501,3,11,12,110,291,44,114,0,0
303,271,209,374,484,3,11,12,103,275,45,114,0,0
304,267,211,365,474,3,11,12,98,263,46,114,0,0
305,263,208,358,465,3,11,12,95,257,47,114,0,0
306,260,205,353,456,3,11,12,93,251,48,114,0,0
307,263,204,354,451,3,11,12,91,247,49,114,0,0
308,262,199,351,441,3,11,12,89,242,50,114,0,0
309,262,197,349,435,3,11,12,87,238,51,114,0,0
310,263,194,345,420,3,11,12,82,226,52,114,0,0
311,264,191,343,413,3,11,12,79,222,53,114,0,0
312,269,182,349,404,3,11,12,80,222,54,114,0,0
313,271,177,349,395,3,11,12,78,218,55,114,0,0
314,270,171,349,391,3,11,12,79,220,56,114,0,0
315,271,169,347,381,3,11,12,76,212,57,114,0,0
316,274,164,351,377,3,11,12,77,213,58,114,0,0
317,277,164,352,369,3,11,12,75,205,59,114,0,0
318,278,162,350,362,3,11,12,72,200,60,114,0,0
319,276,161,345,356,3,11,12,69,195,61,114,0,0
320,276,159,344,350,3,11,12,68,191,62,114,0,0
321,280,160,346,345,3,11,12,66,185,63,114,0,0
322,283,160,347,337,3,11,12,64,177,64,114,0,0
323,282,156,346,335,3,11,12,64,179,65,114,0,0
324,282,159,343,329,3,11,12,61,170,66,114,0,0
325,282,155,343,325,3,11,12,61,170,67,114,0,0
326,284,153,345,324,3,11,12,61,171,68,114,0,0
327,287,151,346,314,3,11,12,59,163,69,114,0,0
328,287,155,343,311,3,11,12,56,156,70,114,0,0
329,287,153,341,305,3,11,12,54,152,71,114,0,0
330,288,149,342,302,3,11,12,54,153,72,114,0,0
331,290,152,344,301,3,11,12,54,149,73,114,0,0
332,292,151,345,296,3,11,12,53,145,74,114,0,0
333,292,152,343,294,3,11,12,51,142,75,114,0,0
334,290,146,342,289,3,11,12,52,143,76,114,0,0
335,290,144,342,285,3,11,12,52,141,77,114,0,0
336,291,143,341,282,3,11,12,50,139,78,114,0,0
337,292,143,342,278,3,11,12,50,135,79,114,0,0
338,292,145,340,274,3,11,12,48,129,80,114,0,0
339,292,143,340,271,3,11,12,48,128,81,114,0,0
340,291,141,339,271,3,11,12,48,130,82,114,0,0
341,290,140,338,270,3,11,12,48,130,83,114,0,0
342,290,140,338,269,3,11,12,48,129,84,114,0,0
343,291,142,336,265,3,11,12,45,123,85,114,0,0
344,290,139,334,260,3,11,12,44,121,86,114,0,0
345,291,140,334,260,3,11,12,43,120,87,114,0,0
346,290,136,334,258,3,11,12,44,122,88,114,0,0
347,288,133,331,253,3,11,12,43,120,89,114,0,0
348,286,131,329,254,3,11,12,43,123,90,114,0,0
349,286,130,328,250,3,11,12,42,120,91,114,0,0
350,286,129,328,249,3,11,12,42,120,92,114,0,0
351,287,128,328,244,3,11,12,41,116,93,114,0,0
352,287,126,328,243,3,11,12,41,117,94,114,0,0
353,288,127,328,242,3,11,12,40,115,95,114,0,0
354,288,126,327,239,3,11,12,39,113,96,114,0,0
355,288,124,328,239,3,11,12,40,115,97,114,0,0
356,290,121,331,236,3,11,12,41,115,98,114,0,0
357,290,122,331,237,3,11,12,41,115,99,114,0,0
358,290,121,331,235,3,11,12,41,114,100,114,0,0
359,291,120,332,233,3,11,12,41,113,101,114,0,0
360,292,120,333,232,3,11,12,41,112,102,114,0,0
361,292,119,332,228,3,11,12,40,109,103,114,0,0
362,291,118,332,228,3,11,12,41,110,104,114,0,0
363,291,118,331,226,3,11,12,40,108,105,114,0,0
364,291,118,330,226,3,11,12,39,108,106,114,0,0
365,292,119,331,226,3,11,12,39,107,107,114,0,0
366,292,120,330,224,3,11,12,38,104,108,114,0,0
367,292,119,330,222,3,11,12,38,103,109,114,0,0
368,292,119,329,220,3,11,12,37,101,110,114,0,0
369,293,119,330,218,3,11,12,37,99,111,114,0,0
370,293,121,329,216,3,11,12,36,95,112,114,0,0
371,292,121,329,215,3,11,12,37,94,113,114,0,0
372,292,121,328,213,3,11,12,36,92,114,114,1,0
270,7,762,200,1078,4,11,12,193,316,0,29,0,1
271,0,533,268,1077,4,11,12,268,544,1,29,0,0
272,0,490,294,1056,4,11,12,294,566,2,29,0,0
273,59,467,398,1034,4,11,12,339,567,3,29,0,0
274,122,427,487,1048,4,11,12,365,621,4,29,0,0
275,176,407,531,1023,4,11,12,355,616,5,29,0,0
276,220,388,561,991,4,11,12,341,603,6,29,0,0
277,258,366,575,939,4,11,12,317,573,7,29,0,0
278,278,352,587,926,4,11,12,309,574,8,29,0,0
279,314,334,583,842,4,11,12,269,508,9,29,0,0
280,323,315,577,808,4,11,12,254,493,10,29,0,0
281,324,305,563,783,4,11,12,239,478,11,29,0,0
282,325,285,545,737,4,11,12,220,452,12,29,0,0
283,325,280,533,719,4,11,12,208,439,13,29,0,0
284,329,271,515,672,4,11,12,186,401,14,29,0,0
285,323,263,497,651,4,11,12,174,388,15,29,0,0
286,319,259,480,627,4,11,12,161,368,16,29,0,0
287,306,246,459,607,4,11,12,153,361,17,29,0,0
288,296,240,444,596,4,11,12,148,356,18,29,0,0
289,295,236,430,568,4,11,12,135,332,19,29,0,0
290,292,228,418,546,4,11,12,126,318,20,29,0,0
291,290,228,405,526,4,11,12,115,298,21,29,0,0
292,286,220,396,510,4,11,12,110,290,22,29,0,0
293,283,216,391,510,4,11,12,108,294,23,29,0,0
294,285,215,382,483,4,11,12,97,268,24,29,0,0
295,289,209,379,462,4,11,12,90,253,25,29,0,0
296,284,207,375,475,4,11,12,91,268,26,29,0,0
297,287,207,366,442,4,11,12,79,235,27,29,0,0
298,282,203,365,459,4,11,12,83,256,28,29,0,0
299,280,198,361,446,4,11,12,81,248,29,29,1,0
304,323,178,388,386,4,11,12,65,208,0,29,0,0
305,327,176,390,379,4,11,12,63,203,1,29,0,0
306,330,179,386,368,4,11,12,56,189,2,29,0,0
307,326,176,380,359,4,11,12,54,183,3,29,0,0
308,325,175,374,341,4,11,12,49,166,4,29,0,0
309,323,174,373,343,4,11,12,50,169,5,29,0,0
310,322,173,373,352,4,11,12,51,179,6,29,0,0
311,322,173,369,341,4,11,12,47,168,7,29,0,0
312,322,171,368,333,4,11,12,46,162,8,29,0,0
614,290,119,325,223,7,11,12,35,104,0,85,0,0
619,286,122,322,231,7,11,12,36,109,0,85,0,0
620,287,123,322,230,7,11,12,35,107,1,85,0,0
621,287,124,322,232,7,11,12,35,108,2,85,0,0
622,286,125,321,233,7,11,12,35,108,3,85,0,0
623,286,125,322,235,7,11,12,36,110,4,85,0,0
626,288,130,324,239,7,11,12,36,109,0,85,0,1
627,287,127,325,241,7,11,12,38,114,1,85,0,0
628,286,125,325,242,7,11,12,39,117,2,85,0,0
629,286,127,325,243,7,11,12,39,116,3,85,0,0
630,287,127,326,245,7,11,12,39,118,4,85,0,0
631,288,121,330,246,7,11,12,42,125,5,85,0,0
632,290,124,331,249,7,11,12,41,125,6,85,0,0
633,291,127,331,248,7,11,12,40,121,7,85,0,0
634,291,124,332,251,7,11,12,41,127,8,85,0,0
635,295,129,335,253,7,11,12,40,124,9,85,0,0
636,300,142,337,256,7,11,12,37,114,10,85,0,0
637,305,145,342,259,7,11,12,37,114,11,85,0,0
638,307,147,344,261,7,11,12,37,114,12,85,0,0
639,307,144,345,261,7,11,12,38,117,13,85,0,0
640,307,142,348,266,7,11,12,41,124,14,85,0,0
641,310,142,351,269,7,11,12,41,127,15,85,0,0
642,312,138,356,273,7,11,12,44,135,16,85,0,0
643,313,137,357,274,7,11,12,44,137,17,85,0,0
644,314,139,357,274,7,11,12,43,135,18,85,0,0
645,315,138,360,277,7,11,12,45,139,19,85,0,0
646,320,137,366,277,7,11,12,46,140,20,85,0,0
647,325,138,371,280,7,11,12,46,142,21,85,0,0
648,329,146,374,283,7,11,12,45,137,22,85,0,0
649,330,146,376,283,7,11,12,46,137,23,85,0,0
650,332,146,379,285,7,11,12,47,139,24,85,0,0
651,337,147,384,290,7,11,12,47,143,25,85,0,0
652,340,145,390,294,7,11,12,50,149,26,85,0,0
653,342,146,393,299,7,11,12,51,153,27,85,0,0
654,342,148,393,301,7,11,12,51,153,28,85,0,0
655,341,146,393,304,7,11,12,52,158,29,85,0,0
656,339,147,394,311,7,11,12,55,164,30,85,0,0
657,340,148,395,312,7,11,12,55,164,31,85,0,0
658,340,148,395,316,7,11,12,55,168,32,85,0,0
659,336,151,391,319,7,11,12,55,168,33,85,0,0
660,331,153,386,321,7,11,12,55,168,34,85,0,0
661,328,161,383,329,7,11,12,55,168,35,85,0,0
662,326,166,381,333,7,11,12,55,167,36,85,0,0
663,323,165,379,335,7,11,12,56,170,37,85,0,0
664,319,170,374,339,7,11,12,55,169,38,85,0,0
665,313,169,369,343,7,11,12,56,174,39,85,0,0
666,307,168,365,351,7,11,12,58,183,40,85,0,0
667,305,171,364,358,7,11,12,59,187,41,85,0,0
668,304,171,363,360,7,11,12,59,189,42,85,0,0
669,303,173,364,366,7,11,12,61,193,43,85,0,0
670,302,176,362,368,7,11,12,60,192,44,85,0,0
671,300,176,362,374,7,11,12,62,198,45,85,0,0
672,299,178,363,384,7,11,12,64,206,46,85,0,0
673,300,178,368,392,7,11,12,68,214,47,85,0,0
674,307,181,376,398,7,11,12,69,217,48,85,0,0
675,310,184,379,402,7,11,12,69,218,49,85,0,0
676,312,186,382,407,7,11,12,70,221,50,85,0,0
677,314,189,386,413,7,11,12,72,224,51,85,0,0
678,319,192,393,421,7,11,12,74,229,52,85,0,0
679,327,192,403,427,7,11,12,76,235,53,85,0,0
680,331,195,411,443,7,11,12,80,248,54,85,0,0
681,333,199,414,451,7,11,12,81,252,55,85,0,0
682,335,201,417,458,7,11,12,82,257,56,85,0,0
683,335,204,421,471,7,11,12,86,267,57,85,0,0
684,342,206,430,475,7,11,12,88,269,58,85,0,0
685,349,207,442,491,7,11,12,93,284,59,85,0,0
686,348,209,445,504,7,11,12,97,295,60,85,0,0
687,347,211,445,510,7,11,12,98,299,61,85,0,0
688,350,223,452,528,7,11,12,102,305,62,85,0,0
689,360,224,464,535,7,11,12,104,311,63,85,0,0
690,374,231,484,555,7,11,12,110,324,64,85,0,0
691,379,237,494,573,7,11,12,115,336,65,85,0,0
692,379,238,498,584,7,11,12,119,346,66,85,0,0
693,379,247,502,601,7,11,12,123,354,67,85,0,0
694,387,257,514,617,7,11,12,127,360,68,85,0,0
695,401,262,538,643,7,11,12,137,381,69,85,0,0
696,407,272,554,681,7,11,12,147,409,70,85,0,0
697,401,276,554,701,7,11,12,153,425,71,85,0,0
698,394,284,552,724,7,11,12,158,440,72,85,0,0
699,388,295,556,756,7,11,12,168,461,73,85,0,0
700,395,306,568,777,7,11,12,173,471,74,85,0,0
701,390,319,577,831,7,11,12,187,512,75,85,0,0
702,377,329,565,843,7,11,12,188,514,76,85,0,0
703,349,341,551,894,7,11,12,202,553,77,85,0,0
704,330,367,545,958,7,11,12,215,591,78,85,0,0
705,317,389,531,979,7,11,12,214,590,79,85,0,0
706,281,412,509,1042,7,11,12,228,630,80,85,0,0
707,238,428,465,1031,7,11,12,227,603,81,85,0,0
708,159,454,395,1064,7,11,12,236,610,82,85,0,0
709,87,484,317,1053,7,11,12,230,569,83,85,0,0
710,14,510,224,1041,7,11,12,210,531,84,85,0,0
711,0,526,201,1060,7,11,12,201,534,85,85,1,0
615,1860,594,1919,750,8,11,12,59,156,0,28,0,1
616,1838,515,1920,767,8,11,12,82,252,1,28,0,0
617,1829,485,1920,775,8,11,12,91,290,2,28,0,0
618,1811,460,1920,804,8,11,12,109,344,3,28,0,0
619,1798,441,1920,820,8,11,12,122,379,4,28,0,0
620,1770,433,1915,826,8,11,12,145,393,5,28,0,0
621,1741,430,1897,841,8,11,12,156,411,6,28,0,0
622,1724,430,1884,849,8,11,12,160,419,7,28,0,0
623,1692,432,1864,876,8,11,12,172,444,8,28,0,0
624,1654,440,1836,902,8,11,12,182,462,9,28,0,0
625,1622,439,1809,909,8,11,12,187,470,10,28,0,0
626,1551,452,1749,928,8,11,12,198,476,11,28,0,0
627,1499,448,1708,946,8,11,12,209,498,12,28,0,0
628,1448,445,1675,980,8,11,12,227,535,13,28,0,0
629,1375,446,1622,1021,8,11,12,247,575,14,28,0,0
630,1320,446,1576,1040,8,11,12,256,594,15,28,0,0
631,1227,464,1492,1057,8,11,12,265,593,16,28,0,0
632,1135,470,1411,1073,8,11,12,276,603,17,28,0,0
633,1056,459,1338,1080,8,11,12,282,621,18,28,0,0
634,947,476,1230,1080,8,11,12,283,604,19,28,0,0
635,849,493,1125,1080,8,11,12,276,587,20,28,0,0
636,734,500,1005,1080,8,11,12,271,580,21,28,0,0
637,598,522,863,1078,8,11,12,265,556,22,28,0,0
638,450,519,709,1074,8,11,12,259,555,23,28,0,0
639,316,530,579,1080,8,11,12,263,550,24,28,0,0
640,182,556,437,1076,8,11,12,255,520,25,28,0,0
641,37,583,280,1080,8,11,12,243,497,26,28,0,0
642,0,686,161,1080,8,11,12,161,394,27,28,0,0
643,0,706,61,1080,8,11,12,61,374,28,28,1,0
785,1871,532,1920,739,9,11,12,49,207,0,31,0,1
786,1864,512,1920,757,9,11,12,56,245,1,31,0,0
787,1849,497,1915,775,9,11,12,66,278,2,31,0,0
788,1840,489,1911,784,9,11,12,71,295,3,31,0,0
789,1811,465,1891,787,9,11,12,80,322,4,31,0,0
790,1792,461,1878,792,9,11,12,86,331,5,31,0,0
791,1779,447,1876,803,9,11,12,97,356,6,31,0,0
792,1756,449,1863,829,9,11,12,107,380,7,31,0,0
793,1732,452,1848,850,9,11,12,116,398,8,31,0,0
794,1704,457,1826,858,9,11,12,122,401,9,31,0,0
795,1659,472,1789,871,9,11,12,130,399,10,31,0,0
796,1632,472,1770,882,9,11,12,138,410,11,31,0,0
797,1598,477,1748,915,9,11,12,150,438,12,31,0,0
798,1551,483,1716,948,9,11,12,165,465,13,31,0,0
799,1521,481,1693,957,9,11,12,172,476,14,31,0,0
800,1450,496,1634,973,9,11,12,184,477,15,31,0,0
801,1395,494,1591,990,9,11,12,196,496,16,31,0,0
802,1355,493,1562,1017,9,11,12,207,524,17,31,0,0
803,1273,509,1495,1051,9,11,12,222,542,18,31,0,0
804,1225,515,1452,1069,9,11,12,227,554,19,31,0,0
805,1127,526,1361,1076,9,11,12,234,550,20,31,0,0
806,1030,530,1275,1080,9,11,12,245,550,21,31,0,0
807,959,519,1204,1080,9,11,12,245,561,22,31,0,0
808,874,524,1116,1080,9,11,12,242,556,23,31,0,0
809,791,541,1025,1080,9,11,12,234,539,24,31,0,0
810,691,546,916,1059,9,11,12,225,513,25,31,0,0
811,578,570,796,1069,9,11,12,218,499,26,31,0,0
812,455,572,673,1071,9,11,12,218,499,27,31,0,0
813,326,584,543,1079,9,11,12,217,495,28,31,0,0
814,207,614,413,1080,9,11,12,206,466,29,31,0,0
815,59,622,267,1080,9,11,12,208,458,30,31,0,0
816,0,631,175,1080,9,11,12,175,449,31,31,1,0
834,131,507,364,1068,12,11,12,233,561,0,0,0,0
835,251,501,519,1068,14,11,12,268,567,0,0,0,0
836,394,516,668,1072,15,11,12,274,556,0,26,0,1
837,466,504,744,1072,15,11,12,278,568,1,26,0,0
838,591,496,874,1072,15,11,12,283,576,2,26,0,0
839,687,476,980,1073,15,11,12,293,597,3,26,0,0
840,795,444,1096,1066,15,11,12,301,622,4,26,0,0
841,891,453,1194,1071,15,11,12,303,618,5,26,0,0
842,972,460,1271,1062,15,11,12,299,602,6,26,0,0
843,1096,452,1398,1067,15,11,12,302,615,7,26,0,0
844,1180,446,1488,1065,15,11,12,308,619,8,26,0,0
845,1279,445,1562,1015,15,11,12,283,570,9,26,0,0
846,1340,443,1608,987,15,11,12,268,544,10,26,0,0
847,1388,458,1646,976,15,11,12,258,518,11,26,0,0
848,1471,449,1713,938,15,11,12,242,489,12,26,0,0
849,1526,441,1766,926,15,11,12,240,485,13,26,0,0
850,1569,435,1805,914,15,11,12,236,479,14,26,0,0
851,1615,432,1833,880,15,11,12,218,448,15,26,0,0
852,1637,432,1847,863,15,11,12,210,431,16,26,0,0
853,1671,444,1864,837,15,11,12,193,393,17,26,0,0
854,1713,439,1900,823,15,11,12,187,384,18,26,0,0
855,1736,441,1919,818,15,11,12,183,377,19,26,0,0
856,1766,435,1920,802,15,11,12,154,367,20,26,0,0
857,1784,432,1920,779,15,11,12,136,347,21,26,0,0
858,1790,448,1920,772,15,11,12,130,324,22,26,0,0
859,1814,453,1920,757,15,11,12,106,304,23,26,0,0
860,1840,481,1920,751,15,11,12,80,270,24,26,0,0
861,1854,493,1920,747,15,11,12,66,254,25,26,0,0
862,1882,500,1920,735,15,11,12,38,235,26,26,1,0
894,319,112,355,184,17,11,12,36,72,0,77,0,0
895,320,112,356,185,17,11,12,36,73,1,77,0,0
896,319,112,357,189,17,11,12,38,77,2,77,0,0
897,319,112,357,190,17,11,12,38,78,3,77,0,0
898,321,113,358,190,17,11,12,37,77,4,77,0,0
899,321,114,358,189,17,11,12,37,75,5,77,0,0
900,321,114,359,194,17,11,12,38,80,6,77,0,0
901,321,115,358,194,17,11,12,37,79,7,77,0,0
902,321,115,358,195,17,11,12,37,80,8,77,0,0
903,322,115,359,196,17,11,12,37,81,9,77,0,0
904,323,114,359,195,17,11,12,36,81,10,77,0,0
905,323,114,359,195,17,11,12,36,81,11,77,0,0
906,323,115,360,198,17,11,12,37,83,12,77,0,0
907,324,115,359,197,17,11,12,35,82,13,77,0,0
908,324,114,359,198,17,11,12,35,84,14,77,0,0
909,326,116,361,199,17,11,12,35,83,15,77,0,0
931,327,120,362,231,17,11,12,35,111,0,77,0,0
932,327,121,362,234,17,11,12,35,113,1,77,0,0
933,327,123,362,235,17,11,12,35,112,2,77,0,0
934,326,125,361,236,17,11,12,35,111,3,77,0,0
937,322,125,358,240,17,11,12,36,115,0,77,0,1
938,323,126,360,242,17,11,12,37,116,1,77,0,0
939,324,125,361,242,17,11,12,37,117,2,77,0,0
940,324,124,363,247,17,11,12,39,123,3,77,0,0
941,324,126,362,249,17,11,12,38,123,4,77,0,0
942,327,131,364,249,17,11,12,37,118,5,77,0,0
943,324,125,365,253,17,11,12,41,128,6,77,0,0
944,327,129,367,254,17,11,12,40,125,7,77,0,0
945,328,130,368,256,17,11,12,40,126,8,77,0,0
946,327,124,371,262,17,11,12,44,138,9,77,0,0
947,328,127,371,264,17,11,12,43,137,10,77,0,0
948,330,129,372,263,17,11,12,42,134,11,77,0,0
949,333,133,375,267,17,11,12,42,134,12,77,0,0
950,336,136,378,268,17,11,12,42,132,13,77,0,0
951,339,138,382,270,17,11,12,43,132,14,77,0,0
952,340,135,384,272,17,11,12,44,137,15,77,0,0
953,341,133,386,273,17,11,12,45,140,16,77,0,0
954,343,136,389,276,17,11,12,46,140,17,77,0,0
955,345,135,393,280,17,11,12,48,145,18,77,0,0
956,348,135,395,281,17,11,12,47,146,19,77,0,0
957,350,138,397,285,17,11,12,47,147,20,77,0,0
958,352,144,399,290,17,11,12,47,146,21,77,0,0
959,353,143,401,293,17,11,12,48,150,22,77,0,0
960,356,142,405,296,17,11,12,49,154,23,77,0,0
961,360,142,411,299,17,11,12,51,157,24,77,0,0
962,364,141,416,300,17,11,12,52,159,25,77,0,0
963,367,143,419,304,17,11,12,52,161,26,77,0,0
964,369,145,423,309,17,11,12,54,164,27,77,0,0
965,369,144,423,311,17,11,12,54,167,28,77,0,0
966,366,145,423,320,17,11,12,57,175,29,77,0,0
967,367,147,424,325,17,11,12,57,178,30,77,0,0
968,365,146,423,327,17,11,12,58,181,31,77,0,0
969,361,149,420,333,17,11,12,59,184,32,77,0,0
970,359,152,417,336,17,11,12,58,184,33,77,0,0
971,356,152,417,342,17,11,12,61,190,34,77,0,0
972,358,158,419,349,17,11,12,61,191,35,77,0,0
973,360,156,422,353,17,11,12,62,197,36,77,0,0
974,362,158,425,359,17,11,12,63,201,37,77,0,0
975,365,164,428,368,17,11,12,63,204,38,77,0,0
976,369,165,432,371,17,11,12,63,206,39,77,0,0
977,371,166,437,377,17,11,12,66,211,40,77,0,0
978,373,168,442,385,17,11,12,69,217,41,77,0,0
979,379,164,450,389,17,11,12,71,225,42,77,0,0
980,382,167,456,402,17,11,12,74,235,43,77,0,0
981,388,171,462,410,17,11,12,74,239,44,77,0,0
982,394,171,468,414,17,11,12,74,243,45,77,0,0
983,402,177,479,423,17,11,12,77,246,46,77,0,0
984,410,179,490,429,17,11,12,80,250,47,77,0,0
985,416,177,498,436,17,11,12,82,259,48,77,0,0
986,418,183,502,449,17,11,12,84,266,49,77,0,0
987,419,186,506,462,17,11,12,87,276,50,77,0,0
988,424,187,513,469,17,11,12,89,282,51,77,0,0
989,431,197,521,479,17,11,12,90,282,52,77,0,0
990,437,200,531,489,17,11,12,94,289,53,77,0,0
991,441,202,541,506,17,11,12,100,304,54,77,0,0
992,439,209,543,527,17,11,12,104,318,55,77,0,0
993,438,210,545,538,17,11,12,107,328,56,77,0,0
994,439,212,552,555,17,11,12,113,343,57,77,0,0
995,443,220,561,575,17,11,12,118,355,58,77,0,0
996,453,223,574,589,17,11,12,121,366,59,77,0,0
997,455,229,584,618,17,11,12,129,389,60,77,0,0
998,467,237,582,571,17,11,12,115,334,61,77,0,0
999,464,242,596,628,17,11,12,132,386,62,77,0,0
1000,467,251,615,675,17,11,12,148,424,63,77,0,0
1001,483,262,639,706,17,11,12,156,444,64,77,0,0
1002,493,261,660,727,17,11,12,167,466,65,77,0,0
1003,493,274,674,780,17,11,12,181,506,66,77,0,0
1004,488,294,675,817,17,11,12,187,523,67,77,0,0
1005,486,302,676,832,17,11,12,190,530,68,77,0,0
1006,483,320,696,908,17,11,12,213,588,69,77,0,0
1007,483,337,706,944,17,11,12,223,607,70,77,0,0
1008,462,348,692,979,17,11,12,230,631,71,77,0,0
1009,434,374,675,1038,17,11,12,241,664,72,77,0,0
1010,398,387,645,1068,17,11,12,247,681,73,77,0,0
1011,353,402,606,1080,17,11,12,253,678,74,77,0,0
1012,313,436,564,1080,17,11,12,251,644,75,77,0,0
1013,225,464,468,1080,17,11,12,243,616,76,77,0,0
1014,209,478,456,1080,17,11,12,247,602,77,77,1,0
928,288,125,323,224,18,11,12,35,99,0,81,0,0
931,285,129,320,229,18,11,12,35,100,0,81,0,1
932,285,128,320,229,18,11,12,35,101,1,81,0,0
933,284,128,321,232,18,11,12,37,104,2,81,0,0
934,284,130,320,235,18,11,12,36,105,3,81,0,0
935,282,130,318,236,18,11,12,36,106,4,81,0,0
936,282,131,319,239,18,11,12,37,108,5,81,0,0
937,281,132,319,241,18,11,12,38,109,6,81,0,0
938,283,131,320,241,18,11,12,37,110,7,81,0,0
939,282,133,320,244,18,11,12,38,111,8,81,0,0
940,282,133,319,246,18,11,12,37,113,9,81,0,0
941,281,136,318,249,18,11,12,37,113,10,81,0,0
942,280,134,319,253,18,11,12,39,119,11,81,0,0
943,280,134,320,254,18,11,12,40,120,12,81,0,0
944,281,137,321,258,18,11,12,40,121,13,81,0,0
945,280,140,320,260,18,11,12,40,120,14,81,0,0
946,280,140,320,262,18,11,12,40,122,15,81,0,0
947,281,140,322,265,18,11,12,41,125,16,81,0,0
948,283,141,325,267,18,11,12,42,126,17,81,0,0
949,285,141,328,272,18,11,12,43,131,18,81,0,0
950,286,140,331,277,18,11,12,45,137,19,81,0,0
951,287,140,332,276,18,11,12,45,136,20,81,0,0
952,288,142,334,279,18,11,12,46,137,21,81,0,0
953,291,144,336,279,18,11,12,45,135,22,81,0,0
954,293,147,337,280,18,11,12,44,133,23,81,0,0
955,292,147,339,286,18,11,12,47,139,24,81,0,0
956,290,147,337,287,18,11,12,47,140,25,81,0,0
957,288,147,337,293,18,11,12,49,146,26,81,0,0
958,288,148,338,297,18,11,12,50,149,27,81,0,0
959,287,147,338,300,18,11,12,51,153,28,81,0,0
960,286,150,337,303,18,11,12,51,153,29,81,0,0
961,283,150,336,306,18,11,12,53,156,30,81,0,0
962,281,150,334,309,18,11,12,53,159,31,81,0,0
963,280,151,335,315,18,11,12,55,164,32,81,0,0
964,281,151,337,317,18,11,12,56,166,33,81,0,0
965,281,152,338,323,18,11,12,57,171,34,81,0,0
966,279,153,338,328,18,11,12,59,175,35,81,0,0
967,279,156,339,331,18,11,12,60,175,36,81,0,0
968,280,157,341,337,18,11,12,61,180,37,81,0,0
969,283,158,345,339,18,11,12,62,181,38,81,0,0
970,286,161,350,349,18,11,12,64,188,39,81,0,0
971,288,166,352,355,18,11,12,64,189,40,81,0,0
972,289,169,354,357,18,11,12,65,188,41,81,0,0
973,291,172,358,367,18,11,12,67,195,42,81,0,0
974,293,173,361,370,18,11,12,68,197,43,81,0,0
975,296,175,366,376,18,11,12,70,201,44,81,0,0
976,296,176,370,386,18,11,12,74,210,45,81,0,0
977,296,176,371,390,18,11,12,75,214,46,81,0,0
978,295,176,374,397,18,11,12,79,221,47,81,0,0
979,298,179,378,403,18,11,12,80,224,48,81,0,0
980,303,180,384,406,18,11,12,81,226,49,81,0,0
981,309,183,394,417,18,11,12,85,234,50,81,0,0
982,311,185,400,427,18,11,12,89,242,51,81,0,0
983,310,186,401,433,18,11,12,91,247,52,81,0,0
984,312,189,405,441,18,11,12,93,252,53,81,0,0
985,317,189,412,447,18,11,12,95,258,54,81,0,0
986,320,194,419,464,18,11,12,99,270,55,81,0,0
987,317,198,421,482,18,11,12,104,284,56,81,0,0
988,315,201,422,492,18,11,12,107,291,57,81,0,0
989,315,208,425,507,18,11,12,110,299,58,81,0,0
990,318,207,433,518,18,11,12,115,311,59,81,0,0
991,321,210,442,537,18,11,12,121,327,60,81,0,0
992,320,222,444,556,18,11,12,124,334,61,81,0,0
993,313,227,442,570,18,11,12,129,343,62,81,0,0
994,308,237,443,598,18,11,12,135,361,63,81,0,0
995,308,237,447,611,18,11,12,139,374,64,81,0,0
996,311,242,455,626,18,11,12,144,384,65,81,0,0
997,311,253,462,659,18,11,12,151,406,66,81,0,0
998,303,256,459,676,18,11,12,156,420,67,81,0,0
999,303,267,455,670,18,11,12,152,403,68,81,0,0
1000,304,277,470,720,18,11,12,166,443,69,81,0,0
1001,306,287,480,749,18,11,12,174,462,70,81,0,0
1002,305,302,495,807,18,11,12,190,505,71,81,0,0
1003,298,312,486,806,18,11,12,188,494,72,81,0,0
1004,279,328,487,876,18,11,12,208,548,73,81,0,0
1005,264,347,494,954,18,11,12,230,607,74,81,0,0
1006,264,361,492,960,18,11,12,228,599,75,81,0,0
1007,252,385,484,995,18,11,12,232,610,76,81,0,0
1008,207,405,452,1033,18,11,12,245,628,77,81,0,0
1009,142,424,385,1036,18,11,12,243,612,78,81,0,0
1010,92,462,341,1058,18,11,12,249,596,79,81,0,0
1011,42,479,291,1068,18,11,12,249,589,80,81,0,0
1012,24,493,278,1080,18,11,12,254,587,81,81,1,0
1014,61,506,312,1075,18,11,12,251,569,0,81,0,0
1015,15,535,240,1050,18,11,12,225,515,1,81,0,0
1016,0,550,225,1063,18,11,12,225,513,2,81,0,0
977,1856,456,1920,766,23,11,12,64,310,0,25,0,1
978,1833,442,1901,769,23,11,12,68,327,1,25,0,0
979,1801,413,1882,789,23,11,12,81,376,2,25,0,0
980,1791,394,1880,798,23,11,12,89,404,3,25,0,0
981,1778,392,1878,827,23,11,12,100,435,4,25,0,0
982,1753,401,1862,850,23,11,12,109,449,5,25,0,0
983,1729,415,1842,861,23,11,12,113,446,6,25,0,0
984,1672,419,1798,880,23,11,12,126,461,7,25,0,0
985,1629,419,1768,896,23,11,12,139,477,8,25,0,0
986,1597,412,1754,937,23,11,12,157,525,9,25,0,0
987,1541,421,1720,986,23,11,12,179,565,10,25,0,0
988,1498,423,1689,1007,23,11,12,191,584,11,25,0,0
989,1411,424,1620,1025,23,11,12,209,601,12,25,0,0
990,1324,431,1550,1054,23,11,12,226,623,13,25,0,0
991,1268,425,1507,1076,23,11,12,239,651,14,25,0,0
992,1175,427,1425,1080,23,11,12,250,653,15,25,0,0
993,1081,437,1335,1080,23,11,12,254,643,16,25,0,0
994,974,428,1234,1080,23,11,12,260,652,17,25,0,0
995,855,436,1120,1080,23,11,12,265,644,18,25,0,0
996,748,437,1017,1080,23,11,12,269,643,19,25,0,0
997,580,439,851,1080,23,11,12,271,641,20,25,0,0
998,435,468,710,1077,23,11,12,275,609,21,25,0,0
999,276,480,543,1079,23,11,12,267,599,22,25,0,0
1000,139,499,403,1080,23,11,12,264,581,23,25,0,0
1001,13,519,251,1049,23,11,12,238,530,24,25,0,0
1002,0,527,151,1053,23,11,12,151,526,25,25,1,0
1294,1817,410,1920,723,25,11,12,103,313,0,80,0,1
1295,1812,383,1920,727,25,11,12,108,344,1,80,0,0
1296,1793,395,1908,744,25,11,12,115,349,2,80,0,0
1297,1774,397,1896,760,25,11,12,122,363,3,80,0,0
1298,1738,396,1865,770,25,11,12,127,374,4,80,0,0
1299,1700,402,1831,783,25,11,12,131,381,5,80,0,0
1300,1677,396,1815,797,25,11,12,138,401,6,80,0,0
1301,1634,400,1781,818,25,11,12,147,418,7,80,0,0
1302,1595,401,1749,835,25,11,12,154,434,8,80,0,0
1303,1538,401,1702,852,25,11,12,164,451,9,80,0,0
1304,1473,401,1650,873,25,11,12,177,472,10,80,0,0
1305,1426,391,1613,890,25,11,12,187,499,11,80,0,0
1306,1349,396,1547,910,25,11,12,198,514,12,80,0,0
1307,1284,394,1494,934,25,11,12,210,540,13,80,0,0
1308,1209,387,1425,937,25,11,12,216,550,14,80,0,0
1309,1097,386,1327,946,25,11,12,230,560,15,80,0,0
1310,1023,375,1254,944,25,11,12,231,569,16,80,0,0
1311,903,368,1140,941,25,11,12,237,573,17,80,0,0
1312,824,352,1066,927,25,11,12,242,575,18,80,0,0
1313,739,334,981,918,25,11,12,242,584,19,80,0,0
1314,656,320,900,907,25,11,12,244,587,20,80,0,0
1315,593,304,829,881,25,11,12,236,577,21,80,0,0
1316,546,292,765,838,25,11,12,219,546,22,80,0,0
1317,509,290,710,800,25,11,12,201,510,23,80,0,0
1318,475,270,664,753,25,11,12,189,483,24,80,0,0
1319,454,264,637,732,25,11,12,183,468,25,80,0,0
1320,438,254,614,707,25,11,12,176,453,26,80,0,0
1321,427,238,591,668,25,11,12,164,430,27,80,0,0
1322,422,240,571,638,25,11,12,149,398,28,80,0,0
1323,412,226,552,606,25,11,12,140,380,29,80,0,0
1324,405,221,540,587,25,11,12,135,366,30,80,0,0
1325,400,216,526,562,25,11,12,126,346,31,80,0,0
1326,394,208,514,543,25,11,12,120,335,32,80,0,0
1327,388,209,502,528,25,11,12,114,319,33,80,0,0
1328,380,200,489,507,25,11,12,109,307,34,80,0,0
1329,375,195,479,490,25,11,12,104,295,35,80,0,0
1330,374,191,472,474,25,11,12,98,283,36,80,0,0
1331,371,185,465,459,25,11,12,94,274,37,80,0,0
1332,367,185,456,450,25,11,12,89,265,38,80,0,0
1333,363,180,448,436,25,11,12,85,256,39,80,0,0
1334,362,178,445,430,25,11,12,83,252,40,80,0,0
1335,366,178,442,414,25,11,12,76,236,41,80,0,0
1336,366,166,443,404,25,11,12,77,238,42,80,0,0
1337,365,164,442,401,25,11,12,77,237,43,80,0,0
1338,366,159,440,388,25,11,12,74,229,44,80,0,0
1339,369,157,439,381,25,11,12,70,224,45,80,0,0
1340,370,155,438,371,25,11,12,68,216,46,80,0,0
1341,371,151,436,363,25,11,12,65,212,47,80,0,0
1342,369,150,434,360,25,11,12,65,210,48,80,0,0
1343,372,148,434,347,25,11,12,62,199,49,80,0,0
1344,374,147,433,339,25,11,12,59,192,50,80,0,0
1345,375,147,432,331,25,11,12,57,184,51,80,0,0
1346,374,145,430,327,25,11,12,56,182,52,80,0,0
1347,373,146,428,325,25,11,12,55,179,53,80,0,0
1348,369,145,423,320,25,11,12,54,175,54,80,0,0
1349,370,147,421,312,25,11,12,51,165,55,80,0,0
1350,370,148,419,305,25,11,12,49,157,56,80,0,0
1351,367,144,417,301,25,11,12,50,157,57,80,0,0
1352,365,144,414,299,25,11,12,49,155,58,80,0,0
1353,359,140,407,295,25,11,12,48,155,59,80,0,0
1354,356,140,404,292,25,11,12,48,152,60,80,0,0
1355,354,137,400,287,25,11,12,46,150,61,80,0,0
1356,353,138,397,285,25,11,12,44,147,62,80,0,0
1357,351,137,394,281,25,11,12,43,144,63,80,0,0
1358,349,135,391,274,25,11,12,42,139,64,80,0,0
1359,349,133,390,270,25,11,12,41,137,65,80,0,0
1360,347,131,388,267,25,11,12,41,136,66,80,0,0
1361,345,129,388,266,25,11,12,43,137,67,80,0,0
1362,339,125,383,264,25,11,12,44,139,68,80,0,0
1363,339,127,382,261,25,11,12,43,134,69,80,0,0
1364,337,126,380,258,25,11,12,43,132,70,80,0,0
1365,336,125,378,252,25,11,12,42,127,71,80,0,0
1366,336,127,376,251,25,11,12,40,124,72,80,0,0
1367,334,126,374,250,25,11,12,40,124,73,80,0,0
1368,335,125,374,247,25,11,12,39,122,74,80,0,0
1369,335,125,372,242,25,11,12,37,117,75,80,0,0
1370,334,124,370,239,25,11,12,36,115,76,80,0,0
1371,331,120,369,241,25,11,12,38,121,77,80,0,0
1372,330,121,367,240,25,11,12,37,119,78,80,0,0
1373,328,118,365,235,25,11,12,37,117,79,80,0,0
1374,327,119,362,230,25,11,12,35,111,80,80,1,0
1376,324,116,359,227,25,11,12,35,111,0,80,0,0
1377,322,116,357,227,25,11,12,35,111,1,80,0,0
1378,321,116,357,228,25,11,12,36,112,2,80,0,0
1379,321,116,357,227,25,11,12,36,111,3,80,0,0
1383,320,116,355,220,25,11,12,35,104,0,80,0,0
1492,1829,387,1920,742,28,11,12,91,355,0,98,0,1
1493,1831,414,1916,747,28,11,12,85,333,1,98,0,0
1494,1808,408,1896,744,28,11,12,88,336,2,98,0,0
1495,1782,415,1873,748,28,11,12,91,333,3,98,0,0
1496,1761,409,1858,752,28,11,12,97,343,4,98,0,0
1497,1749,402,1855,774,28,11,12,106,372,5,98,0,0
1498,1724,411,1839,800,28,11,12,115,389,6,98,0,0
1499,1710,413,1828,806,28,11,12,118,393,7,98,0,0
1500,1671,416,1793,802,28,11,12,122,386,8,98,0,0
1501,1627,413,1764,826,28,11,12,137,413,9,98,0,0
1502,1599,411,1742,833,28,11,12,143,422,10,98,0,0
1503,1567,410,1728,878,28,11,12,161,468,11,98,0,0
1504,1525,419,1697,910,28,11,12,172,491,12,98,0,0
1505,1493,411,1671,919,28,11,12,178,508,13,98,0,0
1506,1418,413,1605,922,28,11,12,187,509,14,98,0,0
1507,1351,417,1547,930,28,11,12,196,513,15,98,0,0
1508,1306,408,1506,933,28,11,12,200,525,16,98,0,0
1509,1221,404,1437,952,28,11,12,216,548,17,98,0,0
1510,1144,411,1369,968,28,11,12,225,557,18,98,0,0
1511,1085,400,1314,975,28,11,12,229,575,19,98,0,0
1512,976,391,1212,968,28,11,12,236,577,20,98,0,0
1513,906,378,1154,972,28,11,12,248,594,21,98,0,0
1514,834,357,1080,957,28,11,12,246,600,22,98,0,0
1515,731,347,982,940,28,11,12,251,593,23,98,0,0
1516,678,342,925,924,28,11,12,247,582,24,98,0,0
1517,585,325,834,912,28,11,12,249,587,25,98,0,0
1518,507,326,754,901,28,11,12,247,575,26,98,0,0
1519,448,317,689,878,28,11,12,241,561,27,98,0,0
1520,408,309,638,849,28,11,12,230,540,28,98,0,0
1521,368,311,587,822,28,11,12,219,511,29,98,0,0
1522,327,303,536,791,28,11,12,209,488,30,98,0,0
1523,281,290,486,767,28,11,12,205,477,31,98,0,0
1524,254,288,456,759,28,11,12,202,471,32,98,0,0
1525,243,269,436,725,28,11,12,193,456,33,98,0,0
1526,239,258,423,700,28,11,12,184,442,34,98,0,0
1527,234,259,409,686,28,11,12,175,427,35,98,0,0
1528,232,248,394,652,28,11,12,162,404,36,98,0,0
1529,230,238,385,634,28,11,12,155,396,37,98,0,0
1530,232,237,381,625,28,11,12,149,388,38,98,0,0
1531,242,228,379,591,28,11,12,137,363,39,98,0,0
1532,247,223,378,573,28,11,12,131,350,40,98,0,0
1533,252,223,373,554,28,11,12,121,331,41,98,0,0
1534,252,212,368,533,28,11,12,116,321,42,98,0,0
1535,251,207,363,522,28,11,12,112,315,43,98,0,0
1536,253,207,360,510,28,11,12,107,303,44,98,0,0
1537,256,200,359,491,28,11,12,103,291,45,98,0,0
1538,256,197,355,483,28,11,12,99,286,46,98,0,0
1539,257,198,350,467,28,11,12,93,269,47,98,0,0
1540,256,190,347,455,28,11,12,91,265,48,98,0,0
1541,258,192,346,449,28,11,12,88,257,49,98,0,0
1542,262,192,346,435,28,11,12,84,243,50,98,0,0
1543,264,184,348,427,28,11,12,84,243,51,98,0,0
1544,263,185,347,424,28,11,12,84,239,52,98,0,0
1545,263,179,345,411,28,11,12,82,232,53,98,0,0
1546,260,170,342,406,28,11,12,82,236,54,98,0,0
1547,262,172,342,401,28,11,12,80,229,55,98,0,0
1548,265,173,339,387,28,11,12,74,214,56,98,0,0
1549,266,173,338,379,28,11,12,72,206,57,98,0,0
1550,265,175,335,374,28,11,12,70,199,58,98,0,0
1551,263,172,332,366,28,11,12,69,194,59,98,0,0
1552,263,170,330,359,28,11,12,67,189,60,98,0,0
1553,263,169,330,358,28,11,12,67,189,61,98,0,0
1554,264,167,330,351,28,11,12,66,184,62,98,0,0
1555,266,166,330,344,28,11,12,64,178,63,98,0,0
1556,264,166,327,339,28,11,12,63,173,64,98,0,0
1557,261,161,324,336,28,11,12,63,175,65,98,0,0
1558,261,159,323,333,28,11,12,62,174,66,98,0,0
1559,261,157,323,330,28,11,12,62,173,67,98,0,0
1560,262,153,324,324,28,11,12,62,171,68,98,0,0
1561,264,155,323,318,28,11,12,59,163,69,98,0,0
1562,264,155,321,312,28,11,12,57,157,70,98,0,0
1563,263,151,320,309,28,11,12,57,158,71,98,0,0
1564,265,151,320,305,28,11,12,55,154,72,98,0,0
1565,268,150,322,302,28,11,12,54,152,73,98,0,0
1566,272,151,323,297,28,11,12,51,146,74,98,0,0
1567,273,151,324,295,28,11,12,51,144,75,98,0,0
1568,273,148,323,289,28,11,12,50,141,76,98,0,0
1569,273,147,323,289,28,11,12,50,142,77,98,0,0
1570,274,147,323,286,28,11,12,49,139,78,98,0,0
1571,276,145,323,282,28,11,12,47,137,79,98,0,0
1572,276,144,323,280,28,11,12,47,136,80,98,0,0
1573,276,146,322,278,28,11,12,46,132,81,98,0,0
1574,275,143,320,275,28,11,12,45,132,82,98,0,0
1575,275,143,321,274,28,11,12,46,131,83,98,0,0
1576,277,144,321,271,28,11,12,44,127,84,98,0,0
1577,278,143,321,267,28,11,12,43,124,85,98,0,0
1578,278,143,320,264,28,11,12,42,121,86,98,0,0
1579,276,141,318,261,28,11,12,42,120,87,98,0,0
1580,275,139,316,260,28,11,12,41,121,88,98,0,0
1581,274,140,314,258,28,11,12,40,118,89,98,0,0
1582,274,139,314,256,28,11,12,40,117,90,98,0,0
1583,274,137,314,253,28,11,12,40,116,91,98,0,0
1584,274,138,313,252,28,11,12,39,114,92,98,0,0
1585,272,135,311,250,28,11,12,39,115,93,98,0,0
1586,270,132,309,250,28,11,12,39,118,94,98,0,0
1587,270,132,308,250,28,11,12,38,118,95,98,0,0
1588,271,133,308,246,28,11,12,37,113,96,98,0,0
1589,273,132,309,245,28,11,12,36,113,97,98,0,0
1590,273,131,308,242,28,11,12,35,111,98,98,1,0
1906,0,614,106,1043,32,11,12,106,429,0,0,0,0
1907,52,592,267,1076,34,11,12,215,484,0,0,0,0
1908,183,583,422,1068,35,11,12,239,485,0,1,0,0
1909,272,551,528,1072,35,11,12,256,521,1,1,0,0
1910,430,550,737,1078,37,11,12,307,528,0,24,0,1
1911,500,519,819,1071,37,11,12,319,552,1,24,0,0
1912,600,510,925,1076,37,11,12,325,566,2,24,0,0
1913,681,502,1012,1079,37,11,12,331,577,3,24,0,0
1914,834,478,1173,1078,37,11,12,339,600,4,24,0,0
1915,936,481,1272,1077,37,11,12,336,596,5,24,0,0
1916,1028,478,1357,1068,37,11,12,329,590,6,24,0,0
1917,1112,477,1433,1057,37,11,12,321,580,7,24,0,0
1918,1186,485,1495,1039,37,11,12,309,554,8,24,0,0
1919,1299,476,1589,1009,37,11,12,290,533,9,24,0,0
1920,1366,477,1653,1001,37,11,12,287,524,10,24,0,0
1921,1443,466,1708,960,37,11,12,265,494,11,24,0,0
1922,1494,466,1741,930,37,11,12,247,464,12,24,0,0
1923,1537,468,1773,908,37,11,12,236,440,13,24,0,0
1924,1602,459,1827,887,37,11,12,225,428,14,24,0,0
1925,1638,455,1859,876,37,11,12,221,421,15,24,0,0
1926,1683,439,1890,845,37,11,12,207,406,16,24,0,0
1927,1707,437,1901,820,37,11,12,194,383,17,24,0,0
1928,1731,443,1915,805,37,11,12,184,362,18,24,0,0
1929,1774,450,1920,791,37,11,12,146,341,19,24,0,0
1930,1789,453,1920,790,37,11,12,131,337,20,24,0,0
1931,1816,456,1920,770,37,11,12,104,314,21,24,0,0
1932,1822,438,1920,754,37,11,12,98,316,22,24,0,0
1933,1836,454,1920,744,37,11,12,84,290,23,24,0,0
1934,1867,454,1920,729,37,11,12,53,275,24,24,1,0
2176,1857,491,1920,716,39,11,12,63,225,0,36,0,1
2177,1845,463,1920,730,39,11,12,75,267,1,36,0,0
2178,1836,430,1920,736,39,11,12,84,306,2,36,0,0
2179,1822,378,1920,761,39,11,12,98,383,3,36,0,0
2180,1816,386,1920,775,39,11,12,104,389,4,36,0,0
2181,1802,387,1912,778,39,11,12,110,391,5,36,0,0
2182,1768,391,1884,783,39,11,12,116,392,6,36,0,0
2183,1744,392,1866,786,39,11,12,122,394,7,36,0,0
2184,1727,385,1857,794,39,11,12,130,409,8,36,0,0
2185,1702,389,1841,815,39,11,12,139,426,9,36,0,0
2186,1681,395,1827,834,39,11,12,146,439,10,36,0,0
2187,1657,396,1809,841,39,11,12,152,445,11,36,0,0
2188,1599,400,1763,852,39,11,12,164,452,12,36,0,0
2189,1560,406,1732,859,39,11,12,172,453,13,36,0,0
2190,1533,395,1717,867,39,11,12,184,472,14,36,0,0
2191,1498,400,1695,897,39,11,12,197,497,15,36,0,0
2192,1462,405,1669,923,39,11,12,207,518,16,36,0,0
2193,1427,400,1640,931,39,11,12,213,531,17,36,0,0
2194,1347,402,1574,943,39,11,12,227,541,18,36,0,0
2195,1288,403,1522,950,39,11,12,234,547,19,36,0,0
2196,1242,391,1487,963,39,11,12,245,572,20,36,0,0
2197,1165,391,1426,993,39,11,12,261,602,21,36,0,0
2198,1102,399,1374,1024,39,11,12,272,625,22,36,0,0
2199,1053,395,1328,1034,39,11,12,275,639,23,36,0,0
2200,946,396,1229,1037,39,11,12,283,641,24,36,0,0
2201,880,398,1169,1045,39,11,12,289,647,25,36,0,0
2202,813,396,1101,1054,39,11,12,288,658,26,36,0,0
2203,706,400,1001,1067,39,11,12,295,667,27,36,0,0
2204,633,417,928,1070,39,11,12,295,653,28,36,0,0
2205,552,425,837,1075,39,11,12,285,650,29,36,0,0
2206,467,435,756,1080,39,11,12,289,645,30,36,0,0
2207,377,448,654,1074,39,11,12,277,626,31,36,0,0
2208,261,443,533,1071,39,11,12,272,628,32,36,0,0
2209,184,455,453,1068,39,11,12,269,613,33,36,0,0
2210,79,481,334,1044,39,11,12,255,563,34,36,0,0
2211,0,487,223,1050,39,11,12,223,563,35,36,0,0
2212,0,493,143,1053,39,11,12,143,560,36,36,1,0
2251,320,110,356,180,42,11,12,36,70,0,87,0,0
2253,320,110,356,180,42,11,12,36,70,0,87,0,0
2254,321,109,356,180,42,11,12,35,71,1,87,0,0
2255,321,109,356,181,42,11,12,35,72,2,87,0,0
2278,321,115,356,204,42,11,12,35,89,0,87,0,1
2279,321,117,356,206,42,11,12,35,89,1,87,0,0
2280,320,115,356,208,42,11,12,36,93,2,87,0,0
2281,321,117,357,211,42,11,12,36,94,3,87,0,0
2282,320,116,358,214,42,11,12,38,98,4,87,0,0
2283,319,118,356,215,42,11,12,37,97,5,87,0,0
2284,317,117,355,218,42,11,12,38,101,6,87,0,0
2285,314,117,353,221,42,11,12,39,104,7,87,0,0
2286,313,118,352,223,42,11,12,39,105,8,87,0,0
2287,313,119,351,223,42,11,12,38,104,9,87,0,0
2288,311,118,350,224,42,11,12,39,106,10,87,0,0
2289,308,118,348,227,42,11,12,40,109,11,87,0,0
2290,306,118,346,228,42,11,12,40,110,12,87,0,0
2291,305,119,344,230,42,11,12,39,111,13,87,0,0
2292,306,121,344,229,42,11,12,38,108,14,87,0,0
2293,305,122,344,234,42,11,12,39,112,15,87,0,0
2294,304,124,342,237,42,11,12,38,113,16,87,0,0
2295,302,124,341,238,42,11,12,39,114,17,87,0,0
2296,301,125,341,241,42,11,12,40,116,18,87,0,0
2297,302,129,341,244,42,11,12,39,115,19,87,0,0
2298,301,129,340,245,42,11,12,39,116,20,87,0,0
2299,299,131,338,247,42,11,12,39,116,21,87,0,0
2300,299,133,337,249,42,11,12,38,116,22,87,0,0
2301,298,136,336,252,42,11,12,38,116,23,87,0,0
2302,299,138,337,254,42,11,12,38,116,24,87,0,0
2303,298,133,339,257,42,11,12,41,124,25,87,0,0
2304,298,136,337,257,42,11,12,39,121,26,87,0,0
2305,297,138,336,260,42,11,12,39,122,27,87,0,0
2306,296,137,337,264,42,11,12,41,127,28,87,0,0
2307,296,138,338,269,42,11,12,42,131,29,87,0,0
2308,298,137,340,270,42,11,12,42,133,30,87,0,0
2309,297,139,339,274,42,11,12,42,135,31,87,0,0
2310,294,140,338,278,42,11,12,44,138,32,87,0,0
2311,294,141,338,280,42,11,12,44,139,33,87,0,0
2312,295,145,339,285,42,11,12,44,140,34,87,0,0
2313,297,147,340,285,42,11,12,43,138,35,87,0,0
2314,297,148,342,290,42,11,12,45,142,36,87,0,0
2315,297,151,342,293,42,11,12,45,142,37,87,0,0
2316,299,150,345,296,42,11,12,46,146,38,87,0,0
2317,300,149,348,303,42,11,12,48,154,39,87,0,0
2318,303,148,353,304,42,11,12,50,156,40,87,0,0
2319,304,146,356,311,42,11,12,52,165,41,87,0,0
2320,304,148,357,315,42,11,12,53,167,42,87,0,0
2321,305,149,357,316,42,11,12,52,167,43,87,0,0
2322,304,148,360,325,42,11,12,56,177,44,87,0,0
2323,304,146,362,330,42,11,12,58,184,45,87,0,0
2324,302,145,362,336,42,11,12,60,191,46,87,0,0
2325,299,155,358,342,42,11,12,59,187,47,87,0,0
2326,298,158,357,342,42,11,12,59,184,48,87,0,0
2327,298,165,357,353,42,11,12,59,188,49,87,0,0
2328,298,167,360,360,42,11,12,62,193,50,87,0,0
2329,298,169,361,367,42,11,12,63,198,51,87,0,0
2330,295,175,360,376,42,11,12,65,201,52,87,0,0
2331,294,176,359,380,42,11,12,65,204,53,87,0,0
2332,293,176,361,389,42,11,12,68,213,54,87,0,0
2333,294,177,364,397,42,11,12,70,220,55,87,0,0
2334,292,176,364,402,42,11,12,72,226,56,87,0,0
2335,288,181,364,416,42,11,12,76,235,57,87,0,0
2336,287,183,364,423,42,11,12,77,240,58,87,0,0
2337,288,184,367,431,42,11,12,79,247,59,87,0,0
2338,290,188,370,440,42,11,12,80,252,60,87,0,0
2339,290,188,372,448,42,11,12,82,260,61,87,0,0
2340,286,192,373,466,42,11,12,87,274,62,87,0,0
2341,286,196,374,472,42,11,12,88,276,63,87,0,0
2342,285,198,377,486,42,11,12,92,288,64,87,0,0
2343,290,205,379,481,42,11,12,89,276,65,87,0,0
2344,293,206,384,487,42,11,12,91,281,66,87,0,0
2345,290,207,390,517,42,11,12,100,310,67,87,0,0
2346,288,214,393,540,42,11,12,105,326,68,87,0,0
2347,288,218,400,560,42,11,12,112,342,69,87,0,0
2348,285,227,404,593,42,11,12,119,366,70,87,0,0
2349,284,232,406,608,42,11,12,122,376,71,87,0,0
2350,281,240,407,627,42,11,12,126,387,72,87,0,0
2351,275,250,408,660,42,11,12,133,410,73,87,0,0
2352,272,251,410,677,42,11,12,138,426,74,87,0,0
2353,275,267,417,704,42,11,12,142,437,75,87,0,0
2354,280,279,428,735,42,11,12,148,456,76,87,0,0
2355,281,281,440,772,42,11,12,159,491,77,87,0,0
2356,284,297,455,821,42,11,12,171,524,78,87,0,0
2357,288,314,462,846,42,11,12,174,532,79,87,0,0
2358,291,326,477,885,42,11,12,186,559,80,87,0,0
2359,292,348,490,940,42,11,12,198,592,81,87,0,0
2360,292,369,491,958,42,11,12,199,589,82,87,0,0
2361,272,392,488,1020,42,11,12,216,628,83,87,0,0
2362,224,418,456,1057,42,11,12,232,639,84,87,0,0
2363,149,438,391,1076,42,11,12,242,638,85,87,0,0
2364,92,463,338,1077,42,11,12,246,614,86,87,0,0
2365,79,477,329,1080,42,11,12,250,603,87,87,1,0
2339,36,599,284,1076,43,11,12,248,477,0,65,0,1
2340,28,530,309,1069,43,11,12,281,539,1,65,0,0
2341,142,508,430,1060,43,11,12,288,552,2,65,0,0
2342,205,479,508,1066,43,11,12,303,587,3,65,0,0
2343,246,434,549,1029,43,11,12,303,595,4,65,0,0
2344,285,420,575,1000,43,11,12,290,580,5,65,0,0
2345,321,392,585,929,43,11,12,264,537,6,65,0,0
2346,353,369,598,875,43,11,12,245,506,7,65,0,0
2347,386,348,615,834,43,11,12,229,486,8,65,0,0
2348,414,327,622,777,43,11,12,208,450,9,65,0,0
2349,429,315,627,751,43,11,12,198,436,10,65,0,0
2350,438,294,622,705,43,11,12,184,411,11,65,0,0
2351,440,283,612,675,43,11,12,172,392,12,65,0,0
2352,439,277,603,659,43,11,12,164,382,13,65,0,0
2353,438,268,588,625,43,11,12,150,357,14,65,0,0
2354,430,260,575,609,43,11,12,145,349,15,65,0,0
2355,418,252,553,581,43,11,12,135,329,16,65,0,0
2356,403,246,531,562,43,11,12,128,316,17,65,0,0
2357,393,244,505,525,43,11,12,112,281,18,65,0,0
2358,380,237,483,496,43,11,12,103,259,19,65,0,0
2359,366,235,464,481,43,11,12,98,246,20,65,0,0
2360,346,230,438,461,43,11,12,92,231,21,65,0,0
2361,328,228,426,479,43,11,12,98,251,22,65,0,0
2362,320,225,416,476,43,11,12,96,251,23,65,0,0
2363,312,217,404,462,43,11,12,92,245,24,65,0,0
2364,307,221,393,452,43,11,12,86,231,25,65,0,0
2365,299,212,382,437,43,11,12,83,225,26,65,0,0
2366,292,207,374,428,43,11,12,82,221,27,65,0,0
2367,292,207,370,421,43,11,12,78,214,28,65,0,0
2368,291,202,367,411,43,11,12,76,209,29,65,0,0
2369,291,199,365,406,43,11,12,74,207,30,65,0,0
2370,288,190,360,394,43,11,12,72,204,31,65,0,0
2371,288,188,357,385,43,11,12,69,197,32,65,0,0
2372,286,185,355,384,43,11,12,69,199,33,65,0,0
2373,289,182,354,372,43,11,12,65,190,34,65,0,0
2374,290,182,352,366,43,11,12,62,184,35,65,0,0
2375,287,181,348,359,43,11,12,61,178,36,65,0,0
2376,287,182,345,353,43,11,12,58,171,37,65,0,0
2377,286,181,344,352,43,11,12,58,171,38,65,0,0
2378,288,180,342,341,43,11,12,54,161,39,65,0,0
2379,288,181,340,335,43,11,12,52,154,40,65,0,0
2380,283,170,337,331,43,11,12,54,161,41,65,0,0
2381,280,164,334,326,43,11,12,54,162,42,65,0,0
2382,279,163,333,326,43,11,12,54,163,43,65,0,0
2383,281,163,331,316,43,11,12,50,153,44,65,0,0
2384,282,161,331,315,43,11,12,49,154,45,65,0,0
2385,283,158,330,306,43,11,12,47,148,46,65,0,0
2386,285,158,331,303,43,11,12,46,145,47,65,0,0
2387,287,158,333,301,43,11,12,46,143,48,65,0,0
2388,291,157,334,289,43,11,12,43,132,49,65,0,0
2389,293,158,335,287,43,11,12,42,129,50,65,0,0
2390,292,155,333,285,43,11,12,41,130,51,65,0,0
2391,291,154,332,282,43,11,12,41,128,52,65,0,0
2392,290,154,331,279,43,11,12,41,125,53,65,0,0
2393,291,154,330,276,43,11,12,39,122,54,65,0,0
2394,290,154,330,276,43,11,12,40,122,55,65,0,0
2395,288,149,328,272,43,11,12,40,123,56,65,0,0
2396,288,149,326,267,43,11,12,38,118,57,65,0,0
2397,288,148,325,262,43,11,12,37,114,58,65,0,0
2398,290,147,325,256,43,11,12,35,109,59,65,0,0
2399,289,148,324,255,43,11,12,35,107,60,65,0,0
2400,288,145,323,253,43,11,12,35,108,61,65,0,0
2401,288,145,323,252,43,11,12,35,107,62,65,0,0
2402,289,143,324,250,43,11,12,35,107,63,65,0,0
2403,291,142,326,247,43,11,12,35,105,64,65,0,0
2404,291,141,326,248,43,11,12,35,107,65,65,1,0
2433,5,653,161,1080,44,11,12,156,427,0,82,0,1
2434,43,607,213,1069,44,11,12,170,462,1,82,0,0
2435,111,577,277,1029,44,11,12,166,452,2,82,0,0
2436,173,551,361,1055,44,11,12,188,504,3,82,0,0
2437,255,520,460,1056,44,11,12,205,536,4,82,0,0
2438,298,487,520,1062,44,11,12,222,575,5,82,0,0
2439,327,457,555,1053,44,11,12,228,596,6,82,0,0
2440,362,444,585,1032,44,11,12,223,588,7,82,0,0
2441,398,426,608,985,44,11,12,210,559,8,82,0,0
2442,425,402,632,956,44,11,12,207,554,9,82,0,0
2443,448,387,649,929,44,11,12,201,542,10,82,0,0
2444,468,364,663,897,44,11,12,195,533,11,82,0,0
2445,484,351,665,852,44,11,12,181,501,12,82,0,0
2446,491,337,667,830,44,11,12,176,493,13,82,0,0
2447,498,325,661,788,44,11,12,163,463,14,82,0,0
2448,500,310,652,745,44,11,12,152,435,15,82,0,0
2449,503,305,649,724,44,11,12,146,419,16,82,0,0
2450,502,292,647,708,44,11,12,145,416,17,82,0,0
2451,507,282,642,672,44,11,12,135,390,18,82,0,0
2452,509,276,639,651,44,11,12,130,375,19,82,0,0
2453,502,266,627,626,44,11,12,125,360,20,82,0,0
2454,492,259,613,613,44,11,12,121,354,21,82,0,0
2455,486,253,604,599,44,11,12,118,346,22,82,0,0
2456,488,248,595,565,44,11,12,107,317,23,82,0,0
2457,487,239,592,556,44,11,12,105,317,24,82,0,0
2458,488,236,590,547,44,11,12,102,311,25,82,0,0
2459,481,227,580,533,44,11,12,99,306,26,82,0,0
2460,477,216,574,518,44,11,12,97,302,27,82,0,0
2461,478,217,571,509,44,11,12,93,292,28,82,0,0
2462,479,218,567,494,44,11,12,88,276,29,82,0,0
2463,480,216,563,480,44,11,12,83,264,30,82,0,0
2464,475,216,556,469,44,11,12,81,253,31,82,0,0
2465,464,211,543,459,44,11,12,79,248,32,82,0,0
2466,458,205,535,451,44,11,12,77,246,33,82,0,0
2467,449,202,525,443,44,11,12,76,241,34,82,0,0
2468,437,195,513,437,44,11,12,76,242,35,82,0,0
2469,428,197,502,431,44,11,12,74,234,36,82,0,0
2470,414,197,486,423,44,11,12,72,226,37,82,0,0
2471,400,195,469,415,44,11,12,69,220,38,82,0,0
2472,386,199,452,409,44,11,12,66,210,39,82,0,0
2473,369,188,436,401,44,11,12,67,213,40,82,0,0
2474,355,182,422,396,44,11,12,67,214,41,82,0,0
2475,344,177,412,393,44,11,12,68,216,42,82,0,0
2476,331,169,400,388,44,11,12,69,219,43,82,0,0
2477,323,176,388,384,44,11,12,65,208,44,82,0,0
2478,315,182,377,381,44,11,12,62,199,45,82,0,0
2479,304,181,363,369,44,11,12,59,188,46,82,0,0
2480,292,180,351,367,44,11,12,59,187,47,82,0,0
2481,286,179,345,367,44,11,12,59,188,48,82,0,0
2482,282,177,340,359,44,11,12,58,182,49,82,0,0
2483,278,172,337,356,44,11,12,59,184,50,82,0,0
2484,276,174,336,352,44,11,12,60,178,51,82,0,0
2485,279,173,336,341,44,11,12,57,168,52,82,0,0
2486,279,171,335,337,44,11,12,56,166,53,82,0,0
2487,278,170,334,337,44,11,12,56,167,54,82,0,0
2488,279,168,334,332,44,11,12,55,164,55,82,0,0
2489,281,168,336,330,44,11,12,55,162,56,82,0,0
2490,280,166,336,328,44,11,12,56,162,57,82,0,0
2491,279,162,334,323,44,11,12,55,161,58,82,0,0
2492,278,163,330,318,44,11,12,52,155,59,82,0,0
2493,276,162,326,310,44,11,12,50,148,60,82,0,0
2494,276,159,326,306,44,11,12,50,147,61,82,0,0
2495,275,158,325,304,44,11,12,50,146,62,82,0,0
2496,278,158,327,300,44,11,12,49,142,63,82,0,0
2497,279,157,327,300,44,11,12,48,143,64,82,0,0
2498,280,155,327,297,44,11,12,47,142,65,82,0,0
2499,282,154,328,291,44,11,12,46,137,66,82,0,0
2500,284,154,329,287,44,11,12,45,133,67,82,0,0
2501,287,156,331,286,44,11,12,44,130,68,82,0,0
2502,290,155,334,283,44,11,12,44,128,69,82,0,0
2503,291,152,336,280,44,11,12,45,128,70,82,0,0
2504,291,151,335,277,44,11,12,44,126,71,82,0,0
2505,293,150,338,277,44,11,12,45,127,72,82,0,0
2506,296,152,340,276,44,11,12,44,124,73,82,0,0
2507,299,151,343,274,44,11,12,44,123,74,82,0,0
2508,305,151,347,271,44,11,12,42,120,75,82,0,0
2509,307,150,348,269,44,11,12,41,119,76,82,0,0
2510,308,149,347,266,44,11,12,39,117,77,82,0,0
2511,309,145,348,263,44,11,12,39,118,78,82,0,0
2512,311,144,349,260,44,11,12,38,116,79,82,0,0
2513,312,143,351,261,44,11,12,39,118,80,82,0,0
2514,312,139,350,256,44,11,12,38,117,81,82,0,0
2515,313,143,348,253,44,11,12,35,110,82,82,1,0
2517,311,140,346,249,44,11,12,35,109,0,82,0,0
2561,1866,594,1919,710,46,11,12,53,116,0,4,0,0
2562,1864,593,1918,711,46,11,12,54,118,1,4,0,0
2563,1864,598,1916,712,46,11,12,52,114,2,4,0,0
2564,1863,586,1920,710,46,11,12,57,124,3,4,0,0
2565,1862,583,1920,710,46,11,12,58,127,4,4,0,0
2772,1864,605,1920,727,47,11,12,56,122,0,0,0,0
2773,1835,313,1920,739,48,11,12,85,426,0,30,0,1
2774,1841,424,1906,742,48,11,12,65,318,1,30,0,0
2775,1833,446,1900,776,48,11,12,67,330,2,30,0,0
2776,1825,453,1894,782,48,11,12,69,329,3,30,0,0
2777,1800,428,1880,789,48,11,12,80,361,4,30,0,0
2778,1763,398,1857,800,48,11,12,94,402,5,30,0,0
2779,1734,383,1841,811,48,11,12,107,428,6,30,0,0
2780,1716,380,1832,829,48,11,12,116,449,7,30,0,0
2781,1677,386,1807,859,48,11,12,130,473,8,30,0,0
2782,1654,397,1790,875,48,11,12,136,478,9,30,0,0
2783,1594,380,1747,884,48,11,12,153,504,10,30,0,0
2784,1533,384,1700,900,48,11,12,167,516,11,30,0,0
2785,1484,379,1664,914,48,11,12,180,535,12,30,0,0
2786,1434,377,1634,954,48,11,12,200,577,13,30,0,0
2787,1387,394,1598,981,48,11,12,211,587,14,30,0,0
2788,1341,395,1559,997,48,11,12,218,602,15,30,0,0
2789,1241,391,1475,1008,48,11,12,234,617,16,30,0,0
2790,1161,400,1409,1031,48,11,12,248,631,17,30,0,0
2791,1105,402,1357,1050,48,11,12,252,648,18,30,0,0
2792,1006,416,1269,1065,48,11,12,263,649,19,30,0,0
2793,942,426,1212,1077,48,11,12,270,651,20,30,0,0
2794,839,418,1108,1079,48,11,12,269,661,21,30,0,0
2795,702,420,979,1079,48,11,12,277,659,22,30,0,0
2796,612,414,902,1080,48,11,12,290,666,23,30,0,0
2797,488,396,780,1080,48,11,12,292,684,24,30,0,0
2798,379,393,684,1080,48,11,12,305,687,25,30,0,0
2799,282,434,580,1080,48,11,12,298,646,26,30,0,0
2800,157,450,438,1066,48,11,12,281,616,27,30,0,0
2801,51,477,319,1052,48,11,12,268,575,28,30,0,0
2802,0,491,226,1070,48,11,12,226,579,29,30,0,0
2803,0,499,140,1076,48,11,12,140,577,30,30,1,0
3469,1836,448,1920,766,50,11,12,84,318,0,29,0,1
3470,1804,413,1901,776,50,11,12,97,363,1,29,0,0
3471,1780,396,1887,792,50,11,12,107,396,2,29,0,0
3472,1769,400,1880,799,50,11,12,111,399,3,29,0,0
3473,1755,411,1870,816,50,11,12,115,405,4,29,0,0
3474,1732,417,1855,839,50,11,12,123,422,5,29,0,0
3475,1714,419,1838,839,50,11,12,124,420,6,29,0,0
3476,1663,429,1796,855,50,11,12,133,426,7,29,0,0
3477,1632,431,1774,866,50,11,12,142,435,8,29,0,0
3478,1612,432,1761,881,50,11,12,149,449,9,29,0,0
3479,1564,435,1730,917,50,11,12,166,482,10,29,0,0
3480,1529,440,1702,935,50,11,12,173,495,11,29,0,0
3481,1453,444,1641,956,50,11,12,188,512,12,29,0,0
3482,1393,443,1595,976,50,11,12,202,533,13,29,0,0
3483,1355,434,1563,980,50,11,12,208,546,14,29,0,0
3484,1271,443,1493,1010,50,11,12,222,567,15,29,0,0
3485,1197,447,1434,1043,50,11,12,237,596,16,29,0,0
3486,1128,440,1373,1057,50,11,12,245,617,17,29,0,0
3487,1007,446,1261,1064,50,11,12,254,618,18,29,0,0
3488,930,433,1189,1070,50,11,12,259,637,19,29,0,0
3489,861,431,1116,1069,50,11,12,255,638,20,29,0,0
3490,772,443,1027,1076,50,11,12,255,633,21,29,0,0
3491,667,457,915,1079,50,11,12,248,622,22,29,0,0
3492,555,457,804,1079,50,11,12,249,622,23,29,0,0
3493,472,466,725,1078,50,11,12,253,612,24,29,0,0
3494,357,464,606,1079,50,11,12,249,615,25,29,0,0
3495,261,475,513,1080,50,11,12,252,605,26,29,0,0
3496,163,502,411,1078,50,11,12,248,576,27,29,0,0
3497,43,504,290,1075,50,11,12,247,571,28,29,0,0
3498,0,509,207,1080,50,11,12,207,571,29,29,1,0
3968,1241,863,1413,1073,52,11,12,172,210,0,0,0,0
3974,960,480,1549,1076,53,11,12,589,596,0,3,0,0
3975,1006,445,1606,1072,53,11,12,600,627,1,3,0,0
3976,1046,426,1640,1066,53,11,12,594,640,2,3,0,0
3977,1043,392,1668,1066,53,11,12,625,674,3,3,0,0
3975,0,708,177,1068,54,11,12,177,360,0,0,0,0
3976,102,681,277,1076,55,11,12,175,395,0,1,0,0
3977,163,651,349,1070,55,11,12,186,419,1,1,0,0
3977,1287,415,1515,957,56,11,12,228,542,0,14,0,0
3978,1303,427,1520,943,56,11,12,217,516,1,14,0,0
3979,1336,432,1547,927,56,11,12,211,495,2,14,0,0
3980,1422,417,1627,896,56,11,12,205,479,3,14,0,0
3981,1475,414,1679,889,56,11,12,204,475,4,14,0,0
3982,1528,401,1729,864,56,11,12,201,463,5,14,0,0
3983,1579,402,1771,844,56,11,12,192,442,6,14,0,0
3984,1612,413,1796,827,56,11,12,184,414,7,14,0,0
3985,1666,413,1845,814,56,11,12,179,401,8,14,0,0
3986,1715,412,1892,810,56,11,12,177,398,9,14,0,0
3987,1747,418,1920,806,56,11,12,173,388,10,14,0,0
3988,1788,422,1920,788,56,11,12,132,366,11,14,0,0
3989,1807,449,1920,779,56,11,12,113,330,12,14,0,0
3990,1829,467,1920,765,56,11,12,91,298,13,14,0,0
3991,1865,474,1920,752,56,11,12,55,278,14,14,0,0
3978,263,636,565,1068,57,11,12,302,432,0,32,0,1
3979,366,626,670,1061,57,11,12,304,435,1,32,0,0
3980,448,609,767,1068,57,11,12,319,459,2,32,0,0
3981,497,606,818,1069,57,11,12,321,463,3,32,0,0
3982,584,592,918,1076,57,11,12,334,484,4,32,0,0
3983,706,575,1042,1072,57,11,12,336,497,5,32,0,0
3984,807,575,1142,1076,57,11,12,335,501,6,32,0,0
3985,888,572,1224,1079,57,11,12,336,507,7,32,0,0
3986,977,546,1322,1080,57,11,12,345,534,8,32,0,0
3987,1016,535,1366,1078,57,11,12,350,543,9,32,0,0
3988,1077,522,1425,1074,57,11,12,348,552,10,32,0,0
3989,1150,506,1490,1060,57,11,12,340,554,11,32,0,0
3990,1199,498,1534,1049,57,11,12,335,551,12,32,0,0
3991,1261,495,1569,1011,57,11,12,308,516,13,32,0,0
3992,1321,479,1618,990,57,11,12,297,511,14,32,0,0
3993,1356,472,1643,979,57,11,12,287,507,15,32,0,0
3994,1406,458,1672,943,57,11,12,266,485,16,32,0,0
3995,1440,454,1686,913,57,11,12,246,459,17,32,0,0
3996,1469,453,1702,892,57,11,12,233,439,18,32,0,0
3997,1504,440,1731,872,57,11,12,227,432,19,32,0,0
3998,1547,437,1765,857,57,11,12,218,420,20,32,0,0
3999,1573,445,1782,850,57,11,12,209,405,21,32,0,0
4000,1611,434,1808,822,57,11,12,197,388,22,32,0,0
4001,1637,450,1821,814,57,11,12,184,364,23,32,0,0
4002,1663,460,1840,806,57,11,12,177,346,24,32,0,0
4003,1700,453,1875,798,57,11,12,175,345,25,32,0,0
4004,1726,458,1897,799,57,11,12,171,341,26,32,0,0
4005,1746,453,1915,795,57,11,12,169,342,27,32,0,0
4006,1780,457,1920,777,57,11,12,140,320,28,32,0,0
4007,1791,453,1920,772,57,11,12,129,319,29,32,0,0
4008,1805,478,1920,768,57,11,12,115,290,30,32,0,0
4009,1831,497,1920,761,57,11,12,89,264,31,32,0,0
4010,1859,502,1920,751,57,11,12,61,249,32,32,1,0
4415,316,114,351,190,59,11,12,35,76,0,118,0,1
4416,316,115,352,193,59,11,12,36,78,1,118,0,0
4417,316,115,353,196,59,11,12,37,81,2,118,0,0
4418,316,115,352,195,59,11,12,36,80,3,118,0,0
4419,316,114,354,197,59,11,12,38,83,4,118,0,0
4420,317,116,354,199,59,11,12,37,83,5,118,0,0
4421,319,118,355,198,59,11,12,36,80,6,118,0,0
4422,320,118,356,198,59,11,12,36,80,7,118,0,0
4423,320,118,357,199,59,11,12,37,81,8,118,0,0
4424,318,118,356,200,59,11,12,38,82,9,118,0,0
4425,318,118,355,201,59,11,12,37,83,10,118,0,0
4426,318,118,355,202,59,11,12,37,84,11,118,0,0
4427,318,118,355,202,59,11,12,37,84,12,118,0,0
4428,318,118,355,203,59,11,12,37,85,13,118,0,0
4429,317,121,353,203,59,11,12,36,82,14,118,0,0
4430,318,121,354,206,59,11,12,36,85,15,118,0,0
4431,318,123,354,208,59,11,12,36,85,16,118,0,0
4432,319,118,356,208,59,11,12,37,90,17,118,0,0
4433,319,120,356,209,59,11,12,37,89,18,118,0,0
4434,318,122,354,209,59,11,12,36,87,19,118,0,0
4435,318,126,353,212,59,11,12,35,86,20,118,0,0
4436,318,124,353,214,59,11,12,35,90,21,118,0,0
4437,318,123,355,215,59,11,12,37,92,22,118,0,0
4438,317,120,355,218,59,11,12,38,98,23,118,0,0
4439,316,118,355,219,59,11,12,39,101,24,118,0,0
4440,317,123,354,220,59,11,12,37,97,25,118,0,0
4441,316,120,354,224,59,11,12,38,104,26,118,0,0
4442,317,122,355,226,59,11,12,38,104,27,118,0,0
4443,316,122,355,228,59,11,12,39,106,28,118,0,0
4444,316,119,355,229,59,11,12,39,110,29,118,0,0
4445,316,121,355,231,59,11,12,39,110,30,118,0,0
4446,316,122,355,231,59,11,12,39,109,31,118,0,0
4447,316,119,356,233,59,11,12,40,114,32,118,0,0
4448,317,121,356,233,59,11,12,39,112,33,118,0,0
4449,317,122,356,234,59,11,12,39,112,34,118,0,0
4450,317,120,357,237,59,11,12,40,117,35,118,0,0
4451,317,122,357,238,59,11,12,40,116,36,118,0,0
4452,317,120,358,239,59,11,12,41,119,37,118,0,0
4453,318,123,358,241,59,11,12,40,118,38,118,0,0
4454,318,123,359,242,59,11,12,41,119,39,118,0,0
4455,318,121,360,244,59,11,12,42,123,40,118,0,0
4456,318,125,360,246,59,11,12,42,121,41,118,0,0
4457,318,122,361,247,59,11,12,43,125,42,118,0,0
4458,317,119,362,250,59,11,12,45,131,43,118,0,0
4459,317,120,361,250,59,11,12,44,130,44,118,0,0
4460,316,120,360,252,59,11,12,44,132,45,118,0,0
4461,314,122,359,256,59,11,12,45,134,46,118,0,0
4462,311,121,357,256,59,11,12,46,135,47,118,0,0
4463,310,124,356,261,59,11,12,46,137,48,118,0,0
4464,311,129,355,263,59,11,12,44,134,49,118,0,0
4465,310,126,356,265,59,11,12,46,139,50,118,0,0
4466,311,130,357,270,59,11,12,46,140,51,118,0,0
4467,310,135,356,272,59,11,12,46,137,52,118,0,0
4468,311,134,357,275,59,11,12,46,141,53,118,0,0
4469,311,132,358,277,59,11,12,47,145,54,118,0,0
4470,312,127,362,279,59,11,12,50,152,55,118,0,0
4471,313,127,364,281,59,11,12,51,154,56,118,0,0
4472,315,134,365,285,59,11,12,50,151,57,118,0,0
4473,314,134,365,287,59,11,12,51,153,58,118,0,0
4474,314,128,368,292,59,11,12,54,164,59,118,0,0
4475,318,137,369,295,59,11,12,51,158,60,118,0,0
4476,320,143,371,298,59,11,12,51,155,61,118,0,0
4477,320,142,372,301,59,11,12,52,159,62,118,0,0
4478,319,145,371,302,59,11,12,52,157,63,118,0,0
4479,320,150,371,305,59,11,12,51,155,64,118,0,0
4480,318,151,371,312,59,11,12,53,161,65,118,0,0
4481,318,150,372,315,59,11,12,54,165,66,118,0,0
4482,316,149,372,322,59,11,12,56,173,67,118,0,0
4483,312,147,371,327,59,11,12,59,180,68,118,0,0
4484,310,144,370,330,59,11,12,60,186,69,118,0,0
4485,309,151,368,335,59,11,12,59,184,70,118,0,0
4486,311,159,368,339,59,11,12,57,180,71,118,0,0
4487,312,161,369,340,59,11,12,57,179,72,118,0,0
4488,313,166,371,349,59,11,12,58,183,73,118,0,0
4489,310,169,370,356,59,11,12,60,187,74,118,0,0
4490,310,171,370,361,59,11,12,60,190,75,118,0,0
4491,310,174,370,367,59,11,12,60,193,76,118,0,0
4492,312,176,373,369,59,11,12,61,193,77,118,0,0
4493,313,175,377,378,59,11,12,64,203,78,118,0,0
4494,312,177,377,384,59,11,12,65,207,79,118,0,0
4495,309,178,375,387,59,11,12,66,209,80,118,0,0
4496,307,179,375,396,59,11,12,68,217,81,118,0,0
4497,310,182,379,402,59,11,12,69,220,82,118,0,0
4498,311,182,383,410,59,11,12,72,228,83,118,0,0
4499,313,187,386,422,59,11,12,73,235,84,118,0,0
4500,314,189,389,428,59,11,12,75,239,85,118,0,0
4501,315,191,392,434,59,11,12,77,243,86,118,0,0
4502,319,194,399,447,59,11,12,80,253,87,118,0,0
4503,322,195,404,452,59,11,12,82,257,88,118,0,0
4504,322,199,409,467,59,11,12,87,268,89,118,0,0
4505,324,204,411,476,59,11,12,87,272,90,118,0,0
4506,328,207,416,481,59,11,12,88,274,91,118,0,0
4507,332,211,423,494,59,11,12,91,283,92,118,0,0
4508,337,215,430,508,59,11,12,93,293,93,118,0,0
4509,337,214,437,522,59,11,12,100,308,94,118,0,0
4510,333,223,440,546,59,11,12,107,323,95,118,0,0
4511,333,230,443,558,59,11,12,110,328,96,118,0,0
4512,336,233,450,578,59,11,12,114,345,97,118,0,0
4513,339,239,458,599,59,11,12,119,360,98,118,0,0
4514,343,242,464,604,59,11,12,121,362,99,118,0,0
4515,334,247,468,639,59,11,12,134,392,100,118,0,0
4516,334,255,472,661,59,11,12,138,406,101,118,0,0
4517,343,263,483,673,59,11,12,140,410,102,118,0,0
4518,353,278,498,698,59,11,12,145,420,103,118,0,0
4519,362,286,513,726,59,11,12,151,440,104,118,0,0
4520,360,297,518,754,59,11,12,158,457,105,118,0,0
4521,349,316,519,800,59,11,12,170,484,106,118,0,0
4522,353,324,524,815,59,11,12,171,491,107,118,0,0
4523,352,336,534,859,59,11,12,182,523,108,118,0,0
4524,350,347,544,906,59,11,12,194,559,109,118,0,0
4525,342,353,545,932,59,11,12,203,579,110,118,0,0
4526,323,369,536,977,59,11,12,213,608,111,118,0,0
4527,313,394,526,993,59,11,12,213,599,112,118,0,0
4528,273,411,495,1030,59,11,12,222,619,113,118,0,0
4529,225,435,452,1057,59,11,12,227,622,114,118,0,0
4530,169,466,383,1034,59,11,12,214,568,115,118,0,0
4531,82,489,286,1020,59,11,12,204,531,116,118,0,0
4532,30,522,225,1025,59,11,12,195,503,117,118,0,0
4533,6,538,201,1041,59,11,12,195,503,118,118,1,0
4506,160,666,386,1071,60,11,12,226,405,0,0,0,0
4507,320,639,559,1071,61,11,12,239,432,0,1,0,0
4508,405,606,664,1076,61,11,12,259,470,1,1,0,0
4509,585,598,836,1070,62,11,12,251,472,0,24,0,1
4510,681,586,942,1078,62,11,12,261,492,1,24,0,0
4511,799,574,1067,1069,62,11,12,268,495,2,24,0,0
4512,901,564,1178,1067,62,11,12,277,503,3,24,0,0
4513,995,534,1290,1075,62,11,12,295,541,4,24,0,0
4514,1064,527,1364,1077,62,11,12,300,550,5,24,0,0
4515,1138,531,1443,1079,62,11,12,305,548,6,24,0,0
4516,1231,520,1539,1078,62,11,12,308,558,7,24,0,0
4517,1304,516,1614,1073,62,11,12,310,557,8,24,0,0
4518,1376,511,1676,1058,62,11,12,300,547,9,24,0,0
4519,1418,509,1711,1043,62,11,12,293,534,10,24,0,0
4520,1460,518,1739,1017,62,11,12,279,499,11,24,0,0
4521,1538,511,1807,997,62,11,12,269,486,12,24,0,0
4522,1589,503,1854,984,62,11,12,265,481,13,24,0,0
4523,1641,482,1893,950,62,11,12,252,468,14,24,0,0
4524,1667,472,1905,921,62,11,12,238,449,15,24,0,0
4525,1695,471,1920,896,62,11,12,225,425,16,24,0,0
4526,1732,477,1920,865,62,11,12,188,388,17,24,0,0
4527,1754,483,1920,860,62,11,12,166,377,18,24,0,0
4528,1773,472,1920,835,62,11,12,147,363,19,24,0,0
4529,1779,465,1920,817,62,11,12,141,352,20,24,0,0
4530,1787,466,1920,802,62,11,12,133,336,21,24,0,0
4531,1805,466,1920,782,62,11,12,115,316,22,24,0,0
4532,1815,443,1920,778,62,11,12,105,335,23,24,0,0
4533,1841,437,1920,762,62,11,12,79,325,24,24,1,0
4533,1874,504,1920,764,63,11,12,46,260,0,0,0,0
4619,555,498,1126,1080,66,11,12,571,582,0,69,0,1
4620,523,470,1086,1070,66,11,12,563,600,1,69,0,0
4621,491,451,1043,1069,66,11,12,552,618,2,69,0,0
4622,477,432,979,1021,66,11,12,502,589,3,69,0,0
4623,465,409,936,988,66,11,12,471,579,4,69,0,0
4624,452,395,901,970,66,11,12,449,575,5,69,0,0
4625,446,377,848,917,66,11,12,402,540,6,69,0,0
4626,434,358,798,873,66,11,12,364,515,7,69,0,0
4627,423,349,764,857,66,11,12,341,508,8,69,0,0
4628,420,336,727,817,66,11,12,307,481,9,69,0,0
4629,417,327,703,790,66,11,12,286,463,10,69,0,0
4630,416,320,686,775,66,11,12,270,455,11,69,0,0
4631,416,308,657,729,66,11,12,241,421,12,69,0,0
4632,410,302,631,706,66,11,12,221,404,13,69,0,0
4633,402,292,613,693,66,11,12,211,401,14,69,0,0
4634,402,280,599,667,66,11,12,197,387,15,69,0,0
4635,403,276,591,652,66,11,12,188,376,16,69,0,0
4636,396,264,573,624,66,11,12,177,360,17,69,0,0
4637,393,259,556,602,66,11,12,163,343,18,69,0,0
4638,389,251,546,591,66,11,12,157,340,19,69,0,0
4639,378,243,525,571,66,11,12,147,328,20,69,0,0
4640,372,237,512,561,66,11,12,140,324,21,69,0,0
4641,374,235,504,544,66,11,12,130,309,22,69,0,0
4642,369,225,494,531,66,11,12,125,306,23,69,0,0
4643,367,222,486,523,66,11,12,119,301,24,69,0,0
4644,365,221,479,518,66,11,12,114,297,25,69,0,0
4645,365,218,469,495,66,11,12,104,277,26,69,0,0
4646,364,214,468,490,66,11,12,104,276,27,69,0,0
4647,366,212,467,482,66,11,12,101,270,28,69,0,0
4648,368,205,466,470,66,11,12,98,265,29,69,0,0
4649,365,205,458,458,66,11,12,93,253,30,69,0,0
4650,362,201,450,447,66,11,12,88,246,31,69,0,0
4651,358,197,444,440,66,11,12,86,243,32,69,0,0
4652,355,194,439,432,66,11,12,84,238,33,69,0,0
4653,353,191,435,427,66,11,12,82,236,34,69,0,0
4654,351,185,431,422,66,11,12,80,237,35,69,0,0
4655,350,184,427,416,66,11,12,77,232,36,69,0,0
4656,346,182,422,413,66,11,12,76,231,37,69,0,0
4657,343,180,416,404,66,11,12,73,224,38,69,0,0
4658,342,179,413,397,66,11,12,71,218,39,69,0,0
4659,341,175,411,395,66,11,12,70,220,40,69,0,0
4660,338,176,406,388,66,11,12,68,212,41,69,0,0
4661,335,178,399,384,66,11,12,64,206,42,69,0,0
4662,329,176,390,376,66,11,12,61,200,43,69,0,0
4663,328,176,386,369,66,11,12,58,193,44,69,0,0
4664,328,177,384,366,66,11,12,56,189,45,69,0,0
4665,329,180,382,357,66,11,12,53,177,46,69,0,0
4666,329,177,381,352,66,11,12,52,175,47,69,0,0
4667,330,182,379,350,66,11,12,49,168,48,69,0,0
4668,328,182,376,348,66,11,12,48,166,49,69,0,0
4669,327,177,374,338,66,11,12,47,161,50,69,0,0
4670,325,174,373,336,66,11,12,48,162,51,69,0,0
4671,324,170,371,330,66,11,12,47,160,52,69,0,0
4672,322,169,367,327,66,11,12,45,158,53,69,0,0
4673,320,170,365,326,66,11,12,45,156,54,69,0,0
4674,317,166,362,323,66,11,12,45,157,55,69,0,0
4675,316,162,361,319,66,11,12,45,157,56,69,0,0
4676,318,161,363,320,66,11,12,45,159,57,69,0,0
4677,321,163,364,316,66,11,12,43,153,58,69,0,0
4678,323,167,363,309,66,11,12,40,142,59,69,0,0
4679,325,166,362,298,66,11,12,37,132,60,69,0,0
4680,322,157,362,300,66,11,12,40,143,61,69,0,0
4681,321,155,361,297,66,11,12,40,142,62,69,0,0
4682,322,157,361,298,66,11,12,39,141,63,69,0,0
4683,324,150,364,293,66,11,12,40,143,64,69,0,0
4684,325,148,364,288,66,11,12,39,140,65,69,0,0
4685,324,146,363,287,66,11,12,39,141,66,69,0,0
4686,324,145,362,286,66,11,12,38,141,67,69,0,0
4687,323,142,360,281,66,11,12,37,139,68,69,0,0
4688,324,140,361,280,66,11,12,37,140,69,69,1,0
4694,316,128,352,268,66,11,12,36,140,0,69,0,0
4695,314,125,350,261,66,11,12,36,136,1,69,0,0
4698,310,127,346,259,66,11,12,36,132,0,69,0,0
4699,310,125,346,259,66,11,12,36,134,1,69,0,0
4620,427,383,708,1066,67,11,12,281,683,0,94,0,1
4621,407,366,688,1052,67,11,12,281,686,1,94,0,0
4622,387,363,667,1048,67,11,12,280,685,2,94,0,0
4623,375,347,636,988,67,11,12,261,641,3,94,0,0
4624,361,332,610,951,67,11,12,249,619,4,94,0,0
4625,352,325,597,938,67,11,12,245,613,5,94,0,0
4626,356,315,579,880,67,11,12,223,565,6,94,0,0
4627,350,299,561,842,67,11,12,211,543,7,94,0,0
4628,346,301,546,817,67,11,12,200,516,8,94,0,0
4629,338,295,527,787,67,11,12,189,492,9,94,0,0
4630,321,271,509,766,67,11,12,188,495,10,94,0,0
4631,309,265,494,760,67,11,12,185,495,11,94,0,0
4632,305,256,487,751,67,11,12,182,495,12,94,0,0
4633,306,244,475,710,67,11,12,169,466,13,94,0,0
4634,307,240,466,687,67,11,12,159,447,14,94,0,0
4635,303,236,455,666,67,11,12,152,430,15,94,0,0
4636,292,228,437,642,67,11,12,145,414,16,94,0,0
4637,287,226,429,633,67,11,12,142,407,17,94,0,0
4638,285,225,423,622,67,11,12,138,397,18,94,0,0
4639,288,218,417,593,67,11,12,129,375,19,94,0,0
4640,292,217,415,579,67,11,12,123,362,20,94,0,0
4641,292,218,408,563,67,11,12,116,345,21,94,0,0
4642,287,209,399,544,67,11,12,112,335,22,94,0,0
4643,282,206,392,535,67,11,12,110,329,23,94,0,0
4644,279,203,388,530,67,11,12,109,327,24,94,0,0
4645,280,199,382,509,67,11,12,102,310,25,94,0,0
4646,280,196,379,498,67,11,12,99,302,26,94,0,0
4647,279,194,376,487,67,11,12,97,293,27,94,0,0
4648,276,188,371,474,67,11,12,95,286,28,94,0,0
4649,275,186,369,469,67,11,12,94,283,29,94,0,0
4650,275,188,367,464,67,11,12,92,276,30,94,0,0
4651,279,180,367,446,67,11,12,88,266,31,94,0,0
4652,283,178,369,440,67,11,12,86,262,32,94,0,0
4653,285,178,369,434,67,11,12,84,256,33,94,0,0
4654,286,177,366,423,67,11,12,80,246,34,94,0,0
4655,284,175,363,421,67,11,12,79,246,35,94,0,0
4656,283,174,360,415,67,11,12,77,241,36,94,0,0
4657,283,170,357,403,67,11,12,74,233,37,94,0,0
4658,281,169,354,397,67,11,12,73,228,38,94,0,0
4659,278,169,350,394,67,11,12,72,225,39,94,0,0
4660,275,167,346,386,67,11,12,71,219,40,94,0,0
4661,274,165,345,384,67,11,12,71,219,41,94,0,0
4662,276,166,345,381,67,11,12,69,215,42,94,0,0
4663,278,163,344,371,67,11,12,66,208,43,94,0,0
4664,279,162,344,368,67,11,12,65,206,44,94,0,0
4665,276,161,340,363,67,11,12,64,202,45,94,0,0
4666,273,158,336,357,67,11,12,63,199,46,94,0,0
4667,271,158,332,355,67,11,12,61,197,47,94,0,0
4668,269,155,330,352,67,11,12,61,197,48,94,0,0
4669,269,153,329,345,67,11,12,60,192,49,94,0,0
4670,269,155,327,340,67,11,12,58,185,50,94,0,0
4671,268,155,324,337,67,11,12,56,182,51,94,0,0
4672,265,151,320,332,67,11,12,55,181,52,94,0,0
4673,264,152,318,328,67,11,12,54,176,53,94,0,0
4674,264,150,318,326,67,11,12,54,176,54,94,0,0
4675,266,149,318,320,67,11,12,52,171,55,94,0,0
4676,267,150,317,317,67,11,12,50,167,56,94,0,0
4677,266,149,315,312,67,11,12,49,163,57,94,0,0
4678,267,148,316,311,67,11,12,49,163,58,94,0,0
4679,270,145,318,309,67,11,12,48,164,59,94,0,0
4680,276,144,323,303,67,11,12,47,159,60,94,0,0
4681,278,143,325,300,67,11,12,47,157,61,94,0,0
4682,280,143,326,298,67,11,12,46,155,62,94,0,0
4683,282,142,327,295,67,11,12,45,153,63,94,0,0
4684,282,141,327,293,67,11,12,45,152,64,94,0,0
4685,282,140,327,291,67,11,12,45,151,65,94,0,0
4686,284,140,327,285,67,11,12,43,145,66,94,0,0
4687,286,141,327,283,67,11,12,41,142,67,94,0,0
4688,287,141,328,282,67,11,12,41,141,68,94,0,0
4689,286,140,327,280,67,11,12,41,140,69,94,0,0
4690,283,138,325,279,67,11,12,42,141,70,94,0,0
4691,283,138,325,278,67,11,12,42,140,71,94,0,0
4692,283,138,324,275,67,11,12,41,137,72,94,0,0
4693,283,137,323,272,67,11,12,40,135,73,94,0,0
4694,283,137,323,271,67,11,12,40,134,74,94,0,0
4695,280,137,320,267,67,11,12,40,130,75,94,0,0
4696,279,139,317,265,67,11,12,38,126,76,94,0,0
4697,277,140,315,264,67,11,12,38,124,77,94,0,0
4698,277,136,314,260,67,11,12,37,124,78,94,0,0
4699,278,136,315,260,67,11,12,37,124,79,94,0,0
4700,278,137,316,261,67,11,12,38,124,80,94,0,0
4701,278,138,314,257,67,11,12,36,119,81,94,0,0
4702,277,136,314,256,67,11,12,37,120,82,94,0,0
4703,277,137,313,255,67,11,12,36,118,83,94,0,0
4704,276,135,313,255,67,11,12,37,120,84,94,0,0
4705,276,134,312,251,67,11,12,36,117,85,94,0,0
4706,276,133,313,251,67,11,12,37,118,86,94,0,0
4707,276,133,313,251,67,11,12,37,118,87,94,0,0
4708,276,136,311,247,67,11,12,35,111,88,94,0,0
4709,275,134,311,248,67,11,12,36,114,89,94,0,0
4710,275,130,311,246,67,11,12,36,116,90,94,0,0
4711,276,129,312,243,67,11,12,36,114,91,94,0,0
4712,276,129,311,242,67,11,12,35,113,92,94,0,0
4713,275,129,310,241,67,11,12,35,112,93,94,0,0
4714,274,129,309,240,67,11,12,35,111,94,94,1,0
4716,274,125,309,239,67,11,12,35,114,0,94,0,0
4717,276,124,311,234,67,11,12,35,110,1,94,0,0
4718,276,123,311,235,67,11,12,35,112,2,94,0,0
4986,333,143,370,263,79,11,12,37,120,0,89,0,1
4987,338,149,374,263,79,11,12,36,114,1,89,0,0
4988,336,155,371,265,79,11,12,35,110,2,89,0,0
4989,336,156,371,265,79,11,12,35,109,3,89,0,0
4990,335,159,372,269,79,11,12,37,110,4,89,0,0
4991,335,161,371,271,79,11,12,36,110,5,89,0,0
4992,335,164,372,274,79,11,12,37,110,6,89,0,0
4993,337,158,376,275,79,11,12,39,117,7,89,0,0
4994,339,157,379,276,79,11,12,40,119,8,89,0,0
4995,340,161,379,279,79,11,12,39,118,9,89,0,0
4996,341,164,379,280,79,11,12,38,116,10,89,0,0
4997,340,164,378,282,79,11,12,38,118,11,89,0,0
4998,341,163,380,285,79,11,12,39,122,12,89,0,0
4999,343,162,382,285,79,11,12,39,123,13,89,0,0
5000,343,162,382,287,79,11,12,39,125,14,89,0,0
5001,341,164,381,291,79,11,12,40,127,15,89,0,0
5002,339,167,379,295,79,11,12,40,128,16,89,0,0
5003,337,168,379,300,79,11,12,42,132,17,89,0,0
5004,336,170,378,304,79,11,12,42,134,18,89,0,0
5005,336,172,378,305,79,11,12,42,133,19,89,0,0
5006,336,172,379,311,79,11,12,43,139,20,89,0,0
5007,336,176,379,315,79,11,12,43,139,21,89,0,0
5008,335,177,379,318,79,11,12,44,141,22,89,0,0
5009,336,178,382,323,79,11,12,46,145,23,89,0,0
5010,339,179,386,326,79,11,12,47,147,24,89,0,0
5011,341,179,389,327,79,11,12,48,148,25,89,0,0
5012,343,182,391,332,79,11,12,48,150,26,89,0,0
5013,344,182,393,335,79,11,12,49,153,27,89,0,0
5014,346,184,395,338,79,11,12,49,154,28,89,0,0
5015,349,186,400,343,79,11,12,51,157,29,89,0,0
5016,353,182,405,347,79,11,12,52,165,30,89,0,0
5017,354,181,409,355,79,11,12,55,174,31,89,0,0
5018,355,185,410,358,79,11,12,55,173,32,89,0,0
5019,356,184,411,358,79,11,12,55,174,33,89,0,0
5020,359,193,413,363,79,11,12,54,170,34,89,0,0
5021,364,196,419,368,79,11,12,55,172,35,89,0,0
5022,367,198,423,374,79,11,12,56,176,36,89,0,0
5023,370,198,427,380,79,11,12,57,182,37,89,0,0
5024,369,197,428,386,79,11,12,59,189,38,89,0,0
5025,369,197,431,391,79,11,12,62,194,39,89,0,0
5026,370,203,433,398,79,11,12,63,195,40,89,0,0
5027,373,206,437,403,79,11,12,64,197,41,89,0,0
5028,376,206,442,412,79,11,12,66,206,42,89,0,0
5029,378,212,445,421,79,11,12,67,209,43,89,0,0
5030,377,212,446,426,79,11,12,69,214,44,89,0,0
5031,378,214,447,429,79,11,12,69,215,45,89,0,0
5032,379,223,449,438,79,11,12,70,215,46,89,0,0
5033,384,225,457,445,79,11,12,73,220,47,89,0,0
5034,387,225,463,452,79,11,12,76,227,48,89,0,0
5035,390,228,467,463,79,11,12,77,235,49,89,0,0
5036,388,231,467,468,79,11,12,79,237,50,89,0,0
5037,387,231,469,477,79,11,12,82,246,51,89,0,0
5038,390,243,471,483,79,11,12,81,240,52,89,0,0
5039,397,246,480,491,79,11,12,83,245,53,89,0,0
5040,401,251,487,503,79,11,12,86,252,54,89,0,0
5041,400,252,490,518,79,11,12,90,266,55,89,0,0
5042,400,254,492,524,79,11,12,92,270,56,89,0,0
5043,402,255,499,542,79,11,12,97,287,57,89,0,0
5044,405,263,505,556,79,11,12,100,293,58,89,0,0
5045,412,268,513,564,79,11,12,101,296,59,89,0,0
5046,421,274,525,579,79,11,12,104,305,60,89,0,0
5047,424,280,532,597,79,11,12,108,317,61,89,0,0
5048,427,280,537,604,79,11,12,110,324,62,89,0,0
5049,435,289,548,617,79,11,12,113,328,63,89,0,0
5050,443,293,560,636,79,11,12,117,343,64,89,0,0
5051,450,298,570,651,79,11,12,120,353,65,89,0,0
5052,456,310,581,678,79,11,12,125,368,66,89,0,0
5053,454,321,581,701,79,11,12,127,380,67,89,0,0
5054,450,328,579,712,79,11,12,129,384,68,89,0,0
5055,448,337,582,731,79,11,12,134,394,69,89,0,0
5056,445,345,585,756,79,11,12,140,411,70,89,0,0
5057,453,348,596,770,79,11,12,143,422,71,89,0,0
5058,458,356,610,804,79,11,12,152,448,72,89,0,0
5059,462,378,618,840,79,11,12,156,462,73,89,0,0
5060,466,388,624,859,79,11,12,158,471,74,89,0,0
5061,470,401,631,874,79,11,12,161,473,75,89,0,0
5062,476,427,645,913,79,11,12,169,486,76,89,0,0
5063,503,439,677,934,79,11,12,174,495,77,89,0,0
5064,525,459,708,977,79,11,12,183,518,78,89,0,0
5065,535,486,726,1032,79,11,12,191,546,79,89,0,0
5066,545,502,740,1053,79,11,12,195,551,80,89,0,0
5067,547,526,746,1074,79,11,12,199,548,81,89,0,0
5068,552,551,751,1080,79,11,12,199,529,82,89,0,0
5069,570,575,765,1080,79,11,12,195,505,83,89,0,0
5070,570,603,760,1080,79,11,12,190,477,84,89,0,0
5071,537,618,726,1080,79,11,12,189,462,85,89,0,0
5072,488,645,674,1080,79,11,12,186,435,86,89,0,0
5073,436,676,618,1080,79,11,12,182,404,87,89,0,0
5074,370,712,547,1077,79,11,12,177,365,88,89,0,0
5075,355,734,526,1080,79,11,12,171,346,89,89,1,0
4931,318,114,354,187,83,11,12,36,73,0,88,0,0
4932,319,114,354,186,83,11,12,35,72,1,88,0,0
4933,320,114,355,187,83,11,12,35,73,2,88,0,0
4934,319,113,354,188,83,11,12,35,75,3,88,0,0
4935,317,113,354,192,83,11,12,37,79,4,88,0,0
4936,317,114,355,195,83,11,12,38,81,5,88,0,0
4937,315,114,353,196,83,11,12,38,82,6,88,0,0
4938,313,114,350,196,83,11,12,37,82,7,88,0,0
4939,322,118,358,198,83,11,12,36,80,8,88,0,0
4941,328,120,363,201,83,11,12,35,81,0,88,0,0
4942,327,119,362,201,83,11,12,35,82,1,88,0,0
4968,341,137,376,231,83,11,12,35,94,0,88,0,0
4969,342,136,378,232,83,11,12,36,96,1,88,0,0
4970,343,136,379,231,83,11,12,36,95,2,88,0,0
4971,343,132,381,234,83,11,12,38,102,3,88,0,0
4972,345,133,383,236,83,11,12,38,103,4,88,0,0
4973,348,134,386,238,83,11,12,38,104,5,88,0,0
4974,349,134,387,241,83,11,12,38,107,6,88,0,0
4975,348,137,386,244,83,11,12,38,107,7,88,0,0
4976,346,137,385,248,83,11,12,39,111,8,88,0,0
4977,346,136,386,250,83,11,12,40,114,9,88,0,0
4978,348,138,388,252,83,11,12,40,114,10,88,0,0
4979,352,138,390,252,83,11,12,38,114,11,88,0,0
4980,353,138,391,252,83,11,12,38,114,12,88,0,0
4981,355,139,390,249,83,11,12,35,110,13,88,0,0
4982,356,141,391,252,83,11,12,35,111,14,88,0,0
4983,356,143,391,256,83,11,12,35,113,15,88,0,0
4986,359,145,394,262,83,11,12,35,117,0,88,0,0
4988,362,147,397,266,83,11,12,35,119,0,88,0,1
4989,363,148,398,269,83,11,12,35,121,1,88,0,0
4990,368,151,403,271,83,11,12,35,120,2,88,0,0
4991,373,150,409,272,83,11,12,36,122,3,88,0,0
4992,376,152,412,272,83,11,12,36,120,4,88,0,0
4993,377,152,414,276,83,11,12,37,124,5,88,0,0
4994,377,152,415,278,83,11,12,38,126,6,88,0,0
4995,377,151,416,282,83,11,12,39,131,7,88,0,0
4996,377,151,417,284,83,11,12,40,133,8,88,0,0
4997,378,151,419,286,83,11,12,41,135,9,88,0,0
4998,379,150,421,289,83,11,12,42,139,10,88,0,0
4999,379,150,422,292,83,11,12,43,142,11,88,0,0
5000,378,149,422,295,83,11,12,44,146,12,88,0,0
5001,378,150,423,300,83,11,12,45,150,13,88,0,0
5002,380,150,426,302,83,11,12,46,152,14,88,0,0
5003,384,153,430,303,83,11,12,46,150,15,88,0,0
5004,385,155,432,307,83,11,12,47,152,16,88,0,0
5005,385,156,433,314,83,11,12,48,158,17,88,0,0
5006,384,154,434,316,83,11,12,50,162,18,88,0,0
5007,384,156,435,320,83,11,12,51,164,19,88,0,0
5008,388,158,438,323,83,11,12,50,165,20,88,0,0
5009,392,160,442,326,83,11,12,50,166,21,88,0,0
5010,393,163,444,331,83,11,12,51,168,22,88,0,0
5011,393,166,444,334,83,11,12,51,168,23,88,0,0
5012,393,166,444,336,83,11,12,51,170,24,88,0,0
5013,394,171,445,340,83,11,12,51,169,25,88,0,0
5014,397,173,449,343,83,11,12,52,170,26,88,0,0
5015,400,174,453,349,83,11,12,53,175,27,88,0,0
5016,403,175,457,358,83,11,12,54,183,28,88,0,0
5017,406,176,462,362,83,11,12,56,186,29,88,0,0
5018,408,177,464,364,83,11,12,56,187,30,88,0,0
5019,410,178,467,368,83,11,12,57,190,31,88,0,0
5020,414,175,474,372,83,11,12,60,197,32,88,0,0
5021,417,178,478,380,83,11,12,61,202,33,88,0,0
5022,419,185,479,386,83,11,12,60,201,34,88,0,0
5023,422,190,481,391,83,11,12,59,201,35,88,0,0
5024,423,191,484,395,83,11,12,61,204,36,88,0,0
5025,428,198,488,401,83,11,12,60,203,37,88,0,0
5026,433,200,494,406,83,11,12,61,206,38,88,0,0
5027,436,201,499,414,83,11,12,63,213,39,88,0,0
5028,437,201,503,423,83,11,12,66,222,40,88,0,0
5029,437,201,504,426,83,11,12,67,225,41,88,0,0
5030,439,201,508,434,83,11,12,69,233,42,88,0,0
5031,442,202,514,441,83,11,12,72,239,43,88,0,0
5032,447,203,520,446,83,11,12,73,243,44,88,0,0
5033,450,208,525,455,83,11,12,75,247,45,88,0,0
5034,453,212,530,466,83,11,12,77,254,46,88,0,0
5035,453,214,531,470,83,11,12,78,256,47,88,0,0
5036,455,216,534,477,83,11,12,79,261,48,88,0,0
5037,459,221,539,480,83,11,12,80,259,49,88,0,0
5038,463,226,545,493,83,11,12,82,267,50,88,0,0
5039,466,231,551,506,83,11,12,85,275,51,88,0,0
5040,471,234,557,509,83,11,12,86,275,52,88,0,0
5041,476,240,564,521,83,11,12,88,281,53,88,0,0
5042,484,244,575,535,83,11,12,91,291,54,88,0,0
5043,493,247,586,542,83,11,12,93,295,55,88,0,0
5044,494,254,593,566,83,11,12,99,312,56,88,0,0
5045,499,261,600,582,83,11,12,101,321,57,88,0,0
5046,506,263,608,590,83,11,12,102,327,58,88,0,0
5047,517,270,623,609,83,11,12,106,339,59,88,0,0
5048,526,278,636,626,83,11,12,110,348,60,88,0,0
5049,536,282,647,632,83,11,12,111,350,61,88,0,0
5050,540,288,660,665,83,11,12,120,377,62,88,0,0
5051,550,296,672,684,83,11,12,122,388,63,88,0,0
5052,558,301,683,692,83,11,12,125,391,64,88,0,0
5053,570,315,701,721,83,11,12,131,406,65,88,0,0
5054,584,321,721,743,83,11,12,137,422,66,88,0,0
5055,604,328,741,754,83,11,12,137,426,67,88,0,0
5056,610,342,760,801,83,11,12,150,459,68,88,0,0
5057,622,360,778,832,83,11,12,156,472,69,88,0,0
5058,634,369,791,849,83,11,12,157,480,70,88,0,0
5059,646,384,813,885,83,11,12,167,501,71,88,0,0
5060,665,402,837,922,83,11,12,172,520,72,88,0,0
5061,686,418,861,938,83,11,12,175,520,73,88,0,0
5062,703,435,887,977,83,11,12,184,542,74,88,0,0
5063,720,461,917,1042,83,11,12,197,581,75,88,0,0
5064,743,480,942,1061,83,11,12,199,581,76,88,0,0
5065,768,503,967,1079,83,11,12,199,576,77,88,0,0
5066,802,529,999,1080,83,11,12,197,551,78,88,0,0
5067,858,557,1051,1080,83,11,12,193,523,79,88,0,0
5068,904,583,1097,1080,83,11,12,193,497,80,88,0,0
5069,942,610,1133,1080,83,11,12,191,470,81,88,0,0
5070,980,634,1172,1078,83,11,12,192,444,82,88,0,0
5071,1019,673,1211,1080,83,11,12,192,407,83,88,0,0
5072,1077,719,1263,1080,83,11,12,186,361,84,88,0,0
5073,1170,790,1343,1080,83,11,12,173,290,85,88,0,0
5074,1258,848,1418,1080,83,11,12,160,232,86,88,0,0
5075,1326,895,1469,1079,83,11,12,143,184,87,88,0,0
5076,1390,934,1507,1080,83,11,12,117,146,88,88,1,0
4975,286,135,321,242,90,11,12,35,107,0,90,0,0
4976,287,136,322,242,90,11,12,35,106,1,90,0,0
4977,287,136,322,245,90,11,12,35,109,2,90,0,0
4978,286,135,322,247,90,11,12,36,112,3,90,0,0
4979,286,137,322,249,90,11,12,36,112,4,90,0,0
4980,285,140,320,253,90,11,12,35,113,5,90,0,0
4981,284,141,319,253,90,11,12,35,112,6,90,0,0
4982,282,144,317,255,90,11,12,35,111,7,90,0,0
4985,279,146,314,261,90,11,12,35,115,0,90,0,1
4986,280,144,316,263,90,11,12,36,119,1,90,0,0
4987,281,147,317,266,90,11,12,36,119,2,90,0,0
4988,282,148,318,268,90,11,12,36,120,3,90,0,0
4989,282,146,319,270,90,11,12,37,124,4,90,0,0
4990,282,147,320,273,90,11,12,38,126,5,90,0,0
4991,284,150,321,274,90,11,12,37,124,6,90,0,0
4992,285,152,323,276,90,11,12,38,124,7,90,0,0
4993,285,153,323,278,90,11,12,38,125,8,90,0,0
4994,286,153,324,280,90,11,12,38,127,9,90,0,0
4995,287,154,325,283,90,11,12,38,129,10,90,0,0
4996,289,157,327,284,90,11,12,38,127,11,90,0,0
4997,291,159,329,288,90,11,12,38,129,12,90,0,0
4998,293,160,331,286,90,11,12,38,126,13,90,0,0
4999,292,159,332,290,90,11,12,40,131,14,90,0,0
5000,292,159,333,293,90,11,12,41,134,15,90,0,0
5001,293,162,335,297,90,11,12,42,135,16,90,0,0
5002,293,161,337,301,90,11,12,44,140,17,90,0,0
5003,292,166,336,305,90,11,12,44,139,18,90,0,0
5004,289,169,333,307,90,11,12,44,138,19,90,0,0
5005,286,170,331,309,90,11,12,45,139,20,90,0,0
5006,284,169,331,315,90,11,12,47,146,21,90,0,0
5007,283,165,330,318,90,11,12,47,153,22,90,0,0
5008,283,170,329,321,90,11,12,46,151,23,90,0,0
5009,281,169,329,325,90,11,12,48,156,24,90,0,0
5010,281,170,329,329,90,11,12,48,159,25,90,0,0
5011,281,178,328,332,90,11,12,47,154,26,90,0,0
5012,281,176,329,336,90,11,12,48,160,27,90,0,0
5013,281,175,330,338,90,11,12,49,163,28,90,0,0
5014,281,179,331,346,90,11,12,50,167,29,90,0,0
5015,280,182,330,349,90,11,12,50,167,30,90,0,0
5016,280,183,331,354,90,11,12,51,171,31,90,0,0
5017,280,184,332,358,90,11,12,52,174,32,90,0,0
5018,279,183,333,363,90,11,12,54,180,33,90,0,0
5019,279,185,336,373,90,11,12,57,188,34,90,0,0
5020,278,186,336,377,90,11,12,58,191,35,90,0,0
5021,278,189,336,382,90,11,12,58,193,36,90,0,0
5022,278,191,337,386,90,11,12,59,195,37,90,0,0
5023,275,189,336,390,90,11,12,61,201,38,90,0,0
5024,274,195,337,400,90,11,12,63,205,39,90,0,0
5025,275,198,338,404,90,11,12,63,206,40,90,0,0
5026,276,202,338,407,90,11,12,62,205,41,90,0,0
5027,277,206,339,412,90,11,12,62,206,42,90,0,0
5028,276,206,340,418,90,11,12,64,212,43,90,0,0
5029,275,207,341,426,90,11,12,66,219,44,90,0,0
5030,273,210,339,432,90,11,12,66,222,45,90,0,0
5031,270,212,338,439,90,11,12,68,227,46,90,0,0
5032,270,216,340,450,90,11,12,70,234,47,90,0,0
5033,272,219,344,459,90,11,12,72,240,48,90,0,0
5034,273,220,347,466,90,11,12,74,246,49,90,0,0
5035,275,225,349,472,90,11,12,74,247,50,90,0,0
5036,280,227,356,480,90,11,12,76,253,51,90,0,0
5037,287,233,365,487,90,11,12,78,254,52,90,0,0
5038,293,239,372,497,90,11,12,79,258,53,90,0,0
5039,299,241,379,505,90,11,12,80,264,54,90,0,0
5040,298,246,381,520,90,11,12,83,274,55,90,0,0
5041,298,250,383,534,90,11,12,85,284,56,90,0,0
5042,298,254,385,541,90,11,12,87,287,57,90,0,0
5043,293,258,387,564,90,11,12,94,306,58,90,0,0
5044,291,263,387,572,90,11,12,96,309,59,90,0,0
5045,285,264,384,582,90,11,12,99,318,60,90,0,0
5046,279,272,382,602,90,11,12,103,330,61,90,0,0
5047,280,279,382,607,90,11,12,102,328,62,90,0,0
5048,283,289,388,628,90,11,12,105,339,63,90,0,0
5049,288,292,396,643,90,11,12,108,351,64,90,0,0
5050,289,297,402,656,90,11,12,113,359,65,90,0,0
5051,288,305,410,694,90,11,12,122,389,66,90,0,0
5052,288,312,414,709,90,11,12,126,397,67,90,0,0
5053,298,322,425,722,90,11,12,127,400,68,90,0,0
5054,309,337,437,735,90,11,12,128,398,69,90,0,0
5055,307,338,444,760,90,11,12,137,422,70,90,0,0
5056,301,351,448,804,90,11,12,147,453,71,90,0,0
5057,297,367,446,821,90,11,12,149,454,72,90,0,0
5058,297,381,450,847,90,11,12,153,466,73,90,0,0
5059,294,403,458,903,90,11,12,164,500,74,90,0,0
5060,296,417,462,917,90,11,12,166,500,75,90,0,0
5061,288,429,468,968,90,11,12,180,539,76,90,0,0
5062,277,445,473,1034,90,11,12,196,589,77,90,0,0
5063,273,462,472,1045,90,11,12,199,583,78,90,0,0
5064,260,484,462,1069,90,11,12,202,585,79,90,0,0
5065,242,506,440,1069,90,11,12,198,563,80,90,0,0
5066,219,528,402,1032,90,11,12,183,504,81,90,0,0
5067,172,542,359,1042,90,11,12,187,500,82,90,0,0
5068,110,548,309,1054,90,11,12,199,506,83,90,0,0
5069,103,583,271,1020,90,11,12,168,437,84,90,0,0
5070,94,596,249,1004,90,11,12,155,408,85,90,0,0
5071,81,586,238,1002,90,11,12,157,416,86,90,0,0
5072,55,566,223,1006,90,11,12,168,440,87,90,0,0
5073,74,580,233,995,90,11,12,159,415,88,90,0,0
5074,94,590,252,997,90,11,12,158,407,89,90,0,0
5075,88,598,243,1000,90,11,12,155,402,90,90,1,0
5008,361,178,396,306,97,11,12,35,128,0,0,0,0
5075,41,577,510,1072,98,11,12,469,495,0,10,0,0
5076,71,579,526,1062,98,11,12,455,483,1,10,0,0
5077,135,587,579,1065,98,11,12,444,478,2,10,0,0
5078,224,610,647,1071,98,11,12,423,461,3,10,0,0
5079,320,634,719,1072,98,11,12,399,438,4,10,0,0
5080,387,661,761,1078,98,11,12,374,417,5,10,0,0
5081,503,691,847,1079,98,11,12,344,388,6,10,0,0
5082,619,711,945,1077,98,11,12,326,366,7,10,0,0
5083,776,787,1043,1079,98,11,12,267,292,8,10,0,0
5084,943,878,1131,1077,98,11,12,188,199,9,10,0,0
5085,1058,923,1205,1077,98,11,12,147,154,10,10,0,0
5082,35,719,384,1080,100,11,12,349,361,0,0,0,0
5230,1851,533,1919,769,104,11,12,68,236,0,22,0,1
5231,1829,506,1912,793,104,11,12,83,287,1,22,0,0
5232,1826,483,1917,801,104,11,12,91,318,2,22,0,0
5233,1807,466,1910,819,104,11,12,103,353,3,22,0,0
5234,1787,467,1898,841,104,11,12,111,374,4,22,0,0
5235,1764,466,1880,847,104,11,12,116,381,5,22,0,0
5236,1722,472,1845,853,104,11,12,123,381,6,22,0,0
5237,1687,471,1818,865,104,11,12,131,394,7,22,0,0
5238,1657,471,1800,892,104,11,12,143,421,8,22,0,0
5239,1609,491,1762,928,104,11,12,153,437,9,22,0,0
5240,1573,487,1736,943,104,11,12,163,456,10,22,0,0
5241,1502,504,1677,964,104,11,12,175,460,11,22,0,0
5242,1450,507,1636,983,104,11,12,186,476,12,22,0,0
5243,1402,502,1607,1021,104,11,12,205,519,13,22,0,0
5244,1320,518,1537,1055,104,11,12,217,537,14,22,0,0
5245,1263,525,1485,1072,104,11,12,222,547,15,22,0,0
5246,1157,540,1388,1080,104,11,12,231,540,16,22,0,0
5247,1067,547,1297,1080,104,11,12,230,533,17,22,0,0
5248,971,540,1205,1080,104,11,12,234,540,18,22,0,0
5249,854,557,1084,1080,104,11,12,230,523,19,22,0,0
5250,736,574,958,1080,104,11,12,222,506,20,22,0,0
5251,615,578,835,1080,104,11,12,220,502,21,22,0,0
5252,545,583,767,1080,104,11,12,222,497,22,22,1,0
5252,419,606,653,1072,105,11,12,234,466,0,0,0,0
5253,317,618,506,1077,106,11,12,189,459,0,0,0,0
5254,206,692,415,1069,107,11,12,209,377,0,0,0,0
5327,424,618,684,1071,109,11,12,260,453,0,74,0,1
5328,401,594,674,1071,109,11,12,273,477,1,74,0,0
5329,371,560,665,1077,109,11,12,294,517,2,74,0,0
5330,353,529,660,1077,109,11,12,307,548,3,74,0,0
5331,340,510,651,1075,109,11,12,311,565,4,74,0,0
5332,343,487,632,1019,109,11,12,289,532,5,74,0,0
5333,344,468,618,986,109,11,12,274,518,6,74,0,0
5334,345,441,614,966,109,11,12,269,525,7,74,0,0
5335,361,409,604,898,109,11,12,243,489,8,74,0,0
5336,369,394,598,869,109,11,12,229,475,9,74,0,0
5337,372,383,589,843,109,11,12,217,460,10,74,0,0
5338,372,363,571,794,109,11,12,199,431,11,74,0,0
5339,372,353,564,778,109,11,12,192,425,12,74,0,0
5340,383,341,558,737,109,11,12,175,396,13,74,0,0
5341,395,332,558,707,109,11,12,163,375,14,74,0,0
5342,402,326,560,696,109,11,12,158,370,15,74,0,0
5343,412,320,555,659,109,11,12,143,339,16,74,0,0
5344,412,302,553,641,109,11,12,141,339,17,74,0,0
5345,416,294,554,631,109,11,12,138,337,18,74,0,0
5346,424,285,552,603,109,11,12,128,318,19,74,0,0
5347,428,274,552,585,109,11,12,124,311,20,74,0,0
5348,427,269,544,564,109,11,12,117,295,21,74,0,0
5349,422,262,536,550,109,11,12,114,288,22,74,0,0
5350,420,262,530,542,109,11,12,110,280,23,74,0,0
5351,416,256,522,527,109,11,12,106,271,24,74,0,0
5352,410,251,510,508,109,11,12,100,257,25,74,0,0
5353,401,247,499,502,109,11,12,98,255,26,74,0,0
5354,390,238,486,488,109,11,12,96,250,27,74,0,0
5355,381,233,475,481,109,11,12,94,248,28,74,0,0
5356,377,225,470,474,109,11,12,93,249,29,74,0,0
5357,373,213,465,463,109,11,12,92,250,30,74,0,0
5358,371,207,461,453,109,11,12,90,246,31,74,0,0
5359,371,218,453,441,109,11,12,82,223,32,74,0,0
5360,370,221,448,435,109,11,12,78,214,33,74,0,0
5361,366,224,443,432,109,11,12,77,208,34,74,0,0
5362,363,221,436,421,109,11,12,73,200,35,74,0,0
5363,360,213,433,414,109,11,12,73,201,36,74,0,0
5364,358,214,428,405,109,11,12,70,191,37,74,0,0
5365,355,204,424,397,109,11,12,69,193,38,74,0,0
5366,353,205,420,393,109,11,12,67,188,39,74,0,0
5367,348,203,414,388,109,11,12,66,185,40,74,0,0
5368,342,199,407,382,109,11,12,65,183,41,74,0,0
5369,337,200,399,377,109,11,12,62,177,42,74,0,0
5370,329,201,388,369,109,11,12,59,168,43,74,0,0
5371,322,197,379,365,109,11,12,57,168,44,74,0,0
5372,317,198,372,362,109,11,12,55,164,45,74,0,0
5373,312,191,365,354,109,11,12,53,163,46,74,0,0
5374,307,189,360,353,109,11,12,53,164,47,74,0,0
5375,303,188,355,351,109,11,12,52,163,48,74,0,0
5376,300,187,350,344,109,11,12,50,157,49,74,0,0
5377,296,185,347,343,109,11,12,51,158,50,74,0,0
5378,298,184,345,335,109,11,12,47,151,51,74,0,0
5379,297,182,344,332,109,11,12,47,150,52,74,0,0
5380,297,183,343,331,109,11,12,46,148,53,74,0,0
5381,295,183,340,326,109,11,12,45,143,54,74,0,0
5382,294,180,339,323,109,11,12,45,143,55,74,0,0
5383,294,179,339,321,109,11,12,45,142,56,74,0,0
5384,296,177,340,315,109,11,12,44,138,57,74,0,0
5385,297,177,340,311,109,11,12,43,134,58,74,0,0
5386,297,177,339,308,109,11,12,42,131,59,74,0,0
5387,297,173,340,307,109,11,12,43,134,60,74,0,0
5388,297,173,340,305,109,11,12,43,132,61,74,0,0
5389,299,172,341,301,109,11,12,42,129,62,74,0,0
5390,301,171,342,297,109,11,12,41,126,63,74,0,0
5391,303,170,344,296,109,11,12,41,126,64,74,0,0
5392,303,169,343,291,109,11,12,40,122,65,74,0,0
5393,304,168,344,288,109,11,12,40,120,66,74,0,0
5394,306,168,345,285,109,11,12,39,117,67,74,0,0
5395,309,163,347,280,109,11,12,38,117,68,74,0,0
5396,310,161,348,278,109,11,12,38,117,69,74,0,0
5397,310,159,348,276,109,11,12,38,117,70,74,0,0
5398,309,155,348,275,109,11,12,39,120,71,74,0,0
5399,309,155,347,273,109,11,12,38,118,72,74,0,0
5400,310,153,346,268,109,11,12,36,115,73,74,0,0
5401,310,154,346,267,109,11,12,36,113,74,74,1,0
5403,310,154,345,266,109,11,12,35,112,0,74,0,0
5505,1845,427,1920,732,110,11,12,75,305,0,17,0,0
5506,1838,431,1920,770,110,11,12,82,339,1,17,0,0
5507,1810,406,1896,750,110,11,12,86,344,2,17,0,0
5508,1788,402,1877,743,110,11,12,89,341,3,17,0,0
5509,1776,398,1872,758,110,11,12,96,360,4,17,0,0
5510,1757,398,1861,774,110,11,12,104,376,5,17,0,0
5511,1740,400,1850,789,110,11,12,110,389,6,17,0,0
5512,1711,401,1825,787,110,11,12,114,386,7,17,0,0
5513,1664,402,1789,798,110,11,12,125,396,8,17,0,0
5514,1633,402,1764,798,110,11,12,131,396,9,17,0,0
5515,1612,399,1751,810,110,11,12,139,411,10,17,0,0
5516,1567,403,1717,831,110,11,12,150,428,11,17,0,0
5517,1532,401,1691,845,110,11,12,159,444,12,17,0,0
5518,1486,400,1656,857,110,11,12,170,457,13,17,0,0
5519,1430,401,1609,866,110,11,12,179,465,14,17,0,0
5520,1390,398,1580,887,110,11,12,190,489,15,17,0,0
5521,1328,409,1534,925,110,11,12,206,516,16,17,0,0
5522,1295,409,1506,938,110,11,12,211,529,17,17,0,0
5509,1850,442,1918,859,111,11,12,68,417,0,3,0,0
5510,1851,537,1905,865,111,11,12,54,328,1,3,0,0
5511,1828,551,1882,862,111,11,12,54,311,2,3,0,0
5512,1819,570,1869,862,111,11,12,50,292,3,3,0,0
5512,1746,521,1917,886,112,11,12,171,365,0,23,0,1
5513,1734,503,1918,896,112,11,12,184,393,1,23,0,0
5514,1719,502,1920,931,112,11,12,201,429,2,23,0,0
5515,1700,527,1905,965,112,11,12,205,438,3,23,0,0
5516,1669,530,1872,964,112,11,12,203,434,4,23,0,0
5517,1616,547,1824,983,112,11,12,208,436,5,23,0,0
5518,1572,549,1788,1000,112,11,12,216,451,6,23,0,0
5519,1533,552,1768,1043,112,11,12,235,491,7,23,0,0
5520,1470,555,1716,1066,112,11,12,246,511,8,23,0,0
5521,1427,570,1673,1078,112,11,12,246,508,9,23,0,0
5522,1337,555,1597,1080,112,11,12,260,525,10,23,0,0
5523,1268,567,1526,1080,112,11,12,258,513,11,23,0,0
5524,1163,524,1446,1076,112,11,12,283,552,12,23,0,0
5525,1111,552,1384,1077,112,11,12,273,525,13,23,0,0
5526,1048,588,1302,1078,112,11,12,254,490,14,23,0,0
5527,955,611,1201,1076,112,11,12,246,465,15,23,0,0
5528,836,638,1076,1080,112,11,12,240,442,16,23,0,0
5529,706,644,943,1079,112,11,12,237,435,17,23,0,0
5530,574,659,808,1080,112,11,12,234,421,18,23,0,0
5531,422,680,652,1080,112,11,12,230,400,19,23,0,0
5532,305,690,531,1080,112,11,12,226,390,20,23,0,0
5533,155,708,374,1078,112,11,12,219,370,21,23,0,0
5534,49,741,253,1080,112,11,12,204,339,22,23,0,0
5535,0,756,146,1080,112,11,12,146,324,23,23,1,0
5524,1212,428,1398,796,113,11,12,186,368,0,14,0,0
5525,1135,424,1333,815,113,11,12,198,391,1,14,0,0
5526,1061,429,1241,779,113,11,12,180,350,2,14,0,0
5527,967,434,1151,786,113,11,12,184,352,3,14,0,0
5528,911,435,1104,807,113,11,12,193,372,4,14,0,0
5529,785,437,1063,983,113,11,12,278,546,5,14,0,0
5530,694,450,999,1053,113,11,12,305,603,6,14,0,0
5531,562,449,876,1080,113,11,12,314,631,7,14,0,0
5532,449,464,766,1080,113,11,12,317,616,8,14,0,0
5533,341,479,656,1080,113,11,12,315,601,9,14,0,0
5534,217,487,521,1080,113,11,12,304,593,10,14,0,0
5535,110,508,403,1080,113,11,12,293,572,11,14,0,0
5536,4,505,277,1046,113,11,12,273,541,12,14,0,0
5537,0,551,182,1016,113,11,12,182,465,13,14,0,0
5538,0,561,97,1033,113,11,12,97,472,14,14,0,0
5549,6,619,241,1078,114,11,12,235,459,0,82,0,1
5550,78,579,322,1052,114,11,12,244,473,1,82,0,0
5551,163,556,424,1060,114,11,12,261,504,2,82,0,0
5552,236,516,520,1067,114,11,12,284,551,3,82,0,0
5553,300,484,599,1071,114,11,12,299,587,4,82,0,0
5554,348,460,657,1070,114,11,12,309,610,5,82,0,0
5555,385,433,695,1054,114,11,12,310,621,6,82,0,0
5556,409,402,718,1033,114,11,12,309,631,7,82,0,0
5557,448,383,730,968,114,11,12,282,585,8,82,0,0
5558,466,361,730,917,114,11,12,264,556,9,82,0,0
5559,473,342,728,889,114,11,12,255,547,10,82,0,0
5560,484,322,715,830,114,11,12,231,508,11,82,0,0
5561,487,307,705,791,114,11,12,218,484,12,82,0,0
5562,486,298,697,779,114,11,12,211,481,13,82,0,0
5563,489,285,684,736,114,11,12,195,451,14,82,0,0
5564,488,279,666,700,114,11,12,178,421,15,82,0,0
5565,480,275,647,677,114,11,12,167,402,16,82,0,0
5566,468,258,629,649,114,11,12,161,391,17,82,0,0
5567,456,253,609,630,114,11,12,153,377,18,82,0,0
5568,453,244,597,608,114,11,12,144,364,19,82,0,0
5569,451,235,586,582,114,11,12,135,347,20,82,0,0
5570,451,235,577,563,114,11,12,126,328,21,82,0,0
5571,445,231,564,542,114,11,12,119,311,22,82,0,0
5572,439,224,553,525,114,11,12,114,301,23,82,0,0
5573,434,219,545,516,114,11,12,111,297,24,82,0,0
5574,433,215,537,492,114,11,12,104,277,25,82,0,0
5575,428,211,528,481,114,11,12,100,270,26,82,0,0
5576,419,209,516,475,114,11,12,97,266,27,82,0,0
5577,410,202,505,463,114,11,12,95,261,28,82,0,0
5578,402,201,493,455,114,11,12,91,254,29,82,0,0
5579,399,192,487,440,114,11,12,88,248,30,82,0,0
5580,396,192,480,431,114,11,12,84,239,31,82,0,0
5581,389,193,471,425,114,11,12,82,232,32,82,0,0
5582,378,189,458,417,114,11,12,80,228,33,82,0,0
5583,368,182,448,413,114,11,12,80,231,34,82,0,0
5584,365,179,443,406,114,11,12,78,227,35,82,0,0
5585,362,170,439,398,114,11,12,77,228,36,82,0,0
5586,359,170,434,392,114,11,12,75,222,37,82,0,0
5587,354,169,427,385,114,11,12,73,216,38,82,0,0
5588,350,169,420,377,114,11,12,70,208,39,82,0,0
5589,349,171,416,371,114,11,12,67,200,40,82,0,0
5590,348,170,413,363,114,11,12,65,193,41,82,0,0
5591,347,170,409,356,114,11,12,62,186,42,82,0,0
5592,345,171,406,354,114,11,12,61,183,43,82,0,0
5593,341,172,399,348,114,11,12,58,176,44,82,0,0
5594,338,172,395,345,114,11,12,57,173,45,82,0,0
5595,336,171,392,340,114,11,12,56,169,46,82,0,0
5596,333,160,390,334,114,11,12,57,174,47,82,0,0
5597,331,159,388,330,114,11,12,57,171,48,82,0,0
5598,327,165,381,327,114,11,12,54,162,49,82,0,0
5599,324,166,375,324,114,11,12,51,158,50,82,0,0
5600,323,167,373,323,114,11,12,50,156,51,82,0,0
5601,323,163,372,315,114,11,12,49,152,52,82,0,0
5602,324,166,370,311,114,11,12,46,145,53,82,0,0
5603,324,163,370,307,114,11,12,46,144,54,82,0,0
5604,321,164,366,304,114,11,12,45,140,55,82,0,0
5605,321,166,365,304,114,11,12,44,138,56,82,0,0
5606,319,160,363,300,114,11,12,44,140,57,82,0,0
5607,316,145,363,297,114,11,12,47,152,58,82,0,0
5608,314,145,360,293,114,11,12,46,148,59,82,0,0
5609,313,146,357,290,114,11,12,44,144,60,82,0,0
5610,311,146,354,286,114,11,12,43,140,61,82,0,0
5611,311,148,352,282,114,11,12,41,134,62,82,0,0
5612,311,147,352,279,114,11,12,41,132,63,82,0,0
5613,310,142,351,275,114,11,12,41,133,64,82,0,0
5614,311,144,350,273,114,11,12,39,129,65,82,0,0
5615,311,143,350,271,114,11,12,39,128,66,82,0,0
5616,311,144,350,269,114,11,12,39,125,67,82,0,0
5617,312,138,352,268,114,11,12,40,130,68,82,0,0
5618,313,132,354,268,114,11,12,41,136,69,82,0,0
5619,315,130,356,266,114,11,12,41,136,70,82,0,0
5620,316,133,355,263,114,11,12,39,130,71,82,0,0
5621,316,130,355,260,114,11,12,39,130,72,82,0,0
5622,317,133,353,257,114,11,12,36,124,73,82,0,0
5623,318,127,356,255,114,11,12,38,128,74,82,0,0
5624,318,125,356,252,114,11,12,38,127,75,82,0,0
5625,318,125,355,252,114,11,12,37,127,76,82,0,0
5626,317,125,353,249,114,11,12,36,124,77,82,0,0
5627,316,124,352,247,114,11,12,36,123,78,82,0,0
5628,315,125,351,246,114,11,12,36,121,79,82,0,0
5629,316,123,352,244,114,11,12,36,121,80,82,0,0
5630,317,124,352,243,114,11,12,35,119,81,82,0,0
5631,316,123,352,243,114,11,12,36,120,82,82,1,0
5998,12,580,229,1056,116,11,12,217,476,0,7,0,0
5999,52,560,280,1059,116,11,12,228,499,1,7,0,0
6000,105,527,353,1070,116,11,12,248,543,2,7,0,0
6001,163,499,422,1069,116,11,12,259,570,3,7,0,0
6002,216,472,488,1077,116,11,12,272,605,4,7,0,0
6003,262,439,532,1046,116,11,12,270,607,5,7,0,0
6004,287,418,550,1019,116,11,12,263,601,6,7,0,0
6005,317,401,556,955,116,11,12,239,554,7,7,0,0
59,368,127,434,197,1,11,13,66,70,0,7,0,0
60,374,125,440,196,1,11,13,66,71,1,7,0,0
61,384,126,450,198,1,11,13,66,72,2,7,0,0
62,395,126,460,200,1,11,13,65,74,3,7,0,0
63,394,125,460,200,1,11,13,66,75,4,7,0,0
89,480,128,534,198,1,11,13,54,70,0,7,0,0
90,466,125,522,197,1,11,13,56,72,1,7,0,0
91,456,127,510,197,1,11,13,54,70,2,7,0,0
92,445,124,499,196,1,11,13,54,72,3,7,0,0
93,433,126,483,197,1,11,13,50,71,4,7,0,0
94,416,126,466,198,1,11,13,50,72,5,7,0,0
95,399,124,449,198,1,11,13,50,74,6,7,0,0
96,390,123,441,198,1,11,13,51,75,7,7,0,0
65,462,123,502,203,2,11,13,40,80,0,1,0,0
66,479,129,514,200,2,11,13,35,71,1,1,0,0
75,448,123,494,198,5,11,13,46,75,0,3,0,0
76,460,123,505,197,5,11,13,45,74,1,3,0,0
77,472,126,517,198,5,11,13,45,72,2,3,0,0
78,479,127,523,199,5,11,13,44,72,3,3,0,0
80,517,129,561,199,5,11,13,44,70,0,3,0,0
81,527,127,575,200,5,11,13,48,73,1,3,0,0
82,531,127,581,200,5,11,13,50,73,2,3,0,0
83,542,128,592,201,5,11,13,50,73,3,3,0,0
262,799,555,958,1074,9,11,13,159,519,0,1,0,0
263,869,582,1021,1071,9,11,13,152,489,1,1,0,0
264,953,608,1175,1075,10,11,13,222,467,0,0,0,0
265,1075,661,1300,1076,11,11,13,225,415,0,0,0,0
266,1207,688,1433,1077,12,11,13,226,389,0,5,0,0
267,1323,725,1525,1070,12,11,13,202,345,1,5,0,0
268,1448,781,1619,1067,12,11,13,171,286,2,5,0,0
269,1614,830,1767,1074,12,11,13,153,244,3,5,0,0
270,1737,891,1860,1077,12,11,13,123,186,4,5,0,0
271,1856,937,1920,1079,12,11,13,64,142,5,5,0,0
641,880,210,928,435,18,11,13,48,225,0,0,0,0
644,1404,747,1710,1072,20,11,13,306,325,0,8,0,0
645,1293,716,1622,1066,20,11,13,329,350,1,8,0,0
646,1130,653,1514,1065,20,11,13,384,412,2,8,0,0
647,974,590,1412,1065,20,11,13,438,475,3,8,0,0
648,858,547,1322,1057,20,11,13,464,510,4,8,0,0
649,771,497,1273,1062,20,11,13,502,565,5,8,0,0
650,708,450,1240,1071,20,11,13,532,621,6,8,0,0
651,645,427,1176,1073,20,11,13,531,646,7,8,0,0
652,550,386,1114,1073,20,11,13,564,687,8,8,0,0
652,825,390,957,971,21,11,13,132,581,0,1,0,0
653,842,467,912,773,21,11,13,70,306,1,1,0,0
711,1776,861,1920,1075,22,11,13,144,214,0,14,0,0
712,1688,814,1867,1078,22,11,13,179,264,1,14,0,0
713,1566,760,1782,1071,22,11,13,216,311,2,14,0,0
714,1475,721,1719,1076,22,11,13,244,355,3,14,0,0
715,1348,674,1619,1070,22,11,13,271,396,4,14,0,0
716,1198,624,1502,1063,22,11,13,304,439,5,14,0,0
717,1075,585,1408,1065,22,11,13,333,480,6,14,0,0
718,996,541,1358,1068,22,11,13,362,527,7,14,0,0
719,924,509,1305,1074,22,11,13,381,565,8,14,0,0
720,860,477,1252,1075,22,11,13,392,598,9,14,0,0
721,798,446,1188,1059,22,11,13,390,613,10,14,0,0
722,752,424,1132,1042,22,11,13,380,618,11,14,0,0
723,726,402,1086,1011,22,11,13,360,609,12,14,0,0
724,714,378,1038,951,22,11,13,324,573,13,14,0,0
725,641,345,978,941,22,11,13,337,596,14,14,0,0
725,818,466,925,926,23,11,13,107,460,0,0,0,0
813,847,265,955,610,29,11,13,108,345,0,19,0,1
814,862,278,980,655,29,11,13,118,377,1,19,0,0
815,870,289,987,658,29,11,13,117,369,2,19,0,0
816,883,298,1001,674,29,11,13,118,376,3,19,0,0
817,899,318,1029,724,29,11,13,130,406,4,19,0,0
818,940,324,1076,748,29,11,13,136,424,5,19,0,0
819,986,349,1131,785,29,11,13,145,436,6,19,0,0
820,1013,365,1162,811,29,11,13,149,446,7,19,0,0
821,1041,376,1199,847,29,11,13,158,471,8,19,0,0
822,1088,405,1237,827,29,11,13,149,422,9,19,0,0
823,1128,425,1303,923,29,11,13,175,498,10,19,0,0
824,1166,449,1356,977,29,11,13,190,528,11,19,0,0
825,1213,491,1417,1031,29,11,13,204,540,12,19,0,0
826,1234,520,1445,1071,29,11,13,211,551,13,19,0,0
827,1274,555,1483,1080,29,11,13,209,525,14,19,0,0
828,1343,607,1548,1080,29,11,13,205,473,15,19,0,0
829,1421,644,1624,1080,29,11,13,203,436,16,19,0,0
830,1506,713,1694,1080,29,11,13,188,367,17,19,0,0
831,1615,793,1783,1080,29,11,13,168,287,18,19,0,0
832,1674,831,1832,1080,29,11,13,158,249,19,19,0,0
818,1494,838,1717,1075,30,11,13,223,237,0,1,0,0
819,1418,817,1658,1071,30,11,13,240,254,1,1,0,0
820,1182,746,1489,1070,31,11,13,307,324,0,7,0,0
821,1059,700,1412,1074,31,11,13,353,374,1,7,0,0
822,960,654,1356,1077,31,11,13,396,423,2,7,0,0
823,862,602,1298,1074,31,11,13,436,472,3,7,0,0
824,756,566,1223,1078,31,11,13,467,512,4,7,0,0
825,672,522,1162,1076,31,11,13,490,554,5,7,0,0
826,618,486,1116,1070,31,11,13,498,584,6,7,0,0
827,542,451,1069,1070,31,11,13,527,619,7,7,0,0
832,1806,881,1919,1075,32,11,13,113,194,0,0,0,0
907,404,126,441,198,42,11,13,37,72,0,0,0,0
951,966,444,1185,989,45,11,13,219,545,0,5,0,0
952,905,415,1117,942,45,11,13,212,527,1,5,0,0
953,848,396,1061,927,45,11,13,213,531,2,5,0,0
954,817,357,1011,846,45,11,13,194,489,3,5,0,0
955,796,348,978,813,45,11,13,182,465,4,5,0,0
956,767,330,942,777,45,11,13,175,447,5,5,0,0
956,850,405,904,593,46,11,13,54,188,0,0,0,0
1002,1749,863,1918,1076,49,11,13,169,213,0,0,0,0
1010,781,422,1004,1065,51,11,13,223,643,0,0,0,0
1012,1788,854,1920,1073,52,11,13,132,219,0,16,0,0
1013,1688,810,1849,1072,52,11,13,161,262,1,16,0,0
1014,1575,751,1774,1071,52,11,13,199,320,2,16,0,0
1015,1471,693,1707,1070,52,11,13,236,377,3,16,0,0
1016,1365,648,1627,1070,52,11,13,262,422,4,16,0,0
1017,1256,599,1547,1068,52,11,13,291,469,5,16,0,0
1018,1146,557,1465,1067,52,11,13,319,510,6,16,0,0
1019,1065,522,1407,1069,52,11,13,342,547,7,16,0,0
1020,1011,480,1371,1067,52,11,13,360,587,8,16,0,0
1021,949,455,1310,1052,52,11,13,361,597,9,16,0,0
1022,906,431,1261,1037,52,11,13,355,606,10,16,0,0
1023,866,408,1199,988,52,11,13,333,580,11,16,0,0
1024,831,393,1135,931,52,11,13,304,538,12,16,0,0
1025,836,382,1070,796,52,11,13,234,414,13,16,0,0
1026,846,366,1023,686,52,11,13,177,320,14,16,0,0
1027,822,365,971,640,52,11,13,149,275,15,16,0,0
1028,774,341,916,602,52,11,13,142,261,16,16,0,0
1016,1756,884,1917,1074,53,11,13,161,190,0,0,0,0
1017,1596,837,1834,1078,54,11,13,238,241,0,0,0,0
1018,1496,811,1700,1077,55,11,13,204,266,0,12,0,0
1019,1416,747,1665,1070,55,11,13,249,323,1,12,0,0
1020,1315,698,1600,1069,55,11,13,285,371,2,12,0,0
1021,1182,647,1507,1072,55,11,13,325,425,3,12,0,0
1022,1103,596,1448,1055,55,11,13,345,459,4,12,0,0
1023,1013,556,1388,1067,55,11,13,375,511,5,12,0,0
1024,930,562,1297,1074,55,11,13,367,512,6,12,0,0
1025,826,500,1224,1065,55,11,13,398,565,7,12,0,0
1026,757,466,1171,1071,55,11,13,414,605,8,12,0,0
1027,713,445,1127,1070,55,11,13,414,625,9,12,0,0
1028,663,405,1088,1072,55,11,13,425,667,10,12,0,0
1029,652,398,1050,1054,55,11,13,398,656,11,12,0,0
1030,582,365,999,1052,55,11,13,417,687,12,12,0,0
1024,1113,544,1206,658,56,11,13,93,114,0,0,0,0
1030,794,427,931,1013,58,11,13,137,586,0,1,0,0
1031,793,486,918,1018,58,11,13,125,532,1,1,0,0
1033,830,610,880,776,60,11,13,50,166,0,0,0,0
1508,347,119,398,195,70,11,13,51,76,0,0,0,0
1514,458,122,506,199,71,11,13,48,77,0,1,0,0
1515,473,124,519,199,71,11,13,46,75,1,1,0,0
1517,511,128,564,198,72,11,13,53,70,0,0,0,0
1592,430,122,467,196,74,11,13,37,74,0,0,0,0
1899,801,597,1023,1075,75,11,13,222,478,0,1,0,0
1900,901,633,1107,1075,75,11,13,206,442,1,1,0,0
1901,1039,672,1323,1073,76,11,13,284,401,0,1,0,0
1902,1159,738,1399,1073,76,11,13,240,335,1,1,0,0
2008,344,128,383,198,80,11,13,39,70,0,1,0,0
2009,352,126,393,198,80,11,13,41,72,1,1,0,0
2048,879,206,931,412,83,11,13,52,206,0,0,0,0
2058,893,211,942,411,85,11,13,49,200,0,1,0,0
2059,876,211,934,449,85,11,13,58,238,1,1,0,0
2061,404,127,450,198,86,11,13,46,71,0,0,0,0
2097,351,127,420,199,91,11,13,69,72,0,2,0,0
2098,344,127,411,199,91,11,13,67,72,1,2,0,0
2099,338,126,406,199,91,11,13,68,73,2,2,0,0
2211,857,232,934,548,92,11,13,77,316,0,1,0,0
2212,862,246,933,536,92,11,13,71,290,1,1,0,0
2212,1733,830,1920,1071,93,11,13,187,241,0,17,0,0
2213,1623,766,1862,1072,93,11,13,239,306,1,17,0,0
2214,1520,709,1799,1064,93,11,13,279,355,2,17,0,0
2215,1410,658,1729,1065,93,11,13,319,407,3,17,0,0
2216,1300,614,1653,1064,93,11,13,353,450,4,17,0,0
2217,1216,564,1609,1062,93,11,13,393,498,5,17,0,0
2218,1108,537,1509,1051,93,11,13,401,514,6,17,0,0
2219,1029,501,1453,1056,93,11,13,424,555,7,17,0,0
2220,955,463,1404,1067,93,11,13,449,604,8,17,0,0
2221,862,441,1317,1066,93,11,13,455,625,9,17,0,0
2222,813,424,1254,1046,93,11,13,441,622,10,17,0,0
2223,789,400,1208,1012,93,11,13,419,612,11,17,0,0
2224,767,385,1169,989,93,11,13,402,604,12,17,0,0
2225,762,372,1131,948,93,11,13,369,576,13,17,0,0
2226,757,350,1087,882,93,11,13,330,532,14,17,0,0
2227,742,331,1058,864,93,11,13,316,533,15,17,0,0
2228,740,312,1033,833,93,11,13,293,521,16,17,0,0
2229,691,286,989,815,93,11,13,298,529,17,17,0,0
2229,848,304,954,736,94,11,13,106,432,0,0,0,0
2242,877,247,921,443,95,11,13,44,196,0,0,0,0
2321,844,321,936,672,98,11,13,92,351,0,16,0,0
2322,854,329,951,698,98,11,13,97,369,1,16,0,0
2323,871,341,974,730,98,11,13,103,389,2,16,0,0
2324,895,363,1004,769,98,11,13,109,406,3,16,0,0
2325,944,381,1054,784,98,11,13,110,403,4,16,0,0
2326,979,411,1098,839,98,11,13,119,428,5,16,0,0
2327,1016,427,1134,846,98,11,13,118,419,6,16,0,0
2328,1047,447,1180,904,98,11,13,133,457,7,16,0,0
2329,1089,477,1227,938,98,11,13,138,461,8,16,0,0
2330,1143,507,1292,993,98,11,13,149,486,9,16,0,0
2331,1193,551,1351,1054,98,11,13,158,503,10,16,0,0
2332,1248,589,1410,1079,98,11,13,162,490,11,16,0,0
2333,1310,634,1470,1080,98,11,13,160,446,12,16,0,0
2334,1411,686,1569,1080,98,11,13,158,394,13,16,0,0
2335,1479,742,1631,1080,98,11,13,152,338,14,16,0,0
2336,1569,816,1721,1080,98,11,13,152,264,15,16,0,0
2337,1631,855,1773,1080,98,11,13,142,225,16,16,0,0
2365,1791,820,1920,1074,99,11,13,129,254,0,0,0,0
2371,954,505,1498,1065,100,11,13,544,560,0,9,0,0
2372,875,480,1418,1057,100,11,13,543,577,1,9,0,0
2373,800,440,1364,1061,100,11,13,564,621,2,9,0,0
2374,748,413,1296,1040,100,11,13,548,627,3,9,0,0
2375,726,385,1227,985,100,11,13,501,600,4,9,0,0
2376,713,364,1178,945,100,11,13,465,581,5,9,0,0
2377,706,345,1136,909,100,11,13,430,564,6,9,0,0
2378,709,321,1087,840,100,11,13,378,519,7,9,0,0
2379,711,304,1059,810,100,11,13,348,506,8,9,0,0
2380,654,273,1009,789,100,11,13,355,516,9,9,0,0
2380,847,299,942,726,101,11,13,95,427,0,0,0,0
2388,852,250,927,551,102,11,13,75,301,0,3,0,0
2389,854,239,933,553,102,11,13,79,314,1,3,0,0
2390,863,243,935,528,102,11,13,72,285,2,3,0,0
2391,867,243,937,519,102,11,13,70,276,3,3,0,0
2421,785,692,894,1058,103,11,13,109,366,0,10,0,0
2422,820,605,958,1067,103,11,13,138,462,1,10,0,0
2423,886,572,1039,1075,103,11,13,153,503,2,10,0,0
2424,969,579,1124,1075,103,11,13,155,496,3,10,0,0
2425,1055,616,1203,1072,103,11,13,148,456,4,10,0,0
2426,1147,651,1291,1075,103,11,13,144,424,5,10,0,0
2427,1225,686,1365,1074,103,11,13,140,388,6,10,0,0
2428,1321,748,1450,1075,103,11,13,129,327,7,10,0,0
2429,1431,793,1551,1073,103,11,13,120,280,8,10,0,0
2430,1530,840,1641,1073,103,11,13,111,233,9,10,0,0
2431,1618,870,1715,1074,103,11,13,97,204,10,10,0,0
2802,1820,884,1918,1068,106,11,13,98,184,0,0,0,0
2809,986,503,1222,1078,108,11,13,236,575,0,4,0,0
2810,874,479,1117,1069,108,11,13,243,590,1,4,0,0
2811,801,440,1058,1067,108,11,13,257,627,2,4,0,0
2812,746,443,998,1068,108,11,13,252,625,3,4,0,0
2813,697,431,953,1067,108,11,13,256,636,4,4,0,0
3497,1760,870,1920,1079,109,11,13,160,209,0,0,0,0
3505,959,517,1093,745,111,11,13,134,228,0,0,0,0
3507,791,472,931,1047,112,11,13,140,575,0,0,0,0
3841,1321,753,1596,1079,115,11,13,275,326,0,15,0,0
3842,1258,729,1547,1072,115,11,13,289,343,1,15,0,0
3843,1180,686,1506,1074,115,11,13,326,388,2,15,0,0
3844,1125,633,1485,1067,115,11,13,360,434,3,15,0,0
3845,1080,600,1461,1063,115,11,13,381,463,4,15,0,0
3846,1016,561,1409,1049,115,11,13,393,488,5,15,0,0
3847,937,535,1349,1060,115,11,13,412,525,6,15,0,0
3848,857,513,1284,1063,115,11,13,427,550,7,15,0,0
3849,803,488,1237,1059,115,11,13,434,571,8,15,0,0
3850,782,454,1219,1050,115,11,13,437,596,9,15,0,0
3851,770,429,1208,1042,115,11,13,438,613,10,15,0,0
3852,749,411,1181,1034,115,11,13,432,623,11,15,0,0
3853,735,391,1127,975,115,11,13,392,584,12,15,0,0
3854,740,369,1086,908,115,11,13,346,539,13,15,0,0
3855,734,369,1048,884,115,11,13,314,515,14,15,0,0
3856,696,345,1015,868,115,11,13,319,523,15,15,0,0
3957,808,419,929,925,119,11,13,121,506,0,13,0,0
3958,860,425,996,986,119,11,13,136,561,1,13,0,0
3959,889,453,1029,1013,119,11,13,140,560,2,13,0,0
3960,916,468,1058,1030,119,11,13,142,562,3,13,0,0
3961,947,496,1095,1063,119,11,13,148,567,4,13,0,0
3962,979,525,1128,1073,119,11,13,149,548,5,13,0,0
3963,1065,545,1217,1076,119,11,13,152,531,6,13,0,0
3964,1145,576,1302,1080,119,11,13,157,504,7,13,0,0
3965,1186,613,1342,1077,119,11,13,156,464,8,13,0,0
3966,1209,647,1362,1078,119,11,13,153,431,9,13,0,0
3967,1263,705,1408,1077,119,11,13,145,372,10,13,0,0
3968,1347,765,1485,1076,119,11,13,138,311,11,13,0,0
3969,1423,811,1557,1077,119,11,13,134,266,12,13,0,0
3970,1487,849,1604,1080,119,11,13,117,231,13,13,0,0
4115,391,127,429,197,121,11,13,38,70,0,0,0,0
4492,807,489,933,996,130,11,13,126,507,0,7,0,0
4493,828,508,967,1064,130,11,13,139,556,1,7,0,0
4494,880,546,1018,1077,130,11,13,138,531,2,7,0,0
4495,983,581,1116,1080,130,11,13,133,499,3,7,0,0
4496,1089,649,1215,1075,130,11,13,126,426,4,7,0,0
4497,1161,717,1278,1072,130,11,13,117,355,5,7,0,0
4498,1287,782,1395,1072,130,11,13,108,290,6,7,0,0
4499,1377,832,1467,1074,130,11,13,90,242,7,7,0,0
4530,1829,907,1919,1080,132,11,13,90,173,0,0,0,0
4540,801,483,970,1070,134,11,13,169,587,0,0,0,0
4541,833,572,920,844,135,11,13,87,272,0,0,0,0
4659,855,314,941,657,138,11,13,86,343,0,81,0,1
4660,854,313,954,711,138,11,13,100,398,1,81,0,0
4661,859,321,964,738,138,11,13,105,417,2,81,0,0
4662,871,323,978,741,138,11,13,107,418,3,81,0,0
4663,881,329,990,746,138,11,13,109,417,4,81,0,0
4664,886,333,1002,765,138,11,13,116,432,5,81,0,0
4665,892,351,1013,794,138,11,13,121,443,6,81,0,0
4666,898,361,1018,795,138,11,13,120,434,7,81,0,0
4667,910,362,1023,761,138,11,13,113,399,8,81,0,0
4668,919,370,1018,706,138,11,13,99,336,9,81,0,0
4669,916,385,1043,822,138,11,13,127,437,10,81,0,0
4670,924,402,1055,840,138,11,13,131,438,11,81,0,0
4671,938,415,1075,855,138,11,13,137,440,12,81,0,0
4672,952,420,1110,912,138,11,13,158,492,13,81,0,0
4673,958,434,1131,964,138,11,13,173,530,14,81,0,0
4674,959,444,1143,1000,138,11,13,184,556,15,81,0,0
4675,973,456,1160,1013,138,11,13,187,557,16,81,0,0
4676,981,475,1175,1041,138,11,13,194,566,17,81,0,0
4677,1008,497,1207,1062,138,11,13,199,565,18,81,0,0
4678,1054,517,1251,1060,138,11,13,197,543,19,81,0,0
4679,1109,527,1303,1053,138,11,13,194,526,20,81,0,0
4680,1142,544,1338,1058,138,11,13,196,514,21,81,0,0
4681,1173,562,1374,1066,138,11,13,201,504,22,81,0,0
4682,1206,577,1416,1066,138,11,13,210,489,23,81,0,0
4683,1231,598,1442,1059,138,11,13,211,461,24,81,0,0
4684,1256,623,1462,1047,138,11,13,206,424,25,81,0,0
4685,1290,657,1482,1042,138,11,13,192,385,26,81,0,0
4686,1348,680,1555,1059,138,11,13,207,379,27,81,0,0
4687,1382,706,1593,1070,138,11,13,211,364,28,81,0,0
4688,1411,740,1615,1066,138,11,13,204,326,29,81,0,0
4689,1418,776,1618,1069,138,11,13,200,293,30,81,0,0
4690,1411,817,1597,1074,138,11,13,186,257,31,81,0,0
4691,1429,841,1609,1073,138,11,13,180,232,32,81,0,0
4692,1472,838,1668,1073,138,11,13,196,235,33,81,0,0
4693,1482,829,1696,1077,138,11,13,214,248,34,81,0,0
4694,1538,873,1719,1077,138,11,13,181,204,35,81,0,0
4695,1504,843,1715,1073,138,11,13,211,230,36,81,0,0
4696,1485,839,1706,1075,138,11,13,221,236,37,81,0,0
4697,1471,829,1703,1069,138,11,13,232,240,38,81,0,0
4698,1415,823,1657,1072,138,11,13,242,249,39,81,0,0
4699,1377,807,1630,1070,138,11,13,253,263,40,81,0,0
4700,1338,804,1596,1076,138,11,13,258,272,41,81,0,0
4701,1302,795,1564,1072,138,11,13,262,277,42,81,0,0
4702,1260,789,1525,1072,138,11,13,265,283,43,81,0,0
4703,1190,772,1475,1070,138,11,13,285,298,44,81,0,0
4704,1160,751,1458,1068,138,11,13,298,317,45,81,0,0
4705,1082,726,1410,1069,138,11,13,328,343,46,81,0,0
4706,1046,701,1398,1070,138,11,13,352,369,47,81,0,0
4707,1043,691,1400,1068,138,11,13,357,377,48,81,0,0
4708,1029,682,1389,1072,138,11,13,360,390,49,81,0,0
4709,1007,681,1366,1071,138,11,13,359,390,50,81,0,0
4710,989,688,1345,1073,138,11,13,356,385,51,81,0,0
4711,1000,697,1346,1074,138,11,13,346,377,52,81,0,0
4712,1023,706,1356,1075,138,11,13,333,369,53,81,0,0
4713,1035,716,1356,1077,138,11,13,321,361,54,81,0,0
4714,1044,723,1353,1076,138,11,13,309,353,55,81,0,0
4715,1050,722,1352,1070,138,11,13,302,348,56,81,0,0
4716,1056,728,1352,1072,138,11,13,296,344,57,81,0,0
4717,1062,731,1354,1073,138,11,13,292,342,58,81,0,0
4718,1071,734,1360,1074,138,11,13,289,340,59,81,0,0
4719,1076,727,1368,1074,138,11,13,292,347,60,81,0,0
4720,1066,720,1364,1074,138,11,13,298,354,61,81,0,0
4721,1064,717,1364,1073,138,11,13,300,356,62,81,0,0
4722,1062,716,1364,1073,138,11,13,302,357,63,81,0,0
4723,1055,712,1363,1075,138,11,13,308,363,64,81,0,0
4724,1058,711,1366,1075,138,11,13,308,364,65,81,0,0
4725,1061,708,1371,1074,138,11,13,310,366,66,81,0,0
4726,1064,706,1375,1074,138,11,13,311,368,67,81,0,0
4727,1069,702,1378,1072,138,11,13,309,370,68,81,0,0
4728,1071,698,1380,1073,138,11,13,309,375,69,81,0,0
4729,1067,694,1377,1073,138,11,13,310,379,70,81,0,0
4730,1058,691,1369,1072,138,11,13,311,381,71,81,0,0
4731,1051,692,1362,1074,138,11,13,311,382,72,81,0,0
4732,1058,696,1365,1074,138,11,13,307,378,73,81,0,0
4733,1077,700,1379,1069,138,11,13,302,369,74,81,0,0
4734,1103,706,1401,1065,138,11,13,298,359,75,81,0,0
4735,1139,717,1432,1062,138,11,13,293,345,76,81,0,0
4736,1198,741,1486,1066,138,11,13,288,325,77,81,0,0
4737,1235,753,1525,1074,138,11,13,290,321,78,81,0,0
4738,1274,763,1562,1072,138,11,13,288,309,79,81,0,0
4739,1295,780,1573,1073,138,11,13,278,293,80,81,0,0
4740,1331,809,1590,1075,138,11,13,259,266,81,81,1,0
4660,360,124,397,200,139,11,13,37,76,0,2,0,0
4661,377,127,412,198,139,11,13,35,71,1,2,0,0
4662,394,124,430,199,139,11,13,36,75,2,2,0,0
4779,358,128,410,200,142,11,13,52,72,0,3,0,0
4780,351,128,403,199,142,11,13,52,71,1,3,0,0
4781,338,125,391,200,142,11,13,53,75,2,3,0,0
4782,332,124,386,200,142,11,13,54,76,3,3,0,0
4975,464,128,515,198,143,11,13,51,70,0,16,0,0
4976,457,128,507,199,143,11,13,50,71,1,16,0,0
4977,453,127,503,199,143,11,13,50,72,2,16,0,0
4978,442,124,493,199,143,11,13,51,75,3,16,0,0
4979,437,123,488,199,143,11,13,51,76,4,16,0,0
4980,429,123,477,198,143,11,13,48,75,5,16,0,0
4981,422,122,470,199,143,11,13,48,77,6,16,0,0
4982,415,123,461,200,143,11,13,46,77,7,16,0,0
4983,411,125,454,199,143,11,13,43,74,8,16,0,0
4984,407,125,449,200,143,11,13,42,75,9,16,0,0
4985,401,127,440,201,143,11,13,39,74,10,16,0,0
4986,392,125,431,201,143,11,13,39,76,11,16,0,0
4987,384,125,422,199,143,11,13,38,74,12,16,0,0
4988,377,125,415,199,143,11,13,38,74,13,16,0,0
4989,369,128,405,198,143,11,13,36,70,14,16,0,0
4990,357,125,395,199,143,11,13,38,74,15,16,0,0
4991,350,125,388,199,143,11,13,38,74,16,16,0,0
5254,1513,835,1708,1071,147,11,13,195,236,0,1,0,0
5255,1426,813,1643,1073,147,11,13,217,260,1,1,0,0
5256,1233,762,1487,1070,148,11,13,254,308,0,0,0,0
5257,1099,688,1335,1073,149,11,13,236,385,0,5,0,0
5258,1001,632,1266,1066,149,11,13,265,434,1,5,0,0
5259,880,587,1175,1070,149,11,13,295,483,2,5,0,0
5260,800,537,1120,1068,149,11,13,320,531,3,5,0,0
5261,731,497,1070,1071,149,11,13,339,574,4,5,0,0
5262,663,463,1022,1072,149,11,13,359,609,5,5,0,0
5262,812,569,931,1039,150,11,13,119,470,0,0,0,0
5531,840,569,900,753,152,11,13,60,184,0,0,0,0
5532,798,462,933,1049,153,11,13,135,587,0,7,0,0
5533,820,472,957,1061,153,11,13,137,589,1,7,0,0
5534,834,503,967,1067,153,11,13,133,564,2,7,0,0
5535,866,524,999,1071,153,11,13,133,547,3,7,0,0
5536,905,557,1037,1072,153,11,13,132,515,4,7,0,0
5537,932,590,1062,1071,153,11,13,130,481,5,7,0,0
5538,965,621,1097,1067,153,11,13,132,446,6,7,0,0
5539,995,646,1119,1067,153,11,13,124,421,7,7,0,0
5568,878,260,938,469,153,11,13,60,209,0,7,0,0
5569,876,248,933,449,153,11,13,57,201,1,7,0,0
5534,1443,816,1689,1070,154,11,13,246,254,0,0,0,0
5535,1662,814,1906,1070,155,11,13,244,256,0,21,0,1
5536,1530,742,1842,1071,155,11,13,312,329,1,21,0,0
5537,1451,692,1811,1073,155,11,13,360,381,2,21,0,0
5538,1355,643,1757,1075,155,11,13,402,432,3,21,0,0
5539,1260,591,1700,1072,155,11,13,440,481,4,21,0,0
5540,1233,557,1689,1063,155,11,13,456,506,5,21,0,0
5541,1175,529,1566,973,155,11,13,391,444,6,21,0,0
5542,1067,491,1518,1022,155,11,13,451,531,7,21,0,0
5543,1011,469,1483,1043,155,11,13,472,574,8,21,0,0
5544,981,444,1435,1016,155,11,13,454,572,9,21,0,0
5545,962,428,1375,968,155,11,13,413,540,10,21,0,0
5546,907,408,1301,942,155,11,13,394,534,11,21,0,0
5547,884,385,1246,896,155,11,13,362,511,12,21,0,0
5548,869,366,1207,864,155,11,13,338,498,13,21,0,0
5549,854,349,1178,844,155,11,13,324,495,14,21,0,0
5550,841,330,1140,803,155,11,13,299,473,15,21,0,0
5551,819,320,1096,776,155,11,13,277,456,16,21,0,0
5552,798,312,1058,758,155,11,13,260,446,17,21,0,0
5553,787,298,1026,727,155,11,13,239,429,18,21,0,0
5554,780,287,1007,712,155,11,13,227,425,19,21,0,0
5555,776,279,990,698,155,11,13,214,419,20,21,0,0
5556,745,261,958,678,155,11,13,213,417,21,21,1,0
5541,848,589,1325,1070,156,11,13,477,481,0,4,0,0
5542,772,527,1293,1072,156,11,13,521,545,1,4,0,0
5543,720,486,1239,1051,156,11,13,519,565,2,4,0,0
5544,680,468,1167,1020,156,11,13,487,552,3,4,0,0
5545,618,437,1128,1015,156,11,13,510,578,4,4,0,0
5539,1158,631,1309,1008,157,11,13,151,377,0,0,0,0
5540,1039,572,1238,896,158,11,13,199,324,0,0,0,0
5543,1457,838,1688,1078,160,11,13,231,240,0,0,0,0
5545,817,444,967,925,161,11,13,150,481,0,1,0,0
5546,800,419,957,923,161,11,13,157,504,1,1,0,0
5566,865,245,933,520,162,11,13,68,275,0,0,0,0
5673,874,217,936,429,163,11,13,62,212,0,0,0,0
5684,862,272,930,533,164,11,13,68,261,0,0,0,0
5688,864,230,936,511,165,11,13,72,281,0,1,0,0
5689,866,237,933,503,165,11,13,67,266,1,1,0,0
5985,801,602,1036,1065,166,11,13,235,463,0,5,0,0
5986,860,616,1092,1072,166,11,13,232,456,1,5,0,0
5987,981,646,1200,1071,166,11,13,219,425,2,5,0,0
5988,1098,691,1294,1065,166,11,13,196,374,3,5,0,0
5989,1190,717,1382,1067,166,11,13,192,350,4,5,0,0
5990,1277,743,1454,1066,166,11,13,177,323,5,5,0,0
1,861,701,1075,982,1,11,14,214,281,0,991,0,1
2,860,700,1074,982,1,11,14,214,282,1,991,0,0
3,861,701,1074,982,1,11,14,213,281,2,991,0,0
4,860,702,1074,982,1,11,14,214,280,3,991,0,0
5,861,702,1074,982,1,11,14,213,280,4,991,0,0
6,862,701,1073,978,1,11,14,211,277,5,991,0,0
7,863,700,1073,976,1,11,14,210,276,6,991,0,0
8,863,700,1073,976,1,11,14,210,276,7,991,0,0
9,861,698,1073,977,1,11,14,212,279,8,991,0,0
10,860,697,1074,978,1,11,14,214,281,9,991,0,0
11,860,699,1075,981,1,11,14,215,282,10,991,0,0
12,861,701,1075,981,1,11,14,214,280,11,991,0,0
13,861,701,1075,981,1,11,14,214,280,12,991,0,0
14,861,701,1075,982,1,11,14,214,281,13,991,0,0
15,861,701,1075,982,1,11,14,214,281,14,991,0,0
16,862,701,1075,981,1,11,14,213,280,15,991,0,0
17,862,701,1075,981,1,11,14,213,280,16,991,0,0
18,862,702,1075,981,1,11,14,213,279,17,991,0,0
19,861,702,1076,981,1,11,14,215,279,18,991,0,0
20,862,700,1079,983,1,11,14,217,283,19,991,0,0
21,860,702,1076,983,1,11,14,216,281,20,991,0,0
22,859,702,1075,983,1,11,14,216,281,21,991,0,0
23,860,701,1077,985,1,11,14,217,284,22,991,0,0
24,859,699,1078,985,1,11,14,219,286,23,991,0,0
25,860,702,1075,983,1,11,14,215,281,24,991,0,0
26,860,702,1074,982,1,11,14,214,280,25,991,0,0
27,860,703,1074,981,1,11,14,214,278,26,991,0,0
28,860,703,1074,981,1,11,14,214,278,27,991,0,0
29,860,703,1074,981,1,11,14,214,278,28,991,0,0
30,860,703,1074,981,1,11,14,214,278,29,991,0,0
31,861,703,1073,979,1,11,14,212,276,30,991,0,0
32,861,703,1073,979,1,11,14,212,276,31,991,0,0
33,861,699,1077,980,1,11,14,216,281,32,991,0,0
34,861,702,1074,979,1,11,14,213,277,33,991,0,0
35,860,703,1073,979,1,11,14,213,276,34,991,0,0
36,861,704,1074,980,1,11,14,213,276,35,991,0,0
37,861,704,1074,980,1,11,14,213,276,36,991,0,0
38,861,705,1074,980,1,11,14,213,275,37,991,0,0
39,861,705,1074,980,1,11,14,213,275,38,991,0,0
40,861,705,1074,980,1,11,14,213,275,39,991,0,0
41,861,705,1075,981,1,11,14,214,276,40,991,0,0
42,861,705,1075,981,1,11,14,214,276,41,991,0,0
43,861,705,1074,982,1,11,14,213,277,42,991,0,0
44,861,705,1075,982,1,11,14,214,277,43,991,0,0
45,861,705,1075,981,1,11,14,214,276,44,991,0,0
46,861,705,1074,981,1,11,14,213,276,45,991,0,0
47,861,701,1077,983,1,11,14,216,282,46,991,0,0
48,861,704,1075,982,1,11,14,214,278,47,991,0,0
49,860,705,1074,982,1,11,14,214,277,48,991,0,0
50,860,701,1078,984,1,11,14,218,283,49,991,0,0
51,861,700,1078,982,1,11,14,217,282,50,991,0,0
52,860,702,1076,982,1,11,14,216,280,51,991,0,0
53,860,703,1074,981,1,11,14,214,278,52,991,0,0
54,860,704,1074,981,1,11,14,214,277,53,991,0,0
55,859,704,1075,982,1,11,14,216,278,54,991,0,0
56,860,703,1075,982,1,11,14,215,279,55,991,0,0
57,860,703,1076,982,1,11,14,216,279,56,991,0,0
58,860,703,1076,982,1,11,14,216,279,57,991,0,0
59,860,703,1076,983,1,11,14,216,280,58,991,0,0
60,860,704,1076,983,1,11,14,216,279,59,991,0,0
61,861,702,1075,981,1,11,14,214,279,60,991,0,0
62,861,701,1075,980,1,11,14,214,279,61,991,0,0
63,861,700,1075,980,1,11,14,214,280,62,991,0,0
64,862,698,1077,980,1,11,14,215,282,63,991,0,0
65,862,699,1075,979,1,11,14,213,280,64,991,0,0
66,861,702,1074,981,1,11,14,213,279,65,991,0,0
67,861,704,1073,981,1,11,14,212,277,66,991,0,0
68,861,704,1073,981,1,11,14,212,277,67,991,0,0
69,862,705,1074,981,1,11,14,212,276,68,991,0,0
70,862,705,1074,982,1,11,14,212,277,69,991,0,0
71,861,704,1074,982,1,11,14,213,278,70,991,0,0
72,861,704,1074,981,1,11,14,213,277,71,991,0,0
73,861,704,1074,981,1,11,14,213,277,72,991,0,0
74,861,704,1074,981,1,11,14,213,277,73,991,0,0
75,861,704,1074,981,1,11,14,213,277,74,991,0,0
76,861,703,1075,982,1,11,14,214,279,75,991,0,0
77,860,701,1076,982,1,11,14,216,281,76,991,0,0
78,858,697,1077,983,1,11,14,219,286,77,991,0,0
79,859,698,1077,983,1,11,14,218,285,78,991,0,0
80,859,695,1078,984,1,11,14,219,289,79,991,0,0
81,862,698,1075,980,1,11,14,213,282,80,991,0,0
82,862,698,1077,980,1,11,14,215,282,81,991,0,0
83,860,699,1077,986,1,11,14,217,287,82,991,0,0
84,862,701,1073,981,1,11,14,211,280,83,991,0,0
85,861,703,1071,980,1,11,14,210,277,84,991,0,0
86,859,703,1071,982,1,11,14,212,279,85,991,0,0
87,859,704,1072,983,1,11,14,213,279,86,991,0,0
88,859,706,1071,984,1,11,14,212,278,87,991,0,0
89,859,707,1072,984,1,11,14,213,277,88,991,0,0
90,858,707,1072,985,1,11,14,214,278,89,991,0,0
91,859,707,1071,983,1,11,14,212,276,90,991,0,0
92,859,707,1071,983,1,11,14,212,276,91,991,0,0
93,858,708,1071,983,1,11,14,213,275,92,991,0,0
94,858,708,1071,983,1,11,14,213,275,93,991,0,0
95,858,708,1071,982,1,11,14,213,274,94,991,0,0
96,859,706,1072,981,1,11,14,213,275,95,991,0,0
97,859,707,1073,981,1,11,14,214,274,96,991,0,0
98,859,706,1073,980,1,11,14,214,274,97,991,0,0
99,858,706,1073,980,1,11,14,215,274,98,991,0,0
100,859,706,1073,980,1,11,14,214,274,99,991,0,0
101,859,706,1073,980,1,11,14,214,274,100,991,0,0
102,859,706,1073,980,1,11,14,214,274,101,991,0,0
103,859,707,1073,979,1,11,14,214,272,102,991,0,0
104,859,707,1073,979,1,11,14,214,272,103,991,0,0
105,859,707,1073,981,1,11,14,214,274,104,991,0,0
106,860,707,1074,981,1,11,14,214,274,105,991,0,0
107,860,707,1074,981,1,11,14,214,274,106,991,0,0
108,859,706,1074,981,1,11,14,215,275,107,991,0,0
109,859,706,1074,981,1,11,14,215,275,108,991,0,0
110,859,706,1074,981,1,11,14,215,275,109,991,0,0
111,860,705,1074,980,1,11,14,214,275,110,991,0,0
112,860,705,1074,980,1,11,14,214,275,111,991,0,0
113,860,705,1074,980,1,11,14,214,275,112,991,0,0
114,860,705,1074,979,1,11,14,214,274,113,991,0,0
115,860,705,1074,980,1,11,14,214,275,114,991,0,0
116,859,706,1073,981,1,11,14,214,275,115,991,0,0
117,857,706,1073,982,1,11,14,216,276,116,991,0,0
118,858,706,1073,982,1,11,14,215,276,117,991,0,0
119,858,706,1073,983,1,11,14,215,277,118,991,0,0
120,859,705,1077,985,1,11,14,218,280,119,991,0,0
121,860,703,1079,986,1,11,14,219,283,120,991,0,0
122,860,703,1080,986,1,11,14,220,283,121,991,0,0
123,859,704,1076,985,1,11,14,217,281,122,991,0,0
124,860,704,1078,985,1,11,14,218,281,123,991,0,0
125,861,704,1079,986,1,11,14,218,282,124,991,0,0
126,860,705,1076,985,1,11,14,216,280,125,991,0,0
127,859,705,1074,984,1,11,14,215,279,126,991,0,0
128,859,705,1074,984,1,11,14,215,279,127,991,0,0
129,858,701,1075,983,1,11,14,217,282,128,991,0,0
130,854,691,1078,983,1,11,14,224,292,129,991,0,0
131,857,689,1081,983,1,11,14,224,294,130,991,0,0
132,855,684,1080,981,1,11,14,225,297,131,991,0,0
133,854,683,1080,981,1,11,14,226,298,132,991,0,0
134,855,685,1078,980,1,11,14,223,295,133,991,0,0
135,858,689,1078,980,1,11,14,220,291,134,991,0,0
136,859,694,1075,981,1,11,14,216,287,135,991,0,0
137,859,697,1073,981,1,11,14,214,284,136,991,0,0
138,860,698,1073,981,1,11,14,213,283,137,991,0,0
139,859,698,1073,981,1,11,14,214,283,138,991,0,0
140,860,698,1073,981,1,11,14,213,283,139,991,0,0
141,859,698,1073,981,1,11,14,214,283,140,991,0,0
142,853,694,1074,987,1,11,14,221,293,141,991,0,0
143,857,698,1072,984,1,11,14,215,286,142,991,0,0
144,855,691,1074,982,1,11,14,219,291,143,991,0,0
145,850,682,1077,984,1,11,14,227,302,144,991,0,0
146,852,675,1080,981,1,11,14,228,306,145,991,0,0
147,852,669,1082,980,1,11,14,230,311,146,991,0,0
148,854,669,1081,980,1,11,14,227,311,147,991,0,0
149,853,668,1079,980,1,11,14,226,312,148,991,0,0
150,856,669,1079,979,1,11,14,223,310,149,991,0,0
151,859,675,1079,980,1,11,14,220,305,150,991,0,0
152,858,683,1075,984,1,11,14,217,301,151,991,0,0
153,857,681,1075,982,1,11,14,218,301,152,991,0,0
154,857,682,1074,981,1,11,14,217,299,153,991,0,0
155,857,682,1074,981,1,11,14,217,299,154,991,0,0
156,861,684,1075,978,1,11,14,214,294,155,991,0,0
157,862,686,1075,977,1,11,14,213,291,156,991,0,0
158,859,685,1075,981,1,11,14,216,296,157,991,0,0
159,858,685,1076,983,1,11,14,218,298,158,991,0,0
160,862,687,1075,979,1,11,14,213,292,159,991,0,0
161,862,692,1073,979,1,11,14,211,287,160,991,0,0
162,862,694,1072,979,1,11,14,210,285,161,991,0,0
163,864,695,1073,980,1,11,14,209,285,162,991,0,0
164,865,695,1076,981,1,11,14,211,286,163,991,0,0
165,862,692,1074,980,1,11,14,212,288,164,991,0,0
166,864,693,1074,978,1,11,14,210,285,165,991,0,0
167,864,698,1072,979,1,11,14,208,281,166,991,0,0
168,865,696,1072,975,1,11,14,207,279,167,991,0,0
169,866,695,1072,973,1,11,14,206,278,168,991,0,0
170,864,700,1071,979,1,11,14,207,279,169,991,0,0
171,865,696,1073,977,1,11,14,208,281,170,991,0,0
172,865,694,1073,975,1,11,14,208,281,171,991,0,0
173,863,698,1072,979,1,11,14,209,281,172,991,0,0
174,865,697,1077,983,1,11,14,212,286,173,991,0,0
175,863,699,1074,982,1,11,14,211,283,174,991,0,0
176,862,697,1075,983,1,11,14,213,286,175,991,0,0
177,862,700,1073,984,1,11,14,211,284,176,991,0,0
178,863,702,1072,983,1,11,14,209,281,177,991,0,0
179,863,701,1074,984,1,11,14,211,283,178,991,0,0
180,862,702,1072,983,1,11,14,210,281,179,991,0,0
181,861,703,1071,982,1,11,14,210,279,180,991,0,0
182,863,701,1075,983,1,11,14,212,282,181,991,0,0
183,862,703,1072,981,1,11,14,210,278,182,991,0,0
184,862,703,1071,981,1,11,14,209,278,183,991,0,0
185,862,703,1071,980,1,11,14,209,277,184,991,0,0
186,863,704,1071,980,1,11,14,208,276,185,991,0,0
187,863,703,1072,979,1,11,14,209,276,186,991,0,0
188,863,703,1072,979,1,11,14,209,276,187,991,0,0
189,863,703,1072,979,1,11,14,209,276,188,991,0,0
190,862,703,1073,980,1,11,14,211,277,189,991,0,0
191,862,703,1072,980,1,11,14,210,277,190,991,0,0
192,861,699,1074,980,1,11,14,213,281,191,991,0,0
193,861,698,1073,980,1,11,14,212,282,192,991,0,0
194,861,700,1072,980,1,11,14,211,280,193,991,0,0
195,861,698,1074,981,1,11,14,213,283,194,991,0,0
196,861,701,1073,982,1,11,14,212,281,195,991,0,0
197,861,699,1073,982,1,11,14,212,283,196,991,0,0
198,861,700,1074,983,1,11,14,213,283,197,991,0,0
199,862,700,1073,982,1,11,14,211,282,198,991,0,0
200,862,699,1074,982,1,11,14,212,283,199,991,0,0
201,863,699,1074,981,1,11,14,211,282,200,991,0,0
202,863,696,1074,979,1,11,14,211,283,201,991,0,0
203,863,695,1074,978,1,11,14,211,283,202,991,0,0
204,864,698,1073,979,1,11,14,209,281,203,991,0,0
205,866,697,1076,981,1,11,14,210,284,204,991,0,0
206,866,699,1075,981,1,11,14,209,282,205,991,0,0
207,867,700,1075,981,1,11,14,208,281,206,991,0,0
208,869,696,1075,975,1,11,14,206,279,207,991,0,0
209,868,699,1075,979,1,11,14,207,280,208,991,0,0
210,867,700,1075,980,1,11,14,208,280,209,991,0,0
211,867,700,1074,981,1,11,14,207,281,210,991,0,0
212,866,701,1073,981,1,11,14,207,280,211,991,0,0
213,866,701,1073,981,1,11,14,207,280,212,991,0,0
214,866,701,1073,981,1,11,14,207,280,213,991,0,0
215,866,701,1073,981,1,11,14,207,280,214,991,0,0
216,865,700,1074,983,1,11,14,209,283,215,991,0,0
217,865,700,1074,982,1,11,14,209,282,216,991,0,0
218,865,700,1074,982,1,11,14,209,282,217,991,0,0
219,865,700,1074,983,1,11,14,209,283,218,991,0,0
220,865,700,1074,982,1,11,14,209,282,219,991,0,0
221,865,700,1073,980,1,11,14,208,280,220,991,0,0
222,864,700,1074,981,1,11,14,210,281,221,991,0,0
223,864,700,1074,982,1,11,14,210,282,222,991,0,0
224,863,700,1073,981,1,11,14,210,281,223,991,0,0
225,863,700,1073,980,1,11,14,210,280,224,991,0,0
226,862,700,1072,980,1,11,14,210,280,225,991,0,0
227,863,701,1071,978,1,11,14,208,277,226,991,0,0
228,864,701,1072,977,1,11,14,208,276,227,991,0,0
229,865,701,1074,978,1,11,14,209,277,228,991,0,0
230,865,701,1074,978,1,11,14,209,277,229,991,0,0
231,862,701,1073,981,1,11,14,211,280,230,991,0,0
232,861,699,1075,983,1,11,14,214,284,231,991,0,0
233,862,700,1074,982,1,11,14,212,282,232,991,0,0
234,861,699,1074,982,1,11,14,213,283,233,991,0,0
235,863,694,1076,978,1,11,14,213,284,234,991,0,0
236,863,694,1075,978,1,11,14,212,284,235,991,0,0
237,863,695,1074,978,1,11,14,211,283,236,991,0,0
238,863,698,1073,980,1,11,14,210,282,237,991,0,0
239,864,695,1073,976,1,11,14,209,281,238,991,0,0
240,864,696,1073,977,1,11,14,209,281,239,991,0,0
241,863,696,1071,978,1,11,14,208,282,240,991,0,0
242,864,698,1071,977,1,11,14,207,279,241,991,0,0
243,864,698,1071,977,1,11,14,207,279,242,991,0,0
244,865,697,1073,978,1,11,14,208,281,243,991,0,0
245,868,697,1074,978,1,11,14,206,281,244,991,0,0
246,867,697,1077,985,1,11,14,210,288,245,991,0,0
247,867,696,1076,982,1,11,14,209,286,246,991,0,0
248,869,696,1075,977,1,11,14,206,281,247,991,0,0
249,869,696,1075,977,1,11,14,206,281,248,991,0,0
250,867,696,1076,983,1,11,14,209,287,249,991,0,0
251,868,696,1073,975,1,11,14,205,279,250,991,0,0
252,865,700,1071,980,1,11,14,206,280,251,991,0,0
253,865,697,1074,980,1,11,14,209,283,252,991,0,0
254,863,701,1072,982,1,11,14,209,281,253,991,0,0
255,863,699,1072,981,1,11,14,209,282,254,991,0,0
256,863,698,1072,979,1,11,14,209,281,255,991,0,0
257,861,692,1074,979,1,11,14,213,287,256,991,0,0
258,861,691,1074,978,1,11,14,213,287,257,991,0,0
259,858,689,1074,980,1,11,14,216,291,258,991,0,0
260,861,696,1071,980,1,11,14,210,284,259,991,0,0
261,860,694,1071,979,1,11,14,211,285,260,991,0,0
262,857,686,1074,981,1,11,14,217,295,261,991,0,0
263,857,685,1075,983,1,11,14,218,298,262,991,0,0
264,859,689,1075,985,1,11,14,216,296,263,991,0,0
265,861,691,1074,985,1,11,14,213,294,264,991,0,0
266,862,696,1070,982,1,11,14,208,286,265,991,0,0
267,864,697,1072,983,1,11,14,208,286,266,991,0,0
268,864,696,1071,982,1,11,14,207,286,267,991,0,0
269,863,689,1073,979,1,11,14,210,290,268,991,0,0
270,857,677,1074,979,1,11,14,217,302,269,991,0,0
271,853,672,1076,984,1,11,14,223,312,270,991,0,0
272,856,675,1078,988,1,11,14,222,313,271,991,0,0
273,860,689,1072,988,1,11,14,212,299,272,991,0,0
274,865,695,1072,987,1,11,14,207,292,273,991,0,0
275,865,700,1068,985,1,11,14,203,285,274,991,0,0
276,866,703,1066,983,1,11,14,200,280,275,991,0,0
277,867,705,1065,980,1,11,14,198,275,276,991,0,0
278,867,705,1066,980,1,11,14,199,275,277,991,0,0
279,868,705,1067,980,1,11,14,199,275,278,991,0,0
280,867,706,1066,981,1,11,14,199,275,279,991,0,0
281,866,706,1066,980,1,11,14,200,274,280,991,0,0
282,865,706,1066,980,1,11,14,201,274,281,991,0,0
283,866,707,1065,979,1,11,14,199,272,282,991,0,0
284,865,707,1066,979,1,11,14,201,272,283,991,0,0
285,865,707,1066,981,1,11,14,201,274,284,991,0,0
286,864,706,1066,980,1,11,14,202,274,285,991,0,0
287,864,707,1066,980,1,11,14,202,273,286,991,0,0
288,864,707,1066,980,1,11,14,202,273,287,991,0,0
289,864,707,1066,979,1,11,14,202,272,288,991,0,0
290,864,707,1067,979,1,11,14,203,272,289,991,0,0
291,864,707,1067,978,1,11,14,203,271,290,991,0,0
292,865,707,1067,977,1,11,14,202,270,291,991,0,0
293,867,703,1068,971,1,11,14,201,268,292,991,0,0
294,865,702,1068,972,1,11,14,203,270,293,991,0,0
295,866,700,1069,970,1,11,14,203,270,294,991,0,0
296,863,701,1069,975,1,11,14,206,274,295,991,0,0
297,861,701,1069,977,1,11,14,208,276,296,991,0,0
298,861,701,1069,978,1,11,14,208,277,297,991,0,0
299,861,702,1069,978,1,11,14,208,276,298,991,0,0
300,861,702,1069,979,1,11,14,208,277,299,991,0,0
301,860,702,1070,981,1,11,14,210,279,300,991,0,0
302,862,700,1074,983,1,11,14,212,283,301,991,0,0
303,860,701,1072,982,1,11,14,212,281,302,991,0,0
304,860,701,1071,982,1,11,14,211,281,303,991,0,0
305,860,701,1070,982,1,11,14,210,281,304,991,0,0
306,861,699,1072,981,1,11,14,211,282,305,991,0,0
307,861,700,1071,980,1,11,14,210,280,306,991,0,0
308,863,696,1072,975,1,11,14,209,279,307,991,0,0
309,865,694,1073,973,1,11,14,208,279,308,991,0,0
310,863,698,1071,978,1,11,14,208,280,309,991,0,0
311,862,699,1069,977,1,11,14,207,278,310,991,0,0
312,862,700,1069,977,1,11,14,207,277,311,991,0,0
313,862,700,1069,977,1,11,14,207,277,312,991,0,0
314,861,700,1068,978,1,11,14,207,278,313,991,0,0
315,861,700,1068,978,1,11,14,207,278,314,991,0,0
316,862,700,1069,977,1,11,14,207,277,315,991,0,0
317,862,701,1069,977,1,11,14,207,276,316,991,0,0
318,862,701,1069,977,1,11,14,207,276,317,991,0,0
319,861,700,1069,977,1,11,14,208,277,318,991,0,0
320,861,700,1069,977,1,11,14,208,277,319,991,0,0
321,860,700,1069,979,1,11,14,209,279,320,991,0,0
322,859,700,1069,980,1,11,14,210,280,321,991,0,0
323,859,700,1069,980,1,11,14,210,280,322,991,0,0
324,858,701,1069,982,1,11,14,211,281,323,991,0,0
325,858,701,1069,982,1,11,14,211,281,324,991,0,0
326,857,702,1069,983,1,11,14,212,281,325,991,0,0
327,857,703,1068,983,1,11,14,211,280,326,991,0,0
328,857,703,1069,983,1,11,14,212,280,327,991,0,0
329,857,703,1069,984,1,11,14,212,281,328,991,0,0
330,857,701,1070,982,1,11,14,213,281,329,991,0,0
331,858,701,1070,982,1,11,14,212,281,330,991,0,0
332,858,701,1070,982,1,11,14,212,281,331,991,0,0
333,857,701,1070,982,1,11,14,213,281,332,991,0,0
334,857,702,1070,983,1,11,14,213,281,333,991,0,0
335,857,702,1070,983,1,11,14,213,281,334,991,0,0
336,858,702,1070,983,1,11,14,212,281,335,991,0,0
337,859,703,1071,983,1,11,14,212,280,336,991,0,0
338,860,700,1075,984,1,11,14,215,284,337,991,0,0
339,858,695,1074,982,1,11,14,216,287,338,991,0,0
340,853,682,1077,982,1,11,14,224,300,339,991,0,0
341,857,681,1076,979,1,11,14,219,298,340,991,0,0
342,857,682,1076,980,1,11,14,219,298,341,991,0,0
343,858,683,1076,980,1,11,14,218,297,342,991,0,0
344,858,683,1075,980,1,11,14,217,297,343,991,0,0
345,859,684,1074,981,1,11,14,215,297,344,991,0,0
346,858,683,1074,981,1,11,14,216,298,345,991,0,0
347,860,687,1072,979,1,11,14,212,292,346,991,0,0
348,861,689,1071,979,1,11,14,210,290,347,991,0,0
349,860,690,1071,979,1,11,14,211,289,348,991,0,0
350,859,687,1071,979,1,11,14,212,292,349,991,0,0
351,860,689,1070,979,1,11,14,210,290,350,991,0,0
352,860,690,1070,980,1,11,14,210,290,351,991,0,0
353,859,681,1075,980,1,11,14,216,299,352,991,0,0
354,860,675,1077,980,1,11,14,217,305,353,991,0,0
355,859,677,1075,981,1,11,14,216,304,354,991,0,0
356,858,674,1075,981,1,11,14,217,307,355,991,0,0
357,859,682,1070,979,1,11,14,211,297,356,991,0,0
358,859,689,1068,981,1,11,14,209,292,357,991,0,0
359,860,691,1067,981,1,11,14,207,290,358,991,0,0
360,860,692,1067,981,1,11,14,207,289,359,991,0,0
361,861,693,1067,980,1,11,14,206,287,360,991,0,0
362,861,693,1068,980,1,11,14,207,287,361,991,0,0
363,862,694,1068,978,1,11,14,206,284,362,991,0,0
364,863,694,1068,978,1,11,14,205,284,363,991,0,0
365,863,694,1068,977,1,11,14,205,283,364,991,0,0
366,864,694,1068,975,1,11,14,204,281,365,991,0,0
367,861,688,1069,975,1,11,14,208,287,366,991,0,0
368,863,692,1069,975,1,11,14,206,283,367,991,0,0
369,862,690,1069,975,1,11,14,207,285,368,991,0,0
370,863,692,1069,977,1,11,14,206,285,369,991,0,0
371,863,693,1069,977,1,11,14,206,284,370,991,0,0
372,861,689,1071,978,1,11,14,210,289,371,991,0,0
373,859,687,1071,978,1,11,14,212,291,372,991,0,0
374,860,687,1071,977,1,11,14,211,290,373,991,0,0
375,861,687,1072,977,1,11,14,211,290,374,991,0,0
376,863,693,1071,979,1,11,14,208,286,375,991,0,0
377,863,696,1070,980,1,11,14,207,284,376,991,0,0
378,863,696,1070,981,1,11,14,207,285,377,991,0,0
379,863,697,1070,981,1,11,14,207,284,378,991,0,0
380,861,692,1072,982,1,11,14,211,290,379,991,0,0
381,862,693,1073,981,1,11,14,211,288,380,991,0,0
382,863,694,1071,980,1,11,14,208,286,381,991,0,0
383,864,694,1071,980,1,11,14,207,286,382,991,0,0
384,864,695,1070,979,1,11,14,206,284,383,991,0,0
385,864,694,1071,980,1,11,14,207,286,384,991,0,0
386,863,694,1068,978,1,11,14,205,284,385,991,0,0
387,863,693,1069,978,1,11,14,206,285,386,991,0,0
388,863,697,1067,978,1,11,14,204,281,387,991,0,0
389,862,699,1067,979,1,11,14,205,280,388,991,0,0
390,862,700,1067,979,1,11,14,205,279,389,991,0,0
391,863,701,1068,979,1,11,14,205,278,390,991,0,0
392,863,702,1068,980,1,11,14,205,278,391,991,0,0
393,863,702,1068,980,1,11,14,205,278,392,991,0,0
394,862,702,1068,980,1,11,14,206,278,393,991,0,0
395,862,703,1068,979,1,11,14,206,276,394,991,0,0
396,861,703,1067,981,1,11,14,206,278,395,991,0,0
397,861,703,1067,980,1,11,14,206,277,396,991,0,0
398,861,701,1071,982,1,11,14,210,281,397,991,0,0
399,860,703,1069,982,1,11,14,209,279,398,991,0,0
400,860,703,1068,982,1,11,14,208,279,399,991,0,0
401,860,703,1068,981,1,11,14,208,278,400,991,0,0
402,860,703,1068,980,1,11,14,208,277,401,991,0,0
403,860,703,1068,980,1,11,14,208,277,402,991,0,0
404,859,703,1068,980,1,11,14,209,277,403,991,0,0
405,859,703,1069,980,1,11,14,210,277,404,991,0,0
406,860,703,1069,979,1,11,14,209,276,405,991,0,0
407,863,700,1072,977,1,11,14,209,277,406,991,0,0
408,862,702,1071,978,1,11,14,209,276,407,991,0,0
409,861,703,1070,979,1,11,14,209,276,408,991,0,0
410,861,701,1070,979,1,11,14,209,278,409,991,0,0
411,860,703,1069,981,1,11,14,209,278,410,991,0,0
412,860,704,1069,981,1,11,14,209,277,411,991,0,0
413,860,704,1069,981,1,11,14,209,277,412,991,0,0
414,861,704,1070,981,1,11,14,209,277,413,991,0,0
415,861,704,1070,981,1,11,14,209,277,414,991,0,0
416,860,705,1068,979,1,11,14,208,274,415,991,0,0
417,860,705,1068,979,1,11,14,208,274,416,991,0,0
418,861,703,1072,980,1,11,14,211,277,417,991,0,0
419,861,704,1069,979,1,11,14,208,275,418,991,0,0
420,859,704,1069,979,1,11,14,210,275,419,991,0,0
421,859,704,1069,979,1,11,14,210,275,420,991,0,0
422,860,704,1069,979,1,11,14,209,275,421,991,0,0
423,860,704,1069,979,1,11,14,209,275,422,991,0,0
424,859,702,1070,979,1,11,14,211,277,423,991,0,0
425,858,694,1074,979,1,11,14,216,285,424,991,0,0
426,856,696,1072,983,1,11,14,216,287,425,991,0,0
427,856,699,1071,984,1,11,14,215,285,426,991,0,0
428,859,703,1071,984,1,11,14,212,281,427,991,0,0
429,863,702,1075,985,1,11,14,212,283,428,991,0,0
430,864,702,1076,985,1,11,14,212,283,429,991,0,0
431,863,705,1072,983,1,11,14,209,278,430,991,0,0
432,862,706,1071,983,1,11,14,209,277,431,991,0,0
433,862,707,1070,982,1,11,14,208,275,432,991,0,0
434,862,708,1069,982,1,11,14,207,274,433,991,0,0
435,862,708,1069,982,1,11,14,207,274,434,991,0,0
436,863,704,1073,982,1,11,14,210,278,435,991,0,0
437,864,703,1074,982,1,11,14,210,279,436,991,0,0
438,862,705,1071,982,1,11,14,209,277,437,991,0,0
439,861,706,1070,982,1,11,14,209,276,438,991,0,0
440,862,707,1069,982,1,11,14,207,275,439,991,0,0
441,860,707,1069,983,1,11,14,209,276,440,991,0,0
442,859,707,1069,983,1,11,14,210,276,441,991,0,0
443,859,707,1070,984,1,11,14,211,277,442,991,0,0
444,859,707,1069,984,1,11,14,210,277,443,991,0,0
445,859,706,1070,984,1,11,14,211,278,444,991,0,0
446,860,706,1070,983,1,11,14,210,277,445,991,0,0
447,862,704,1073,983,1,11,14,211,279,446,991,0,0
448,861,706,1070,981,1,11,14,209,275,447,991,0,0
449,861,706,1070,981,1,11,14,209,275,448,991,0,0
450,863,704,1074,982,1,11,14,211,278,449,991,0,0
451,862,706,1072,982,1,11,14,210,276,450,991,0,0
452,861,706,1071,982,1,11,14,210,276,451,991,0,0
453,862,707,1071,982,1,11,14,209,275,452,991,0,0
454,861,707,1071,983,1,11,14,210,276,453,991,0,0
455,862,708,1071,983,1,11,14,209,275,454,991,0,0
456,861,708,1071,984,1,11,14,210,276,455,991,0,0
457,861,708,1070,984,1,11,14,209,276,456,991,0,0
458,861,708,1071,984,1,11,14,210,276,457,991,0,0
459,861,708,1070,984,1,11,14,209,276,458,991,0,0
460,861,708,1071,984,1,11,14,210,276,459,991,0,0
461,861,708,1070,982,1,11,14,209,274,460,991,0,0
462,862,708,1070,982,1,11,14,208,274,461,991,0,0
463,862,708,1070,982,1,11,14,208,274,462,991,0,0
464,861,708,1071,983,1,11,14,210,275,463,991,0,0
465,861,708,1070,983,1,11,14,209,275,464,991,0,0
466,861,707,1070,982,1,11,14,209,275,465,991,0,0
467,861,707,1070,982,1,11,14,209,275,466,991,0,0
468,862,707,1070,980,1,11,14,208,273,467,991,0,0
469,861,706,1070,981,1,11,14,209,275,468,991,0,0
470,862,706,1071,982,1,11,14,209,276,469,991,0,0
471,861,706,1071,981,1,11,14,210,275,470,991,0,0
472,861,706,1070,981,1,11,14,209,275,471,991,0,0
473,861,706,1070,980,1,11,14,209,274,472,991,0,0
474,860,706,1070,980,1,11,14,210,274,473,991,0,0
475,860,706,1070,980,1,11,14,210,274,474,991,0,0
476,860,706,1071,982,1,11,14,211,276,475,991,0,0
477,860,706,1071,983,1,11,14,211,277,476,991,0,0
478,860,706,1072,983,1,11,14,212,277,477,991,0,0
479,860,707,1071,984,1,11,14,211,277,478,991,0,0
480,860,707,1071,984,1,11,14,211,277,479,991,0,0
481,861,707,1071,982,1,11,14,210,275,480,991,0,0
482,862,707,1071,982,1,11,14,209,275,481,991,0,0
483,862,708,1071,981,1,11,14,209,273,482,991,0,0
484,862,708,1071,981,1,11,14,209,273,483,991,0,0
485,862,708,1071,981,1,11,14,209,273,484,991,0,0
486,862,708,1071,981,1,11,14,209,273,485,991,0,0
487,863,708,1072,981,1,11,14,209,273,486,991,0,0
488,863,708,1072,981,1,11,14,209,273,487,991,0,0
489,863,708,1072,981,1,11,14,209,273,488,991,0,0
490,862,708,1072,981,1,11,14,210,273,489,991,0,0
491,862,708,1072,982,1,11,14,210,274,490,991,0,0
492,862,708,1072,982,1,11,14,210,274,491,991,0,0
493,862,708,1072,982,1,11,14,210,274,492,991,0,0
494,862,708,1072,982,1,11,14,210,274,493,991,0,0
495,862,708,1072,983,1,11,14,210,275,494,991,0,0
496,862,708,1071,981,1,11,14,209,273,495,991,0,0
497,862,708,1071,981,1,11,14,209,273,496,991,0,0
498,862,708,1071,981,1,11,14,209,273,497,991,0,0
499,862,708,1071,982,1,11,14,209,274,498,991,0,0
500,862,708,1071,982,1,11,14,209,274,499,991,0,0
501,862,708,1072,983,1,11,14,210,275,500,991,0,0
502,862,708,1072,984,1,11,14,210,276,501,991,0,0
503,862,708,1072,984,1,11,14,210,276,502,991,0,0
504,862,708,1072,984,1,11,14,210,276,503,991,0,0
505,862,708,1072,985,1,11,14,210,277,504,991,0,0
506,862,707,1071,983,1,11,14,209,276,505,991,0,0
507,862,707,1071,983,1,11,14,209,276,506,991,0,0
508,862,707,1070,982,1,11,14,208,275,507,991,0,0
509,861,706,1070,982,1,11,14,209,276,508,991,0,0
510,861,706,1070,982,1,11,14,209,276,509,991,0,0
511,862,707,1071,984,1,11,14,209,277,510,991,0,0
512,862,707,1072,984,1,11,14,210,277,511,991,0,0
513,862,707,1072,984,1,11,14,210,277,512,991,0,0
514,862,707,1071,984,1,11,14,209,277,513,991,0,0
515,862,708,1072,984,1,11,14,210,276,514,991,0,0
516,861,708,1070,984,1,11,14,209,276,515,991,0,0
517,862,708,1070,982,1,11,14,208,274,516,991,0,0
518,862,707,1070,982,1,11,14,208,275,517,991,0,0
519,862,707,1071,982,1,11,14,209,275,518,991,0,0
520,863,707,1070,981,1,11,14,207,274,519,991,0,0
521,861,707,1071,984,1,11,14,210,277,520,991,0,0
522,861,707,1071,985,1,11,14,210,278,521,991,0,0
523,861,708,1071,985,1,11,14,210,277,522,991,0,0
524,860,708,1071,986,1,11,14,211,278,523,991,0,0
525,861,704,1073,984,1,11,14,212,280,524,991,0,0
526,860,705,1071,984,1,11,14,211,279,525,991,0,0
527,860,706,1070,985,1,11,14,210,279,526,991,0,0
528,860,706,1070,985,1,11,14,210,279,527,991,0,0
529,859,706,1070,985,1,11,14,211,279,528,991,0,0
530,860,706,1070,985,1,11,14,210,279,529,991,0,0
531,860,706,1069,981,1,11,14,209,275,530,991,0,0
532,861,706,1068,979,1,11,14,207,273,531,991,0,0
533,860,706,1068,979,1,11,14,208,273,532,991,0,0
534,860,706,1068,979,1,11,14,208,273,533,991,0,0
535,860,706,1068,979,1,11,14,208,273,534,991,0,0
536,860,706,1070,980,1,11,14,210,274,535,991,0,0
537,860,706,1070,981,1,11,14,210,275,536,991,0,0
538,860,706,1071,982,1,11,14,211,276,537,991,0,0
539,860,706,1071,982,1,11,14,211,276,538,991,0,0
540,860,706,1071,982,1,11,14,211,276,539,991,0,0
541,860,706,1070,980,1,11,14,210,274,540,991,0,0
542,860,706,1070,980,1,11,14,210,274,541,991,0,0
543,859,705,1070,979,1,11,14,211,274,542,991,0,0
544,859,705,1070,979,1,11,14,211,274,543,991,0,0
545,859,705,1070,980,1,11,14,211,275,544,991,0,0
546,859,706,1070,982,1,11,14,211,276,545,991,0,0
547,859,706,1071,982,1,11,14,212,276,546,991,0,0
548,859,706,1070,983,1,11,14,211,277,547,991,0,0
549,858,707,1070,983,1,11,14,212,276,548,991,0,0
550,859,707,1070,983,1,11,14,211,276,549,991,0,0
551,861,703,1072,980,1,11,14,211,277,550,991,0,0
552,862,702,1073,979,1,11,14,211,277,551,991,0,0
553,862,702,1073,979,1,11,14,211,277,552,991,0,0
554,862,704,1072,980,1,11,14,210,276,553,991,0,0
555,862,706,1071,981,1,11,14,209,275,554,991,0,0
556,861,706,1071,982,1,11,14,210,276,555,991,0,0
557,861,706,1071,982,1,11,14,210,276,556,991,0,0
558,861,707,1071,983,1,11,14,210,276,557,991,0,0
559,860,707,1070,983,1,11,14,210,276,558,991,0,0
560,860,707,1070,983,1,11,14,210,276,559,991,0,0
561,860,705,1070,981,1,11,14,210,276,560,991,0,0
562,860,705,1071,981,1,11,14,211,276,561,991,0,0
563,860,705,1071,981,1,11,14,211,276,562,991,0,0
564,859,704,1070,981,1,11,14,211,277,563,991,0,0
565,860,705,1070,981,1,11,14,210,276,564,991,0,0
566,860,705,1070,980,1,11,14,210,275,565,991,0,0
567,862,703,1074,981,1,11,14,212,278,566,991,0,0
568,861,704,1072,981,1,11,14,211,277,567,991,0,0
569,862,706,1072,981,1,11,14,210,275,568,991,0,0
570,862,702,1075,981,1,11,14,213,279,569,991,0,0
571,860,700,1074,982,1,11,14,214,282,570,991,0,0
572,859,702,1073,983,1,11,14,214,281,571,991,0,0
573,860,699,1073,982,1,11,14,213,283,572,991,0,0
574,860,698,1074,982,1,11,14,214,284,573,991,0,0
575,860,697,1074,982,1,11,14,214,285,574,991,0,0
576,863,696,1074,976,1,11,14,211,280,575,991,0,0
577,863,698,1073,979,1,11,14,210,281,576,991,0,0
578,865,697,1074,975,1,11,14,209,278,577,991,0,0
579,863,698,1073,979,1,11,14,210,281,578,991,0,0
580,861,698,1072,980,1,11,14,211,282,579,991,0,0
581,858,692,1072,980,1,11,14,214,288,580,991,0,0
582,856,688,1068,974,1,11,14,212,286,581,991,0,0
583,860,686,1066,962,1,11,14,206,276,582,991,0,0
584,863,685,1068,958,1,11,14,205,273,583,991,0,0
585,864,687,1068,960,1,11,14,204,273,584,991,0,0
586,863,691,1067,964,1,11,14,204,273,585,991,0,0
587,863,691,1067,964,1,11,14,204,273,586,991,0,0
588,862,692,1068,967,1,11,14,206,275,587,991,0,0
589,859,693,1067,969,1,11,14,208,276,588,991,0,0
590,859,695,1067,971,1,11,14,208,276,589,991,0,0
591,859,693,1066,969,1,11,14,207,276,590,991,0,0
592,859,693,1068,970,1,11,14,209,277,591,991,0,0
593,860,694,1068,970,1,11,14,208,276,592,991,0,0
594,860,694,1068,970,1,11,14,208,276,593,991,0,0
595,860,696,1066,969,1,11,14,206,273,594,991,0,0
596,860,701,1065,973,1,11,14,205,272,595,991,0,0
597,858,704,1060,971,1,11,14,202,267,596,991,0,0
598,858,699,1061,969,1,11,14,203,270,597,991,0,0
599,857,695,1065,971,1,11,14,208,276,598,991,0,0
600,856,688,1070,975,1,11,14,214,287,599,991,0,0
601,857,684,1074,976,1,11,14,217,292,600,991,0,0
602,856,684,1071,975,1,11,14,215,291,601,991,0,0
603,855,685,1069,975,1,11,14,214,290,602,991,0,0
604,855,684,1068,973,1,11,14,213,289,603,991,0,0
605,855,685,1069,974,1,11,14,214,289,604,991,0,0
606,857,686,1069,975,1,11,14,212,289,605,991,0,0
607,858,685,1071,976,1,11,14,213,291,606,991,0,0
608,858,686,1068,974,1,11,14,210,288,607,991,0,0
609,858,687,1067,973,1,11,14,209,286,608,991,0,0
610,859,688,1066,972,1,11,14,207,284,609,991,0,0
611,860,689,1065,970,1,11,14,205,281,610,991,0,0
612,860,689,1065,969,1,11,14,205,280,611,991,0,0
613,860,689,1064,968,1,11,14,204,279,612,991,0,0
614,861,690,1064,967,1,11,14,203,277,613,991,0,0
615,861,690,1065,968,1,11,14,204,278,614,991,0,0
616,861,690,1066,970,1,11,14,205,280,615,991,0,0
617,861,690,1066,971,1,11,14,205,281,616,991,0,0
618,861,691,1066,971,1,11,14,205,280,617,991,0,0
619,862,693,1065,972,1,11,14,203,279,618,991,0,0
620,862,694,1065,972,1,11,14,203,278,619,991,0,0
621,862,694,1065,971,1,11,14,203,277,620,991,0,0
622,863,694,1065,970,1,11,14,202,276,621,991,0,0
623,862,693,1067,972,1,11,14,205,279,622,991,0,0
624,862,693,1066,971,1,11,14,204,278,623,991,0,0
625,862,693,1065,970,1,11,14,203,277,624,991,0,0
626,862,693,1065,969,1,11,14,203,276,625,991,0,0
627,863,693,1066,969,1,11,14,203,276,626,991,0,0
628,860,692,1068,976,1,11,14,208,284,627,991,0,0
629,862,694,1069,977,1,11,14,207,283,628,991,0,0
630,864,694,1065,970,1,11,14,201,276,629,991,0,0
631,863,697,1066,974,1,11,14,203,277,630,991,0,0
632,885,693,1081,967,1,11,14,196,274,631,991,0,0
633,843,641,1127,1042,1,11,14,284,401,632,991,0,0
634,850,669,1087,1004,1,11,14,237,335,633,991,0,0
635,864,684,1072,978,1,11,14,208,294,634,991,0,0
636,863,692,1066,976,1,11,14,203,284,635,991,0,0
637,863,695,1064,976,1,11,14,201,281,636,991,0,0
638,863,695,1064,975,1,11,14,201,280,637,991,0,0
639,862,695,1063,975,1,11,14,201,280,638,991,0,0
640,861,695,1063,975,1,11,14,202,280,639,991,0,0
641,862,696,1062,974,1,11,14,200,278,640,991,0,0
642,862,697,1062,972,1,11,14,200,275,641,991,0,0
643,862,697,1062,973,1,11,14,200,276,642,991,0,0
644,861,697,1062,972,1,11,14,201,275,643,991,0,0
645,860,697,1062,973,1,11,14,202,276,644,991,0,0
646,861,694,1065,973,1,11,14,204,279,645,991,0,0
647,860,695,1063,971,1,11,14,203,276,646,991,0,0
648,860,695,1063,971,1,11,14,203,276,647,991,0,0
649,859,696,1063,972,1,11,14,204,276,648,991,0,0
650,860,697,1064,972,1,11,14,204,275,649,991,0,0
651,860,699,1064,974,1,11,14,204,275,650,991,0,0
652,860,699,1064,974,1,11,14,204,275,651,991,0,0
653,860,700,1064,975,1,11,14,204,275,652,991,0,0
654,861,700,1064,974,1,11,14,203,274,653,991,0,0
655,861,701,1064,974,1,11,14,203,273,654,991,0,0
656,860,700,1064,974,1,11,14,204,274,655,991,0,0
657,860,700,1064,973,1,11,14,204,273,656,991,0,0
658,860,700,1064,973,1,11,14,204,273,657,991,0,0
659,860,700,1065,973,1,11,14,205,273,658,991,0,0
660,859,700,1065,974,1,11,14,206,274,659,991,0,0
661,859,698,1065,974,1,11,14,206,276,660,991,0,0
662,858,697,1066,974,1,11,14,208,277,661,991,0,0
663,858,697,1066,974,1,11,14,208,277,662,991,0,0
664,858,697,1066,974,1,11,14,208,277,663,991,0,0
665,858,697,1066,974,1,11,14,208,277,664,991,0,0
666,859,697,1065,972,1,11,14,206,275,665,991,0,0
667,860,697,1065,971,1,11,14,205,274,666,991,0,0
668,861,697,1065,971,1,11,14,204,274,667,991,0,0
669,860,697,1065,971,1,11,14,205,274,668,991,0,0
670,860,697,1065,971,1,11,14,205,274,669,991,0,0
671,859,697,1066,973,1,11,14,207,276,670,991,0,0
672,859,697,1066,974,1,11,14,207,277,671,991,0,0
673,858,698,1066,975,1,11,14,208,277,672,991,0,0
674,858,697,1066,974,1,11,14,208,277,673,991,0,0
675,858,697,1066,974,1,11,14,208,277,674,991,0,0
676,859,698,1065,972,1,11,14,206,274,675,991,0,0
677,860,699,1064,971,1,11,14,204,272,676,991,0,0
678,860,699,1065,971,1,11,14,205,272,677,991,0,0
679,860,699,1065,972,1,11,14,205,273,678,991,0,0
680,860,699,1065,971,1,11,14,205,272,679,991,0,0
681,860,699,1066,973,1,11,14,206,274,680,991,0,0
682,861,699,1066,973,1,11,14,205,274,681,991,0,0
683,860,699,1067,974,1,11,14,207,275,682,991,0,0
684,860,699,1067,974,1,11,14,207,275,683,991,0,0
685,860,699,1067,974,1,11,14,207,275,684,991,0,0
686,861,699,1066,973,1,11,14,205,274,685,991,0,0
687,861,699,1066,972,1,11,14,205,273,686,991,0,0
688,862,700,1066,972,1,11,14,204,272,687,991,0,0
689,862,700,1065,971,1,11,14,203,271,688,991,0,0
690,864,697,1070,973,1,11,14,206,276,689,991,0,0
691,862,698,1067,971,1,11,14,205,273,690,991,0,0
692,862,698,1066,971,1,11,14,204,273,691,991,0,0
693,862,699,1065,970,1,11,14,203,271,692,991,0,0
694,861,699,1065,970,1,11,14,204,271,693,991,0,0
695,861,699,1065,970,1,11,14,204,271,694,991,0,0
696,862,699,1065,969,1,11,14,203,270,695,991,0,0
697,862,699,1065,969,1,11,14,203,270,696,991,0,0
698,862,699,1065,968,1,11,14,203,269,697,991,0,0
699,861,699,1065,969,1,11,14,204,270,698,991,0,0
700,862,698,1065,968,1,11,14,203,270,699,991,0,0
701,862,698,1066,970,1,11,14,204,272,700,991,0,0
702,862,698,1066,971,1,11,14,204,273,701,991,0,0
703,862,698,1067,972,1,11,14,205,274,702,991,0,0
704,862,699,1066,972,1,11,14,204,273,703,991,0,0
705,863,699,1066,971,1,11,14,203,272,704,991,0,0
706,864,698,1067,970,1,11,14,203,272,705,991,0,0
707,863,699,1065,970,1,11,14,202,271,706,991,0,0
708,863,699,1065,969,1,11,14,202,270,707,991,0,0
709,862,695,1067,971,1,11,14,205,276,708,991,0,0
710,862,697,1065,969,1,11,14,203,272,709,991,0,0
711,860,698,1065,971,1,11,14,205,273,710,991,0,0
712,860,698,1065,973,1,11,14,205,275,711,991,0,0
713,860,698,1064,972,1,11,14,204,274,712,991,0,0
714,859,698,1064,972,1,11,14,205,274,713,991,0,0
715,860,699,1065,973,1,11,14,205,274,714,991,0,0
716,859,698,1065,973,1,11,14,206,275,715,991,0,0
717,859,694,1068,974,1,11,14,209,280,716,991,0,0
718,859,693,1068,974,1,11,14,209,281,717,991,0,0
719,859,696,1066,974,1,11,14,207,278,718,991,0,0
720,859,697,1065,974,1,11,14,206,277,719,991,0,0
721,861,696,1067,974,1,11,14,206,278,720,991,0,0
722,861,699,1065,973,1,11,14,204,274,721,991,0,0
723,862,699,1067,974,1,11,14,205,275,722,991,0,0
724,861,699,1065,974,1,11,14,204,275,723,991,0,0
725,861,699,1065,974,1,11,14,204,275,724,991,0,0
726,863,697,1068,974,1,11,14,205,277,725,991,0,0
727,863,699,1066,973,1,11,14,203,274,726,991,0,0
728,864,699,1066,973,1,11,14,202,274,727,991,0,0
729,865,699,1066,973,1,11,14,201,274,728,991,0,0
730,865,700,1066,973,1,11,14,201,273,729,991,0,0
731,864,704,1062,971,1,11,14,198,267,730,991,0,0
732,863,704,1061,970,1,11,14,198,266,731,991,0,0
733,862,704,1062,970,1,11,14,200,266,732,991,0,0
734,862,704,1062,970,1,11,14,200,266,733,991,0,0
735,862,704,1062,970,1,11,14,200,266,734,991,0,0
736,860,704,1063,972,1,11,14,203,268,735,991,0,0
737,862,703,1066,974,1,11,14,204,271,736,991,0,0
738,861,703,1064,972,1,11,14,203,269,737,991,0,0
739,861,704,1064,972,1,11,14,203,268,738,991,0,0
740,860,704,1064,972,1,11,14,204,268,739,991,0,0
741,861,704,1063,970,1,11,14,202,266,740,991,0,0
742,861,703,1065,972,1,11,14,204,269,741,991,0,0
743,860,703,1064,972,1,11,14,204,269,742,991,0,0
744,860,703,1063,971,1,11,14,203,268,743,991,0,0
745,860,704,1064,971,1,11,14,204,267,744,991,0,0
746,860,704,1063,970,1,11,14,203,266,745,991,0,0
747,860,704,1064,972,1,11,14,204,268,746,991,0,0
748,859,704,1064,972,1,11,14,205,268,747,991,0,0
749,858,704,1065,973,1,11,14,207,269,748,991,0,0
750,858,704,1065,973,1,11,14,207,269,749,991,0,0
751,859,703,1067,974,1,11,14,208,271,750,991,0,0
752,859,703,1067,974,1,11,14,208,271,751,991,0,0
753,859,703,1067,973,1,11,14,208,270,752,991,0,0
754,859,702,1067,972,1,11,14,208,270,753,991,0,0
755,859,702,1067,972,1,11,14,208,270,754,991,0,0
756,859,702,1067,972,1,11,14,208,270,755,991,0,0
757,859,702,1067,973,1,11,14,208,271,756,991,0,0
758,859,702,1067,973,1,11,14,208,271,757,991,0,0
759,859,702,1067,973,1,11,14,208,271,758,991,0,0
760,859,701,1067,973,1,11,14,208,272,759,991,0,0
761,857,701,1067,975,1,11,14,210,274,760,991,0,0
762,856,701,1067,975,1,11,14,211,274,761,991,0,0
763,856,701,1067,976,1,11,14,211,275,762,991,0,0
764,856,701,1067,977,1,11,14,211,276,763,991,0,0
765,856,701,1067,977,1,11,14,211,276,764,991,0,0
766,859,700,1067,972,1,11,14,208,272,765,991,0,0
767,858,696,1068,971,1,11,14,210,275,766,991,0,0
768,858,698,1066,970,1,11,14,208,272,767,991,0,0
769,858,696,1067,971,1,11,14,209,275,768,991,0,0
770,858,697,1065,970,1,11,14,207,273,769,991,0,0
771,857,696,1066,971,1,11,14,209,275,770,991,0,0
772,856,692,1067,971,1,11,14,211,279,771,991,0,0
773,856,690,1068,970,1,11,14,212,280,772,991,0,0
774,856,687,1070,971,1,11,14,214,284,773,991,0,0
775,857,686,1070,970,1,11,14,213,284,774,991,0,0
776,859,686,1072,970,1,11,14,213,284,775,991,0,0
777,860,686,1071,970,1,11,14,211,284,776,991,0,0
778,860,689,1069,970,1,11,14,209,281,777,991,0,0
779,860,690,1068,970,1,11,14,208,280,778,991,0,0
780,861,688,1069,969,1,11,14,208,281,779,991,0,0
781,860,691,1067,970,1,11,14,207,279,780,991,0,0
782,860,693,1067,970,1,11,14,207,277,781,991,0,0
783,861,693,1066,969,1,11,14,205,276,782,991,0,0
784,860,694,1066,970,1,11,14,206,276,783,991,0,0
785,860,694,1066,971,1,11,14,206,277,784,991,0,0
786,859,693,1067,972,1,11,14,208,279,785,991,0,0
787,859,693,1068,972,1,11,14,209,279,786,991,0,0
788,859,694,1068,973,1,11,14,209,279,787,991,0,0
789,860,694,1067,972,1,11,14,207,278,788,991,0,0
790,860,694,1067,972,1,11,14,207,278,789,991,0,0
791,859,693,1067,972,1,11,14,208,279,790,991,0,0
792,858,693,1068,973,1,11,14,210,280,791,991,0,0
793,858,693,1068,973,1,11,14,210,280,792,991,0,0
794,858,692,1068,973,1,11,14,210,281,793,991,0,0
795,858,692,1068,973,1,11,14,210,281,794,991,0,0
796,860,694,1068,971,1,11,14,208,277,795,991,0,0
797,862,694,1067,970,1,11,14,205,276,796,991,0,0
798,860,694,1067,971,1,11,14,207,277,797,991,0,0
799,860,695,1066,971,1,11,14,206,276,798,991,0,0
800,859,693,1069,974,1,11,14,210,281,799,991,0,0
801,862,695,1067,971,1,11,14,205,276,800,991,0,0
802,863,695,1068,971,1,11,14,205,276,801,991,0,0
803,867,697,1067,968,1,11,14,200,271,802,991,0,0
804,865,697,1068,971,1,11,14,203,274,803,991,0,0
805,864,696,1067,969,1,11,14,203,273,804,991,0,0
806,891,696,1083,962,1,11,14,192,266,805,991,0,0
807,875,701,1041,932,1,11,14,166,231,806,991,0,0
808,868,699,1055,956,1,11,14,187,257,807,991,0,0
809,867,699,1060,963,1,11,14,193,264,808,991,0,0
810,863,699,1062,971,1,11,14,199,272,809,991,0,0
811,863,698,1063,970,1,11,14,200,272,810,991,0,0
812,863,698,1063,969,1,11,14,200,271,811,991,0,0
813,863,698,1064,969,1,11,14,201,271,812,991,0,0
814,863,698,1064,968,1,11,14,201,270,813,991,0,0
815,863,698,1064,968,1,11,14,201,270,814,991,0,0
816,862,697,1065,969,1,11,14,203,272,815,991,0,0
817,861,697,1065,970,1,11,14,204,273,816,991,0,0
818,860,697,1065,970,1,11,14,205,273,817,991,0,0
819,860,696,1065,970,1,11,14,205,274,818,991,0,0
820,861,697,1065,970,1,11,14,204,273,819,991,0,0
821,860,698,1064,970,1,11,14,204,272,820,991,0,0
822,859,698,1064,969,1,11,14,205,271,821,991,0,0
823,859,698,1065,969,1,11,14,206,271,822,991,0,0
824,859,698,1065,970,1,11,14,206,272,823,991,0,0
825,859,698,1065,970,1,11,14,206,272,824,991,0,0
826,858,698,1065,972,1,11,14,207,274,825,991,0,0
827,858,699,1066,972,1,11,14,208,273,826,991,0,0
828,858,699,1065,972,1,11,14,207,273,827,991,0,0
829,857,699,1066,972,1,11,14,209,273,828,991,0,0
830,858,699,1067,973,1,11,14,209,274,829,991,0,0
831,858,697,1066,971,1,11,14,208,274,830,991,0,0
832,858,697,1066,970,1,11,14,208,273,831,991,0,0
833,858,697,1066,970,1,11,14,208,273,832,991,0,0
834,859,696,1067,968,1,11,14,208,272,833,991,0,0
835,846,694,1037,949,1,11,14,191,255,834,991,0,0
836,891,693,1057,916,1,11,14,166,223,835,991,0,0
837,878,695,1071,956,1,11,14,193,261,836,991,0,0
838,867,696,1070,971,1,11,14,203,275,837,991,0,0
839,865,696,1067,970,1,11,14,202,274,838,991,0,0
840,863,698,1065,970,1,11,14,202,272,839,991,0,0
841,865,699,1067,972,1,11,14,202,273,840,991,0,0
842,862,699,1066,974,1,11,14,204,275,841,991,0,0
843,861,694,1068,976,1,11,14,207,282,842,991,0,0
844,860,696,1065,974,1,11,14,205,278,843,991,0,0
845,859,696,1065,974,1,11,14,206,278,844,991,0,0
846,861,696,1065,971,1,11,14,204,275,845,991,0,0
847,861,696,1065,970,1,11,14,204,274,846,991,0,0
848,861,696,1065,970,1,11,14,204,274,847,991,0,0
849,861,697,1065,970,1,11,14,204,273,848,991,0,0
850,860,697,1065,970,1,11,14,205,273,849,991,0,0
851,859,696,1065,970,1,11,14,206,274,850,991,0,0
852,859,696,1065,971,1,11,14,206,275,851,991,0,0
853,859,696,1065,971,1,11,14,206,275,852,991,0,0
854,859,695,1065,971,1,11,14,206,276,853,991,0,0
855,859,695,1066,970,1,11,14,207,275,854,991,0,0
856,860,697,1065,970,1,11,14,205,273,855,991,0,0
857,860,698,1065,969,1,11,14,205,271,856,991,0,0
858,860,698,1065,969,1,11,14,205,271,857,991,0,0
859,860,698,1065,969,1,11,14,205,271,858,991,0,0
860,860,698,1065,969,1,11,14,205,271,859,991,0,0
861,860,698,1065,969,1,11,14,205,271,860,991,0,0
862,859,698,1065,970,1,11,14,206,272,861,991,0,0
863,859,699,1065,970,1,11,14,206,271,862,991,0,0
864,858,699,1065,970,1,11,14,207,271,863,991,0,0
865,858,699,1065,970,1,11,14,207,271,864,991,0,0
866,859,698,1066,970,1,11,14,207,272,865,991,0,0
867,860,698,1067,970,1,11,14,207,272,866,991,0,0
868,860,698,1067,969,1,11,14,207,271,867,991,0,0
869,861,698,1068,969,1,11,14,207,271,868,991,0,0
870,860,697,1068,970,1,11,14,208,273,869,991,0,0
871,859,697,1068,972,1,11,14,209,275,870,991,0,0
872,859,697,1067,970,1,11,14,208,273,871,991,0,0
873,858,697,1067,971,1,11,14,209,274,872,991,0,0
874,857,697,1067,971,1,11,14,210,274,873,991,0,0
875,857,696,1067,972,1,11,14,210,276,874,991,0,0
876,857,697,1066,970,1,11,14,209,273,875,991,0,0
877,858,697,1066,970,1,11,14,208,273,876,991,0,0
878,858,697,1067,970,1,11,14,209,273,877,991,0,0
879,858,697,1067,970,1,11,14,209,273,878,991,0,0
880,858,698,1067,969,1,11,14,209,271,879,991,0,0
881,856,697,1068,972,1,11,14,212,275,880,991,0,0
882,856,697,1068,972,1,11,14,212,275,881,991,0,0
883,855,696,1069,973,1,11,14,214,277,882,991,0,0
884,856,696,1068,973,1,11,14,212,277,883,991,0,0
885,856,696,1069,973,1,11,14,213,277,884,991,0,0
886,857,696,1069,972,1,11,14,212,276,885,991,0,0
887,858,695,1069,972,1,11,14,211,277,886,991,0,0
888,859,696,1069,972,1,11,14,210,276,887,991,0,0
889,859,696,1069,971,1,11,14,210,275,888,991,0,0
890,859,696,1068,971,1,11,14,209,275,889,991,0,0
891,859,696,1067,969,1,11,14,208,273,890,991,0,0
892,859,696,1066,969,1,11,14,207,273,891,991,0,0
893,859,696,1066,969,1,11,14,207,273,892,991,0,0
894,859,697,1067,969,1,11,14,208,272,893,991,0,0
895,860,697,1066,968,1,11,14,206,271,894,991,0,0
896,858,698,1066,970,1,11,14,208,272,895,991,0,0
897,858,698,1067,971,1,11,14,209,273,896,991,0,0
898,857,698,1066,972,1,11,14,209,274,897,991,0,0
899,857,698,1066,972,1,11,14,209,274,898,991,0,0
900,856,699,1066,973,1,11,14,210,274,899,991,0,0
901,856,697,1067,972,1,11,14,211,275,900,991,0,0
902,857,697,1067,971,1,11,14,210,274,901,991,0,0
903,857,697,1067,971,1,11,14,210,274,902,991,0,0
904,858,697,1067,970,1,11,14,209,273,903,991,0,0
905,857,697,1067,970,1,11,14,210,273,904,991,0,0
906,857,697,1067,970,1,11,14,210,273,905,991,0,0
907,856,696,1067,970,1,11,14,211,274,906,991,0,0
908,856,695,1067,970,1,11,14,211,275,907,991,0,0
909,857,694,1068,970,1,11,14,211,276,908,991,0,0
910,857,693,1068,970,1,11,14,211,277,909,991,0,0
911,859,694,1069,970,1,11,14,210,276,910,991,0,0
912,860,695,1068,968,1,11,14,208,273,911,991,0,0
913,860,694,1069,968,1,11,14,209,274,912,991,0,0
914,860,694,1069,968,1,11,14,209,274,913,991,0,0
915,861,695,1069,969,1,11,14,208,274,914,991,0,0
916,861,695,1069,969,1,11,14,208,274,915,991,0,0
917,861,695,1068,969,1,11,14,207,274,916,991,0,0
918,861,695,1069,969,1,11,14,208,274,917,991,0,0
919,861,695,1069,968,1,11,14,208,273,918,991,0,0
920,861,694,1068,968,1,11,14,207,274,919,991,0,0
921,862,694,1068,968,1,11,14,206,274,920,991,0,0
922,862,694,1068,967,1,11,14,206,273,921,991,0,0
923,861,695,1069,970,1,11,14,208,275,922,991,0,0
924,860,695,1069,970,1,11,14,209,275,923,991,0,0
925,860,695,1069,971,1,11,14,209,276,924,991,0,0
926,860,694,1069,971,1,11,14,209,277,925,991,0,0
927,860,694,1069,971,1,11,14,209,277,926,991,0,0
928,860,693,1069,972,1,11,14,209,279,927,991,0,0
929,860,693,1069,971,1,11,14,209,278,928,991,0,0
930,860,693,1068,971,1,11,14,208,278,929,991,0,0
931,858,693,1067,971,1,11,14,209,278,930,991,0,0
932,858,693,1067,972,1,11,14,209,279,931,991,0,0
933,858,693,1066,971,1,11,14,208,278,932,991,0,0
934,859,695,1066,970,1,11,14,207,275,933,991,0,0
935,866,698,1069,968,1,11,14,203,270,934,991,0,0
936,869,699,1074,972,1,11,14,205,273,935,991,0,0
937,882,699,1063,939,1,11,14,181,240,936,991,0,0
938,869,697,1069,963,1,11,14,200,266,937,991,0,0
939,867,699,1070,971,1,11,14,203,272,938,991,0,0
940,867,697,1073,975,1,11,14,206,278,939,991,0,0
941,866,699,1067,971,1,11,14,201,272,940,991,0,0
942,867,703,1064,973,1,11,14,197,270,941,991,0,0
943,868,715,1059,975,1,11,14,191,260,942,991,0,0
944,869,713,1061,974,1,11,14,192,261,943,991,0,0
945,870,711,1063,974,1,11,14,193,263,944,991,0,0
946,870,710,1065,975,1,11,14,195,265,945,991,0,0
947,870,706,1067,975,1,11,14,197,269,946,991,0,0
948,869,705,1066,973,1,11,14,197,268,947,991,0,0
949,869,705,1064,972,1,11,14,195,267,948,991,0,0
950,869,706,1063,972,1,11,14,194,266,949,991,0,0
951,871,708,1064,971,1,11,14,193,263,950,991,0,0
952,872,706,1065,969,1,11,14,193,263,951,991,0,0
953,873,705,1067,966,1,11,14,194,261,952,991,0,0
954,872,705,1068,967,1,11,14,196,262,953,991,0,0
955,868,705,1067,969,1,11,14,199,264,954,991,0,0
956,868,706,1068,968,1,11,14,200,262,955,991,0,0
957,870,708,1072,970,1,11,14,202,262,956,991,0,0
958,864,706,1069,971,1,11,14,205,265,957,991,0,0
959,867,706,1075,971,1,11,14,208,265,958,991,0,0
960,869,707,1078,970,1,11,14,209,263,959,991,0,0
961,866,704,1079,970,1,11,14,213,266,960,991,0,0
962,864,704,1076,970,1,11,14,212,266,961,991,0,0
963,863,703,1074,969,1,11,14,211,266,962,991,0,0
964,862,703,1073,969,1,11,14,211,266,963,991,0,0
965,860,705,1073,972,1,11,14,213,267,964,991,0,0
966,861,707,1073,972,1,11,14,212,265,965,991,0,0
967,862,708,1074,972,1,11,14,212,264,966,991,0,0
968,862,706,1076,973,1,11,14,214,267,967,991,0,0
969,862,707,1075,971,1,11,14,213,264,968,991,0,0
970,862,706,1077,972,1,11,14,215,266,969,991,0,0
971,863,705,1079,974,1,11,14,216,269,970,991,0,0
972,863,704,1080,974,1,11,14,217,270,971,991,0,0
973,862,703,1080,975,1,11,14,218,272,972,991,0,0
974,862,703,1080,975,1,11,14,218,272,973,991,0,0
975,862,703,1080,975,1,11,14,218,272,974,991,0,0
976,864,703,1079,971,1,11,14,215,268,975,991,0,0
977,867,701,1082,971,1,11,14,215,270,976,991,0,0
978,868,700,1083,971,1,11,14,215,271,977,991,0,0
979,869,700,1083,971,1,11,14,214,271,978,991,0,0
980,869,700,1083,971,1,11,14,214,271,979,991,0,0
981,866,701,1080,973,1,11,14,214,272,980,991,0,0
982,865,702,1078,973,1,11,14,213,271,981,991,0,0
983,864,702,1078,973,1,11,14,214,271,982,991,0,0
984,865,702,1078,973,1,11,14,213,271,983,991,0,0
985,864,702,1078,973,1,11,14,214,271,984,991,0,0
986,864,700,1079,973,1,11,14,215,273,985,991,0,0
987,861,696,1080,973,1,11,14,219,277,986,991,0,0
988,858,693,1082,976,1,11,14,224,283,987,991,0,0
989,859,694,1081,976,1,11,14,222,282,988,991,0,0
990,862,697,1082,978,1,11,14,220,281,989,991,0,0
991,874,698,1087,974,1,11,14,213,276,990,991,0,0
992,875,698,1088,974,1,11,14,213,276,991,991,1,0
995,870,700,1080,973,1,11,14,210,273,0,991,0,1
996,868,702,1077,973,1,11,14,209,271,1,991,0,0
997,866,703,1076,972,1,11,14,210,269,2,991,0,0
998,866,704,1076,972,1,11,14,210,268,3,991,0,0
999,866,705,1076,972,1,11,14,210,267,4,991,0,0
1000,866,704,1077,972,1,11,14,211,268,5,991,0,0
1001,866,703,1078,973,1,11,14,212,270,6,991,0,0
1002,866,702,1079,973,1,11,14,213,271,7,991,0,0
1003,866,702,1078,973,1,11,14,212,271,8,991,0,0
1004,865,702,1078,973,1,11,14,213,271,9,991,0,0
1005,866,702,1078,973,1,11,14,212,271,10,991,0,0
1006,865,702,1077,972,1,11,14,212,270,11,991,0,0
1007,866,702,1078,972,1,11,14,212,270,12,991,0,0
1008,866,703,1077,971,1,11,14,211,268,13,991,0,0
1009,866,703,1077,971,1,11,14,211,268,14,991,0,0
1010,869,701,1081,970,1,11,14,212,269,15,991,0,0
1011,868,699,1083,971,1,11,14,215,272,16,991,0,0
1012,869,698,1083,971,1,11,14,214,273,17,991,0,0
1013,870,697,1083,971,1,11,14,213,274,18,991,0,0
1014,867,699,1080,972,1,11,14,213,273,19,991,0,0
1015,869,698,1082,971,1,11,14,213,273,20,991,0,0
1016,866,701,1078,973,1,11,14,212,272,21,991,0,0
1017,864,701,1077,973,1,11,14,213,272,22,991,0,0
1018,864,701,1077,974,1,11,14,213,273,23,991,0,0
1019,864,702,1077,974,1,11,14,213,272,24,991,0,0
1020,864,702,1077,974,1,11,14,213,272,25,991,0,0
1021,864,701,1077,973,1,11,14,213,272,26,991,0,0
1022,864,701,1077,972,1,11,14,213,271,27,991,0,0
1023,864,701,1077,972,1,11,14,213,271,28,991,0,0
1024,862,701,1077,973,1,11,14,215,272,29,991,0,0
1025,862,701,1078,973,1,11,14,216,272,30,991,0,0
1026,863,701,1077,970,1,11,14,214,269,31,991,0,0
1027,864,702,1076,969,1,11,14,212,267,32,991,0,0
1028,864,702,1076,968,1,11,14,212,266,33,991,0,0
1029,863,702,1077,969,1,11,14,214,267,34,991,0,0
1030,863,702,1077,969,1,11,14,214,267,35,991,0,0
1031,864,702,1078,968,1,11,14,214,266,36,991,0,0
1032,865,703,1078,968,1,11,14,213,265,37,991,0,0
1033,865,703,1078,968,1,11,14,213,265,38,991,0,0
1034,865,704,1078,969,1,11,14,213,265,39,991,0,0
1035,865,704,1078,969,1,11,14,213,265,40,991,0,0
1036,864,704,1079,971,1,11,14,215,267,41,991,0,0
1037,863,704,1079,972,1,11,14,216,268,42,991,0,0
1038,863,704,1079,972,1,11,14,216,268,43,991,0,0
1039,864,704,1079,972,1,11,14,215,268,44,991,0,0
1040,863,704,1078,972,1,11,14,215,268,45,991,0,0
1041,865,705,1079,971,1,11,14,214,266,46,991,0,0
1042,865,705,1078,970,1,11,14,213,265,47,991,0,0
1043,865,705,1078,970,1,11,14,213,265,48,991,0,0
1044,866,702,1078,966,1,11,14,212,264,49,991,0,0
1045,866,704,1077,967,1,11,14,211,263,50,991,0,0
1046,866,703,1080,970,1,11,14,214,267,51,991,0,0
1047,865,704,1079,970,1,11,14,214,266,52,991,0,0
1048,864,704,1079,971,1,11,14,215,267,53,991,0,0
1049,863,704,1078,971,1,11,14,215,267,54,991,0,0
1050,864,705,1078,970,1,11,14,214,265,55,991,0,0
1051,863,705,1078,971,1,11,14,215,266,56,991,0,0
1052,862,705,1078,971,1,11,14,216,266,57,991,0,0
1053,862,705,1078,972,1,11,14,216,267,58,991,0,0
1054,862,705,1078,972,1,11,14,216,267,59,991,0,0
1055,862,705,1078,972,1,11,14,216,267,60,991,0,0
1056,862,706,1078,972,1,11,14,216,266,61,991,0,0
1057,862,706,1078,972,1,11,14,216,266,62,991,0,0
1058,862,707,1078,972,1,11,14,216,265,63,991,0,0
1059,863,707,1078,971,1,11,14,215,264,64,991,0,0
1060,863,707,1078,971,1,11,14,215,264,65,991,0,0
1061,863,707,1077,971,1,11,14,214,264,66,991,0,0
1062,863,708,1078,970,1,11,14,215,262,67,991,0,0
1063,862,707,1078,971,1,11,14,216,264,68,991,0,0
1064,861,707,1078,971,1,11,14,217,264,69,991,0,0
1065,862,707,1078,971,1,11,14,216,264,70,991,0,0
1066,864,707,1079,970,1,11,14,215,263,71,991,0,0
1067,863,707,1079,969,1,11,14,216,262,72,991,0,0
1068,864,707,1079,969,1,11,14,215,262,73,991,0,0
1069,865,707,1079,969,1,11,14,214,262,74,991,0,0
1070,865,706,1080,969,1,11,14,215,263,75,991,0,0
1071,861,706,1080,973,1,11,14,219,267,76,991,0,0
1072,861,706,1079,973,1,11,14,218,267,77,991,0,0
1073,861,706,1079,973,1,11,14,218,267,78,991,0,0
1074,861,706,1079,973,1,11,14,218,267,79,991,0,0
1075,860,704,1079,973,1,11,14,219,269,80,991,0,0
1076,861,704,1079,972,1,11,14,218,268,81,991,0,0
1077,862,704,1079,971,1,11,14,217,267,82,991,0,0
1078,861,704,1079,971,1,11,14,218,267,83,991,0,0
1079,861,704,1078,970,1,11,14,217,266,84,991,0,0
1080,861,704,1078,970,1,11,14,217,266,85,991,0,0
1081,860,705,1077,969,1,11,14,217,264,86,991,0,0
1082,860,705,1077,969,1,11,14,217,264,87,991,0,0
1083,860,706,1077,969,1,11,14,217,263,88,991,0,0
1084,860,706,1077,968,1,11,14,217,262,89,991,0,0
1085,860,706,1076,967,1,11,14,216,261,90,991,0,0
1086,859,705,1079,970,1,11,14,220,265,91,991,0,0
1087,859,705,1079,970,1,11,14,220,265,92,991,0,0
1088,859,705,1080,971,1,11,14,221,266,93,991,0,0
1089,858,705,1080,971,1,11,14,222,266,94,991,0,0
1090,858,705,1080,972,1,11,14,222,267,95,991,0,0
1091,860,705,1080,969,1,11,14,220,264,96,991,0,0
1092,861,704,1080,967,1,11,14,219,263,97,991,0,0
1093,861,704,1079,967,1,11,14,218,263,98,991,0,0
1094,862,705,1079,966,1,11,14,217,261,99,991,0,0
1095,862,705,1080,967,1,11,14,218,262,100,991,0,0
1096,860,705,1081,970,1,11,14,221,265,101,991,0,0
1097,860,705,1080,971,1,11,14,220,266,102,991,0,0
1098,860,705,1080,971,1,11,14,220,266,103,991,0,0
1099,860,705,1081,971,1,11,14,221,266,104,991,0,0
1100,860,705,1081,971,1,11,14,221,266,105,991,0,0
1101,860,705,1080,970,1,11,14,220,265,106,991,0,0
1102,861,705,1079,969,1,11,14,218,264,107,991,0,0
1103,862,705,1079,969,1,11,14,217,264,108,991,0,0
1104,861,705,1079,969,1,11,14,218,264,109,991,0,0
1105,861,705,1078,968,1,11,14,217,263,110,991,0,0
1106,860,704,1080,970,1,11,14,220,266,111,991,0,0
1107,860,704,1080,970,1,11,14,220,266,112,991,0,0
1108,860,704,1080,970,1,11,14,220,266,113,991,0,0
1109,860,704,1080,970,1,11,14,220,266,114,991,0,0
1110,861,704,1081,970,1,11,14,220,266,115,991,0,0
1111,861,704,1080,970,1,11,14,219,266,116,991,0,0
1112,861,704,1080,970,1,11,14,219,266,117,991,0,0
1113,862,704,1079,970,1,11,14,217,266,118,991,0,0
1114,862,704,1079,970,1,11,14,217,266,119,991,0,0
1115,862,704,1079,969,1,11,14,217,265,120,991,0,0
1116,860,703,1079,971,1,11,14,219,268,121,991,0,0
1117,859,703,1078,971,1,11,14,219,268,122,991,0,0
1118,859,703,1078,971,1,11,14,219,268,123,991,0,0
1119,859,703,1078,971,1,11,14,219,268,124,991,0,0
1120,859,703,1077,971,1,11,14,218,268,125,991,0,0
1121,860,704,1077,970,1,11,14,217,266,126,991,0,0
1122,861,705,1076,969,1,11,14,215,264,127,991,0,0
1123,861,705,1076,969,1,11,14,215,264,128,991,0,0
1124,862,705,1076,969,1,11,14,214,264,129,991,0,0
1125,861,705,1076,969,1,11,14,215,264,130,991,0,0
1126,862,701,1079,967,1,11,14,217,266,131,991,0,0
1127,864,701,1079,965,1,11,14,215,264,132,991,0,0
1128,866,703,1080,966,1,11,14,214,263,133,991,0,0
1129,866,701,1079,964,1,11,14,213,263,134,991,0,0
1130,865,701,1078,963,1,11,14,213,262,135,991,0,0
1131,861,704,1077,969,1,11,14,216,265,136,991,0,0
1132,859,706,1076,971,1,11,14,217,265,137,991,0,0
1133,859,706,1075,972,1,11,14,216,266,138,991,0,0
1134,859,707,1075,972,1,11,14,216,265,139,991,0,0
1135,859,707,1075,972,1,11,14,216,265,140,991,0,0
1136,859,706,1076,970,1,11,14,217,264,141,991,0,0
1137,859,706,1076,970,1,11,14,217,264,142,991,0,0
1138,859,706,1076,970,1,11,14,217,264,143,991,0,0
1139,858,706,1076,970,1,11,14,218,264,144,991,0,0
1140,858,706,1076,970,1,11,14,218,264,145,991,0,0
1141,860,706,1076,967,1,11,14,216,261,146,991,0,0
1142,861,706,1076,967,1,11,14,215,261,147,991,0,0
1143,862,707,1077,966,1,11,14,215,259,148,991,0,0
1144,863,707,1077,965,1,11,14,214,258,149,991,0,0
1145,863,707,1078,966,1,11,14,215,259,150,991,0,0
1146,861,705,1078,968,1,11,14,217,263,151,991,0,0
1147,860,705,1079,970,1,11,14,219,265,152,991,0,0
1148,861,705,1078,969,1,11,14,217,264,153,991,0,0
1149,862,705,1078,969,1,11,14,216,264,154,991,0,0
1150,861,704,1079,969,1,11,14,218,265,155,991,0,0
1151,860,702,1080,970,1,11,14,220,268,156,991,0,0
1152,861,701,1081,970,1,11,14,220,269,157,991,0,0
1153,862,701,1081,970,1,11,14,219,269,158,991,0,0
1154,862,701,1081,970,1,11,14,219,269,159,991,0,0
1155,861,701,1081,971,1,11,14,220,270,160,991,0,0
1156,862,700,1082,971,1,11,14,220,271,161,991,0,0
1157,861,701,1079,970,1,11,14,218,269,162,991,0,0
1158,860,702,1079,970,1,11,14,219,268,163,991,0,0
1159,860,703,1079,971,1,11,14,219,268,164,991,0,0
1160,860,703,1078,970,1,11,14,218,267,165,991,0,0
1161,861,703,1079,969,1,11,14,218,266,166,991,0,0
1162,863,701,1082,969,1,11,14,219,268,167,991,0,0
1163,862,703,1079,968,1,11,14,217,265,168,991,0,0
1164,862,703,1079,968,1,11,14,217,265,169,991,0,0
1165,861,703,1079,968,1,11,14,218,265,170,991,0,0
1166,860,703,1080,972,1,11,14,220,269,171,991,0,0
1167,860,704,1080,972,1,11,14,220,268,172,991,0,0
1168,861,704,1081,973,1,11,14,220,269,173,991,0,0
1169,860,705,1081,974,1,11,14,221,269,174,991,0,0
1170,860,705,1081,974,1,11,14,221,269,175,991,0,0
1171,863,705,1081,972,1,11,14,218,267,176,991,0,0
1172,864,705,1081,971,1,11,14,217,266,177,991,0,0
1173,864,706,1080,971,1,11,14,216,265,178,991,0,0
1174,864,706,1079,970,1,11,14,215,264,179,991,0,0
1175,863,706,1079,970,1,11,14,216,264,180,991,0,0
1176,861,705,1078,970,1,11,14,217,265,181,991,0,0
1177,860,704,1078,970,1,11,14,218,266,182,991,0,0
1178,861,704,1078,968,1,11,14,217,264,183,991,0,0
1179,862,704,1078,968,1,11,14,216,264,184,991,0,0
1180,861,704,1078,968,1,11,14,217,264,185,991,0,0
1181,859,701,1079,970,1,11,14,220,269,186,991,0,0
1182,859,703,1079,970,1,11,14,220,267,187,991,0,0
1183,859,704,1079,971,1,11,14,220,267,188,991,0,0
1184,859,704,1079,971,1,11,14,220,267,189,991,0,0
1185,859,704,1079,971,1,11,14,220,267,190,991,0,0
1186,859,704,1080,973,1,11,14,221,269,191,991,0,0
1187,859,705,1080,973,1,11,14,221,268,192,991,0,0
1188,858,705,1079,974,1,11,14,221,269,193,991,0,0
1189,859,705,1079,973,1,11,14,220,268,194,991,0,0
1190,859,705,1079,973,1,11,14,220,268,195,991,0,0
1191,861,705,1079,969,1,11,14,218,264,196,991,0,0
1192,861,705,1079,969,1,11,14,218,264,197,991,0,0
1193,859,703,1079,968,1,11,14,220,265,198,991,0,0
1194,860,703,1079,968,1,11,14,219,265,199,991,0,0
1195,860,704,1078,968,1,11,14,218,264,200,991,0,0
1196,860,703,1078,967,1,11,14,218,264,201,991,0,0
1197,860,703,1078,967,1,11,14,218,264,202,991,0,0
1198,861,702,1077,967,1,11,14,216,265,203,991,0,0
1199,860,702,1077,967,1,11,14,217,265,204,991,0,0
1200,861,702,1077,967,1,11,14,216,265,205,991,0,0
1201,862,704,1077,968,1,11,14,215,264,206,991,0,0
1202,862,705,1077,968,1,11,14,215,263,207,991,0,0
1203,862,706,1077,968,1,11,14,215,262,208,991,0,0
1204,862,706,1078,969,1,11,14,216,263,209,991,0,0
1205,862,706,1079,969,1,11,14,217,263,210,991,0,0
1206,862,706,1080,971,1,11,14,218,265,211,991,0,0
1207,863,704,1082,970,1,11,14,219,266,212,991,0,0
1208,864,704,1082,970,1,11,14,218,266,213,991,0,0
1209,864,706,1080,971,1,11,14,216,265,214,991,0,0
1210,864,706,1080,970,1,11,14,216,264,215,991,0,0
1211,865,706,1081,972,1,11,14,216,266,216,991,0,0
1212,864,706,1081,972,1,11,14,217,266,217,991,0,0
1213,864,706,1080,973,1,11,14,216,267,218,991,0,0
1214,864,706,1080,973,1,11,14,216,267,219,991,0,0
1215,864,707,1080,973,1,11,14,216,266,220,991,0,0
1216,864,705,1081,973,1,11,14,217,268,221,991,0,0
1217,864,704,1080,972,1,11,14,216,268,222,991,0,0
1218,863,703,1080,972,1,11,14,217,269,223,991,0,0
1219,864,703,1080,972,1,11,14,216,269,224,991,0,0
1220,863,702,1080,972,1,11,14,217,270,225,991,0,0
1221,863,704,1079,972,1,11,14,216,268,226,991,0,0
1222,864,705,1079,972,1,11,14,215,267,227,991,0,0
1223,865,705,1079,971,1,11,14,214,266,228,991,0,0
1224,866,705,1080,971,1,11,14,214,266,229,991,0,0
1225,866,703,1081,970,1,11,14,215,267,230,991,0,0
1226,867,700,1083,969,1,11,14,216,269,231,991,0,0
1227,868,700,1083,969,1,11,14,215,269,232,991,0,0
1228,866,702,1080,968,1,11,14,214,266,233,991,0,0
1229,867,701,1082,968,1,11,14,215,267,234,991,0,0
1230,867,701,1083,969,1,11,14,216,268,235,991,0,0
1231,865,701,1081,969,1,11,14,216,268,236,991,0,0
1232,867,700,1082,968,1,11,14,215,268,237,991,0,0
1233,865,701,1080,969,1,11,14,215,268,238,991,0,0
1234,867,701,1082,969,1,11,14,215,268,239,991,0,0
1235,869,701,1083,968,1,11,14,214,267,240,991,0,0
1236,865,702,1080,970,1,11,14,215,268,241,991,0,0
1237,864,703,1079,971,1,11,14,215,268,242,991,0,0
1238,864,703,1079,971,1,11,14,215,268,243,991,0,0
1239,864,704,1078,972,1,11,14,214,268,244,991,0,0
1240,864,704,1078,972,1,11,14,214,268,245,991,0,0
1241,865,704,1079,972,1,11,14,214,268,246,991,0,0
1242,865,704,1079,971,1,11,14,214,267,247,991,0,0
1243,867,704,1080,971,1,11,14,213,267,248,991,0,0
1244,866,704,1080,971,1,11,14,214,267,249,991,0,0
1245,866,705,1079,972,1,11,14,213,267,250,991,0,0
1246,865,705,1078,971,1,11,14,213,266,251,991,0,0
1247,865,705,1078,971,1,11,14,213,266,252,991,0,0
1248,866,705,1078,970,1,11,14,212,265,253,991,0,0
1249,865,706,1078,970,1,11,14,213,264,254,991,0,0
1250,865,705,1079,971,1,11,14,214,266,255,991,0,0
1251,865,705,1081,973,1,11,14,216,268,256,991,0,0
1252,864,705,1081,973,1,11,14,217,268,257,991,0,0
1253,868,703,1085,972,1,11,14,217,269,258,991,0,0
1254,866,703,1083,973,1,11,14,217,270,259,991,0,0
1255,865,704,1082,973,1,11,14,217,269,260,991,0,0
1256,863,704,1080,973,1,11,14,217,269,261,991,0,0
1257,863,705,1079,973,1,11,14,216,268,262,991,0,0
1258,864,702,1079,969,1,11,14,215,267,263,991,0,0
1259,864,700,1079,968,1,11,14,215,268,264,991,0,0
1260,864,704,1079,970,1,11,14,215,266,265,991,0,0
1261,862,705,1078,972,1,11,14,216,267,266,991,0,0
1262,862,703,1079,972,1,11,14,217,269,267,991,0,0
1263,863,703,1079,970,1,11,14,216,267,268,991,0,0
1264,863,703,1078,970,1,11,14,215,267,269,991,0,0
1265,863,705,1078,971,1,11,14,215,266,270,991,0,0
1266,862,704,1079,973,1,11,14,217,269,271,991,0,0
1267,862,704,1079,974,1,11,14,217,270,272,991,0,0
1268,862,704,1079,974,1,11,14,217,270,273,991,0,0
1269,864,706,1079,973,1,11,14,215,267,274,991,0,0
1270,864,705,1079,973,1,11,14,215,268,275,991,0,0
1271,864,705,1077,971,1,11,14,213,266,276,991,0,0
1272,864,706,1077,970,1,11,14,213,264,277,991,0,0
1273,864,706,1077,970,1,11,14,213,264,278,991,0,0
1274,863,705,1077,970,1,11,14,214,265,279,991,0,0
1275,863,704,1077,969,1,11,14,214,265,280,991,0,0
1276,864,700,1081,969,1,11,14,217,269,281,991,0,0
1277,865,699,1082,968,1,11,14,217,269,282,991,0,0
1278,866,698,1082,968,1,11,14,216,270,283,991,0,0
1279,866,698,1082,967,1,11,14,216,269,284,991,0,0
1280,864,701,1079,968,1,11,14,215,267,285,991,0,0
1281,863,701,1079,970,1,11,14,216,269,286,991,0,0
1282,864,702,1079,970,1,11,14,215,268,287,991,0,0
1283,864,702,1079,971,1,11,14,215,269,288,991,0,0
1284,863,702,1079,971,1,11,14,216,269,289,991,0,0
1285,863,702,1078,971,1,11,14,215,269,290,991,0,0
1286,862,702,1078,973,1,11,14,216,271,291,991,0,0
1287,862,702,1078,973,1,11,14,216,271,292,991,0,0
1288,862,702,1078,973,1,11,14,216,271,293,991,0,0
1289,861,703,1078,973,1,11,14,217,270,294,991,0,0
1290,861,703,1078,973,1,11,14,217,270,295,991,0,0
1291,861,703,1078,973,1,11,14,217,270,296,991,0,0
1292,861,703,1079,974,1,11,14,218,271,297,991,0,0
1293,861,704,1079,974,1,11,14,218,270,298,991,0,0
1294,861,704,1079,974,1,11,14,218,270,299,991,0,0
1295,861,704,1079,974,1,11,14,218,270,300,991,0,0
1296,860,703,1080,974,1,11,14,220,271,301,991,0,0
1297,860,703,1080,974,1,11,14,220,271,302,991,0,0
1298,860,703,1080,974,1,11,14,220,271,303,991,0,0
1299,860,703,1080,974,1,11,14,220,271,304,991,0,0
1300,859,702,1080,974,1,11,14,221,272,305,991,0,0
1301,860,702,1079,973,1,11,14,219,271,306,991,0,0
1302,859,702,1079,973,1,11,14,220,271,307,991,0,0
1303,860,702,1079,972,1,11,14,219,270,308,991,0,0
1304,860,700,1080,971,1,11,14,220,271,309,991,0,0
1305,860,702,1079,973,1,11,14,219,271,310,991,0,0
1306,860,703,1080,976,1,11,14,220,273,311,991,0,0
1307,859,703,1080,976,1,11,14,221,273,312,991,0,0
1308,859,702,1080,977,1,11,14,221,275,313,991,0,0
1309,860,702,1081,977,1,11,14,221,275,314,991,0,0
1310,860,701,1081,976,1,11,14,221,275,315,991,0,0
1311,865,703,1081,972,1,11,14,216,269,316,991,0,0
1312,867,703,1081,971,1,11,14,214,268,317,991,0,0
1313,868,704,1081,971,1,11,14,213,267,318,991,0,0
1314,869,704,1081,970,1,11,14,212,266,319,991,0,0
1315,870,704,1082,970,1,11,14,212,266,320,991,0,0
1316,865,703,1079,972,1,11,14,214,269,321,991,0,0
1317,864,703,1079,972,1,11,14,215,269,322,991,0,0
1318,863,703,1078,972,1,11,14,215,269,323,991,0,0
1319,864,704,1078,972,1,11,14,214,268,324,991,0,0
1320,863,704,1078,972,1,11,14,215,268,325,991,0,0
1321,861,706,1078,975,1,11,14,217,269,326,991,0,0
1322,861,706,1078,975,1,11,14,217,269,327,991,0,0
1323,861,706,1078,975,1,11,14,217,269,328,991,0,0
1324,862,706,1078,974,1,11,14,216,268,329,991,0,0
1325,861,706,1077,974,1,11,14,216,268,330,991,0,0
1326,863,705,1079,973,1,11,14,216,268,331,991,0,0
1327,867,703,1082,970,1,11,14,215,267,332,991,0,0
1328,866,703,1082,970,1,11,14,216,267,333,991,0,0
1329,865,704,1081,971,1,11,14,216,267,334,991,0,0
1330,865,704,1081,971,1,11,14,216,267,335,991,0,0
1331,865,704,1079,971,1,11,14,214,267,336,991,0,0
1332,864,704,1079,971,1,11,14,215,267,337,991,0,0
1333,866,705,1079,970,1,11,14,213,265,338,991,0,0
1334,867,705,1079,970,1,11,14,212,265,339,991,0,0
1335,866,705,1079,969,1,11,14,213,264,340,991,0,0
1336,866,705,1078,970,1,11,14,212,265,341,991,0,0
1337,866,705,1078,970,1,11,14,212,265,342,991,0,0
1338,866,706,1078,969,1,11,14,212,263,343,991,0,0
1339,866,706,1077,969,1,11,14,211,263,344,991,0,0
1340,865,706,1077,969,1,11,14,212,263,345,991,0,0
1341,862,706,1077,973,1,11,14,215,267,346,991,0,0
1342,861,706,1077,975,1,11,14,216,269,347,991,0,0
1343,861,706,1078,975,1,11,14,217,269,348,991,0,0
1344,862,706,1078,975,1,11,14,216,269,349,991,0,0
1345,861,706,1076,973,1,11,14,215,267,350,991,0,0
1346,862,706,1075,972,1,11,14,213,266,351,991,0,0
1347,862,706,1074,971,1,11,14,212,265,352,991,0,0
1348,862,705,1075,973,1,11,14,213,268,353,991,0,0
1349,865,707,1075,973,1,11,14,210,266,354,991,0,0
1350,865,711,1074,977,1,11,14,209,266,355,991,0,0
1351,864,719,1069,981,1,11,14,205,262,356,991,0,0
1352,879,723,1087,981,1,11,14,208,258,357,991,0,0
1353,887,724,1095,978,1,11,14,208,254,358,991,0,0
1354,879,724,1093,980,1,11,14,214,256,359,991,0,0
1355,867,715,1087,981,1,11,14,220,266,360,991,0,0
1356,859,706,1083,978,1,11,14,224,272,361,991,0,0
1357,859,702,1082,975,1,11,14,223,273,362,991,0,0
1358,862,703,1081,971,1,11,14,219,268,363,991,0,0
1359,863,697,1083,970,1,11,14,220,273,364,991,0,0
1360,859,689,1084,971,1,11,14,225,282,365,991,0,0
1361,861,689,1082,968,1,11,14,221,279,366,991,0,0
1362,863,690,1079,966,1,11,14,216,276,367,991,0,0
1363,865,693,1077,965,1,11,14,212,272,368,991,0,0
1364,865,696,1076,967,1,11,14,211,271,369,991,0,0
1365,866,697,1074,966,1,11,14,208,269,370,991,0,0
1366,866,697,1074,966,1,11,14,208,269,371,991,0,0
1367,867,699,1072,964,1,11,14,205,265,372,991,0,0
1368,867,699,1072,964,1,11,14,205,265,373,991,0,0
1369,867,700,1071,964,1,11,14,204,264,374,991,0,0
1370,867,702,1071,965,1,11,14,204,263,375,991,0,0
1371,867,702,1071,966,1,11,14,204,264,376,991,0,0
1372,867,703,1070,966,1,11,14,203,263,377,991,0,0
1373,868,703,1071,965,1,11,14,203,262,378,991,0,0
1374,869,703,1070,963,1,11,14,201,260,379,991,0,0
1375,869,704,1070,964,1,11,14,201,260,380,991,0,0
1376,867,704,1069,965,1,11,14,202,261,381,991,0,0
1377,866,704,1069,966,1,11,14,203,262,382,991,0,0
1378,866,704,1069,966,1,11,14,203,262,383,991,0,0
1379,866,704,1069,964,1,11,14,203,260,384,991,0,0
1380,866,704,1068,964,1,11,14,202,260,385,991,0,0
1381,867,704,1070,965,1,11,14,203,261,386,991,0,0
1382,866,704,1070,967,1,11,14,204,263,387,991,0,0
1383,866,704,1070,967,1,11,14,204,263,388,991,0,0
1384,866,704,1070,967,1,11,14,204,263,389,991,0,0
1385,866,704,1070,967,1,11,14,204,263,390,991,0,0
1386,867,704,1071,966,1,11,14,204,262,391,991,0,0
1387,868,704,1071,966,1,11,14,203,262,392,991,0,0
1388,868,704,1071,966,1,11,14,203,262,393,991,0,0
1389,868,704,1070,965,1,11,14,202,261,394,991,0,0
1390,868,704,1070,965,1,11,14,202,261,395,991,0,0
1391,867,704,1070,965,1,11,14,203,261,396,991,0,0
1392,867,704,1070,965,1,11,14,203,261,397,991,0,0
1393,867,704,1070,966,1,11,14,203,262,398,991,0,0
1394,867,705,1070,966,1,11,14,203,261,399,991,0,0
1395,867,704,1071,966,1,11,14,204,262,400,991,0,0
1396,869,704,1071,964,1,11,14,202,260,401,991,0,0
1397,871,705,1070,962,1,11,14,199,257,402,991,0,0
1398,871,705,1069,960,1,11,14,198,255,403,991,0,0
1399,871,706,1069,960,1,11,14,198,254,404,991,0,0
1400,870,706,1070,962,1,11,14,200,256,405,991,0,0
1401,870,705,1070,961,1,11,14,200,256,406,991,0,0
1402,870,704,1070,961,1,11,14,200,257,407,991,0,0
1403,869,704,1070,961,1,11,14,201,257,408,991,0,0
1404,870,704,1069,959,1,11,14,199,255,409,991,0,0
1405,870,704,1069,959,1,11,14,199,255,410,991,0,0
1406,869,704,1070,962,1,11,14,201,258,411,991,0,0
1407,869,704,1070,963,1,11,14,201,259,412,991,0,0
1408,867,705,1070,964,1,11,14,203,259,413,991,0,0
1409,868,705,1070,964,1,11,14,202,259,414,991,0,0
1410,868,705,1070,964,1,11,14,202,259,415,991,0,0
1411,867,705,1070,964,1,11,14,203,259,416,991,0,0
1412,867,705,1071,965,1,11,14,204,260,417,991,0,0
1413,867,705,1071,965,1,11,14,204,260,418,991,0,0
1414,867,705,1071,966,1,11,14,204,261,419,991,0,0
1415,866,705,1071,966,1,11,14,205,261,420,991,0,0
1416,868,705,1071,965,1,11,14,203,260,421,991,0,0
1417,869,706,1071,964,1,11,14,202,258,422,991,0,0
1418,870,706,1069,961,1,11,14,199,255,423,991,0,0
1419,870,705,1070,963,1,11,14,200,258,424,991,0,0
1420,870,706,1069,961,1,11,14,199,255,425,991,0,0
1421,868,706,1070,964,1,11,14,202,258,426,991,0,0
1422,868,706,1070,964,1,11,14,202,258,427,991,0,0
1423,869,704,1071,964,1,11,14,202,260,428,991,0,0
1424,868,705,1071,966,1,11,14,203,261,429,991,0,0
1425,868,705,1071,966,1,11,14,203,261,430,991,0,0
1426,869,706,1070,964,1,11,14,201,258,431,991,0,0
1427,868,706,1070,965,1,11,14,202,259,432,991,0,0
1428,868,706,1070,965,1,11,14,202,259,433,991,0,0
1429,868,707,1070,965,1,11,14,202,258,434,991,0,0
1430,869,707,1069,964,1,11,14,200,257,435,991,0,0
1431,869,707,1070,965,1,11,14,201,258,436,991,0,0
1432,870,707,1071,965,1,11,14,201,258,437,991,0,0
1433,870,707,1071,965,1,11,14,201,258,438,991,0,0
1434,870,707,1070,966,1,11,14,200,259,439,991,0,0
1435,870,707,1070,966,1,11,14,200,259,440,991,0,0
1436,868,706,1069,966,1,11,14,201,260,441,991,0,0
1437,868,706,1069,965,1,11,14,201,259,442,991,0,0
1438,868,706,1069,966,1,11,14,201,260,443,991,0,0
1439,867,706,1069,966,1,11,14,202,260,444,991,0,0
1440,867,707,1069,966,1,11,14,202,259,445,991,0,0
1441,869,706,1071,966,1,11,14,202,260,446,991,0,0
1442,870,706,1072,967,1,11,14,202,261,447,991,0,0
1443,870,706,1071,967,1,11,14,201,261,448,991,0,0
1444,870,706,1071,967,1,11,14,201,261,449,991,0,0
1445,871,706,1071,966,1,11,14,200,260,450,991,0,0
1446,871,707,1072,969,1,11,14,201,262,451,991,0,0
1447,871,707,1072,971,1,11,14,201,264,452,991,0,0
1448,871,708,1071,971,1,11,14,200,263,453,991,0,0
1449,871,708,1071,971,1,11,14,200,263,454,991,0,0
1450,871,708,1071,970,1,11,14,200,262,455,991,0,0
1451,872,706,1068,965,1,11,14,196,259,456,991,0,0
1452,872,706,1067,963,1,11,14,195,257,457,991,0,0
1453,872,708,1065,962,1,11,14,193,254,458,991,0,0
1454,871,708,1065,961,1,11,14,194,253,459,991,0,0
1455,872,708,1067,962,1,11,14,195,254,460,991,0,0
1456,871,707,1067,963,1,11,14,196,256,461,991,0,0
1457,870,707,1067,963,1,11,14,197,256,462,991,0,0
1458,872,707,1069,964,1,11,14,197,257,463,991,0,0
1459,871,706,1068,963,1,11,14,197,257,464,991,0,0
1460,871,706,1068,962,1,11,14,197,256,465,991,0,0
1461,871,707,1068,962,1,11,14,197,255,466,991,0,0
1462,871,706,1070,964,1,11,14,199,258,467,991,0,0
1463,872,706,1071,965,1,11,14,199,259,468,991,0,0
1464,872,706,1070,965,1,11,14,198,259,469,991,0,0
1465,871,707,1069,965,1,11,14,198,258,470,991,0,0
1466,871,707,1069,967,1,11,14,198,260,471,991,0,0
1467,870,707,1069,967,1,11,14,199,260,472,991,0,0
1468,871,705,1069,966,1,11,14,198,261,473,991,0,0
1469,871,705,1068,966,1,11,14,197,261,474,991,0,0
1470,871,706,1069,967,1,11,14,198,261,475,991,0,0
1471,874,706,1069,964,1,11,14,195,258,476,991,0,0
1472,874,706,1068,963,1,11,14,194,257,477,991,0,0
1473,875,705,1068,962,1,11,14,193,257,478,991,0,0
1474,875,705,1068,963,1,11,14,193,258,479,991,0,0
1475,876,705,1068,963,1,11,14,192,258,480,991,0,0
1476,875,706,1069,966,1,11,14,194,260,481,991,0,0
1477,875,706,1070,967,1,11,14,195,261,482,991,0,0
1478,875,706,1070,967,1,11,14,195,261,483,991,0,0
1479,874,707,1069,967,1,11,14,195,260,484,991,0,0
1480,874,707,1069,968,1,11,14,195,261,485,991,0,0
1481,875,705,1070,966,1,11,14,195,261,486,991,0,0
1482,875,702,1072,967,1,11,14,197,265,487,991,0,0
1483,873,700,1072,967,1,11,14,199,267,488,991,0,0
1484,874,698,1074,969,1,11,14,200,271,489,991,0,0
1485,873,697,1072,967,1,11,14,199,270,490,991,0,0
1486,872,696,1072,967,1,11,14,200,271,491,991,0,0
1487,871,696,1071,967,1,11,14,200,271,492,991,0,0
1488,872,696,1071,965,1,11,14,199,269,493,991,0,0
1489,873,697,1071,965,1,11,14,198,268,494,991,0,0
1490,872,698,1070,966,1,11,14,198,268,495,991,0,0
1491,871,698,1070,968,1,11,14,199,270,496,991,0,0
1492,870,698,1070,968,1,11,14,200,270,497,991,0,0
1493,870,698,1070,967,1,11,14,200,269,498,991,0,0
1494,870,698,1070,967,1,11,14,200,269,499,991,0,0
1495,870,698,1070,967,1,11,14,200,269,500,991,0,0
1496,870,699,1070,967,1,11,14,200,268,501,991,0,0
1497,869,699,1070,968,1,11,14,201,269,502,991,0,0
1498,869,699,1070,968,1,11,14,201,269,503,991,0,0
1499,869,699,1070,969,1,11,14,201,270,504,991,0,0
1500,869,699,1070,969,1,11,14,201,270,505,991,0,0
1501,873,700,1073,970,1,11,14,200,270,506,991,0,0
1502,874,701,1073,970,1,11,14,199,269,507,991,0,0
1503,874,701,1074,971,1,11,14,200,270,508,991,0,0
1504,875,700,1074,972,1,11,14,199,272,509,991,0,0
1505,873,700,1073,974,1,11,14,200,274,510,991,0,0
1506,871,700,1071,973,1,11,14,200,273,511,991,0,0
1507,872,701,1071,973,1,11,14,199,272,512,991,0,0
1508,872,703,1068,969,1,11,14,196,266,513,991,0,0
1509,874,704,1069,969,1,11,14,195,265,514,991,0,0
1510,872,700,1070,970,1,11,14,198,270,515,991,0,0
1511,875,702,1073,974,1,11,14,198,272,516,991,0,0
1512,875,703,1074,976,1,11,14,199,273,517,991,0,0
1513,876,703,1073,977,1,11,14,197,274,518,991,0,0
1514,875,704,1072,977,1,11,14,197,273,519,991,0,0
1515,877,704,1072,975,1,11,14,195,271,520,991,0,0
1516,878,703,1071,972,1,11,14,193,269,521,991,0,0
1517,879,703,1070,970,1,11,14,191,267,522,991,0,0
1518,879,703,1070,968,1,11,14,191,265,523,991,0,0
1519,880,703,1070,968,1,11,14,190,265,524,991,0,0
1520,880,704,1070,968,1,11,14,190,264,525,991,0,0
1521,876,704,1069,972,1,11,14,193,268,526,991,0,0
1522,875,704,1067,970,1,11,14,192,266,527,991,0,0
1523,874,704,1067,969,1,11,14,193,265,528,991,0,0
1524,874,703,1069,971,1,11,14,195,268,529,991,0,0
1525,875,703,1071,973,1,11,14,196,270,530,991,0,0
1526,876,703,1070,971,1,11,14,194,268,531,991,0,0
1527,877,705,1069,970,1,11,14,192,265,532,991,0,0
1528,874,703,1067,969,1,11,14,193,266,533,991,0,0
1529,874,705,1066,966,1,11,14,192,261,534,991,0,0
1530,874,705,1066,965,1,11,14,192,260,535,991,0,0
1531,877,705,1066,961,1,11,14,189,256,536,991,0,0
1532,878,705,1067,959,1,11,14,189,254,537,991,0,0
1533,877,705,1067,959,1,11,14,190,254,538,991,0,0
1534,877,705,1067,958,1,11,14,190,253,539,991,0,0
1535,878,705,1066,955,1,11,14,188,250,540,991,0,0
1536,875,705,1068,961,1,11,14,193,256,541,991,0,0
1537,874,705,1069,963,1,11,14,195,258,542,991,0,0
1538,874,705,1069,964,1,11,14,195,259,543,991,0,0
1539,874,705,1070,964,1,11,14,196,259,544,991,0,0
1540,874,705,1070,964,1,11,14,196,259,545,991,0,0
1541,872,705,1069,966,1,11,14,197,261,546,991,0,0
1542,870,705,1070,968,1,11,14,200,263,547,991,0,0
1543,870,705,1069,968,1,11,14,199,263,548,991,0,0
1544,870,705,1069,967,1,11,14,199,262,549,991,0,0
1545,869,705,1069,967,1,11,14,200,262,550,991,0,0
1546,869,704,1069,967,1,11,14,200,263,551,991,0,0
1547,869,704,1070,967,1,11,14,201,263,552,991,0,0
1548,870,704,1070,967,1,11,14,200,263,553,991,0,0
1549,870,703,1070,967,1,11,14,200,264,554,991,0,0
1550,870,703,1070,967,1,11,14,200,264,555,991,0,0
1551,871,705,1070,967,1,11,14,199,262,556,991,0,0
1552,872,705,1071,968,1,11,14,199,263,557,991,0,0
1553,872,705,1072,969,1,11,14,200,264,558,991,0,0
1554,872,705,1072,969,1,11,14,200,264,559,991,0,0
1555,872,705,1071,970,1,11,14,199,265,560,991,0,0
1556,871,706,1070,970,1,11,14,199,264,561,991,0,0
1557,872,706,1070,970,1,11,14,198,264,562,991,0,0
1558,872,707,1070,968,1,11,14,198,261,563,991,0,0
1559,873,707,1070,969,1,11,14,197,262,564,991,0,0
1560,872,707,1069,969,1,11,14,197,262,565,991,0,0
1561,872,707,1069,967,1,11,14,197,260,566,991,0,0
1562,871,706,1069,968,1,11,14,198,262,567,991,0,0
1563,871,706,1069,968,1,11,14,198,262,568,991,0,0
1564,871,706,1069,968,1,11,14,198,262,569,991,0,0
1565,871,707,1069,969,1,11,14,198,262,570,991,0,0
1566,872,707,1071,971,1,11,14,199,264,571,991,0,0
1567,872,707,1071,970,1,11,14,199,263,572,991,0,0
1568,872,706,1073,972,1,11,14,201,266,573,991,0,0
1569,873,706,1073,971,1,11,14,200,265,574,991,0,0
1570,873,708,1071,969,1,11,14,198,261,575,991,0,0
1571,871,702,1071,964,1,11,14,200,262,576,991,0,0
1572,868,696,1073,965,1,11,14,205,269,577,991,0,0
1573,867,695,1072,966,1,11,14,205,271,578,991,0,0
1574,868,696,1071,964,1,11,14,203,268,579,991,0,0
1575,868,702,1067,964,1,11,14,199,262,580,991,0,0
1576,870,707,1064,962,1,11,14,194,255,581,991,0,0
1577,870,707,1066,964,1,11,14,196,257,582,991,0,0
1578,871,707,1067,964,1,11,14,196,257,583,991,0,0
1579,874,706,1069,960,1,11,14,195,254,584,991,0,0
1580,871,708,1066,964,1,11,14,195,256,585,991,0,0
1581,874,707,1068,961,1,11,14,194,254,586,991,0,0
1582,874,707,1068,962,1,11,14,194,255,587,991,0,0
1583,876,710,1068,961,1,11,14,192,251,588,991,0,0
1584,875,708,1067,960,1,11,14,192,252,589,991,0,0
1585,881,708,1067,953,1,11,14,186,245,590,991,0,0
1586,875,708,1065,958,1,11,14,190,250,591,991,0,0
1587,873,708,1064,960,1,11,14,191,252,592,991,0,0
1588,876,709,1066,959,1,11,14,190,250,593,991,0,0
1589,877,709,1068,961,1,11,14,191,252,594,991,0,0
1590,877,709,1069,963,1,11,14,192,254,595,991,0,0
1591,876,708,1071,967,1,11,14,195,259,596,991,0,0
1592,875,709,1070,966,1,11,14,195,257,597,991,0,0
1593,874,709,1070,966,1,11,14,196,257,598,991,0,0
1594,874,710,1070,965,1,11,14,196,255,599,991,0,0
1595,873,710,1071,965,1,11,14,198,255,600,991,0,0
1596,874,710,1071,964,1,11,14,197,254,601,991,0,0
1597,874,709,1072,965,1,11,14,198,256,602,991,0,0
1598,874,708,1073,966,1,11,14,199,258,603,991,0,0
1599,873,707,1072,965,1,11,14,199,258,604,991,0,0
1600,871,704,1072,965,1,11,14,201,261,605,991,0,0
1601,864,704,1067,968,1,11,14,203,264,606,991,0,0
1602,864,697,1071,970,1,11,14,207,273,607,991,0,0
1603,864,704,1064,967,1,11,14,200,263,608,991,0,0
1604,872,729,1057,969,1,11,14,185,240,609,991,0,0
1605,882,760,1048,969,1,11,14,166,209,610,991,0,0
1606,884,762,1047,966,1,11,14,163,204,611,991,0,0
1607,881,747,1059,968,1,11,14,178,221,612,991,0,0
1608,876,739,1061,968,1,11,14,185,229,613,991,0,0
1609,877,754,1055,972,1,11,14,178,218,614,991,0,0
1610,875,765,1050,975,1,11,14,175,210,615,991,0,0
1611,873,771,1048,976,1,11,14,175,205,616,991,0,0
1612,871,770,1048,977,1,11,14,177,207,617,991,0,0
1613,869,768,1048,973,1,11,14,179,205,618,991,0,0
1614,868,770,1050,976,1,11,14,182,206,619,991,0,0
1615,870,771,1055,978,1,11,14,185,207,620,991,0,0
1616,865,765,1058,980,1,11,14,193,215,621,991,0,0
1617,864,766,1059,983,1,11,14,195,217,622,991,0,0
1618,867,767,1062,982,1,11,14,195,215,623,991,0,0
1619,868,767,1063,981,1,11,14,195,214,624,991,0,0
1620,868,768,1063,980,1,11,14,195,212,625,991,0,0
1621,866,765,1064,980,1,11,14,198,215,626,991,0,0
1622,867,767,1064,979,1,11,14,197,212,627,991,0,0
1623,865,765,1064,980,1,11,14,199,215,628,991,0,0
1624,863,764,1064,980,1,11,14,201,216,629,991,0,0
1625,863,763,1064,980,1,11,14,201,217,630,991,0,0
1626,863,766,1061,979,1,11,14,198,213,631,991,0,0
1627,862,767,1061,980,1,11,14,199,213,632,991,0,0
1628,862,768,1061,980,1,11,14,199,212,633,991,0,0
1629,863,764,1064,979,1,11,14,201,215,634,991,0,0
1630,862,766,1063,980,1,11,14,201,214,635,991,0,0
1631,861,763,1063,979,1,11,14,202,216,636,991,0,0
1632,859,757,1065,977,1,11,14,206,220,637,991,0,0
1633,860,761,1063,978,1,11,14,203,217,638,991,0,0
1634,859,760,1061,977,1,11,14,202,217,639,991,0,0
1635,859,762,1061,977,1,11,14,202,215,640,991,0,0
1636,862,764,1061,976,1,11,14,199,212,641,991,0,0
1637,863,764,1061,975,1,11,14,198,211,642,991,0,0
1638,862,766,1059,975,1,11,14,197,209,643,991,0,0
1639,860,766,1061,980,1,11,14,201,214,644,991,0,0
1640,860,767,1061,980,1,11,14,201,213,645,991,0,0
1641,863,768,1064,979,1,11,14,201,211,646,991,0,0
1642,862,768,1064,981,1,11,14,202,213,647,991,0,0
1643,860,769,1066,985,1,11,14,206,216,648,991,0,0
1644,859,769,1065,985,1,11,14,206,216,649,991,0,0
1645,860,770,1066,985,1,11,14,206,215,650,991,0,0
1646,858,770,1064,984,1,11,14,206,214,651,991,0,0
1647,859,770,1066,985,1,11,14,207,215,652,991,0,0
1648,860,770,1067,984,1,11,14,207,214,653,991,0,0
1649,860,770,1067,982,1,11,14,207,212,654,991,0,0
1650,859,769,1065,981,1,11,14,206,212,655,991,0,0
1651,855,765,1066,981,1,11,14,211,216,656,991,0,0
1652,854,760,1066,979,1,11,14,212,219,657,991,0,0
1653,855,762,1067,981,1,11,14,212,219,658,991,0,0
1654,855,760,1067,979,1,11,14,212,219,659,991,0,0
1655,857,762,1067,980,1,11,14,210,218,660,991,0,0
1656,858,762,1068,982,1,11,14,210,220,661,991,0,0
1657,858,762,1067,982,1,11,14,209,220,662,991,0,0
1658,859,762,1067,982,1,11,14,208,220,663,991,0,0
1659,859,762,1067,982,1,11,14,208,220,664,991,0,0
1660,860,762,1066,981,1,11,14,206,219,665,991,0,0
1661,859,762,1064,979,1,11,14,205,217,666,991,0,0
1662,858,762,1064,979,1,11,14,206,217,667,991,0,0
1663,860,761,1065,979,1,11,14,205,218,668,991,0,0
1664,860,761,1065,979,1,11,14,205,218,669,991,0,0
1665,860,763,1065,979,1,11,14,205,216,670,991,0,0
1666,860,765,1061,977,1,11,14,201,212,671,991,0,0
1667,859,764,1064,980,1,11,14,205,216,672,991,0,0
1668,859,766,1061,978,1,11,14,202,212,673,991,0,0
1669,859,764,1063,978,1,11,14,204,214,674,991,0,0
1670,859,763,1065,980,1,11,14,206,217,675,991,0,0
1671,859,764,1063,979,1,11,14,204,215,676,991,0,0
1672,860,763,1065,978,1,11,14,205,215,677,991,0,0
1673,862,764,1064,977,1,11,14,202,213,678,991,0,0
1674,862,764,1065,978,1,11,14,203,214,679,991,0,0
1675,862,764,1064,978,1,11,14,202,214,680,991,0,0
1676,861,763,1064,977,1,11,14,203,214,681,991,0,0
1677,860,765,1062,977,1,11,14,202,212,682,991,0,0
1678,854,763,1067,988,1,11,14,213,225,683,991,0,0
1679,851,763,1068,994,1,11,14,217,231,684,991,0,0
1680,850,762,1071,999,1,11,14,221,237,685,991,0,0
1681,849,760,1070,999,1,11,14,221,239,686,991,0,0
1682,849,759,1070,999,1,11,14,221,240,687,991,0,0
1683,849,762,1070,1003,1,11,14,221,241,688,991,0,0
1684,850,763,1070,1004,1,11,14,220,241,689,991,0,0
1685,850,763,1070,1004,1,11,14,220,241,690,991,0,0
1686,852,761,1067,998,1,11,14,215,237,691,991,0,0
1687,852,763,1066,999,1,11,14,214,236,692,991,0,0
1688,853,760,1066,997,1,11,14,213,237,693,991,0,0
1689,854,762,1067,999,1,11,14,213,237,694,991,0,0
1690,861,762,1062,985,1,11,14,201,223,695,991,0,0
1691,865,760,1062,977,1,11,14,197,217,696,991,0,0
1692,864,762,1060,978,1,11,14,196,216,697,991,0,0
1693,862,762,1060,978,1,11,14,198,216,698,991,0,0
1694,861,764,1059,981,1,11,14,198,217,699,991,0,0
1695,862,765,1060,981,1,11,14,198,216,700,991,0,0
1696,861,764,1063,983,1,11,14,202,219,701,991,0,0
1697,860,763,1064,984,1,11,14,204,221,702,991,0,0
1698,860,763,1064,984,1,11,14,204,221,703,991,0,0
1699,857,763,1066,990,1,11,14,209,227,704,991,0,0
1700,853,761,1068,995,1,11,14,215,234,705,991,0,0
1701,853,761,1068,996,1,11,14,215,235,706,991,0,0
1702,852,759,1068,997,1,11,14,216,238,707,991,0,0
1703,854,759,1069,997,1,11,14,215,238,708,991,0,0
1704,855,763,1067,999,1,11,14,212,236,709,991,0,0
1705,855,763,1067,1000,1,11,14,212,237,710,991,0,0
1706,856,761,1067,995,1,11,14,211,234,711,991,0,0
1707,861,762,1066,990,1,11,14,205,228,712,991,0,0
1708,862,764,1064,987,1,11,14,202,223,713,991,0,0
1709,862,763,1062,985,1,11,14,200,222,714,991,0,0
1710,862,765,1061,984,1,11,14,199,219,715,991,0,0
1711,859,765,1064,990,1,11,14,205,225,716,991,0,0
1712,855,763,1068,998,1,11,14,213,235,717,991,0,0
1713,855,760,1067,995,1,11,14,212,235,718,991,0,0
1714,854,760,1065,993,1,11,14,211,233,719,991,0,0
1715,854,759,1064,992,1,11,14,210,233,720,991,0,0
1716,852,758,1065,996,1,11,14,213,238,721,991,0,0
1717,853,757,1066,997,1,11,14,213,240,722,991,0,0
1718,858,760,1065,991,1,11,14,207,231,723,991,0,0
1719,860,762,1062,987,1,11,14,202,225,724,991,0,0
1720,860,762,1061,984,1,11,14,201,222,725,991,0,0
1721,860,762,1062,986,1,11,14,202,224,726,991,0,0
1722,861,761,1060,979,1,11,14,199,218,727,991,0,0
1723,862,760,1059,976,1,11,14,197,216,728,991,0,0
1724,858,761,1062,984,1,11,14,204,223,729,991,0,0
1725,858,762,1065,989,1,11,14,207,227,730,991,0,0
1726,857,760,1065,987,1,11,14,208,227,731,991,0,0
1727,857,763,1065,990,1,11,14,208,227,732,991,0,0
1728,857,761,1067,990,1,11,14,210,229,733,991,0,0
1729,857,760,1068,991,1,11,14,211,231,734,991,0,0
1730,857,760,1068,991,1,11,14,211,231,735,991,0,0
1731,860,761,1069,991,1,11,14,209,230,736,991,0,0
1732,860,762,1069,991,1,11,14,209,229,737,991,0,0
1733,858,762,1068,990,1,11,14,210,228,738,991,0,0
1734,860,762,1069,990,1,11,14,209,228,739,991,0,0
1735,860,762,1069,990,1,11,14,209,228,740,991,0,0
1736,858,762,1065,989,1,11,14,207,227,741,991,0,0
1737,856,758,1065,987,1,11,14,209,229,742,991,0,0
1738,856,758,1065,986,1,11,14,209,228,743,991,0,0
1739,856,757,1065,986,1,11,14,209,229,744,991,0,0
1740,856,756,1066,986,1,11,14,210,230,745,991,0,0
1741,854,761,1067,994,1,11,14,213,233,746,991,0,0
1742,852,762,1070,1004,1,11,14,218,242,747,991,0,0
1743,851,762,1071,1008,1,11,14,220,246,748,991,0,0
1744,851,763,1071,1010,1,11,14,220,247,749,991,0,0
1745,852,763,1071,1009,1,11,14,219,246,750,991,0,0
1746,852,760,1069,1006,1,11,14,217,246,751,991,0,0
1747,852,758,1068,1004,1,11,14,216,246,752,991,0,0
1748,852,758,1068,1004,1,11,14,216,246,753,991,0,0
1749,855,757,1065,997,1,11,14,210,240,754,991,0,0
1750,857,757,1064,992,1,11,14,207,235,755,991,0,0
1751,859,757,1063,989,1,11,14,204,232,756,991,0,0
1752,860,757,1064,989,1,11,14,204,232,757,991,0,0
1753,859,757,1064,988,1,11,14,205,231,758,991,0,0
1754,860,760,1064,990,1,11,14,204,230,759,991,0,0
1755,859,758,1064,989,1,11,14,205,231,760,991,0,0
1756,860,762,1063,990,1,11,14,203,228,761,991,0,0
1757,859,763,1063,991,1,11,14,204,228,762,991,0,0
1758,859,760,1064,989,1,11,14,205,229,763,991,0,0
1759,861,761,1065,990,1,11,14,204,229,764,991,0,0
1760,861,762,1066,990,1,11,14,205,228,765,991,0,0
1761,858,758,1065,989,1,11,14,207,231,766,991,0,0
1762,856,756,1065,989,1,11,14,209,233,767,991,0,0
1763,856,756,1064,988,1,11,14,208,232,768,991,0,0
1764,856,755,1064,988,1,11,14,208,233,769,991,0,0
1765,856,755,1064,988,1,11,14,208,233,770,991,0,0
1766,858,759,1064,989,1,11,14,206,230,771,991,0,0
1767,857,758,1063,988,1,11,14,206,230,772,991,0,0
1768,856,758,1063,988,1,11,14,207,230,773,991,0,0
1769,857,758,1063,987,1,11,14,206,229,774,991,0,0
1770,857,757,1063,987,1,11,14,206,230,775,991,0,0
1771,857,761,1064,991,1,11,14,207,230,776,991,0,0
1772,857,759,1064,990,1,11,14,207,231,777,991,0,0
1773,858,762,1064,991,1,11,14,206,229,778,991,0,0
1774,860,762,1064,989,1,11,14,204,227,779,991,0,0
1775,861,762,1064,988,1,11,14,203,226,780,991,0,0
1776,859,762,1065,991,1,11,14,206,229,781,991,0,0
1777,860,762,1066,990,1,11,14,206,228,782,991,0,0
1778,858,762,1067,993,1,11,14,209,231,783,991,0,0
1779,858,762,1067,993,1,11,14,209,231,784,991,0,0
1780,858,762,1067,994,1,11,14,209,232,785,991,0,0
1781,857,759,1066,991,1,11,14,209,232,786,991,0,0
1782,858,759,1066,991,1,11,14,208,232,787,991,0,0
1783,857,759,1066,992,1,11,14,209,233,788,991,0,0
1784,857,759,1066,992,1,11,14,209,233,789,991,0,0
1785,857,758,1066,992,1,11,14,209,234,790,991,0,0
1786,857,757,1065,988,1,11,14,208,231,791,991,0,0
1787,858,757,1064,987,1,11,14,206,230,792,991,0,0
1788,859,760,1065,989,1,11,14,206,229,793,991,0,0
1789,858,762,1064,991,1,11,14,206,229,794,991,0,0
1790,858,759,1064,988,1,11,14,206,229,795,991,0,0
1791,857,760,1066,993,1,11,14,209,233,796,991,0,0
1792,857,760,1066,993,1,11,14,209,233,797,991,0,0
1793,857,759,1067,994,1,11,14,210,235,798,991,0,0
1794,858,759,1067,993,1,11,14,209,234,799,991,0,0
1795,858,759,1066,993,1,11,14,208,234,800,991,0,0
1796,857,760,1063,991,1,11,14,206,231,801,991,0,0
1797,856,759,1063,991,1,11,14,207,232,802,991,0,0
1798,856,760,1062,990,1,11,14,206,230,803,991,0,0
1799,858,758,1062,986,1,11,14,204,228,804,991,0,0
1800,858,757,1062,985,1,11,14,204,228,805,991,0,0
1801,858,757,1063,985,1,11,14,205,228,806,991,0,0
1802,858,757,1063,984,1,11,14,205,227,807,991,0,0
1803,860,760,1064,986,1,11,14,204,226,808,991,0,0
1804,859,758,1064,985,1,11,14,205,227,809,991,0,0
1805,858,756,1065,985,1,11,14,207,229,810,991,0,0
1806,859,757,1064,983,1,11,14,205,226,811,991,0,0
1807,858,757,1063,983,1,11,14,205,226,812,991,0,0
1808,859,757,1063,982,1,11,14,204,225,813,991,0,0
1809,858,761,1062,986,1,11,14,204,225,814,991,0,0
1810,859,759,1063,984,1,11,14,204,225,815,991,0,0
1811,860,761,1064,986,1,11,14,204,225,816,991,0,0
1812,860,762,1064,986,1,11,14,204,224,817,991,0,0
1813,861,762,1065,987,1,11,14,204,225,818,991,0,0
1814,861,763,1063,985,1,11,14,202,222,819,991,0,0
1815,860,762,1063,986,1,11,14,203,224,820,991,0,0
1816,858,759,1063,985,1,11,14,205,226,821,991,0,0
1817,857,761,1063,987,1,11,14,206,226,822,991,0,0
1818,858,758,1062,981,1,11,14,204,223,823,991,0,0
1819,859,760,1061,981,1,11,14,202,221,824,991,0,0
1820,860,762,1061,981,1,11,14,201,219,825,991,0,0
1821,860,762,1061,982,1,11,14,201,220,826,991,0,0
1822,859,763,1062,983,1,11,14,203,220,827,991,0,0
1823,859,762,1062,983,1,11,14,203,221,828,991,0,0
1824,858,762,1063,984,1,11,14,205,222,829,991,0,0
1825,857,762,1064,987,1,11,14,207,225,830,991,0,0
1826,856,762,1064,987,1,11,14,208,225,831,991,0,0
1827,854,759,1066,988,1,11,14,212,229,832,991,0,0
1828,854,760,1065,988,1,11,14,211,228,833,991,0,0
1829,855,760,1064,988,1,11,14,209,228,834,991,0,0
1830,855,760,1064,988,1,11,14,209,228,835,991,0,0
1831,855,758,1065,986,1,11,14,210,228,836,991,0,0
1832,856,761,1064,987,1,11,14,208,226,837,991,0,0
1833,855,758,1065,985,1,11,14,210,227,838,991,0,0
1834,855,758,1065,985,1,11,14,210,227,839,991,0,0
1835,855,757,1065,985,1,11,14,210,228,840,991,0,0
1836,856,757,1064,982,1,11,14,208,225,841,991,0,0
1837,859,761,1065,984,1,11,14,206,223,842,991,0,0
1838,861,762,1065,983,1,11,14,204,221,843,991,0,0
1839,859,758,1065,981,1,11,14,206,223,844,991,0,0
1840,859,760,1064,980,1,11,14,205,220,845,991,0,0
1841,858,762,1061,980,1,11,14,203,218,846,991,0,0
1842,858,762,1064,983,1,11,14,206,221,847,991,0,0
1843,857,762,1064,985,1,11,14,207,223,848,991,0,0
1844,857,761,1065,985,1,11,14,208,224,849,991,0,0
1845,857,761,1065,985,1,11,14,208,224,850,991,0,0
1846,857,761,1065,987,1,11,14,208,226,851,991,0,0
1847,857,762,1065,988,1,11,14,208,226,852,991,0,0
1848,857,762,1065,988,1,11,14,208,226,853,991,0,0
1849,857,762,1065,988,1,11,14,208,226,854,991,0,0
1850,860,762,1067,986,1,11,14,207,224,855,991,0,0
1851,859,762,1065,986,1,11,14,206,224,856,991,0,0
1852,858,762,1065,987,1,11,14,207,225,857,991,0,0
1853,858,762,1064,986,1,11,14,206,224,858,991,0,0
1854,858,762,1064,986,1,11,14,206,224,859,991,0,0
1855,858,762,1064,986,1,11,14,206,224,860,991,0,0
1856,857,760,1064,984,1,11,14,207,224,861,991,0,0
1857,857,759,1064,984,1,11,14,207,225,862,991,0,0
1858,856,759,1064,983,1,11,14,208,224,863,991,0,0
1859,856,758,1064,983,1,11,14,208,225,864,991,0,0
1860,857,758,1063,983,1,11,14,206,225,865,991,0,0
1861,860,761,1066,985,1,11,14,206,224,866,991,0,0
1862,859,763,1064,985,1,11,14,205,222,867,991,0,0
1863,859,763,1064,986,1,11,14,205,223,868,991,0,0
1864,861,763,1067,986,1,11,14,206,223,869,991,0,0
1865,859,761,1068,988,1,11,14,209,227,870,991,0,0
1866,859,761,1066,986,1,11,14,207,225,871,991,0,0
1867,860,760,1064,982,1,11,14,204,222,872,991,0,0
1868,860,760,1066,983,1,11,14,206,223,873,991,0,0
1869,859,760,1067,984,1,11,14,208,224,874,991,0,0
1870,859,762,1065,984,1,11,14,206,222,875,991,0,0
1871,858,758,1067,984,1,11,14,209,226,876,991,0,0
1872,857,760,1067,987,1,11,14,210,227,877,991,0,0
1873,857,761,1067,988,1,11,14,210,227,878,991,0,0
1874,860,761,1069,987,1,11,14,209,226,879,991,0,0
1875,859,761,1068,988,1,11,14,209,227,880,991,0,0
1876,859,762,1067,987,1,11,14,208,225,881,991,0,0
1877,859,760,1067,987,1,11,14,208,227,882,991,0,0
1878,859,761,1066,987,1,11,14,207,226,883,991,0,0
1879,861,761,1067,987,1,11,14,206,226,884,991,0,0
1880,859,758,1065,984,1,11,14,206,226,885,991,0,0
1881,858,762,1062,985,1,11,14,204,223,886,991,0,0
1882,858,762,1062,985,1,11,14,204,223,887,991,0,0
1883,861,762,1060,980,1,11,14,199,218,888,991,0,0
1884,861,762,1060,979,1,11,14,199,217,889,991,0,0
1885,862,763,1058,976,1,11,14,196,213,890,991,0,0
1886,863,763,1061,979,1,11,14,198,216,891,991,0,0
1887,862,763,1062,979,1,11,14,200,216,892,991,0,0
1888,861,764,1063,982,1,11,14,202,218,893,991,0,0
1889,861,763,1065,984,1,11,14,204,221,894,991,0,0
1890,862,763,1060,975,1,11,14,198,212,895,991,0,0
1891,865,763,1057,967,1,11,14,192,204,896,991,0,0
1892,869,767,1054,961,1,11,14,185,194,897,991,0,0
1893,867,765,1053,959,1,11,14,186,194,898,991,0,0
1894,867,766,1052,957,1,11,14,185,191,899,991,0,0
1895,870,770,1054,956,1,11,14,184,186,900,991,0,0
1896,870,771,1061,963,1,11,14,191,192,901,991,0,0
1897,865,767,1065,968,1,11,14,200,201,902,991,0,0
1899,857,762,1066,972,1,11,14,209,210,0,991,0,0
1901,859,763,1067,972,1,11,14,208,209,0,991,0,1
1902,860,764,1067,973,1,11,14,207,209,1,991,0,0
1903,860,762,1069,973,1,11,14,209,211,2,991,0,0
1904,863,763,1070,972,1,11,14,207,209,3,991,0,0
1905,861,761,1069,973,1,11,14,208,212,4,991,0,0
1906,861,762,1069,975,1,11,14,208,213,5,991,0,0
1907,862,762,1070,975,1,11,14,208,213,6,991,0,0
1908,843,766,1033,967,1,11,14,190,201,7,991,0,0
1909,792,737,1077,1043,1,11,14,285,306,8,991,0,0
1910,842,752,1088,1023,1,11,14,246,271,9,991,0,0
1911,859,759,1075,997,1,11,14,216,238,10,991,0,0
1912,866,760,1070,984,1,11,14,204,224,11,991,0,0
1913,868,760,1068,980,1,11,14,200,220,12,991,0,0
1914,863,757,1069,983,1,11,14,206,226,13,991,0,0
1915,862,753,1067,979,1,11,14,205,226,14,991,0,0
1916,864,753,1069,977,1,11,14,205,224,15,991,0,0
1917,866,754,1068,976,1,11,14,202,222,16,991,0,0
1918,867,757,1067,976,1,11,14,200,219,17,991,0,0
1919,867,758,1066,975,1,11,14,199,217,18,991,0,0
1920,869,759,1066,973,1,11,14,197,214,19,991,0,0
1921,868,758,1067,973,1,11,14,199,215,20,991,0,0
1922,867,758,1067,973,1,11,14,200,215,21,991,0,0
1923,867,758,1067,973,1,11,14,200,215,22,991,0,0
1924,866,758,1067,974,1,11,14,201,216,23,991,0,0
1925,866,758,1067,974,1,11,14,201,216,24,991,0,0
1926,864,758,1067,975,1,11,14,203,217,25,991,0,0
1927,864,758,1067,975,1,11,14,203,217,26,991,0,0
1928,864,757,1067,976,1,11,14,203,219,27,991,0,0
1929,864,757,1067,976,1,11,14,203,219,28,991,0,0
1930,864,757,1067,976,1,11,14,203,219,29,991,0,0
1931,864,757,1067,975,1,11,14,203,218,30,991,0,0
1932,861,755,1068,978,1,11,14,207,223,31,991,0,0
1933,856,754,1068,983,1,11,14,212,229,32,991,0,0
1934,854,754,1067,985,1,11,14,213,231,33,991,0,0
1935,852,756,1066,989,1,11,14,214,233,34,991,0,0
1936,853,755,1063,986,1,11,14,210,231,35,991,0,0
1937,854,756,1062,984,1,11,14,208,228,36,991,0,0
1938,856,756,1061,981,1,11,14,205,225,37,991,0,0
1939,852,756,1066,994,1,11,14,214,238,38,991,0,0
1940,851,756,1068,999,1,11,14,217,243,39,991,0,0
1941,853,758,1067,999,1,11,14,214,241,40,991,0,0
1942,854,758,1068,1001,1,11,14,214,243,41,991,0,0
1943,854,760,1067,1002,1,11,14,213,242,42,991,0,0
1944,855,758,1067,1001,1,11,14,212,243,43,991,0,0
1945,855,761,1065,1002,1,11,14,210,241,44,991,0,0
1946,856,760,1067,1003,1,11,14,211,243,45,991,0,0
1947,856,759,1067,1003,1,11,14,211,244,46,991,0,0
1948,857,759,1068,1004,1,11,14,211,245,47,991,0,0
1949,857,759,1068,1004,1,11,14,211,245,48,991,0,0
1950,855,759,1064,1003,1,11,14,209,244,49,991,0,0
1951,856,762,1064,1006,1,11,14,208,244,50,991,0,0
1952,857,763,1064,1005,1,11,14,207,242,51,991,0,0
1953,856,764,1062,1007,1,11,14,206,243,52,991,0,0
1954,857,763,1062,1004,1,11,14,205,241,53,991,0,0
1955,857,760,1062,1001,1,11,14,205,241,54,991,0,0
1956,857,762,1062,1003,1,11,14,205,241,55,991,0,0
1957,858,760,1063,1000,1,11,14,205,240,56,991,0,0
1958,858,763,1062,1003,1,11,14,204,240,57,991,0,0
1959,860,763,1064,1005,1,11,14,204,242,58,991,0,0
1960,863,765,1063,1000,1,11,14,200,235,59,991,0,0
1961,861,762,1065,1002,1,11,14,204,240,60,991,0,0
1962,860,760,1066,1003,1,11,14,206,243,61,991,0,0
1963,861,761,1065,1002,1,11,14,204,241,62,991,0,0
1964,860,760,1065,1002,1,11,14,205,242,63,991,0,0
1965,860,759,1066,1003,1,11,14,206,244,64,991,0,0
1966,859,758,1064,1002,1,11,14,205,244,65,991,0,0
1967,859,758,1064,1002,1,11,14,205,244,66,991,0,0
1968,860,760,1062,1001,1,11,14,202,241,67,991,0,0
1969,860,761,1062,1002,1,11,14,202,241,68,991,0,0
1970,859,759,1063,1002,1,11,14,204,243,69,991,0,0
1971,860,758,1063,1001,1,11,14,203,243,70,991,0,0
1972,862,760,1062,998,1,11,14,200,238,71,991,0,0
1973,864,758,1062,994,1,11,14,198,236,72,991,0,0
1974,865,761,1061,993,1,11,14,196,232,73,991,0,0
1975,866,760,1061,990,1,11,14,195,230,74,991,0,0
1976,869,760,1060,983,1,11,14,191,223,75,991,0,0
1977,871,760,1060,979,1,11,14,189,219,76,991,0,0
1978,870,762,1059,978,1,11,14,189,216,77,991,0,0
1979,871,762,1060,977,1,11,14,189,215,78,991,0,0
1980,868,758,1061,976,1,11,14,193,218,79,991,0,0
1981,867,761,1060,978,1,11,14,193,217,80,991,0,0
1982,866,762,1061,980,1,11,14,195,218,81,991,0,0
1983,866,762,1060,979,1,11,14,194,217,82,991,0,0
1984,867,761,1063,978,1,11,14,196,217,83,991,0,0
1985,866,762,1063,979,1,11,14,197,217,84,991,0,0
1986,864,760,1063,978,1,11,14,199,218,85,991,0,0
1987,865,760,1063,977,1,11,14,198,217,86,991,0,0
1988,863,760,1063,978,1,11,14,200,218,87,991,0,0
1989,862,762,1063,980,1,11,14,201,218,88,991,0,0
1990,863,760,1064,977,1,11,14,201,217,89,991,0,0
1991,864,761,1065,978,1,11,14,201,217,90,991,0,0
1992,862,760,1067,980,1,11,14,205,220,91,991,0,0
1993,863,762,1066,979,1,11,14,203,217,92,991,0,0
1994,861,763,1066,983,1,11,14,205,220,93,991,0,0
1995,859,763,1057,976,1,11,14,198,213,94,991,0,0
1996,852,760,1066,992,1,11,14,214,232,95,991,0,0
1997,849,759,1071,1002,1,11,14,222,243,96,991,0,0
1998,847,756,1073,1005,1,11,14,226,249,97,991,0,0
1999,845,755,1073,1008,1,11,14,228,253,98,991,0,0
2000,845,755,1072,1010,1,11,14,227,255,99,991,0,0
2001,848,755,1072,1009,1,11,14,224,254,100,991,0,0
2002,850,756,1071,1008,1,11,14,221,252,101,991,0,0
2003,850,758,1072,1014,1,11,14,222,256,102,991,0,0
2004,851,757,1072,1012,1,11,14,221,255,103,991,0,0
2005,852,757,1071,1011,1,11,14,219,254,104,991,0,0
2006,853,758,1069,1009,1,11,14,216,251,105,991,0,0
2007,853,758,1068,1008,1,11,14,215,250,106,991,0,0
2008,853,758,1067,1008,1,11,14,214,250,107,991,0,0
2009,854,757,1067,1009,1,11,14,213,252,108,991,0,0
2010,854,757,1067,1009,1,11,14,213,252,109,991,0,0
2011,854,757,1067,1008,1,11,14,213,251,110,991,0,0
2012,854,759,1067,1013,1,11,14,213,254,111,991,0,0
2013,854,759,1068,1014,1,11,14,214,255,112,991,0,0
2014,855,760,1068,1015,1,11,14,213,255,113,991,0,0
2015,855,760,1068,1015,1,11,14,213,255,114,991,0,0
2016,855,760,1068,1016,1,11,14,213,256,115,991,0,0
2017,855,760,1068,1016,1,11,14,213,256,116,991,0,0
2018,855,761,1067,1015,1,11,14,212,254,117,991,0,0
2019,856,761,1067,1015,1,11,14,211,254,118,991,0,0
2020,855,761,1067,1016,1,11,14,212,255,119,991,0,0
2021,855,761,1066,1016,1,11,14,211,255,120,991,0,0
2022,855,758,1064,1012,1,11,14,209,254,121,991,0,0
2023,856,757,1064,1010,1,11,14,208,253,122,991,0,0
2024,858,761,1062,1007,1,11,14,204,246,123,991,0,0
2025,858,759,1060,1004,1,11,14,202,245,124,991,0,0
2026,861,758,1057,995,1,11,14,196,237,125,991,0,0
2027,863,762,1059,997,1,11,14,196,235,126,991,0,0
2028,861,760,1061,998,1,11,14,200,238,127,991,0,0
2029,861,759,1062,998,1,11,14,201,239,128,991,0,0
2030,860,759,1062,999,1,11,14,202,240,129,991,0,0
2031,857,758,1063,1002,1,11,14,206,244,130,991,0,0
2032,857,758,1063,1003,1,11,14,206,245,131,991,0,0
2033,856,758,1063,1005,1,11,14,207,247,132,991,0,0
2034,855,758,1062,1005,1,11,14,207,247,133,991,0,0
2035,859,761,1060,1001,1,11,14,201,240,134,991,0,0
2036,860,758,1061,997,1,11,14,201,239,135,991,0,0
2037,861,757,1060,995,1,11,14,199,238,136,991,0,0
2038,861,757,1060,994,1,11,14,199,237,137,991,0,0
2039,860,756,1060,995,1,11,14,200,239,138,991,0,0
2040,860,756,1059,993,1,11,14,199,237,139,991,0,0
2041,858,759,1061,1001,1,11,14,203,242,140,991,0,0
2042,856,758,1062,1003,1,11,14,206,245,141,991,0,0
2043,856,760,1062,1005,1,11,14,206,245,142,991,0,0
2044,857,761,1061,1004,1,11,14,204,243,143,991,0,0
2045,857,761,1061,1005,1,11,14,204,244,144,991,0,0
2046,857,758,1060,1000,1,11,14,203,242,145,991,0,0
2047,857,757,1059,998,1,11,14,202,241,146,991,0,0
2048,857,757,1059,998,1,11,14,202,241,147,991,0,0
2049,855,757,1059,1002,1,11,14,204,245,148,991,0,0
2050,856,757,1059,1000,1,11,14,203,243,149,991,0,0
2051,858,759,1059,1000,1,11,14,201,241,150,991,0,0
2052,860,762,1061,1003,1,11,14,201,241,151,991,0,0
2053,858,764,1058,1003,1,11,14,200,239,152,991,0,0
2054,857,760,1060,1004,1,11,14,203,244,153,991,0,0
2055,858,761,1062,1006,1,11,14,204,245,154,991,0,0
2056,858,759,1061,1002,1,11,14,203,243,155,991,0,0
2057,858,758,1061,1002,1,11,14,203,244,156,991,0,0
2058,857,758,1061,1003,1,11,14,204,245,157,991,0,0
2059,858,758,1061,1003,1,11,14,203,245,158,991,0,0
2060,858,759,1061,1003,1,11,14,203,244,159,991,0,0
2061,858,759,1059,999,1,11,14,201,240,160,991,0,0
2062,858,759,1060,1001,1,11,14,202,242,161,991,0,0
2063,858,759,1060,1001,1,11,14,202,242,162,991,0,0
2064,860,759,1059,995,1,11,14,199,236,163,991,0,0
2065,862,759,1057,990,1,11,14,195,231,164,991,0,0
2066,863,758,1058,988,1,11,14,195,230,165,991,0,0
2067,860,760,1061,997,1,11,14,201,237,166,991,0,0
2068,858,759,1062,1000,1,11,14,204,241,167,991,0,0
2069,860,762,1062,999,1,11,14,202,237,168,991,0,0
2070,857,763,1063,1005,1,11,14,206,242,169,991,0,0
2071,855,759,1064,1005,1,11,14,209,246,170,991,0,0
2072,854,757,1064,1005,1,11,14,210,248,171,991,0,0
2073,854,757,1065,1007,1,11,14,211,250,172,991,0,0
2074,854,756,1065,1007,1,11,14,211,251,173,991,0,0
2075,854,756,1065,1007,1,11,14,211,251,174,991,0,0
2076,854,760,1065,1011,1,11,14,211,251,175,991,0,0
2077,854,761,1064,1012,1,11,14,210,251,176,991,0,0
2078,853,761,1064,1013,1,11,14,211,252,177,991,0,0
2079,853,760,1062,1009,1,11,14,209,249,178,991,0,0
2080,855,758,1062,1005,1,11,14,207,247,179,991,0,0
2081,865,758,1056,982,1,11,14,191,224,180,991,0,0
2082,870,753,1054,967,1,11,14,184,214,181,991,0,0
2083,871,750,1055,962,1,11,14,184,212,182,991,0,0
2084,870,752,1055,962,1,11,14,185,210,183,991,0,0
2085,869,753,1054,961,1,11,14,185,208,184,991,0,0
2086,870,755,1055,960,1,11,14,185,205,185,991,0,0
2087,871,760,1054,959,1,11,14,183,199,186,991,0,0
2088,869,759,1052,958,1,11,14,183,199,187,991,0,0
2089,870,758,1057,959,1,11,14,187,201,188,991,0,0
2090,868,762,1061,968,1,11,14,193,206,189,991,0,0
2091,871,765,1060,965,1,11,14,189,200,190,991,0,0
2092,873,764,1062,962,1,11,14,189,198,191,991,0,0
2093,870,767,1062,965,1,11,14,192,198,192,991,0,0
2094,869,768,1063,967,1,11,14,194,199,193,991,0,0
2095,869,768,1063,967,1,11,14,194,199,194,991,0,0
2096,867,766,1064,967,1,11,14,197,201,195,991,0,0
2097,865,765,1064,967,1,11,14,199,202,196,991,0,0
2098,863,765,1065,969,1,11,14,202,204,197,991,0,0
2100,860,762,1067,971,1,11,14,207,209,0,991,0,0
2101,863,763,1069,970,1,11,14,206,207,1,991,0,0
2103,864,763,1070,970,1,11,14,206,207,0,991,0,0
2117,856,761,1071,977,1,11,14,215,216,0,991,0,0
2122,855,760,1072,978,1,11,14,217,218,0,991,0,1
2123,855,760,1072,979,1,11,14,217,219,1,991,0,0
2124,855,760,1072,979,1,11,14,217,219,2,991,0,0
2125,855,760,1072,979,1,11,14,217,219,3,991,0,0
2126,858,763,1069,976,1,11,14,211,213,4,991,0,0
2127,860,764,1070,975,1,11,14,210,211,5,991,0,0
2128,861,762,1071,973,1,11,14,210,211,6,991,0,0
2129,861,763,1070,973,1,11,14,209,210,7,991,0,0
2130,861,763,1070,973,1,11,14,209,210,8,991,0,0
2131,856,760,1071,976,1,11,14,215,216,9,991,0,0
2132,854,759,1070,977,1,11,14,216,218,10,991,0,0
2133,856,760,1069,976,1,11,14,213,216,11,991,0,0
2134,857,760,1069,976,1,11,14,212,216,12,991,0,0
2135,856,760,1069,977,1,11,14,213,217,13,991,0,0
2136,857,760,1069,976,1,11,14,212,216,14,991,0,0
2137,862,762,1070,974,1,11,14,208,212,15,991,0,0
2138,863,762,1070,973,1,11,14,207,211,16,991,0,0
2139,864,762,1070,973,1,11,14,206,211,17,991,0,0
2140,864,763,1071,974,1,11,14,207,211,18,991,0,0
2141,862,764,1069,975,1,11,14,207,211,19,991,0,0
2142,861,764,1069,976,1,11,14,208,212,20,991,0,0
2143,861,765,1069,976,1,11,14,208,211,21,991,0,0
2144,861,765,1069,976,1,11,14,208,211,22,991,0,0
2145,860,765,1069,976,1,11,14,209,211,23,991,0,0
2146,860,765,1071,978,1,11,14,211,213,24,991,0,0
2147,859,765,1071,978,1,11,14,212,213,25,991,0,0
2148,859,763,1073,979,1,11,14,214,216,26,991,0,0
2149,859,763,1072,979,1,11,14,213,216,27,991,0,0
2150,859,763,1072,979,1,11,14,213,216,28,991,0,0
2151,860,764,1070,977,1,11,14,210,213,29,991,0,0
2152,860,764,1070,977,1,11,14,210,213,30,991,0,0
2153,861,765,1069,976,1,11,14,208,211,31,991,0,0
2154,861,764,1071,977,1,11,14,210,213,32,991,0,0
2155,860,764,1070,977,1,11,14,210,213,33,991,0,0
2156,861,764,1070,976,1,11,14,209,212,34,991,0,0
2157,861,763,1072,976,1,11,14,211,213,35,991,0,0
2158,855,761,1074,985,1,11,14,219,224,36,991,0,0
2159,852,757,1073,984,1,11,14,221,227,37,991,0,0
2160,852,757,1065,977,1,11,14,213,220,38,991,0,0
2161,853,756,1063,973,1,11,14,210,217,39,991,0,0
2162,854,759,1067,981,1,11,14,213,222,40,991,0,0
2163,856,761,1072,987,1,11,14,216,226,41,991,0,0
2164,855,763,1071,990,1,11,14,216,227,42,991,0,0
2165,855,763,1070,990,1,11,14,215,227,43,991,0,0
2166,858,762,1070,986,1,11,14,212,224,44,991,0,0
2167,861,762,1072,986,1,11,14,211,224,45,991,0,0
2168,858,762,1070,987,1,11,14,212,225,46,991,0,0
2169,861,762,1072,986,1,11,14,211,224,47,991,0,0
2170,862,762,1072,986,1,11,14,210,224,48,991,0,0
2171,860,763,1071,987,1,11,14,211,224,49,991,0,0
2172,859,763,1070,988,1,11,14,211,225,50,991,0,0
2173,859,763,1070,988,1,11,14,211,225,51,991,0,0
2174,859,763,1069,987,1,11,14,210,224,52,991,0,0
2175,857,761,1069,988,1,11,14,212,227,53,991,0,0
2176,858,760,1071,989,1,11,14,213,229,54,991,0,0
2177,858,762,1071,991,1,11,14,213,229,55,991,0,0
2178,858,762,1070,991,1,11,14,212,229,56,991,0,0
2179,856,760,1069,990,1,11,14,213,230,57,991,0,0
2180,857,761,1070,991,1,11,14,213,230,58,991,0,0
2181,857,761,1067,987,1,11,14,210,226,59,991,0,0
2182,855,753,1071,987,1,11,14,216,234,60,991,0,0
2183,853,741,1077,987,1,11,14,224,246,61,991,0,0
2184,852,736,1078,986,1,11,14,226,250,62,991,0,0
2185,853,736,1077,986,1,11,14,224,250,63,991,0,0
2186,856,745,1071,985,1,11,14,215,240,64,991,0,0
2187,863,749,1072,982,1,11,14,209,233,65,991,0,0
2188,861,747,1074,986,1,11,14,213,239,66,991,0,0
2189,862,747,1074,986,1,11,14,212,239,67,991,0,0
2190,864,750,1072,984,1,11,14,208,234,68,991,0,0
2191,861,752,1069,985,1,11,14,208,233,69,991,0,0
2192,863,753,1070,984,1,11,14,207,231,70,991,0,0
2193,863,756,1071,988,1,11,14,208,232,71,991,0,0
2194,863,756,1071,988,1,11,14,208,232,72,991,0,0
2195,863,758,1068,987,1,11,14,205,229,73,991,0,0
2196,864,757,1071,989,1,11,14,207,232,74,991,0,0
2197,864,758,1071,989,1,11,14,207,231,75,991,0,0
2198,862,757,1071,992,1,11,14,209,235,76,991,0,0
2199,861,757,1071,994,1,11,14,210,237,77,991,0,0
2200,862,756,1076,999,1,11,14,214,243,78,991,0,0
2201,862,756,1077,1000,1,11,14,215,244,79,991,0,0
2203,869,762,1070,988,1,11,14,201,226,0,991,0,1
2204,865,758,1070,988,1,11,14,205,230,1,991,0,0
2205,864,757,1069,987,1,11,14,205,230,2,991,0,0
2206,863,759,1068,989,1,11,14,205,230,3,991,0,0
2207,863,760,1066,987,1,11,14,203,227,4,991,0,0
2208,863,760,1065,986,1,11,14,202,226,5,991,0,0
2209,862,760,1065,986,1,11,14,203,226,6,991,0,0
2210,862,760,1066,986,1,11,14,204,226,7,991,0,0
2211,860,756,1067,986,1,11,14,207,230,8,991,0,0
2212,860,758,1065,985,1,11,14,205,227,9,991,0,0
2213,860,759,1064,985,1,11,14,204,226,10,991,0,0
2214,860,759,1064,985,1,11,14,204,226,11,991,0,0
2215,863,760,1068,987,1,11,14,205,227,12,991,0,0
2216,862,761,1067,986,1,11,14,205,225,13,991,0,0
2217,860,759,1065,984,1,11,14,205,225,14,991,0,0
2218,859,760,1064,983,1,11,14,205,223,15,991,0,0
2219,862,761,1068,985,1,11,14,206,224,16,991,0,0
2220,860,761,1065,984,1,11,14,205,223,17,991,0,0
2221,860,761,1069,989,1,11,14,209,228,18,991,0,0
2222,861,761,1071,990,1,11,14,210,229,19,991,0,0
2223,862,761,1072,991,1,11,14,210,230,20,991,0,0
2224,862,761,1071,989,1,11,14,209,228,21,991,0,0
2225,861,761,1072,990,1,11,14,211,229,22,991,0,0
2226,858,755,1070,986,1,11,14,212,231,23,991,0,0
2227,862,759,1070,985,1,11,14,208,226,24,991,0,0
2228,858,758,1068,987,1,11,14,210,229,25,991,0,0
2229,857,758,1067,987,1,11,14,210,229,26,991,0,0
2230,857,756,1068,986,1,11,14,211,230,27,991,0,0
2231,860,759,1070,988,1,11,14,210,229,28,991,0,0
2232,861,760,1071,988,1,11,14,210,228,29,991,0,0
2233,860,760,1070,989,1,11,14,210,229,30,991,0,0
2234,861,761,1071,988,1,11,14,210,227,31,991,0,0
2235,859,756,1070,986,1,11,14,211,230,32,991,0,0
2236,856,754,1068,986,1,11,14,212,232,33,991,0,0
2237,855,754,1067,985,1,11,14,212,231,34,991,0,0
2238,856,755,1068,986,1,11,14,212,231,35,991,0,0
2239,858,758,1067,986,1,11,14,209,228,36,991,0,0
2240,858,758,1068,988,1,11,14,210,230,37,991,0,0
2241,858,756,1069,986,1,11,14,211,230,38,991,0,0
2242,858,756,1069,986,1,11,14,211,230,39,991,0,0
2243,860,759,1066,984,1,11,14,206,225,40,991,0,0
2244,861,757,1067,982,1,11,14,206,225,41,991,0,0
2245,861,756,1067,980,1,11,14,206,224,42,991,0,0
2246,864,758,1070,981,1,11,14,206,223,43,991,0,0
2247,865,758,1071,982,1,11,14,206,224,44,991,0,0
2248,865,758,1072,983,1,11,14,207,225,45,991,0,0
2249,859,759,1070,987,1,11,14,211,228,46,991,0,0
2250,857,758,1071,991,1,11,14,214,233,47,991,0,0
2251,855,758,1072,996,1,11,14,217,238,48,991,0,0
2252,857,756,1071,991,1,11,14,214,235,49,991,0,0
2253,858,758,1069,990,1,11,14,211,232,50,991,0,0
2254,857,760,1068,994,1,11,14,211,234,51,991,0,0
2255,861,762,1071,994,1,11,14,210,232,52,991,0,0
2256,858,761,1069,996,1,11,14,211,235,53,991,0,0
2257,857,757,1071,998,1,11,14,214,241,54,991,0,0
2258,858,757,1071,996,1,11,14,213,239,55,991,0,0
2259,857,757,1070,997,1,11,14,213,240,56,991,0,0
2260,858,756,1069,995,1,11,14,211,239,57,991,0,0
2261,856,758,1069,999,1,11,14,213,241,58,991,0,0
2262,858,757,1065,992,1,11,14,207,235,59,991,0,0
2263,855,756,1064,994,1,11,14,209,238,60,991,0,0
2264,852,756,1063,997,1,11,14,211,241,61,991,0,0
2265,852,756,1063,998,1,11,14,211,242,62,991,0,0
2266,855,756,1064,997,1,11,14,209,241,63,991,0,0
2267,856,757,1063,994,1,11,14,207,237,64,991,0,0
2268,857,757,1063,994,1,11,14,206,237,65,991,0,0
2269,856,757,1063,995,1,11,14,207,238,66,991,0,0
2270,856,756,1063,995,1,11,14,207,239,67,991,0,0
2271,857,760,1063,998,1,11,14,206,238,68,991,0,0
2272,856,758,1063,998,1,11,14,207,240,69,991,0,0
2273,855,757,1064,998,1,11,14,209,241,70,991,0,0
2274,855,761,1062,1000,1,11,14,207,239,71,991,0,0
2275,856,759,1062,998,1,11,14,206,239,72,991,0,0
2276,856,758,1061,996,1,11,14,205,238,73,991,0,0
2277,854,758,1062,1000,1,11,14,208,242,74,991,0,0
2278,854,758,1063,1002,1,11,14,209,244,75,991,0,0
2279,852,758,1063,1005,1,11,14,211,247,76,991,0,0
2280,854,758,1062,1004,1,11,14,208,246,77,991,0,0
2281,856,755,1053,987,1,11,14,197,232,78,991,0,0
2282,854,759,1060,1004,1,11,14,206,245,79,991,0,0
2283,853,761,1064,1014,1,11,14,211,253,80,991,0,0
2284,852,762,1067,1019,1,11,14,215,257,81,991,0,0
2285,853,763,1067,1021,1,11,14,214,258,82,991,0,0
2286,855,763,1062,1013,1,11,14,207,250,83,991,0,0
2287,855,764,1062,1012,1,11,14,207,248,84,991,0,0
2288,855,764,1061,1011,1,11,14,206,247,85,991,0,0
2289,856,764,1060,1009,1,11,14,204,245,86,991,0,0
2290,856,764,1060,1009,1,11,14,204,245,87,991,0,0
2291,854,763,1064,1017,1,11,14,210,254,88,991,0,0
2292,854,764,1064,1019,1,11,14,210,255,89,991,0,0
2293,854,763,1064,1018,1,11,14,210,255,90,991,0,0
2294,862,761,1054,991,1,11,14,192,230,91,991,0,0
2295,868,762,1052,978,1,11,14,184,216,92,991,0,0
2296,870,764,1050,972,1,11,14,180,208,93,991,0,0
2297,872,763,1055,970,1,11,14,183,207,94,991,0,0
2298,870,761,1054,969,1,11,14,184,208,95,991,0,0
2299,872,760,1056,966,1,11,14,184,206,96,991,0,0
2300,873,761,1059,967,1,11,14,186,206,97,991,0,0
2301,871,761,1061,970,1,11,14,190,209,98,991,0,0
2302,870,760,1062,970,1,11,14,192,210,99,991,0,0
2303,869,760,1062,971,1,11,14,193,211,100,991,0,0
2304,868,761,1063,973,1,11,14,195,212,101,991,0,0
2305,868,761,1064,973,1,11,14,196,212,102,991,0,0
2306,869,761,1064,971,1,11,14,195,210,103,991,0,0
2307,864,755,1064,970,1,11,14,200,215,104,991,0,0
2308,862,752,1065,970,1,11,14,203,218,105,991,0,0
2309,860,750,1065,970,1,11,14,205,220,106,991,0,0
2310,860,755,1064,973,1,11,14,204,218,107,991,0,0
2311,861,756,1064,973,1,11,14,203,217,108,991,0,0
2312,864,756,1068,973,1,11,14,204,217,109,991,0,0
2313,862,756,1066,974,1,11,14,204,218,110,991,0,0
2314,861,756,1066,974,1,11,14,205,218,111,991,0,0
2315,861,756,1065,974,1,11,14,204,218,112,991,0,0
2316,864,756,1068,973,1,11,14,204,217,113,991,0,0
2317,862,756,1066,973,1,11,14,204,217,114,991,0,0
2318,861,756,1065,973,1,11,14,204,217,115,991,0,0
2319,861,757,1065,973,1,11,14,204,216,116,991,0,0
2320,861,757,1065,973,1,11,14,204,216,117,991,0,0
2321,861,756,1066,974,1,11,14,205,218,118,991,0,0
2322,859,752,1066,972,1,11,14,207,220,119,991,0,0
2323,858,750,1066,972,1,11,14,208,222,120,991,0,0
2324,859,755,1065,973,1,11,14,206,218,121,991,0,0
2325,859,756,1064,974,1,11,14,205,218,122,991,0,0
2326,860,756,1064,973,1,11,14,204,217,123,991,0,0
2327,860,756,1064,973,1,11,14,204,217,124,991,0,0
2328,860,757,1064,973,1,11,14,204,216,125,991,0,0
2329,861,757,1064,972,1,11,14,203,215,126,991,0,0
2330,861,757,1064,973,1,11,14,203,216,127,991,0,0
2331,861,758,1063,972,1,11,14,202,214,128,991,0,0
2332,861,758,1063,973,1,11,14,202,215,129,991,0,0
2333,860,757,1064,973,1,11,14,204,216,130,991,0,0
2334,860,755,1065,973,1,11,14,205,218,131,991,0,0
2335,863,757,1067,972,1,11,14,204,215,132,991,0,0
2336,862,757,1066,973,1,11,14,204,216,133,991,0,0
2337,862,758,1065,973,1,11,14,203,215,134,991,0,0
2338,863,759,1066,974,1,11,14,203,215,135,991,0,0
2339,863,760,1066,974,1,11,14,203,214,136,991,0,0
2340,863,760,1066,974,1,11,14,203,214,137,991,0,0
2341,863,760,1065,973,1,11,14,202,213,138,991,0,0
2342,864,761,1065,973,1,11,14,201,212,139,991,0,0
2343,864,762,1065,973,1,11,14,201,211,140,991,0,0
2344,863,761,1065,972,1,11,14,202,211,141,991,0,0
2345,863,761,1065,972,1,11,14,202,211,142,991,0,0
2346,863,762,1065,973,1,11,14,202,211,143,991,0,0
2347,863,763,1065,973,1,11,14,202,210,144,991,0,0
2348,863,762,1065,973,1,11,14,202,211,145,991,0,0
2349,863,762,1064,971,1,11,14,201,209,146,991,0,0
2350,863,762,1062,969,1,11,14,199,207,147,991,0,0
2351,863,762,1062,967,1,11,14,199,205,148,991,0,0
2352,863,762,1061,966,1,11,14,198,204,149,991,0,0
2353,861,762,1061,967,1,11,14,200,205,150,991,0,0
2354,861,762,1063,969,1,11,14,202,207,151,991,0,0
2355,861,762,1064,969,1,11,14,203,207,152,991,0,0
2356,859,758,1066,969,1,11,14,207,211,153,991,0,0
2357,862,761,1064,968,1,11,14,202,207,154,991,0,0
2358,860,757,1067,969,1,11,14,207,212,155,991,0,0
2359,862,761,1065,969,1,11,14,203,208,156,991,0,0
2360,859,758,1066,969,1,11,14,207,211,157,991,0,0
2361,860,761,1065,971,1,11,14,205,210,158,991,0,0
2362,860,763,1065,972,1,11,14,205,209,159,991,0,0
2363,860,763,1065,972,1,11,14,205,209,160,991,0,0
2364,858,763,1064,973,1,11,14,206,210,161,991,0,0
2365,860,763,1064,972,1,11,14,204,209,162,991,0,0
2366,860,763,1065,972,1,11,14,205,209,163,991,0,0
2367,861,763,1065,972,1,11,14,204,209,164,991,0,0
2368,860,762,1065,972,1,11,14,205,210,165,991,0,0
2369,860,762,1066,972,1,11,14,206,210,166,991,0,0
2370,860,762,1065,971,1,11,14,205,209,167,991,0,0
2371,857,758,1067,972,1,11,14,210,214,168,991,0,0
2372,856,756,1067,972,1,11,14,211,216,169,991,0,0
2373,856,755,1067,972,1,11,14,211,217,170,991,0,0
2374,857,756,1066,970,1,11,14,209,214,171,991,0,0
2375,857,756,1065,970,1,11,14,208,214,172,991,0,0
2376,859,761,1064,971,1,11,14,205,210,173,991,0,0
2377,860,762,1064,971,1,11,14,204,209,174,991,0,0
2378,860,762,1064,971,1,11,14,204,209,175,991,0,0
2379,857,757,1066,971,1,11,14,209,214,176,991,0,0
2380,859,761,1064,971,1,11,14,205,210,177,991,0,0
2381,859,758,1065,970,1,11,14,206,212,178,991,0,0
2382,861,762,1063,967,1,11,14,202,205,179,991,0,0
2383,863,762,1065,968,1,11,14,202,206,180,991,0,0
2384,863,763,1065,968,1,11,14,202,205,181,991,0,0
2385,863,759,1066,964,1,11,14,203,205,182,991,0,0
2386,862,761,1066,968,1,11,14,204,207,183,991,0,0
2387,861,761,1067,970,1,11,14,206,209,184,991,0,0
2388,861,762,1066,970,1,11,14,205,208,185,991,0,0
2389,861,762,1066,970,1,11,14,205,208,186,991,0,0
2390,861,762,1065,970,1,11,14,204,208,187,991,0,0
2391,857,758,1066,970,1,11,14,209,212,188,991,0,0
2392,856,757,1067,971,1,11,14,211,214,189,991,0,0
2393,860,758,1068,971,1,11,14,208,213,190,991,0,0
2394,862,759,1069,971,1,11,14,207,212,191,991,0,0
2395,858,757,1067,971,1,11,14,209,214,192,991,0,0
2396,858,755,1066,968,1,11,14,208,213,193,991,0,0
2397,860,759,1064,968,1,11,14,204,209,194,991,0,0
2398,859,760,1063,969,1,11,14,204,209,195,991,0,0
2399,858,760,1062,969,1,11,14,204,209,196,991,0,0
2400,858,761,1062,969,1,11,14,204,208,197,991,0,0
2401,861,761,1064,969,1,11,14,203,208,198,991,0,0
2402,862,761,1065,968,1,11,14,203,207,199,991,0,0
2403,860,757,1066,966,1,11,14,206,209,200,991,0,0
2404,861,759,1066,968,1,11,14,205,209,201,991,0,0
2405,862,760,1066,968,1,11,14,204,208,202,991,0,0
2406,862,760,1068,970,1,11,14,206,210,203,991,0,0
2407,862,760,1068,971,1,11,14,206,211,204,991,0,0
2408,862,758,1069,971,1,11,14,207,213,205,991,0,0
2409,861,757,1069,971,1,11,14,208,214,206,991,0,0
2410,862,757,1069,971,1,11,14,207,214,207,991,0,0
2411,861,759,1067,971,1,11,14,206,212,208,991,0,0
2412,857,757,1067,972,1,11,14,210,215,209,991,0,0
2413,856,756,1066,972,1,11,14,210,216,210,991,0,0
2414,855,756,1066,973,1,11,14,211,217,211,991,0,0
2415,858,759,1065,973,1,11,14,207,214,212,991,0,0
2416,861,759,1068,973,1,11,14,207,214,213,991,0,0
2417,862,759,1069,973,1,11,14,207,214,214,991,0,0
2418,862,759,1069,973,1,11,14,207,214,215,991,0,0
2419,863,758,1069,972,1,11,14,206,214,216,991,0,0
2420,863,758,1070,972,1,11,14,207,214,217,991,0,0
2421,863,759,1068,973,1,11,14,205,214,218,991,0,0
2422,864,759,1068,972,1,11,14,204,213,219,991,0,0
2423,864,759,1068,972,1,11,14,204,213,220,991,0,0
2424,864,759,1068,972,1,11,14,204,213,221,991,0,0
2425,864,759,1067,972,1,11,14,203,213,222,991,0,0
2426,864,758,1068,972,1,11,14,204,214,223,991,0,0
2427,864,758,1068,972,1,11,14,204,214,224,991,0,0
2428,862,759,1066,972,1,11,14,204,213,225,991,0,0
2429,864,759,1067,973,1,11,14,203,214,226,991,0,0
2430,864,759,1067,973,1,11,14,203,214,227,991,0,0
2431,865,760,1067,973,1,11,14,202,213,228,991,0,0
2432,865,760,1067,973,1,11,14,202,213,229,991,0,0
2433,864,760,1067,973,1,11,14,203,213,230,991,0,0
2434,860,758,1065,973,1,11,14,205,215,231,991,0,0
2435,858,757,1064,973,1,11,14,206,216,232,991,0,0
2436,862,759,1067,973,1,11,14,205,214,233,991,0,0
2437,864,759,1067,973,1,11,14,203,214,234,991,0,0
2438,863,760,1066,973,1,11,14,203,213,235,991,0,0
2439,864,760,1067,973,1,11,14,203,213,236,991,0,0
2440,863,761,1066,973,1,11,14,203,212,237,991,0,0
2441,864,759,1067,973,1,11,14,203,214,238,991,0,0
2442,864,759,1067,973,1,11,14,203,214,239,991,0,0
2443,863,759,1068,973,1,11,14,205,214,240,991,0,0
2444,863,759,1068,973,1,11,14,205,214,241,991,0,0
2445,863,759,1069,974,1,11,14,206,215,242,991,0,0
2446,864,759,1068,972,1,11,14,204,213,243,991,0,0
2447,864,759,1067,972,1,11,14,203,213,244,991,0,0
2448,865,760,1066,971,1,11,14,201,211,245,991,0,0
2449,865,760,1066,971,1,11,14,201,211,246,991,0,0
2450,865,760,1067,970,1,11,14,202,210,247,991,0,0
2451,864,760,1066,971,1,11,14,202,211,248,991,0,0
2452,863,760,1067,973,1,11,14,204,213,249,991,0,0
2453,863,760,1067,973,1,11,14,204,213,250,991,0,0
2454,864,760,1067,973,1,11,14,203,213,251,991,0,0
2455,864,760,1067,973,1,11,14,203,213,252,991,0,0
2456,864,760,1066,972,1,11,14,202,212,253,991,0,0
2457,861,758,1065,973,1,11,14,204,215,254,991,0,0
2458,863,760,1065,972,1,11,14,202,212,255,991,0,0
2459,864,760,1065,972,1,11,14,201,212,256,991,0,0
2460,864,760,1065,972,1,11,14,201,212,257,991,0,0
2461,865,759,1068,971,1,11,14,203,212,258,991,0,0
2462,865,759,1068,971,1,11,14,203,212,259,991,0,0
2463,865,759,1068,971,1,11,14,203,212,260,991,0,0
2464,865,759,1068,972,1,11,14,203,213,261,991,0,0
2465,864,757,1068,970,1,11,14,204,213,262,991,0,0
2466,864,758,1069,973,1,11,14,205,215,263,991,0,0
2467,863,758,1070,975,1,11,14,207,217,264,991,0,0
2468,863,758,1070,976,1,11,14,207,218,265,991,0,0
2469,863,758,1070,976,1,11,14,207,218,266,991,0,0
2470,863,758,1069,977,1,11,14,206,219,267,991,0,0
2471,865,760,1068,974,1,11,14,203,214,268,991,0,0
2472,865,760,1067,974,1,11,14,202,214,269,991,0,0
2473,865,760,1067,973,1,11,14,202,213,270,991,0,0
2474,861,758,1066,974,1,11,14,205,216,271,991,0,0
2475,859,757,1065,974,1,11,14,206,217,272,991,0,0
2476,863,759,1066,972,1,11,14,203,213,273,991,0,0
2477,864,758,1066,970,1,11,14,202,212,274,991,0,0
2478,864,758,1067,970,1,11,14,203,212,275,991,0,0
2479,864,758,1067,970,1,11,14,203,212,276,991,0,0
2480,864,758,1068,971,1,11,14,204,213,277,991,0,0
2481,864,759,1067,972,1,11,14,203,213,278,991,0,0
2482,864,759,1067,972,1,11,14,203,213,279,991,0,0
2483,864,759,1067,972,1,11,14,203,213,280,991,0,0
2484,864,760,1067,972,1,11,14,203,212,281,991,0,0
2485,864,760,1067,972,1,11,14,203,212,282,991,0,0
2486,865,760,1067,972,1,11,14,202,212,283,991,0,0
2487,865,760,1067,972,1,11,14,202,212,284,991,0,0
2488,866,761,1067,972,1,11,14,201,211,285,991,0,0
2489,866,761,1067,971,1,11,14,201,210,286,991,0,0
2490,866,761,1067,971,1,11,14,201,210,287,991,0,0
2491,859,758,1066,973,1,11,14,207,215,288,991,0,0
2492,858,758,1066,975,1,11,14,208,217,289,991,0,0
2493,857,757,1065,974,1,11,14,208,217,290,991,0,0
2494,861,759,1066,972,1,11,14,205,213,291,991,0,0
2495,863,760,1066,972,1,11,14,203,212,292,991,0,0
2496,864,760,1068,974,1,11,14,204,214,293,991,0,0
2497,864,760,1069,974,1,11,14,205,214,294,991,0,0
2498,864,760,1069,975,1,11,14,205,215,295,991,0,0
2499,864,760,1069,975,1,11,14,205,215,296,991,0,0
2500,864,759,1069,974,1,11,14,205,215,297,991,0,0
2501,863,761,1065,972,1,11,14,202,211,298,991,0,0
2502,863,761,1064,972,1,11,14,201,211,299,991,0,0
2503,863,762,1064,972,1,11,14,201,210,300,991,0,0
2504,860,759,1064,971,1,11,14,204,212,301,991,0,0
2505,860,760,1064,973,1,11,14,204,213,302,991,0,0
2506,861,756,1066,969,1,11,14,205,213,303,991,0,0
2507,862,760,1065,971,1,11,14,203,211,304,991,0,0
2508,863,762,1065,971,1,11,14,202,209,305,991,0,0
2509,863,763,1065,971,1,11,14,202,208,306,991,0,0
2510,863,763,1065,971,1,11,14,202,208,307,991,0,0
2511,860,759,1066,973,1,11,14,206,214,308,991,0,0
2512,858,759,1067,975,1,11,14,209,216,309,991,0,0
2513,863,760,1068,972,1,11,14,205,212,310,991,0,0
2514,864,760,1069,971,1,11,14,205,211,311,991,0,0
2515,865,760,1068,971,1,11,14,203,211,312,991,0,0
2516,861,758,1068,973,1,11,14,207,215,313,991,0,0
2517,859,757,1067,973,1,11,14,208,216,314,991,0,0
2518,862,759,1069,973,1,11,14,207,214,315,991,0,0
2519,862,760,1067,973,1,11,14,205,213,316,991,0,0
2520,861,760,1066,973,1,11,14,205,213,317,991,0,0
2521,857,756,1067,974,1,11,14,210,218,318,991,0,0
2522,856,755,1068,975,1,11,14,212,220,319,991,0,0
2523,861,758,1069,974,1,11,14,208,216,320,991,0,0
2524,863,759,1069,974,1,11,14,206,215,321,991,0,0
2525,859,758,1067,974,1,11,14,208,216,322,991,0,0
2526,859,758,1066,974,1,11,14,207,216,323,991,0,0
2527,861,762,1065,973,1,11,14,204,211,324,991,0,0
2528,862,760,1066,971,1,11,14,204,211,325,991,0,0
2529,860,759,1066,973,1,11,14,206,214,326,991,0,0
2530,862,761,1065,973,1,11,14,203,212,327,991,0,0
2531,863,760,1067,973,1,11,14,204,213,328,991,0,0
2532,862,760,1067,972,1,11,14,205,212,329,991,0,0
2533,863,760,1068,974,1,11,14,205,214,330,991,0,0
2534,863,760,1069,974,1,11,14,206,214,331,991,0,0
2535,862,760,1067,973,1,11,14,205,213,332,991,0,0
2536,864,760,1068,973,1,11,14,204,213,333,991,0,0
2537,865,760,1068,971,1,11,14,203,211,334,991,0,0
2538,864,761,1068,973,1,11,14,204,212,335,991,0,0
2539,864,761,1068,973,1,11,14,204,212,336,991,0,0
2540,864,761,1069,973,1,11,14,205,212,337,991,0,0
2541,865,761,1069,973,1,11,14,204,212,338,991,0,0
2542,865,761,1069,974,1,11,14,204,213,339,991,0,0
2543,865,761,1069,974,1,11,14,204,213,340,991,0,0
2544,865,761,1069,974,1,11,14,204,213,341,991,0,0
2545,863,761,1067,974,1,11,14,204,213,342,991,0,0
2546,862,757,1069,974,1,11,14,207,217,343,991,0,0
2547,859,756,1068,975,1,11,14,209,219,344,991,0,0
2548,858,756,1068,976,1,11,14,210,220,345,991,0,0
2549,861,754,1070,974,1,11,14,209,220,346,991,0,0
2550,859,754,1069,975,1,11,14,210,221,347,991,0,0
2551,858,755,1067,974,1,11,14,209,219,348,991,0,0
2552,859,755,1066,973,1,11,14,207,218,349,991,0,0
2553,859,755,1065,973,1,11,14,206,218,350,991,0,0
2554,859,755,1065,973,1,11,14,206,218,351,991,0,0
2555,859,755,1065,972,1,11,14,206,217,352,991,0,0
2556,860,756,1066,974,1,11,14,206,218,353,991,0,0
2557,860,756,1067,974,1,11,14,207,218,354,991,0,0
2558,858,754,1067,975,1,11,14,209,221,355,991,0,0
2559,859,756,1067,975,1,11,14,208,219,356,991,0,0
2560,858,754,1067,976,1,11,14,209,222,357,991,0,0
2561,860,756,1066,974,1,11,14,206,218,358,991,0,0
2562,861,757,1065,973,1,11,14,204,216,359,991,0,0
2563,861,757,1064,972,1,11,14,203,215,360,991,0,0
2564,861,757,1065,972,1,11,14,204,215,361,991,0,0
2565,861,759,1065,973,1,11,14,204,214,362,991,0,0
2566,860,758,1064,972,1,11,14,204,214,363,991,0,0
2567,860,759,1064,972,1,11,14,204,213,364,991,0,0
2568,860,759,1064,972,1,11,14,204,213,365,991,0,0
2569,859,760,1064,972,1,11,14,205,212,366,991,0,0
2570,859,759,1064,972,1,11,14,205,213,367,991,0,0
2571,860,759,1065,972,1,11,14,205,213,368,991,0,0
2572,860,760,1065,972,1,11,14,205,212,369,991,0,0
2573,861,761,1065,972,1,11,14,204,211,370,991,0,0
2574,863,760,1067,972,1,11,14,204,212,371,991,0,0
2575,864,760,1069,972,1,11,14,205,212,372,991,0,0
2576,863,759,1070,973,1,11,14,207,214,373,991,0,0
2577,862,759,1070,974,1,11,14,208,215,374,991,0,0
2578,863,759,1069,973,1,11,14,206,214,375,991,0,0
2579,862,761,1067,973,1,11,14,205,212,376,991,0,0
2580,863,760,1069,974,1,11,14,206,214,377,991,0,0
2581,862,761,1066,973,1,11,14,204,212,378,991,0,0
2582,863,759,1068,971,1,11,14,205,212,379,991,0,0
2583,861,761,1067,974,1,11,14,206,213,380,991,0,0
2584,862,762,1066,974,1,11,14,204,212,381,991,0,0
2585,862,762,1066,974,1,11,14,204,212,382,991,0,0
2586,864,761,1067,971,1,11,14,203,210,383,991,0,0
2587,863,758,1067,969,1,11,14,204,211,384,991,0,0
2588,864,759,1068,971,1,11,14,204,212,385,991,0,0
2589,864,759,1069,971,1,11,14,205,212,386,991,0,0
2590,864,759,1068,971,1,11,14,204,212,387,991,0,0
2591,861,756,1069,971,1,11,14,208,215,388,991,0,0
2592,863,758,1069,971,1,11,14,206,213,389,991,0,0
2593,864,759,1069,972,1,11,14,205,213,390,991,0,0
2594,862,761,1068,974,1,11,14,206,213,391,991,0,0
2595,863,760,1069,973,1,11,14,206,213,392,991,0,0
2596,862,761,1067,974,1,11,14,205,213,393,991,0,0
2597,861,761,1067,974,1,11,14,206,213,394,991,0,0
2598,861,762,1066,975,1,11,14,205,213,395,991,0,0
2599,863,760,1068,973,1,11,14,205,213,396,991,0,0
2600,861,761,1067,974,1,11,14,206,213,397,991,0,0
2601,862,759,1068,973,1,11,14,206,214,398,991,0,0
2602,863,759,1069,973,1,11,14,206,214,399,991,0,0
2603,864,759,1069,973,1,11,14,205,214,400,991,0,0
2604,864,759,1069,973,1,11,14,205,214,401,991,0,0
2605,863,758,1070,972,1,11,14,207,214,402,991,0,0
2606,864,759,1069,973,1,11,14,205,214,403,991,0,0
2607,864,759,1069,973,1,11,14,205,214,404,991,0,0
2608,864,760,1069,973,1,11,14,205,213,405,991,0,0
2609,865,760,1069,973,1,11,14,204,213,406,991,0,0
2610,865,760,1069,973,1,11,14,204,213,407,991,0,0
2611,865,759,1069,973,1,11,14,204,214,408,991,0,0
2612,865,759,1069,973,1,11,14,204,214,409,991,0,0
2613,864,759,1069,973,1,11,14,205,214,410,991,0,0
2614,865,758,1069,973,1,11,14,204,215,411,991,0,0
2615,864,758,1069,973,1,11,14,205,215,412,991,0,0
2616,865,759,1068,973,1,11,14,203,214,413,991,0,0
2617,865,759,1068,972,1,11,14,203,213,414,991,0,0
2618,864,759,1068,972,1,11,14,204,213,415,991,0,0
2619,864,759,1068,972,1,11,14,204,213,416,991,0,0
2620,864,760,1068,973,1,11,14,204,213,417,991,0,0
2621,864,760,1069,973,1,11,14,205,213,418,991,0,0
2622,864,759,1069,973,1,11,14,205,214,419,991,0,0
2623,865,759,1070,974,1,11,14,205,215,420,991,0,0
2624,864,759,1070,974,1,11,14,206,215,421,991,0,0
2625,862,762,1068,976,1,11,14,206,214,422,991,0,0
2626,863,760,1069,974,1,11,14,206,214,423,991,0,0
2627,864,760,1069,972,1,11,14,205,212,424,991,0,0
2628,865,760,1069,971,1,11,14,204,211,425,991,0,0
2629,865,760,1069,971,1,11,14,204,211,426,991,0,0
2630,865,760,1070,971,1,11,14,205,211,427,991,0,0
2631,863,759,1069,973,1,11,14,206,214,428,991,0,0
2632,862,758,1070,974,1,11,14,208,216,429,991,0,0
2633,859,757,1069,976,1,11,14,210,219,430,991,0,0
2634,858,755,1070,978,1,11,14,212,223,431,991,0,0
2635,857,753,1070,977,1,11,14,213,224,432,991,0,0
2636,858,754,1070,979,1,11,14,212,225,433,991,0,0
2637,861,755,1071,977,1,11,14,210,222,434,991,0,0
2638,862,757,1070,977,1,11,14,208,220,435,991,0,0
2639,863,758,1069,977,1,11,14,206,219,436,991,0,0
2640,865,759,1069,976,1,11,14,204,217,437,991,0,0
2641,865,759,1068,976,1,11,14,203,217,438,991,0,0
2642,865,760,1067,975,1,11,14,202,215,439,991,0,0
2643,865,760,1067,975,1,11,14,202,215,440,991,0,0
2644,865,760,1067,975,1,11,14,202,215,441,991,0,0
2645,864,759,1067,975,1,11,14,203,216,442,991,0,0
2646,864,759,1067,975,1,11,14,203,216,443,991,0,0
2647,864,759,1067,975,1,11,14,203,216,444,991,0,0
2648,864,759,1067,975,1,11,14,203,216,445,991,0,0
2649,864,759,1067,974,1,11,14,203,215,446,991,0,0
2650,864,759,1067,975,1,11,14,203,216,447,991,0,0
2651,863,759,1066,975,1,11,14,203,216,448,991,0,0
2652,863,759,1066,975,1,11,14,203,216,449,991,0,0
2653,863,759,1067,976,1,11,14,204,217,450,991,0,0
2654,861,760,1064,976,1,11,14,203,216,451,991,0,0
2655,861,760,1064,976,1,11,14,203,216,452,991,0,0
2656,863,759,1065,974,1,11,14,202,215,453,991,0,0
2657,863,759,1067,975,1,11,14,204,216,454,991,0,0
2658,864,759,1067,974,1,11,14,203,215,455,991,0,0
2659,864,759,1066,974,1,11,14,202,215,456,991,0,0
2660,864,759,1066,974,1,11,14,202,215,457,991,0,0
2661,860,756,1066,975,1,11,14,206,219,458,991,0,0
2662,861,758,1067,977,1,11,14,206,219,459,991,0,0
2663,860,756,1066,976,1,11,14,206,220,460,991,0,0
2664,861,757,1067,978,1,11,14,206,221,461,991,0,0
2665,859,756,1066,977,1,11,14,207,221,462,991,0,0
2666,862,758,1067,977,1,11,14,205,219,463,991,0,0
2667,863,758,1067,976,1,11,14,204,218,464,991,0,0
2668,863,758,1067,976,1,11,14,204,218,465,991,0,0
2669,863,759,1068,976,1,11,14,205,217,466,991,0,0
2670,864,759,1067,976,1,11,14,203,217,467,991,0,0
2671,865,759,1067,973,1,11,14,202,214,468,991,0,0
2672,865,758,1067,972,1,11,14,202,214,469,991,0,0
2673,865,758,1066,971,1,11,14,201,213,470,991,0,0
2674,863,758,1064,971,1,11,14,201,213,471,991,0,0
2675,863,758,1065,971,1,11,14,202,213,472,991,0,0
2676,860,754,1065,971,1,11,14,205,217,473,991,0,0
2677,859,753,1065,971,1,11,14,206,218,474,991,0,0
2678,859,752,1065,971,1,11,14,206,219,475,991,0,0
2679,859,752,1066,971,1,11,14,207,219,476,991,0,0
2680,859,752,1066,971,1,11,14,207,219,477,991,0,0
2681,859,756,1065,975,1,11,14,206,219,478,991,0,0
2682,862,758,1068,976,1,11,14,206,218,479,991,0,0
2683,863,759,1068,976,1,11,14,205,217,480,991,0,0
2684,863,759,1068,976,1,11,14,205,217,481,991,0,0
2685,864,760,1068,976,1,11,14,204,216,482,991,0,0
2686,860,757,1067,976,1,11,14,207,219,483,991,0,0
2687,862,758,1067,976,1,11,14,205,218,484,991,0,0
2688,859,756,1066,976,1,11,14,207,220,485,991,0,0
2689,862,758,1067,975,1,11,14,205,217,486,991,0,0
2690,859,756,1065,975,1,11,14,206,219,487,991,0,0
2691,860,754,1065,972,1,11,14,205,218,488,991,0,0
2692,859,755,1065,974,1,11,14,206,219,489,991,0,0
2693,859,756,1064,973,1,11,14,205,217,490,991,0,0
2694,859,756,1065,973,1,11,14,206,217,491,991,0,0
2695,859,756,1065,973,1,11,14,206,217,492,991,0,0
2696,862,758,1067,974,1,11,14,205,216,493,991,0,0
2697,862,758,1068,974,1,11,14,206,216,494,991,0,0
2698,863,758,1068,975,1,11,14,205,217,495,991,0,0
2699,863,758,1068,975,1,11,14,205,217,496,991,0,0
2700,863,758,1068,975,1,11,14,205,217,497,991,0,0
2701,863,759,1068,975,1,11,14,205,216,498,991,0,0
2702,863,759,1068,975,1,11,14,205,216,499,991,0,0
2703,862,758,1068,976,1,11,14,206,218,500,991,0,0
2704,862,756,1069,975,1,11,14,207,219,501,991,0,0
2705,859,754,1068,977,1,11,14,209,223,502,991,0,0
2706,856,752,1069,977,1,11,14,213,225,503,991,0,0
2707,856,751,1068,978,1,11,14,212,227,504,991,0,0
2708,858,751,1069,975,1,11,14,211,224,505,991,0,0
2709,859,750,1070,975,1,11,14,211,225,506,991,0,0
2710,857,749,1068,973,1,11,14,211,224,507,991,0,0
2711,857,753,1067,977,1,11,14,210,224,508,991,0,0
2712,856,755,1066,979,1,11,14,210,224,509,991,0,0
2713,860,754,1069,977,1,11,14,209,223,510,991,0,0
2714,858,755,1067,978,1,11,14,209,223,511,991,0,0
2715,860,754,1070,977,1,11,14,210,223,512,991,0,0
2716,860,756,1065,973,1,11,14,205,217,513,991,0,0
2717,860,756,1064,973,1,11,14,204,217,514,991,0,0
2718,861,756,1064,972,1,11,14,203,216,515,991,0,0
2719,861,757,1064,972,1,11,14,203,215,516,991,0,0
2720,861,757,1064,972,1,11,14,203,215,517,991,0,0
2721,859,757,1063,972,1,11,14,204,215,518,991,0,0
2722,858,757,1062,972,1,11,14,204,215,519,991,0,0
2723,861,755,1067,971,1,11,14,206,216,520,991,0,0
2724,859,752,1067,971,1,11,14,208,219,521,991,0,0
2725,862,753,1068,971,1,11,14,206,218,522,991,0,0
2726,863,755,1070,973,1,11,14,207,218,523,991,0,0
2727,864,756,1070,974,1,11,14,206,218,524,991,0,0
2728,865,756,1070,974,1,11,14,205,218,525,991,0,0
2729,863,758,1068,976,1,11,14,205,218,526,991,0,0
2730,862,756,1070,978,1,11,14,208,222,527,991,0,0
2731,855,756,1071,988,1,11,14,216,232,528,991,0,0
2732,854,754,1072,988,1,11,14,218,234,529,991,0,0
2733,854,755,1071,990,1,11,14,217,235,530,991,0,0
2734,857,753,1069,983,1,11,14,212,230,531,991,0,0
2735,858,751,1068,980,1,11,14,210,229,532,991,0,0
2736,859,753,1065,977,1,11,14,206,224,533,991,0,0
2737,860,752,1064,973,1,11,14,204,221,534,991,0,0
2738,863,755,1065,974,1,11,14,202,219,535,991,0,0
2739,861,755,1065,976,1,11,14,204,221,536,991,0,0
2740,864,757,1065,974,1,11,14,201,217,537,991,0,0
2741,863,759,1063,974,1,11,14,200,215,538,991,0,0
2742,865,758,1065,973,1,11,14,200,215,539,991,0,0
2743,865,758,1066,973,1,11,14,201,215,540,991,0,0
2744,865,758,1066,972,1,11,14,201,214,541,991,0,0
2745,863,759,1064,972,1,11,14,201,213,542,991,0,0
2746,863,759,1063,972,1,11,14,200,213,543,991,0,0
2747,864,758,1066,971,1,11,14,202,213,544,991,0,0
2748,865,757,1067,971,1,11,14,202,214,545,991,0,0
2749,865,757,1067,971,1,11,14,202,214,546,991,0,0
2750,864,757,1067,971,1,11,14,203,214,547,991,0,0
2751,864,757,1068,973,1,11,14,204,216,548,991,0,0
2752,864,757,1068,973,1,11,14,204,216,549,991,0,0
2753,864,757,1068,973,1,11,14,204,216,550,991,0,0
2754,864,758,1067,973,1,11,14,203,215,551,991,0,0
2755,864,758,1068,973,1,11,14,204,215,552,991,0,0
2756,862,760,1065,974,1,11,14,203,214,553,991,0,0
2757,861,760,1065,974,1,11,14,204,214,554,991,0,0
2758,858,758,1066,977,1,11,14,208,219,555,991,0,0
2759,862,756,1069,974,1,11,14,207,218,556,991,0,0
2760,862,754,1070,974,1,11,14,208,220,557,991,0,0
2761,862,754,1072,976,1,11,14,210,222,558,991,0,0
2762,862,753,1072,976,1,11,14,210,223,559,991,0,0
2763,863,755,1071,976,1,11,14,208,221,560,991,0,0
2764,863,755,1071,976,1,11,14,208,221,561,991,0,0
2765,863,755,1070,976,1,11,14,207,221,562,991,0,0
2766,864,756,1070,976,1,11,14,206,220,563,991,0,0
2767,864,756,1070,976,1,11,14,206,220,564,991,0,0
2768,864,756,1069,975,1,11,14,205,219,565,991,0,0
2769,864,756,1069,975,1,11,14,205,219,566,991,0,0
2770,864,756,1069,975,1,11,14,205,219,567,991,0,0
2771,864,756,1068,975,1,11,14,204,219,568,991,0,0
2772,864,756,1068,975,1,11,14,204,219,569,991,0,0
2773,864,757,1068,975,1,11,14,204,218,570,991,0,0
2774,864,757,1068,974,1,11,14,204,217,571,991,0,0
2775,864,757,1068,974,1,11,14,204,217,572,991,0,0
2776,863,757,1067,975,1,11,14,204,218,573,991,0,0
2777,863,757,1067,976,1,11,14,204,219,574,991,0,0
2778,863,756,1068,976,1,11,14,205,220,575,991,0,0
2779,863,756,1067,976,1,11,14,204,220,576,991,0,0
2780,864,756,1067,976,1,11,14,203,220,577,991,0,0
2781,864,755,1068,976,1,11,14,204,221,578,991,0,0
2782,864,754,1069,975,1,11,14,205,221,579,991,0,0
2783,863,754,1069,976,1,11,14,206,222,580,991,0,0
2784,862,754,1068,976,1,11,14,206,222,581,991,0,0
2785,863,753,1069,976,1,11,14,206,223,582,991,0,0
2786,861,753,1069,979,1,11,14,208,226,583,991,0,0
2787,861,751,1069,979,1,11,14,208,228,584,991,0,0
2788,861,751,1069,979,1,11,14,208,228,585,991,0,0
2789,863,753,1071,985,1,11,14,208,232,586,991,0,0
2790,865,754,1070,984,1,11,14,205,230,587,991,0,0
2791,865,754,1071,984,1,11,14,206,230,588,991,0,0
2794,870,755,1067,974,1,11,14,197,219,0,991,0,1
2795,870,755,1069,976,1,11,14,199,221,1,991,0,0
2796,868,755,1066,974,1,11,14,198,219,2,991,0,0
2797,867,755,1066,973,1,11,14,199,218,3,991,0,0
2798,867,755,1066,972,1,11,14,199,217,4,991,0,0
2799,866,755,1066,972,1,11,14,200,217,5,991,0,0
2800,865,755,1067,974,1,11,14,202,219,6,991,0,0
2801,863,755,1066,975,1,11,14,203,220,7,991,0,0
2802,862,755,1066,976,1,11,14,204,221,8,991,0,0
2803,862,756,1066,976,1,11,14,204,220,9,991,0,0
2804,861,756,1066,977,1,11,14,205,221,10,991,0,0
2805,862,756,1066,977,1,11,14,204,221,11,991,0,0
2806,862,756,1065,976,1,11,14,203,220,12,991,0,0
2807,862,756,1064,975,1,11,14,202,219,13,991,0,0
2808,862,756,1064,975,1,11,14,202,219,14,991,0,0
2809,862,757,1064,974,1,11,14,202,217,15,991,0,0
2810,862,757,1064,974,1,11,14,202,217,16,991,0,0
2811,863,755,1067,974,1,11,14,204,219,17,991,0,0
2812,863,754,1067,974,1,11,14,204,220,18,991,0,0
2813,862,755,1067,974,1,11,14,205,219,19,991,0,0
2814,860,755,1067,976,1,11,14,207,221,20,991,0,0
2815,862,754,1068,975,1,11,14,206,221,21,991,0,0
2816,861,756,1066,975,1,11,14,205,219,22,991,0,0
2817,862,754,1068,975,1,11,14,206,221,23,991,0,0
2818,862,754,1068,976,1,11,14,206,222,24,991,0,0
2819,862,754,1069,976,1,11,14,207,222,25,991,0,0
2820,862,753,1069,976,1,11,14,207,223,26,991,0,0
2821,861,757,1066,977,1,11,14,205,220,27,991,0,0
2822,862,755,1067,976,1,11,14,205,221,28,991,0,0
2823,862,754,1068,976,1,11,14,206,222,29,991,0,0
2824,862,754,1069,977,1,11,14,207,223,30,991,0,0
2825,863,753,1068,977,1,11,14,205,224,31,991,0,0
2826,863,755,1066,975,1,11,14,203,220,32,991,0,0
2827,863,756,1064,974,1,11,14,201,218,33,991,0,0
2828,863,756,1064,974,1,11,14,201,218,34,991,0,0
2829,863,757,1064,973,1,11,14,201,216,35,991,0,0
2830,863,757,1065,973,1,11,14,202,216,36,991,0,0
2831,862,757,1063,972,1,11,14,201,215,37,991,0,0
2832,863,757,1063,972,1,11,14,200,215,38,991,0,0
2833,863,757,1064,971,1,11,14,201,214,39,991,0,0
2834,862,757,1064,971,1,11,14,202,214,40,991,0,0
2835,862,757,1064,972,1,11,14,202,215,41,991,0,0
2836,860,757,1064,974,1,11,14,204,217,42,991,0,0
2837,860,756,1065,974,1,11,14,205,218,43,991,0,0
2838,861,756,1066,975,1,11,14,205,219,44,991,0,0
2839,860,756,1065,975,1,11,14,205,219,45,991,0,0
2840,862,755,1067,974,1,11,14,205,219,46,991,0,0
2841,861,757,1065,974,1,11,14,204,217,47,991,0,0
2842,859,753,1064,972,1,11,14,205,219,48,991,0,0
2843,859,756,1064,973,1,11,14,205,217,49,991,0,0
2844,859,757,1064,974,1,11,14,205,217,50,991,0,0
2845,859,758,1064,974,1,11,14,205,216,51,991,0,0
2846,862,756,1066,971,1,11,14,204,215,52,991,0,0
2847,862,755,1066,969,1,11,14,204,214,53,991,0,0
2848,860,757,1065,972,1,11,14,205,215,54,991,0,0
2849,858,752,1066,971,1,11,14,208,219,55,991,0,0
2850,860,753,1067,972,1,11,14,207,219,56,991,0,0
2851,860,756,1066,974,1,11,14,206,218,57,991,0,0
2852,860,757,1066,974,1,11,14,206,217,58,991,0,0
2853,860,757,1066,975,1,11,14,206,218,59,991,0,0
2854,861,755,1068,974,1,11,14,207,219,60,991,0,0
2855,862,755,1069,974,1,11,14,207,219,61,991,0,0
2856,863,754,1067,970,1,11,14,204,216,62,991,0,0
2857,863,754,1067,970,1,11,14,204,216,63,991,0,0
2858,863,754,1067,970,1,11,14,204,216,64,991,0,0
2859,862,757,1066,973,1,11,14,204,216,65,991,0,0
2860,861,758,1066,974,1,11,14,205,216,66,991,0,0
2861,862,756,1068,974,1,11,14,206,218,67,991,0,0
2862,863,756,1069,974,1,11,14,206,218,68,991,0,0
2863,864,756,1069,973,1,11,14,205,217,69,991,0,0
2864,864,756,1070,973,1,11,14,206,217,70,991,0,0
2865,863,756,1069,973,1,11,14,206,217,71,991,0,0
2866,863,755,1069,973,1,11,14,206,218,72,991,0,0
2867,862,755,1069,973,1,11,14,207,218,73,991,0,0
2868,861,756,1067,975,1,11,14,206,219,74,991,0,0
2869,860,756,1067,975,1,11,14,207,219,75,991,0,0
2870,862,755,1068,974,1,11,14,206,219,76,991,0,0
2871,861,757,1066,974,1,11,14,205,217,77,991,0,0
2872,860,757,1066,974,1,11,14,206,217,78,991,0,0
2873,860,757,1066,975,1,11,14,206,218,79,991,0,0
2874,860,757,1066,975,1,11,14,206,218,80,991,0,0
2875,859,757,1066,975,1,11,14,207,218,81,991,0,0
2876,860,755,1067,974,1,11,14,207,219,82,991,0,0
2877,860,757,1065,974,1,11,14,205,217,83,991,0,0
2878,860,757,1066,975,1,11,14,206,218,84,991,0,0
2879,860,753,1067,973,1,11,14,207,220,85,991,0,0
2880,860,755,1066,974,1,11,14,206,219,86,991,0,0
2881,860,758,1065,975,1,11,14,205,217,87,991,0,0
2882,862,756,1067,973,1,11,14,205,217,88,991,0,0
2883,860,758,1066,975,1,11,14,206,217,89,991,0,0
2884,860,760,1066,976,1,11,14,206,216,90,991,0,0
2885,860,760,1066,976,1,11,14,206,216,91,991,0,0
2886,859,758,1067,976,1,11,14,208,218,92,991,0,0
2887,861,756,1069,975,1,11,14,208,219,93,991,0,0
2888,862,755,1069,974,1,11,14,207,219,94,991,0,0
2889,862,755,1069,974,1,11,14,207,219,95,991,0,0
2890,862,754,1069,973,1,11,14,207,219,96,991,0,0
2891,861,756,1065,973,1,11,14,204,217,97,991,0,0
2892,860,756,1065,973,1,11,14,205,217,98,991,0,0
2893,860,757,1064,973,1,11,14,204,216,99,991,0,0
2894,860,757,1064,973,1,11,14,204,216,100,991,0,0
2895,859,756,1065,974,1,11,14,206,218,101,991,0,0
2896,859,756,1066,975,1,11,14,207,219,102,991,0,0
2897,860,756,1066,975,1,11,14,206,219,103,991,0,0
2898,860,756,1066,975,1,11,14,206,219,104,991,0,0
2899,859,756,1066,975,1,11,14,207,219,105,991,0,0
2900,861,755,1068,974,1,11,14,207,219,106,991,0,0
2901,863,755,1069,974,1,11,14,206,219,107,991,0,0
2902,863,754,1068,974,1,11,14,205,220,108,991,0,0
2903,863,754,1069,973,1,11,14,206,219,109,991,0,0
2904,863,754,1069,973,1,11,14,206,219,110,991,0,0
2905,863,754,1069,973,1,11,14,206,219,111,991,0,0
2906,862,756,1066,974,1,11,14,204,218,112,991,0,0
2907,861,756,1066,974,1,11,14,205,218,113,991,0,0
2908,861,756,1066,974,1,11,14,205,218,114,991,0,0
2909,861,756,1066,975,1,11,14,205,219,115,991,0,0
2910,861,757,1066,975,1,11,14,205,218,116,991,0,0
2911,861,757,1065,974,1,11,14,204,217,117,991,0,0
2912,861,757,1065,974,1,11,14,204,217,118,991,0,0
2913,861,757,1065,974,1,11,14,204,217,119,991,0,0
2914,861,757,1065,973,1,11,14,204,216,120,991,0,0
2915,861,757,1065,973,1,11,14,204,216,121,991,0,0
2916,862,757,1066,973,1,11,14,204,216,122,991,0,0
2917,862,757,1066,973,1,11,14,204,216,123,991,0,0
2918,862,757,1066,972,1,11,14,204,215,124,991,0,0
2919,862,753,1067,970,1,11,14,205,217,125,991,0,0
2920,862,755,1066,972,1,11,14,204,217,126,991,0,0
2921,860,756,1066,974,1,11,14,206,218,127,991,0,0
2922,861,756,1065,973,1,11,14,204,217,128,991,0,0
2923,860,756,1064,973,1,11,14,204,217,129,991,0,0
2924,860,757,1064,973,1,11,14,204,216,130,991,0,0
2925,860,757,1065,973,1,11,14,205,216,131,991,0,0
2926,861,757,1065,973,1,11,14,204,216,132,991,0,0
2927,860,757,1065,973,1,11,14,205,216,133,991,0,0
2928,860,757,1065,973,1,11,14,205,216,134,991,0,0
2929,860,756,1065,972,1,11,14,205,216,135,991,0,0
2930,860,756,1065,973,1,11,14,205,217,136,991,0,0
2931,861,755,1067,973,1,11,14,206,218,137,991,0,0
2932,862,755,1068,973,1,11,14,206,218,138,991,0,0
2933,861,757,1066,974,1,11,14,205,217,139,991,0,0
2934,861,757,1066,973,1,11,14,205,216,140,991,0,0
2935,861,757,1066,974,1,11,14,205,217,141,991,0,0
2936,861,757,1066,974,1,11,14,205,217,142,991,0,0
2937,861,757,1066,974,1,11,14,205,217,143,991,0,0
2938,861,757,1066,974,1,11,14,205,217,144,991,0,0
2939,861,757,1066,974,1,11,14,205,217,145,991,0,0
2940,861,757,1066,974,1,11,14,205,217,146,991,0,0
2941,861,757,1066,974,1,11,14,205,217,147,991,0,0
2942,861,757,1065,974,1,11,14,204,217,148,991,0,0
2943,861,758,1066,974,1,11,14,205,216,149,991,0,0
2944,861,758,1066,974,1,11,14,205,216,150,991,0,0
2945,862,756,1067,973,1,11,14,205,217,151,991,0,0
2946,861,756,1067,974,1,11,14,206,218,152,991,0,0
2947,861,756,1066,974,1,11,14,205,218,153,991,0,0
2948,861,756,1066,974,1,11,14,205,218,154,991,0,0
2949,861,756,1066,974,1,11,14,205,218,155,991,0,0
2950,860,756,1066,974,1,11,14,206,218,156,991,0,0
2951,861,756,1066,974,1,11,14,205,218,157,991,0,0
2952,860,756,1066,974,1,11,14,206,218,158,991,0,0
2953,860,756,1066,974,1,11,14,206,218,159,991,0,0
2954,860,756,1066,974,1,11,14,206,218,160,991,0,0
2955,860,756,1066,974,1,11,14,206,218,161,991,0,0
2956,861,755,1067,973,1,11,14,206,218,162,991,0,0
2957,861,754,1067,972,1,11,14,206,218,163,991,0,0
2958,861,755,1066,972,1,11,14,205,217,164,991,0,0
2959,860,755,1066,972,1,11,14,206,217,165,991,0,0
2960,860,755,1066,972,1,11,14,206,217,166,991,0,0
2961,860,755,1066,972,1,11,14,206,217,167,991,0,0
2962,859,755,1066,973,1,11,14,207,218,168,991,0,0
2963,859,755,1066,974,1,11,14,207,219,169,991,0,0
2964,859,755,1066,974,1,11,14,207,219,170,991,0,0
2965,859,755,1066,974,1,11,14,207,219,171,991,0,0
2966,859,755,1067,975,1,11,14,208,220,172,991,0,0
2967,860,755,1067,974,1,11,14,207,219,173,991,0,0
2968,860,755,1067,974,1,11,14,207,219,174,991,0,0
2969,861,755,1067,974,1,11,14,206,219,175,991,0,0
2970,860,755,1067,975,1,11,14,207,220,176,991,0,0
2971,862,755,1069,975,1,11,14,207,220,177,991,0,0
2972,863,755,1070,975,1,11,14,207,220,178,991,0,0
2973,863,754,1070,975,1,11,14,207,221,179,991,0,0
2974,863,754,1070,975,1,11,14,207,221,180,991,0,0
2975,863,754,1070,975,1,11,14,207,221,181,991,0,0
2976,864,754,1068,971,1,11,14,204,217,182,991,0,0
2977,864,754,1068,971,1,11,14,204,217,183,991,0,0
2978,863,753,1067,970,1,11,14,204,217,184,991,0,0
2979,863,753,1068,970,1,11,14,205,217,185,991,0,0
2980,864,753,1068,970,1,11,14,204,217,186,991,0,0
2981,863,754,1068,972,1,11,14,205,218,187,991,0,0
2982,862,754,1068,973,1,11,14,206,219,188,991,0,0
2983,863,754,1068,973,1,11,14,205,219,189,991,0,0
2984,863,754,1068,973,1,11,14,205,219,190,991,0,0
2985,862,754,1069,974,1,11,14,207,220,191,991,0,0
2986,862,754,1068,974,1,11,14,206,220,192,991,0,0
2987,859,751,1067,973,1,11,14,208,222,193,991,0,0
2988,860,755,1067,975,1,11,14,207,220,194,991,0,0
2989,860,756,1066,976,1,11,14,206,220,195,991,0,0
2990,860,757,1065,976,1,11,14,205,219,196,991,0,0
2991,861,757,1065,974,1,11,14,204,217,197,991,0,0
2992,861,758,1065,974,1,11,14,204,216,198,991,0,0
2993,861,758,1064,974,1,11,14,203,216,199,991,0,0
2994,861,758,1064,974,1,11,14,203,216,200,991,0,0
2995,860,757,1065,973,1,11,14,205,216,201,991,0,0
2996,858,751,1067,973,1,11,14,209,222,202,991,0,0
2997,858,755,1066,975,1,11,14,208,220,203,991,0,0
2998,858,753,1067,975,1,11,14,209,222,204,991,0,0
2999,857,751,1068,976,1,11,14,211,225,205,991,0,0
3000,858,748,1068,973,1,11,14,210,225,206,991,0,0
3001,858,745,1068,970,1,11,14,210,225,207,991,0,0
3002,860,748,1064,966,1,11,14,204,218,208,991,0,0
3003,861,750,1064,967,1,11,14,203,217,209,991,0,0
3004,860,754,1062,968,1,11,14,202,214,210,991,0,0
3005,860,756,1061,968,1,11,14,201,212,211,991,0,0
3006,860,754,1064,969,1,11,14,204,215,212,991,0,0
3007,861,754,1067,971,1,11,14,206,217,213,991,0,0
3008,862,753,1070,973,1,11,14,208,220,214,991,0,0
3009,859,755,1066,973,1,11,14,207,218,215,991,0,0
3010,859,755,1066,973,1,11,14,207,218,216,991,0,0
3011,859,755,1067,975,1,11,14,208,220,217,991,0,0
3012,861,754,1070,975,1,11,14,209,221,218,991,0,0
3013,861,754,1071,976,1,11,14,210,222,219,991,0,0
3014,861,754,1072,976,1,11,14,211,222,220,991,0,0
3015,862,754,1071,976,1,11,14,209,222,221,991,0,0
3016,861,756,1069,976,1,11,14,208,220,222,991,0,0
3017,860,755,1068,975,1,11,14,208,220,223,991,0,0
3018,862,753,1070,973,1,11,14,208,220,224,991,0,0
3019,861,756,1068,975,1,11,14,207,219,225,991,0,0
3020,862,753,1070,973,1,11,14,208,220,226,991,0,0
3021,860,755,1068,974,1,11,14,208,219,227,991,0,0
3022,860,755,1068,975,1,11,14,208,220,228,991,0,0
3023,859,755,1067,975,1,11,14,208,220,229,991,0,0
3024,862,754,1069,974,1,11,14,207,220,230,991,0,0
3025,862,754,1070,974,1,11,14,208,220,231,991,0,0
3026,861,754,1068,974,1,11,14,207,220,232,991,0,0
3027,861,754,1067,973,1,11,14,206,219,233,991,0,0
3028,861,755,1067,973,1,11,14,206,218,234,991,0,0
3029,861,755,1067,972,1,11,14,206,217,235,991,0,0
3030,861,755,1067,972,1,11,14,206,217,236,991,0,0
3031,862,754,1069,972,1,11,14,207,218,237,991,0,0
3032,863,754,1070,973,1,11,14,207,219,238,991,0,0
3033,863,754,1071,973,1,11,14,208,219,239,991,0,0
3034,863,753,1070,973,1,11,14,207,220,240,991,0,0
3035,864,753,1070,973,1,11,14,206,220,241,991,0,0
3036,862,757,1067,973,1,11,14,205,216,242,991,0,0
3037,862,758,1067,974,1,11,14,205,216,243,991,0,0
3038,861,757,1067,974,1,11,14,206,217,244,991,0,0
3039,860,757,1067,974,1,11,14,207,217,245,991,0,0
3040,860,757,1067,974,1,11,14,207,217,246,991,0,0
3041,860,757,1068,975,1,11,14,208,218,247,991,0,0
3042,862,755,1069,973,1,11,14,207,218,248,991,0,0
3043,862,757,1068,975,1,11,14,206,218,249,991,0,0
3044,863,756,1070,974,1,11,14,207,218,250,991,0,0
3045,862,757,1068,975,1,11,14,206,218,251,991,0,0
3046,861,756,1068,973,1,11,14,207,217,252,991,0,0
3047,862,756,1068,973,1,11,14,206,217,253,991,0,0
3048,861,756,1067,972,1,11,14,206,216,254,991,0,0
3049,861,756,1068,972,1,11,14,207,216,255,991,0,0
3050,863,754,1069,970,1,11,14,206,216,256,991,0,0
3051,864,754,1070,971,1,11,14,206,217,257,991,0,0
3052,864,755,1070,972,1,11,14,206,217,258,991,0,0
3053,863,755,1070,972,1,11,14,207,217,259,991,0,0
3054,863,755,1070,972,1,11,14,207,217,260,991,0,0
3055,864,754,1070,972,1,11,14,206,218,261,991,0,0
3056,863,754,1070,971,1,11,14,207,217,262,991,0,0
3057,861,756,1068,973,1,11,14,207,217,263,991,0,0
3058,861,756,1068,973,1,11,14,207,217,264,991,0,0
3059,862,754,1069,971,1,11,14,207,217,265,991,0,0
3060,861,756,1068,973,1,11,14,207,217,266,991,0,0
3061,860,756,1068,973,1,11,14,208,217,267,991,0,0
3062,860,756,1067,973,1,11,14,207,217,268,991,0,0
3063,860,756,1067,972,1,11,14,207,216,269,991,0,0
3064,860,756,1067,972,1,11,14,207,216,270,991,0,0
3065,862,753,1068,969,1,11,14,206,216,271,991,0,0
3066,861,755,1067,971,1,11,14,206,216,272,991,0,0
3067,861,755,1066,971,1,11,14,205,216,273,991,0,0
3068,860,755,1066,971,1,11,14,206,216,274,991,0,0
3069,860,755,1066,971,1,11,14,206,216,275,991,0,0
3070,860,755,1066,971,1,11,14,206,216,276,991,0,0
3071,860,755,1067,973,1,11,14,207,218,277,991,0,0
3072,860,756,1067,973,1,11,14,207,217,278,991,0,0
3073,860,756,1067,973,1,11,14,207,217,279,991,0,0
3074,860,756,1067,974,1,11,14,207,218,280,991,0,0
3075,860,756,1067,974,1,11,14,207,218,281,991,0,0
3076,861,756,1067,973,1,11,14,206,217,282,991,0,0
3077,861,756,1067,972,1,11,14,206,216,283,991,0,0
3078,861,757,1066,972,1,11,14,205,215,284,991,0,0
3079,861,756,1067,972,1,11,14,206,216,285,991,0,0
3080,862,756,1066,970,1,11,14,204,214,286,991,0,0
3081,861,758,1064,971,1,11,14,203,213,287,991,0,0
3082,859,753,1065,968,1,11,14,206,215,288,991,0,0
3083,858,754,1065,971,1,11,14,207,217,289,991,0,0
3084,857,751,1066,970,1,11,14,209,219,290,991,0,0
3085,861,753,1066,968,1,11,14,205,215,291,991,0,0
3086,860,755,1066,972,1,11,14,206,217,292,991,0,0
3087,859,756,1066,973,1,11,14,207,217,293,991,0,0
3088,860,757,1066,973,1,11,14,206,216,294,991,0,0
3089,860,757,1066,974,1,11,14,206,217,295,991,0,0
3090,859,758,1066,974,1,11,14,207,216,296,991,0,0
3091,860,758,1066,975,1,11,14,206,217,297,991,0,0
3092,861,759,1066,974,1,11,14,205,215,298,991,0,0
3093,861,759,1065,974,1,11,14,204,215,299,991,0,0
3094,861,759,1066,974,1,11,14,205,215,300,991,0,0
3095,860,759,1066,974,1,11,14,206,215,301,991,0,0
3096,860,758,1066,974,1,11,14,206,216,302,991,0,0
3097,860,758,1066,973,1,11,14,206,215,303,991,0,0
3098,860,758,1066,973,1,11,14,206,215,304,991,0,0
3099,860,758,1066,973,1,11,14,206,215,305,991,0,0
3100,860,758,1066,972,1,11,14,206,214,306,991,0,0
3101,860,755,1068,972,1,11,14,208,217,307,991,0,0
3102,862,755,1069,970,1,11,14,207,215,308,991,0,0
3103,861,756,1068,972,1,11,14,207,216,309,991,0,0
3104,861,754,1070,972,1,11,14,209,218,310,991,0,0
3105,861,754,1071,973,1,11,14,210,219,311,991,0,0
3106,862,755,1071,974,1,11,14,209,219,312,991,0,0
3107,862,755,1071,974,1,11,14,209,219,313,991,0,0
3108,862,755,1070,974,1,11,14,208,219,314,991,0,0
3109,862,755,1070,974,1,11,14,208,219,315,991,0,0
3110,863,755,1070,974,1,11,14,207,219,316,991,0,0
3111,864,757,1069,974,1,11,14,205,217,317,991,0,0
3112,863,760,1068,976,1,11,14,205,216,318,991,0,0
3113,863,761,1068,976,1,11,14,205,215,319,991,0,0
3114,862,762,1068,977,1,11,14,206,215,320,991,0,0
3115,862,762,1068,977,1,11,14,206,215,321,991,0,0
3116,862,760,1067,976,1,11,14,205,216,322,991,0,0
3117,862,761,1066,975,1,11,14,204,214,323,991,0,0
3118,861,762,1065,975,1,11,14,204,213,324,991,0,0
3119,861,762,1065,975,1,11,14,204,213,325,991,0,0
3120,861,762,1065,975,1,11,14,204,213,326,991,0,0
3121,859,754,1068,973,1,11,14,209,219,327,991,0,0
3122,859,752,1069,972,1,11,14,210,220,328,991,0,0
3123,858,751,1069,972,1,11,14,211,221,329,991,0,0
3124,861,754,1070,973,1,11,14,209,219,330,991,0,0
3125,863,755,1070,973,1,11,14,207,218,331,991,0,0
3126,862,757,1067,972,1,11,14,205,215,332,991,0,0
3127,862,758,1066,972,1,11,14,204,214,333,991,0,0
3128,861,758,1066,972,1,11,14,205,214,334,991,0,0
3129,861,759,1066,972,1,11,14,205,213,335,991,0,0
3130,861,758,1066,972,1,11,14,205,214,336,991,0,0
3131,861,758,1066,973,1,11,14,205,215,337,991,0,0
3132,860,758,1067,973,1,11,14,207,215,338,991,0,0
3133,862,756,1067,971,1,11,14,205,215,339,991,0,0
3134,863,756,1068,969,1,11,14,205,213,340,991,0,0
3135,862,755,1068,969,1,11,14,206,214,341,991,0,0
3136,861,758,1066,973,1,11,14,205,215,342,991,0,0
3137,860,760,1066,974,1,11,14,206,214,343,991,0,0
3138,860,760,1066,974,1,11,14,206,214,344,991,0,0
3139,859,761,1067,975,1,11,14,208,214,345,991,0,0
3140,859,761,1067,975,1,11,14,208,214,346,991,0,0
3141,860,761,1067,975,1,11,14,207,214,347,991,0,0
3142,859,760,1068,975,1,11,14,209,215,348,991,0,0
3143,862,758,1070,973,1,11,14,208,215,349,991,0,0
3144,862,756,1070,972,1,11,14,208,216,350,991,0,0
3145,862,755,1071,972,1,11,14,209,217,351,991,0,0
3146,859,756,1068,974,1,11,14,209,218,352,991,0,0
3147,859,755,1070,975,1,11,14,211,220,353,991,0,0
3148,857,752,1069,974,1,11,14,212,222,354,991,0,0
3149,856,750,1068,974,1,11,14,212,224,355,991,0,0
3150,857,754,1067,976,1,11,14,210,222,356,991,0,0
3151,860,756,1068,975,1,11,14,208,219,357,991,0,0
3152,862,754,1069,973,1,11,14,207,219,358,991,0,0
3153,863,753,1070,973,1,11,14,207,220,359,991,0,0
3154,864,753,1070,972,1,11,14,206,219,360,991,0,0
3155,864,753,1070,972,1,11,14,206,219,361,991,0,0
3156,864,753,1069,971,1,11,14,205,218,362,991,0,0
3157,862,755,1067,973,1,11,14,205,218,363,991,0,0
3158,862,757,1066,974,1,11,14,204,217,364,991,0,0
3159,862,757,1066,974,1,11,14,204,217,365,991,0,0
3160,861,757,1065,975,1,11,14,204,218,366,991,0,0
3161,862,755,1068,975,1,11,14,206,220,367,991,0,0
3162,863,755,1069,975,1,11,14,206,220,368,991,0,0
3163,863,755,1070,975,1,11,14,207,220,369,991,0,0
3164,863,754,1070,976,1,11,14,207,222,370,991,0,0
3165,863,754,1069,975,1,11,14,206,221,371,991,0,0
3166,864,754,1068,971,1,11,14,204,217,372,991,0,0
3167,864,754,1068,971,1,11,14,204,217,373,991,0,0
3168,862,756,1066,973,1,11,14,204,217,374,991,0,0
3169,861,757,1066,974,1,11,14,205,217,375,991,0,0
3170,861,757,1065,974,1,11,14,204,217,376,991,0,0
3171,864,756,1066,970,1,11,14,202,214,377,991,0,0
3172,864,754,1067,968,1,11,14,203,214,378,991,0,0
3173,864,753,1067,967,1,11,14,203,214,379,991,0,0
3174,864,753,1067,967,1,11,14,203,214,380,991,0,0
3175,864,753,1067,967,1,11,14,203,214,381,991,0,0
3176,863,756,1067,971,1,11,14,204,215,382,991,0,0
3177,861,752,1068,970,1,11,14,207,218,383,991,0,0
3178,861,750,1066,968,1,11,14,205,218,384,991,0,0
3179,860,748,1068,969,1,11,14,208,221,385,991,0,0
3180,860,745,1071,970,1,11,14,211,225,386,991,0,0
3181,860,745,1068,968,1,11,14,208,223,387,991,0,0
3182,862,749,1065,965,1,11,14,203,216,388,991,0,0
3183,862,751,1061,963,1,11,14,199,212,389,991,0,0
3184,860,753,1060,966,1,11,14,200,213,390,991,0,0
3185,861,753,1063,967,1,11,14,202,214,391,991,0,0
3186,862,753,1064,967,1,11,14,202,214,392,991,0,0
3187,865,753,1064,965,1,11,14,199,212,393,991,0,0
3188,864,753,1064,966,1,11,14,200,213,394,991,0,0
3189,863,753,1064,965,1,11,14,201,212,395,991,0,0
3190,863,756,1064,967,1,11,14,201,211,396,991,0,0
3191,864,754,1069,969,1,11,14,205,215,397,991,0,0
3192,863,754,1069,971,1,11,14,206,217,398,991,0,0
3193,862,754,1070,971,1,11,14,208,217,399,991,0,0
3194,861,754,1070,972,1,11,14,209,218,400,991,0,0
3195,862,753,1072,972,1,11,14,210,219,401,991,0,0
3196,860,749,1072,971,1,11,14,212,222,402,991,0,0
3197,859,751,1070,972,1,11,14,211,221,403,991,0,0
3198,858,749,1071,972,1,11,14,213,223,404,991,0,0
3199,858,748,1070,971,1,11,14,212,223,405,991,0,0
3200,858,753,1070,975,1,11,14,212,222,406,991,0,0
3201,858,750,1071,975,1,11,14,213,225,407,991,0,0
3202,857,749,1071,975,1,11,14,214,226,408,991,0,0
3203,858,749,1071,974,1,11,14,213,225,409,991,0,0
3204,858,748,1071,974,1,11,14,213,226,410,991,0,0
3205,858,748,1071,974,1,11,14,213,226,411,991,0,0
3206,858,748,1070,974,1,11,14,212,226,412,991,0,0
3207,858,748,1070,974,1,11,14,212,226,413,991,0,0
3208,858,748,1070,974,1,11,14,212,226,414,991,0,0
3209,859,752,1069,976,1,11,14,210,224,415,991,0,0
3210,859,750,1069,975,1,11,14,210,225,416,991,0,0
3211,859,749,1069,973,1,11,14,210,224,417,991,0,0
3212,859,749,1069,973,1,11,14,210,224,418,991,0,0
3213,860,750,1068,973,1,11,14,208,223,419,991,0,0
3214,861,754,1067,974,1,11,14,206,220,420,991,0,0
3215,861,755,1067,975,1,11,14,206,220,421,991,0,0
3216,860,757,1068,978,1,11,14,208,221,422,991,0,0
3217,860,758,1069,980,1,11,14,209,222,423,991,0,0
3218,859,758,1069,980,1,11,14,210,222,424,991,0,0
3219,859,758,1069,979,1,11,14,210,221,425,991,0,0
3220,859,757,1069,980,1,11,14,210,223,426,991,0,0
3221,857,752,1069,975,1,11,14,212,223,427,991,0,0
3222,857,749,1068,973,1,11,14,211,224,428,991,0,0
3223,857,749,1068,973,1,11,14,211,224,429,991,0,0
3224,857,754,1067,976,1,11,14,210,222,430,991,0,0
3225,857,750,1068,974,1,11,14,211,224,431,991,0,0
3226,861,752,1070,975,1,11,14,209,223,432,991,0,0
3227,862,753,1071,975,1,11,14,209,222,433,991,0,0
3228,863,753,1071,975,1,11,14,208,222,434,991,0,0
3229,860,750,1070,975,1,11,14,210,225,435,991,0,0
3230,859,749,1069,975,1,11,14,210,226,436,991,0,0
3231,860,749,1067,971,1,11,14,207,222,437,991,0,0
3232,860,749,1067,970,1,11,14,207,221,438,991,0,0
3233,860,749,1066,970,1,11,14,206,221,439,991,0,0
3234,859,749,1066,970,1,11,14,207,221,440,991,0,0
3235,861,755,1065,972,1,11,14,204,217,441,991,0,0
3236,861,757,1067,977,1,11,14,206,220,442,991,0,0
3237,860,758,1068,979,1,11,14,208,221,443,991,0,0
3238,860,759,1068,979,1,11,14,208,220,444,991,0,0
3239,861,759,1067,978,1,11,14,206,219,445,991,0,0
3240,862,756,1069,977,1,11,14,207,221,446,991,0,0
3241,861,757,1068,977,1,11,14,207,220,447,991,0,0
3242,860,757,1068,977,1,11,14,208,220,448,991,0,0
3243,860,757,1067,976,1,11,14,207,219,449,991,0,0
3244,858,751,1068,974,1,11,14,210,223,450,991,0,0
3245,859,753,1067,974,1,11,14,208,221,451,991,0,0
3246,861,755,1066,973,1,11,14,205,218,452,991,0,0
3247,861,756,1065,973,1,11,14,204,217,453,991,0,0
3248,861,756,1066,973,1,11,14,205,217,454,991,0,0
3249,861,757,1066,974,1,11,14,205,217,455,991,0,0
3250,860,756,1067,974,1,11,14,207,218,456,991,0,0
3251,860,756,1067,975,1,11,14,207,219,457,991,0,0
3252,859,756,1066,975,1,11,14,207,219,458,991,0,0
3253,857,751,1067,974,1,11,14,210,223,459,991,0,0
3254,860,754,1066,974,1,11,14,206,220,460,991,0,0
3255,857,750,1067,974,1,11,14,210,224,461,991,0,0
3256,858,750,1068,974,1,11,14,210,224,462,991,0,0
3257,861,756,1067,975,1,11,14,206,219,463,991,0,0
3258,862,758,1066,976,1,11,14,204,218,464,991,0,0
3259,863,756,1067,972,1,11,14,204,216,465,991,0,0
3260,862,758,1067,974,1,11,14,205,216,466,991,0,0
3261,860,752,1068,973,1,11,14,208,221,467,991,0,0
3262,859,750,1068,973,1,11,14,209,223,468,991,0,0
3263,859,750,1068,973,1,11,14,209,223,469,991,0,0
3264,859,749,1069,974,1,11,14,210,225,470,991,0,0
3265,860,754,1067,976,1,11,14,207,222,471,991,0,0
3266,858,751,1068,976,1,11,14,210,225,472,991,0,0
3267,860,755,1067,976,1,11,14,207,221,473,991,0,0
3268,859,751,1067,975,1,11,14,208,224,474,991,0,0
3269,859,750,1068,975,1,11,14,209,225,475,991,0,0
3270,859,750,1067,975,1,11,14,208,225,476,991,0,0
3271,861,755,1066,976,1,11,14,205,221,477,991,0,0
3272,860,752,1067,974,1,11,14,207,222,478,991,0,0
3273,860,755,1067,976,1,11,14,207,221,479,991,0,0
3274,860,757,1067,977,1,11,14,207,220,480,991,0,0
3275,863,755,1069,975,1,11,14,206,220,481,991,0,0
3276,860,751,1068,973,1,11,14,208,222,482,991,0,0
3277,859,749,1067,973,1,11,14,208,224,483,991,0,0
3278,858,749,1067,972,1,11,14,209,223,484,991,0,0
3279,858,748,1067,973,1,11,14,209,225,485,991,0,0
3280,858,748,1067,973,1,11,14,209,225,486,991,0,0
3281,858,748,1067,973,1,11,14,209,225,487,991,0,0
3282,861,754,1066,974,1,11,14,205,220,488,991,0,0
3283,860,751,1066,973,1,11,14,206,222,489,991,0,0
3284,861,755,1066,975,1,11,14,205,220,490,991,0,0
3285,860,751,1067,974,1,11,14,207,223,491,991,0,0
3286,859,749,1067,974,1,11,14,208,225,492,991,0,0
3287,859,749,1067,974,1,11,14,208,225,493,991,0,0
3288,859,748,1067,974,1,11,14,208,226,494,991,0,0
3289,860,753,1065,975,1,11,14,205,222,495,991,0,0
3290,859,750,1066,974,1,11,14,207,224,496,991,0,0
3291,862,752,1067,975,1,11,14,205,223,497,991,0,0
3292,863,754,1067,975,1,11,14,204,221,498,991,0,0
3293,861,755,1065,977,1,11,14,204,222,499,991,0,0
3294,863,755,1067,976,1,11,14,204,221,500,991,0,0
3295,863,754,1067,976,1,11,14,204,222,501,991,0,0
3296,861,751,1067,974,1,11,14,206,223,502,991,0,0
3297,860,750,1066,974,1,11,14,206,224,503,991,0,0
3298,861,754,1065,975,1,11,14,204,221,504,991,0,0
3299,860,750,1066,974,1,11,14,206,224,505,991,0,0
3300,861,754,1066,975,1,11,14,205,221,506,991,0,0
3301,862,756,1066,975,1,11,14,204,219,507,991,0,0
3302,862,756,1066,976,1,11,14,204,220,508,991,0,0
3303,861,752,1067,974,1,11,14,206,222,509,991,0,0
3304,863,754,1068,974,1,11,14,205,220,510,991,0,0
3305,862,756,1066,975,1,11,14,204,219,511,991,0,0
3306,864,755,1066,972,1,11,14,202,217,512,991,0,0
3307,860,752,1066,974,1,11,14,206,222,513,991,0,0
3308,858,751,1066,975,1,11,14,208,224,514,991,0,0
3309,860,751,1065,972,1,11,14,205,221,515,991,0,0
3310,859,751,1066,974,1,11,14,207,223,516,991,0,0
3311,860,750,1067,973,1,11,14,207,223,517,991,0,0
3312,859,750,1067,973,1,11,14,208,223,518,991,0,0
3313,861,755,1066,976,1,11,14,205,221,519,991,0,0
3314,860,756,1065,976,1,11,14,205,220,520,991,0,0
3315,861,756,1065,977,1,11,14,204,221,521,991,0,0
3316,861,757,1065,977,1,11,14,204,220,522,991,0,0
3317,861,757,1065,977,1,11,14,204,220,523,991,0,0
3318,863,755,1067,976,1,11,14,204,221,524,991,0,0
3319,863,755,1068,975,1,11,14,205,220,525,991,0,0
3320,862,754,1067,975,1,11,14,205,221,526,991,0,0
3321,862,756,1064,973,1,11,14,202,217,527,991,0,0
3322,862,757,1063,972,1,11,14,201,215,528,991,0,0
3323,862,758,1063,972,1,11,14,201,214,529,991,0,0
3324,863,759,1063,971,1,11,14,200,212,530,991,0,0
3325,864,757,1065,969,1,11,14,201,212,531,991,0,0
3326,860,752,1068,972,1,11,14,208,220,532,991,0,0
3327,859,750,1069,973,1,11,14,210,223,533,991,0,0
3328,858,750,1069,974,1,11,14,211,224,534,991,0,0
3329,860,754,1068,976,1,11,14,208,222,535,991,0,0
3330,859,751,1069,975,1,11,14,210,224,536,991,0,0
3331,859,754,1068,977,1,11,14,209,223,537,991,0,0
3332,861,755,1070,978,1,11,14,209,223,538,991,0,0
3333,862,755,1070,978,1,11,14,208,223,539,991,0,0
3334,863,755,1070,977,1,11,14,207,222,540,991,0,0
3335,863,755,1070,977,1,11,14,207,222,541,991,0,0
3336,862,751,1066,970,1,11,14,204,219,542,991,0,0
3337,863,757,1063,970,1,11,14,200,213,543,991,0,0
3338,862,759,1061,970,1,11,14,199,211,544,991,0,0
3339,862,753,1062,966,1,11,14,200,213,545,991,0,0
3340,859,754,1062,969,1,11,14,203,215,546,991,0,0
3341,859,751,1065,971,1,11,14,206,220,547,991,0,0
3342,860,756,1066,973,1,11,14,206,217,548,991,0,0
3343,861,758,1065,973,1,11,14,204,215,549,991,0,0
3344,860,758,1066,974,1,11,14,206,216,550,991,0,0
3345,860,758,1066,974,1,11,14,206,216,551,991,0,0
3346,860,752,1066,969,1,11,14,206,217,552,991,0,0
3347,861,750,1066,966,1,11,14,205,216,553,991,0,0
3348,860,756,1065,969,1,11,14,205,213,554,991,0,0
3349,858,755,1065,971,1,11,14,207,216,555,991,0,0
3350,859,751,1066,967,1,11,14,207,216,556,991,0,0
3351,862,754,1069,970,1,11,14,207,216,557,991,0,0
3352,862,755,1070,972,1,11,14,208,217,558,991,0,0
3353,862,755,1070,972,1,11,14,208,217,559,991,0,0
3354,859,752,1069,971,1,11,14,210,219,560,991,0,0
3355,858,750,1068,971,1,11,14,210,221,561,991,0,0
3356,857,753,1065,973,1,11,14,208,220,562,991,0,0
3357,858,756,1066,974,1,11,14,208,218,563,991,0,0
3358,857,751,1066,971,1,11,14,209,220,564,991,0,0
3359,857,749,1066,971,1,11,14,209,222,565,991,0,0
3360,857,749,1065,969,1,11,14,208,220,566,991,0,0
3361,860,754,1066,973,1,11,14,206,219,567,991,0,0
3362,862,753,1067,971,1,11,14,205,218,568,991,0,0
3363,861,753,1068,971,1,11,14,207,218,569,991,0,0
3364,861,753,1067,971,1,11,14,206,218,570,991,0,0
3365,860,753,1068,973,1,11,14,208,220,571,991,0,0
3366,859,751,1067,972,1,11,14,208,221,572,991,0,0
3367,861,754,1066,972,1,11,14,205,218,573,991,0,0
3368,861,756,1066,973,1,11,14,205,217,574,991,0,0
3369,861,757,1065,973,1,11,14,204,216,575,991,0,0
3370,859,752,1065,970,1,11,14,206,218,576,991,0,0
3371,859,756,1066,975,1,11,14,207,219,577,991,0,0
3372,860,758,1066,975,1,11,14,206,217,578,991,0,0
3373,859,758,1066,976,1,11,14,207,218,579,991,0,0
3374,859,759,1066,977,1,11,14,207,218,580,991,0,0
3375,859,759,1067,977,1,11,14,208,218,581,991,0,0
3376,858,753,1068,973,1,11,14,210,220,582,991,0,0
3377,859,751,1069,972,1,11,14,210,221,583,991,0,0
3378,859,750,1068,971,1,11,14,209,221,584,991,0,0
3379,859,749,1068,971,1,11,14,209,222,585,991,0,0
3380,859,749,1068,971,1,11,14,209,222,586,991,0,0
3381,861,755,1066,972,1,11,14,205,217,587,991,0,0
3382,863,753,1066,968,1,11,14,203,215,588,991,0,0
3383,863,756,1065,969,1,11,14,202,213,589,991,0,0
3384,863,758,1064,968,1,11,14,201,210,590,991,0,0
3385,863,758,1065,969,1,11,14,202,211,591,991,0,0
3386,863,758,1066,969,1,11,14,203,211,592,991,0,0
3387,861,757,1065,970,1,11,14,204,213,593,991,0,0
3388,862,757,1066,969,1,11,14,204,212,594,991,0,0
3389,863,758,1066,969,1,11,14,203,211,595,991,0,0
3390,863,758,1066,968,1,11,14,203,210,596,991,0,0
3391,861,757,1066,969,1,11,14,205,212,597,991,0,0
3392,862,757,1068,969,1,11,14,206,212,598,991,0,0
3393,861,757,1068,971,1,11,14,207,214,599,991,0,0
3394,859,757,1067,971,1,11,14,208,214,600,991,0,0
3395,860,757,1068,971,1,11,14,208,214,601,991,0,0
3396,862,758,1069,971,1,11,14,207,213,602,991,0,0
3397,861,754,1070,969,1,11,14,209,215,603,991,0,0
3398,862,757,1069,970,1,11,14,207,213,604,991,0,0
3399,861,754,1070,968,1,11,14,209,214,605,991,0,0
3400,862,757,1069,970,1,11,14,207,213,606,991,0,0
3401,863,758,1068,968,1,11,14,205,210,607,991,0,0
3402,862,754,1069,966,1,11,14,207,212,608,991,0,0
3403,862,757,1068,967,1,11,14,206,210,609,991,0,0
3404,862,759,1067,968,1,11,14,205,209,610,991,0,0
3405,862,759,1068,968,1,11,14,206,209,611,991,0,0
3406,861,759,1067,969,1,11,14,206,210,612,991,0,0
3407,861,759,1067,969,1,11,14,206,210,613,991,0,0
3408,861,759,1066,968,1,11,14,205,209,614,991,0,0
3409,860,757,1069,969,1,11,14,209,212,615,991,0,0
3410,861,758,1068,969,1,11,14,207,211,616,991,0,0
3411,858,756,1068,970,1,11,14,210,214,617,991,0,0
3412,859,755,1069,969,1,11,14,210,214,618,991,0,0
3413,860,753,1071,967,1,11,14,211,214,619,991,0,0
3414,860,754,1070,968,1,11,14,210,214,620,991,0,0
3415,859,754,1070,968,1,11,14,211,214,621,991,0,0
3416,861,756,1070,969,1,11,14,209,213,622,991,0,0
3417,860,756,1069,969,1,11,14,209,213,623,991,0,0
3418,861,756,1070,969,1,11,14,209,213,624,991,0,0
3419,861,756,1070,969,1,11,14,209,213,625,991,0,0
3420,861,755,1071,970,1,11,14,210,215,626,991,0,0
3421,861,756,1070,970,1,11,14,209,214,627,991,0,0
3422,860,753,1070,968,1,11,14,210,215,628,991,0,0
3423,861,756,1069,969,1,11,14,208,213,629,991,0,0
3424,861,757,1070,970,1,11,14,209,213,630,991,0,0
3425,861,757,1070,970,1,11,14,209,213,631,991,0,0
3426,861,758,1068,969,1,11,14,207,211,632,991,0,0
3427,861,758,1068,969,1,11,14,207,211,633,991,0,0
3428,862,758,1068,969,1,11,14,206,211,634,991,0,0
3429,862,759,1068,969,1,11,14,206,210,635,991,0,0
3430,862,758,1068,968,1,11,14,206,210,636,991,0,0
3431,861,754,1069,966,1,11,14,208,212,637,991,0,0
3432,861,753,1069,966,1,11,14,208,213,638,991,0,0
3433,861,753,1070,965,1,11,14,209,212,639,991,0,0
3434,860,756,1067,967,1,11,14,207,211,640,991,0,0
3435,860,757,1067,967,1,11,14,207,210,641,991,0,0
3436,861,756,1069,968,1,11,14,208,212,642,991,0,0
3437,861,756,1070,968,1,11,14,209,212,643,991,0,0
3438,862,756,1070,968,1,11,14,208,212,644,991,0,0
3439,861,755,1071,968,1,11,14,210,213,645,991,0,0
3440,862,757,1069,968,1,11,14,207,211,646,991,0,0
3441,861,758,1068,968,1,11,14,207,210,647,991,0,0
3442,861,755,1069,966,1,11,14,208,211,648,991,0,0
3443,860,757,1068,968,1,11,14,208,211,649,991,0,0
3444,860,758,1068,969,1,11,14,208,211,650,991,0,0
3445,861,754,1069,966,1,11,14,208,212,651,991,0,0
3446,861,756,1069,968,1,11,14,208,212,652,991,0,0
3447,860,758,1068,970,1,11,14,208,212,653,991,0,0
3448,860,759,1067,970,1,11,14,207,211,654,991,0,0
3449,859,759,1067,970,1,11,14,208,211,655,991,0,0
3450,861,758,1068,969,1,11,14,207,211,656,991,0,0
3451,860,758,1069,970,1,11,14,209,212,657,991,0,0
3452,860,758,1069,970,1,11,14,209,212,658,991,0,0
3453,860,758,1069,971,1,11,14,209,213,659,991,0,0
3454,860,758,1069,971,1,11,14,209,213,660,991,0,0
3455,859,758,1069,971,1,11,14,210,213,661,991,0,0
3456,859,758,1068,970,1,11,14,209,212,662,991,0,0
3457,859,759,1068,970,1,11,14,209,211,663,991,0,0
3458,860,759,1068,970,1,11,14,208,211,664,991,0,0
3459,860,759,1068,970,1,11,14,208,211,665,991,0,0
3460,860,759,1068,970,1,11,14,208,211,666,991,0,0
3461,859,757,1070,969,1,11,14,211,212,667,991,0,0
3462,860,758,1069,969,1,11,14,209,211,668,991,0,0
3463,859,757,1070,969,1,11,14,211,212,669,991,0,0
3464,860,760,1068,970,1,11,14,208,210,670,991,0,0
3465,861,758,1071,970,1,11,14,210,212,671,991,0,0
3466,860,758,1071,972,1,11,14,211,214,672,991,0,0
3467,859,754,1071,970,1,11,14,212,216,673,991,0,0
3468,859,757,1071,972,1,11,14,212,215,674,991,0,0
3469,860,758,1070,972,1,11,14,210,214,675,991,0,0
3470,860,755,1071,970,1,11,14,211,215,676,991,0,0
3471,860,757,1069,969,1,11,14,209,212,677,991,0,0
3472,860,757,1069,970,1,11,14,209,213,678,991,0,0
3473,860,757,1068,969,1,11,14,208,212,679,991,0,0
3474,859,753,1070,968,1,11,14,211,215,680,991,0,0
3475,861,756,1069,968,1,11,14,208,212,681,991,0,0
3476,860,754,1069,967,1,11,14,209,213,682,991,0,0
3477,861,759,1067,969,1,11,14,206,210,683,991,0,0
3478,862,756,1069,967,1,11,14,207,211,684,991,0,0
3479,862,758,1069,969,1,11,14,207,211,685,991,0,0
3480,861,760,1068,969,1,11,14,207,209,686,991,0,0
3481,861,760,1069,971,1,11,14,208,211,687,991,0,0
3482,862,761,1069,971,1,11,14,207,210,688,991,0,0
3483,860,757,1071,973,1,11,14,211,216,689,991,0,0
3484,860,755,1069,970,1,11,14,209,215,690,991,0,0
3485,860,758,1069,973,1,11,14,209,215,691,991,0,0
3486,859,755,1078,983,1,11,14,219,228,692,991,0,0
3487,796,746,1081,1042,1,11,14,285,296,693,991,0,0
3488,866,762,1154,1058,1,11,14,288,296,694,991,0,0
3489,865,762,1161,1066,1,11,14,296,304,695,991,0,0
252,0,458,62,708,2,11,14,62,250,0,26,0,1
253,12,472,73,719,2,11,14,61,247,1,26,0,0
254,15,458,86,736,2,11,14,71,278,2,26,0,0
255,16,449,96,760,2,11,14,80,311,3,26,0,0
256,20,462,103,778,2,11,14,83,316,4,26,0,0
257,28,465,115,786,2,11,14,87,321,5,26,0,0
258,40,464,134,798,2,11,14,94,334,6,26,0,0
259,45,467,146,815,2,11,14,101,348,7,26,0,0
260,52,470,163,836,2,11,14,111,366,8,26,0,0
261,57,476,177,858,2,11,14,120,382,9,26,0,0
262,79,484,208,874,2,11,14,129,390,10,26,0,0
263,93,488,235,897,2,11,14,142,409,11,26,0,0
264,96,490,251,920,2,11,14,155,430,12,26,0,0
265,101,504,271,964,2,11,14,170,460,13,26,0,0
266,106,516,286,988,2,11,14,180,472,14,26,0,0
267,134,535,325,1012,2,11,14,191,477,15,26,0,0
268,147,546,355,1050,2,11,14,208,504,16,26,0,0
269,154,555,375,1076,2,11,14,221,521,17,26,0,0
270,166,588,385,1080,2,11,14,219,492,18,26,0,0
271,175,607,399,1080,2,11,14,224,473,19,26,0,0
272,187,634,412,1080,2,11,14,225,446,20,26,0,0
273,209,660,437,1080,2,11,14,228,420,21,26,0,0
274,215,696,437,1080,2,11,14,222,384,22,26,0,0
275,203,756,409,1080,2,11,14,206,324,23,26,0,0
276,181,804,372,1075,2,11,14,191,271,24,26,0,0
277,158,883,314,1077,2,11,14,156,194,25,26,0,0
278,163,919,297,1080,2,11,14,134,161,26,26,1,0
257,0,469,52,690,3,11,14,52,221,0,0,0,0
609,2,466,49,711,5,11,14,47,245,0,24,0,1
610,19,466,69,723,5,11,14,50,257,1,24,0,0
611,21,445,79,736,5,11,14,58,291,2,24,0,0
612,21,434,88,759,5,11,14,67,325,3,24,0,0
613,26,445,98,783,5,11,14,72,338,4,24,0,0
614,32,448,107,787,5,11,14,75,339,5,24,0,0
615,56,452,140,798,5,11,14,84,346,6,24,0,0
616,74,457,166,812,5,11,14,92,355,7,24,0,0
617,80,452,182,832,5,11,14,102,380,8,24,0,0
618,93,463,205,861,5,11,14,112,398,9,24,0,0
619,103,473,220,878,5,11,14,117,405,10,24,0,0
620,126,470,255,886,5,11,14,129,416,11,24,0,0
621,148,482,291,918,5,11,14,143,436,12,24,0,0
622,164,483,315,928,5,11,14,151,445,13,24,0,0
623,179,493,349,983,5,11,14,170,490,14,24,0,0
624,199,508,383,1020,5,11,14,184,512,15,24,0,0
625,225,512,420,1037,5,11,14,195,525,16,24,0,0
626,275,534,483,1063,5,11,14,208,529,17,24,0,0
627,313,539,526,1072,5,11,14,213,533,18,24,0,0
628,367,538,591,1080,5,11,14,224,542,19,24,0,0
629,443,567,666,1080,5,11,14,223,513,20,24,0,0
630,505,575,731,1080,5,11,14,226,505,21,24,0,0
631,586,598,807,1080,5,11,14,221,482,22,24,0,0
632,701,604,921,1080,5,11,14,220,476,23,24,0,0
633,747,612,970,1080,5,11,14,223,468,24,24,1,0
636,1327,723,1635,1064,7,11,14,308,341,0,0,0,0
779,3,472,81,713,9,11,14,78,241,0,29,0,1
780,4,471,84,718,9,11,14,80,247,1,29,0,0
781,0,457,92,745,9,11,14,92,288,2,29,0,0
782,0,466,96,761,9,11,14,96,295,3,29,0,0
783,10,479,104,770,9,11,14,94,291,4,29,0,0
784,23,479,123,781,9,11,14,100,302,5,29,0,0
785,36,509,131,789,9,11,14,95,280,6,29,0,0
786,31,488,145,821,9,11,14,114,333,7,29,0,0
787,35,489,158,844,9,11,14,123,355,8,29,0,0
788,43,489,170,852,9,11,14,127,363,9,29,0,0
789,65,494,200,862,9,11,14,135,368,10,29,0,0
790,82,502,221,875,9,11,14,139,373,11,29,0,0
791,92,499,240,889,9,11,14,148,390,12,29,0,0
792,113,516,269,924,9,11,14,156,408,13,29,0,0
793,128,525,292,948,9,11,14,164,423,14,29,0,0
794,156,535,327,961,9,11,14,171,426,15,29,0,0
795,187,548,366,980,9,11,14,179,432,16,29,0,0
796,205,546,395,998,9,11,14,190,452,17,29,0,0
797,232,556,439,1043,9,11,14,207,487,18,29,0,0
798,260,576,473,1064,9,11,14,213,488,19,29,0,0
799,287,581,507,1080,9,11,14,220,499,20,29,0,0
800,344,598,568,1080,9,11,14,224,482,21,29,0,0
801,394,609,619,1080,9,11,14,225,471,22,29,0,0
802,444,620,669,1080,9,11,14,225,460,23,29,0,0
803,504,647,725,1080,9,11,14,221,433,24,29,0,0
804,555,674,768,1080,9,11,14,213,406,25,29,0,0
805,646,693,860,1080,9,11,14,214,387,26,29,0,0
806,748,713,961,1080,9,11,14,213,367,27,29,0,0
807,864,717,1084,1080,9,11,14,220,363,28,29,0,0
808,924,729,1142,1080,9,11,14,218,351,29,29,1,0
808,1036,783,1236,1052,10,11,14,200,269,0,0,0,0
809,1156,821,1397,1073,11,11,14,241,252,0,0,0,0
834,1082,727,1341,1070,14,11,14,259,343,0,0,0,0
835,866,684,1180,1067,15,11,14,314,383,0,29,0,1
836,748,687,1064,1073,15,11,14,316,386,1,29,0,0
837,605,655,950,1079,15,11,14,345,424,2,29,0,0
838,504,635,865,1080,15,11,14,361,445,3,29,0,0
839,420,607,801,1080,15,11,14,381,473,4,29,0,0
840,336,576,733,1078,15,11,14,397,502,5,29,0,0
841,287,573,677,1074,15,11,14,390,501,6,29,0,0
842,236,565,627,1074,15,11,14,391,509,7,29,0,0
843,166,550,557,1071,15,11,14,391,521,8,29,0,0
844,120,526,524,1075,15,11,14,404,549,9,29,0,0
845,84,508,468,1048,15,11,14,384,540,10,29,0,0
846,77,502,428,1009,15,11,14,351,507,11,29,0,0
847,70,504,396,983,15,11,14,326,479,12,29,0,0
848,42,489,347,950,15,11,14,305,461,13,29,0,0
849,27,515,302,940,15,11,14,275,425,14,29,0,0
850,7,490,275,912,15,11,14,268,422,15,29,0,0
851,0,473,242,881,15,11,14,242,408,16,29,0,0
852,0,475,226,868,15,11,14,226,393,17,29,0,0
853,0,468,205,846,15,11,14,205,378,18,29,0,0
854,0,458,179,831,15,11,14,179,373,19,29,0,0
855,0,467,161,825,15,11,14,161,358,20,29,0,0
856,0,462,140,801,15,11,14,140,339,21,29,0,0
857,0,453,128,778,15,11,14,128,325,22,29,0,0
858,0,462,121,766,15,11,14,121,304,23,29,0,0
859,0,476,103,749,15,11,14,103,273,24,29,0,0
860,0,481,93,743,15,11,14,93,262,25,29,0,0
861,0,468,89,738,15,11,14,89,270,26,29,0,0
862,0,465,72,725,15,11,14,72,260,27,29,0,0
863,0,454,79,703,15,11,14,79,249,28,29,0,0
864,0,450,66,688,15,11,14,66,238,29,29,1,0
879,1584,162,1619,269,17,11,14,35,107,0,53,0,0
884,1588,171,1623,280,17,11,14,35,109,0,53,0,0
886,1589,173,1624,282,17,11,14,35,109,0,53,0,1
887,1590,176,1625,284,17,11,14,35,108,1,53,0,0
888,1592,176,1627,285,17,11,14,35,109,2,53,0,0
889,1593,179,1628,289,17,11,14,35,110,3,53,0,0
890,1592,179,1629,292,17,11,14,37,113,4,53,0,0
891,1593,181,1629,293,17,11,14,36,112,5,53,0,0
892,1593,184,1630,296,17,11,14,37,112,6,53,0,0
893,1593,181,1632,303,17,11,14,39,122,7,53,0,0
894,1592,183,1632,306,17,11,14,40,123,8,53,0,0
895,1591,181,1633,311,17,11,14,42,130,9,53,0,0
896,1590,182,1632,314,17,11,14,42,132,10,53,0,0
897,1589,185,1631,315,17,11,14,42,130,11,53,0,0
898,1587,183,1632,322,17,11,14,45,139,12,53,0,0
899,1583,184,1631,330,17,11,14,48,146,13,53,0,0
900,1579,181,1629,334,17,11,14,50,153,14,53,0,0
901,1577,185,1628,337,17,11,14,51,152,15,53,0,0
902,1577,186,1628,340,17,11,14,51,154,16,53,0,0
903,1573,187,1629,351,17,11,14,56,164,17,53,0,0
904,1571,194,1627,358,17,11,14,56,164,18,53,0,0
905,1570,192,1628,362,17,11,14,58,170,19,53,0,0
906,1572,201,1630,369,17,11,14,58,168,20,53,0,0
907,1573,199,1633,374,17,11,14,60,175,21,53,0,0
908,1570,202,1633,383,17,11,14,63,181,22,53,0,0
909,1567,207,1632,388,17,11,14,65,181,23,53,0,0
910,1565,207,1633,398,17,11,14,68,191,24,53,0,0
911,1564,212,1634,408,17,11,14,70,196,25,53,0,0
912,1562,212,1633,415,17,11,14,71,203,26,53,0,0
913,1555,215,1631,431,17,11,14,76,216,27,53,0,0
914,1552,214,1631,440,17,11,14,79,226,28,53,0,0
915,1552,219,1632,448,17,11,14,80,229,29,53,0,0
916,1550,224,1633,461,17,11,14,83,237,30,53,0,0
917,1542,224,1628,472,17,11,14,86,248,31,53,0,0
918,1533,232,1623,488,17,11,14,90,256,32,53,0,0
919,1526,234,1619,500,17,11,14,93,266,33,53,0,0
920,1524,242,1620,517,17,11,14,96,275,34,53,0,0
921,1517,249,1616,533,17,11,14,99,284,35,53,0,0
922,1504,247,1609,551,17,11,14,105,304,36,53,0,0
923,1487,257,1597,571,17,11,14,110,314,37,53,0,0
924,1474,253,1590,588,17,11,14,116,335,38,53,0,0
925,1465,264,1587,619,17,11,14,122,355,39,53,0,0
926,1453,274,1580,644,17,11,14,127,370,40,53,0,0
927,1434,275,1567,661,17,11,14,133,386,41,53,0,0
928,1413,292,1553,696,17,11,14,140,404,42,53,0,0
929,1398,295,1544,719,17,11,14,146,424,43,53,0,0
930,1387,314,1542,763,17,11,14,155,449,44,53,0,0
931,1381,340,1538,787,17,11,14,157,447,45,53,0,0
932,1367,350,1539,836,17,11,14,172,486,46,53,0,0
933,1355,370,1544,902,17,11,14,189,532,47,53,0,0
934,1363,381,1561,937,17,11,14,198,556,48,53,0,0
935,1376,413,1592,1018,17,11,14,216,605,49,53,0,0
936,1411,431,1632,1046,17,11,14,221,615,50,53,0,0
937,1472,451,1695,1063,17,11,14,223,612,51,53,0,0
938,1536,510,1754,1073,17,11,14,218,563,52,53,0,0
939,1543,525,1765,1080,17,11,14,222,555,53,53,1,0
939,1683,554,1919,1075,18,11,14,236,521,0,0,0,0
971,0,441,62,748,19,11,14,62,307,0,24,0,1
972,4,451,66,755,19,11,14,62,304,1,24,0,0
973,25,465,87,761,19,11,14,62,296,2,24,0,0
974,29,441,101,778,19,11,14,72,337,3,24,0,0
975,29,429,108,789,19,11,14,79,360,4,24,0,0
976,29,433,118,821,19,11,14,89,388,5,24,0,0
977,34,435,131,843,19,11,14,97,408,6,24,0,0
978,52,432,158,851,19,11,14,106,419,7,24,0,0
979,79,438,199,876,19,11,14,120,438,8,24,0,0
980,97,450,223,888,19,11,14,126,438,9,24,0,0
981,107,453,251,932,19,11,14,144,479,10,24,0,0
982,134,465,291,960,19,11,14,157,495,11,24,0,0
983,157,457,325,973,19,11,14,168,516,12,24,0,0
984,214,466,401,997,19,11,14,187,531,13,24,0,0
985,261,475,463,1015,19,11,14,202,540,14,24,0,0
986,282,467,507,1059,19,11,14,225,592,15,24,0,0
987,328,483,562,1075,19,11,14,234,592,16,24,0,0
988,372,497,609,1080,19,11,14,237,583,17,24,0,0
989,441,497,688,1080,19,11,14,247,583,18,24,0,0
990,513,508,761,1080,19,11,14,248,572,19,24,0,0
991,591,509,843,1080,19,11,14,252,571,20,24,0,0
992,700,539,962,1080,19,11,14,262,541,21,24,0,0
993,827,567,1090,1080,19,11,14,263,513,22,24,0,0
994,934,582,1192,1076,19,11,14,258,494,23,24,0,0
995,997,592,1255,1080,19,11,14,258,488,24,24,1,0
994,858,701,1006,975,20,11,14,148,274,0,0,0,0
995,1136,639,1426,1066,21,11,14,290,427,0,0,0,0
996,1318,650,1708,1070,22,11,14,390,420,0,1,0,0
997,1473,674,1844,1075,22,11,14,371,401,1,1,0,0
998,1735,791,1915,1075,23,11,14,180,284,0,0,0,0
1291,3,524,44,794,26,11,14,41,270,0,19,0,1
1292,16,517,59,796,26,11,14,43,279,1,19,0,0
1293,25,498,76,821,26,11,14,51,323,2,19,0,0
1294,24,484,81,834,26,11,14,57,350,3,19,0,0
1295,25,479,91,870,26,11,14,66,391,4,19,0,0
1296,36,491,106,881,26,11,14,70,390,5,19,0,0
1297,50,494,129,899,26,11,14,79,405,6,19,0,0
1298,69,502,162,935,26,11,14,93,433,7,19,0,0
1299,75,505,180,957,26,11,14,105,452,8,19,0,0
1300,83,507,205,1004,26,11,14,122,497,9,19,0,0
1301,101,524,237,1050,26,11,14,136,526,10,19,0,0
1302,119,529,268,1067,26,11,14,149,538,11,19,0,0
1303,144,558,302,1080,26,11,14,158,522,12,19,0,0
1304,166,584,328,1080,26,11,14,162,496,13,19,0,0
1305,181,605,350,1080,26,11,14,169,475,14,19,0,0
1306,196,650,368,1080,26,11,14,172,430,15,19,0,0
1307,190,681,366,1080,26,11,14,176,399,16,19,0,0
1308,172,738,341,1080,26,11,14,169,342,17,19,0,0
1309,141,823,288,1079,26,11,14,147,256,18,19,0,0
1310,148,853,283,1080,26,11,14,135,227,19,19,0,0
1488,2,501,78,765,28,11,14,76,264,0,25,0,1
1489,0,500,80,788,28,11,14,80,288,1,25,0,0
1490,0,500,81,793,28,11,14,81,293,2,25,0,0
1491,0,500,87,818,28,11,14,87,318,3,25,0,0
1492,0,489,95,846,28,11,14,95,357,4,25,0,0
1493,0,486,100,853,28,11,14,100,367,5,25,0,0
1494,14,482,126,863,28,11,14,112,381,6,25,0,0
1495,27,486,144,876,28,11,14,117,390,7,25,0,0
1496,31,485,154,882,28,11,14,123,397,8,25,0,0
1497,29,477,171,926,28,11,14,142,449,9,25,0,0
1498,41,492,191,951,28,11,14,150,459,10,25,0,0
1499,51,495,207,960,28,11,14,156,465,11,25,0,0
1500,85,499,256,979,28,11,14,171,480,12,25,0,0
1501,108,510,294,1008,28,11,14,186,498,13,25,0,0
1502,123,515,317,1022,28,11,14,194,507,14,25,0,0
1503,129,526,338,1060,28,11,14,209,534,15,25,0,0
1504,146,554,357,1076,28,11,14,211,522,16,25,0,0
1505,163,563,380,1080,28,11,14,217,517,17,25,0,0
1506,186,589,404,1080,28,11,14,218,491,18,25,0,0
1507,225,617,444,1080,28,11,14,219,463,19,25,0,0
1508,247,625,476,1077,28,11,14,229,452,20,25,0,0
1509,254,670,477,1080,28,11,14,223,410,21,25,0,0
1510,229,738,431,1080,28,11,14,202,342,22,25,0,0
1511,202,788,389,1076,28,11,14,187,288,23,25,0,0
1512,176,895,309,1078,28,11,14,133,183,24,25,0,0
1513,181,935,289,1080,28,11,14,108,145,25,25,1,0
1906,1351,809,1555,1059,31,11,14,204,250,0,0,0,0
1907,1137,810,1382,1071,32,11,14,245,261,0,0,0,0
1908,904,748,1217,1072,33,11,14,313,324,0,0,0,0
1910,664,693,942,1080,34,11,14,278,387,0,23,0,1
1911,574,657,877,1080,34,11,14,303,423,1,23,0,0
1912,489,646,796,1076,34,11,14,307,430,2,23,0,0
1913,387,619,713,1077,34,11,14,326,458,3,23,0,0
1914,319,604,655,1077,34,11,14,336,473,4,23,0,0
1915,255,579,605,1079,34,11,14,350,500,5,23,0,0
1916,201,558,559,1077,34,11,14,358,519,6,23,0,0
1917,169,546,529,1074,34,11,14,360,528,7,23,0,0
1918,125,538,463,1042,34,11,14,338,504,8,23,0,0
1919,89,526,417,1024,34,11,14,328,498,9,23,0,0
1920,66,529,367,994,34,11,14,301,465,10,23,0,0
1921,43,504,323,948,34,11,14,280,444,11,23,0,0
1922,33,500,300,928,34,11,14,267,428,12,23,0,0
1923,13,493,260,898,34,11,14,247,405,13,23,0,0
1924,0,487,231,887,34,11,14,231,400,14,23,0,0
1925,0,489,196,856,34,11,14,196,367,15,23,0,0
1926,0,484,171,826,34,11,14,171,342,16,23,0,0
1927,0,483,163,815,34,11,14,163,332,17,23,0,0
1928,0,475,141,793,34,11,14,141,318,18,23,0,0
1929,0,465,130,785,34,11,14,130,320,19,23,0,0
1930,0,460,118,772,34,11,14,118,312,20,23,0,0
1931,0,459,105,753,34,11,14,105,294,21,23,0,0
1932,0,479,95,736,34,11,14,95,257,22,23,0,0
1933,0,476,76,718,34,11,14,76,242,23,23,1,0
2171,0,491,76,732,35,11,14,76,241,0,33,0,1
2172,2,506,73,731,35,11,14,71,225,1,33,0,0
2173,0,468,86,767,35,11,14,86,299,2,33,0,0
2174,0,472,87,781,35,11,14,87,309,3,33,0,0
2175,0,471,92,784,35,11,14,92,313,4,33,0,0
2176,6,458,111,794,35,11,14,105,336,5,33,0,0
2177,11,456,122,802,35,11,14,111,346,6,33,0,0
2178,10,454,129,821,35,11,14,119,367,7,33,0,0
2179,9,459,137,855,35,11,14,128,396,8,33,0,0
2180,8,461,141,872,35,11,14,133,411,9,33,0,0
2181,17,460,156,881,35,11,14,139,421,10,33,0,0
2182,34,468,182,893,35,11,14,148,425,11,33,0,0
2183,40,474,196,904,35,11,14,156,430,12,33,0,0
2184,42,471,212,929,35,11,14,170,458,13,33,0,0
2185,44,476,229,969,35,11,14,185,493,14,33,0,0
2186,48,486,239,991,35,11,14,191,505,15,33,0,0
2187,66,483,267,1002,35,11,14,201,519,16,33,0,0
2188,97,491,313,1024,35,11,14,216,533,17,33,0,0
2189,127,505,350,1038,35,11,14,223,533,18,33,0,0
2190,134,507,371,1065,35,11,14,237,558,19,33,0,0
2191,148,528,388,1080,35,11,14,240,552,20,33,0,0
2192,164,542,403,1079,35,11,14,239,537,21,33,0,0
2193,186,548,429,1080,35,11,14,243,532,22,33,0,0
2194,223,565,466,1080,35,11,14,243,515,23,33,0,0
2195,270,568,517,1080,35,11,14,247,512,24,33,0,0
2196,315,571,569,1079,35,11,14,254,508,25,33,0,0
2197,382,596,636,1077,35,11,14,254,481,26,33,0,0
2198,441,623,693,1076,35,11,14,252,453,27,33,0,0
2199,507,638,762,1075,35,11,14,255,437,28,33,0,0
2200,589,670,831,1073,35,11,14,242,403,29,33,0,0
2201,716,688,956,1068,35,11,14,240,380,30,33,0,0
2202,843,694,1093,1074,35,11,14,250,380,31,33,0,0
2203,1009,738,1240,1076,35,11,14,231,338,32,33,0,0
2204,1092,755,1313,1080,35,11,14,221,325,33,33,1,0
2765,1,431,51,701,39,11,14,50,270,0,24,0,1
2766,10,430,62,704,39,11,14,52,274,1,24,0,0
2767,15,414,75,727,39,11,14,60,313,2,24,0,0
2768,18,415,80,735,39,11,14,62,320,3,24,0,0
2769,16,419,84,768,39,11,14,68,349,4,24,0,0
2770,16,433,87,788,39,11,14,71,355,5,24,0,0
2771,19,435,93,792,39,11,14,74,357,6,24,0,0
2772,28,434,111,817,39,11,14,83,383,7,24,0,0
2773,33,441,122,829,39,11,14,89,388,8,24,0,0
2774,38,431,138,846,39,11,14,100,415,9,24,0,0
2775,43,439,151,872,39,11,14,108,433,10,24,0,0
2776,45,443,163,890,39,11,14,118,447,11,24,0,0
2777,71,453,198,900,39,11,14,127,447,12,24,0,0
2778,99,464,238,929,39,11,14,139,465,13,24,0,0
2779,116,467,260,938,39,11,14,144,471,14,24,0,0
2780,127,467,288,986,39,11,14,161,519,15,24,0,0
2781,146,491,315,1028,39,11,14,169,537,16,24,0,0
2782,164,491,341,1042,39,11,14,177,551,17,24,0,0
2783,210,502,404,1068,39,11,14,194,566,18,24,0,0
2784,244,494,451,1080,39,11,14,207,586,19,24,0,0
2785,269,489,487,1080,39,11,14,218,591,20,24,0,0
2786,318,524,533,1080,39,11,14,215,556,21,24,0,0
2787,393,577,597,1079,39,11,14,204,502,22,24,0,0
2788,416,578,625,1075,39,11,14,209,497,23,24,0,0
2789,442,587,653,1080,39,11,14,211,493,24,24,1,0
2795,1164,725,1484,1054,41,11,14,320,329,0,0,0,0
2796,1387,725,1659,1058,42,11,14,272,333,0,0,0,0
2797,1529,709,1859,1073,43,11,14,330,364,0,0,0,0
2798,1730,780,1918,1080,44,11,14,188,300,0,0,0,0
3462,0,486,80,763,45,11,14,80,277,0,1,0,0
3463,2,453,92,764,45,11,14,90,311,1,1,0,0
3465,8,437,132,783,46,11,14,124,346,0,22,0,1
3466,6,455,137,819,46,11,14,131,364,1,22,0,0
3467,8,453,145,835,46,11,14,137,382,2,22,0,0
3468,15,461,151,839,46,11,14,136,378,3,22,0,0
3469,47,468,186,848,46,11,14,139,380,4,22,0,0
3470,62,475,209,872,46,11,14,147,397,5,22,0,0
3471,69,479,225,895,46,11,14,156,416,6,22,0,0
3472,84,485,253,930,46,11,14,169,445,7,22,0,0
3473,94,493,269,952,46,11,14,175,459,8,22,0,0
3474,123,498,306,966,46,11,14,183,468,9,22,0,0
3475,160,510,355,995,46,11,14,195,485,10,22,0,0
3476,182,519,381,1006,46,11,14,199,487,11,22,0,0
3477,204,524,421,1052,46,11,14,217,528,12,22,0,0
3478,227,529,451,1066,46,11,14,224,537,13,22,0,0
3479,255,532,486,1075,46,11,14,231,543,14,22,0,0
3480,300,554,530,1080,46,11,14,230,526,15,22,0,0
3481,341,577,567,1080,46,11,14,226,503,16,22,0,0
3482,380,590,601,1077,46,11,14,221,487,17,22,0,0
3483,435,622,648,1078,46,11,14,213,456,18,22,0,0
3484,498,644,709,1080,46,11,14,211,436,19,22,0,0
3485,575,678,782,1080,46,11,14,207,402,20,22,0,0
3486,683,719,882,1079,46,11,14,199,360,21,22,0,0
3487,734,739,927,1080,46,11,14,193,341,22,22,1,0
3469,25,495,136,646,47,11,14,111,151,0,0,0,0
3488,862,761,998,963,48,11,14,136,202,0,523,0,1
3489,888,755,1035,973,48,11,14,147,218,1,523,0,0
3490,892,760,1040,975,48,11,14,148,215,2,523,0,0
3491,893,760,1042,974,48,11,14,149,214,3,523,0,0
3492,892,760,1044,974,48,11,14,152,214,4,523,0,0
3493,890,759,1045,974,48,11,14,155,215,5,523,0,0
3494,888,759,1047,974,48,11,14,159,215,6,523,0,0
3495,886,759,1048,974,48,11,14,162,215,7,523,0,0
3496,883,759,1048,973,48,11,14,165,214,8,523,0,0
3497,881,755,1050,971,48,11,14,169,216,9,523,0,0
3498,879,757,1051,972,48,11,14,172,215,10,523,0,0
3499,878,757,1051,971,48,11,14,173,214,11,523,0,0
3500,876,757,1053,971,48,11,14,177,214,12,523,0,0
3501,874,753,1055,969,48,11,14,181,216,13,523,0,0
3502,873,752,1057,969,48,11,14,184,217,14,523,0,0
3503,872,751,1058,968,48,11,14,186,217,15,523,0,0
3504,873,755,1058,969,48,11,14,185,214,16,523,0,0
3505,870,753,1059,969,48,11,14,189,216,17,523,0,0
3506,870,753,1060,968,48,11,14,190,215,18,523,0,0
3507,869,757,1060,969,48,11,14,191,212,19,523,0,0
3508,869,758,1060,969,48,11,14,191,211,20,523,0,0
3509,867,754,1062,968,48,11,14,195,214,21,523,0,0
3510,867,757,1062,970,48,11,14,195,213,22,523,0,0
3511,867,758,1062,970,48,11,14,195,212,23,523,0,0
3512,867,758,1063,970,48,11,14,196,212,24,523,0,0
3513,865,758,1063,971,48,11,14,198,213,25,523,0,0
3514,864,758,1063,971,48,11,14,199,213,26,523,0,0
3515,865,758,1064,970,48,11,14,199,212,27,523,0,0
3516,865,758,1064,969,48,11,14,199,211,28,523,0,0
3517,865,758,1065,969,48,11,14,200,211,29,523,0,0
3518,864,758,1065,969,48,11,14,201,211,30,523,0,0
3519,864,758,1066,969,48,11,14,202,211,31,523,0,0
3520,864,758,1066,969,48,11,14,202,211,32,523,0,0
3521,863,760,1065,970,48,11,14,202,210,33,523,0,0
3522,861,755,1066,968,48,11,14,205,213,34,523,0,0
3523,860,756,1066,969,48,11,14,206,213,35,523,0,0
3524,859,756,1065,969,48,11,14,206,213,36,523,0,0
3525,860,758,1067,971,48,11,14,207,213,37,523,0,0
3526,861,760,1067,971,48,11,14,206,211,38,523,0,0
3527,861,759,1068,971,48,11,14,207,212,39,523,0,0
3528,861,759,1068,971,48,11,14,207,212,40,523,0,0
3529,861,759,1068,972,48,11,14,207,213,41,523,0,0
3530,861,759,1068,971,48,11,14,207,212,42,523,0,0
3531,863,756,1069,967,48,11,14,206,211,43,523,0,0
3532,863,755,1069,966,48,11,14,206,211,44,523,0,0
3533,862,753,1069,966,48,11,14,207,213,45,523,0,0
3534,860,752,1069,967,48,11,14,209,215,46,523,0,0
3535,860,751,1069,967,48,11,14,209,216,47,523,0,0
3536,860,757,1069,971,48,11,14,209,214,48,523,0,0
3537,861,758,1070,973,48,11,14,209,215,49,523,0,0
3538,860,758,1070,973,48,11,14,210,215,50,523,0,0
3539,861,757,1070,972,48,11,14,209,215,51,523,0,0
3540,861,757,1070,971,48,11,14,209,214,52,523,0,0
3541,861,760,1067,970,48,11,14,206,210,53,523,0,0
3542,861,760,1066,969,48,11,14,205,209,54,523,0,0
3543,861,761,1066,969,48,11,14,205,208,55,523,0,0
3544,861,761,1066,969,48,11,14,205,208,56,523,0,0
3545,860,761,1066,969,48,11,14,206,208,57,523,0,0
3546,860,759,1068,969,48,11,14,208,210,58,523,0,0
3547,859,759,1068,971,48,11,14,209,212,59,523,0,0
3548,860,759,1068,969,48,11,14,208,210,60,523,0,0
3549,860,759,1068,969,48,11,14,208,210,61,523,0,0
3550,859,754,1070,969,48,11,14,211,215,62,523,0,0
3551,861,751,1072,966,48,11,14,211,215,63,523,0,0
3552,860,752,1071,967,48,11,14,211,215,64,523,0,0
3553,861,749,1072,965,48,11,14,211,216,65,523,0,0
3554,860,752,1071,969,48,11,14,211,217,66,523,0,0
3555,862,751,1072,966,48,11,14,210,215,67,523,0,0
3556,862,750,1071,965,48,11,14,209,215,68,523,0,0
3557,861,749,1072,966,48,11,14,211,217,69,523,0,0
3558,861,748,1071,966,48,11,14,210,218,70,523,0,0
3559,860,748,1070,966,48,11,14,210,218,71,523,0,0
3560,859,752,1069,969,48,11,14,210,217,72,523,0,0
3561,860,749,1069,967,48,11,14,209,218,73,523,0,0
3562,860,751,1069,969,48,11,14,209,218,74,523,0,0
3563,860,752,1068,969,48,11,14,208,217,75,523,0,0
3564,860,752,1068,969,48,11,14,208,217,76,523,0,0
3565,860,750,1069,967,48,11,14,209,217,77,523,0,0
3566,861,752,1068,969,48,11,14,207,217,78,523,0,0
3567,861,753,1069,970,48,11,14,208,217,79,523,0,0
3568,860,751,1070,970,48,11,14,210,219,80,523,0,0
3569,860,753,1069,971,48,11,14,209,218,81,523,0,0
3570,861,753,1069,971,48,11,14,208,218,82,523,0,0
3571,862,751,1070,968,48,11,14,208,217,83,523,0,0
3572,863,750,1070,966,48,11,14,207,216,84,523,0,0
3573,862,750,1069,966,48,11,14,207,216,85,523,0,0
3574,862,749,1070,966,48,11,14,208,217,86,523,0,0
3575,862,752,1069,968,48,11,14,207,216,87,523,0,0
3576,861,750,1069,967,48,11,14,208,217,88,523,0,0
3577,862,751,1068,966,48,11,14,206,215,89,523,0,0
3578,861,751,1069,967,48,11,14,208,216,90,523,0,0
3579,860,754,1068,971,48,11,14,208,217,91,523,0,0
3580,860,754,1068,970,48,11,14,208,216,92,523,0,0
3581,857,748,1069,969,48,11,14,212,221,93,523,0,0
3582,855,743,1068,967,48,11,14,213,224,94,523,0,0
3583,858,745,1065,964,48,11,14,207,219,95,523,0,0
3584,860,751,1064,967,48,11,14,204,216,96,523,0,0
3585,860,751,1065,969,48,11,14,205,218,97,523,0,0
3586,860,755,1065,972,48,11,14,205,217,98,523,0,0
3587,860,755,1066,974,48,11,14,206,219,99,523,0,0
3588,862,755,1066,972,48,11,14,204,217,100,523,0,0
3589,862,755,1066,971,48,11,14,204,216,101,523,0,0
3590,863,754,1067,970,48,11,14,204,216,102,523,0,0
3591,863,755,1067,973,48,11,14,204,218,103,523,0,0
3592,862,755,1067,973,48,11,14,205,218,104,523,0,0
3593,862,756,1067,974,48,11,14,205,218,105,523,0,0
3594,862,755,1068,975,48,11,14,206,220,106,523,0,0
3595,862,755,1067,975,48,11,14,205,220,107,523,0,0
3596,862,755,1067,975,48,11,14,205,220,108,523,0,0
3597,862,754,1067,973,48,11,14,205,219,109,523,0,0
3598,862,753,1063,968,48,11,14,201,215,110,523,0,0
3599,861,751,1063,967,48,11,14,202,216,111,523,0,0
3600,861,753,1064,969,48,11,14,203,216,112,523,0,0
3601,860,750,1065,969,48,11,14,205,219,113,523,0,0
3602,861,755,1063,971,48,11,14,202,216,114,523,0,0
3603,860,754,1064,971,48,11,14,204,217,115,523,0,0
3604,861,757,1063,972,48,11,14,202,215,116,523,0,0
3605,859,753,1064,971,48,11,14,205,218,117,523,0,0
3606,860,757,1064,975,48,11,14,204,218,118,523,0,0
3607,860,759,1064,976,48,11,14,204,217,119,523,0,0
3608,861,760,1065,977,48,11,14,204,217,120,523,0,0
3609,860,760,1064,976,48,11,14,204,216,121,523,0,0
3610,861,760,1064,976,48,11,14,203,216,122,523,0,0
3611,860,759,1064,974,48,11,14,204,215,123,523,0,0
3612,860,758,1063,974,48,11,14,203,216,124,523,0,0
3613,859,758,1063,974,48,11,14,204,216,125,523,0,0
3614,860,760,1063,974,48,11,14,203,214,126,523,0,0
3615,860,761,1063,974,48,11,14,203,213,127,523,0,0
3616,862,758,1065,972,48,11,14,203,214,128,523,0,0
3617,863,758,1065,971,48,11,14,202,213,129,523,0,0
3618,864,758,1066,971,48,11,14,202,213,130,523,0,0
3619,864,758,1066,970,48,11,14,202,212,131,523,0,0
3620,865,758,1067,970,48,11,14,202,212,132,523,0,0
3621,863,758,1066,972,48,11,14,203,214,133,523,0,0
3622,862,758,1065,973,48,11,14,203,215,134,523,0,0
3623,861,758,1064,973,48,11,14,203,215,135,523,0,0
3624,860,755,1065,973,48,11,14,205,218,136,523,0,0
3625,859,753,1065,973,48,11,14,206,220,137,523,0,0
3626,860,757,1065,975,48,11,14,205,218,138,523,0,0
3627,862,759,1065,973,48,11,14,203,214,139,523,0,0
3628,863,759,1065,972,48,11,14,202,213,140,523,0,0
3629,863,760,1065,972,48,11,14,202,212,141,523,0,0
3630,863,760,1066,971,48,11,14,203,211,142,523,0,0
3631,859,754,1067,972,48,11,14,208,218,143,523,0,0
3632,863,756,1067,971,48,11,14,204,215,144,523,0,0
3633,860,753,1068,972,48,11,14,208,219,145,523,0,0
3634,860,758,1066,974,48,11,14,206,216,146,523,0,0
3635,860,760,1065,975,48,11,14,205,215,147,523,0,0
3636,860,761,1066,977,48,11,14,206,216,148,523,0,0
3637,858,756,1067,976,48,11,14,209,220,149,523,0,0
3638,859,757,1065,976,48,11,14,206,219,150,523,0,0
3639,859,759,1065,976,48,11,14,206,217,151,523,0,0
3640,857,753,1067,975,48,11,14,210,222,152,523,0,0
3641,860,758,1066,976,48,11,14,206,218,153,523,0,0
3642,859,758,1066,977,48,11,14,207,219,154,523,0,0
3643,859,758,1066,978,48,11,14,207,220,155,523,0,0
3644,859,759,1066,978,48,11,14,207,219,156,523,0,0
3645,859,759,1067,978,48,11,14,208,219,157,523,0,0
3646,859,757,1066,977,48,11,14,207,220,158,523,0,0
3647,859,757,1065,976,48,11,14,206,219,159,523,0,0
3648,859,757,1065,976,48,11,14,206,219,160,523,0,0
3649,859,757,1065,976,48,11,14,206,219,161,523,0,0
3650,859,757,1065,976,48,11,14,206,219,162,523,0,0
3651,861,755,1068,975,48,11,14,207,220,163,523,0,0
3652,862,754,1069,975,48,11,14,207,221,164,523,0,0
3653,862,754,1070,974,48,11,14,208,220,165,523,0,0
3654,860,755,1068,976,48,11,14,208,221,166,523,0,0
3655,862,755,1069,975,48,11,14,207,220,167,523,0,0
3656,860,755,1068,977,48,11,14,208,222,168,523,0,0
3657,862,753,1068,975,48,11,14,206,222,169,523,0,0
3658,862,752,1068,973,48,11,14,206,221,170,523,0,0
3659,860,754,1067,976,48,11,14,207,222,171,523,0,0
3660,860,754,1067,976,48,11,14,207,222,172,523,0,0
3661,864,755,1067,973,48,11,14,203,218,173,523,0,0
3662,866,755,1068,972,48,11,14,202,217,174,523,0,0
3663,866,755,1068,972,48,11,14,202,217,175,523,0,0
3664,866,756,1068,971,48,11,14,202,215,176,523,0,0
3665,866,756,1069,971,48,11,14,203,215,177,523,0,0
3666,861,756,1068,977,48,11,14,207,221,178,523,0,0
3667,859,756,1068,979,48,11,14,209,223,179,523,0,0
3668,861,754,1070,977,48,11,14,209,223,180,523,0,0
3669,860,755,1068,979,48,11,14,208,224,181,523,0,0
3670,861,754,1069,977,48,11,14,208,223,182,523,0,0
3671,860,754,1066,975,48,11,14,206,221,183,523,0,0
3672,862,753,1067,973,48,11,14,205,220,184,523,0,0
3673,864,754,1068,972,48,11,14,204,218,185,523,0,0
3674,861,755,1065,973,48,11,14,204,218,186,523,0,0
3675,863,755,1066,972,48,11,14,203,217,187,523,0,0
3676,862,757,1065,974,48,11,14,203,217,188,523,0,0
3677,861,759,1064,975,48,11,14,203,216,189,523,0,0
3678,861,759,1064,975,48,11,14,203,216,190,523,0,0
3679,862,759,1064,975,48,11,14,202,216,191,523,0,0
3680,861,760,1064,975,48,11,14,203,215,192,523,0,0
3681,861,760,1064,975,48,11,14,203,215,193,523,0,0
3682,861,760,1065,976,48,11,14,204,216,194,523,0,0
3683,860,759,1065,976,48,11,14,205,217,195,523,0,0
3684,860,759,1065,976,48,11,14,205,217,196,523,0,0
3685,860,759,1065,977,48,11,14,205,218,197,523,0,0
3686,862,757,1067,975,48,11,14,205,218,198,523,0,0
3687,863,756,1068,973,48,11,14,205,217,199,523,0,0
3688,864,756,1069,973,48,11,14,205,217,200,523,0,0
3689,864,756,1069,973,48,11,14,205,217,201,523,0,0
3690,862,754,1069,974,48,11,14,207,220,202,523,0,0
3691,861,756,1067,974,48,11,14,206,218,203,523,0,0
3692,860,755,1066,974,48,11,14,206,219,204,523,0,0
3693,859,755,1066,975,48,11,14,207,220,205,523,0,0
3694,859,755,1066,976,48,11,14,207,221,206,523,0,0
3695,859,755,1066,976,48,11,14,207,221,207,523,0,0
3696,860,756,1066,976,48,11,14,206,220,208,523,0,0
3697,861,756,1066,976,48,11,14,205,220,209,523,0,0
3698,861,756,1066,976,48,11,14,205,220,210,523,0,0
3699,860,753,1066,974,48,11,14,206,221,211,523,0,0
3700,859,751,1066,973,48,11,14,207,222,212,523,0,0
3701,860,755,1065,975,48,11,14,205,220,213,523,0,0
3702,860,757,1064,975,48,11,14,204,218,214,523,0,0
3703,861,758,1064,975,48,11,14,203,217,215,523,0,0
3704,861,759,1064,976,48,11,14,203,217,216,523,0,0
3705,860,759,1064,976,48,11,14,204,217,217,523,0,0
3706,862,757,1067,976,48,11,14,205,219,218,523,0,0
3707,860,757,1067,979,48,11,14,207,222,219,523,0,0
3708,859,758,1067,979,48,11,14,208,221,220,523,0,0
3709,860,758,1067,980,48,11,14,207,222,221,523,0,0
3710,860,758,1066,979,48,11,14,206,221,222,523,0,0
3711,862,755,1066,973,48,11,14,204,218,223,523,0,0
3712,863,754,1066,971,48,11,14,203,217,224,523,0,0
3713,863,753,1066,971,48,11,14,203,218,225,523,0,0
3714,865,754,1066,970,48,11,14,201,216,226,523,0,0
3715,864,754,1066,970,48,11,14,202,216,227,523,0,0
3716,863,757,1065,974,48,11,14,202,217,228,523,0,0
3717,860,753,1065,974,48,11,14,205,221,229,523,0,0
3718,858,751,1066,974,48,11,14,208,223,230,523,0,0
3719,860,756,1065,976,48,11,14,205,220,231,523,0,0
3720,859,752,1066,975,48,11,14,207,223,232,523,0,0
3721,860,756,1064,977,48,11,14,204,221,233,523,0,0
3722,860,758,1064,977,48,11,14,204,219,234,523,0,0
3723,860,758,1064,978,48,11,14,204,220,235,523,0,0
3724,860,759,1064,978,48,11,14,204,219,236,523,0,0
3725,860,758,1064,978,48,11,14,204,220,237,523,0,0
3726,861,759,1065,978,48,11,14,204,219,238,523,0,0
3727,861,759,1065,978,48,11,14,204,219,239,523,0,0
3728,861,760,1065,978,48,11,14,204,218,240,523,0,0
3729,861,760,1066,978,48,11,14,205,218,241,523,0,0
3730,861,760,1066,978,48,11,14,205,218,242,523,0,0
3731,861,756,1067,976,48,11,14,206,220,243,523,0,0
3732,860,757,1066,976,48,11,14,206,219,244,523,0,0
3733,863,757,1068,974,48,11,14,205,217,245,523,0,0
3734,864,756,1068,974,48,11,14,204,218,246,523,0,0
3735,864,756,1068,973,48,11,14,204,217,247,523,0,0
3736,863,756,1067,973,48,11,14,204,217,248,523,0,0
3737,863,756,1067,972,48,11,14,204,216,249,523,0,0
3738,863,755,1067,972,48,11,14,204,217,250,523,0,0
3739,862,759,1066,975,48,11,14,204,216,251,523,0,0
3740,861,759,1065,976,48,11,14,204,217,252,523,0,0
3741,860,760,1064,976,48,11,14,204,216,253,523,0,0
3742,860,760,1064,976,48,11,14,204,216,254,523,0,0
3743,860,760,1064,976,48,11,14,204,216,255,523,0,0
3744,860,760,1064,976,48,11,14,204,216,256,523,0,0
3745,860,760,1064,976,48,11,14,204,216,257,523,0,0
3746,862,758,1067,976,48,11,14,205,218,258,523,0,0
3747,862,758,1068,976,48,11,14,206,218,259,523,0,0
3748,863,758,1068,976,48,11,14,205,218,260,523,0,0
3749,863,758,1067,976,48,11,14,204,218,261,523,0,0
3750,859,755,1066,977,48,11,14,207,222,262,523,0,0
3751,859,758,1064,977,48,11,14,205,219,263,523,0,0
3752,858,754,1065,977,48,11,14,207,223,264,523,0,0
3753,859,755,1065,976,48,11,14,206,221,265,523,0,0
3754,859,755,1064,975,48,11,14,205,220,266,523,0,0
3755,862,755,1065,971,48,11,14,203,216,267,523,0,0
3756,864,758,1063,970,48,11,14,199,212,268,523,0,0
3757,864,760,1063,971,48,11,14,199,211,269,523,0,0
3758,867,759,1065,968,48,11,14,198,209,270,523,0,0
3759,865,757,1067,970,48,11,14,202,213,271,523,0,0
3760,866,758,1067,969,48,11,14,201,211,272,523,0,0
3761,862,754,1066,967,48,11,14,204,213,273,523,0,0
3762,861,752,1066,966,48,11,14,205,214,274,523,0,0
3763,859,751,1066,967,48,11,14,207,216,275,523,0,0
3764,863,755,1066,966,48,11,14,203,211,276,523,0,0
3765,858,753,1067,970,48,11,14,209,217,277,523,0,0
3766,859,752,1068,970,48,11,14,209,218,278,523,0,0
3767,859,752,1068,970,48,11,14,209,218,279,523,0,0
3768,860,751,1068,969,48,11,14,208,218,280,523,0,0
3769,860,751,1069,969,48,11,14,209,218,281,523,0,0
3770,865,757,1068,968,48,11,14,203,211,282,523,0,0
3771,862,757,1068,972,48,11,14,206,215,283,523,0,0
3772,863,758,1069,972,48,11,14,206,214,284,523,0,0
3773,861,758,1068,973,48,11,14,207,215,285,523,0,0
3774,863,758,1069,971,48,11,14,206,213,286,523,0,0
3775,863,758,1069,971,48,11,14,206,213,287,523,0,0
3776,863,754,1070,969,48,11,14,207,215,288,523,0,0
3777,863,754,1070,969,48,11,14,207,215,289,523,0,0
3778,860,752,1068,968,48,11,14,208,216,290,523,0,0
3779,859,751,1068,968,48,11,14,209,217,291,523,0,0
3780,858,752,1068,970,48,11,14,210,218,292,523,0,0
3781,859,751,1068,968,48,11,14,209,217,293,523,0,0
3782,860,750,1069,968,48,11,14,209,218,294,523,0,0
3783,859,749,1070,968,48,11,14,211,219,295,523,0,0
3784,860,749,1069,968,48,11,14,209,219,296,523,0,0
3785,860,751,1068,968,48,11,14,208,217,297,523,0,0
3786,858,750,1067,968,48,11,14,209,218,298,523,0,0
3787,857,750,1066,969,48,11,14,209,219,299,523,0,0
3788,858,751,1066,969,48,11,14,208,218,300,523,0,0
3789,858,751,1067,970,48,11,14,209,219,301,523,0,0
3790,857,750,1067,970,48,11,14,210,220,302,523,0,0
3791,858,756,1062,970,48,11,14,204,214,303,523,0,0
3792,857,753,1063,968,48,11,14,206,215,304,523,0,0
3793,858,751,1065,968,48,11,14,207,217,305,523,0,0
3794,858,751,1066,968,48,11,14,208,217,306,523,0,0
3795,858,751,1066,968,48,11,14,208,217,307,523,0,0
3796,857,754,1065,971,48,11,14,208,217,308,523,0,0
3797,858,756,1064,971,48,11,14,206,215,309,523,0,0
3798,858,758,1063,972,48,11,14,205,214,310,523,0,0
3799,858,757,1064,972,48,11,14,206,215,311,523,0,0
3800,858,758,1064,972,48,11,14,206,214,312,523,0,0
3801,859,758,1065,973,48,11,14,206,215,313,523,0,0
3802,860,759,1066,973,48,11,14,206,214,314,523,0,0
3803,861,759,1066,974,48,11,14,205,215,315,523,0,0
3804,859,755,1066,971,48,11,14,207,216,316,523,0,0
3805,862,757,1067,971,48,11,14,205,214,317,523,0,0
3806,861,759,1066,973,48,11,14,205,214,318,523,0,0
3807,864,759,1068,972,48,11,14,204,213,319,523,0,0
3808,863,761,1066,974,48,11,14,203,213,320,523,0,0
3809,863,763,1065,973,48,11,14,202,210,321,523,0,0
3810,863,763,1065,973,48,11,14,202,210,322,523,0,0
3811,863,760,1067,972,48,11,14,204,212,323,523,0,0
3812,864,759,1068,971,48,11,14,204,212,324,523,0,0
3813,864,759,1068,971,48,11,14,204,212,325,523,0,0
3814,864,759,1068,971,48,11,14,204,212,326,523,0,0
3815,864,759,1069,971,48,11,14,205,212,327,523,0,0
3816,860,758,1069,974,48,11,14,209,216,328,523,0,0
3817,860,760,1067,974,48,11,14,207,214,329,523,0,0
3818,862,760,1068,973,48,11,14,206,213,330,523,0,0
3819,860,758,1069,975,48,11,14,209,217,331,523,0,0
3820,863,759,1069,973,48,11,14,206,214,332,523,0,0
3821,862,759,1068,972,48,11,14,206,213,333,523,0,0
3822,860,759,1067,973,48,11,14,207,214,334,523,0,0
3823,860,759,1066,973,48,11,14,206,214,335,523,0,0
3824,860,757,1067,971,48,11,14,207,214,336,523,0,0
3825,859,756,1068,973,48,11,14,209,217,337,523,0,0
3826,858,758,1066,974,48,11,14,208,216,338,523,0,0
3827,857,757,1067,976,48,11,14,210,219,339,523,0,0
3828,857,758,1067,976,48,11,14,210,218,340,523,0,0
3829,858,759,1067,975,48,11,14,209,216,341,523,0,0
3830,857,757,1068,975,48,11,14,211,218,342,523,0,0
3831,861,757,1067,970,48,11,14,206,213,343,523,0,0
3832,862,757,1067,968,48,11,14,205,211,344,523,0,0
3833,863,757,1067,968,48,11,14,204,211,345,523,0,0
3834,863,757,1067,967,48,11,14,204,210,346,523,0,0
3835,863,756,1068,967,48,11,14,205,211,347,523,0,0
3836,859,758,1066,973,48,11,14,207,215,348,523,0,0
3837,857,759,1066,975,48,11,14,209,216,349,523,0,0
3838,857,758,1066,975,48,11,14,209,217,350,523,0,0
3839,857,759,1065,973,48,11,14,208,214,351,523,0,0
3840,855,755,1067,974,48,11,14,212,219,352,523,0,0
3841,860,756,1069,973,48,11,14,209,217,353,523,0,0
3842,858,757,1068,974,48,11,14,210,217,354,523,0,0
3843,861,757,1070,974,48,11,14,209,217,355,523,0,0
3844,862,758,1070,974,48,11,14,208,216,356,523,0,0
3845,863,758,1070,973,48,11,14,207,215,357,523,0,0
3846,861,759,1068,973,48,11,14,207,214,358,523,0,0
3847,861,759,1068,973,48,11,14,207,214,359,523,0,0
3848,861,760,1067,973,48,11,14,206,213,360,523,0,0
3849,860,760,1067,973,48,11,14,207,213,361,523,0,0
3850,860,760,1067,973,48,11,14,207,213,362,523,0,0
3851,858,754,1068,971,48,11,14,210,217,363,523,0,0
3852,861,755,1069,970,48,11,14,208,215,364,523,0,0
3853,858,753,1070,972,48,11,14,212,219,365,523,0,0
3854,862,755,1069,970,48,11,14,207,215,366,523,0,0
3855,858,753,1070,973,48,11,14,212,220,367,523,0,0
3856,861,755,1069,971,48,11,14,208,216,368,523,0,0
3857,862,755,1069,970,48,11,14,207,215,369,523,0,0
3858,861,754,1068,970,48,11,14,207,216,370,523,0,0
3859,859,752,1067,968,48,11,14,208,216,371,523,0,0
3860,860,753,1068,969,48,11,14,208,216,372,523,0,0
3861,862,754,1069,969,48,11,14,207,215,373,523,0,0
3862,862,755,1069,970,48,11,14,207,215,374,523,0,0
3863,862,755,1069,970,48,11,14,207,215,375,523,0,0
3864,860,755,1069,972,48,11,14,209,217,376,523,0,0
3865,861,754,1069,970,48,11,14,208,216,377,523,0,0
3866,859,754,1068,972,48,11,14,209,218,378,523,0,0
3867,860,757,1067,972,48,11,14,207,215,379,523,0,0
3868,860,756,1067,972,48,11,14,207,216,380,523,0,0
3869,861,758,1067,972,48,11,14,206,214,381,523,0,0
3870,859,756,1067,972,48,11,14,208,216,382,523,0,0
3871,863,758,1068,971,48,11,14,205,213,383,523,0,0
3872,864,758,1069,970,48,11,14,205,212,384,523,0,0
3873,859,756,1069,974,48,11,14,210,218,385,523,0,0
3874,859,758,1068,975,48,11,14,209,217,386,523,0,0
3875,860,759,1068,975,48,11,14,208,216,387,523,0,0
3876,858,753,1069,971,48,11,14,211,218,388,523,0,0
3877,857,751,1068,970,48,11,14,211,219,389,523,0,0
3878,857,751,1068,970,48,11,14,211,219,390,523,0,0
3879,857,750,1068,970,48,11,14,211,220,391,523,0,0
3880,857,749,1069,970,48,11,14,212,221,392,523,0,0
3881,857,749,1068,969,48,11,14,211,220,393,523,0,0
3882,857,749,1068,969,48,11,14,211,220,394,523,0,0
3883,857,749,1068,969,48,11,14,211,220,395,523,0,0
3884,862,755,1067,968,48,11,14,205,213,396,523,0,0
3885,865,757,1068,968,48,11,14,203,211,397,523,0,0
3886,862,757,1067,969,48,11,14,205,212,398,523,0,0
3887,861,757,1066,970,48,11,14,205,213,399,523,0,0
3888,862,754,1068,968,48,11,14,206,214,400,523,0,0
3889,859,752,1066,968,48,11,14,207,216,401,523,0,0
3890,861,753,1067,968,48,11,14,206,215,402,523,0,0
3891,858,755,1066,971,48,11,14,208,216,403,523,0,0
3892,858,753,1067,970,48,11,14,209,217,404,523,0,0
3893,858,756,1065,972,48,11,14,207,216,405,523,0,0
3894,857,757,1065,973,48,11,14,208,216,406,523,0,0
3895,858,754,1065,969,48,11,14,207,215,407,523,0,0
3896,860,757,1065,969,48,11,14,205,212,408,523,0,0
3897,861,758,1066,970,48,11,14,205,212,409,523,0,0
3898,861,758,1066,970,48,11,14,205,212,410,523,0,0
3899,860,758,1067,970,48,11,14,207,212,411,523,0,0
3900,860,758,1066,971,48,11,14,206,213,412,523,0,0
3901,859,754,1068,970,48,11,14,209,216,413,523,0,0
3902,858,752,1068,970,48,11,14,210,218,414,523,0,0
3903,860,757,1067,971,48,11,14,207,214,415,523,0,0
3904,859,753,1068,971,48,11,14,209,218,416,523,0,0
3905,860,758,1067,971,48,11,14,207,213,417,523,0,0
3906,861,761,1066,971,48,11,14,205,210,418,523,0,0
3907,860,762,1066,972,48,11,14,206,210,419,523,0,0
3908,860,762,1066,972,48,11,14,206,210,420,523,0,0
3909,859,762,1066,973,48,11,14,207,211,421,523,0,0
3910,858,760,1067,973,48,11,14,209,213,422,523,0,0
3911,857,754,1068,970,48,11,14,211,216,423,523,0,0
3912,857,752,1067,968,48,11,14,210,216,424,523,0,0
3913,857,752,1068,968,48,11,14,211,216,425,523,0,0
3914,857,751,1068,968,48,11,14,211,217,426,523,0,0
3915,858,754,1068,971,48,11,14,210,217,427,523,0,0
3916,858,756,1068,972,48,11,14,210,216,428,523,0,0
3917,858,756,1068,972,48,11,14,210,216,429,523,0,0
3918,858,757,1067,973,48,11,14,209,216,430,523,0,0
3919,858,753,1068,970,48,11,14,210,217,431,523,0,0
3920,858,755,1067,972,48,11,14,209,217,432,523,0,0
3921,860,757,1067,972,48,11,14,207,215,433,523,0,0
3922,864,758,1068,968,48,11,14,204,210,434,523,0,0
3923,865,758,1068,966,48,11,14,203,208,435,523,0,0
3924,865,757,1069,966,48,11,14,204,209,436,523,0,0
3925,865,757,1069,965,48,11,14,204,208,437,523,0,0
3926,860,753,1068,967,48,11,14,208,214,438,523,0,0
3927,857,750,1068,966,48,11,14,211,216,439,523,0,0
3928,858,755,1067,969,48,11,14,209,214,440,523,0,0
3929,861,755,1068,968,48,11,14,207,213,441,523,0,0
3930,862,755,1068,967,48,11,14,206,212,442,523,0,0
3931,864,757,1069,966,48,11,14,205,209,443,523,0,0
3932,862,758,1068,969,48,11,14,206,211,444,523,0,0
3933,861,758,1068,971,48,11,14,207,213,445,523,0,0
3934,861,759,1067,971,48,11,14,206,212,446,523,0,0
3935,861,758,1067,971,48,11,14,206,213,447,523,0,0
3936,859,759,1067,973,48,11,14,208,214,448,523,0,0
3937,859,759,1067,973,48,11,14,208,214,449,523,0,0
3938,859,760,1067,973,48,11,14,208,213,450,523,0,0
3939,859,760,1067,973,48,11,14,208,213,451,523,0,0
3940,860,760,1067,973,48,11,14,207,213,452,523,0,0
3941,857,753,1067,969,48,11,14,210,216,453,523,0,0
3942,862,755,1068,967,48,11,14,206,212,454,523,0,0
3943,864,757,1068,966,48,11,14,204,209,455,523,0,0
3944,859,752,1068,967,48,11,14,209,215,456,523,0,0
3945,862,755,1068,966,48,11,14,206,211,457,523,0,0
3946,857,751,1069,967,48,11,14,212,216,458,523,0,0
3947,856,750,1068,968,48,11,14,212,218,459,523,0,0
3948,857,755,1067,970,48,11,14,210,215,460,523,0,0
3949,858,756,1066,970,48,11,14,208,214,461,523,0,0
3950,858,758,1066,971,48,11,14,208,213,462,523,0,0
3951,861,758,1068,969,48,11,14,207,211,463,523,0,0
3952,863,758,1069,968,48,11,14,206,210,464,523,0,0
3953,861,756,1070,969,48,11,14,209,213,465,523,0,0
3954,861,756,1070,969,48,11,14,209,213,466,523,0,0
3955,862,756,1070,968,48,11,14,208,212,467,523,0,0
3956,858,752,1068,967,48,11,14,210,215,468,523,0,0
3957,856,749,1067,967,48,11,14,211,218,469,523,0,0
3958,855,749,1067,966,48,11,14,212,217,470,523,0,0
3959,860,752,1067,965,48,11,14,207,213,471,523,0,0
3960,857,750,1066,965,48,11,14,209,215,472,523,0,0
3961,857,754,1066,970,48,11,14,209,216,473,523,0,0
3962,858,750,1069,969,48,11,14,211,219,474,523,0,0
3963,859,756,1068,972,48,11,14,209,216,475,523,0,0
3964,858,757,1070,976,48,11,14,212,219,476,523,0,0
3965,852,745,1069,973,48,11,14,217,228,477,523,0,0
3966,851,744,1070,973,48,11,14,219,229,478,523,0,0
3968,846,752,1088,1011,48,11,14,242,259,0,523,0,0
3969,849,754,1080,1004,48,11,14,231,250,1,523,0,0
3970,859,756,1070,983,48,11,14,211,227,2,523,0,0
3971,862,754,1069,977,48,11,14,207,223,3,523,0,0
3972,863,752,1069,973,48,11,14,206,221,4,523,0,0
3973,861,751,1068,974,48,11,14,207,223,5,523,0,0
3974,859,750,1066,974,48,11,14,207,224,6,523,0,0
3975,862,750,1067,971,48,11,14,205,221,7,523,0,0
3976,864,754,1065,970,48,11,14,201,216,8,523,0,0
3977,854,756,1047,965,48,11,14,193,209,9,523,0,0
3978,836,775,1000,960,48,11,14,164,185,10,523,0,0
3979,832,777,992,959,48,11,14,160,182,11,523,0,0
3983,859,752,1058,977,48,11,14,199,225,0,523,0,1
3984,861,749,1065,980,48,11,14,204,231,1,523,0,0
3985,863,750,1065,979,48,11,14,202,229,2,523,0,0
3986,865,751,1064,973,48,11,14,199,222,3,523,0,0
3987,866,750,1063,971,48,11,14,197,221,4,523,0,0
3988,866,753,1063,971,48,11,14,197,218,5,523,0,0
3989,865,751,1063,969,48,11,14,198,218,6,523,0,0
3990,864,751,1063,969,48,11,14,199,218,7,523,0,0
3991,864,751,1063,968,48,11,14,199,217,8,523,0,0
3992,863,750,1063,968,48,11,14,200,218,9,523,0,0
3993,862,750,1063,968,48,11,14,201,218,10,523,0,0
3994,861,749,1063,968,48,11,14,202,219,11,523,0,0
3995,861,749,1064,968,48,11,14,203,219,12,523,0,0
3996,861,750,1064,968,48,11,14,203,218,13,523,0,0
3997,861,750,1064,968,48,11,14,203,218,14,523,0,0
3998,860,750,1064,968,48,11,14,204,218,15,523,0,0
3999,860,750,1064,968,48,11,14,204,218,16,523,0,0
4000,860,750,1065,968,48,11,14,205,218,17,523,0,0
4001,860,753,1065,972,48,11,14,205,219,18,523,0,0
4002,860,754,1065,972,48,11,14,205,218,19,523,0,0
4003,862,757,1065,972,48,11,14,203,215,20,523,0,0
4004,863,759,1065,972,48,11,14,202,213,21,523,0,0
4005,863,760,1065,972,48,11,14,202,212,22,523,0,0
4006,861,759,1065,972,48,11,14,204,213,23,523,0,0
4007,861,760,1065,973,48,11,14,204,213,24,523,0,0
4008,860,759,1065,973,48,11,14,205,214,25,523,0,0
4009,858,754,1067,971,48,11,14,209,217,26,523,0,0
4010,860,757,1066,972,48,11,14,206,215,27,523,0,0
4011,861,760,1064,970,48,11,14,203,210,28,523,0,0
4012,860,758,1065,970,48,11,14,205,212,29,523,0,0
4013,861,761,1062,968,48,11,14,201,207,30,523,0,0
4014,853,758,1070,985,48,11,14,217,227,31,523,0,0
4015,850,755,1071,988,48,11,14,221,233,32,523,0,0
4016,850,754,1070,988,48,11,14,220,234,33,523,0,0
4017,855,754,1066,978,48,11,14,211,224,34,523,0,0
4018,858,752,1063,970,48,11,14,205,218,35,523,0,0
4019,859,752,1062,968,48,11,14,203,216,36,523,0,0
4020,859,752,1062,968,48,11,14,203,216,37,523,0,0
4021,862,755,1066,972,48,11,14,204,217,38,523,0,0
4022,863,756,1067,974,48,11,14,204,218,39,523,0,0
4023,863,756,1068,974,48,11,14,205,218,40,523,0,0
4024,864,757,1068,975,48,11,14,204,218,41,523,0,0
4025,862,754,1067,973,48,11,14,205,219,42,523,0,0
4026,859,757,1064,975,48,11,14,205,218,43,523,0,0
4027,858,759,1063,976,48,11,14,205,217,44,523,0,0
4028,857,757,1065,977,48,11,14,208,220,45,523,0,0
4029,860,754,1069,976,48,11,14,209,222,46,523,0,0
4030,861,752,1070,975,48,11,14,209,223,47,523,0,0
4031,861,752,1071,976,48,11,14,210,224,48,523,0,0
4032,862,752,1071,976,48,11,14,209,224,49,523,0,0
4033,863,753,1070,975,48,11,14,207,222,50,523,0,0
4034,863,754,1069,975,48,11,14,206,221,51,523,0,0
4035,863,754,1068,975,48,11,14,205,221,52,523,0,0
4036,864,755,1068,974,48,11,14,204,219,53,523,0,0
4037,865,755,1067,973,48,11,14,202,218,54,523,0,0
4038,865,755,1067,973,48,11,14,202,218,55,523,0,0
4039,865,756,1066,973,48,11,14,201,217,56,523,0,0
4040,864,755,1067,973,48,11,14,203,218,57,523,0,0
4041,862,752,1066,972,48,11,14,204,220,58,523,0,0
4042,863,754,1066,973,48,11,14,203,219,59,523,0,0
4043,864,754,1067,973,48,11,14,203,219,60,523,0,0
4044,865,755,1067,973,48,11,14,202,218,61,523,0,0
4045,865,755,1067,973,48,11,14,202,218,62,523,0,0
4046,864,755,1066,974,48,11,14,202,219,63,523,0,0
4047,864,756,1066,974,48,11,14,202,218,64,523,0,0
4048,864,756,1066,974,48,11,14,202,218,65,523,0,0
4049,864,756,1066,975,48,11,14,202,219,66,523,0,0
4050,864,756,1066,975,48,11,14,202,219,67,523,0,0
4051,861,756,1064,976,48,11,14,203,220,68,523,0,0
4052,862,756,1066,978,48,11,14,204,222,69,523,0,0
4053,862,756,1067,978,48,11,14,205,222,70,523,0,0
4054,862,756,1067,978,48,11,14,205,222,71,523,0,0
4055,863,756,1067,978,48,11,14,204,222,72,523,0,0
4056,864,757,1066,977,48,11,14,202,220,73,523,0,0
4057,865,757,1066,976,48,11,14,201,219,74,523,0,0
4058,865,757,1066,976,48,11,14,201,219,75,523,0,0
4059,865,757,1066,975,48,11,14,201,218,76,523,0,0
4060,865,757,1065,975,48,11,14,200,218,77,523,0,0
4061,863,758,1063,974,48,11,14,200,216,78,523,0,0
4062,864,756,1065,974,48,11,14,201,218,79,523,0,0
4063,862,758,1063,975,48,11,14,201,217,80,523,0,0
4064,864,760,1064,975,48,11,14,200,215,81,523,0,0
4065,864,756,1066,973,48,11,14,202,217,82,523,0,0
4066,864,756,1068,975,48,11,14,204,219,83,523,0,0
4067,865,756,1069,975,48,11,14,204,219,84,523,0,0
4068,864,755,1069,975,48,11,14,205,220,85,523,0,0
4069,862,755,1068,974,48,11,14,206,219,86,523,0,0
4070,862,755,1069,975,48,11,14,207,220,87,523,0,0
4071,863,755,1070,976,48,11,14,207,221,88,523,0,0
4072,863,755,1070,976,48,11,14,207,221,89,523,0,0
4073,863,755,1071,977,48,11,14,208,222,90,523,0,0
4074,862,755,1071,977,48,11,14,209,222,91,523,0,0
4075,864,757,1069,974,48,11,14,205,217,92,523,0,0
4076,861,755,1066,971,48,11,14,205,216,93,523,0,0
4077,863,756,1065,969,48,11,14,202,213,94,523,0,0
4078,863,757,1065,968,48,11,14,202,211,95,523,0,0
4079,863,757,1065,968,48,11,14,202,211,96,523,0,0
4080,861,758,1066,970,48,11,14,205,212,97,523,0,0
4081,862,758,1067,970,48,11,14,205,212,98,523,0,0
4082,863,758,1067,969,48,11,14,204,211,99,523,0,0
4083,860,756,1067,970,48,11,14,207,214,100,523,0,0
4084,861,755,1067,969,48,11,14,206,214,101,523,0,0
4085,860,756,1066,970,48,11,14,206,214,102,523,0,0
4086,860,756,1066,970,48,11,14,206,214,103,523,0,0
4087,860,755,1066,969,48,11,14,206,214,104,523,0,0
4088,862,755,1065,966,48,11,14,203,211,105,523,0,0
4089,862,755,1066,966,48,11,14,204,211,106,523,0,0
4090,862,753,1070,969,48,11,14,208,216,107,523,0,0
4091,862,754,1071,971,48,11,14,209,217,108,523,0,0
4092,862,754,1071,971,48,11,14,209,217,109,523,0,0
4093,862,756,1070,971,48,11,14,208,215,110,523,0,0
4094,862,756,1070,972,48,11,14,208,216,111,523,0,0
4095,862,756,1071,972,48,11,14,209,216,112,523,0,0
4096,863,757,1070,972,48,11,14,207,215,113,523,0,0
4097,863,756,1071,972,48,11,14,208,216,114,523,0,0
4098,863,755,1071,972,48,11,14,208,217,115,523,0,0
4099,864,757,1069,971,48,11,14,205,214,116,523,0,0
4100,864,756,1070,971,48,11,14,206,215,117,523,0,0
4101,861,758,1068,973,48,11,14,207,215,118,523,0,0
4102,860,758,1067,973,48,11,14,207,215,119,523,0,0
4103,859,758,1068,974,48,11,14,209,216,120,523,0,0
4104,861,758,1067,972,48,11,14,206,214,121,523,0,0
4105,860,758,1068,974,48,11,14,208,216,122,523,0,0
4106,863,761,1067,971,48,11,14,204,210,123,523,0,0
4107,862,761,1067,971,48,11,14,205,210,124,523,0,0
4108,862,761,1067,971,48,11,14,205,210,125,523,0,0
4109,861,761,1068,972,48,11,14,207,211,126,523,0,0
4110,861,761,1068,972,48,11,14,207,211,127,523,0,0
4111,861,759,1070,971,48,11,14,209,212,128,523,0,0
4112,860,761,1068,971,48,11,14,208,210,129,523,0,0
4113,861,762,1068,972,48,11,14,207,210,130,523,0,0
4114,861,762,1068,972,48,11,14,207,210,131,523,0,0
4115,860,762,1069,972,48,11,14,209,210,132,523,0,0
4116,856,757,1070,974,48,11,14,214,217,133,523,0,0
4117,857,759,1068,973,48,11,14,211,214,134,523,0,0
4118,857,759,1068,973,48,11,14,211,214,135,523,0,0
4119,858,757,1071,973,48,11,14,213,216,136,523,0,0
4120,859,756,1071,972,48,11,14,212,216,137,523,0,0
4121,860,757,1070,972,48,11,14,210,215,138,523,0,0
4122,860,755,1071,971,48,11,14,211,216,139,523,0,0
4123,860,757,1069,970,48,11,14,209,213,140,523,0,0
4124,862,756,1069,970,48,11,14,207,214,141,523,0,0
4125,861,758,1068,970,48,11,14,207,212,142,523,0,0
4126,862,758,1068,970,48,11,14,206,212,143,523,0,0
4127,862,761,1068,972,48,11,14,206,211,144,523,0,0
4128,861,759,1067,971,48,11,14,206,212,145,523,0,0
4129,860,760,1067,971,48,11,14,207,211,146,523,0,0
4130,860,760,1068,971,48,11,14,208,211,147,523,0,0
4131,859,759,1066,970,48,11,14,207,211,148,523,0,0
4132,860,757,1068,970,48,11,14,208,213,149,523,0,0
4133,860,757,1068,970,48,11,14,208,213,150,523,0,0
4134,861,757,1068,970,48,11,14,207,213,151,523,0,0
4135,862,757,1069,968,48,11,14,207,211,152,523,0,0
4136,862,757,1071,970,48,11,14,209,213,153,523,0,0
4137,862,757,1071,970,48,11,14,209,213,154,523,0,0
4138,863,757,1071,970,48,11,14,208,213,155,523,0,0
4139,861,756,1070,970,48,11,14,209,214,156,523,0,0
4140,861,758,1069,970,48,11,14,208,212,157,523,0,0
4141,861,758,1069,971,48,11,14,208,213,158,523,0,0
4142,861,758,1068,970,48,11,14,207,212,159,523,0,0
4143,861,757,1068,970,48,11,14,207,213,160,523,0,0
4144,861,757,1068,970,48,11,14,207,213,161,523,0,0
4145,861,757,1068,970,48,11,14,207,213,162,523,0,0
4146,861,759,1067,971,48,11,14,206,212,163,523,0,0
4147,861,759,1068,971,48,11,14,207,212,164,523,0,0
4148,861,759,1068,971,48,11,14,207,212,165,523,0,0
4149,861,759,1068,972,48,11,14,207,213,166,523,0,0
4150,861,759,1068,972,48,11,14,207,213,167,523,0,0
4151,860,760,1065,970,48,11,14,205,210,168,523,0,0
4152,860,759,1066,970,48,11,14,206,211,169,523,0,0
4153,860,759,1066,970,48,11,14,206,211,170,523,0,0
4154,860,759,1067,970,48,11,14,207,211,171,523,0,0
4155,859,758,1067,970,48,11,14,208,212,172,523,0,0
4156,860,755,1070,970,48,11,14,210,215,173,523,0,0
4157,860,757,1069,971,48,11,14,209,214,174,523,0,0
4158,860,758,1068,971,48,11,14,208,213,175,523,0,0
4159,859,758,1067,971,48,11,14,208,213,176,523,0,0
4160,859,758,1068,972,48,11,14,209,214,177,523,0,0
4161,861,756,1070,970,48,11,14,209,214,178,523,0,0
4162,861,756,1070,970,48,11,14,209,214,179,523,0,0
4163,861,755,1070,970,48,11,14,209,215,180,523,0,0
4164,860,755,1070,970,48,11,14,210,215,181,523,0,0
4165,861,754,1070,970,48,11,14,209,216,182,523,0,0
4166,861,756,1069,970,48,11,14,208,214,183,523,0,0
4167,862,757,1068,970,48,11,14,206,213,184,523,0,0
4168,861,756,1069,970,48,11,14,208,214,185,523,0,0
4169,861,756,1070,970,48,11,14,209,214,186,523,0,0
4170,861,756,1070,970,48,11,14,209,214,187,523,0,0
4171,861,755,1071,972,48,11,14,210,217,188,523,0,0
4172,861,756,1070,971,48,11,14,209,215,189,523,0,0
4173,861,755,1071,971,48,11,14,210,216,190,523,0,0
4174,861,755,1071,971,48,11,14,210,216,191,523,0,0
4175,861,754,1072,972,48,11,14,211,218,192,523,0,0
4176,861,755,1071,971,48,11,14,210,216,193,523,0,0
4177,862,755,1070,970,48,11,14,208,215,194,523,0,0
4178,862,755,1070,970,48,11,14,208,215,195,523,0,0
4179,862,755,1070,970,48,11,14,208,215,196,523,0,0
4180,862,754,1070,970,48,11,14,208,216,197,523,0,0
4181,863,755,1070,970,48,11,14,207,215,198,523,0,0
4182,863,757,1069,970,48,11,14,206,213,199,523,0,0
4183,863,756,1070,969,48,11,14,207,213,200,523,0,0
4184,862,756,1069,969,48,11,14,207,213,201,523,0,0
4185,862,758,1068,969,48,11,14,206,211,202,523,0,0
4186,861,755,1070,971,48,11,14,209,216,203,523,0,0
4187,860,754,1071,972,48,11,14,211,218,204,523,0,0
4188,861,754,1071,970,48,11,14,210,216,205,523,0,0
4189,862,753,1071,970,48,11,14,209,217,206,523,0,0
4190,862,753,1071,970,48,11,14,209,217,207,523,0,0
4191,861,756,1069,971,48,11,14,208,215,208,523,0,0
4192,861,757,1068,971,48,11,14,207,214,209,523,0,0
4193,861,757,1068,971,48,11,14,207,214,210,523,0,0
4194,861,758,1068,972,48,11,14,207,214,211,523,0,0
4195,861,758,1068,972,48,11,14,207,214,212,523,0,0
4196,861,759,1068,972,48,11,14,207,213,213,523,0,0
4197,861,760,1069,972,48,11,14,208,212,214,523,0,0
4198,861,760,1069,972,48,11,14,208,212,215,523,0,0
4199,861,759,1069,972,48,11,14,208,213,216,523,0,0
4200,861,760,1067,972,48,11,14,206,212,217,523,0,0
4201,860,757,1070,972,48,11,14,210,215,218,523,0,0
4202,861,756,1071,971,48,11,14,210,215,219,523,0,0
4203,862,756,1071,971,48,11,14,209,215,220,523,0,0
4204,861,758,1069,972,48,11,14,208,214,221,523,0,0
4205,860,759,1069,972,48,11,14,209,213,222,523,0,0
4206,861,757,1070,971,48,11,14,209,214,223,523,0,0
4207,861,759,1069,971,48,11,14,208,212,224,523,0,0
4208,861,757,1071,971,48,11,14,210,214,225,523,0,0
4209,860,758,1069,971,48,11,14,209,213,226,523,0,0
4210,860,759,1068,971,48,11,14,208,212,227,523,0,0
4211,861,757,1071,971,48,11,14,210,214,228,523,0,0
4212,861,756,1071,971,48,11,14,210,215,229,523,0,0
4213,860,758,1069,972,48,11,14,209,214,230,523,0,0
4214,862,756,1071,971,48,11,14,209,215,231,523,0,0
4215,861,758,1069,971,48,11,14,208,213,232,523,0,0
4216,859,756,1070,973,48,11,14,211,217,233,523,0,0
4217,859,756,1070,973,48,11,14,211,217,234,523,0,0
4218,860,756,1071,974,48,11,14,211,218,235,523,0,0
4219,861,755,1070,972,48,11,14,209,217,236,523,0,0
4220,860,755,1070,972,48,11,14,210,217,237,523,0,0
4221,859,755,1070,974,48,11,14,211,219,238,523,0,0
4222,859,756,1069,974,48,11,14,210,218,239,523,0,0
4223,859,756,1069,975,48,11,14,210,219,240,523,0,0
4224,859,756,1069,975,48,11,14,210,219,241,523,0,0
4225,859,756,1069,975,48,11,14,210,219,242,523,0,0
4226,860,756,1069,973,48,11,14,209,217,243,523,0,0
4227,861,755,1069,972,48,11,14,208,217,244,523,0,0
4228,861,755,1069,972,48,11,14,208,217,245,523,0,0
4229,861,755,1069,972,48,11,14,208,217,246,523,0,0
4230,861,757,1068,973,48,11,14,207,216,247,523,0,0
4231,863,755,1069,969,48,11,14,206,214,248,523,0,0
4232,862,754,1069,969,48,11,14,207,215,249,523,0,0
4233,861,754,1069,970,48,11,14,208,216,250,523,0,0
4234,861,756,1068,971,48,11,14,207,215,251,523,0,0
4235,861,757,1068,971,48,11,14,207,214,252,523,0,0
4236,861,756,1069,970,48,11,14,208,214,253,523,0,0
4237,862,755,1069,969,48,11,14,207,214,254,523,0,0
4238,861,755,1069,970,48,11,14,208,215,255,523,0,0
4239,861,755,1069,970,48,11,14,208,215,256,523,0,0
4240,861,755,1070,970,48,11,14,209,215,257,523,0,0
4241,861,756,1068,970,48,11,14,207,214,258,523,0,0
4242,860,756,1067,970,48,11,14,207,214,259,523,0,0
4243,860,756,1067,970,48,11,14,207,214,260,523,0,0
4244,860,757,1067,970,48,11,14,207,213,261,523,0,0
4245,860,757,1067,970,48,11,14,207,213,262,523,0,0
4246,860,756,1069,971,48,11,14,209,215,263,523,0,0
4247,861,757,1069,971,48,11,14,208,214,264,523,0,0
4248,860,757,1070,971,48,11,14,210,214,265,523,0,0
4249,860,757,1069,971,48,11,14,209,214,266,523,0,0
4250,860,757,1069,972,48,11,14,209,215,267,523,0,0
4251,861,756,1070,970,48,11,14,209,214,268,523,0,0
4252,862,756,1070,969,48,11,14,208,213,269,523,0,0
4253,862,757,1070,969,48,11,14,208,212,270,523,0,0
4254,863,757,1070,969,48,11,14,207,212,271,523,0,0
4255,863,757,1070,969,48,11,14,207,212,272,523,0,0
4256,861,757,1070,971,48,11,14,209,214,273,523,0,0
4257,860,759,1067,972,48,11,14,207,213,274,523,0,0
4258,860,758,1069,972,48,11,14,209,214,275,523,0,0
4259,860,756,1069,971,48,11,14,209,215,276,523,0,0
4260,860,755,1070,971,48,11,14,210,216,277,523,0,0
4261,859,754,1069,971,48,11,14,210,217,278,523,0,0
4262,858,754,1067,971,48,11,14,209,217,279,523,0,0
4263,857,750,1068,970,48,11,14,211,220,280,523,0,0
4264,855,749,1069,974,48,11,14,214,225,281,523,0,0
4265,858,754,1070,977,48,11,14,212,223,282,523,0,0
4266,859,753,1071,977,48,11,14,212,224,283,523,0,0
4267,859,752,1071,976,48,11,14,212,224,284,523,0,0
4268,859,749,1072,975,48,11,14,213,226,285,523,0,0
4269,861,752,1071,976,48,11,14,210,224,286,523,0,0
4270,861,752,1071,976,48,11,14,210,224,287,523,0,0
4271,863,752,1072,975,48,11,14,209,223,288,523,0,0
4272,860,749,1071,975,48,11,14,211,226,289,523,0,0
4273,863,752,1071,975,48,11,14,208,223,290,523,0,0
4274,862,754,1069,977,48,11,14,207,223,291,523,0,0
4275,861,755,1069,979,48,11,14,208,224,292,523,0,0
4276,862,756,1068,978,48,11,14,206,222,293,523,0,0
4277,862,755,1068,978,48,11,14,206,223,294,523,0,0
4278,861,755,1067,978,48,11,14,206,223,295,523,0,0
4279,863,757,1066,977,48,11,14,203,220,296,523,0,0
4280,862,757,1066,977,48,11,14,204,220,297,523,0,0
4281,862,757,1067,978,48,11,14,205,221,298,523,0,0
4282,860,751,1069,976,48,11,14,209,225,299,523,0,0
4283,862,755,1068,977,48,11,14,206,222,300,523,0,0
4284,861,751,1069,976,48,11,14,208,225,301,523,0,0
4285,862,754,1067,976,48,11,14,205,222,302,523,0,0
4286,862,752,1067,974,48,11,14,205,222,303,523,0,0
4287,861,750,1067,974,48,11,14,206,224,304,523,0,0
4288,860,750,1067,974,48,11,14,207,224,305,523,0,0
4289,861,754,1066,976,48,11,14,205,222,306,523,0,0
4290,863,756,1066,976,48,11,14,203,220,307,523,0,0
4291,863,757,1066,976,48,11,14,203,219,308,523,0,0
4292,863,757,1066,976,48,11,14,203,219,309,523,0,0
4293,864,757,1066,976,48,11,14,202,219,310,523,0,0
4294,863,757,1066,976,48,11,14,203,219,311,523,0,0
4295,864,756,1066,974,48,11,14,202,218,312,523,0,0
4296,861,752,1067,974,48,11,14,206,222,313,523,0,0
4297,860,755,1064,975,48,11,14,204,220,314,523,0,0
4298,863,755,1067,976,48,11,14,204,221,315,523,0,0
4299,863,754,1068,976,48,11,14,205,222,316,523,0,0
4300,864,754,1068,976,48,11,14,204,222,317,523,0,0
4301,862,751,1068,974,48,11,14,206,223,318,523,0,0
4302,864,753,1067,972,48,11,14,203,219,319,523,0,0
4303,862,750,1068,972,48,11,14,206,222,320,523,0,0
4304,863,755,1067,976,48,11,14,204,221,321,523,0,0
4305,862,751,1067,974,48,11,14,205,223,322,523,0,0
4306,861,749,1067,973,48,11,14,206,224,323,523,0,0
4307,862,754,1066,975,48,11,14,204,221,324,523,0,0
4308,861,751,1067,974,48,11,14,206,223,325,523,0,0
4309,860,749,1067,974,48,11,14,207,225,326,523,0,0
4310,860,749,1067,973,48,11,14,207,224,327,523,0,0
4311,860,748,1067,973,48,11,14,207,225,328,523,0,0
4312,859,748,1067,973,48,11,14,208,225,329,523,0,0
4313,859,747,1067,973,48,11,14,208,226,330,523,0,0
4314,859,747,1067,973,48,11,14,208,226,331,523,0,0
4315,862,751,1068,975,48,11,14,206,224,332,523,0,0
4316,865,753,1069,975,48,11,14,204,222,333,523,0,0
4317,865,754,1068,975,48,11,14,203,221,334,523,0,0
4318,864,756,1068,978,48,11,14,204,222,335,523,0,0
4319,865,754,1069,976,48,11,14,204,222,336,523,0,0
4320,865,754,1069,976,48,11,14,204,222,337,523,0,0
4321,865,754,1068,975,48,11,14,203,221,338,523,0,0
4322,864,755,1067,976,48,11,14,203,221,339,523,0,0
4323,864,757,1066,976,48,11,14,202,219,340,523,0,0
4324,863,756,1067,977,48,11,14,204,221,341,523,0,0
4325,863,756,1067,977,48,11,14,204,221,342,523,0,0
4326,861,752,1067,976,48,11,14,206,224,343,523,0,0
4327,860,750,1067,975,48,11,14,207,225,344,523,0,0
4328,860,750,1067,975,48,11,14,207,225,345,523,0,0
4329,860,749,1067,975,48,11,14,207,226,346,523,0,0
4330,860,749,1067,975,48,11,14,207,226,347,523,0,0
4331,862,754,1065,975,48,11,14,203,221,348,523,0,0
4332,862,756,1065,975,48,11,14,203,219,349,523,0,0
4333,863,756,1065,975,48,11,14,202,219,350,523,0,0
4334,863,757,1065,975,48,11,14,202,218,351,523,0,0
4335,863,757,1065,976,48,11,14,202,219,352,523,0,0
4336,862,755,1065,974,48,11,14,203,219,353,523,0,0
4337,862,755,1065,975,48,11,14,203,220,354,523,0,0
4338,861,751,1066,973,48,11,14,205,222,355,523,0,0
4339,858,747,1069,974,48,11,14,211,227,356,523,0,0
4340,848,730,1071,976,48,11,14,223,246,357,523,0,0
4341,846,708,1080,970,48,11,14,234,262,358,523,0,0
4342,857,691,1077,942,48,11,14,220,251,359,523,0,0
4343,846,678,1082,954,48,11,14,236,276,360,523,0,0
4344,841,674,1075,956,48,11,14,234,282,361,523,0,0
4345,845,676,1073,955,48,11,14,228,279,362,523,0,0
4346,850,682,1075,959,48,11,14,225,277,363,523,0,0
4347,853,688,1075,961,48,11,14,222,273,364,523,0,0
4348,852,693,1073,965,48,11,14,221,272,365,523,0,0
4349,857,699,1073,965,48,11,14,216,266,366,523,0,0
4350,854,692,1076,965,48,11,14,222,273,367,523,0,0
4351,851,684,1077,964,48,11,14,226,280,368,523,0,0
4352,850,680,1079,964,48,11,14,229,284,369,523,0,0
4353,849,678,1080,966,48,11,14,231,288,370,523,0,0
4354,850,680,1078,966,48,11,14,228,286,371,523,0,0
4355,851,690,1071,967,48,11,14,220,277,372,523,0,0
4356,851,695,1067,969,48,11,14,216,274,373,523,0,0
4357,855,699,1065,966,48,11,14,210,267,374,523,0,0
4358,853,698,1066,968,48,11,14,213,270,375,523,0,0
4359,854,693,1068,967,48,11,14,214,274,376,523,0,0
4360,856,686,1073,965,48,11,14,217,279,377,523,0,0
4361,856,685,1074,968,48,11,14,218,283,378,523,0,0
4362,857,686,1074,970,48,11,14,217,284,379,523,0,0
4363,856,686,1071,968,48,11,14,215,282,380,523,0,0
4364,856,687,1070,967,48,11,14,214,280,381,523,0,0
4365,858,687,1070,967,48,11,14,212,280,382,523,0,0
4366,858,686,1069,966,48,11,14,211,280,383,523,0,0
4367,860,684,1071,964,48,11,14,211,280,384,523,0,0
4368,859,685,1069,964,48,11,14,210,279,385,523,0,0
4369,860,684,1069,963,48,11,14,209,279,386,523,0,0
4370,861,684,1069,963,48,11,14,208,279,387,523,0,0
4371,861,684,1069,963,48,11,14,208,279,388,523,0,0
4372,862,684,1070,964,48,11,14,208,280,389,523,0,0
4373,861,686,1068,965,48,11,14,207,279,390,523,0,0
4374,861,691,1065,966,48,11,14,204,275,391,523,0,0
4375,862,695,1065,966,48,11,14,203,271,392,523,0,0
4376,864,698,1064,964,48,11,14,200,266,393,523,0,0
4377,865,699,1063,962,48,11,14,198,263,394,523,0,0
4378,864,700,1063,963,48,11,14,199,263,395,523,0,0
4379,863,699,1064,963,48,11,14,201,264,396,523,0,0
4380,863,700,1064,963,48,11,14,201,263,397,523,0,0
4381,861,699,1064,964,48,11,14,203,265,398,523,0,0
4382,860,699,1064,965,48,11,14,204,266,399,523,0,0
4383,860,699,1065,965,48,11,14,205,266,400,523,0,0
4384,861,699,1066,964,48,11,14,205,265,401,523,0,0
4385,862,698,1067,964,48,11,14,205,266,402,523,0,0
4386,861,700,1067,966,48,11,14,206,266,403,523,0,0
4387,860,700,1066,967,48,11,14,206,267,404,523,0,0
4388,859,700,1065,967,48,11,14,206,267,405,523,0,0
4389,859,701,1065,967,48,11,14,206,266,406,523,0,0
4390,858,698,1066,967,48,11,14,208,269,407,523,0,0
4391,856,696,1065,966,48,11,14,209,270,408,523,0,0
4392,855,693,1066,966,48,11,14,211,273,409,523,0,0
4393,854,692,1066,966,48,11,14,212,274,410,523,0,0
4394,854,692,1065,966,48,11,14,211,274,411,523,0,0
4395,854,690,1066,965,48,11,14,212,275,412,523,0,0
4396,854,681,1069,963,48,11,14,215,282,413,523,0,0
4397,853,675,1069,959,48,11,14,216,284,414,523,0,0
4398,852,672,1071,962,48,11,14,219,290,415,523,0,0
4399,853,675,1070,963,48,11,14,217,288,416,523,0,0
4400,854,677,1070,963,48,11,14,216,286,417,523,0,0
4401,855,676,1073,965,48,11,14,218,289,418,523,0,0
4402,853,675,1069,965,48,11,14,216,290,419,523,0,0
4403,856,680,1070,968,48,11,14,214,288,420,523,0,0
4404,858,683,1070,968,48,11,14,212,285,421,523,0,0
4405,855,679,1069,968,48,11,14,214,289,422,523,0,0
4406,859,684,1069,968,48,11,14,210,284,423,523,0,0
4407,861,690,1068,969,48,11,14,207,279,424,523,0,0
4408,862,695,1066,969,48,11,14,204,274,425,523,0,0
4409,863,698,1065,969,48,11,14,202,271,426,523,0,0
4410,863,701,1063,969,48,11,14,200,268,427,523,0,0
4411,862,703,1060,966,48,11,14,198,263,428,523,0,0
4412,862,704,1060,965,48,11,14,198,261,429,523,0,0
4413,861,704,1060,965,48,11,14,199,261,430,523,0,0
4414,861,704,1060,964,48,11,14,199,260,431,523,0,0
4415,861,704,1062,964,48,11,14,201,260,432,523,0,0
4416,860,703,1062,964,48,11,14,202,261,433,523,0,0
4417,860,703,1063,964,48,11,14,203,261,434,523,0,0
4418,860,703,1063,964,48,11,14,203,261,435,523,0,0
4419,859,703,1064,964,48,11,14,205,261,436,523,0,0
4420,859,703,1064,964,48,11,14,205,261,437,523,0,0
4421,862,707,1063,962,48,11,14,201,255,438,523,0,0
4422,862,708,1062,961,48,11,14,200,253,439,523,0,0
4423,858,704,1062,962,48,11,14,204,258,440,523,0,0
4424,857,703,1063,962,48,11,14,206,259,441,523,0,0
4425,857,702,1064,963,48,11,14,207,261,442,523,0,0
4426,856,704,1062,963,48,11,14,206,259,443,523,0,0
4427,861,703,1065,959,48,11,14,204,256,444,523,0,0
4428,861,703,1066,959,48,11,14,205,256,445,523,0,0
4429,857,701,1064,960,48,11,14,207,259,446,523,0,0
4430,854,696,1065,960,48,11,14,211,264,447,523,0,0
4431,853,693,1066,961,48,11,14,213,268,448,523,0,0
4432,853,693,1066,962,48,11,14,213,269,449,523,0,0
4433,853,692,1066,962,48,11,14,213,270,450,523,0,0
4434,854,691,1066,962,48,11,14,212,271,451,523,0,0
4435,855,692,1065,962,48,11,14,210,270,452,523,0,0
4436,856,693,1067,963,48,11,14,211,270,453,523,0,0
4437,856,694,1067,964,48,11,14,211,270,454,523,0,0
4438,856,694,1067,964,48,11,14,211,270,455,523,0,0
4439,857,695,1067,965,48,11,14,210,270,456,523,0,0
4440,856,695,1067,965,48,11,14,211,270,457,523,0,0
4441,858,697,1066,964,48,11,14,208,267,458,523,0,0
4442,858,698,1065,964,48,11,14,207,266,459,523,0,0
4443,858,698,1065,964,48,11,14,207,266,460,523,0,0
4444,858,698,1065,964,48,11,14,207,266,461,523,0,0
4445,858,698,1065,964,48,11,14,207,266,462,523,0,0
4446,858,697,1066,964,48,11,14,208,267,463,523,0,0
4447,858,696,1066,964,48,11,14,208,268,464,523,0,0
4448,857,696,1067,964,48,11,14,210,268,465,523,0,0
4449,857,696,1067,964,48,11,14,210,268,466,523,0,0
4450,857,696,1067,964,48,11,14,210,268,467,523,0,0
4451,856,696,1066,966,48,11,14,210,270,468,523,0,0
4452,855,696,1065,966,48,11,14,210,270,469,523,0,0
4453,855,696,1065,967,48,11,14,210,271,470,523,0,0
4454,855,696,1065,967,48,11,14,210,271,471,523,0,0
4455,856,696,1064,965,48,11,14,208,269,472,523,0,0
4456,858,697,1066,964,48,11,14,208,267,473,523,0,0
4457,859,698,1066,963,48,11,14,207,265,474,523,0,0
4458,860,698,1066,963,48,11,14,206,265,475,523,0,0
4459,861,698,1068,962,48,11,14,207,264,476,523,0,0
4460,860,698,1067,963,48,11,14,207,265,477,523,0,0
4461,859,698,1065,963,48,11,14,206,265,478,523,0,0
4462,859,699,1065,962,48,11,14,206,263,479,523,0,0
4463,859,699,1065,962,48,11,14,206,263,480,523,0,0
4464,859,699,1064,962,48,11,14,205,263,481,523,0,0
4465,855,698,1061,964,48,11,14,206,266,482,523,0,0
4466,858,698,1065,964,48,11,14,207,266,483,523,0,0
4467,858,700,1064,966,48,11,14,206,266,484,523,0,0
4468,858,702,1064,967,48,11,14,206,265,485,523,0,0
4469,861,704,1066,966,48,11,14,205,262,486,523,0,0
4470,860,706,1064,967,48,11,14,204,261,487,523,0,0
4471,857,706,1061,966,48,11,14,204,260,488,523,0,0
4472,856,706,1059,966,48,11,14,203,260,489,523,0,0
4473,857,706,1059,966,48,11,14,202,260,490,523,0,0
4474,857,706,1058,966,48,11,14,201,260,491,523,0,0
4475,857,706,1058,966,48,11,14,201,260,492,523,0,0
4476,857,705,1059,967,48,11,14,202,262,493,523,0,0
4477,857,705,1058,967,48,11,14,201,262,494,523,0,0
4478,857,705,1059,967,48,11,14,202,262,495,523,0,0
4479,857,705,1059,967,48,11,14,202,262,496,523,0,0
4480,858,705,1060,967,48,11,14,202,262,497,523,0,0
4481,857,701,1062,967,48,11,14,205,266,498,523,0,0
4482,857,695,1065,966,48,11,14,208,271,499,523,0,0
4483,858,693,1066,966,48,11,14,208,273,500,523,0,0
4484,857,695,1064,967,48,11,14,207,272,501,523,0,0
4485,856,696,1063,967,48,11,14,207,271,502,523,0,0
4486,857,698,1063,968,48,11,14,206,270,503,523,0,0
4487,858,699,1063,968,48,11,14,205,269,504,523,0,0
4488,857,699,1063,969,48,11,14,206,270,505,523,0,0
4489,858,700,1062,970,48,11,14,204,270,506,523,0,0
4490,858,700,1062,969,48,11,14,204,269,507,523,0,0
4491,857,700,1061,968,48,11,14,204,268,508,523,0,0
4492,857,701,1060,967,48,11,14,203,266,509,523,0,0
4493,857,701,1059,967,48,11,14,202,266,510,523,0,0
4494,856,700,1059,967,48,11,14,203,267,511,523,0,0
4495,857,699,1060,966,48,11,14,203,267,512,523,0,0
4496,856,699,1059,965,48,11,14,203,266,513,523,0,0
4497,855,696,1058,965,48,11,14,203,269,514,523,0,0
4498,857,697,1060,965,48,11,14,203,268,515,523,0,0
4499,857,697,1060,965,48,11,14,203,268,516,523,0,0
4500,858,697,1060,965,48,11,14,202,268,517,523,0,0
4501,856,696,1060,965,48,11,14,204,269,518,523,0,0
4502,856,696,1061,965,48,11,14,205,269,519,523,0,0
4503,855,696,1060,965,48,11,14,205,269,520,523,0,0
4504,858,700,1061,967,48,11,14,203,267,521,523,0,0
4505,851,704,1050,967,48,11,14,199,263,522,523,0,0
4506,850,704,1049,967,48,11,14,199,263,523,523,1,0
4508,873,702,1070,967,48,11,14,197,265,0,523,0,1
4509,867,707,1062,970,48,11,14,195,263,1,523,0,0
4510,865,710,1057,968,48,11,14,192,258,2,523,0,0
4511,867,711,1058,965,48,11,14,191,254,3,523,0,0
4512,869,709,1060,964,48,11,14,191,255,4,523,0,0
4513,866,707,1059,964,48,11,14,193,257,5,523,0,0
4514,863,705,1059,966,48,11,14,196,261,6,523,0,0
4515,861,706,1058,966,48,11,14,197,260,7,523,0,0
4516,860,704,1059,968,48,11,14,199,264,8,523,0,0
4517,859,704,1059,968,48,11,14,200,264,9,523,0,0
4518,859,704,1059,968,48,11,14,200,264,10,523,0,0
4519,859,703,1060,968,48,11,14,201,265,11,523,0,0
4520,859,703,1060,968,48,11,14,201,265,12,523,0,0
4521,858,703,1059,968,48,11,14,201,265,13,523,0,0
4522,857,703,1058,968,48,11,14,201,265,14,523,0,0
4523,856,703,1058,969,48,11,14,202,266,15,523,0,0
4524,856,703,1058,969,48,11,14,202,266,16,523,0,0
4525,856,703,1058,968,48,11,14,202,265,17,523,0,0
4526,856,703,1058,968,48,11,14,202,265,18,523,0,0
4527,856,703,1057,968,48,11,14,201,265,19,523,0,0
4528,855,703,1058,969,48,11,14,203,266,20,523,0,0
4529,855,701,1058,969,48,11,14,203,268,21,523,0,0
4530,856,701,1059,967,48,11,14,203,266,22,523,0,0
4531,856,700,1059,967,48,11,14,203,267,23,523,0,0
4532,856,700,1059,967,48,11,14,203,267,24,523,0,0
4533,856,700,1059,967,48,11,14,203,267,25,523,0,0
4534,856,700,1059,967,48,11,14,203,267,26,523,0,0
4535,857,700,1059,967,48,11,14,202,267,27,523,0,0
4536,857,700,1059,966,48,11,14,202,266,28,523,0,0
4537,857,701,1058,966,48,11,14,201,265,29,523,0,0
4538,857,701,1058,966,48,11,14,201,265,30,523,0,0
4539,858,702,1058,966,48,11,14,200,264,31,523,0,0
4540,858,702,1059,966,48,11,14,201,264,32,523,0,0
4541,857,702,1059,968,48,11,14,202,266,33,523,0,0
4542,857,701,1059,968,48,11,14,202,267,34,523,0,0
4543,857,701,1059,968,48,11,14,202,267,35,523,0,0
4544,857,701,1059,969,48,11,14,202,268,36,523,0,0
4545,857,697,1060,967,48,11,14,203,270,37,523,0,0
4546,857,691,1062,965,48,11,14,205,274,38,523,0,0
4547,856,688,1064,965,48,11,14,208,277,39,523,0,0
4548,856,687,1064,965,48,11,14,208,278,40,523,0,0
4549,856,688,1065,966,48,11,14,209,278,41,523,0,0
4550,857,689,1064,965,48,11,14,207,276,42,523,0,0
4551,858,691,1062,963,48,11,14,204,272,43,523,0,0
4552,858,692,1061,963,48,11,14,203,271,44,523,0,0
4553,861,690,1063,960,48,11,14,202,270,45,523,0,0
4554,859,692,1062,962,48,11,14,203,270,46,523,0,0
4555,859,693,1061,962,48,11,14,202,269,47,523,0,0
4556,860,691,1063,962,48,11,14,203,271,48,523,0,0
4557,859,692,1062,963,48,11,14,203,271,49,523,0,0
4558,858,693,1061,963,48,11,14,203,270,50,523,0,0
4559,858,694,1061,964,48,11,14,203,270,51,523,0,0
4560,859,695,1062,964,48,11,14,203,269,52,523,0,0
4561,858,696,1060,965,48,11,14,202,269,53,523,0,0
4562,858,696,1060,965,48,11,14,202,269,54,523,0,0
4563,857,696,1060,965,48,11,14,203,269,55,523,0,0
4564,857,696,1059,964,48,11,14,202,268,56,523,0,0
4565,857,696,1059,964,48,11,14,202,268,57,523,0,0
4566,858,696,1059,962,48,11,14,201,266,58,523,0,0
4567,858,696,1059,962,48,11,14,201,266,59,523,0,0
4568,858,696,1059,962,48,11,14,201,266,60,523,0,0
4569,858,696,1059,962,48,11,14,201,266,61,523,0,0
4570,857,696,1059,962,48,11,14,202,266,62,523,0,0
4571,856,696,1059,964,48,11,14,203,268,63,523,0,0
4572,856,697,1059,965,48,11,14,203,268,64,523,0,0
4573,856,697,1059,965,48,11,14,203,268,65,523,0,0
4574,856,697,1059,966,48,11,14,203,269,66,523,0,0
4575,856,696,1060,966,48,11,14,204,270,67,523,0,0
4576,856,696,1060,966,48,11,14,204,270,68,523,0,0
4577,856,695,1060,966,48,11,14,204,271,69,523,0,0
4578,856,695,1061,967,48,11,14,205,272,70,523,0,0
4579,855,694,1061,968,48,11,14,206,274,71,523,0,0
4580,855,694,1061,968,48,11,14,206,274,72,523,0,0
4581,854,693,1059,967,48,11,14,205,274,73,523,0,0
4582,854,694,1059,967,48,11,14,205,273,74,523,0,0
4583,854,695,1058,968,48,11,14,204,273,75,523,0,0
4584,854,695,1058,968,48,11,14,204,273,76,523,0,0
4585,854,696,1057,968,48,11,14,203,272,77,523,0,0
4586,855,696,1059,970,48,11,14,204,274,78,523,0,0
4587,855,696,1060,970,48,11,14,205,274,79,523,0,0
4588,856,696,1059,971,48,11,14,203,275,80,523,0,0
4589,856,696,1060,971,48,11,14,204,275,81,523,0,0
4590,856,696,1060,971,48,11,14,204,275,82,523,0,0
4591,857,696,1059,969,48,11,14,202,273,83,523,0,0
4592,858,697,1059,969,48,11,14,201,272,84,523,0,0
4593,857,697,1058,969,48,11,14,201,272,85,523,0,0
4594,858,697,1059,968,48,11,14,201,271,86,523,0,0
4595,859,697,1059,967,48,11,14,200,270,87,523,0,0
4596,859,697,1060,968,48,11,14,201,271,88,523,0,0
4597,859,697,1059,968,48,11,14,200,271,89,523,0,0
4598,859,697,1060,968,48,11,14,201,271,90,523,0,0
4599,859,697,1059,968,48,11,14,200,271,91,523,0,0
4600,859,697,1059,968,48,11,14,200,271,92,523,0,0
4601,858,694,1060,966,48,11,14,202,272,93,523,0,0
4602,857,688,1062,964,48,11,14,205,276,94,523,0,0
4603,856,689,1063,965,48,11,14,207,276,95,523,0,0
4604,854,693,1059,966,48,11,14,205,273,96,523,0,0
4605,855,695,1059,967,48,11,14,204,272,97,523,0,0
4606,860,695,1063,965,48,11,14,203,270,98,523,0,0
4607,861,697,1066,967,48,11,14,205,270,99,523,0,0
4608,852,689,1063,969,48,11,14,211,280,100,523,0,0
4609,837,685,1051,975,48,11,14,214,290,101,523,0,0
4610,826,680,1034,971,48,11,14,208,291,102,523,0,0
4611,805,683,1022,1004,48,11,14,217,321,103,523,0,0
4612,799,682,1019,1008,48,11,14,220,326,104,523,0,0
4616,861,695,1051,971,48,11,14,190,276,0,523,0,1
4617,866,699,1055,966,48,11,14,189,267,1,523,0,0
4618,869,700,1057,963,48,11,14,188,263,2,523,0,0
4619,868,701,1058,962,48,11,14,190,261,3,523,0,0
4620,865,701,1059,964,48,11,14,194,263,4,523,0,0
4621,864,701,1059,966,48,11,14,195,265,5,523,0,0
4622,860,700,1058,966,48,11,14,198,266,6,523,0,0
4623,858,698,1058,966,48,11,14,200,268,7,523,0,0
4624,857,702,1057,967,48,11,14,200,265,8,523,0,0
4625,857,704,1056,968,48,11,14,199,264,9,523,0,0
4626,857,707,1056,968,48,11,14,199,261,10,523,0,0
4627,862,709,1058,964,48,11,14,196,255,11,523,0,0
4628,859,708,1058,967,48,11,14,199,259,12,523,0,0
4629,858,708,1058,967,48,11,14,200,259,13,523,0,0
4630,857,707,1059,968,48,11,14,202,261,14,523,0,0
4631,857,704,1060,964,48,11,14,203,260,15,523,0,0
4632,857,704,1060,961,48,11,14,203,257,16,523,0,0
4633,858,706,1060,961,48,11,14,202,255,17,523,0,0
4634,855,704,1061,963,48,11,14,206,259,18,523,0,0
4635,857,706,1062,962,48,11,14,205,256,19,523,0,0
4636,859,709,1063,963,48,11,14,204,254,20,523,0,0
4637,857,709,1064,966,48,11,14,207,257,21,523,0,0
4638,855,707,1065,969,48,11,14,210,262,22,523,0,0
4639,854,708,1065,969,48,11,14,211,261,23,523,0,0
4640,855,709,1064,969,48,11,14,209,260,24,523,0,0
4641,852,706,1062,966,48,11,14,210,260,25,523,0,0
4642,852,705,1062,965,48,11,14,210,260,26,523,0,0
4643,852,708,1061,967,48,11,14,209,259,27,523,0,0
4644,852,709,1061,967,48,11,14,209,258,28,523,0,0
4645,851,705,1061,965,48,11,14,210,260,29,523,0,0
4646,853,703,1062,962,48,11,14,209,259,30,523,0,0
4647,854,703,1062,960,48,11,14,208,257,31,523,0,0
4648,854,703,1061,960,48,11,14,207,257,32,523,0,0
4649,854,704,1060,960,48,11,14,206,256,33,523,0,0
4650,854,708,1061,963,48,11,14,207,255,34,523,0,0
4651,854,708,1062,964,48,11,14,208,256,35,523,0,0
4652,857,710,1062,962,48,11,14,205,252,36,523,0,0
4653,859,712,1062,959,48,11,14,203,247,37,523,0,0
4654,856,705,1063,959,48,11,14,207,254,38,523,0,0
4655,858,710,1063,959,48,11,14,205,249,39,523,0,0
4656,859,712,1061,957,48,11,14,202,245,40,523,0,0
4657,859,713,1061,957,48,11,14,202,244,41,523,0,0
4658,859,713,1060,957,48,11,14,201,244,42,523,0,0
4659,859,713,1060,956,48,11,14,201,243,43,523,0,0
4660,857,711,1060,956,48,11,14,203,245,44,523,0,0
4661,855,711,1060,959,48,11,14,205,248,45,523,0,0
4662,851,699,1065,961,48,11,14,214,262,46,523,0,0
4663,852,693,1070,962,48,11,14,218,269,47,523,0,0
4664,851,692,1070,962,48,11,14,219,270,48,523,0,0
4665,851,695,1066,963,48,11,14,215,268,49,523,0,0
4666,851,699,1064,965,48,11,14,213,266,50,523,0,0
4667,852,700,1063,966,48,11,14,211,266,51,523,0,0
4668,852,700,1063,967,48,11,14,211,267,52,523,0,0
4669,852,701,1062,968,48,11,14,210,267,53,523,0,0
4670,853,702,1061,967,48,11,14,208,265,54,523,0,0
4671,853,700,1061,968,48,11,14,208,268,55,523,0,0
4672,853,700,1061,968,48,11,14,208,268,56,523,0,0
4673,854,700,1061,968,48,11,14,207,268,57,523,0,0
4674,854,700,1060,968,48,11,14,206,268,58,523,0,0
4675,853,701,1059,969,48,11,14,206,268,59,523,0,0
4676,854,703,1059,969,48,11,14,205,266,60,523,0,0
4677,854,703,1058,969,48,11,14,204,266,61,523,0,0
4678,855,705,1057,969,48,11,14,202,264,62,523,0,0
4679,855,706,1057,969,48,11,14,202,263,63,523,0,0
4680,855,705,1058,969,48,11,14,203,264,64,523,0,0
4681,854,704,1058,969,48,11,14,204,265,65,523,0,0
4682,853,704,1058,969,48,11,14,205,265,66,523,0,0
4683,853,704,1058,969,48,11,14,205,265,67,523,0,0
4684,853,704,1058,969,48,11,14,205,265,68,523,0,0
4685,853,704,1058,969,48,11,14,205,265,69,523,0,0
4686,855,704,1058,966,48,11,14,203,262,70,523,0,0
4687,858,704,1059,962,48,11,14,201,258,71,523,0,0
4688,857,704,1058,964,48,11,14,201,260,72,523,0,0
4689,856,704,1058,964,48,11,14,202,260,73,523,0,0
4690,855,704,1058,965,48,11,14,203,261,74,523,0,0
4691,855,706,1058,968,48,11,14,203,262,75,523,0,0
4692,854,706,1058,970,48,11,14,204,264,76,523,0,0
4693,854,707,1057,969,48,11,14,203,262,77,523,0,0
4694,856,708,1057,967,48,11,14,201,259,78,523,0,0
4695,855,708,1056,968,48,11,14,201,260,79,523,0,0
4696,855,711,1054,969,48,11,14,199,258,80,523,0,0
4697,856,712,1053,969,48,11,14,197,257,81,523,0,0
4698,856,712,1053,969,48,11,14,197,257,82,523,0,0
4699,856,711,1054,969,48,11,14,198,258,83,523,0,0
4700,855,712,1053,970,48,11,14,198,258,84,523,0,0
4701,858,713,1052,964,48,11,14,194,251,85,523,0,0
4702,855,711,1052,966,48,11,14,197,255,86,523,0,0
4703,854,709,1053,967,48,11,14,199,258,87,523,0,0
4704,857,712,1052,963,48,11,14,195,251,88,523,0,0
4705,858,712,1052,962,48,11,14,194,250,89,523,0,0
4706,859,714,1054,963,48,11,14,195,249,90,523,0,0
4707,855,709,1056,967,48,11,14,201,258,91,523,0,0
4708,856,697,1063,963,48,11,14,207,266,92,523,0,0
4709,856,690,1065,963,48,11,14,209,273,93,523,0,0
4710,855,688,1066,964,48,11,14,211,276,94,523,0,0
4711,855,689,1064,962,48,11,14,209,273,95,523,0,0
4712,855,691,1062,961,48,11,14,207,270,96,523,0,0
4713,856,691,1062,960,48,11,14,206,269,97,523,0,0
4714,856,692,1062,960,48,11,14,206,268,98,523,0,0
4715,856,691,1062,960,48,11,14,206,269,99,523,0,0
4716,857,693,1062,963,48,11,14,205,270,100,523,0,0
4717,857,693,1063,964,48,11,14,206,271,101,523,0,0
4718,858,693,1062,964,48,11,14,204,271,102,523,0,0
4719,857,693,1060,963,48,11,14,203,270,103,523,0,0
4720,859,691,1061,960,48,11,14,202,269,104,523,0,0
4721,858,693,1061,962,48,11,14,203,269,105,523,0,0
4722,857,693,1060,962,48,11,14,203,269,106,523,0,0
4723,858,693,1060,962,48,11,14,202,269,107,523,0,0
4724,858,692,1061,962,48,11,14,203,270,108,523,0,0
4725,859,693,1060,960,48,11,14,201,267,109,523,0,0
4726,857,693,1061,962,48,11,14,204,269,110,523,0,0
4727,857,691,1061,962,48,11,14,204,271,111,523,0,0
4728,857,692,1062,963,48,11,14,205,271,112,523,0,0
4729,856,692,1062,963,48,11,14,206,271,113,523,0,0
4730,858,690,1063,960,48,11,14,205,270,114,523,0,0
4731,855,685,1065,962,48,11,14,210,277,115,523,0,0
4732,851,678,1066,963,48,11,14,215,285,116,523,0,0
4733,852,676,1068,966,48,11,14,216,290,117,523,0,0
4734,850,671,1068,965,48,11,14,218,294,118,523,0,0
4735,853,677,1067,964,48,11,14,214,287,119,523,0,0
4736,856,683,1065,965,48,11,14,209,282,120,523,0,0
4737,857,687,1065,966,48,11,14,208,279,121,523,0,0
4738,857,689,1064,965,48,11,14,207,276,122,523,0,0
4739,858,690,1063,965,48,11,14,205,275,123,523,0,0
4740,857,691,1062,965,48,11,14,205,274,124,523,0,0
4741,856,692,1060,965,48,11,14,204,273,125,523,0,0
4742,854,693,1059,965,48,11,14,205,272,126,523,0,0
4743,856,693,1059,964,48,11,14,203,271,127,523,0,0
4744,856,694,1060,964,48,11,14,204,270,128,523,0,0
4745,856,694,1060,964,48,11,14,204,270,129,523,0,0
4746,855,694,1061,965,48,11,14,206,271,130,523,0,0
4747,858,694,1062,965,48,11,14,204,271,131,523,0,0
4748,858,695,1062,965,48,11,14,204,270,132,523,0,0
4749,856,694,1062,965,48,11,14,206,271,133,523,0,0
4750,856,694,1061,964,48,11,14,205,270,134,523,0,0
4751,857,693,1061,961,48,11,14,204,268,135,523,0,0
4752,858,693,1061,961,48,11,14,203,268,136,523,0,0
4753,858,695,1061,960,48,11,14,203,265,137,523,0,0
4754,859,695,1061,960,48,11,14,202,265,138,523,0,0
4755,860,697,1062,961,48,11,14,202,264,139,523,0,0
4756,859,698,1063,965,48,11,14,204,267,140,523,0,0
4757,858,699,1064,967,48,11,14,206,268,141,523,0,0
4758,858,699,1065,967,48,11,14,207,268,142,523,0,0
4759,857,699,1065,968,48,11,14,208,269,143,523,0,0
4760,857,699,1065,968,48,11,14,208,269,144,523,0,0
4761,856,697,1064,965,48,11,14,208,268,145,523,0,0
4762,856,697,1064,964,48,11,14,208,267,146,523,0,0
4763,856,697,1063,964,48,11,14,207,267,147,523,0,0
4764,857,697,1063,963,48,11,14,206,266,148,523,0,0
4765,856,697,1063,963,48,11,14,207,266,149,523,0,0
4766,857,698,1063,962,48,11,14,206,264,150,523,0,0
4767,857,698,1062,962,48,11,14,205,264,151,523,0,0
4768,857,699,1063,962,48,11,14,206,263,152,523,0,0
4769,857,697,1064,962,48,11,14,207,265,153,523,0,0
4770,857,697,1064,962,48,11,14,207,265,154,523,0,0
4771,856,699,1063,965,48,11,14,207,266,155,523,0,0
4772,856,700,1063,966,48,11,14,207,266,156,523,0,0
4773,855,700,1063,966,48,11,14,208,266,157,523,0,0
4774,856,700,1063,966,48,11,14,207,266,158,523,0,0
4775,855,700,1063,966,48,11,14,208,266,159,523,0,0
4776,857,701,1064,965,48,11,14,207,264,160,523,0,0
4777,858,701,1064,963,48,11,14,206,262,161,523,0,0
4778,858,701,1064,963,48,11,14,206,262,162,523,0,0
4779,857,699,1065,963,48,11,14,208,264,163,523,0,0
4780,857,698,1065,963,48,11,14,208,265,164,523,0,0
4781,855,699,1063,963,48,11,14,208,264,165,523,0,0
4782,855,699,1063,963,48,11,14,208,264,166,523,0,0
4783,854,699,1062,963,48,11,14,208,264,167,523,0,0
4784,854,699,1062,963,48,11,14,208,264,168,523,0,0
4785,854,699,1062,963,48,11,14,208,264,169,523,0,0
4786,856,701,1063,962,48,11,14,207,261,170,523,0,0
4787,856,701,1062,962,48,11,14,206,261,171,523,0,0
4788,856,702,1063,961,48,11,14,207,259,172,523,0,0
4789,856,702,1063,961,48,11,14,207,259,173,523,0,0
4790,856,702,1063,961,48,11,14,207,259,174,523,0,0
4791,856,701,1065,964,48,11,14,209,263,175,523,0,0
4792,856,701,1066,964,48,11,14,210,263,176,523,0,0
4793,856,701,1066,965,48,11,14,210,264,177,523,0,0
4794,856,701,1067,965,48,11,14,211,264,178,523,0,0
4795,856,701,1066,965,48,11,14,210,264,179,523,0,0
4796,856,702,1066,965,48,11,14,210,263,180,523,0,0
4797,856,702,1065,965,48,11,14,209,263,181,523,0,0
4798,856,703,1065,965,48,11,14,209,262,182,523,0,0
4799,855,703,1065,965,48,11,14,210,262,183,523,0,0
4800,855,703,1065,966,48,11,14,210,263,184,523,0,0
4801,856,701,1066,964,48,11,14,210,263,185,523,0,0
4802,855,700,1066,964,48,11,14,211,264,186,523,0,0
4803,855,699,1066,964,48,11,14,211,265,187,523,0,0
4804,855,699,1066,964,48,11,14,211,265,188,523,0,0
4805,856,699,1066,964,48,11,14,210,265,189,523,0,0
4806,851,698,1063,966,48,11,14,212,268,190,523,0,0
4807,850,698,1062,966,48,11,14,212,268,191,523,0,0
4808,850,697,1062,967,48,11,14,212,270,192,523,0,0
4809,851,697,1062,967,48,11,14,211,270,193,523,0,0
4810,852,696,1063,965,48,11,14,211,269,194,523,0,0
4811,854,698,1063,965,48,11,14,209,267,195,523,0,0
4812,855,698,1063,966,48,11,14,208,268,196,523,0,0
4813,855,698,1063,966,48,11,14,208,268,197,523,0,0
4814,856,698,1063,966,48,11,14,207,268,198,523,0,0
4815,856,698,1063,967,48,11,14,207,269,199,523,0,0
4816,856,699,1062,966,48,11,14,206,267,200,523,0,0
4817,855,701,1062,967,48,11,14,207,266,201,523,0,0
4818,855,701,1061,966,48,11,14,206,265,202,523,0,0
4819,855,701,1061,966,48,11,14,206,265,203,523,0,0
4820,855,701,1061,966,48,11,14,206,265,204,523,0,0
4821,855,701,1061,966,48,11,14,206,265,205,523,0,0
4822,855,701,1060,966,48,11,14,205,265,206,523,0,0
4823,854,701,1061,965,48,11,14,207,264,207,523,0,0
4824,854,701,1060,965,48,11,14,206,264,208,523,0,0
4825,854,701,1061,965,48,11,14,207,264,209,523,0,0
4826,856,700,1061,963,48,11,14,205,263,210,523,0,0
4827,857,699,1063,963,48,11,14,206,264,211,523,0,0
4828,857,699,1063,962,48,11,14,206,263,212,523,0,0
4829,857,699,1063,962,48,11,14,206,263,213,523,0,0
4830,857,699,1063,962,48,11,14,206,263,214,523,0,0
4831,855,699,1063,964,48,11,14,208,265,215,523,0,0
4832,854,699,1063,964,48,11,14,209,265,216,523,0,0
4833,854,698,1063,964,48,11,14,209,266,217,523,0,0
4834,854,698,1063,964,48,11,14,209,266,218,523,0,0
4835,854,698,1063,965,48,11,14,209,267,219,523,0,0
4836,854,699,1063,964,48,11,14,209,265,220,523,0,0
4837,854,699,1063,963,48,11,14,209,264,221,523,0,0
4838,854,699,1063,963,48,11,14,209,264,222,523,0,0
4839,854,700,1063,963,48,11,14,209,263,223,523,0,0
4840,853,700,1063,963,48,11,14,210,263,224,523,0,0
4841,853,699,1065,965,48,11,14,212,266,225,523,0,0
4842,852,698,1066,966,48,11,14,214,268,226,523,0,0
4843,853,698,1067,966,48,11,14,214,268,227,523,0,0
4844,853,697,1067,966,48,11,14,214,269,228,523,0,0
4845,853,697,1067,966,48,11,14,214,269,229,523,0,0
4846,852,699,1064,965,48,11,14,212,266,230,523,0,0
4847,852,699,1063,965,48,11,14,211,266,231,523,0,0
4848,850,700,1063,968,48,11,14,213,268,232,523,0,0
4849,849,700,1063,969,48,11,14,214,269,233,523,0,0
4850,850,702,1062,970,48,11,14,212,268,234,523,0,0
4851,852,702,1062,967,48,11,14,210,265,235,523,0,0
4852,852,703,1062,967,48,11,14,210,264,236,523,0,0
4853,852,703,1062,967,48,11,14,210,264,237,523,0,0
4854,853,703,1062,966,48,11,14,209,263,238,523,0,0
4855,853,703,1062,966,48,11,14,209,263,239,523,0,0
4856,853,707,1060,967,48,11,14,207,260,240,523,0,0
4857,854,705,1061,965,48,11,14,207,260,241,523,0,0
4858,854,706,1062,967,48,11,14,208,261,242,523,0,0
4859,853,707,1060,967,48,11,14,207,260,243,523,0,0
4860,852,707,1060,967,48,11,14,208,260,244,523,0,0
4861,852,707,1060,967,48,11,14,208,260,245,523,0,0
4862,852,707,1059,967,48,11,14,207,260,246,523,0,0
4863,853,706,1059,963,48,11,14,206,257,247,523,0,0
4864,854,706,1058,961,48,11,14,204,255,248,523,0,0
4865,853,704,1059,961,48,11,14,206,257,249,523,0,0
4866,852,702,1064,967,48,11,14,212,265,250,523,0,0
4867,853,699,1066,967,48,11,14,213,268,251,523,0,0
4868,854,697,1067,967,48,11,14,213,270,252,523,0,0
4869,854,697,1067,967,48,11,14,213,270,253,523,0,0
4870,855,696,1068,967,48,11,14,213,271,254,523,0,0
4871,854,698,1064,965,48,11,14,210,267,255,523,0,0
4872,853,700,1062,966,48,11,14,209,266,256,523,0,0
4873,853,701,1061,966,48,11,14,208,265,257,523,0,0
4874,856,704,1059,963,48,11,14,203,259,258,523,0,0
4875,854,703,1059,965,48,11,14,205,262,259,523,0,0
4876,852,701,1061,969,48,11,14,209,268,260,523,0,0
4877,852,702,1060,969,48,11,14,208,267,261,523,0,0
4878,852,703,1060,970,48,11,14,208,267,262,523,0,0
4879,852,703,1061,970,48,11,14,209,267,263,523,0,0
4880,853,704,1061,969,48,11,14,208,265,264,523,0,0
4881,854,704,1060,966,48,11,14,206,262,265,523,0,0
4882,855,704,1059,964,48,11,14,204,260,266,523,0,0
4883,856,704,1060,964,48,11,14,204,260,267,523,0,0
4884,855,704,1061,964,48,11,14,206,260,268,523,0,0
4885,856,704,1061,964,48,11,14,205,260,269,523,0,0
4886,855,704,1061,965,48,11,14,206,261,270,523,0,0
4887,855,704,1061,965,48,11,14,206,261,271,523,0,0
4888,855,705,1061,965,48,11,14,206,260,272,523,0,0
4889,854,705,1061,966,48,11,14,207,261,273,523,0,0
4890,855,705,1062,966,48,11,14,207,261,274,523,0,0
4891,856,704,1063,964,48,11,14,207,260,275,523,0,0
4892,856,704,1063,964,48,11,14,207,260,276,523,0,0
4893,857,704,1062,963,48,11,14,205,259,277,523,0,0
4894,856,705,1062,963,48,11,14,206,258,278,523,0,0
4895,855,704,1062,963,48,11,14,207,259,279,523,0,0
4896,852,704,1062,967,48,11,14,210,263,280,523,0,0
4897,851,704,1062,970,48,11,14,211,266,281,523,0,0
4898,851,704,1062,968,48,11,14,211,264,282,523,0,0
4899,851,705,1061,969,48,11,14,210,264,283,523,0,0
4900,851,705,1061,969,48,11,14,210,264,284,523,0,0
4901,852,705,1061,968,48,11,14,209,263,285,523,0,0
4902,853,705,1062,967,48,11,14,209,262,286,523,0,0
4903,854,704,1061,963,48,11,14,207,259,287,523,0,0
4904,854,704,1061,963,48,11,14,207,259,288,523,0,0
4905,854,705,1061,963,48,11,14,207,258,289,523,0,0
4906,854,705,1061,964,48,11,14,207,259,290,523,0,0
4907,853,705,1061,965,48,11,14,208,260,291,523,0,0
4908,854,706,1060,964,48,11,14,206,258,292,523,0,0
4909,853,706,1060,965,48,11,14,207,259,293,523,0,0
4910,854,706,1061,965,48,11,14,207,259,294,523,0,0
4911,854,704,1062,963,48,11,14,208,259,295,523,0,0
4912,854,702,1062,961,48,11,14,208,259,296,523,0,0
4913,854,702,1062,961,48,11,14,208,259,297,523,0,0
4914,854,703,1062,962,48,11,14,208,259,298,523,0,0
4915,854,703,1062,961,48,11,14,208,258,299,523,0,0
4916,852,704,1062,965,48,11,14,210,261,300,523,0,0
4917,851,705,1062,967,48,11,14,211,262,301,523,0,0
4918,852,705,1062,968,48,11,14,210,263,302,523,0,0
4919,852,705,1062,968,48,11,14,210,263,303,523,0,0
4920,852,706,1063,968,48,11,14,211,262,304,523,0,0
4921,854,707,1060,964,48,11,14,206,257,305,523,0,0
4922,853,707,1061,966,48,11,14,208,259,306,523,0,0
4923,853,708,1061,966,48,11,14,208,258,307,523,0,0
4924,854,709,1061,966,48,11,14,207,257,308,523,0,0
4925,854,709,1061,966,48,11,14,207,257,309,523,0,0
4926,854,705,1061,963,48,11,14,207,258,310,523,0,0
4927,853,705,1061,964,48,11,14,208,259,311,523,0,0
4928,852,704,1062,965,48,11,14,210,261,312,523,0,0
4929,852,704,1062,965,48,11,14,210,261,313,523,0,0
4930,851,705,1061,967,48,11,14,210,262,314,523,0,0
4931,851,707,1059,967,48,11,14,208,260,315,523,0,0
4932,851,707,1059,967,48,11,14,208,260,316,523,0,0
4933,851,707,1059,967,48,11,14,208,260,317,523,0,0
4934,851,707,1059,967,48,11,14,208,260,318,523,0,0
4935,853,707,1059,965,48,11,14,206,258,319,523,0,0
4936,853,706,1061,965,48,11,14,208,259,320,523,0,0
4937,854,702,1063,963,48,11,14,209,261,321,523,0,0
4938,854,700,1064,963,48,11,14,210,263,322,523,0,0
4939,854,700,1064,963,48,11,14,210,263,323,523,0,0
4940,854,701,1064,964,48,11,14,210,263,324,523,0,0
4941,853,702,1062,965,48,11,14,209,263,325,523,0,0
4942,853,704,1061,965,48,11,14,208,261,326,523,0,0
4943,854,704,1061,965,48,11,14,207,261,327,523,0,0
4944,854,704,1060,964,48,11,14,206,260,328,523,0,0
4945,854,704,1060,964,48,11,14,206,260,329,523,0,0
4946,855,705,1060,963,48,11,14,205,258,330,523,0,0
4947,855,705,1060,963,48,11,14,205,258,331,523,0,0
4948,855,696,1066,963,48,11,14,211,267,332,523,0,0
4949,853,686,1069,962,48,11,14,216,276,333,523,0,0
4950,852,681,1071,962,48,11,14,219,281,334,523,0,0
4951,850,678,1071,963,48,11,14,221,285,335,523,0,0
4952,848,674,1071,964,48,11,14,223,290,336,523,0,0
4953,849,676,1069,964,48,11,14,220,288,337,523,0,0
4954,849,674,1069,965,48,11,14,220,291,338,523,0,0
4955,851,681,1067,967,48,11,14,216,286,339,523,0,0
4956,853,691,1063,969,48,11,14,210,278,340,523,0,0
4957,854,693,1064,970,48,11,14,210,277,341,523,0,0
4958,853,690,1065,969,48,11,14,212,279,342,523,0,0
4959,855,687,1068,969,48,11,14,213,282,343,523,0,0
4960,859,687,1070,967,48,11,14,211,280,344,523,0,0
4961,860,687,1072,967,48,11,14,212,280,345,523,0,0
4962,858,683,1071,964,48,11,14,213,281,346,523,0,0
4963,857,683,1073,968,48,11,14,216,285,347,523,0,0
4964,859,686,1070,966,48,11,14,211,280,348,523,0,0
4965,859,687,1071,966,48,11,14,212,279,349,523,0,0
4966,854,686,1069,969,48,11,14,215,283,350,523,0,0
4967,854,685,1070,969,48,11,14,216,284,351,523,0,0
4968,853,685,1069,970,48,11,14,216,285,352,523,0,0
4969,853,684,1070,970,48,11,14,217,286,353,523,0,0
4970,853,685,1069,969,48,11,14,216,284,354,523,0,0
4971,854,684,1071,971,48,11,14,217,287,355,523,0,0
4972,852,685,1069,971,48,11,14,217,286,356,523,0,0
4973,851,684,1065,967,48,11,14,214,283,357,523,0,0
4974,851,684,1063,965,48,11,14,212,281,358,523,0,0
4975,849,682,1062,964,48,11,14,213,282,359,523,0,0
4976,845,676,1064,966,48,11,14,219,290,360,523,0,0
4977,849,675,1067,966,48,11,14,218,291,361,523,0,0
4978,851,675,1068,966,48,11,14,217,291,362,523,0,0
4979,851,672,1071,968,48,11,14,220,296,363,523,0,0
4980,850,670,1071,969,48,11,14,221,299,364,523,0,0
4981,850,676,1067,969,48,11,14,217,293,365,523,0,0
4982,852,684,1065,971,48,11,14,213,287,366,523,0,0
4983,853,688,1063,970,48,11,14,210,282,367,523,0,0
4984,853,691,1061,970,48,11,14,208,279,368,523,0,0
4985,854,692,1061,969,48,11,14,207,277,369,523,0,0
4986,855,692,1064,969,48,11,14,209,277,370,523,0,0
4987,854,692,1063,970,48,11,14,209,278,371,523,0,0
4988,854,693,1064,970,48,11,14,210,277,372,523,0,0
4989,854,693,1064,970,48,11,14,210,277,373,523,0,0
4990,856,692,1063,965,48,11,14,207,273,374,523,0,0
4991,856,690,1066,967,48,11,14,210,277,375,523,0,0
4992,855,686,1067,966,48,11,14,212,280,376,523,0,0
4993,853,684,1068,966,48,11,14,215,282,377,523,0,0
4994,855,687,1069,969,48,11,14,214,282,378,523,0,0
4995,855,687,1070,969,48,11,14,215,282,379,523,0,0
4996,853,687,1069,971,48,11,14,216,284,380,523,0,0
4997,853,688,1069,973,48,11,14,216,285,381,523,0,0
4998,852,688,1068,973,48,11,14,216,285,382,523,0,0
4999,852,688,1067,972,48,11,14,215,284,383,523,0,0
5000,852,688,1067,972,48,11,14,215,284,384,523,0,0
5001,853,688,1067,971,48,11,14,214,283,385,523,0,0
5002,854,688,1068,970,48,11,14,214,282,386,523,0,0
5003,853,689,1067,970,48,11,14,214,281,387,523,0,0
5004,853,689,1067,970,48,11,14,214,281,388,523,0,0
5005,853,689,1067,971,48,11,14,214,282,389,523,0,0
5006,854,689,1067,969,48,11,14,213,280,390,523,0,0
5007,855,689,1066,966,48,11,14,211,277,391,523,0,0
5008,854,689,1066,967,48,11,14,212,278,392,523,0,0
5009,854,689,1066,967,48,11,14,212,278,393,523,0,0
5010,853,689,1067,967,48,11,14,214,278,394,523,0,0
5011,853,689,1067,969,48,11,14,214,280,395,523,0,0
5012,853,689,1067,969,48,11,14,214,280,396,523,0,0
5013,852,689,1068,969,48,11,14,216,280,397,523,0,0
5014,852,689,1068,969,48,11,14,216,280,398,523,0,0
5015,852,689,1068,969,48,11,14,216,280,399,523,0,0
5016,852,690,1067,968,48,11,14,215,278,400,523,0,0
5017,852,690,1067,968,48,11,14,215,278,401,523,0,0
5018,854,688,1069,967,48,11,14,215,279,402,523,0,0
5019,855,687,1070,967,48,11,14,215,280,403,523,0,0
5020,854,689,1068,966,48,11,14,214,277,404,523,0,0
5021,854,689,1068,968,48,11,14,214,279,405,523,0,0
5022,852,685,1070,969,48,11,14,218,284,406,523,0,0
5023,850,681,1071,969,48,11,14,221,288,407,523,0,0
5024,846,676,1069,970,48,11,14,223,294,408,523,0,0
5025,851,677,1072,969,48,11,14,221,292,409,523,0,0
5026,850,678,1070,969,48,11,14,220,291,410,523,0,0
5027,852,677,1071,968,48,11,14,219,291,411,523,0,0
5028,853,683,1068,968,48,11,14,215,285,412,523,0,0
5029,854,689,1066,968,48,11,14,212,279,413,523,0,0
5030,856,694,1064,968,48,11,14,208,274,414,523,0,0
5031,855,696,1064,970,48,11,14,209,274,415,523,0,0
5032,855,697,1064,970,48,11,14,209,273,416,523,0,0
5033,855,697,1064,970,48,11,14,209,273,417,523,0,0
5034,855,696,1064,970,48,11,14,209,274,418,523,0,0
5035,854,694,1065,970,48,11,14,211,276,419,523,0,0
5036,853,693,1066,970,48,11,14,213,277,420,523,0,0
5037,853,692,1066,970,48,11,14,213,278,421,523,0,0
5038,853,692,1067,970,48,11,14,214,278,422,523,0,0
5039,853,692,1066,970,48,11,14,213,278,423,523,0,0
5040,852,692,1066,970,48,11,14,214,278,424,523,0,0
5041,852,690,1066,968,48,11,14,214,278,425,523,0,0
5042,852,689,1066,968,48,11,14,214,279,426,523,0,0
5043,852,689,1066,968,48,11,14,214,279,427,523,0,0
5044,852,689,1067,967,48,11,14,215,278,428,523,0,0
5045,852,688,1067,967,48,11,14,215,279,429,523,0,0
5046,850,685,1069,969,48,11,14,219,284,430,523,0,0
5047,849,681,1070,969,48,11,14,221,288,431,523,0,0
5048,849,678,1071,969,48,11,14,222,291,432,523,0,0
5049,849,677,1070,968,48,11,14,221,291,433,523,0,0
5050,849,675,1072,968,48,11,14,223,293,434,523,0,0
5051,850,673,1074,969,48,11,14,224,296,435,523,0,0
5052,849,675,1071,969,48,11,14,222,294,436,523,0,0
5053,849,676,1070,969,48,11,14,221,293,437,523,0,0
5054,849,675,1070,968,48,11,14,221,293,438,523,0,0
5055,851,680,1068,969,48,11,14,217,289,439,523,0,0
5056,851,684,1067,970,48,11,14,216,286,440,523,0,0
5057,851,687,1066,970,48,11,14,215,283,441,523,0,0
5058,852,688,1066,971,48,11,14,214,283,442,523,0,0
5059,851,689,1066,973,48,11,14,215,284,443,523,0,0
5060,847,687,1067,977,48,11,14,220,290,444,523,0,0
5061,853,686,1069,972,48,11,14,216,286,445,523,0,0
5062,877,685,1087,968,48,11,14,210,283,446,523,0,0
5063,908,687,1085,931,48,11,14,177,244,447,523,0,0
5064,914,687,1088,927,48,11,14,174,240,448,523,0,0
5069,859,689,1062,968,48,11,14,203,279,0,523,0,1
5070,857,690,1066,975,48,11,14,209,285,1,523,0,0
5071,858,689,1070,977,48,11,14,212,288,2,523,0,0
5072,857,690,1069,975,48,11,14,212,285,3,523,0,0
5073,856,690,1068,974,48,11,14,212,284,4,523,0,0
5074,855,690,1067,973,48,11,14,212,283,5,523,0,0
5075,854,691,1066,973,48,11,14,212,282,6,523,0,0
5076,854,693,1066,974,48,11,14,212,281,7,523,0,0
5077,854,692,1067,975,48,11,14,213,283,8,523,0,0
5078,852,690,1067,974,48,11,14,215,284,9,523,0,0
5079,853,691,1067,974,48,11,14,214,283,10,523,0,0
5080,851,690,1065,974,48,11,14,214,284,11,523,0,0
5081,850,687,1065,973,48,11,14,215,286,12,523,0,0
5082,848,688,1062,971,48,11,14,214,283,13,523,0,0
5083,849,690,1061,970,48,11,14,212,280,14,523,0,0
5084,851,692,1060,969,48,11,14,209,277,15,523,0,0
5085,853,700,1058,970,48,11,14,205,270,16,523,0,0
5086,856,705,1058,970,48,11,14,202,265,17,523,0,0
5087,856,707,1058,971,48,11,14,202,264,18,523,0,0
5088,855,706,1058,969,48,11,14,203,263,19,523,0,0
5089,855,706,1060,969,48,11,14,205,263,20,523,0,0
5090,854,706,1061,971,48,11,14,207,265,21,523,0,0
5091,854,707,1061,971,48,11,14,207,264,22,523,0,0
5092,855,712,1059,971,48,11,14,204,259,23,523,0,0
5093,854,709,1060,969,48,11,14,206,260,24,523,0,0
5094,857,706,1064,969,48,11,14,207,263,25,523,0,0
5095,854,705,1063,968,48,11,14,209,263,26,523,0,0
5096,853,704,1064,970,48,11,14,211,266,27,523,0,0
5097,852,704,1064,970,48,11,14,212,266,28,523,0,0
5098,852,704,1064,971,48,11,14,212,267,29,523,0,0
5099,853,704,1065,971,48,11,14,212,267,30,523,0,0
5100,851,702,1065,971,48,11,14,214,269,31,523,0,0
5101,853,701,1066,969,48,11,14,213,268,32,523,0,0
5102,852,699,1066,969,48,11,14,214,270,33,523,0,0
5103,850,698,1064,969,48,11,14,214,271,34,523,0,0
5104,849,698,1064,969,48,11,14,215,271,35,523,0,0
5105,849,698,1064,969,48,11,14,215,271,36,523,0,0
5106,850,699,1064,968,48,11,14,214,269,37,523,0,0
5107,851,698,1064,968,48,11,14,213,270,38,523,0,0
5108,851,698,1064,967,48,11,14,213,269,39,523,0,0
5109,852,699,1064,967,48,11,14,212,268,40,523,0,0
5110,852,699,1064,967,48,11,14,212,268,41,523,0,0
5111,851,699,1063,967,48,11,14,212,268,42,523,0,0
5112,852,699,1063,967,48,11,14,211,268,43,523,0,0
5113,852,699,1064,967,48,11,14,212,268,44,523,0,0
5114,851,699,1063,967,48,11,14,212,268,45,523,0,0
5115,852,699,1063,967,48,11,14,211,268,46,523,0,0
5116,851,698,1064,967,48,11,14,213,269,47,523,0,0
5117,851,698,1064,967,48,11,14,213,269,48,523,0,0
5118,851,698,1064,967,48,11,14,213,269,49,523,0,0
5119,851,698,1064,967,48,11,14,213,269,50,523,0,0
5120,851,698,1064,967,48,11,14,213,269,51,523,0,0
5121,853,698,1065,967,48,11,14,212,269,52,523,0,0
5122,852,699,1064,969,48,11,14,212,270,53,523,0,0
5123,852,699,1064,969,48,11,14,212,270,54,523,0,0
5124,851,699,1064,969,48,11,14,213,270,55,523,0,0
5125,851,699,1064,970,48,11,14,213,271,56,523,0,0
5126,851,697,1064,968,48,11,14,213,271,57,523,0,0
5127,851,697,1064,968,48,11,14,213,271,58,523,0,0
5128,851,698,1064,968,48,11,14,213,270,59,523,0,0
5129,852,698,1064,968,48,11,14,212,270,60,523,0,0
5130,852,698,1065,968,48,11,14,213,270,61,523,0,0
5131,853,699,1064,967,48,11,14,211,268,62,523,0,0
5132,852,699,1063,967,48,11,14,211,268,63,523,0,0
5133,852,699,1063,967,48,11,14,211,268,64,523,0,0
5134,853,700,1063,967,48,11,14,210,267,65,523,0,0
5135,853,700,1063,967,48,11,14,210,267,66,523,0,0
5136,853,701,1063,967,48,11,14,210,266,67,523,0,0
5137,853,701,1063,967,48,11,14,210,266,68,523,0,0
5138,853,702,1064,967,48,11,14,211,265,69,523,0,0
5139,853,701,1064,967,48,11,14,211,266,70,523,0,0
5140,852,699,1064,967,48,11,14,212,268,71,523,0,0
5141,853,697,1067,969,48,11,14,214,272,72,523,0,0
5142,854,696,1068,969,48,11,14,214,273,73,523,0,0
5143,853,698,1066,970,48,11,14,213,272,74,523,0,0
5144,852,698,1065,970,48,11,14,213,272,75,523,0,0
5145,852,698,1065,970,48,11,14,213,272,76,523,0,0
5146,854,698,1067,971,48,11,14,213,273,77,523,0,0
5147,853,698,1065,969,48,11,14,212,271,78,523,0,0
5148,852,697,1064,969,48,11,14,212,272,79,523,0,0
5149,852,697,1064,970,48,11,14,212,273,80,523,0,0
5150,853,695,1066,969,48,11,14,213,274,81,523,0,0
5151,853,696,1063,967,48,11,14,210,271,82,523,0,0
5152,853,697,1063,967,48,11,14,210,270,83,523,0,0
5153,853,697,1063,967,48,11,14,210,270,84,523,0,0
5154,853,697,1064,967,48,11,14,211,270,85,523,0,0
5155,853,697,1064,968,48,11,14,211,271,86,523,0,0
5156,856,698,1065,967,48,11,14,209,269,87,523,0,0
5157,854,699,1064,968,48,11,14,210,269,88,523,0,0
5158,853,699,1063,968,48,11,14,210,269,89,523,0,0
5159,853,700,1063,968,48,11,14,210,268,90,523,0,0
5160,853,700,1063,968,48,11,14,210,268,91,523,0,0
5161,853,700,1063,967,48,11,14,210,267,92,523,0,0
5162,854,700,1062,967,48,11,14,208,267,93,523,0,0
5163,854,701,1062,967,48,11,14,208,266,94,523,0,0
5164,857,701,1065,966,48,11,14,208,265,95,523,0,0
5165,855,701,1063,967,48,11,14,208,266,96,523,0,0
5166,853,701,1063,968,48,11,14,210,267,97,523,0,0
5167,852,701,1063,968,48,11,14,211,267,98,523,0,0
5168,852,701,1063,968,48,11,14,211,267,99,523,0,0
5169,852,701,1062,969,48,11,14,210,268,100,523,0,0
5170,852,700,1063,969,48,11,14,211,269,101,523,0,0
5171,853,700,1063,968,48,11,14,210,268,102,523,0,0
5172,854,700,1064,968,48,11,14,210,268,103,523,0,0
5173,855,698,1066,968,48,11,14,211,270,104,523,0,0
5174,855,697,1066,967,48,11,14,211,270,105,523,0,0
5175,855,699,1064,967,48,11,14,209,268,106,523,0,0
5176,853,700,1063,969,48,11,14,210,269,107,523,0,0
5177,853,701,1063,968,48,11,14,210,267,108,523,0,0
5178,853,701,1063,969,48,11,14,210,268,109,523,0,0
5179,853,702,1063,969,48,11,14,210,267,110,523,0,0
5180,853,702,1063,969,48,11,14,210,267,111,523,0,0
5181,852,700,1064,971,48,11,14,212,271,112,523,0,0
5182,852,700,1065,971,48,11,14,213,271,113,523,0,0
5183,852,701,1064,971,48,11,14,212,270,114,523,0,0
5184,852,702,1064,971,48,11,14,212,269,115,523,0,0
5185,852,702,1064,971,48,11,14,212,269,116,523,0,0
5186,855,702,1066,970,48,11,14,211,268,117,523,0,0
5187,858,704,1066,967,48,11,14,208,263,118,523,0,0
5188,858,704,1066,967,48,11,14,208,263,119,523,0,0
5189,854,702,1065,968,48,11,14,211,266,120,523,0,0
5190,853,696,1068,968,48,11,14,215,272,121,523,0,0
5191,851,695,1067,969,48,11,14,216,274,122,523,0,0
5192,850,694,1067,969,48,11,14,217,275,123,523,0,0
5193,850,694,1067,969,48,11,14,217,275,124,523,0,0
5194,850,694,1066,969,48,11,14,216,275,125,523,0,0
5195,849,693,1066,969,48,11,14,217,276,126,523,0,0
5196,849,693,1065,969,48,11,14,216,276,127,523,0,0
5197,849,693,1065,969,48,11,14,216,276,128,523,0,0
5198,850,694,1065,969,48,11,14,215,275,129,523,0,0
5199,850,694,1065,968,48,11,14,215,274,130,523,0,0
5200,849,694,1065,969,48,11,14,216,275,131,523,0,0
5201,849,694,1067,971,48,11,14,218,277,132,523,0,0
5202,849,694,1067,972,48,11,14,218,278,133,523,0,0
5203,849,695,1067,973,48,11,14,218,278,134,523,0,0
5204,852,696,1069,973,48,11,14,217,277,135,523,0,0
5205,854,697,1069,974,48,11,14,215,277,136,523,0,0
5206,852,696,1065,970,48,11,14,213,274,137,523,0,0
5207,851,696,1064,969,48,11,14,213,273,138,523,0,0
5208,851,696,1064,969,48,11,14,213,273,139,523,0,0
5209,851,696,1063,968,48,11,14,212,272,140,523,0,0
5210,851,696,1063,968,48,11,14,212,272,141,523,0,0
5211,852,697,1064,969,48,11,14,212,272,142,523,0,0
5212,852,697,1064,969,48,11,14,212,272,143,523,0,0
5213,852,698,1064,969,48,11,14,212,271,144,523,0,0
5214,853,698,1064,969,48,11,14,211,271,145,523,0,0
5215,854,696,1067,969,48,11,14,213,273,146,523,0,0
5216,852,695,1066,969,48,11,14,214,274,147,523,0,0
5217,855,694,1068,969,48,11,14,213,275,148,523,0,0
5218,853,695,1066,969,48,11,14,213,274,149,523,0,0
5219,852,695,1065,968,48,11,14,213,273,150,523,0,0
5220,852,695,1065,968,48,11,14,213,273,151,523,0,0
5221,851,693,1067,970,48,11,14,216,277,152,523,0,0
5222,851,692,1068,970,48,11,14,217,278,153,523,0,0
5223,851,693,1067,970,48,11,14,216,277,154,523,0,0
5224,851,693,1066,971,48,11,14,215,278,155,523,0,0
5225,852,693,1067,971,48,11,14,215,278,156,523,0,0
5226,852,693,1066,969,48,11,14,214,276,157,523,0,0
5227,855,692,1068,967,48,11,14,213,275,158,523,0,0
5228,853,690,1068,968,48,11,14,215,278,159,523,0,0
5229,853,689,1067,967,48,11,14,214,278,160,523,0,0
5230,852,690,1066,968,48,11,14,214,278,161,523,0,0
5231,851,689,1068,972,48,11,14,217,283,162,523,0,0
5232,850,688,1068,972,48,11,14,218,284,163,523,0,0
5233,851,688,1068,973,48,11,14,217,285,164,523,0,0
5234,851,688,1068,973,48,11,14,217,285,165,523,0,0
5235,851,688,1068,973,48,11,14,217,285,166,523,0,0
5236,854,688,1067,969,48,11,14,213,281,167,523,0,0
5237,854,690,1066,969,48,11,14,212,279,168,523,0,0
5238,854,690,1066,969,48,11,14,212,279,169,523,0,0
5239,855,690,1066,967,48,11,14,211,277,170,523,0,0
5240,855,686,1071,973,48,11,14,216,287,171,523,0,0
5241,857,689,1067,967,48,11,14,210,278,172,523,0,0
5242,852,691,1066,972,48,11,14,214,281,173,523,0,0
5243,868,689,1081,975,48,11,14,213,286,174,523,0,0
5244,837,688,1094,1043,48,11,14,257,355,175,523,0,0
5245,850,690,1070,992,48,11,14,220,302,176,523,0,0
5246,854,689,1066,978,48,11,14,212,289,177,523,0,0
5247,856,693,1062,973,48,11,14,206,280,178,523,0,0
5248,859,695,1063,972,48,11,14,204,277,179,523,0,0
5249,859,700,1060,971,48,11,14,201,271,180,523,0,0
5250,860,699,1061,970,48,11,14,201,271,181,523,0,0
5251,859,702,1058,968,48,11,14,199,266,182,523,0,0
5252,858,703,1057,967,48,11,14,199,264,183,523,0,0
5253,857,702,1057,967,48,11,14,200,265,184,523,0,0
5254,856,701,1058,966,48,11,14,202,265,185,523,0,0
5255,857,697,1060,965,48,11,14,203,268,186,523,0,0
5256,858,695,1061,963,48,11,14,203,268,187,523,0,0
5257,856,695,1061,965,48,11,14,205,270,188,523,0,0
5258,856,691,1063,964,48,11,14,207,273,189,523,0,0
5259,854,686,1065,965,48,11,14,211,279,190,523,0,0
5260,853,685,1065,965,48,11,14,212,280,191,523,0,0
5261,852,684,1067,967,48,11,14,215,283,192,523,0,0
5262,852,684,1067,967,48,11,14,215,283,193,523,0,0
5263,852,683,1067,967,48,11,14,215,284,194,523,0,0
5264,852,684,1067,967,48,11,14,215,283,195,523,0,0
5265,852,686,1066,968,48,11,14,214,282,196,523,0,0
5266,852,687,1066,968,48,11,14,214,281,197,523,0,0
5267,852,687,1066,968,48,11,14,214,281,198,523,0,0
5268,852,684,1068,968,48,11,14,216,284,199,523,0,0
5269,851,680,1071,968,48,11,14,220,288,200,523,0,0
5270,851,678,1071,968,48,11,14,220,290,201,523,0,0
5271,852,677,1071,968,48,11,14,219,291,202,523,0,0
5272,850,671,1072,968,48,11,14,222,297,203,523,0,0
5273,847,666,1070,967,48,11,14,223,301,204,523,0,0
5274,846,662,1070,968,48,11,14,224,306,205,523,0,0
5275,845,663,1066,966,48,11,14,221,303,206,523,0,0
5276,851,664,1068,965,48,11,14,217,301,207,523,0,0
5277,852,666,1067,966,48,11,14,215,300,208,523,0,0
5278,854,669,1069,968,48,11,14,215,299,209,523,0,0
5279,852,675,1065,970,48,11,14,213,295,210,523,0,0
5280,859,690,1063,971,48,11,14,204,281,211,523,0,0
5281,863,702,1059,969,48,11,14,196,267,212,523,0,0
5282,862,703,1058,968,48,11,14,196,265,213,523,0,0
5283,861,704,1058,968,48,11,14,197,264,214,523,0,0
5284,860,703,1059,968,48,11,14,199,265,215,523,0,0
5285,858,705,1058,968,48,11,14,200,263,216,523,0,0
5286,856,705,1059,970,48,11,14,203,265,217,523,0,0
5287,855,704,1060,971,48,11,14,205,267,218,523,0,0
5288,854,703,1061,972,48,11,14,207,269,219,523,0,0
5289,853,703,1061,972,48,11,14,208,269,220,523,0,0
5290,853,702,1061,972,48,11,14,208,270,221,523,0,0
5291,853,703,1061,970,48,11,14,208,267,222,523,0,0
5292,854,703,1062,970,48,11,14,208,267,223,523,0,0
5293,853,702,1062,970,48,11,14,209,268,224,523,0,0
5294,853,702,1063,970,48,11,14,210,268,225,523,0,0
5295,853,702,1063,970,48,11,14,210,268,226,523,0,0
5296,853,701,1063,969,48,11,14,210,268,227,523,0,0
5297,852,701,1064,969,48,11,14,212,268,228,523,0,0
5298,852,701,1063,969,48,11,14,211,268,229,523,0,0
5299,852,701,1064,969,48,11,14,212,268,230,523,0,0
5300,851,700,1064,969,48,11,14,213,269,231,523,0,0
5301,851,699,1064,969,48,11,14,213,270,232,523,0,0
5302,851,699,1064,969,48,11,14,213,270,233,523,0,0
5303,851,699,1065,968,48,11,14,214,269,234,523,0,0
5304,851,698,1065,968,48,11,14,214,270,235,523,0,0
5305,851,698,1065,968,48,11,14,214,270,236,523,0,0
5306,851,697,1065,969,48,11,14,214,272,237,523,0,0
5307,851,697,1065,969,48,11,14,214,272,238,523,0,0
5308,851,696,1066,969,48,11,14,215,273,239,523,0,0
5309,851,695,1066,969,48,11,14,215,274,240,523,0,0
5310,851,694,1066,970,48,11,14,215,276,241,523,0,0
5311,851,693,1067,969,48,11,14,216,276,242,523,0,0
5312,852,693,1067,968,48,11,14,215,275,243,523,0,0
5313,852,693,1067,968,48,11,14,215,275,244,523,0,0
5314,852,693,1067,968,48,11,14,215,275,245,523,0,0
5315,852,691,1069,968,48,11,14,217,277,246,523,0,0
5316,851,693,1067,969,48,11,14,216,276,247,523,0,0
5317,851,695,1066,969,48,11,14,215,274,248,523,0,0
5318,851,695,1066,969,48,11,14,215,274,249,523,0,0
5319,851,694,1066,970,48,11,14,215,276,250,523,0,0
5320,851,695,1066,970,48,11,14,215,275,251,523,0,0
5321,852,694,1066,968,48,11,14,214,274,252,523,0,0
5322,853,694,1067,967,48,11,14,214,273,253,523,0,0
5323,852,694,1065,968,48,11,14,213,274,254,523,0,0
5324,851,694,1065,968,48,11,14,214,274,255,523,0,0
5325,850,692,1066,968,48,11,14,216,276,256,523,0,0
5326,849,685,1069,968,48,11,14,220,283,257,523,0,0
5327,847,680,1071,968,48,11,14,224,288,258,523,0,0
5328,848,678,1072,968,48,11,14,224,290,259,523,0,0
5329,849,680,1071,968,48,11,14,222,288,260,523,0,0
5330,851,686,1068,969,48,11,14,217,283,261,523,0,0
5331,852,690,1067,968,48,11,14,215,278,262,523,0,0
5332,853,693,1065,968,48,11,14,212,275,263,523,0,0
5333,854,693,1065,966,48,11,14,211,273,264,523,0,0
5334,854,693,1065,966,48,11,14,211,273,265,523,0,0
5335,853,692,1065,966,48,11,14,212,274,266,523,0,0
5336,852,692,1065,968,48,11,14,213,276,267,523,0,0
5337,852,693,1064,968,48,11,14,212,275,268,523,0,0
5338,852,693,1064,968,48,11,14,212,275,269,523,0,0
5339,852,694,1065,968,48,11,14,213,274,270,523,0,0
5340,852,694,1065,968,48,11,14,213,274,271,523,0,0
5341,854,694,1065,968,48,11,14,211,274,272,523,0,0
5342,854,694,1066,968,48,11,14,212,274,273,523,0,0
5343,854,694,1066,968,48,11,14,212,274,274,523,0,0
5344,854,694,1066,967,48,11,14,212,273,275,523,0,0
5345,854,694,1066,967,48,11,14,212,273,276,523,0,0
5346,853,694,1065,967,48,11,14,212,273,277,523,0,0
5347,853,694,1064,966,48,11,14,211,272,278,523,0,0
5348,853,694,1065,966,48,11,14,212,272,279,523,0,0
5349,853,695,1065,966,48,11,14,212,271,280,523,0,0
5350,853,695,1065,966,48,11,14,212,271,281,523,0,0
5351,853,695,1066,968,48,11,14,213,273,282,523,0,0
5352,853,695,1067,968,48,11,14,214,273,283,523,0,0
5353,853,695,1067,968,48,11,14,214,273,284,523,0,0
5354,853,695,1067,968,48,11,14,214,273,285,523,0,0
5355,853,695,1067,968,48,11,14,214,273,286,523,0,0
5356,852,695,1066,968,48,11,14,214,273,287,523,0,0
5357,852,696,1066,969,48,11,14,214,273,288,523,0,0
5358,851,696,1065,969,48,11,14,214,273,289,523,0,0
5359,851,697,1065,969,48,11,14,214,272,290,523,0,0
5360,852,697,1066,969,48,11,14,214,272,291,523,0,0
5361,852,697,1066,968,48,11,14,214,271,292,523,0,0
5362,853,697,1066,967,48,11,14,213,270,293,523,0,0
5363,853,697,1067,967,48,11,14,214,270,294,523,0,0
5364,854,699,1066,967,48,11,14,212,268,295,523,0,0
5365,854,699,1066,967,48,11,14,212,268,296,523,0,0
5366,852,699,1066,967,48,11,14,214,268,297,523,0,0
5367,852,699,1066,968,48,11,14,214,269,298,523,0,0
5368,853,698,1067,967,48,11,14,214,269,299,523,0,0
5369,852,699,1066,968,48,11,14,214,269,300,523,0,0
5370,851,699,1067,969,48,11,14,216,270,301,523,0,0
5371,850,698,1066,970,48,11,14,216,272,302,523,0,0
5372,850,697,1068,970,48,11,14,218,273,303,523,0,0
5373,850,697,1068,971,48,11,14,218,274,304,523,0,0
5374,852,696,1070,969,48,11,14,218,273,305,523,0,0
5375,851,696,1069,969,48,11,14,218,273,306,523,0,0
5376,850,695,1069,968,48,11,14,219,273,307,523,0,0
5377,850,695,1069,968,48,11,14,219,273,308,523,0,0
5378,850,694,1069,968,48,11,14,219,274,309,523,0,0
5379,850,694,1069,967,48,11,14,219,273,310,523,0,0
5380,851,695,1069,967,48,11,14,218,272,311,523,0,0
5381,850,695,1069,969,48,11,14,219,274,312,523,0,0
5382,850,695,1069,969,48,11,14,219,274,313,523,0,0
5383,850,695,1069,969,48,11,14,219,274,314,523,0,0
5384,850,693,1071,970,48,11,14,221,277,315,523,0,0
5385,850,694,1070,970,48,11,14,220,276,316,523,0,0
5386,850,695,1068,968,48,11,14,218,273,317,523,0,0
5387,851,693,1069,966,48,11,14,218,273,318,523,0,0
5388,852,689,1072,965,48,11,14,220,276,319,523,0,0
5389,851,687,1075,969,48,11,14,224,282,320,523,0,0
5390,851,688,1072,969,48,11,14,221,281,321,523,0,0
5391,857,695,1068,966,48,11,14,211,271,322,523,0,0
5392,867,714,1063,965,48,11,14,196,251,323,523,0,0
5393,871,728,1058,964,48,11,14,187,236,324,523,0,0
5394,870,731,1058,966,48,11,14,188,235,325,523,0,0
5395,866,720,1063,969,48,11,14,197,249,326,523,0,0
5396,863,713,1067,972,48,11,14,204,259,327,523,0,0
5397,864,717,1065,973,48,11,14,201,256,328,523,0,0
5398,869,734,1056,969,48,11,14,187,235,329,523,0,0
5399,873,748,1051,968,48,11,14,178,220,330,523,0,0
5400,872,750,1048,966,48,11,14,176,216,331,523,0,0
5401,868,743,1051,964,48,11,14,183,221,332,523,0,0
5402,867,741,1052,964,48,11,14,185,223,333,523,0,0
5403,866,740,1054,965,48,11,14,188,225,334,523,0,0
5404,865,737,1057,965,48,11,14,192,228,335,523,0,0
5405,864,738,1057,967,48,11,14,193,229,336,523,0,0
5406,863,739,1057,969,48,11,14,194,230,337,523,0,0
5407,862,740,1057,970,48,11,14,195,230,338,523,0,0
5408,860,738,1058,970,48,11,14,198,232,339,523,0,0
5409,859,737,1059,971,48,11,14,200,234,340,523,0,0
5410,859,737,1060,971,48,11,14,201,234,341,523,0,0
5411,859,737,1059,969,48,11,14,200,232,342,523,0,0
5412,859,737,1058,969,48,11,14,199,232,343,523,0,0
5413,860,738,1057,967,48,11,14,197,229,344,523,0,0
5414,859,737,1057,967,48,11,14,198,230,345,523,0,0
5415,859,737,1058,967,48,11,14,199,230,346,523,0,0
5416,859,738,1058,969,48,11,14,199,231,347,523,0,0
5417,859,736,1059,968,48,11,14,200,232,348,523,0,0
5418,860,739,1058,968,48,11,14,198,229,349,523,0,0
5419,860,741,1058,968,48,11,14,198,227,350,523,0,0
5420,860,741,1058,968,48,11,14,198,227,351,523,0,0
5421,861,741,1058,966,48,11,14,197,225,352,523,0,0
5422,859,739,1058,967,48,11,14,199,228,353,523,0,0
5423,861,741,1059,967,48,11,14,198,226,354,523,0,0
5424,862,741,1059,966,48,11,14,197,225,355,523,0,0
5425,862,742,1059,966,48,11,14,197,224,356,523,0,0
5426,861,741,1060,967,48,11,14,199,226,357,523,0,0
5427,859,739,1060,967,48,11,14,201,228,358,523,0,0
5428,859,738,1061,967,48,11,14,202,229,359,523,0,0
5429,859,738,1061,968,48,11,14,202,230,360,523,0,0
5430,859,738,1062,968,48,11,14,203,230,361,523,0,0
5431,859,736,1062,967,48,11,14,203,231,362,523,0,0
5432,859,736,1062,967,48,11,14,203,231,363,523,0,0
5433,859,736,1062,967,48,11,14,203,231,364,523,0,0
5434,858,736,1062,967,48,11,14,204,231,365,523,0,0
5435,858,735,1062,968,48,11,14,204,233,366,523,0,0
5436,858,736,1062,968,48,11,14,204,232,367,523,0,0
5437,858,737,1061,969,48,11,14,203,232,368,523,0,0
5438,858,737,1061,969,48,11,14,203,232,369,523,0,0
5439,859,737,1062,969,48,11,14,203,232,370,523,0,0
5440,858,737,1062,969,48,11,14,204,232,371,523,0,0
5441,858,735,1062,969,48,11,14,204,234,372,523,0,0
5442,858,735,1062,969,48,11,14,204,234,373,523,0,0
5443,858,735,1062,968,48,11,14,204,233,374,523,0,0
5444,858,735,1062,969,48,11,14,204,234,375,523,0,0
5445,858,735,1063,969,48,11,14,205,234,376,523,0,0
5446,858,735,1063,969,48,11,14,205,234,377,523,0,0
5447,858,735,1062,969,48,11,14,204,234,378,523,0,0
5448,858,735,1062,968,48,11,14,204,233,379,523,0,0
5449,859,735,1061,968,48,11,14,202,233,380,523,0,0
5450,858,735,1062,968,48,11,14,204,233,381,523,0,0
5451,859,736,1062,969,48,11,14,203,233,382,523,0,0
5452,859,736,1062,969,48,11,14,203,233,383,523,0,0
5453,859,736,1062,969,48,11,14,203,233,384,523,0,0
5454,859,737,1062,970,48,11,14,203,233,385,523,0,0
5455,859,737,1062,970,48,11,14,203,233,386,523,0,0
5456,859,737,1062,970,48,11,14,203,233,387,523,0,0
5457,859,737,1062,970,48,11,14,203,233,388,523,0,0
5458,860,739,1061,969,48,11,14,201,230,389,523,0,0
5459,860,739,1060,969,48,11,14,200,230,390,523,0,0
5460,860,740,1059,967,48,11,14,199,227,391,523,0,0
5461,860,740,1059,968,48,11,14,199,228,392,523,0,0
5462,860,741,1059,968,48,11,14,199,227,393,523,0,0
5463,859,738,1060,968,48,11,14,201,230,394,523,0,0
5464,859,740,1060,969,48,11,14,201,229,395,523,0,0
5465,858,738,1060,969,48,11,14,202,231,396,523,0,0
5466,857,737,1060,968,48,11,14,203,231,397,523,0,0
5467,857,735,1061,968,48,11,14,204,233,398,523,0,0
5468,856,733,1060,966,48,11,14,204,233,399,523,0,0
5469,856,735,1060,968,48,11,14,204,233,400,523,0,0
5470,856,734,1058,966,48,11,14,202,232,401,523,0,0
5471,857,734,1061,968,48,11,14,204,234,402,523,0,0
5472,857,734,1062,969,48,11,14,205,235,403,523,0,0
5473,858,732,1063,969,48,11,14,205,237,404,523,0,0
5474,857,730,1064,969,48,11,14,207,239,405,523,0,0
5475,858,732,1062,967,48,11,14,204,235,406,523,0,0
5476,858,731,1062,968,48,11,14,204,237,407,523,0,0
5477,857,731,1061,968,48,11,14,204,237,408,523,0,0
5478,858,731,1062,969,48,11,14,204,238,409,523,0,0
5479,859,733,1060,967,48,11,14,201,234,410,523,0,0
5480,860,734,1060,968,48,11,14,200,234,411,523,0,0
5481,860,735,1059,967,48,11,14,199,232,412,523,0,0
5482,860,734,1061,967,48,11,14,201,233,413,523,0,0
5483,860,734,1060,967,48,11,14,200,233,414,523,0,0
5484,860,735,1058,965,48,11,14,198,230,415,523,0,0
5485,861,737,1059,966,48,11,14,198,229,416,523,0,0
5486,860,739,1058,968,48,11,14,198,229,417,523,0,0
5487,860,739,1057,967,48,11,14,197,228,418,523,0,0
5488,859,738,1058,967,48,11,14,199,229,419,523,0,0
5489,859,738,1058,966,48,11,14,199,228,420,523,0,0
5490,859,738,1058,966,48,11,14,199,228,421,523,0,0
5491,859,738,1059,967,48,11,14,200,229,422,523,0,0
5492,859,738,1060,968,48,11,14,201,230,423,523,0,0
5493,857,736,1059,969,48,11,14,202,233,424,523,0,0
5494,856,735,1060,969,48,11,14,204,234,425,523,0,0
5495,859,735,1061,968,48,11,14,202,233,426,523,0,0
5496,860,735,1062,968,48,11,14,202,233,427,523,0,0
5497,860,736,1061,968,48,11,14,201,232,428,523,0,0
5498,860,738,1060,968,48,11,14,200,230,429,523,0,0
5499,861,741,1060,969,48,11,14,199,228,430,523,0,0
5500,862,741,1059,967,48,11,14,197,226,431,523,0,0
5501,860,739,1059,968,48,11,14,199,229,432,523,0,0
5502,859,738,1060,968,48,11,14,201,230,433,523,0,0
5503,858,734,1063,970,48,11,14,205,236,434,523,0,0
5504,856,725,1067,971,48,11,14,211,246,435,523,0,0
5505,854,716,1068,968,48,11,14,214,252,436,523,0,0
5506,854,712,1069,966,48,11,14,215,254,437,523,0,0
5507,854,711,1068,967,48,11,14,214,256,438,523,0,0
5508,860,719,1064,963,48,11,14,204,244,439,523,0,0
5509,862,722,1064,966,48,11,14,202,244,440,523,0,0
5510,863,726,1064,968,48,11,14,201,242,441,523,0,0
5511,865,730,1062,967,48,11,14,197,237,442,523,0,0
5512,865,732,1061,967,48,11,14,196,235,443,523,0,0
5513,865,732,1061,967,48,11,14,196,235,444,523,0,0
5514,866,733,1061,966,48,11,14,195,233,445,523,0,0
5515,864,732,1061,967,48,11,14,197,235,446,523,0,0
5516,864,732,1063,970,48,11,14,199,238,447,523,0,0
5517,865,731,1065,971,48,11,14,200,240,448,523,0,0
5518,861,730,1063,973,48,11,14,202,243,449,523,0,0
5519,863,729,1063,969,48,11,14,200,240,450,523,0,0
5520,878,730,1073,970,48,11,14,195,240,451,523,0,0
5521,879,730,1075,970,48,11,14,196,240,452,523,0,0
5523,856,733,1035,958,48,11,14,179,225,0,523,0,1
5524,877,730,1074,985,48,11,14,197,255,1,523,0,0
5525,877,730,1076,987,48,11,14,199,257,2,523,0,0
5526,867,735,1041,960,48,11,14,174,225,3,523,0,0
5527,869,733,1051,967,48,11,14,182,234,4,523,0,0
5528,869,733,1054,969,48,11,14,185,236,5,523,0,0
5529,869,734,1055,968,48,11,14,186,234,6,523,0,0
5530,868,733,1057,970,48,11,14,189,237,7,523,0,0
5531,868,734,1057,969,48,11,14,189,235,8,523,0,0
5532,868,734,1057,969,48,11,14,189,235,9,523,0,0
5533,868,735,1057,969,48,11,14,189,234,10,523,0,0
5534,867,735,1058,969,48,11,14,191,234,11,523,0,0
5535,867,735,1058,968,48,11,14,191,233,12,523,0,0
5536,865,736,1056,969,48,11,14,191,233,13,523,0,0
5537,864,736,1055,967,48,11,14,191,231,14,523,0,0
5538,863,736,1056,968,48,11,14,193,232,15,523,0,0
5539,865,736,1057,968,48,11,14,192,232,16,523,0,0
5540,865,737,1058,968,48,11,14,193,231,17,523,0,0
5541,863,737,1057,968,48,11,14,194,231,18,523,0,0
5542,864,736,1058,967,48,11,14,194,231,19,523,0,0
5543,865,736,1059,967,48,11,14,194,231,20,523,0,0
5544,865,736,1060,967,48,11,14,195,231,21,523,0,0
5545,862,736,1060,969,48,11,14,198,233,22,523,0,0
5546,863,734,1060,968,48,11,14,197,234,23,523,0,0
5547,863,734,1060,968,48,11,14,197,234,24,523,0,0
5548,863,736,1058,965,48,11,14,195,229,25,523,0,0
5549,862,734,1060,967,48,11,14,198,233,26,523,0,0
5550,862,735,1060,969,48,11,14,198,234,27,523,0,0
5551,862,735,1060,968,48,11,14,198,233,28,523,0,0
5552,862,735,1060,968,48,11,14,198,233,29,523,0,0
5553,862,734,1060,968,48,11,14,198,234,30,523,0,0
5554,862,734,1060,968,48,11,14,198,234,31,523,0,0
5555,862,734,1060,968,48,11,14,198,234,32,523,0,0
5556,864,736,1060,967,48,11,14,196,231,33,523,0,0
5557,864,736,1060,966,48,11,14,196,230,34,523,0,0
5558,865,736,1060,966,48,11,14,195,230,35,523,0,0
5559,865,737,1061,966,48,11,14,196,229,36,523,0,0
5560,865,737,1061,966,48,11,14,196,229,37,523,0,0
5561,864,736,1061,966,48,11,14,197,230,38,523,0,0
5562,864,736,1061,967,48,11,14,197,231,39,523,0,0
5563,864,736,1061,967,48,11,14,197,231,40,523,0,0
5564,863,736,1060,967,48,11,14,197,231,41,523,0,0
5565,863,736,1061,967,48,11,14,198,231,42,523,0,0
5566,864,736,1062,967,48,11,14,198,231,43,523,0,0
5567,864,736,1062,967,48,11,14,198,231,44,523,0,0
5568,863,735,1062,968,48,11,14,199,233,45,523,0,0
5569,863,735,1062,968,48,11,14,199,233,46,523,0,0
5570,861,735,1061,969,48,11,14,200,234,47,523,0,0
5571,861,734,1061,969,48,11,14,200,235,48,523,0,0
5572,862,735,1062,969,48,11,14,200,234,49,523,0,0
5573,862,734,1063,970,48,11,14,201,236,50,523,0,0
5574,862,734,1063,970,48,11,14,201,236,51,523,0,0
5575,863,735,1062,969,48,11,14,199,234,52,523,0,0
5576,863,736,1061,969,48,11,14,198,233,53,523,0,0
5577,861,737,1060,971,48,11,14,199,234,54,523,0,0
5578,861,735,1062,972,48,11,14,201,237,55,523,0,0
5579,861,735,1062,972,48,11,14,201,237,56,523,0,0
5580,861,735,1062,972,48,11,14,201,237,57,523,0,0
5581,863,736,1061,970,48,11,14,198,234,58,523,0,0
5582,864,737,1061,969,48,11,14,197,232,59,523,0,0
5583,863,737,1060,969,48,11,14,197,232,60,523,0,0
5584,862,736,1060,969,48,11,14,198,233,61,523,0,0
5585,862,736,1059,968,48,11,14,197,232,62,523,0,0
5586,863,736,1060,968,48,11,14,197,232,63,523,0,0
5587,863,736,1061,967,48,11,14,198,231,64,523,0,0
5588,863,736,1060,967,48,11,14,197,231,65,523,0,0
5589,863,736,1060,968,48,11,14,197,232,66,523,0,0
5590,863,736,1061,968,48,11,14,198,232,67,523,0,0
5591,861,734,1062,970,48,11,14,201,236,68,523,0,0
5592,861,734,1062,972,48,11,14,201,238,69,523,0,0
5593,861,734,1063,972,48,11,14,202,238,70,523,0,0
5594,862,734,1063,971,48,11,14,201,237,71,523,0,0
5595,862,734,1062,970,48,11,14,200,236,72,523,0,0
5596,861,734,1063,972,48,11,14,202,238,73,523,0,0
5597,861,730,1065,973,48,11,14,204,243,74,523,0,0
5598,862,728,1065,971,48,11,14,203,243,75,523,0,0
5599,863,728,1066,970,48,11,14,203,242,76,523,0,0
5600,863,728,1065,970,48,11,14,202,242,77,523,0,0
5601,863,729,1064,970,48,11,14,201,241,78,523,0,0
5602,863,733,1063,972,48,11,14,200,239,79,523,0,0
5603,865,737,1061,972,48,11,14,196,235,80,523,0,0
5604,865,739,1060,971,48,11,14,195,232,81,523,0,0
5605,865,739,1060,971,48,11,14,195,232,82,523,0,0
5606,863,739,1058,970,48,11,14,195,231,83,523,0,0
5607,863,738,1060,972,48,11,14,197,234,84,523,0,0
5608,863,738,1061,974,48,11,14,198,236,85,523,0,0
5609,863,739,1061,974,48,11,14,198,235,86,523,0,0
5610,862,738,1061,973,48,11,14,199,235,87,523,0,0
5611,863,737,1061,971,48,11,14,198,234,88,523,0,0
5612,863,737,1061,969,48,11,14,198,232,89,523,0,0
5613,863,737,1060,970,48,11,14,197,233,90,523,0,0
5614,862,737,1061,971,48,11,14,199,234,91,523,0,0
5615,862,737,1061,971,48,11,14,199,234,92,523,0,0
5616,864,738,1061,970,48,11,14,197,232,93,523,0,0
5617,863,738,1061,970,48,11,14,198,232,94,523,0,0
5618,864,738,1061,970,48,11,14,197,232,95,523,0,0
5619,863,739,1061,971,48,11,14,198,232,96,523,0,0
5620,864,739,1061,970,48,11,14,197,231,97,523,0,0
5621,863,739,1060,969,48,11,14,197,230,98,523,0,0
5622,863,739,1059,967,48,11,14,196,228,99,523,0,0
5623,863,738,1059,966,48,11,14,196,228,100,523,0,0
5624,862,737,1060,968,48,11,14,198,231,101,523,0,0
5625,861,736,1060,967,48,11,14,199,231,102,523,0,0
5626,860,735,1061,969,48,11,14,201,234,103,523,0,0
5627,860,735,1062,970,48,11,14,202,235,104,523,0,0
5628,860,734,1061,968,48,11,14,201,234,105,523,0,0
5629,860,734,1063,970,48,11,14,203,236,106,523,0,0
5630,858,729,1064,970,48,11,14,206,241,107,523,0,0
5631,856,722,1066,971,48,11,14,210,249,108,523,0,0
5632,853,710,1070,967,48,11,14,217,257,109,523,0,0
5633,852,700,1076,970,48,11,14,224,270,110,523,0,0
5634,851,696,1077,973,48,11,14,226,277,111,523,0,0
5635,847,682,1081,973,48,11,14,234,291,112,523,0,0
5636,848,686,1075,972,48,11,14,227,286,113,523,0,0
5637,849,692,1072,975,48,11,14,223,283,114,523,0,0
5638,852,696,1070,973,48,11,14,218,277,115,523,0,0
5639,852,695,1071,975,48,11,14,219,280,116,523,0,0
5640,845,672,1079,977,48,11,14,234,305,117,523,0,0
5641,853,690,1074,977,48,11,14,221,287,118,523,0,0
5642,858,691,1077,976,48,11,14,219,285,119,523,0,0
5643,856,690,1073,974,48,11,14,217,284,120,523,0,0
5644,856,688,1070,970,48,11,14,214,282,121,523,0,0
5645,857,687,1067,965,48,11,14,210,278,122,523,0,0
5646,854,688,1068,973,48,11,14,214,285,123,523,0,0
5647,856,690,1069,976,48,11,14,213,286,124,523,0,0
5648,859,696,1065,972,48,11,14,206,276,125,523,0,0
5649,862,704,1060,969,48,11,14,198,265,126,523,0,0
5650,862,706,1061,973,48,11,14,199,267,127,523,0,0
5651,863,707,1061,971,48,11,14,198,264,128,523,0,0
5652,860,707,1056,970,48,11,14,196,263,129,523,0,0
5653,860,707,1056,970,48,11,14,196,263,130,523,0,0
5654,861,708,1058,970,48,11,14,197,262,131,523,0,0
5655,862,714,1055,970,48,11,14,193,256,132,523,0,0
5656,860,715,1055,972,48,11,14,195,257,133,523,0,0
5657,860,716,1054,970,48,11,14,194,254,134,523,0,0
5658,860,721,1056,975,48,11,14,196,254,135,523,0,0
5659,862,722,1055,974,48,11,14,193,252,136,523,0,0
5660,863,723,1056,974,48,11,14,193,251,137,523,0,0
5661,865,727,1052,969,48,11,14,187,242,138,523,0,0
5662,866,727,1055,973,48,11,14,189,246,139,523,0,0
5663,864,719,1057,972,48,11,14,193,253,140,523,0,0
5664,861,714,1060,976,48,11,14,199,262,141,523,0,0
5665,860,709,1062,976,48,11,14,202,267,142,523,0,0
5666,860,704,1063,975,48,11,14,203,271,143,523,0,0
5667,860,701,1064,976,48,11,14,204,275,144,523,0,0
5668,860,700,1062,974,48,11,14,202,274,145,523,0,0
5669,862,698,1064,976,48,11,14,202,278,146,523,0,0
5670,858,692,1064,979,48,11,14,206,287,147,523,0,0
5671,857,688,1064,980,48,11,14,207,292,148,523,0,0
5672,857,684,1062,973,48,11,14,205,289,149,523,0,0
5673,859,684,1061,971,48,11,14,202,287,150,523,0,0
5674,859,687,1057,969,48,11,14,198,282,151,523,0,0
5675,858,689,1057,975,48,11,14,199,286,152,523,0,0
5676,857,688,1058,977,48,11,14,201,289,153,523,0,0
5677,857,689,1059,981,48,11,14,202,292,154,523,0,0
5678,861,686,1057,970,48,11,14,196,284,155,523,0,0
5679,862,678,1061,967,48,11,14,199,289,156,523,0,0
5680,862,676,1062,967,48,11,14,200,291,157,523,0,0
5681,864,683,1062,971,48,11,14,198,288,158,523,0,0
5682,863,686,1062,974,48,11,14,199,288,159,523,0,0
5683,864,687,1061,974,48,11,14,197,287,160,523,0,0
5684,863,683,1063,974,48,11,14,200,291,161,523,0,0
5685,862,683,1062,972,48,11,14,200,289,162,523,0,0
5686,863,677,1062,966,48,11,14,199,289,163,523,0,0
5687,857,674,1061,968,48,11,14,204,294,164,523,0,0
5688,850,667,1058,966,48,11,14,208,299,165,523,0,0
5689,842,665,1053,967,48,11,14,211,302,166,523,0,0
5690,834,665,1043,963,48,11,14,209,298,167,523,0,0
5691,837,663,1047,966,48,11,14,210,303,168,523,0,0
5692,847,670,1052,965,48,11,14,205,295,169,523,0,0
5693,855,677,1058,967,48,11,14,203,290,170,523,0,0
5694,860,681,1061,967,48,11,14,201,286,171,523,0,0
5695,868,686,1061,958,48,11,14,193,272,172,523,0,0
5696,866,688,1064,966,48,11,14,198,278,173,523,0,0
5697,864,691,1064,970,48,11,14,200,279,174,523,0,0
5698,868,696,1063,968,48,11,14,195,272,175,523,0,0
5699,867,696,1063,967,48,11,14,196,271,176,523,0,0
5700,868,696,1065,968,48,11,14,197,272,177,523,0,0
5701,867,697,1065,970,48,11,14,198,273,178,523,0,0
5702,867,704,1061,970,48,11,14,194,266,179,523,0,0
5703,872,708,1064,970,48,11,14,192,262,180,523,0,0
5704,876,716,1062,970,48,11,14,186,254,181,523,0,0
5705,878,729,1055,966,48,11,14,177,237,182,523,0,0
5706,875,735,1054,968,48,11,14,179,233,183,523,0,0
5707,868,720,1061,971,48,11,14,193,251,184,523,0,0
5708,857,690,1072,972,48,11,14,215,282,185,523,0,0
5709,851,675,1074,969,48,11,14,223,294,186,523,0,0
5710,855,679,1077,973,48,11,14,222,294,187,523,0,0
5711,859,691,1073,974,48,11,14,214,283,188,523,0,0
5712,862,698,1071,975,48,11,14,209,277,189,523,0,0
5713,863,700,1073,978,48,11,14,210,278,190,523,0,0
5714,862,698,1072,976,48,11,14,210,278,191,523,0,0
5715,859,696,1072,977,48,11,14,213,281,192,523,0,0
5716,858,693,1072,976,48,11,14,214,283,193,523,0,0
5717,858,695,1071,976,48,11,14,213,281,194,523,0,0
5718,858,695,1071,976,48,11,14,213,281,195,523,0,0
5719,858,696,1071,976,48,11,14,213,280,196,523,0,0
5720,859,696,1071,976,48,11,14,212,280,197,523,0,0
5721,860,696,1071,974,48,11,14,211,278,198,523,0,0
5722,859,697,1069,974,48,11,14,210,277,199,523,0,0
5723,859,698,1069,974,48,11,14,210,276,200,523,0,0
5724,859,698,1069,974,48,11,14,210,276,201,523,0,0
5725,858,698,1069,974,48,11,14,211,276,202,523,0,0
5726,858,695,1070,973,48,11,14,212,278,203,523,0,0
5727,857,691,1069,971,48,11,14,212,280,204,523,0,0
5728,857,689,1070,971,48,11,14,213,282,205,523,0,0
5729,858,688,1071,971,48,11,14,213,283,206,523,0,0
5730,857,688,1070,971,48,11,14,213,283,207,523,0,0
5731,861,690,1070,971,48,11,14,209,281,208,523,0,0
5732,860,689,1070,970,48,11,14,210,281,209,523,0,0
5733,860,689,1069,970,48,11,14,209,281,210,523,0,0
5734,860,691,1070,973,48,11,14,210,282,211,523,0,0
5735,859,690,1068,972,48,11,14,209,282,212,523,0,0
5736,861,692,1066,968,48,11,14,205,276,213,523,0,0
5737,862,693,1066,967,48,11,14,204,274,214,523,0,0
5738,860,692,1066,968,48,11,14,206,276,215,523,0,0
5739,859,691,1067,969,48,11,14,208,278,216,523,0,0
5740,859,691,1067,969,48,11,14,208,278,217,523,0,0
5741,859,690,1067,969,48,11,14,208,279,218,523,0,0
5742,858,691,1067,970,48,11,14,209,279,219,523,0,0
5743,858,691,1067,970,48,11,14,209,279,220,523,0,0
5744,858,692,1067,970,48,11,14,209,278,221,523,0,0
5745,861,694,1066,968,48,11,14,205,274,222,523,0,0
5746,859,695,1066,972,48,11,14,207,277,223,523,0,0
5747,859,701,1064,973,48,11,14,205,272,224,523,0,0
5748,860,704,1064,975,48,11,14,204,271,225,523,0,0
5749,860,706,1062,975,48,11,14,202,269,226,523,0,0
5750,858,707,1061,975,48,11,14,203,268,227,523,0,0
5751,858,708,1058,974,48,11,14,200,266,228,523,0,0
5752,859,703,1061,974,48,11,14,202,271,229,523,0,0
5753,858,702,1060,972,48,11,14,202,270,230,523,0,0
5754,858,701,1062,973,48,11,14,204,272,231,523,0,0
5755,858,701,1063,973,48,11,14,205,272,232,523,0,0
5756,858,701,1062,974,48,11,14,204,273,233,523,0,0
5757,858,701,1063,973,48,11,14,205,272,234,523,0,0
5758,860,701,1065,973,48,11,14,205,272,235,523,0,0
5759,867,701,1070,971,48,11,14,203,270,236,523,0,0
5760,865,706,1065,971,48,11,14,200,265,237,523,0,0
5761,871,722,1058,970,48,11,14,187,248,238,523,0,0
5762,875,741,1050,970,48,11,14,175,229,239,523,0,0
5763,875,751,1046,971,48,11,14,171,220,240,523,0,0
5764,873,747,1049,972,48,11,14,176,225,241,523,0,0
5765,867,732,1056,972,48,11,14,189,240,242,523,0,0
5766,863,718,1062,972,48,11,14,199,254,243,523,0,0
5767,865,726,1056,970,48,11,14,191,244,244,523,0,0
5768,869,747,1049,973,48,11,14,180,226,245,523,0,0
5769,870,756,1047,974,48,11,14,177,218,246,523,0,0
5770,870,759,1048,974,48,11,14,178,215,247,523,0,0
5771,869,756,1049,973,48,11,14,180,217,248,523,0,0
5772,866,754,1048,971,48,11,14,182,217,249,523,0,0
5773,866,752,1052,971,48,11,14,186,219,250,523,0,0
5774,864,750,1052,969,48,11,14,188,219,251,523,0,0
5775,862,742,1058,971,48,11,14,196,229,252,523,0,0
5776,858,730,1061,969,48,11,14,203,239,253,523,0,0
5777,852,713,1071,974,48,11,14,219,261,254,523,0,0
5778,853,701,1076,971,48,11,14,223,270,255,523,0,0
5779,855,689,1087,973,48,11,14,232,284,256,523,0,0
5780,860,675,1109,978,48,11,14,249,303,257,523,0,0
5781,850,670,1100,981,48,11,14,250,311,258,523,0,0
5782,844,669,1092,981,48,11,14,248,312,259,523,0,0
5783,844,669,1087,981,48,11,14,243,312,260,523,0,0
5784,845,670,1085,983,48,11,14,240,313,261,523,0,0
5785,849,669,1089,982,48,11,14,240,313,262,523,0,0
5786,853,678,1079,977,48,11,14,226,299,263,523,0,0
5787,859,686,1075,971,48,11,14,216,285,264,523,0,0
5788,862,689,1075,974,48,11,14,213,285,265,523,0,0
5789,856,684,1073,975,48,11,14,217,291,266,523,0,0
5790,850,684,1066,973,48,11,14,216,289,267,523,0,0
5791,850,687,1064,971,48,11,14,214,284,268,523,0,0
5792,849,682,1064,968,48,11,14,215,286,269,523,0,0
5793,850,684,1065,970,48,11,14,215,286,270,523,0,0
5794,847,679,1065,968,48,11,14,218,289,271,523,0,0
5795,844,680,1064,971,48,11,14,220,291,272,523,0,0
5796,850,678,1070,968,48,11,14,220,290,273,523,0,0
5797,850,677,1070,969,48,11,14,220,292,274,523,0,0
5798,850,678,1069,968,48,11,14,219,290,275,523,0,0
5799,849,681,1064,966,48,11,14,215,285,276,523,0,0
5800,850,683,1066,968,48,11,14,216,285,277,523,0,0
5801,847,685,1062,966,48,11,14,215,281,278,523,0,0
5802,842,689,1055,966,48,11,14,213,277,279,523,0,0
5803,839,699,1048,967,48,11,14,209,268,280,523,0,0
5804,838,714,1038,963,48,11,14,200,249,281,523,0,0
5805,842,731,1031,960,48,11,14,189,229,282,523,0,0
5806,846,742,1030,957,48,11,14,184,215,283,523,0,0
5807,843,743,1032,958,48,11,14,189,215,284,523,0,0
5808,835,738,1035,961,48,11,14,200,223,285,523,0,0
5809,830,732,1039,962,48,11,14,209,230,286,523,0,0
5810,829,726,1046,964,48,11,14,217,238,287,523,0,0
5811,826,723,1052,970,48,11,14,226,247,288,523,0,0
5812,826,722,1055,971,48,11,14,229,249,289,523,0,0
5813,827,723,1056,972,48,11,14,229,249,290,523,0,0
5814,827,723,1056,970,48,11,14,229,247,291,523,0,0
5815,826,723,1056,971,48,11,14,230,248,292,523,0,0
5816,827,722,1056,969,48,11,14,229,247,293,523,0,0
5817,828,722,1057,969,48,11,14,229,247,294,523,0,0
5818,827,722,1057,969,48,11,14,230,247,295,523,0,0
5819,827,722,1057,969,48,11,14,230,247,296,523,0,0
5820,826,722,1057,969,48,11,14,231,247,297,523,0,0
5821,826,721,1056,968,48,11,14,230,247,298,523,0,0
5822,826,721,1056,968,48,11,14,230,247,299,523,0,0
5823,825,721,1056,967,48,11,14,231,246,300,523,0,0
5824,823,719,1055,967,48,11,14,232,248,301,523,0,0
5825,821,716,1055,967,48,11,14,234,251,302,523,0,0
5826,821,716,1056,966,48,11,14,235,250,303,523,0,0
5827,821,715,1057,966,48,11,14,236,251,304,523,0,0
5828,821,716,1057,966,48,11,14,236,250,305,523,0,0
5829,821,716,1057,966,48,11,14,236,250,306,523,0,0
5830,821,716,1059,968,48,11,14,238,252,307,523,0,0
5831,821,717,1058,969,48,11,14,237,252,308,523,0,0
5832,822,719,1057,969,48,11,14,235,250,309,523,0,0
5833,823,722,1057,969,48,11,14,234,247,310,523,0,0
5834,824,722,1056,969,48,11,14,232,247,311,523,0,0
5835,823,723,1056,969,48,11,14,233,246,312,523,0,0
5836,822,722,1057,970,48,11,14,235,248,313,523,0,0
5837,821,722,1055,968,48,11,14,234,246,314,523,0,0
5838,821,722,1055,969,48,11,14,234,247,315,523,0,0
5839,822,724,1056,969,48,11,14,234,245,316,523,0,0
5840,826,728,1056,969,48,11,14,230,241,317,523,0,0
5841,830,739,1051,968,48,11,14,221,229,318,523,0,0
5842,834,748,1047,966,48,11,14,213,218,319,523,0,0
5843,835,753,1045,964,48,11,14,210,211,320,523,0,0
5850,806,694,1076,967,48,11,14,270,273,0,523,0,0
5851,817,692,1078,962,48,11,14,261,270,1,523,0,0
5852,828,696,1082,966,48,11,14,254,270,2,523,0,0
5853,837,708,1076,966,48,11,14,239,258,3,523,0,0
5854,843,725,1065,965,48,11,14,222,240,4,523,0,0
5855,851,741,1056,964,48,11,14,205,223,5,523,0,0
5856,858,746,1057,963,48,11,14,199,217,6,523,0,0
5857,858,742,1059,961,48,11,14,201,219,7,523,0,0
5858,859,738,1063,963,48,11,14,204,225,8,523,0,0
5859,859,733,1062,958,48,11,14,203,225,9,523,0,0
5860,855,732,1061,963,48,11,14,206,231,10,523,0,0
5861,849,734,1059,968,48,11,14,210,234,11,523,0,0
5862,844,735,1049,961,48,11,14,205,226,12,523,0,0
5863,845,735,1033,935,48,11,14,188,200,13,523,0,0
5864,843,736,1032,933,48,11,14,189,197,14,523,0,0
5865,838,738,1036,940,48,11,14,198,202,15,523,0,0
5866,833,735,1045,950,48,11,14,212,215,16,523,0,0
5902,817,716,1064,964,48,11,14,247,248,0,523,0,0
5903,817,717,1063,964,48,11,14,246,247,1,523,0,0
5904,819,717,1063,964,48,11,14,244,247,2,523,0,0
5905,820,718,1062,964,48,11,14,242,246,3,523,0,0
5906,822,718,1060,961,48,11,14,238,243,4,523,0,0
5907,823,718,1060,960,48,11,14,237,242,5,523,0,0
5908,824,719,1060,962,48,11,14,236,243,6,523,0,0
5909,826,721,1058,960,48,11,14,232,239,7,523,0,0
5910,832,732,1051,955,48,11,14,219,223,8,523,0,0
5911,838,750,1044,957,48,11,14,206,207,9,523,0,0
3831,1779,696,1920,1080,51,11,14,141,384,0,1,0,0
3832,1799,735,1913,1044,51,11,14,114,309,1,1,0,0
3893,1588,159,1623,274,55,11,14,35,115,0,93,0,0
3897,1588,164,1624,281,55,11,14,36,117,0,93,0,1
3898,1587,164,1622,282,55,11,14,35,118,1,93,0,0
3899,1585,164,1621,285,55,11,14,36,121,2,93,0,0
3900,1585,166,1621,287,55,11,14,36,121,3,93,0,0
3901,1584,165,1621,290,55,11,14,37,125,4,93,0,0
3902,1583,163,1621,296,55,11,14,38,133,5,93,0,0
3903,1581,165,1619,296,55,11,14,38,131,6,93,0,0
3904,1580,167,1618,297,55,11,14,38,130,7,93,0,0
3905,1580,169,1618,300,55,11,14,38,131,8,93,0,0
3906,1581,171,1619,301,55,11,14,38,130,9,93,0,0
3907,1581,171,1621,308,55,11,14,40,137,10,93,0,0
3908,1581,173,1621,310,55,11,14,40,137,11,93,0,0
3909,1581,172,1621,312,55,11,14,40,140,12,93,0,0
3910,1581,174,1621,313,55,11,14,40,139,13,93,0,0
3911,1583,176,1623,314,55,11,14,40,138,14,93,0,0
3912,1584,178,1625,318,55,11,14,41,140,15,93,0,0
3913,1584,180,1626,325,55,11,14,42,145,16,93,0,0
3914,1582,180,1625,327,55,11,14,43,147,17,93,0,0
3915,1581,181,1624,329,55,11,14,43,148,18,93,0,0
3916,1581,184,1624,335,55,11,14,43,151,19,93,0,0
3917,1581,185,1624,336,55,11,14,43,151,20,93,0,0
3918,1580,184,1625,340,55,11,14,45,156,21,93,0,0
3919,1579,185,1625,346,55,11,14,46,161,22,93,0,0
3920,1576,186,1623,349,55,11,14,47,163,23,93,0,0
3921,1574,187,1622,356,55,11,14,48,169,24,93,0,0
3922,1575,190,1622,357,55,11,14,47,167,25,93,0,0
3923,1573,189,1623,362,55,11,14,50,173,26,93,0,0
3924,1572,194,1622,368,55,11,14,50,174,27,93,0,0
3925,1569,201,1619,374,55,11,14,50,173,28,93,0,0
3926,1565,197,1617,375,55,11,14,52,178,29,93,0,0
3927,1561,200,1615,384,55,11,14,54,184,30,93,0,0
3928,1560,200,1615,390,55,11,14,55,190,31,93,0,0
3929,1559,199,1616,393,55,11,14,57,194,32,93,0,0
3930,1557,205,1614,401,55,11,14,57,196,33,93,0,0
3931,1552,205,1611,406,55,11,14,59,201,34,93,0,0
3932,1549,204,1610,413,55,11,14,61,209,35,93,0,0
3933,1546,206,1609,423,55,11,14,63,217,36,93,0,0
3934,1546,205,1611,427,55,11,14,65,222,37,93,0,0
3935,1544,212,1610,436,55,11,14,66,224,38,93,0,0
3936,1539,219,1606,443,55,11,14,67,224,39,93,0,0
3937,1533,216,1602,449,55,11,14,69,233,40,93,0,0
3938,1529,219,1599,459,55,11,14,70,240,41,93,0,0
3939,1526,225,1598,470,55,11,14,72,245,42,93,0,0
3940,1523,226,1597,475,55,11,14,74,249,43,93,0,0
3941,1517,229,1595,491,55,11,14,78,262,44,93,0,0
3942,1512,231,1593,500,55,11,14,81,269,45,93,0,0
3943,1508,235,1590,508,55,11,14,82,273,46,93,0,0
3944,1507,242,1593,527,55,11,14,86,285,47,93,0,0
3945,1508,244,1595,533,55,11,14,87,289,48,93,0,0
3946,1506,245,1599,556,55,11,14,93,311,49,93,0,0
3947,1501,250,1599,577,55,11,14,98,327,50,93,0,0
3948,1499,250,1601,590,55,11,14,102,340,51,93,0,0
3949,1500,261,1605,606,55,11,14,105,345,52,93,0,0
3950,1503,266,1613,622,55,11,14,110,356,53,93,0,0
3951,1504,272,1619,639,55,11,14,115,367,54,93,0,0
3952,1497,285,1619,670,55,11,14,122,385,55,93,0,0
3953,1489,289,1618,693,55,11,14,129,404,56,93,0,0
3954,1485,295,1619,710,55,11,14,134,415,57,93,0,0
3955,1477,310,1622,757,55,11,14,145,447,58,93,0,0
3956,1474,318,1622,771,55,11,14,148,453,59,93,0,0
3957,1458,329,1615,802,55,11,14,157,473,60,93,0,0
3958,1436,345,1604,846,55,11,14,168,501,61,93,0,0
3959,1412,352,1587,869,55,11,14,175,517,62,93,0,0
3960,1374,375,1565,936,55,11,14,191,561,63,93,0,0
3961,1335,395,1535,972,55,11,14,200,577,64,93,0,0
3962,1288,420,1492,1003,55,11,14,204,583,65,93,0,0
3963,1196,452,1416,1055,55,11,14,220,603,66,93,0,0
3964,1135,457,1362,1074,55,11,14,227,617,67,93,0,0
3965,1038,473,1264,1080,55,11,14,226,607,68,93,0,0
3966,946,498,1178,1080,55,11,14,232,582,69,93,0,0
3967,840,509,1069,1080,55,11,14,229,571,70,93,0,0
3968,730,523,960,1080,55,11,14,230,557,71,93,0,0
3969,604,536,831,1080,55,11,14,227,544,72,93,0,0
3970,480,531,708,1080,55,11,14,228,549,73,93,0,0
3971,390,543,622,1080,55,11,14,232,537,74,93,0,0
3972,297,551,534,1080,55,11,14,237,529,75,93,0,0
3973,195,548,437,1080,55,11,14,242,532,76,93,0,0
3974,130,553,374,1078,55,11,14,244,525,77,93,0,0
3975,79,537,319,1063,55,11,14,240,526,78,93,0,0
3976,58,525,295,1044,55,11,14,237,519,79,93,0,0
3977,44,515,274,1015,55,11,14,230,500,80,93,0,0
3978,15,496,237,981,55,11,14,222,485,81,93,0,0
3979,3,490,219,959,55,11,14,216,469,82,93,0,0
3980,0,476,200,923,55,11,14,200,447,83,93,0,0
3981,0,462,184,884,55,11,14,184,422,84,93,0,0
3982,0,463,180,862,55,11,14,180,399,85,93,0,0
3983,0,461,160,824,55,11,14,160,363,86,93,0,0
3984,0,462,147,813,55,11,14,147,351,87,93,0,0
3985,0,469,133,797,55,11,14,133,328,88,93,0,0
3986,0,439,125,770,55,11,14,125,331,89,93,0,0
3987,0,456,115,754,55,11,14,115,298,90,93,0,0
3988,0,451,97,725,55,11,14,97,274,91,93,0,0
3989,0,441,90,709,55,11,14,90,268,92,93,0,0
3990,0,437,71,690,55,11,14,71,253,93,93,1,0
3971,1740,810,1912,1078,56,11,14,172,268,0,0,0,0
3972,1621,787,1813,1074,57,11,14,192,287,0,0,0,0
3973,1503,773,1696,1079,58,11,14,193,306,0,1,0,0
3974,1404,758,1602,1072,58,11,14,198,314,1,1,0,0
3975,1240,719,1459,1073,59,11,14,219,354,0,35,0,1
3976,1131,712,1356,1074,59,11,14,225,362,1,35,0,0
3977,1009,706,1237,1072,59,11,14,228,366,2,35,0,0
3978,896,685,1141,1076,59,11,14,245,391,3,35,0,0
3979,790,676,1043,1075,59,11,14,253,399,4,35,0,0
3980,715,661,982,1072,59,11,14,267,411,5,35,0,0
3981,605,636,887,1076,59,11,14,282,440,6,35,0,0
3982,528,625,812,1074,59,11,14,284,449,7,35,0,0
3983,457,622,740,1072,59,11,14,283,450,8,35,0,0
3984,375,608,663,1071,59,11,14,288,463,9,35,0,0
3985,306,596,599,1075,59,11,14,293,479,10,35,0,0
3986,260,583,559,1077,59,11,14,299,494,11,35,0,0
3987,215,581,510,1077,59,11,14,295,496,12,35,0,0
3988,185,581,476,1070,59,11,14,291,489,13,35,0,0
3989,149,585,429,1056,59,11,14,280,471,14,35,0,0
3990,105,604,363,1040,59,11,14,258,436,15,35,0,0
3991,75,569,351,1041,59,11,14,276,472,16,35,0,0
3992,44,545,313,1019,59,11,14,269,474,17,35,0,0
3993,29,531,281,985,59,11,14,252,454,18,35,0,0
3994,24,530,261,961,59,11,14,237,431,19,35,0,0
3995,7,521,231,932,59,11,14,224,411,20,35,0,0
3996,0,504,218,922,59,11,14,218,418,21,35,0,0
3997,0,507,202,912,59,11,14,202,405,22,35,0,0
3998,0,509,184,880,59,11,14,184,371,23,35,0,0
3999,3,520,173,852,59,11,14,170,332,24,35,0,0
4000,4,513,172,840,59,11,14,168,327,25,35,0,0
4001,0,492,167,822,59,11,14,167,330,26,35,0,0
4002,0,488,151,814,59,11,14,151,326,27,35,0,0
4003,0,483,143,808,59,11,14,143,325,28,35,0,0
4004,0,474,134,784,59,11,14,134,310,29,35,0,0
4005,0,473,124,765,59,11,14,124,292,30,35,0,0
4006,0,477,123,755,59,11,14,123,278,31,35,0,0
4007,0,475,114,740,59,11,14,114,265,32,35,0,0
4008,0,464,105,732,59,11,14,105,268,33,35,0,0
4009,0,465,98,723,59,11,14,98,258,34,35,0,0
4010,0,460,86,710,59,11,14,86,250,35,35,1,0
3981,861,753,1068,973,60,11,14,207,220,0,1,0,0
3982,865,756,1070,974,60,11,14,205,218,1,1,0,0
4523,1614,176,1649,289,65,11,14,35,113,0,89,0,0
4526,1611,177,1647,295,65,11,14,36,118,0,89,0,1
4527,1613,176,1650,295,65,11,14,37,119,1,89,0,0
4528,1616,176,1652,294,65,11,14,36,118,2,89,0,0
4529,1616,176,1655,303,65,11,14,39,127,3,89,0,0
4530,1617,175,1658,308,65,11,14,41,133,4,89,0,0
4531,1618,174,1659,306,65,11,14,41,132,5,89,0,0
4532,1618,176,1661,312,65,11,14,43,136,6,89,0,0
4533,1619,179,1662,318,65,11,14,43,139,7,89,0,0
4534,1619,178,1663,319,65,11,14,44,141,8,89,0,0
4535,1618,178,1661,320,65,11,14,43,142,9,89,0,0
4536,1615,181,1658,321,65,11,14,43,140,10,89,0,0
4537,1614,180,1656,321,65,11,14,42,141,11,89,0,0
4538,1614,179,1657,324,65,11,14,43,145,12,89,0,0
4539,1615,178,1660,327,65,11,14,45,149,13,89,0,0
4540,1616,179,1660,326,65,11,14,44,147,14,89,0,0
4541,1614,180,1658,329,65,11,14,44,149,15,89,0,0
4542,1612,182,1657,333,65,11,14,45,151,16,89,0,0
4543,1608,183,1653,334,65,11,14,45,151,17,89,0,0
4544,1603,183,1650,338,65,11,14,47,155,18,89,0,0
4545,1601,184,1649,343,65,11,14,48,159,19,89,0,0
4546,1600,185,1648,344,65,11,14,48,159,20,89,0,0
4547,1598,185,1648,352,65,11,14,50,167,21,89,0,0
4548,1595,184,1645,354,65,11,14,50,170,22,89,0,0
4549,1595,184,1645,352,65,11,14,50,168,23,89,0,0
4550,1594,185,1645,356,65,11,14,51,171,24,89,0,0
4551,1596,186,1648,362,65,11,14,52,176,25,89,0,0
4552,1599,186,1652,363,65,11,14,53,177,26,89,0,0
4553,1600,187,1655,370,65,11,14,55,183,27,89,0,0
4554,1602,187,1658,373,65,11,14,56,186,28,89,0,0
4555,1602,187,1659,374,65,11,14,57,187,29,89,0,0
4556,1602,189,1661,382,65,11,14,59,193,30,89,0,0
4557,1603,192,1663,388,65,11,14,60,196,31,89,0,0
4558,1605,193,1666,390,65,11,14,61,197,32,89,0,0
4559,1605,194,1667,397,65,11,14,62,203,33,89,0,0
4560,1602,198,1665,403,65,11,14,63,205,34,89,0,0
4561,1597,197,1662,406,65,11,14,65,209,35,89,0,0
4562,1595,199,1660,409,65,11,14,65,210,36,89,0,0
4563,1594,201,1661,416,65,11,14,67,215,37,89,0,0
4564,1593,200,1661,421,65,11,14,68,221,38,89,0,0
4565,1594,201,1661,420,65,11,14,67,219,39,89,0,0
4566,1592,204,1662,431,65,11,14,70,227,40,89,0,0
4567,1591,204,1664,437,65,11,14,73,233,41,89,0,0
4568,1590,205,1665,445,65,11,14,75,240,42,89,0,0
4569,1591,206,1668,451,65,11,14,77,245,43,89,0,0
4570,1594,206,1671,453,65,11,14,77,247,44,89,0,0
4571,1594,210,1673,463,65,11,14,79,253,45,89,0,0
4572,1592,217,1671,472,65,11,14,79,255,46,89,0,0
4573,1589,218,1671,479,65,11,14,82,261,47,89,0,0
4574,1588,220,1672,489,65,11,14,84,269,48,89,0,0
4575,1586,223,1671,497,65,11,14,85,274,49,89,0,0
4576,1586,225,1672,501,65,11,14,86,276,50,89,0,0
4577,1583,230,1673,517,65,11,14,90,287,51,89,0,0
4578,1575,234,1667,528,65,11,14,92,294,52,89,0,0
4579,1569,236,1662,531,65,11,14,93,295,53,89,0,0
4580,1565,240,1660,543,65,11,14,95,303,54,89,0,0
4581,1560,244,1658,561,65,11,14,98,317,55,89,0,0
4582,1560,245,1658,562,65,11,14,98,317,56,89,0,0
4583,1556,246,1657,577,65,11,14,101,331,57,89,0,0
4584,1548,245,1655,592,65,11,14,107,347,58,89,0,0
4585,1542,245,1652,600,65,11,14,110,355,59,89,0,0
4586,1536,252,1648,617,65,11,14,112,365,60,89,0,0
4587,1532,259,1647,634,65,11,14,115,375,61,89,0,0
4588,1532,261,1648,642,65,11,14,116,381,62,89,0,0
4589,1529,270,1650,666,65,11,14,121,396,63,89,0,0
4590,1523,277,1650,694,65,11,14,127,417,64,89,0,0
4591,1519,279,1650,707,65,11,14,131,428,65,89,0,0
4592,1517,287,1653,736,65,11,14,136,449,66,89,0,0
4593,1516,291,1657,762,65,11,14,141,471,67,89,0,0
4594,1514,294,1660,777,65,11,14,146,483,68,89,0,0
4595,1507,303,1659,803,65,11,14,152,500,69,89,0,0
4596,1498,305,1657,830,65,11,14,159,525,70,89,0,0
4597,1490,316,1652,852,65,11,14,162,536,71,89,0,0
4598,1483,331,1652,889,65,11,14,169,558,72,89,0,0
4599,1477,341,1653,920,65,11,14,176,579,73,89,0,0
4600,1465,350,1648,944,65,11,14,183,594,74,89,0,0
4601,1445,368,1640,989,65,11,14,195,621,75,89,0,0
4602,1423,375,1629,1025,65,11,14,206,650,76,89,0,0
4603,1397,389,1612,1061,65,11,14,215,672,77,89,0,0
4604,1378,413,1592,1070,65,11,14,214,657,78,89,0,0
4605,1353,433,1566,1075,65,11,14,213,642,79,89,0,0
4606,1322,453,1539,1080,65,11,14,217,627,80,89,0,0
4607,1290,482,1505,1080,65,11,14,215,598,81,89,0,0
4608,1255,515,1468,1078,65,11,14,213,563,82,89,0,0
4609,1209,538,1428,1078,65,11,14,219,540,83,89,0,0
4610,1161,575,1379,1078,65,11,14,218,503,84,89,0,0
4611,1124,611,1342,1079,65,11,14,218,468,85,89,0,0
4612,1096,648,1314,1078,65,11,14,218,430,86,89,0,0
4613,1066,705,1273,1080,65,11,14,207,375,87,89,0,0
4614,1013,779,1196,1080,65,11,14,183,301,88,89,0,0
4615,988,816,1154,1080,65,11,14,166,264,89,89,1,0
4529,1581,181,1616,300,66,11,14,35,119,0,88,0,1
4530,1578,181,1614,305,66,11,14,36,124,1,88,0,0
4531,1577,182,1613,305,66,11,14,36,123,2,88,0,0
4532,1578,186,1614,310,66,11,14,36,124,3,88,0,0
4533,1580,186,1616,309,66,11,14,36,123,4,88,0,0
4534,1581,186,1618,312,66,11,14,37,126,5,88,0,0
4535,1581,189,1618,314,66,11,14,37,125,6,88,0,0
4536,1580,188,1617,316,66,11,14,37,128,7,88,0,0
4537,1581,189,1617,314,66,11,14,36,125,8,88,0,0
4538,1581,194,1616,317,66,11,14,35,123,9,88,0,0
4539,1581,193,1616,316,66,11,14,35,123,10,88,0,0
4540,1579,194,1615,321,66,11,14,36,127,11,88,0,0
4541,1575,195,1613,329,66,11,14,38,134,12,88,0,0
4542,1571,196,1609,329,66,11,14,38,133,13,88,0,0
4543,1567,194,1607,333,66,11,14,40,139,14,88,0,0
4544,1565,197,1605,334,66,11,14,40,137,15,88,0,0
4545,1564,198,1605,338,66,11,14,41,140,16,88,0,0
4546,1564,199,1604,339,66,11,14,40,140,17,88,0,0
4547,1563,201,1604,342,66,11,14,41,141,18,88,0,0
4548,1562,203,1603,344,66,11,14,41,141,19,88,0,0
4549,1561,202,1603,344,66,11,14,42,142,20,88,0,0
4550,1560,204,1603,349,66,11,14,43,145,21,88,0,0
4551,1562,207,1604,350,66,11,14,42,143,22,88,0,0
4552,1560,204,1605,357,66,11,14,45,153,23,88,0,0
4553,1558,207,1605,367,66,11,14,47,160,24,88,0,0
4554,1553,207,1602,373,66,11,14,49,166,25,88,0,0
4555,1549,208,1600,378,66,11,14,51,170,26,88,0,0
4556,1549,211,1600,382,66,11,14,51,171,27,88,0,0
4557,1548,212,1600,385,66,11,14,52,173,28,88,0,0
4558,1546,209,1600,387,66,11,14,54,178,29,88,0,0
4559,1544,211,1601,397,66,11,14,57,186,30,88,0,0
4560,1540,212,1600,403,66,11,14,60,191,31,88,0,0
4561,1537,212,1598,408,66,11,14,61,196,32,88,0,0
4562,1537,216,1598,412,66,11,14,61,196,33,88,0,0
4563,1539,223,1599,416,66,11,14,60,193,34,88,0,0
4564,1538,223,1599,419,66,11,14,61,196,35,88,0,0
4565,1538,228,1600,429,66,11,14,62,201,36,88,0,0
4566,1533,228,1598,434,66,11,14,65,206,37,88,0,0
4567,1530,225,1596,437,66,11,14,66,212,38,88,0,0
4568,1530,229,1595,440,66,11,14,65,211,39,88,0,0
4569,1530,232,1596,446,66,11,14,66,214,40,88,0,0
4570,1528,230,1596,450,66,11,14,68,220,41,88,0,0
4571,1527,232,1599,462,66,11,14,72,230,42,88,0,0
4572,1524,239,1597,472,66,11,14,73,233,43,88,0,0
4573,1516,239,1592,476,66,11,14,76,237,44,88,0,0
4574,1517,242,1593,482,66,11,14,76,240,45,88,0,0
4575,1517,253,1591,488,66,11,14,74,235,46,88,0,0
4576,1511,252,1588,491,66,11,14,77,239,47,88,0,0
4577,1507,252,1586,501,66,11,14,79,249,48,88,0,0
4578,1502,256,1585,514,66,11,14,83,258,49,88,0,0
4579,1490,257,1576,523,66,11,14,86,266,50,88,0,0
4580,1487,259,1574,532,66,11,14,87,273,51,88,0,0
4581,1485,264,1575,549,66,11,14,90,285,52,88,0,0
4582,1481,265,1572,556,66,11,14,91,291,53,88,0,0
4583,1474,272,1569,572,66,11,14,95,300,54,88,0,0
4584,1463,280,1560,584,66,11,14,97,304,55,88,0,0
4585,1454,282,1553,593,66,11,14,99,311,56,88,0,0
4586,1448,291,1551,616,66,11,14,103,325,57,88,0,0
4587,1441,293,1548,632,66,11,14,107,339,58,88,0,0
4588,1437,297,1545,635,66,11,14,108,338,59,88,0,0
4589,1434,308,1544,652,66,11,14,110,344,60,88,0,0
4590,1423,314,1537,670,66,11,14,114,356,61,88,0,0
4591,1414,320,1531,682,66,11,14,117,362,62,88,0,0
4592,1411,330,1530,699,66,11,14,119,369,63,88,0,0
4593,1406,337,1531,726,66,11,14,125,389,64,88,0,0
4594,1399,341,1529,745,66,11,14,130,404,65,88,0,0
4595,1391,353,1526,771,66,11,14,135,418,66,88,0,0
4596,1373,355,1515,794,66,11,14,142,439,67,88,0,0
4597,1356,362,1503,812,66,11,14,147,450,68,88,0,0
4598,1349,381,1501,852,66,11,14,152,471,69,88,0,0
4599,1338,389,1496,879,66,11,14,158,490,70,88,0,0
4600,1328,402,1489,899,66,11,14,161,497,71,88,0,0
4601,1310,422,1480,945,66,11,14,170,523,72,88,0,0
4602,1285,436,1457,966,66,11,14,172,530,73,88,0,0
4603,1249,452,1433,1016,66,11,14,184,564,74,88,0,0
4604,1215,478,1408,1059,66,11,14,193,581,75,88,0,0
4605,1196,495,1388,1076,66,11,14,192,581,76,88,0,0
4606,1163,518,1353,1079,66,11,14,190,561,77,88,0,0
4607,1126,541,1310,1080,66,11,14,184,539,78,88,0,0
4608,1070,557,1252,1080,66,11,14,182,523,79,88,0,0
4609,1006,569,1187,1080,66,11,14,181,511,80,88,0,0
4610,938,601,1119,1075,66,11,14,181,474,81,88,0,0
4611,901,630,1082,1079,66,11,14,181,449,82,88,0,0
4612,875,657,1049,1078,66,11,14,174,421,83,88,0,0
4613,822,714,985,1080,66,11,14,163,366,84,88,0,0
4614,732,765,887,1080,66,11,14,155,315,85,88,0,0
4615,657,830,793,1079,66,11,14,136,249,86,88,0,0
4616,575,926,677,1080,66,11,14,102,154,87,88,0,0
4617,528,973,601,1080,66,11,14,73,107,88,88,1,0
4500,1698,711,1870,1072,69,11,14,172,361,0,0,0,0
4501,1448,689,1782,1073,70,11,14,334,384,0,31,0,1
4502,1339,700,1655,1063,70,11,14,316,363,1,31,0,0
4503,1230,675,1571,1073,70,11,14,341,398,2,31,0,0
4504,1059,670,1409,1078,70,11,14,350,408,3,31,0,0
4505,939,648,1300,1077,70,11,14,361,429,4,31,0,0
4506,802,617,1180,1073,70,11,14,378,456,5,31,0,0
4507,701,611,1074,1072,70,11,14,373,461,6,31,0,0
4508,595,589,979,1077,70,11,14,384,488,7,31,0,0
4509,495,573,883,1073,70,11,14,388,500,8,31,0,0
4510,430,555,827,1077,70,11,14,397,522,9,31,0,0
4511,380,537,774,1075,70,11,14,394,538,10,31,0,0
4512,345,531,730,1069,70,11,14,385,538,11,31,0,0
4513,297,516,681,1066,70,11,14,384,550,12,31,0,0
4514,237,508,611,1059,70,11,14,374,551,13,31,0,0
4515,207,507,563,1045,70,11,14,356,538,14,31,0,0
4516,185,497,504,994,70,11,14,319,497,15,31,0,0
4517,177,491,474,961,70,11,14,297,470,16,31,0,0
4518,147,484,425,928,70,11,14,278,444,17,31,0,0
4519,107,481,369,909,70,11,14,262,428,18,31,0,0
4520,89,482,340,899,70,11,14,251,417,19,31,0,0
4521,67,474,299,870,70,11,14,232,396,20,31,0,0
4522,58,475,276,852,70,11,14,218,377,21,31,0,0
4523,35,470,245,834,70,11,14,210,364,22,31,0,0
4524,4,466,206,826,70,11,14,202,360,23,31,0,0
4525,0,475,184,820,70,11,14,184,345,24,31,0,0
4526,0,478,156,799,70,11,14,156,321,25,31,0,0
4527,0,477,147,787,70,11,14,147,310,26,31,0,0
4528,0,481,130,774,70,11,14,130,293,27,31,0,0
4529,0,468,120,762,70,11,14,120,294,28,31,0,0
4530,0,468,107,752,70,11,14,107,284,29,31,0,0
4531,0,457,97,731,70,11,14,97,274,30,31,0,0
4532,0,452,74,717,70,11,14,74,265,31,31,1,0
4613,899,678,1069,888,73,11,14,170,210,0,3,0,0
4614,899,685,1063,888,73,11,14,164,203,1,3,0,0
4615,903,688,1069,893,73,11,14,166,205,2,3,0,0
4616,905,691,1071,895,73,11,14,166,204,3,3,0,0
4751,1747,589,1918,953,76,11,14,171,364,0,0,0,0
4753,1652,573,1914,1060,77,11,14,262,487,0,227,0,1
4754,1684,566,1903,974,77,11,14,219,408,1,227,0,0
4755,1657,580,1873,979,77,11,14,216,399,2,227,0,0
4756,1631,573,1832,942,77,11,14,201,369,3,227,0,0
4757,1570,550,1820,1010,77,11,14,250,460,4,227,0,0
4758,1536,542,1805,1039,77,11,14,269,497,5,227,0,0
4759,1521,529,1788,1019,77,11,14,267,490,6,227,0,0
4760,1509,510,1780,1010,77,11,14,271,500,7,227,0,0
4761,1489,490,1781,1037,77,11,14,292,547,8,227,0,0
4762,1467,471,1776,1054,77,11,14,309,583,9,227,0,0
4763,1450,471,1755,1054,77,11,14,305,583,10,227,0,0
4764,1415,458,1723,1054,77,11,14,308,596,11,227,0,0
4765,1390,443,1692,1037,77,11,14,302,594,12,227,0,0
4766,1372,435,1672,1033,77,11,14,300,598,13,227,0,0
4767,1369,430,1660,1018,77,11,14,291,588,14,227,0,0
4768,1372,427,1654,1007,77,11,14,282,580,15,227,0,0
4769,1382,415,1657,989,77,11,14,275,574,16,227,0,0
4770,1392,411,1660,979,77,11,14,268,568,17,227,0,0
4771,1392,405,1654,967,77,11,14,262,562,18,227,0,0
4772,1394,400,1652,957,77,11,14,258,557,19,227,0,0
4773,1395,401,1651,957,77,11,14,256,556,20,227,0,0
4774,1398,403,1650,955,77,11,14,252,552,21,227,0,0
4775,1400,405,1649,954,77,11,14,249,549,22,227,0,0
4776,1401,408,1645,951,77,11,14,244,543,23,227,0,0
4777,1400,404,1645,952,77,11,14,245,548,24,227,0,0
4778,1400,399,1645,953,77,11,14,245,554,25,227,0,0
4779,1399,395,1644,955,77,11,14,245,560,26,227,0,0
4780,1401,396,1642,953,77,11,14,241,557,27,227,0,0
4781,1402,397,1642,955,77,11,14,240,558,28,227,0,0
4782,1403,397,1641,956,77,11,14,238,559,29,227,0,0
4783,1405,403,1638,955,77,11,14,233,552,30,227,0,0
4784,1407,409,1635,952,77,11,14,228,543,31,227,0,0
4785,1408,404,1637,954,77,11,14,229,550,32,227,0,0
4786,1407,401,1639,957,77,11,14,232,556,33,227,0,0
4787,1404,402,1635,954,77,11,14,231,552,34,227,0,0
4788,1399,406,1636,975,77,11,14,237,569,35,227,0,0
4789,1396,408,1633,980,77,11,14,237,572,36,227,0,0
4790,1381,419,1614,982,77,11,14,233,563,37,227,0,0
4791,1366,426,1597,987,77,11,14,231,561,38,227,0,0
4792,1353,429,1584,991,77,11,14,231,562,39,227,0,0
4793,1348,433,1582,1006,77,11,14,234,573,40,227,0,0
4794,1345,439,1584,1032,77,11,14,239,593,41,227,0,0
4795,1344,446,1582,1047,77,11,14,238,601,42,227,0,0
4796,1341,454,1580,1058,77,11,14,239,604,43,227,0,0
4797,1346,463,1583,1062,77,11,14,237,599,44,227,0,0
4798,1356,475,1590,1060,77,11,14,234,585,45,227,0,0
4799,1374,481,1608,1057,77,11,14,234,576,46,227,0,0
4800,1401,476,1634,1047,77,11,14,233,571,47,227,0,0
4801,1423,476,1656,1051,77,11,14,233,575,48,227,0,0
4802,1438,477,1672,1058,77,11,14,234,581,49,227,0,0
4803,1455,490,1686,1054,77,11,14,231,564,50,227,0,0
4804,1482,502,1708,1051,77,11,14,226,549,51,227,0,0
4805,1492,507,1716,1054,77,11,14,224,547,52,227,0,0
4807,1521,562,1742,1062,77,11,14,221,500,0,227,0,0
4808,1533,572,1750,1065,77,11,14,217,493,1,227,0,0
4815,1432,517,1685,1072,77,11,14,253,555,0,227,0,1
4816,1406,489,1664,1066,77,11,14,258,577,1,227,0,0
4817,1384,466,1644,1059,77,11,14,260,593,2,227,0,0
4818,1369,454,1627,1043,77,11,14,258,589,3,227,0,0
4819,1358,442,1620,1046,77,11,14,262,604,4,227,0,0
4820,1368,433,1631,1045,77,11,14,263,612,5,227,0,0
4821,1391,419,1646,1015,77,11,14,255,596,6,227,0,0
4822,1409,410,1652,985,77,11,14,243,575,7,227,0,0
4823,1418,399,1657,972,77,11,14,239,573,8,227,0,0
4824,1424,392,1656,957,77,11,14,232,565,9,227,0,0
4825,1423,385,1641,918,77,11,14,218,533,10,227,0,0
4826,1421,375,1630,891,77,11,14,209,516,11,227,0,0
4827,1426,371,1630,879,77,11,14,204,508,12,227,0,0
4828,1436,370,1636,872,77,11,14,200,502,13,227,0,0
4829,1452,364,1646,852,77,11,14,194,488,14,227,0,0
4830,1469,357,1657,830,77,11,14,188,473,15,227,0,0
4831,1481,352,1664,815,77,11,14,183,463,16,227,0,0
4832,1487,354,1667,820,77,11,14,180,466,17,227,0,0
4833,1487,349,1665,819,77,11,14,178,470,18,227,0,0
4834,1484,343,1653,798,77,11,14,169,455,19,227,0,0
4835,1482,335,1645,780,77,11,14,163,445,20,227,0,0
4836,1485,334,1640,761,77,11,14,155,427,21,227,0,0
4837,1493,333,1642,745,77,11,14,149,412,22,227,0,0
4838,1504,330,1649,731,77,11,14,145,401,23,227,0,0
4839,1513,324,1654,715,77,11,14,141,391,24,227,0,0
4840,1516,321,1656,709,77,11,14,140,388,25,227,0,0
4841,1516,317,1655,703,77,11,14,139,386,26,227,0,0
4842,1510,312,1648,699,77,11,14,138,387,27,227,0,0
4843,1504,306,1637,680,77,11,14,133,374,28,227,0,0
4844,1503,303,1629,661,77,11,14,126,358,29,227,0,0
4845,1501,297,1628,659,77,11,14,127,362,30,227,0,0
4846,1507,299,1634,659,77,11,14,127,360,31,227,0,0
4847,1517,293,1643,651,77,11,14,126,358,32,227,0,0
4848,1524,290,1648,640,77,11,14,124,350,33,227,0,0
4849,1528,288,1651,635,77,11,14,123,347,34,227,0,0
4850,1528,287,1651,634,77,11,14,123,347,35,227,0,0
4851,1527,284,1648,629,77,11,14,121,345,36,227,0,0
4852,1522,282,1640,621,77,11,14,118,339,37,227,0,0
4853,1518,277,1634,611,77,11,14,116,334,38,227,0,0
4854,1520,277,1634,604,77,11,14,114,327,39,227,0,0
4855,1526,274,1640,603,77,11,14,114,329,40,227,0,0
4856,1534,271,1648,601,77,11,14,114,330,41,227,0,0
4857,1540,270,1655,598,77,11,14,115,328,42,227,0,0
4858,1546,271,1660,598,77,11,14,114,327,43,227,0,0
4859,1551,272,1664,600,77,11,14,113,328,44,227,0,0
4860,1554,272,1666,601,77,11,14,112,329,45,227,0,0
4861,1556,274,1667,600,77,11,14,111,326,46,227,0,0
4862,1558,276,1668,601,77,11,14,110,325,47,227,0,0
4863,1558,277,1668,601,77,11,14,110,324,48,227,0,0
4864,1560,277,1670,605,77,11,14,110,328,49,227,0,0
4865,1563,279,1672,605,77,11,14,109,326,50,227,0,0
4866,1565,279,1674,603,77,11,14,109,324,51,227,0,0
4867,1566,278,1674,602,77,11,14,108,324,52,227,0,0
4868,1566,278,1674,602,77,11,14,108,324,53,227,0,0
4869,1566,278,1674,602,77,11,14,108,324,54,227,0,0
4870,1566,279,1674,603,77,11,14,108,324,55,227,0,0
4871,1566,280,1673,603,77,11,14,107,323,56,227,0,0
4872,1565,281,1672,603,77,11,14,107,322,57,227,0,0
4873,1565,282,1671,603,77,11,14,106,321,58,227,0,0
4874,1565,283,1671,603,77,11,14,106,320,59,227,0,0
4875,1565,284,1670,603,77,11,14,105,319,60,227,0,0
4876,1564,282,1671,605,77,11,14,107,323,61,227,0,0
4877,1564,281,1671,605,77,11,14,107,324,62,227,0,0
4878,1564,281,1671,605,77,11,14,107,324,63,227,0,0
4879,1564,281,1671,604,77,11,14,107,323,64,227,0,0
4880,1564,281,1671,604,77,11,14,107,323,65,227,0,0
4881,1564,281,1672,605,77,11,14,108,324,66,227,0,0
4882,1564,281,1672,605,77,11,14,108,324,67,227,0,0
4883,1564,280,1672,605,77,11,14,108,325,68,227,0,0
4884,1563,280,1671,605,77,11,14,108,325,69,227,0,0
4885,1563,280,1672,605,77,11,14,109,325,70,227,0,0
4886,1563,282,1671,606,77,11,14,108,324,71,227,0,0
4887,1563,282,1671,606,77,11,14,108,324,72,227,0,0
4888,1564,282,1671,606,77,11,14,107,324,73,227,0,0
4889,1564,283,1671,606,77,11,14,107,323,74,227,0,0
4890,1564,283,1671,606,77,11,14,107,323,75,227,0,0
4891,1563,281,1670,606,77,11,14,107,325,76,227,0,0
4892,1563,281,1670,606,77,11,14,107,325,77,227,0,0
4893,1562,280,1671,607,77,11,14,109,327,78,227,0,0
4894,1562,280,1671,607,77,11,14,109,327,79,227,0,0
4895,1563,281,1670,607,77,11,14,107,326,80,227,0,0
4896,1563,280,1670,607,77,11,14,107,327,81,227,0,0
4897,1563,280,1670,607,77,11,14,107,327,82,227,0,0
4898,1563,280,1670,606,77,11,14,107,326,83,227,0,0
4899,1563,280,1670,606,77,11,14,107,326,84,227,0,0
4900,1564,280,1670,606,77,11,14,106,326,85,227,0,0
4901,1564,280,1671,605,77,11,14,107,325,86,227,0,0
4902,1565,280,1671,605,77,11,14,106,325,87,227,0,0
4903,1564,280,1672,605,77,11,14,108,325,88,227,0,0
4904,1564,280,1671,606,77,11,14,107,326,89,227,0,0
4905,1564,281,1671,606,77,11,14,107,325,90,227,0,0
4906,1564,282,1670,606,77,11,14,106,324,91,227,0,0
4907,1564,283,1670,606,77,11,14,106,323,92,227,0,0
4908,1564,281,1671,606,77,11,14,107,325,93,227,0,0
4909,1564,280,1671,606,77,11,14,107,326,94,227,0,0
4910,1563,277,1672,607,77,11,14,109,330,95,227,0,0
4911,1562,275,1671,609,77,11,14,109,334,96,227,0,0
4912,1561,274,1670,609,77,11,14,109,335,97,227,0,0
4913,1560,275,1669,608,77,11,14,109,333,98,227,0,0
4914,1562,278,1669,606,77,11,14,107,328,99,227,0,0
4915,1561,278,1668,604,77,11,14,107,326,100,227,0,0
4916,1562,280,1668,604,77,11,14,106,324,101,227,0,0
4917,1564,278,1669,600,77,11,14,105,322,102,227,0,0
4918,1563,274,1669,599,77,11,14,106,325,103,227,0,0
4919,1563,273,1669,600,77,11,14,106,327,104,227,0,0
4920,1562,272,1668,601,77,11,14,106,329,105,227,0,0
4921,1561,275,1666,601,77,11,14,105,326,106,227,0,0
4922,1562,276,1665,601,77,11,14,103,325,107,227,0,0
4923,1560,275,1663,602,77,11,14,103,327,108,227,0,0
4924,1562,274,1663,597,77,11,14,101,323,109,227,0,0
4925,1566,276,1665,594,77,11,14,99,318,110,227,0,0
4926,1569,280,1667,591,77,11,14,98,311,111,227,0,0
4927,1569,278,1669,592,77,11,14,100,314,112,227,0,0
4928,1570,270,1673,597,77,11,14,103,327,113,227,0,0
4929,1572,269,1676,597,77,11,14,104,328,114,227,0,0
4930,1572,270,1677,598,77,11,14,105,328,115,227,0,0
4931,1574,271,1677,597,77,11,14,103,326,116,227,0,0
4932,1574,271,1677,596,77,11,14,103,325,117,227,0,0
4933,1574,272,1677,595,77,11,14,103,323,118,227,0,0
4934,1575,272,1676,592,77,11,14,101,320,119,227,0,0
4935,1574,275,1674,590,77,11,14,100,315,120,227,0,0
4936,1573,277,1673,592,77,11,14,100,315,121,227,0,0
4937,1573,274,1674,593,77,11,14,101,319,122,227,0,0
4938,1572,274,1674,593,77,11,14,102,319,123,227,0,0
4939,1572,274,1674,593,77,11,14,102,319,124,227,0,0
4940,1571,275,1674,593,77,11,14,103,318,125,227,0,0
4941,1571,275,1674,594,77,11,14,103,319,126,227,0,0
4942,1570,277,1673,594,77,11,14,103,317,127,227,0,0
4943,1570,277,1673,594,77,11,14,103,317,128,227,0,0
4944,1570,278,1673,593,77,11,14,103,315,129,227,0,0
4945,1570,278,1673,593,77,11,14,103,315,130,227,0,0
4946,1570,283,1672,593,77,11,14,102,310,131,227,0,0
4947,1570,282,1672,592,77,11,14,102,310,132,227,0,0
4948,1569,279,1672,592,77,11,14,103,313,133,227,0,0
4949,1570,279,1672,591,77,11,14,102,312,134,227,0,0
4950,1570,278,1673,592,77,11,14,103,314,135,227,0,0
4951,1570,294,1669,590,77,11,14,99,296,136,227,0,0
4952,1571,300,1667,590,77,11,14,96,290,137,227,0,0
4953,1570,298,1668,591,77,11,14,98,293,138,227,0,0
4954,1570,297,1669,591,77,11,14,99,294,139,227,0,0
4955,1570,302,1668,590,77,11,14,98,288,140,227,0,0
4956,1570,295,1670,590,77,11,14,100,295,141,227,0,0
4957,1570,292,1671,590,77,11,14,101,298,142,227,0,0
4958,1570,297,1670,589,77,11,14,100,292,143,227,0,0
4959,1571,305,1668,589,77,11,14,97,284,144,227,0,0
4960,1571,307,1668,589,77,11,14,97,282,145,227,0,0
4961,1568,287,1672,591,77,11,14,104,304,146,227,0,0
4962,1567,283,1672,591,77,11,14,105,308,147,227,0,0
4963,1567,280,1674,593,77,11,14,107,313,148,227,0,0
4964,1566,280,1674,594,77,11,14,108,314,149,227,0,0
4965,1567,283,1673,594,77,11,14,106,311,150,227,0,0
4966,1567,280,1673,592,77,11,14,106,312,151,227,0,0
4967,1567,287,1671,590,77,11,14,104,303,152,227,0,0
4968,1569,307,1666,590,77,11,14,97,283,153,227,0,0
4969,1569,308,1666,590,77,11,14,97,282,154,227,0,0
4970,1568,304,1667,590,77,11,14,99,286,155,227,0,0
4971,1568,302,1668,589,77,11,14,100,287,156,227,0,0
4972,1569,304,1668,589,77,11,14,99,285,157,227,0,0
4973,1569,302,1669,588,77,11,14,100,286,158,227,0,0
4974,1568,295,1670,589,77,11,14,102,294,159,227,0,0
4975,1569,288,1674,590,77,11,14,105,302,160,227,0,0
4976,1568,281,1675,593,77,11,14,107,312,161,227,0,0
4977,1568,279,1676,593,77,11,14,108,314,162,227,0,0
4978,1568,280,1675,592,77,11,14,107,312,163,227,0,0
4979,1568,286,1672,592,77,11,14,104,306,164,227,0,0
4980,1568,290,1672,591,77,11,14,104,301,165,227,0,0
4981,1569,292,1671,591,77,11,14,102,299,166,227,0,0
4982,1569,294,1671,589,77,11,14,102,295,167,227,0,0
4983,1571,307,1668,589,77,11,14,97,282,168,227,0,0
4984,1568,296,1670,589,77,11,14,102,293,169,227,0,0
4985,1567,285,1673,593,77,11,14,106,308,170,227,0,0
4986,1567,295,1670,592,77,11,14,103,297,171,227,0,0
4987,1566,293,1670,591,77,11,14,104,298,172,227,0,0
4988,1566,289,1670,591,77,11,14,104,302,173,227,0,0
4989,1567,284,1673,593,77,11,14,106,309,174,227,0,0
4990,1567,281,1674,592,77,11,14,107,311,175,227,0,0
4991,1568,281,1674,592,77,11,14,106,311,176,227,0,0
4992,1569,282,1675,592,77,11,14,106,310,177,227,0,0
4993,1568,282,1674,592,77,11,14,106,310,178,227,0,0
4994,1569,281,1675,592,77,11,14,106,311,179,227,0,0
4995,1568,282,1674,593,77,11,14,106,311,180,227,0,0
4996,1568,282,1674,593,77,11,14,106,311,181,227,0,0
4997,1567,280,1674,594,77,11,14,107,314,182,227,0,0
4998,1568,280,1674,594,77,11,14,106,314,183,227,0,0
4999,1568,282,1674,594,77,11,14,106,312,184,227,0,0
5000,1568,280,1674,594,77,11,14,106,314,185,227,0,0
5001,1568,290,1670,591,77,11,14,102,301,186,227,0,0
5002,1568,289,1670,588,77,11,14,102,299,187,227,0,0
5003,1568,285,1670,587,77,11,14,102,302,188,227,0,0
5004,1569,286,1671,589,77,11,14,102,303,189,227,0,0
5005,1569,282,1673,589,77,11,14,104,307,190,227,0,0
5006,1569,281,1673,591,77,11,14,104,310,191,227,0,0
5007,1567,280,1672,592,77,11,14,105,312,192,227,0,0
5008,1568,273,1676,594,77,11,14,108,321,193,227,0,0
5009,1567,269,1676,595,77,11,14,109,326,194,227,0,0
5010,1570,269,1678,592,77,11,14,108,323,195,227,0,0
5011,1581,266,1685,589,77,11,14,104,323,196,227,0,0
5012,1585,261,1688,588,77,11,14,103,327,197,227,0,0
5013,1589,267,1686,586,77,11,14,97,319,198,227,0,0
5014,1590,271,1684,587,77,11,14,94,316,199,227,0,0
5015,1590,271,1683,588,77,11,14,93,317,200,227,0,0
5016,1591,276,1681,589,77,11,14,90,313,201,227,0,0
5017,1592,278,1680,589,77,11,14,88,311,202,227,0,0
5018,1593,278,1679,589,77,11,14,86,311,203,227,0,0
5019,1595,286,1677,588,77,11,14,82,302,204,227,0,0
5020,1595,291,1675,587,77,11,14,80,296,205,227,0,0
5021,1595,282,1677,588,77,11,14,82,306,206,227,0,0
5022,1595,282,1676,588,77,11,14,81,306,207,227,0,0
5023,1595,275,1677,590,77,11,14,82,315,208,227,0,0
5024,1594,275,1676,592,77,11,14,82,317,209,227,0,0
5025,1593,277,1674,590,77,11,14,81,313,210,227,0,0
5026,1591,285,1670,590,77,11,14,79,305,211,227,0,0
5027,1590,280,1669,588,77,11,14,79,308,212,227,0,0
5028,1588,275,1670,593,77,11,14,82,318,213,227,0,0
5029,1588,273,1670,595,77,11,14,82,322,214,227,0,0
5030,1588,273,1670,595,77,11,14,82,322,215,227,0,0
5031,1589,273,1671,593,77,11,14,82,320,216,227,0,0
5032,1590,274,1671,593,77,11,14,81,319,217,227,0,0
5033,1591,276,1670,593,77,11,14,79,317,218,227,0,0
5034,1592,276,1672,594,77,11,14,80,318,219,227,0,0
5035,1595,281,1672,589,77,11,14,77,308,220,227,0,0
5036,1595,279,1672,587,77,11,14,77,308,221,227,0,0
5037,1596,282,1671,585,77,11,14,75,303,222,227,0,0
5038,1595,286,1669,585,77,11,14,74,299,223,227,0,0
5039,1593,287,1668,584,77,11,14,75,297,224,227,0,0
5040,1592,286,1667,582,77,11,14,75,296,225,227,0,0
5041,1591,286,1666,578,77,11,14,75,292,226,227,0,0
5042,1591,286,1665,577,77,11,14,74,291,227,227,1,0
5044,1590,276,1667,577,77,11,14,77,301,0,227,0,0
5045,1590,274,1668,579,77,11,14,78,305,1,227,0,0
5046,1589,274,1667,582,77,11,14,78,308,2,227,0,0
5047,1588,272,1668,584,77,11,14,80,312,3,227,0,0
5048,1587,271,1668,585,77,11,14,81,314,4,227,0,0
5049,1588,271,1668,585,77,11,14,80,314,5,227,0,0
5050,1588,272,1668,584,77,11,14,80,312,6,227,0,0
5051,1587,271,1668,584,77,11,14,81,313,7,227,0,0
5052,1588,270,1667,577,77,11,14,79,307,8,227,0,0
5053,1588,269,1667,577,77,11,14,79,308,9,227,0,0
5055,1589,271,1667,575,77,11,14,78,304,0,227,0,0
5056,1589,271,1667,575,77,11,14,78,304,1,227,0,0
5061,1591,276,1668,577,77,11,14,77,301,0,227,0,1
5062,1591,276,1668,577,77,11,14,77,301,1,227,0,0
5063,1591,275,1668,579,77,11,14,77,304,2,227,0,0
5064,1591,274,1669,580,77,11,14,78,306,3,227,0,0
5065,1591,274,1669,580,77,11,14,78,306,4,227,0,0
5066,1591,274,1668,578,77,11,14,77,304,5,227,0,0
5067,1591,276,1667,578,77,11,14,76,302,6,227,0,0
5068,1590,276,1667,579,77,11,14,77,303,7,227,0,0
5069,1591,277,1669,587,77,11,14,78,310,8,227,0,0
5070,1590,276,1667,582,77,11,14,77,306,9,227,0,0
5071,1591,273,1668,582,77,11,14,77,309,10,227,0,0
5072,1590,272,1668,582,77,11,14,78,310,11,227,0,0
5073,1591,272,1668,582,77,11,14,77,310,12,227,0,0
5074,1590,272,1668,583,77,11,14,78,311,13,227,0,0
5075,1591,272,1668,583,77,11,14,77,311,14,227,0,0
5076,1590,272,1668,583,77,11,14,78,311,15,227,0,0
5077,1590,271,1668,584,77,11,14,78,313,16,227,0,0
5078,1591,271,1668,579,77,11,14,77,308,17,227,0,0
5079,1590,271,1667,573,77,11,14,77,302,18,227,0,0
5080,1594,276,1665,557,77,11,14,71,281,19,227,0,0
5081,1594,276,1665,554,77,11,14,71,278,20,227,0,0
5082,1593,280,1667,569,77,11,14,74,289,21,227,0,0
5083,1593,278,1669,575,77,11,14,76,297,22,227,0,0
5084,1593,282,1669,580,77,11,14,76,298,23,227,0,0
5085,1595,277,1671,576,77,11,14,76,299,24,227,0,0
5086,1598,274,1672,574,77,11,14,74,300,25,227,0,0
5087,1603,304,1670,574,77,11,14,67,270,26,227,0,0
5088,1600,292,1670,578,77,11,14,70,286,27,227,0,0
5089,1600,273,1675,583,77,11,14,75,310,28,227,0,0
5090,1603,271,1676,580,77,11,14,73,309,29,227,0,0
5091,1605,256,1681,585,77,11,14,76,329,30,227,0,0
5092,1605,257,1679,582,77,11,14,74,325,31,227,0,0
5093,1605,255,1678,581,77,11,14,73,326,32,227,0,0
5094,1606,258,1677,579,77,11,14,71,321,33,227,0,0
5095,1606,262,1676,578,77,11,14,70,316,34,227,0,0
5096,1607,244,1679,580,77,11,14,72,336,35,227,0,0
5097,1606,256,1676,583,77,11,14,70,327,36,227,0,0
5098,1608,258,1677,580,77,11,14,69,322,37,227,0,0
5099,1609,251,1677,579,77,11,14,68,328,38,227,0,0
5100,1608,265,1674,581,77,11,14,66,316,39,227,0,0
5101,1607,268,1673,583,77,11,14,66,315,40,227,0,0
5102,1608,264,1674,583,77,11,14,66,319,41,227,0,0
5103,1608,262,1674,585,77,11,14,66,323,42,227,0,0
5104,1609,268,1673,582,77,11,14,64,314,43,227,0,0
5105,1610,289,1670,578,77,11,14,60,289,44,227,0,0
5106,1611,302,1669,574,77,11,14,58,272,45,227,0,0
5107,1613,288,1671,567,77,11,14,58,279,46,227,0,0
5108,1613,290,1673,575,77,11,14,60,285,47,227,0,0
5109,1617,281,1676,571,77,11,14,59,290,48,227,0,0
5110,1612,288,1670,570,77,11,14,58,282,49,227,0,0
5111,1608,298,1666,573,77,11,14,58,275,50,227,0,0
5112,1608,300,1665,573,77,11,14,57,273,51,227,0,0
4934,1614,281,1673,386,79,11,14,59,105,0,34,0,1
4935,1619,278,1679,385,79,11,14,60,107,1,34,0,0
4936,1619,277,1679,385,79,11,14,60,108,2,34,0,0
4937,1605,279,1680,415,79,11,14,75,136,3,34,0,0
4938,1605,281,1682,422,79,11,14,77,141,4,34,0,0
4939,1601,282,1683,432,79,11,14,82,150,5,34,0,0
4940,1605,283,1681,422,79,11,14,76,139,6,34,0,0
4941,1612,282,1676,401,79,11,14,64,119,7,34,0,0
4942,1608,283,1678,414,79,11,14,70,131,8,34,0,0
4943,1606,286,1681,428,79,11,14,75,142,9,34,0,0
4944,1607,286,1680,428,79,11,14,73,142,10,34,0,0
4945,1613,287,1675,405,79,11,14,62,118,11,34,0,0
4946,1617,283,1673,388,79,11,14,56,105,12,34,0,0
4947,1613,280,1672,390,79,11,14,59,110,13,34,0,0
4948,1610,278,1671,391,79,11,14,61,113,14,34,0,0
4949,1608,280,1670,395,79,11,14,62,115,15,34,0,0
4950,1606,282,1671,401,79,11,14,65,119,16,34,0,0
4951,1608,279,1671,392,79,11,14,63,113,17,34,0,0
4952,1612,276,1671,383,79,11,14,59,107,18,34,0,0
4953,1611,273,1670,380,79,11,14,59,107,19,34,0,0
4954,1609,275,1671,385,79,11,14,62,110,20,34,0,0
4955,1608,274,1670,385,79,11,14,62,111,21,34,0,0
4956,1608,277,1672,391,79,11,14,64,114,22,34,0,0
4957,1608,279,1671,390,79,11,14,63,111,23,34,0,0
4958,1611,279,1672,386,79,11,14,61,107,24,34,0,0
4959,1612,276,1674,385,79,11,14,62,109,25,34,0,0
4960,1612,274,1675,387,79,11,14,63,113,26,34,0,0
4961,1610,275,1673,387,79,11,14,63,112,27,34,0,0
4962,1609,275,1674,390,79,11,14,65,115,28,34,0,0
4963,1612,279,1674,388,79,11,14,62,109,29,34,0,0
4964,1616,281,1677,391,79,11,14,61,110,30,34,0,0
4965,1620,281,1680,391,79,11,14,60,110,31,34,0,0
4966,1623,281,1680,388,79,11,14,57,107,32,34,0,0
4967,1626,282,1679,382,79,11,14,53,100,33,34,0,0
4968,1627,282,1679,381,79,11,14,52,99,34,34,1,0
4973,1626,282,1676,378,79,11,14,50,96,0,34,0,0
4974,1623,282,1675,381,79,11,14,52,99,1,34,0,0
4975,1619,282,1673,386,79,11,14,54,104,2,34,0,0
4976,1619,282,1673,386,79,11,14,54,104,3,34,0,0
4978,1612,285,1672,399,79,11,14,60,114,0,34,0,0
4979,1619,284,1673,387,79,11,14,54,103,1,34,0,0
4980,1622,284,1675,387,79,11,14,53,103,2,34,0,0
4981,1623,283,1676,387,79,11,14,53,104,3,34,0,0
4982,1621,280,1676,389,79,11,14,55,109,4,34,0,0
4983,1621,280,1677,389,79,11,14,56,109,5,34,0,0
4987,1616,282,1668,383,79,11,14,52,101,0,34,0,0
4988,1619,283,1668,376,79,11,14,49,93,1,34,0,0
4989,1619,283,1668,374,79,11,14,49,91,2,34,0,0
4991,1618,283,1671,380,79,11,14,53,97,0,34,0,0
4992,1616,283,1671,384,79,11,14,55,101,1,34,0,0
4993,1617,283,1672,381,79,11,14,55,98,2,34,0,0
4994,1618,282,1673,381,79,11,14,55,99,3,34,0,0
4995,1619,282,1673,379,79,11,14,54,97,4,34,0,0
4996,1618,282,1672,378,79,11,14,54,96,5,34,0,0
4997,1615,282,1672,384,79,11,14,57,102,6,34,0,0
4998,1614,282,1673,385,79,11,14,59,103,7,34,0,0
4999,1613,282,1673,386,79,11,14,60,104,8,34,0,0
5000,1613,282,1673,387,79,11,14,60,105,9,34,0,0
5001,1617,282,1669,371,79,11,14,52,89,10,34,0,0
5002,1622,285,1666,357,79,11,14,44,72,11,34,0,0
5003,1617,285,1668,366,79,11,14,51,81,12,34,0,0
5004,1617,282,1672,370,79,11,14,55,88,13,34,0,0
5005,1615,280,1675,378,79,11,14,60,98,14,34,0,0
5006,1614,282,1676,384,79,11,14,62,102,15,34,0,0
5007,1613,282,1677,386,79,11,14,64,104,16,34,0,0
5010,1608,281,1678,397,79,11,14,70,116,0,34,0,0
5011,1610,276,1679,394,79,11,14,69,118,1,34,0,0
5012,1609,275,1680,396,79,11,14,71,121,2,34,0,0
5013,1612,278,1678,393,79,11,14,66,115,3,34,0,0
5014,1613,279,1677,392,79,11,14,64,113,4,34,0,0
5015,1613,278,1677,391,79,11,14,64,113,5,34,0,0
5016,1614,278,1677,390,79,11,14,63,112,6,34,0,0
5017,1614,279,1677,392,79,11,14,63,113,7,34,0,0
5018,1615,280,1676,391,79,11,14,61,111,8,34,0,0
5019,1617,280,1676,385,79,11,14,59,105,9,34,0,0
5020,1617,280,1676,385,79,11,14,59,105,10,34,0,0
5021,1614,280,1676,391,79,11,14,62,111,11,34,0,0
5022,1613,276,1675,389,79,11,14,62,113,12,34,0,0
5023,1610,276,1673,390,79,11,14,63,114,13,34,0,0
5024,1608,277,1672,393,79,11,14,64,116,14,34,0,0
5025,1608,276,1672,394,79,11,14,64,118,15,34,0,0
5058,1594,276,1671,377,81,11,14,77,101,0,11,0,0
5059,1593,276,1671,377,81,11,14,78,101,1,11,0,0
5060,1588,274,1672,385,81,11,14,84,111,2,11,0,0
5061,1592,273,1672,378,81,11,14,80,105,3,11,0,0
5062,1594,273,1671,375,81,11,14,77,102,4,11,0,0
5063,1596,273,1670,371,81,11,14,74,98,5,11,0,0
5064,1597,273,1670,370,81,11,14,73,97,6,11,0,0
5065,1596,275,1671,374,81,11,14,75,99,7,11,0,0
5066,1598,276,1669,372,81,11,14,71,96,8,11,0,0
5067,1598,276,1666,366,81,11,14,68,90,9,11,0,0
5068,1598,276,1667,367,81,11,14,69,91,10,11,0,0
5069,1599,277,1667,366,81,11,14,68,89,11,11,0,0
5081,1594,274,1671,375,81,11,14,77,101,0,11,0,0
5082,1594,273,1671,376,81,11,14,77,103,1,11,0,0
5062,773,658,979,1032,82,11,14,206,374,0,47,0,1
5063,745,631,985,1066,82,11,14,240,435,1,47,0,0
5064,783,608,1042,1078,82,11,14,259,470,2,47,0,0
5065,838,573,1113,1075,82,11,14,275,502,3,47,0,0
5066,863,537,1155,1072,82,11,14,292,535,4,47,0,0
5067,872,515,1166,1053,82,11,14,294,538,5,47,0,0
5068,876,496,1168,1026,82,11,14,292,530,6,47,0,0
5069,934,466,1250,1058,82,11,14,316,592,7,47,0,0
5070,988,456,1295,1045,82,11,14,307,589,8,47,0,0
5071,1028,456,1316,1025,82,11,14,288,569,9,47,0,0
5072,1062,446,1335,998,82,11,14,273,552,10,47,0,0
5073,1088,441,1352,990,82,11,14,264,549,11,47,0,0
5074,1108,450,1359,984,82,11,14,251,534,12,47,0,0
5075,1134,416,1371,929,82,11,14,237,513,13,47,0,0
5076,1180,402,1374,824,82,11,14,194,422,14,47,0,0
5077,1209,411,1390,808,82,11,14,181,397,15,47,0,0
5078,1237,397,1446,867,82,11,14,209,470,16,47,0,0
5079,1276,378,1476,843,82,11,14,200,465,17,47,0,0
5080,1301,357,1492,812,82,11,14,191,455,18,47,0,0
5081,1309,355,1501,822,82,11,14,192,467,19,47,0,0
5082,1325,348,1493,762,82,11,14,168,414,20,47,0,0
5083,1327,326,1493,748,82,11,14,166,422,21,47,0,0
5084,1341,329,1492,717,82,11,14,151,388,22,47,0,0
5085,1346,325,1497,722,82,11,14,151,397,23,47,0,0
5086,1353,313,1494,691,82,11,14,141,378,24,47,0,0
5087,1365,315,1485,643,82,11,14,120,328,25,47,0,0
5088,1359,314,1477,647,82,11,14,118,333,26,47,0,0
5089,1365,293,1463,581,82,11,14,98,288,27,47,0,0
5090,1368,291,1463,572,82,11,14,95,281,28,47,0,0
5091,1371,287,1468,582,82,11,14,97,295,29,47,0,0
5092,1371,280,1468,584,82,11,14,97,304,30,47,0,0
5093,1372,274,1468,588,82,11,14,96,314,31,47,0,0
5094,1378,267,1473,577,82,11,14,95,310,32,47,0,0
5105,1408,242,1468,448,82,11,14,60,206,0,47,0,1
5106,1412,238,1467,432,82,11,14,55,194,1,47,0,0
5107,1416,234,1469,430,82,11,14,53,196,2,47,0,0
5108,1422,236,1474,432,82,11,14,52,196,3,47,0,0
5109,1430,236,1481,426,82,11,14,51,190,4,47,0,0
5110,1437,231,1489,427,82,11,14,52,196,5,47,0,0
5111,1443,229,1495,423,82,11,14,52,194,6,47,0,0
5112,1444,227,1494,414,82,11,14,50,187,7,47,0,0
5113,1447,221,1497,407,82,11,14,50,186,8,47,0,0
5114,1453,220,1503,404,82,11,14,50,184,9,47,0,0
5115,1459,220,1509,401,82,11,14,50,181,10,47,0,0
5116,1464,216,1513,394,82,11,14,49,178,11,47,0,0
5117,1466,215,1516,392,82,11,14,50,177,12,47,0,0
5118,1468,215,1516,387,82,11,14,48,172,13,47,0,0
5119,1470,212,1518,383,82,11,14,48,171,14,47,0,0
5120,1473,215,1521,378,82,11,14,48,163,15,47,0,0
5121,1480,213,1527,375,82,11,14,47,162,16,47,0,0
5122,1485,211,1532,374,82,11,14,47,163,17,47,0,0
5123,1488,211,1533,372,82,11,14,45,161,18,47,0,0
5124,1489,211,1533,367,82,11,14,44,156,19,47,0,0
5125,1492,208,1536,366,82,11,14,44,158,20,47,0,0
5126,1494,207,1538,362,82,11,14,44,155,21,47,0,0
5127,1498,207,1541,359,82,11,14,43,152,22,47,0,0
5128,1501,206,1544,355,82,11,14,43,149,23,47,0,0
5129,1505,201,1548,353,82,11,14,43,152,24,47,0,0
5130,1508,200,1551,351,82,11,14,43,151,25,47,0,0
5131,1509,198,1551,345,82,11,14,42,147,26,47,0,0
5132,1509,195,1551,343,82,11,14,42,148,27,47,0,0
5133,1512,195,1553,339,82,11,14,41,144,28,47,0,0
5134,1514,194,1554,335,82,11,14,40,141,29,47,0,0
5135,1515,193,1554,332,82,11,14,39,139,30,47,0,0
5136,1517,192,1555,326,82,11,14,38,134,31,47,0,0
5137,1519,191,1556,324,82,11,14,37,133,32,47,0,0
5138,1520,189,1558,324,82,11,14,38,135,33,47,0,0
5139,1522,188,1559,322,82,11,14,37,134,34,47,0,0
5140,1522,184,1560,320,82,11,14,38,136,35,47,0,0
5141,1524,184,1561,318,82,11,14,37,134,36,47,0,0
5142,1524,183,1562,316,82,11,14,38,133,37,47,0,0
5143,1526,182,1565,317,82,11,14,39,135,38,47,0,0
5144,1530,185,1568,315,82,11,14,38,130,39,47,0,0
5145,1532,184,1569,312,82,11,14,37,128,40,47,0,0
5146,1533,184,1570,310,82,11,14,37,126,41,47,0,0
5147,1534,183,1571,306,82,11,14,37,123,42,47,0,0
5148,1536,183,1572,304,82,11,14,36,121,43,47,0,0
5149,1539,182,1575,301,82,11,14,36,119,44,47,0,0
5150,1540,181,1575,299,82,11,14,35,118,45,47,0,0
5151,1541,180,1576,295,82,11,14,35,115,46,47,0,0
5152,1542,179,1577,293,82,11,14,35,114,47,47,1,0
5074,1636,779,1920,1074,83,11,14,284,295,0,64,0,0
5075,1624,757,1920,1075,83,11,14,296,318,1,64,0,0
5076,1597,737,1920,1074,83,11,14,323,337,2,64,0,0
5079,1396,643,1813,1073,83,11,14,417,430,0,64,0,1
5080,1358,607,1784,1068,83,11,14,426,461,1,64,0,0
5081,1321,581,1752,1068,83,11,14,431,487,2,64,0,0
5082,1288,551,1720,1066,83,11,14,432,515,3,64,0,0
5083,1272,521,1689,1044,83,11,14,417,523,4,64,0,0
5084,1260,491,1656,1015,83,11,14,396,524,5,64,0,0
5085,1278,453,1640,957,83,11,14,362,504,6,64,0,0
5086,1298,434,1634,927,83,11,14,336,493,7,64,0,0
5087,1315,432,1621,900,83,11,14,306,468,8,64,0,0
5088,1330,412,1597,839,83,11,14,267,427,9,64,0,0
5089,1335,396,1584,810,83,11,14,249,414,10,64,0,0
5090,1353,383,1580,775,83,11,14,227,392,11,64,0,0
5091,1371,364,1581,741,83,11,14,210,377,12,64,0,0
5092,1386,356,1585,725,83,11,14,199,369,13,64,0,0
5093,1394,342,1576,691,83,11,14,182,349,14,64,0,0
5094,1398,332,1566,665,83,11,14,168,333,15,64,0,0
5095,1407,321,1567,650,83,11,14,160,329,16,64,0,0
5096,1423,310,1572,627,83,11,14,149,317,17,64,0,0
5097,1439,308,1582,614,83,11,14,143,306,18,64,0,0
5098,1444,297,1582,595,83,11,14,138,298,19,64,0,0
5099,1444,286,1576,579,83,11,14,132,293,20,64,0,0
5100,1455,292,1577,569,83,11,14,122,277,21,64,0,0
5101,1472,285,1587,554,83,11,14,115,269,22,64,0,0
5102,1486,282,1595,542,83,11,14,109,260,23,64,0,0
5103,1496,278,1603,537,83,11,14,107,259,24,64,0,0
5104,1505,274,1602,517,83,11,14,97,243,25,64,0,0
5105,1514,271,1605,505,83,11,14,91,234,26,64,0,0
5106,1525,268,1613,497,83,11,14,88,229,27,64,0,0
5107,1535,264,1620,489,83,11,14,85,225,28,64,0,0
5108,1541,263,1622,481,83,11,14,81,218,29,64,0,0
5109,1545,256,1624,471,83,11,14,79,215,30,64,0,0
5110,1549,256,1625,464,83,11,14,76,208,31,64,0,0
5111,1556,254,1630,458,83,11,14,74,204,32,64,0,0
5112,1560,246,1635,452,83,11,14,75,206,33,64,0,0
5113,1565,246,1637,447,83,11,14,72,201,34,64,0,0
5114,1565,242,1633,435,83,11,14,68,193,35,64,0,0
5115,1563,239,1631,431,83,11,14,68,192,36,64,0,0
5116,1567,239,1632,427,83,11,14,65,188,37,64,0,0
5117,1571,234,1634,417,83,11,14,63,183,38,64,0,0
5118,1574,235,1635,412,83,11,14,61,177,39,64,0,0
5119,1573,234,1633,407,83,11,14,60,173,40,64,0,0
5120,1570,232,1627,397,83,11,14,57,165,41,64,0,0
5121,1571,231,1626,393,83,11,14,55,162,42,64,0,0
5122,1575,226,1630,385,83,11,14,55,159,43,64,0,0
5123,1579,223,1632,380,83,11,14,53,157,44,64,0,0
5124,1580,222,1633,379,83,11,14,53,157,45,64,0,0
5125,1579,219,1631,373,83,11,14,52,154,46,64,0,0
5126,1580,217,1631,368,83,11,14,51,151,47,64,0,0
5127,1582,217,1632,364,83,11,14,50,147,48,64,0,0
5128,1586,215,1635,359,83,11,14,49,144,49,64,0,0
5129,1587,215,1634,355,83,11,14,47,140,50,64,0,0
5130,1585,213,1632,353,83,11,14,47,140,51,64,0,0
5131,1587,209,1633,346,83,11,14,46,137,52,64,0,0
5132,1589,210,1633,343,83,11,14,44,133,53,64,0,0
5133,1591,204,1636,339,83,11,14,45,135,54,64,0,0
5134,1592,209,1635,339,83,11,14,43,130,55,64,0,0
5135,1592,208,1635,336,83,11,14,43,128,56,64,0,0
5136,1593,203,1635,332,83,11,14,42,129,57,64,0,0
5137,1595,203,1635,327,83,11,14,40,124,58,64,0,0
5138,1597,203,1637,327,83,11,14,40,124,59,64,0,0
5139,1601,202,1640,323,83,11,14,39,121,60,64,0,0
5140,1604,202,1643,321,83,11,14,39,119,61,64,0,0
5141,1606,201,1644,319,83,11,14,38,118,62,64,0,0
5142,1606,198,1645,319,83,11,14,39,121,63,64,0,0
5143,1610,199,1645,306,83,11,14,35,107,64,64,1,0
5153,1613,188,1648,292,83,11,14,35,104,0,64,0,0
5154,1614,187,1649,294,83,11,14,35,107,1,64,0,0
5155,1615,185,1650,290,83,11,14,35,105,2,64,0,0
5078,1009,586,1478,1067,84,11,14,469,481,0,3,0,0
5079,993,525,1500,1068,84,11,14,507,543,1,3,0,0
5080,984,483,1510,1071,84,11,14,526,588,2,3,0,0
5081,937,442,1498,1071,84,11,14,561,629,3,3,0,0
5081,1187,471,1365,1000,85,11,14,178,529,0,75,0,1
5082,1199,440,1380,980,85,11,14,181,540,1,75,0,0
5083,1223,365,1428,978,85,11,14,205,613,2,75,0,0
5084,1231,384,1409,918,85,11,14,178,534,3,75,0,0
5085,1245,389,1407,878,85,11,14,162,489,4,75,0,0
5086,1256,356,1415,841,85,11,14,159,485,5,75,0,0
5087,1268,334,1418,797,85,11,14,150,463,6,75,0,0
5088,1279,306,1434,785,85,11,14,155,479,7,75,0,0
5089,1285,294,1430,748,85,11,14,145,454,8,75,0,0
5090,1291,296,1426,724,85,11,14,135,428,9,75,0,0
5091,1297,303,1419,694,85,11,14,122,391,10,75,0,0
5092,1302,291,1419,668,85,11,14,117,377,11,75,0,0
5093,1311,278,1428,660,85,11,14,117,382,12,75,0,0
5094,1328,263,1441,636,85,11,14,113,373,13,75,0,0
5095,1335,255,1446,622,85,11,14,111,367,14,75,0,0
5096,1343,255,1448,604,85,11,14,105,349,15,75,0,0
5097,1355,254,1454,586,85,11,14,99,332,16,75,0,0
5098,1368,249,1465,577,85,11,14,97,328,17,75,0,0
5099,1379,249,1469,558,85,11,14,90,309,18,75,0,0
5100,1388,251,1473,546,85,11,14,85,295,19,75,0,0
5101,1392,243,1479,546,85,11,14,87,303,20,75,0,0
5102,1401,244,1481,524,85,11,14,80,280,21,75,0,0
5103,1407,240,1487,518,85,11,14,80,278,22,75,0,0
5104,1415,238,1493,505,85,11,14,78,267,23,75,0,0
5105,1427,238,1501,493,85,11,14,74,255,24,75,0,0
5106,1436,237,1508,488,85,11,14,72,251,25,75,0,0
5107,1447,234,1518,484,85,11,14,71,250,26,75,0,0
5108,1457,235,1525,474,85,11,14,68,239,27,75,0,0
5109,1465,234,1532,470,85,11,14,67,236,28,75,0,0
5110,1476,232,1540,462,85,11,14,64,230,29,75,0,0
5111,1485,231,1547,458,85,11,14,62,227,30,75,0,0
5112,1490,230,1549,447,85,11,14,59,217,31,75,0,0
5113,1494,229,1552,441,85,11,14,58,212,32,75,0,0
5114,1499,229,1556,441,85,11,14,57,212,33,75,0,0
5115,1504,224,1561,435,85,11,14,57,211,34,75,0,0
5116,1507,223,1561,427,85,11,14,54,204,35,75,0,0
5117,1509,224,1561,421,85,11,14,52,197,36,75,0,0
5118,1511,227,1560,412,85,11,14,49,185,37,75,0,0
5119,1514,222,1563,411,85,11,14,49,189,38,75,0,0
5120,1518,220,1566,404,85,11,14,48,184,39,75,0,0
5121,1521,214,1569,399,85,11,14,48,185,40,75,0,0
5122,1523,212,1570,394,85,11,14,47,182,41,75,0,0
5123,1522,206,1569,389,85,11,14,47,183,42,75,0,0
5124,1524,207,1570,384,85,11,14,46,177,43,75,0,0
5125,1526,205,1572,380,85,11,14,46,175,44,75,0,0
5126,1530,204,1574,374,85,11,14,44,170,45,75,0,0
5127,1534,206,1575,363,85,11,14,41,157,46,75,0,0
5128,1537,205,1576,357,85,11,14,39,152,47,75,0,0
5129,1541,201,1581,357,85,11,14,40,156,48,75,0,0
5130,1545,206,1584,357,85,11,14,39,151,49,75,0,0
5131,1549,203,1588,354,85,11,14,39,151,50,75,0,0
5132,1552,200,1590,348,85,11,14,38,148,51,75,0,0
5133,1554,196,1592,344,85,11,14,38,148,52,75,0,0
5134,1554,196,1591,343,85,11,14,37,147,53,75,0,0
5135,1556,198,1592,341,85,11,14,36,143,54,75,0,0
5136,1558,198,1595,339,85,11,14,37,141,55,75,0,0
5137,1559,197,1595,334,85,11,14,36,137,56,75,0,0
5139,1561,196,1597,329,85,11,14,36,133,0,75,0,0
5140,1562,193,1598,326,85,11,14,36,133,1,75,0,0
5141,1564,193,1600,324,85,11,14,36,131,2,75,0,0
5142,1565,188,1602,323,85,11,14,37,135,3,75,0,0
5143,1568,188,1604,319,85,11,14,36,131,4,75,0,0
5144,1569,188,1604,315,85,11,14,35,127,5,75,0,0
5145,1571,189,1606,314,85,11,14,35,125,6,75,0,0
5248,1559,198,1594,319,85,11,14,35,121,0,75,0,1
5249,1554,199,1590,322,85,11,14,36,123,1,75,0,0
5250,1550,200,1586,324,85,11,14,36,124,2,75,0,0
5251,1545,203,1583,328,85,11,14,38,125,3,75,0,0
5252,1540,205,1578,329,85,11,14,38,124,4,75,0,0
5253,1535,205,1574,330,85,11,14,39,125,5,75,0,0
5254,1531,205,1571,333,85,11,14,40,128,6,75,0,0
5255,1529,204,1570,336,85,11,14,41,132,7,75,0,0
5256,1528,205,1570,339,85,11,14,42,134,8,75,0,0
5257,1527,210,1568,342,85,11,14,41,132,9,75,0,0
5258,1525,209,1567,342,85,11,14,42,133,10,75,0,0
5259,1523,210,1566,349,85,11,14,43,139,11,75,0,0
5260,1521,210,1565,350,85,11,14,44,140,12,75,0,0
5261,1518,209,1562,353,85,11,14,44,144,13,75,0,0
5262,1513,213,1557,355,85,11,14,44,142,14,75,0,0
5263,1503,214,1550,359,85,11,14,47,145,15,75,0,0
5264,1497,215,1545,363,85,11,14,48,148,16,75,0,0
5265,1495,220,1542,368,85,11,14,47,148,17,75,0,0
5266,1493,221,1541,373,85,11,14,48,152,18,75,0,0
5267,1489,224,1539,380,85,11,14,50,156,19,75,0,0
5268,1489,227,1538,383,85,11,14,49,156,20,75,0,0
5269,1485,228,1536,388,85,11,14,51,160,21,75,0,0
5270,1486,233,1536,394,85,11,14,50,161,22,75,0,0
5271,1485,232,1537,398,85,11,14,52,166,23,75,0,0
5272,1485,234,1538,402,85,11,14,53,168,24,75,0,0
5273,1485,236,1540,410,85,11,14,55,174,25,75,0,0
5274,1483,238,1537,409,85,11,14,54,171,26,75,0,0
5275,1478,238,1536,421,85,11,14,58,183,27,75,0,0
5276,1475,238,1535,426,85,11,14,60,188,28,75,0,0
5277,1471,238,1533,430,85,11,14,62,192,29,75,0,0
5278,1467,242,1530,437,85,11,14,63,195,30,75,0,0
5279,1461,249,1524,445,85,11,14,63,196,31,75,0,0
5280,1452,251,1517,454,85,11,14,65,203,32,75,0,0
5281,1444,254,1511,464,85,11,14,67,210,33,75,0,0
5282,1438,256,1505,469,85,11,14,67,213,34,75,0,0
5283,1431,260,1498,474,85,11,14,67,214,35,75,0,0
5284,1422,263,1491,483,85,11,14,69,220,36,75,0,0
5285,1412,264,1482,485,85,11,14,70,221,37,75,0,0
5286,1406,270,1477,494,85,11,14,71,224,38,75,0,0
5287,1405,278,1476,500,85,11,14,71,222,39,75,0,0
5288,1405,280,1477,505,85,11,14,72,225,40,75,0,0
5289,1401,285,1477,520,85,11,14,76,235,41,75,0,0
5290,1395,287,1474,530,85,11,14,79,243,42,75,0,0
5291,1389,289,1471,540,85,11,14,82,251,43,75,0,0
5292,1387,300,1471,556,85,11,14,84,256,44,75,0,0
5293,1389,301,1475,562,85,11,14,86,261,45,75,0,0
5294,1385,301,1477,578,85,11,14,92,277,46,75,0,0
5295,1383,310,1478,597,85,11,14,95,287,47,75,0,0
5296,1381,316,1477,603,85,11,14,96,287,48,75,0,0
5297,1378,322,1476,618,85,11,14,98,296,49,75,0,0
5298,1375,328,1477,637,85,11,14,102,309,50,75,0,0
5299,1373,330,1477,646,85,11,14,104,316,51,75,0,0
5300,1371,345,1475,657,85,11,14,104,312,52,75,0,0
5301,1361,355,1471,680,85,11,14,110,325,53,75,0,0
5302,1349,358,1466,701,85,11,14,117,343,54,75,0,0
5303,1342,375,1464,731,85,11,14,122,356,55,75,0,0
5304,1341,385,1467,751,85,11,14,126,366,56,75,0,0
5305,1337,398,1467,770,85,11,14,130,372,57,75,0,0
5306,1326,409,1465,803,85,11,14,139,394,58,75,0,0
5307,1314,420,1456,821,85,11,14,142,401,59,75,0,0
5308,1302,435,1451,850,85,11,14,149,415,60,75,0,0
5309,1291,452,1447,883,85,11,14,156,431,61,75,0,0
5310,1284,465,1445,906,85,11,14,161,441,62,75,0,0
5311,1277,485,1445,941,85,11,14,168,456,63,75,0,0
5312,1265,508,1445,995,85,11,14,180,487,64,75,0,0
5313,1252,528,1438,1027,85,11,14,186,499,65,75,0,0
5314,1248,551,1441,1067,85,11,14,193,516,66,75,0,0
5315,1251,570,1445,1080,85,11,14,194,510,67,75,0,0
5316,1251,596,1441,1080,85,11,14,190,484,68,75,0,0
5317,1249,639,1430,1080,85,11,14,181,441,69,75,0,0
5318,1247,677,1421,1080,85,11,14,174,403,70,75,0,0
5319,1240,727,1407,1080,85,11,14,167,353,71,75,0,0
5320,1247,792,1401,1080,85,11,14,154,288,72,75,0,0
5321,1263,861,1396,1076,85,11,14,133,215,73,75,0,0
5322,1260,954,1346,1077,85,11,14,86,123,74,75,0,0
5323,1267,1003,1323,1080,85,11,14,56,77,75,75,1,0
5140,1611,272,1670,582,90,11,14,59,310,0,21,0,1
5141,1608,285,1662,566,90,11,14,54,281,1,21,0,0
5142,1603,287,1657,565,90,11,14,54,278,2,21,0,0
5143,1596,304,1650,570,90,11,14,54,266,3,21,0,0
5144,1592,275,1653,574,90,11,14,61,299,4,21,0,0
5145,1589,273,1652,574,90,11,14,63,301,5,21,0,0
5146,1586,265,1652,571,90,11,14,66,306,6,21,0,0
5147,1585,248,1654,565,90,11,14,69,317,7,21,0,0
5148,1588,264,1656,565,90,11,14,68,301,8,21,0,0
5149,1588,269,1656,566,90,11,14,68,297,9,21,0,0
5150,1588,269,1658,565,90,11,14,70,296,10,21,0,0
5151,1589,266,1660,564,90,11,14,71,298,11,21,0,0
5152,1589,267,1662,562,90,11,14,73,295,12,21,0,0
5153,1589,266,1663,561,90,11,14,74,295,13,21,0,0
5154,1589,267,1663,560,90,11,14,74,293,14,21,0,0
5155,1589,272,1664,561,90,11,14,75,289,15,21,0,0
5156,1589,281,1664,563,90,11,14,75,282,16,21,0,0
5157,1589,287,1663,562,90,11,14,74,275,17,21,0,0
5158,1585,288,1661,565,90,11,14,76,277,18,21,0,0
5159,1584,298,1661,570,90,11,14,77,272,19,21,0,0
5160,1583,316,1658,573,90,11,14,75,257,20,21,0,0
5161,1583,320,1657,574,90,11,14,74,254,21,21,1,0
5168,1557,438,1662,589,95,11,14,105,151,0,8,0,0
5169,1556,433,1664,589,95,11,14,108,156,1,8,0,0
5170,1559,433,1664,586,95,11,14,105,153,2,8,0,0
5171,1558,433,1669,594,95,11,14,111,161,3,8,0,0
5172,1560,436,1669,594,95,11,14,109,158,4,8,0,0
5173,1562,425,1679,596,95,11,14,117,171,5,8,0,0
5174,1569,426,1680,590,95,11,14,111,164,6,8,0,0
5175,1570,428,1680,594,95,11,14,110,166,7,8,0,0
5176,1572,427,1683,595,95,11,14,111,168,8,8,0,0
5218,1,461,66,694,103,11,14,65,233,0,26,0,1
5219,0,442,68,699,103,11,14,68,257,1,26,0,0
5220,0,445,72,707,103,11,14,72,262,2,26,0,0
5221,4,451,80,723,103,11,14,76,272,3,26,0,0
5222,17,454,98,735,103,11,14,81,281,4,26,0,0
5223,29,461,114,751,103,11,14,85,290,5,26,0,0
5224,34,457,127,768,103,11,14,93,311,6,26,0,0
5225,49,467,148,787,103,11,14,99,320,7,26,0,0
5226,54,469,160,806,103,11,14,106,337,8,26,0,0
5227,72,475,184,813,103,11,14,112,338,9,26,0,0
5228,88,477,209,834,103,11,14,121,357,10,26,0,0
5229,98,478,226,846,103,11,14,128,368,11,26,0,0
5230,107,490,245,884,103,11,14,138,394,12,26,0,0
5231,122,502,269,915,103,11,14,147,413,13,26,0,0
5232,141,515,289,924,103,11,14,148,409,14,26,0,0
5233,174,529,333,951,103,11,14,159,422,15,26,0,0
5234,203,534,373,972,103,11,14,170,438,16,26,0,0
5235,227,545,412,1016,103,11,14,185,471,17,26,0,0
5236,264,554,463,1053,103,11,14,199,499,18,26,0,0
5237,295,565,497,1066,103,11,14,202,501,19,26,0,0
5238,359,574,569,1076,103,11,14,210,502,20,26,0,0
5239,411,578,623,1078,103,11,14,212,500,21,26,0,0
5240,462,590,672,1080,103,11,14,210,490,22,26,0,0
5241,538,616,739,1077,103,11,14,201,461,23,26,0,0
5242,616,628,814,1075,103,11,14,198,447,24,26,0,0
5243,708,653,902,1080,103,11,14,194,427,25,26,0,0
5244,752,665,947,1080,103,11,14,195,415,26,26,1,0
5245,985,709,1234,1074,104,11,14,249,365,0,0,0,0
5246,1123,742,1374,1078,105,11,14,251,336,0,0,0,0
5247,1317,768,1524,1072,106,11,14,207,304,0,0,0,0
5248,1488,792,1736,1074,107,11,14,248,282,0,0,0,0
5249,1655,832,1874,1077,108,11,14,219,245,0,0,0,0
5493,2,439,83,703,111,11,14,81,264,0,32,0,1
5494,10,445,89,702,111,11,14,79,257,1,32,0,0
5495,13,442,100,722,111,11,14,87,280,2,32,0,0
5496,23,451,112,734,111,11,14,89,283,3,32,0,0
5497,35,454,127,740,111,11,14,92,286,4,32,0,0
5498,54,455,151,744,111,11,14,97,289,5,32,0,0
5499,73,458,172,748,111,11,14,99,290,6,32,0,0
5500,78,454,184,760,111,11,14,106,306,7,32,0,0
5501,82,457,193,775,111,11,14,111,318,8,32,0,0
5502,90,466,202,783,111,11,14,112,317,9,32,0,0
5503,109,470,228,792,111,11,14,119,322,10,32,0,0
5504,127,477,251,807,111,11,14,124,330,11,32,0,0
5505,134,476,263,816,111,11,14,129,340,12,32,0,0
5506,141,482,279,839,111,11,14,138,357,13,32,0,0
5507,153,489,298,862,111,11,14,145,373,14,32,0,0
5508,177,491,330,870,111,11,14,153,379,15,32,0,0
5509,210,496,374,890,111,11,14,164,394,16,32,0,0
5510,235,498,405,903,111,11,14,170,405,17,32,0,0
5511,248,494,436,943,111,11,14,188,449,18,32,0,0
5512,281,513,472,969,111,11,14,191,456,19,32,0,0
5513,304,517,501,988,111,11,14,197,471,20,32,0,0
5514,358,530,566,1010,111,11,14,208,480,21,32,0,0
5515,404,540,619,1032,111,11,14,215,492,22,32,0,0
5516,429,548,651,1061,111,11,14,222,513,23,32,0,0
5517,479,569,700,1076,111,11,14,221,507,24,32,0,0
5518,531,583,748,1080,111,11,14,217,497,25,32,0,0
5519,599,594,815,1080,111,11,14,216,486,26,32,0,0
5520,690,621,901,1080,111,11,14,211,459,27,32,0,0
5521,781,621,996,1076,111,11,14,215,455,28,32,0,0
5522,873,639,1088,1076,111,11,14,215,437,29,32,0,0
5523,978,673,1186,1080,111,11,14,208,407,30,32,0,0
5524,1073,688,1273,1078,111,11,14,200,390,31,32,0,0
5525,1135,701,1333,1080,111,11,14,198,379,32,32,1,0
5499,0,472,74,765,112,11,14,74,293,0,27,0,1
5500,0,487,68,780,112,11,14,68,293,1,27,0,0
5501,0,495,66,791,112,11,14,66,296,2,27,0,0
5502,0,504,71,823,112,11,14,71,319,3,27,0,0
5503,0,503,73,841,112,11,14,73,338,4,27,0,0
5504,4,505,90,853,112,11,14,86,348,5,27,0,0
5505,15,489,113,873,112,11,14,98,384,6,27,0,0
5506,17,484,121,884,112,11,14,104,400,7,27,0,0
5507,14,482,129,922,112,11,14,115,440,8,27,0,0
5508,14,492,135,948,112,11,14,121,456,9,27,0,0
5509,20,501,144,954,112,11,14,124,453,10,27,0,0
5510,40,511,172,966,112,11,14,132,455,11,27,0,0
5511,48,517,195,994,112,11,14,147,477,12,27,0,0
5512,48,522,207,1014,112,11,14,159,492,13,27,0,0
5513,54,527,233,1059,112,11,14,179,532,14,27,0,0
5514,64,545,249,1079,112,11,14,185,534,15,27,0,0
5515,106,553,301,1080,112,11,14,195,527,16,27,0,0
5516,149,565,350,1080,112,11,14,201,515,17,27,0,0
5517,172,562,380,1080,112,11,14,208,518,18,27,0,0
5518,217,579,426,1080,112,11,14,209,501,19,27,0,0
5519,255,596,464,1080,112,11,14,209,484,20,27,0,0
5520,322,614,534,1080,112,11,14,212,466,21,27,0,0
5521,386,636,597,1080,112,11,14,211,444,22,27,0,0
5522,479,652,694,1080,112,11,14,215,428,23,27,0,0
5523,563,661,780,1080,112,11,14,217,419,24,27,0,0
5524,665,698,875,1079,112,11,14,210,381,25,27,0,0
5525,782,716,997,1080,112,11,14,215,364,26,27,0,0
5526,847,730,1056,1080,112,11,14,209,350,27,27,1,0
5525,1225,721,1510,1068,113,11,14,285,347,0,4,0,0
5526,1322,725,1604,1069,113,11,14,282,344,1,4,0,0
5527,1453,740,1724,1073,113,11,14,271,333,2,4,0,0
5528,1615,784,1853,1074,113,11,14,238,290,3,4,0,0
5529,1717,804,1920,1076,113,11,14,203,272,4,4,0,0
5526,938,767,1220,1077,114,11,14,282,310,0,0,0,0
5543,1769,856,1920,1078,118,11,14,151,222,0,3,0,0
5544,1716,816,1896,1079,118,11,14,180,263,1,3,0,0
5545,1624,832,1796,1077,118,11,14,172,245,2,3,0,0
5546,1582,832,1754,1077,118,11,14,172,245,3,3,0,0
5742,1556,391,1666,583,122,11,14,110,192,0,0,0,0
5747,1563,401,1668,574,123,11,14,105,173,0,0,0,0
5750,1583,390,1672,568,124,11,14,89,178,0,0,0,0
100,1369,207,1433,508,1,11,15,64,301,0,37,0,1
101,1344,197,1409,501,1,11,15,65,304,1,37,0,0
102,1307,197,1373,496,1,11,15,66,299,2,37,0,0
103,1277,185,1344,482,1,11,15,67,297,3,37,0,0
104,1244,184,1312,474,1,11,15,68,290,4,37,0,0
105,1227,182,1294,464,1,11,15,67,282,5,37,0,0
106,1215,173,1283,448,1,11,15,68,275,6,37,0,0
107,1205,174,1272,438,1,11,15,67,264,7,37,0,0
108,1195,171,1259,417,1,11,15,64,246,8,37,0,0
109,1188,170,1251,408,1,11,15,63,238,9,37,0,0
110,1185,167,1248,398,1,11,15,63,231,10,37,0,0
111,1182,159,1245,389,1,11,15,63,230,11,37,0,0
112,1181,162,1243,385,1,11,15,62,223,12,37,0,0
113,1174,152,1238,380,1,11,15,64,228,13,37,0,0
114,1173,149,1235,369,1,11,15,62,220,14,37,0,0
115,1173,147,1236,371,1,11,15,63,224,15,37,0,0
116,1174,142,1236,359,1,11,15,62,217,16,37,0,0
117,1173,142,1233,349,1,11,15,60,207,17,37,0,0
118,1172,142,1230,340,1,11,15,58,198,18,37,0,0
119,1172,141,1229,333,1,11,15,57,192,19,37,0,0
120,1175,139,1231,327,1,11,15,56,188,20,37,0,0
121,1177,137,1232,319,1,11,15,55,182,21,37,0,0
122,1178,138,1233,317,1,11,15,55,179,22,37,0,0
123,1178,136,1233,314,1,11,15,55,178,23,37,0,0
124,1181,135,1234,306,1,11,15,53,171,24,37,0,0
125,1183,134,1236,301,1,11,15,53,167,25,37,0,0
126,1188,132,1240,294,1,11,15,52,162,26,37,0,0
127,1189,130,1241,292,1,11,15,52,162,27,37,0,0
128,1190,127,1242,291,1,11,15,52,164,28,37,0,0
129,1190,127,1240,284,1,11,15,50,157,29,37,0,0
130,1189,127,1239,282,1,11,15,50,155,30,37,0,0
131,1190,124,1239,276,1,11,15,49,152,31,37,0,0
132,1187,124,1235,275,1,11,15,48,151,32,37,0,0
133,1185,122,1232,267,1,11,15,47,145,33,37,0,0
134,1181,121,1227,262,1,11,15,46,141,34,37,0,0
135,1178,120,1223,258,1,11,15,45,138,35,37,0,0
136,1172,118,1218,260,1,11,15,46,142,36,37,0,0
137,1170,116,1216,256,1,11,15,46,140,37,37,1,0
234,166,728,393,1069,2,11,15,227,341,0,1,0,0
235,243,708,477,1060,2,11,15,234,352,1,1,0,0
236,397,665,647,1071,3,11,15,250,406,0,0,0,0
237,503,628,846,1072,4,11,15,343,444,0,13,0,0
238,565,591,935,1070,4,11,15,370,479,1,13,0,0
239,598,549,996,1068,4,11,15,398,519,2,13,0,0
240,644,513,1064,1070,4,11,15,420,557,3,13,0,0
241,725,489,1159,1072,4,11,15,434,583,4,13,0,0
242,772,456,1223,1076,4,11,15,451,620,5,13,0,0
243,852,433,1303,1070,4,11,15,451,637,6,13,0,0
244,912,416,1353,1057,4,11,15,441,641,7,13,0,0
245,978,399,1382,1005,4,11,15,404,606,8,13,0,0
246,1044,385,1412,958,4,11,15,368,573,9,13,0,0
247,1090,380,1437,930,4,11,15,347,550,10,13,0,0
248,1164,374,1482,896,4,11,15,318,522,11,13,0,0
249,1218,368,1519,885,4,11,15,301,517,12,13,0,0
250,1270,351,1570,869,4,11,15,300,518,13,13,0,0
250,1355,456,1414,718,5,11,15,59,262,0,0,0,0
416,1440,922,1589,1079,6,11,15,149,157,0,1,0,0
417,1371,941,1502,1078,6,11,15,131,137,1,1,0,0
500,0,870,179,1072,10,11,15,179,202,0,0,0,0
501,107,807,328,1073,11,11,15,221,266,0,0,0,0
502,250,749,466,1071,12,11,15,216,322,0,0,0,0
503,371,684,639,1069,13,11,15,268,385,0,14,0,0
504,447,618,762,1071,13,11,15,315,453,1,14,0,0
505,537,584,873,1071,13,11,15,336,487,2,14,0,0
506,624,537,991,1075,13,11,15,367,538,3,14,0,0
507,710,497,1100,1076,13,11,15,390,579,4,14,0,0
508,770,464,1176,1071,13,11,15,406,607,5,14,0,0
509,837,427,1240,1049,13,11,15,403,622,6,14,0,0
510,903,403,1295,1023,13,11,15,392,620,7,14,0,0
511,963,388,1326,976,13,11,15,363,588,8,14,0,0
512,1047,365,1390,938,13,11,15,343,573,9,14,0,0
513,1108,359,1438,917,13,11,15,330,558,10,14,0,0
514,1175,341,1476,867,13,11,15,301,526,11,14,0,0
515,1217,335,1498,842,13,11,15,281,507,12,14,0,0
516,1239,269,1524,805,13,11,15,285,536,13,14,0,0
517,1292,241,1581,783,13,11,15,289,542,14,14,0,0
515,3,847,145,1075,14,11,15,142,228,0,0,0,0
516,43,798,310,1074,15,11,15,267,276,0,16,0,0
517,134,738,458,1074,15,11,15,324,336,1,16,0,0
518,225,692,590,1072,15,11,15,365,380,2,16,0,0
519,332,647,737,1074,15,11,15,405,427,3,16,0,0
520,461,594,915,1073,15,11,15,454,479,4,16,0,0
521,545,552,1030,1071,15,11,15,485,519,5,16,0,0
522,602,500,1121,1070,15,11,15,519,570,6,16,0,0
523,682,473,1203,1063,15,11,15,521,590,7,16,0,0
524,746,444,1270,1057,15,11,15,524,613,8,16,0,0
525,841,420,1348,1033,15,11,15,507,613,9,16,0,0
526,911,402,1399,1013,15,11,15,488,611,10,16,0,0
527,986,383,1424,953,15,11,15,438,570,11,16,0,0
528,1043,365,1452,918,15,11,15,409,553,12,16,0,0
529,1110,355,1481,876,15,11,15,371,521,13,16,0,0
530,1173,341,1521,852,15,11,15,348,511,14,16,0,0
531,1211,339,1538,845,15,11,15,327,506,15,16,0,0
532,1274,315,1607,829,15,11,15,333,514,16,16,0,0
610,1334,196,1445,517,16,11,15,111,321,0,46,0,1
611,1328,196,1439,517,16,11,15,111,321,1,46,0,0
612,1325,193,1433,506,16,11,15,108,313,2,46,0,0
613,1303,191,1411,503,16,11,15,108,312,3,46,0,0
614,1285,186,1388,482,16,11,15,103,296,4,46,0,0
615,1265,183,1366,476,16,11,15,101,293,5,46,0,0
616,1248,181,1348,470,16,11,15,100,289,6,46,0,0
617,1237,172,1333,450,16,11,15,96,278,7,46,0,0
618,1231,170,1327,448,16,11,15,96,278,8,46,0,0
619,1228,173,1321,441,16,11,15,93,268,9,46,0,0
620,1221,166,1310,425,16,11,15,89,259,10,46,0,0
621,1211,162,1298,416,16,11,15,87,254,11,46,0,0
622,1203,161,1289,409,16,11,15,86,248,12,46,0,0
623,1199,152,1282,395,16,11,15,83,243,13,46,0,0
624,1198,153,1280,392,16,11,15,82,239,14,46,0,0
625,1198,153,1277,379,16,11,15,79,226,15,46,0,0
626,1198,147,1276,371,16,11,15,78,224,16,46,0,0
627,1196,146,1273,369,16,11,15,77,223,17,46,0,0
628,1193,142,1268,361,16,11,15,75,219,18,46,0,0
629,1192,141,1266,355,16,11,15,74,214,19,46,0,0
630,1190,140,1264,354,16,11,15,74,214,20,46,0,0
631,1190,139,1261,347,16,11,15,71,208,21,46,0,0
632,1188,138,1258,342,16,11,15,70,204,22,46,0,0
633,1189,139,1257,339,16,11,15,68,200,23,46,0,0
634,1188,135,1255,334,16,11,15,67,199,24,46,0,0
635,1189,133,1255,326,16,11,15,66,193,25,46,0,0
636,1190,136,1253,320,16,11,15,63,184,26,46,0,0
637,1193,135,1253,312,16,11,15,60,177,27,46,0,0
638,1196,136,1255,307,16,11,15,59,171,28,46,0,0
639,1198,135,1256,307,16,11,15,58,172,29,46,0,0
640,1198,130,1257,303,16,11,15,59,173,30,46,0,0
641,1198,126,1257,301,16,11,15,59,175,31,46,0,0
642,1200,124,1258,298,16,11,15,58,174,32,46,0,0
643,1202,121,1260,295,16,11,15,58,174,33,46,0,0
644,1203,120,1259,288,16,11,15,56,168,34,46,0,0
645,1203,120,1257,282,16,11,15,54,162,35,46,0,0
646,1204,121,1257,277,16,11,15,53,156,36,46,0,0
647,1204,121,1256,275,16,11,15,52,154,37,46,0,0
648,1204,120,1254,268,16,11,15,50,148,38,46,0,0
649,1203,119,1253,266,16,11,15,50,147,39,46,0,0
650,1199,119,1249,266,16,11,15,50,147,40,46,0,0
651,1195,116,1244,260,16,11,15,49,144,41,46,0,0
652,1189,116,1237,258,16,11,15,48,142,42,46,0,0
653,1182,117,1230,257,16,11,15,48,140,43,46,0,0
654,1174,116,1219,249,16,11,15,45,133,44,46,0,0
655,1167,113,1211,247,16,11,15,44,134,45,46,0,0
656,1164,112,1207,243,16,11,15,43,131,46,46,1,0
743,1313,277,1436,749,17,11,15,123,472,0,21,0,1
744,1298,281,1423,761,17,11,15,125,480,1,21,0,0
745,1277,279,1403,761,17,11,15,126,482,2,21,0,0
746,1210,295,1338,767,17,11,15,128,472,3,21,0,0
747,1160,299,1293,783,17,11,15,133,484,4,21,0,0
748,1093,299,1237,814,17,11,15,144,515,5,21,0,0
749,1020,310,1177,849,17,11,15,157,539,6,21,0,0
750,954,318,1118,868,17,11,15,164,550,7,21,0,0
751,882,329,1052,882,17,11,15,170,553,8,21,0,0
752,823,344,1005,903,17,11,15,182,559,9,21,0,0
753,739,351,932,922,17,11,15,193,571,10,21,0,0
754,669,374,883,979,17,11,15,214,605,11,21,0,0
755,600,391,835,1022,17,11,15,235,631,12,21,0,0
756,519,405,762,1040,17,11,15,243,635,13,21,0,0
757,457,439,711,1069,17,11,15,254,630,14,21,0,0
758,379,469,634,1075,17,11,15,255,606,15,21,0,0
759,306,498,568,1080,17,11,15,262,582,16,21,0,0
760,244,547,508,1080,17,11,15,264,533,17,21,0,0
761,155,591,411,1080,17,11,15,256,489,18,21,0,0
762,85,651,322,1076,17,11,15,237,425,19,21,0,0
763,0,708,202,1080,17,11,15,202,372,20,21,0,0
764,0,741,124,1080,17,11,15,124,339,21,21,1,0
747,1344,402,1434,806,18,11,15,90,404,0,17,0,0
748,1309,324,1420,820,18,11,15,111,496,1,17,0,0
749,1243,316,1365,843,18,11,15,122,527,2,17,0,0
750,1201,329,1329,873,18,11,15,128,544,3,17,0,0
751,1149,333,1288,912,18,11,15,139,579,4,17,0,0
752,1089,358,1244,982,18,11,15,155,624,5,17,0,0
753,1051,378,1213,1020,18,11,15,162,642,6,17,0,0
754,1007,393,1174,1044,18,11,15,167,651,7,17,0,0
755,953,426,1123,1067,18,11,15,170,641,8,17,0,0
756,891,452,1063,1075,18,11,15,172,623,9,17,0,0
757,814,478,990,1078,18,11,15,176,600,10,17,0,0
758,752,541,922,1080,18,11,15,170,539,11,17,0,0
759,683,584,850,1080,18,11,15,167,496,12,17,0,0
760,581,632,749,1080,18,11,15,168,448,13,17,0,0
761,475,690,639,1080,18,11,15,164,390,14,17,0,0
762,328,735,489,1076,18,11,15,161,341,15,17,0,0
763,206,805,354,1074,18,11,15,148,269,16,17,0,0
764,125,846,255,1080,18,11,15,130,234,17,17,0,0
1149,1175,135,1215,252,19,11,15,40,117,0,44,0,1
1150,1188,135,1228,252,19,11,15,40,117,1,44,0,0
1151,1194,131,1240,264,19,11,15,46,133,2,44,0,0
1152,1203,132,1249,269,19,11,15,46,137,3,44,0,0
1153,1212,137,1257,270,19,11,15,45,133,4,44,0,0
1154,1220,137,1268,278,19,11,15,48,141,5,44,0,0
1155,1230,139,1277,278,19,11,15,47,139,6,44,0,0
1156,1237,137,1285,282,19,11,15,48,145,7,44,0,0
1157,1244,140,1293,286,19,11,15,49,146,8,44,0,0
1158,1246,142,1297,290,19,11,15,51,148,9,44,0,0
1159,1248,143,1299,292,19,11,15,51,149,10,44,0,0
1160,1251,145,1301,291,19,11,15,50,146,11,44,0,0
1161,1252,146,1303,295,19,11,15,51,149,12,44,0,0
1162,1252,146,1305,302,19,11,15,53,156,13,44,0,0
1163,1253,149,1306,304,19,11,15,53,155,14,44,0,0
1164,1254,150,1308,308,19,11,15,54,158,15,44,0,0
1165,1255,150,1311,316,19,11,15,56,166,16,44,0,0
1166,1258,153,1315,322,19,11,15,57,169,17,44,0,0
1167,1260,155,1315,323,19,11,15,55,168,18,44,0,0
1168,1262,156,1318,328,19,11,15,56,172,19,44,0,0
1169,1263,160,1319,331,19,11,15,56,171,20,44,0,0
1170,1263,160,1321,337,19,11,15,58,177,21,44,0,0
1171,1264,166,1324,348,19,11,15,60,182,22,44,0,0
1172,1265,170,1325,351,19,11,15,60,181,23,44,0,0
1173,1264,172,1326,359,19,11,15,62,187,24,44,0,0
1174,1263,176,1326,366,19,11,15,63,190,25,44,0,0
1175,1259,177,1324,371,19,11,15,65,194,26,44,0,0
1176,1255,179,1323,381,19,11,15,68,202,27,44,0,0
1177,1255,182,1324,385,19,11,15,69,203,28,44,0,0
1178,1253,183,1323,388,19,11,15,70,205,29,44,0,0
1179,1254,187,1325,396,19,11,15,71,209,30,44,0,0
1180,1251,192,1323,403,19,11,15,72,211,31,44,0,0
1181,1250,194,1325,414,19,11,15,75,220,32,44,0,0
1182,1251,198,1329,428,19,11,15,78,230,33,44,0,0
1183,1257,200,1336,433,19,11,15,79,233,34,44,0,0
1184,1260,204,1342,445,19,11,15,82,241,35,44,0,0
1185,1265,211,1349,459,19,11,15,84,248,36,44,0,0
1186,1269,214,1354,469,19,11,15,85,255,37,44,0,0
1187,1278,221,1362,472,19,11,15,84,251,38,44,0,0
1188,1288,226,1375,488,19,11,15,87,262,39,44,0,0
1189,1303,228,1392,498,19,11,15,89,270,40,44,0,0
1190,1319,235,1409,511,19,11,15,90,276,41,44,0,0
1191,1340,237,1431,523,19,11,15,91,286,42,44,0,0
1192,1356,243,1444,528,19,11,15,88,285,43,44,0,0
1193,1364,247,1453,537,19,11,15,89,290,44,44,1,0
1673,1278,286,1430,837,21,11,15,152,551,0,21,0,1
1674,1271,290,1430,862,21,11,15,159,572,1,21,0,0
1675,1234,288,1396,865,21,11,15,162,577,2,21,0,0
1676,1188,300,1352,873,21,11,15,164,573,3,21,0,0
1677,1146,304,1317,890,21,11,15,171,586,4,21,0,0
1678,1112,313,1304,957,21,11,15,192,644,5,21,0,0
1679,1083,330,1283,998,21,11,15,200,668,6,21,0,0
1680,1048,333,1254,1006,21,11,15,206,673,7,21,0,0
1681,1001,348,1220,1052,21,11,15,219,704,8,21,0,0
1682,967,366,1190,1069,21,11,15,223,703,9,21,0,0
1683,944,377,1172,1078,21,11,15,228,701,10,21,0,0
1684,939,397,1170,1080,21,11,15,231,683,11,21,0,0
1685,940,421,1171,1078,21,11,15,231,657,12,21,0,0
1686,940,453,1173,1077,21,11,15,233,624,13,21,0,0
1687,935,499,1168,1078,21,11,15,233,579,14,21,0,0
1688,954,535,1190,1076,21,11,15,236,541,15,21,0,0
1689,1040,577,1283,1070,21,11,15,243,493,16,21,0,0
1690,1075,606,1319,1066,21,11,15,244,460,17,21,0,0
1691,1170,669,1406,1075,21,11,15,236,406,18,21,0,0
1692,1251,728,1468,1072,21,11,15,217,344,19,21,0,0
1693,1326,773,1528,1072,21,11,15,202,299,20,21,0,0
1694,1375,810,1554,1076,21,11,15,179,266,21,21,1,0
1756,56,774,299,1077,23,11,15,243,303,0,0,0,0
1757,219,721,462,1073,24,11,15,243,352,0,15,0,0
1758,292,655,582,1074,24,11,15,290,419,1,15,0,0
1759,405,620,715,1069,24,11,15,310,449,2,15,0,0
1760,516,566,865,1073,24,11,15,349,507,3,15,0,0
1761,615,514,994,1071,24,11,15,379,557,4,15,0,0
1762,706,481,1102,1073,24,11,15,396,592,5,15,0,0
1763,791,437,1204,1069,24,11,15,413,632,6,15,0,0
1764,862,400,1287,1067,24,11,15,425,667,7,15,0,0
1765,907,375,1338,1068,24,11,15,431,693,8,15,0,0
1766,966,346,1376,1026,24,11,15,410,680,9,15,0,0
1767,1030,329,1405,970,24,11,15,375,641,10,15,0,0
1768,1071,330,1421,940,24,11,15,350,610,11,15,0,0
1769,1146,314,1463,883,24,11,15,317,569,12,15,0,0
1770,1193,301,1494,860,24,11,15,301,559,13,15,0,0
1771,1225,299,1507,842,24,11,15,282,543,14,15,0,0
1772,1284,276,1569,824,24,11,15,285,548,15,15,0,0
1815,1175,121,1220,246,25,11,15,45,125,0,62,0,1
1816,1180,121,1227,251,25,11,15,47,130,1,62,0,0
1817,1190,120,1238,252,25,11,15,48,132,2,62,0,0
1818,1199,122,1248,261,25,11,15,49,139,3,62,0,0
1819,1208,124,1257,263,25,11,15,49,139,4,62,0,0
1820,1217,125,1266,263,25,11,15,49,138,5,62,0,0
1821,1227,131,1276,268,25,11,15,49,137,6,62,0,0
1822,1234,131,1283,268,25,11,15,49,137,7,62,0,0
1823,1238,132,1288,271,25,11,15,50,139,8,62,0,0
1824,1239,132,1290,277,25,11,15,51,145,9,62,0,0
1825,1236,132,1290,283,25,11,15,54,151,10,62,0,0
1826,1230,133,1287,296,25,11,15,57,163,11,62,0,0
1827,1225,133,1282,296,25,11,15,57,163,12,62,0,0
1828,1217,135,1276,300,25,11,15,59,165,13,62,0,0
1829,1203,137,1266,314,25,11,15,63,177,14,62,0,0
1830,1193,135,1256,314,25,11,15,63,179,15,62,0,0
1831,1183,136,1247,322,25,11,15,64,186,16,62,0,0
1832,1173,137,1236,323,25,11,15,63,186,17,62,0,0
1833,1161,139,1225,327,25,11,15,64,188,18,62,0,0
1834,1147,143,1212,333,25,11,15,65,190,19,62,0,0
1835,1133,143,1200,338,25,11,15,67,195,20,62,0,0
1836,1121,146,1189,343,25,11,15,68,197,21,62,0,0
1837,1108,147,1179,352,25,11,15,71,205,22,62,0,0
1838,1098,148,1171,357,25,11,15,73,209,23,62,0,0
1839,1086,153,1161,366,25,11,15,75,213,24,62,0,0
1840,1074,153,1151,371,25,11,15,77,218,25,62,0,0
1841,1066,157,1145,379,25,11,15,79,222,26,62,0,0
1842,1053,156,1138,392,25,11,15,85,236,27,62,0,0
1843,1042,157,1128,395,25,11,15,86,238,28,62,0,0
1844,1030,166,1118,406,25,11,15,88,240,29,62,0,0
1845,1016,165,1108,416,25,11,15,92,251,30,62,0,0
1846,1000,167,1096,430,25,11,15,96,263,31,62,0,0
1847,987,173,1087,444,25,11,15,100,271,32,62,0,0
1848,974,173,1077,451,25,11,15,103,278,33,62,0,0
1849,961,183,1066,466,25,11,15,105,283,34,62,0,0
1850,947,185,1056,479,25,11,15,109,294,35,62,0,0
1851,933,187,1046,498,25,11,15,113,311,36,62,0,0
1852,919,195,1035,517,25,11,15,116,322,37,62,0,0
1853,908,194,1026,524,25,11,15,118,330,38,62,0,0
1854,890,204,1011,541,25,11,15,121,337,39,62,0,0
1855,875,212,999,561,25,11,15,124,349,40,62,0,0
1856,858,214,989,583,25,11,15,131,369,41,62,0,0
1857,837,224,974,616,25,11,15,137,392,42,62,0,0
1858,822,231,962,634,25,11,15,140,403,43,62,0,0
1859,806,237,952,657,25,11,15,146,420,44,62,0,0
1860,784,252,936,691,25,11,15,152,439,45,62,0,0
1861,761,260,915,704,25,11,15,154,444,46,62,0,0
1862,737,278,898,744,25,11,15,161,466,47,62,0,0
1863,717,291,886,783,25,11,15,169,492,48,62,0,0
1864,696,303,871,812,25,11,15,175,509,49,62,0,0
1865,672,326,860,874,25,11,15,188,548,50,62,0,0
1866,650,338,843,901,25,11,15,193,563,51,62,0,0
1867,629,351,842,970,25,11,15,213,619,52,62,0,0
1868,626,381,852,1031,25,11,15,226,650,53,62,0,0
1869,615,395,852,1062,25,11,15,237,667,54,62,0,0
1870,604,427,848,1078,25,11,15,244,651,55,62,0,0
1871,628,471,869,1078,25,11,15,241,607,56,62,0,0
1872,670,496,912,1080,25,11,15,242,584,57,62,0,0
1873,724,561,948,1080,25,11,15,224,519,58,62,0,0
1874,804,604,1016,1080,25,11,15,212,476,59,62,0,0
1875,880,638,1088,1076,25,11,15,208,438,60,62,0,0
1876,967,706,1168,1080,25,11,15,201,374,61,62,0,0
1877,1000,737,1192,1080,25,11,15,192,343,62,62,1,0
2093,1376,793,1598,1073,28,11,15,222,280,0,21,0,1
2094,1297,750,1552,1069,28,11,15,255,319,1,21,0,0
2095,1226,725,1504,1069,28,11,15,278,344,2,21,0,0
2096,1135,683,1453,1066,28,11,15,318,383,3,21,0,0
2097,1011,638,1374,1065,28,11,15,363,427,4,21,0,0
2098,895,598,1299,1066,28,11,15,404,468,5,21,0,0
2099,784,557,1233,1070,28,11,15,449,513,6,21,0,0
2100,726,510,1213,1066,28,11,15,487,556,7,21,0,0
2101,711,479,1226,1066,28,11,15,515,587,8,21,0,0
2102,747,454,1277,1063,28,11,15,530,609,9,21,0,0
2103,768,418,1322,1064,28,11,15,554,646,10,21,0,0
2104,790,393,1353,1065,28,11,15,563,672,11,21,0,0
2105,808,368,1374,1066,28,11,15,566,698,12,21,0,0
2106,848,340,1401,1051,28,11,15,553,711,13,21,0,0
2107,897,329,1416,1025,28,11,15,519,696,14,21,0,0
2108,960,321,1432,976,28,11,15,472,655,15,21,0,0
2109,1018,310,1462,952,28,11,15,444,642,16,21,0,0
2110,1061,298,1483,933,28,11,15,422,635,17,21,0,0
2111,1108,281,1488,877,28,11,15,380,596,18,21,0,0
2112,1149,276,1498,847,28,11,15,349,571,19,21,0,0
2113,1195,327,1481,814,28,11,15,286,487,20,21,0,0
2114,1200,314,1482,794,28,11,15,282,480,21,21,1,0
2221,1391,796,1617,1074,32,11,15,226,278,0,0,0,0
2222,1230,782,1453,1072,33,11,15,223,290,0,0,0,0
2223,1012,692,1297,1073,34,11,15,285,381,0,17,0,0
2224,865,654,1176,1069,34,11,15,311,415,1,17,0,0
2225,781,621,1121,1074,34,11,15,340,453,2,17,0,0
2226,698,556,1085,1072,34,11,15,387,516,3,17,0,0
2227,650,510,1070,1075,34,11,15,420,565,4,17,0,0
2228,635,475,1071,1073,34,11,15,436,598,5,17,0,0
2229,637,432,1094,1075,34,11,15,457,643,6,17,0,0
2230,658,405,1118,1071,34,11,15,460,666,7,17,0,0
2231,708,380,1151,1045,34,11,15,443,665,8,17,0,0
2232,776,356,1185,992,34,11,15,409,636,9,17,0,0
2233,822,337,1219,973,34,11,15,397,636,10,17,0,0
2234,903,321,1275,934,34,11,15,372,613,11,17,0,0
2235,993,307,1336,894,34,11,15,343,587,12,17,0,0
2236,1050,306,1382,882,34,11,15,332,576,13,17,0,0
2237,1112,299,1425,854,34,11,15,313,555,14,17,0,0
2238,1185,290,1478,837,34,11,15,293,547,15,17,0,0
2239,1220,294,1497,834,34,11,15,277,540,16,17,0,0
2240,1245,277,1524,819,34,11,15,279,542,17,17,0,0
2280,1178,127,1218,234,35,11,15,40,107,0,46,0,1
2281,1167,122,1212,242,35,11,15,45,120,1,46,0,0
2282,1175,124,1215,233,35,11,15,40,109,2,46,0,0
2283,1184,124,1229,246,35,11,15,45,122,3,46,0,0
2284,1193,123,1241,255,35,11,15,48,132,4,46,0,0
2285,1201,123,1252,261,35,11,15,51,138,5,46,0,0
2286,1211,124,1261,259,35,11,15,50,135,6,46,0,0
2287,1218,131,1267,263,35,11,15,49,132,7,46,0,0
2288,1224,133,1273,264,35,11,15,49,131,8,46,0,0
2289,1228,137,1276,268,35,11,15,48,131,9,46,0,0
2290,1231,136,1282,275,35,11,15,51,139,10,46,0,0
2291,1232,135,1284,279,35,11,15,52,144,11,46,0,0
2292,1234,138,1284,281,35,11,15,50,143,12,46,0,0
2293,1233,137,1285,284,35,11,15,52,147,13,46,0,0
2294,1233,143,1284,287,35,11,15,51,144,14,46,0,0
2295,1230,146,1283,298,35,11,15,53,152,15,46,0,0
2296,1228,148,1283,306,35,11,15,55,158,16,46,0,0
2297,1228,151,1282,311,35,11,15,54,160,17,46,0,0
2298,1226,151,1280,309,35,11,15,54,158,18,46,0,0
2299,1225,151,1281,316,35,11,15,56,165,19,46,0,0
2300,1223,151,1281,321,35,11,15,58,170,20,46,0,0
2301,1217,151,1278,331,35,11,15,61,180,21,46,0,0
2302,1214,156,1277,339,35,11,15,63,183,22,46,0,0
2303,1213,155,1276,341,35,11,15,63,186,23,46,0,0
2304,1207,158,1274,357,35,11,15,67,199,24,46,0,0
2305,1202,160,1270,364,35,11,15,68,204,25,46,0,0
2306,1197,162,1267,369,35,11,15,70,207,26,46,0,0
2307,1193,168,1265,380,35,11,15,72,212,27,46,0,0
2308,1189,166,1262,381,35,11,15,73,215,28,46,0,0
2309,1184,170,1257,384,35,11,15,73,214,29,46,0,0
2310,1177,172,1253,392,35,11,15,76,220,30,46,0,0
2311,1169,173,1248,405,35,11,15,79,232,31,46,0,0
2312,1168,180,1246,416,35,11,15,78,236,32,46,0,0
2313,1167,182,1248,426,35,11,15,81,244,33,46,0,0
2314,1168,186,1250,436,35,11,15,82,250,34,46,0,0
2315,1167,190,1250,447,35,11,15,83,257,35,46,0,0
2316,1167,191,1253,460,35,11,15,86,269,36,46,0,0
2317,1170,198,1262,485,35,11,15,92,287,37,46,0,0
2318,1175,196,1271,498,35,11,15,96,302,38,46,0,0
2319,1180,203,1279,520,35,11,15,99,317,39,46,0,0
2320,1185,210,1286,534,35,11,15,101,324,40,46,0,0
2321,1198,222,1301,547,35,11,15,103,325,41,46,0,0
2322,1218,231,1327,564,35,11,15,109,333,42,46,0,0
2323,1265,229,1381,569,35,11,15,116,340,43,46,0,0
2324,1280,228,1405,593,35,11,15,125,365,44,46,0,0
2325,1312,245,1433,606,35,11,15,121,361,45,46,0,0
2326,1321,250,1445,618,35,11,15,124,368,46,46,1,0
2287,1265,131,1303,269,38,11,15,38,138,0,36,0,1
2288,1273,134,1312,277,38,11,15,39,143,1,36,0,0
2289,1280,135,1319,276,38,11,15,39,141,2,36,0,0
2290,1283,136,1324,282,38,11,15,41,146,3,36,0,0
2291,1285,136,1326,282,38,11,15,41,146,4,36,0,0
2292,1286,137,1328,286,38,11,15,42,149,5,36,0,0
2293,1289,139,1331,287,38,11,15,42,148,6,36,0,0
2294,1290,140,1334,289,38,11,15,44,149,7,36,0,0
2295,1291,145,1336,299,38,11,15,45,154,8,36,0,0
2296,1288,145,1336,310,38,11,15,48,165,9,36,0,0
2297,1286,148,1336,316,38,11,15,50,168,10,36,0,0
2298,1285,150,1337,322,38,11,15,52,172,11,36,0,0
2299,1284,153,1337,331,38,11,15,53,178,12,36,0,0
2300,1282,156,1336,335,38,11,15,54,179,13,36,0,0
2301,1277,154,1333,338,38,11,15,56,184,14,36,0,0
2302,1274,156,1332,347,38,11,15,58,191,15,36,0,0
2303,1273,154,1333,354,38,11,15,60,200,16,36,0,0
2304,1269,155,1332,367,38,11,15,63,212,17,36,0,0
2305,1265,158,1329,369,38,11,15,64,211,18,36,0,0
2306,1263,159,1327,372,38,11,15,64,213,19,36,0,0
2307,1261,164,1325,374,38,11,15,64,210,20,36,0,0
2308,1259,165,1324,380,38,11,15,65,215,21,36,0,0
2309,1254,167,1324,396,38,11,15,70,229,22,36,0,0
2310,1246,172,1317,404,38,11,15,71,232,23,36,0,0
2311,1241,173,1314,409,38,11,15,73,236,24,36,0,0
2312,1240,179,1315,421,38,11,15,75,242,25,36,0,0
2313,1236,180,1315,434,38,11,15,79,254,26,36,0,0
2314,1238,178,1319,443,38,11,15,81,265,27,36,0,0
2315,1240,185,1319,445,38,11,15,79,260,28,36,0,0
2316,1239,185,1327,474,38,11,15,88,289,29,36,0,0
2317,1239,195,1333,500,38,11,15,94,305,30,36,0,0
2318,1252,196,1346,500,38,11,15,94,304,31,36,0,0
2319,1261,198,1359,515,38,11,15,98,317,32,36,0,0
2320,1266,207,1363,520,38,11,15,97,313,33,36,0,0
2321,1277,214,1370,516,38,11,15,93,302,34,36,0,0
2322,1304,225,1390,517,38,11,15,86,292,35,36,0,0
2323,1308,229,1395,524,38,11,15,87,295,36,36,1,0
2322,1378,223,1437,527,39,11,15,59,304,0,0,0,0
2324,1325,213,1389,416,40,11,15,64,203,0,43,0,1
2325,1300,204,1386,479,40,11,15,86,275,1,43,0,0
2326,1283,201,1372,482,40,11,15,89,281,2,43,0,0
2327,1263,197,1354,479,40,11,15,91,282,3,43,0,0
2328,1251,190,1342,473,40,11,15,91,283,4,43,0,0
2329,1245,187,1333,458,40,11,15,88,271,5,43,0,0
2330,1237,186,1323,452,40,11,15,86,266,6,43,0,0
2331,1228,181,1311,435,40,11,15,83,254,7,43,0,0
2332,1221,181,1303,426,40,11,15,82,245,8,43,0,0
2333,1220,177,1304,431,40,11,15,84,254,9,43,0,0
2334,1224,172,1304,412,40,11,15,80,240,10,43,0,0
2335,1226,173,1307,417,40,11,15,81,244,11,43,0,0
2336,1227,169,1303,396,40,11,15,76,227,12,43,0,0
2337,1226,168,1300,385,40,11,15,74,217,13,43,0,0
2338,1227,167,1303,388,40,11,15,76,221,14,43,0,0
2339,1234,160,1308,376,40,11,15,74,216,15,43,0,0
2340,1243,157,1315,365,40,11,15,72,208,16,43,0,0
2341,1242,154,1314,364,40,11,15,72,210,17,43,0,0
2342,1239,149,1311,358,40,11,15,72,209,18,43,0,0
2343,1239,148,1309,349,40,11,15,70,201,19,43,0,0
2344,1243,147,1310,342,40,11,15,67,195,20,43,0,0
2345,1246,144,1311,335,40,11,15,65,191,21,43,0,0
2346,1245,143,1310,334,40,11,15,65,191,22,43,0,0
2347,1240,141,1305,328,40,11,15,65,187,23,43,0,0
2348,1240,140,1301,316,40,11,15,61,176,24,43,0,0
2349,1241,141,1299,312,40,11,15,58,171,25,43,0,0
2350,1241,139,1300,313,40,11,15,59,174,26,43,0,0
2351,1242,142,1298,307,40,11,15,56,165,27,43,0,0
2352,1241,142,1296,306,40,11,15,55,164,28,43,0,0
2353,1240,139,1294,301,40,11,15,54,162,29,43,0,0
2354,1239,140,1292,302,40,11,15,53,162,30,43,0,0
2355,1239,133,1292,298,40,11,15,53,165,31,43,0,0
2356,1238,133,1291,293,40,11,15,53,160,32,43,0,0
2357,1235,130,1287,290,40,11,15,52,160,33,43,0,0
2358,1231,129,1283,285,40,11,15,52,156,34,43,0,0
2359,1229,131,1277,277,40,11,15,48,146,35,43,0,0
2360,1225,129,1273,274,40,11,15,48,145,36,43,0,0
2361,1219,126,1268,275,40,11,15,49,149,37,43,0,0
2362,1212,124,1262,275,40,11,15,50,151,38,43,0,0
2363,1203,124,1251,269,40,11,15,48,145,39,43,0,0
2364,1193,124,1239,265,40,11,15,46,141,40,43,0,0
2365,1181,123,1228,263,40,11,15,47,140,41,43,0,0
2366,1169,120,1214,257,40,11,15,45,137,42,43,0,0
2367,1163,119,1207,254,40,11,15,44,135,43,43,1,0
2324,1374,263,1433,593,41,11,15,59,330,0,0,0,0
2710,0,927,95,1076,42,11,15,95,149,0,0,0,0
2718,613,547,1132,1071,44,11,15,519,524,0,11,0,0
2719,672,518,1202,1072,44,11,15,530,554,1,11,0,0
2720,736,485,1278,1072,44,11,15,542,587,2,11,0,0
2721,784,457,1332,1071,44,11,15,548,614,3,11,0,0
2722,835,439,1369,1059,44,11,15,534,620,4,11,0,0
2723,909,409,1393,997,44,11,15,484,588,5,11,0,0
2724,967,396,1409,954,44,11,15,442,558,6,11,0,0
2725,1008,379,1421,923,44,11,15,413,544,7,11,0,0
2726,1086,371,1457,881,44,11,15,371,510,8,11,0,0
2727,1132,366,1483,866,44,11,15,351,500,9,11,0,0
2728,1177,354,1512,850,44,11,15,335,496,10,11,0,0
2729,1228,333,1566,834,44,11,15,338,501,11,11,0,0
2729,1325,363,1434,806,45,11,15,109,443,0,0,0,0
4343,1172,120,1214,244,46,11,15,42,124,0,33,0,1
4344,1185,121,1229,250,46,11,15,44,129,1,33,0,0
4345,1197,126,1242,260,46,11,15,45,134,2,33,0,0
4346,1210,125,1258,265,46,11,15,48,140,3,33,0,0
4347,1219,131,1266,269,46,11,15,47,138,4,33,0,0
4348,1224,131,1274,274,46,11,15,50,143,5,33,0,0
4349,1231,133,1280,274,46,11,15,49,141,6,33,0,0
4350,1236,135,1284,274,46,11,15,48,139,7,33,0,0
4351,1239,135,1292,288,46,11,15,53,153,8,33,0,0
4352,1240,139,1295,297,46,11,15,55,158,9,33,0,0
4353,1240,141,1297,306,46,11,15,57,165,10,33,0,0
4354,1238,143,1296,314,46,11,15,58,171,11,33,0,0
4355,1236,143,1296,320,46,11,15,60,177,12,33,0,0
4356,1234,143,1295,322,46,11,15,61,179,13,33,0,0
4357,1227,146,1292,337,46,11,15,65,191,14,33,0,0
4358,1220,146,1286,340,46,11,15,66,194,15,33,0,0
4359,1216,145,1284,343,46,11,15,68,198,16,33,0,0
4360,1214,150,1282,347,46,11,15,68,197,17,33,0,0
4361,1211,149,1281,353,46,11,15,70,204,18,33,0,0
4362,1204,156,1278,371,46,11,15,74,215,19,33,0,0
4363,1197,155,1275,386,46,11,15,78,231,20,33,0,0
4364,1194,156,1274,395,46,11,15,80,239,21,33,0,0
4365,1196,163,1277,406,46,11,15,81,243,22,33,0,0
4366,1198,165,1279,405,46,11,15,81,240,23,33,0,0
4367,1199,174,1283,424,46,11,15,84,250,24,33,0,0
4368,1198,178,1283,431,46,11,15,85,253,25,33,0,0
4369,1203,179,1293,444,46,11,15,90,265,26,33,0,0
4370,1213,184,1307,459,46,11,15,94,275,27,33,0,0
4371,1231,185,1327,467,46,11,15,96,282,28,33,0,0
4372,1247,196,1345,486,46,11,15,98,290,29,33,0,0
4373,1274,197,1375,500,46,11,15,101,303,30,33,0,0
4374,1300,200,1404,512,46,11,15,104,312,31,33,0,0
4375,1317,208,1421,511,46,11,15,104,303,32,33,0,0
4376,1325,212,1432,520,46,11,15,107,308,33,33,1,0
4459,1227,136,1265,285,47,11,15,38,149,0,31,0,1
4460,1233,134,1272,289,47,11,15,39,155,1,31,0,0
4461,1237,132,1277,289,47,11,15,40,157,2,31,0,0
4462,1239,137,1281,293,47,11,15,42,156,3,31,0,0
4463,1240,140,1281,296,47,11,15,41,156,4,31,0,0
4464,1239,142,1284,305,47,11,15,45,163,5,31,0,0
4465,1241,146,1285,309,47,11,15,44,163,6,31,0,0
4466,1237,144,1285,317,47,11,15,48,173,7,31,0,0
4467,1234,145,1285,324,47,11,15,51,179,8,31,0,0
4468,1230,150,1280,329,47,11,15,50,179,9,31,0,0
4469,1223,150,1275,331,47,11,15,52,181,10,31,0,0
4470,1218,152,1272,338,47,11,15,54,186,11,31,0,0
4471,1214,151,1270,342,47,11,15,56,191,12,31,0,0
4472,1211,156,1267,346,47,11,15,56,190,13,31,0,0
4473,1205,157,1263,352,47,11,15,58,195,14,31,0,0
4474,1199,154,1260,357,47,11,15,61,203,15,31,0,0
4475,1195,165,1256,367,47,11,15,61,202,16,31,0,0
4476,1190,167,1253,373,47,11,15,63,206,17,31,0,0
4477,1189,169,1253,380,47,11,15,64,211,18,31,0,0
4478,1186,173,1252,393,47,11,15,66,220,19,31,0,0
4479,1181,172,1250,401,47,11,15,69,229,20,31,0,0
4480,1180,180,1251,412,47,11,15,71,232,21,31,0,0
4481,1185,183,1259,425,47,11,15,74,242,22,31,0,0
4482,1194,187,1270,434,47,11,15,76,247,23,31,0,0
4483,1204,195,1284,449,47,11,15,80,254,24,31,0,0
4484,1210,196,1292,457,47,11,15,82,261,25,31,0,0
4485,1223,202,1310,475,47,11,15,87,273,26,31,0,0
4486,1236,208,1326,484,47,11,15,90,276,27,31,0,0
4487,1269,210,1360,495,47,11,15,91,285,28,31,0,0
4488,1292,217,1390,512,47,11,15,98,295,29,31,0,0
4489,1330,221,1426,519,47,11,15,96,298,30,31,0,0
4490,1340,225,1438,529,47,11,15,98,304,31,31,1,0
4752,1291,321,1431,697,48,11,15,140,376,0,8,0,0
4753,1275,313,1420,703,48,11,15,145,390,1,8,0,0
4754,1237,318,1386,719,48,11,15,149,401,2,8,0,0
4755,1192,328,1343,732,48,11,15,151,404,3,8,0,0
4756,1138,326,1292,738,48,11,15,154,412,4,8,0,0
4757,1078,337,1233,745,48,11,15,155,408,5,8,0,0
4758,1038,342,1195,755,48,11,15,157,413,6,8,0,0
4759,988,351,1154,792,48,11,15,166,441,7,8,0,0
4760,947,357,1116,805,48,11,15,169,448,8,8,0,0
4755,1369,370,1426,679,49,11,15,57,309,0,0,0,0
4756,1277,356,1419,865,50,11,15,142,509,0,17,0,0
4757,1217,370,1364,891,50,11,15,147,521,1,17,0,0
4758,1193,383,1336,884,50,11,15,143,501,2,17,0,0
4759,1126,391,1270,886,50,11,15,144,495,3,17,0,0
4760,1055,396,1213,922,50,11,15,158,526,4,17,0,0
4761,981,387,1149,933,50,11,15,168,546,5,17,0,0
4762,909,404,1096,999,50,11,15,187,595,6,17,0,0
4763,843,404,1047,1048,50,11,15,204,644,7,17,0,0
4764,787,451,983,1065,50,11,15,196,614,8,17,0,0
4765,721,486,915,1079,50,11,15,194,593,9,17,0,0
4766,657,522,849,1080,50,11,15,192,558,10,17,0,0
4767,565,544,756,1080,50,11,15,191,536,11,17,0,0
4768,480,577,669,1080,50,11,15,189,503,12,17,0,0
4769,401,629,579,1080,50,11,15,178,451,13,17,0,0
4770,310,676,483,1080,50,11,15,173,404,14,17,0,0
4771,206,722,373,1080,50,11,15,167,358,15,17,0,0
4772,95,765,256,1077,50,11,15,161,312,16,17,0,0
4773,18,797,165,1080,50,11,15,147,283,17,17,0,0
4758,1264,382,1384,661,51,11,15,120,279,0,0,0,0
4759,1210,403,1332,815,52,11,15,122,412,0,15,0,0
4760,1162,416,1286,831,52,11,15,124,415,1,15,0,0
4761,1098,402,1233,856,52,11,15,135,454,2,15,0,0
4762,1057,412,1187,852,52,11,15,130,440,3,15,0,0
4763,1016,422,1150,873,52,11,15,134,451,4,15,0,0
4764,979,435,1115,889,52,11,15,136,454,5,15,0,0
4765,943,458,1083,921,52,11,15,140,463,6,15,0,0
4766,908,474,1056,957,52,11,15,148,483,7,15,0,0
4767,870,508,1034,1039,52,11,15,164,531,8,15,0,0
4768,839,549,1003,1070,52,11,15,164,521,9,15,0,0
4769,805,587,968,1080,52,11,15,163,493,10,15,0,0
4770,753,628,912,1080,52,11,15,159,452,11,15,0,0
4771,684,671,838,1080,52,11,15,154,409,12,15,0,0
4772,620,755,760,1080,52,11,15,140,325,13,15,0,0
4773,549,829,677,1080,52,11,15,128,251,14,15,0,0
4774,505,869,620,1080,52,11,15,115,211,15,15,0,0
4764,820,402,996,722,53,11,15,176,320,0,1,0,0
4765,772,420,997,833,53,11,15,225,413,1,1,0,0
4767,663,468,851,943,54,11,15,188,475,0,8,0,0
4768,595,480,791,975,54,11,15,196,495,1,8,0,0
4769,519,502,732,1039,54,11,15,213,537,2,8,0,0
4770,448,526,663,1061,54,11,15,215,535,3,8,0,0
4771,375,562,584,1071,54,11,15,209,509,4,8,0,0
4772,298,609,492,1072,54,11,15,194,463,5,8,0,0
4773,229,639,421,1077,54,11,15,192,438,6,8,0,0
4774,200,677,389,1070,54,11,15,189,393,7,8,0,0
4775,147,706,328,1080,54,11,15,181,374,8,8,0,0
4776,3,757,300,1077,55,11,15,297,320,0,0,0,0
5233,1248,124,1285,269,56,11,15,37,145,0,31,0,1
5234,1255,126,1293,272,56,11,15,38,146,1,31,0,0
5235,1259,130,1299,282,56,11,15,40,152,2,31,0,0
5236,1262,128,1304,287,56,11,15,42,159,3,31,0,0
5237,1264,132,1307,290,56,11,15,43,158,4,31,0,0
5238,1268,132,1314,299,56,11,15,46,167,5,31,0,0
5239,1272,134,1319,303,56,11,15,47,169,6,31,0,0
5240,1274,136,1324,311,56,11,15,50,175,7,31,0,0
5241,1273,135,1325,313,56,11,15,52,178,8,31,0,0
5242,1272,138,1325,319,56,11,15,53,181,9,31,0,0
5243,1272,138,1327,323,56,11,15,55,185,10,31,0,0
5244,1271,139,1327,325,56,11,15,56,186,11,31,0,0
5245,1271,142,1328,334,56,11,15,57,192,12,31,0,0
5246,1267,142,1327,341,56,11,15,60,199,13,31,0,0
5247,1264,146,1325,347,56,11,15,61,201,14,31,0,0
5248,1261,146,1326,361,56,11,15,65,215,15,31,0,0
5249,1260,145,1328,367,56,11,15,68,222,16,31,0,0
5250,1259,148,1329,372,56,11,15,70,224,17,31,0,0
5251,1254,148,1326,378,56,11,15,72,230,18,31,0,0
5252,1249,148,1323,382,56,11,15,74,234,19,31,0,0
5253,1248,154,1325,399,56,11,15,77,245,20,31,0,0
5254,1251,156,1330,404,56,11,15,79,248,21,31,0,0
5255,1255,161,1334,410,56,11,15,79,249,22,31,0,0
5256,1257,170,1337,421,56,11,15,80,251,23,31,0,0
5257,1258,173,1341,435,56,11,15,83,262,24,31,0,0
5258,1264,179,1351,452,56,11,15,87,273,25,31,0,0
5259,1275,181,1364,460,56,11,15,89,279,26,31,0,0
5260,1291,184,1383,473,56,11,15,92,289,27,31,0,0
5261,1305,186,1403,494,56,11,15,98,308,28,31,0,0
5262,1325,189,1424,502,56,11,15,99,313,29,31,0,0
5263,1336,194,1435,504,56,11,15,99,310,30,31,0,0
5264,1342,196,1443,513,56,11,15,101,317,31,31,1,0
5253,1363,173,1401,267,57,11,15,38,94,0,0,0,0
5491,1208,132,1243,271,58,11,15,35,139,0,44,0,1
5492,1208,132,1244,273,58,11,15,36,141,1,44,0,0
5493,1208,134,1244,275,58,11,15,36,141,2,44,0,0
5494,1207,133,1245,280,58,11,15,38,147,3,44,0,0
5495,1205,137,1244,284,58,11,15,39,147,4,44,0,0
5496,1201,139,1242,287,58,11,15,41,148,5,44,0,0
5497,1198,141,1240,288,58,11,15,42,147,6,44,0,0
5498,1195,143,1238,293,58,11,15,43,150,7,44,0,0
5499,1194,144,1238,295,58,11,15,44,151,8,44,0,0
5500,1192,145,1238,301,58,11,15,46,156,9,44,0,0
5501,1192,146,1239,304,58,11,15,47,158,10,44,0,0
5502,1192,147,1240,308,58,11,15,48,161,11,44,0,0
5503,1195,148,1245,311,58,11,15,50,163,12,44,0,0
5504,1201,148,1252,311,58,11,15,51,163,13,44,0,0
5505,1207,148,1260,318,58,11,15,53,170,14,44,0,0
5506,1213,152,1265,320,58,11,15,52,168,15,44,0,0
5507,1216,153,1270,326,58,11,15,54,173,16,44,0,0
5508,1220,154,1275,332,58,11,15,55,178,17,44,0,0
5509,1222,152,1280,339,58,11,15,58,187,18,44,0,0
5510,1223,156,1282,346,58,11,15,59,190,19,44,0,0
5511,1221,162,1281,352,58,11,15,60,190,20,44,0,0
5512,1219,166,1278,355,58,11,15,59,189,21,44,0,0
5513,1216,170,1277,362,58,11,15,61,192,22,44,0,0
5514,1213,172,1275,365,58,11,15,62,193,23,44,0,0
5515,1209,174,1271,366,58,11,15,62,192,24,44,0,0
5516,1203,177,1265,372,58,11,15,62,195,25,44,0,0
5517,1197,176,1261,377,58,11,15,64,201,26,44,0,0
5518,1190,178,1256,387,58,11,15,66,209,27,44,0,0
5519,1184,179,1252,392,58,11,15,68,213,28,44,0,0
5520,1179,179,1248,392,58,11,15,69,213,29,44,0,0
5521,1174,183,1243,399,58,11,15,69,216,30,44,0,0
5522,1169,184,1240,404,58,11,15,71,220,31,44,0,0
5523,1168,189,1240,414,58,11,15,72,225,32,44,0,0
5524,1171,190,1245,418,58,11,15,74,228,33,44,0,0
5525,1177,192,1252,427,58,11,15,75,235,34,44,0,0
5526,1187,200,1262,438,58,11,15,75,238,35,44,0,0
5527,1195,201,1273,446,58,11,15,78,245,36,44,0,0
5528,1209,207,1288,457,58,11,15,79,250,37,44,0,0
5529,1223,210,1304,463,58,11,15,81,253,38,44,0,0
5530,1245,213,1326,470,58,11,15,81,257,39,44,0,0
5531,1263,216,1347,480,58,11,15,84,264,40,44,0,0
5532,1287,219,1370,486,58,11,15,83,267,41,44,0,0
5533,1308,214,1397,495,58,11,15,89,281,42,44,0,0
5534,1324,216,1416,498,58,11,15,92,282,43,44,0,0
5535,1334,218,1427,504,58,11,15,93,286,44,44,1,0
5617,0,961,93,1079,59,11,15,93,118,0,0,0,0
5620,257,869,448,1066,62,11,15,191,197,0,0,0,0
5621,367,814,583,1073,63,11,15,216,259,0,17,0,0
5622,420,759,682,1073,63,11,15,262,314,1,17,0,0
5623,488,730,768,1069,63,11,15,280,339,2,17,0,0
5624,562,689,876,1072,63,11,15,314,383,3,17,0,0
5625,621,642,968,1072,63,11,15,347,430,4,17,0,0
5626,680,608,1050,1077,63,11,15,370,469,5,17,0,0
5627,736,569,1125,1076,63,11,15,389,507,6,17,0,0
5628,787,536,1185,1071,63,11,15,398,535,7,17,0,0
5629,837,513,1237,1067,63,11,15,400,554,8,17,0,0
5630,906,482,1276,1013,63,11,15,370,531,9,17,0,0
5631,961,462,1317,993,63,11,15,356,531,10,17,0,0
5632,1006,438,1351,973,63,11,15,345,535,11,17,0,0
5633,1065,414,1380,922,63,11,15,315,508,12,17,0,0
5634,1115,404,1409,885,63,11,15,294,481,13,17,0,0
5635,1166,403,1437,854,63,11,15,271,451,14,17,0,0
5636,1236,400,1482,830,63,11,15,246,430,15,17,0,0
5637,1269,443,1484,832,63,11,15,215,389,16,17,0,0
5638,1318,430,1531,817,63,11,15,213,387,17,17,0,0
5790,1302,319,1445,836,64,11,15,143,517,0,18,0,0
5791,1298,313,1443,838,64,11,15,145,525,1,18,0,0
5792,1246,321,1402,881,64,11,15,156,560,2,18,0,0
5793,1207,327,1369,901,64,11,15,162,574,3,18,0,0
5794,1169,337,1331,900,64,11,15,162,563,4,18,0,0
5795,1104,345,1278,932,64,11,15,174,587,5,18,0,0
5796,1065,348,1248,958,64,11,15,183,610,6,18,0,0
5797,1012,358,1210,998,64,11,15,198,640,7,18,0,0
5798,958,378,1175,1055,64,11,15,217,677,8,18,0,0
5799,928,397,1152,1074,64,11,15,224,677,9,18,0,0
5800,911,423,1138,1080,64,11,15,227,657,10,18,0,0
5801,894,456,1116,1080,64,11,15,222,624,11,18,0,0
5802,872,480,1096,1077,64,11,15,224,597,12,18,0,0
5803,870,522,1100,1076,64,11,15,230,554,13,18,0,0
5804,919,574,1162,1079,64,11,15,243,505,14,18,0,0
5805,981,632,1233,1078,64,11,15,252,446,15,18,0,0
5806,1044,712,1292,1079,64,11,15,248,367,16,18,0,0
5807,1112,800,1339,1079,64,11,15,227,279,17,18,0,0
5808,1175,871,1368,1076,64,11,15,193,205,18,18,0,0
1,312,168,350,299,1,11,2,38,131,0,74,0,1
2,311,164,350,301,1,11,2,39,137,1,74,0,0
3,311,161,353,306,1,11,2,42,145,2,74,0,0
4,313,162,354,306,1,11,2,41,144,3,74,0,0
5,311,160,354,308,1,11,2,43,148,4,74,0,0
6,311,161,355,313,1,11,2,44,152,5,74,0,0
7,313,166,357,318,1,11,2,44,152,6,74,0,0
8,315,168,359,322,1,11,2,44,154,7,74,0,0
9,317,166,363,325,1,11,2,46,159,8,74,0,0
10,319,170,365,328,1,11,2,46,158,9,74,0,0
11,320,170,367,331,1,11,2,47,161,10,74,0,0
12,322,171,369,332,1,11,2,47,161,11,74,0,0
13,324,173,373,336,1,11,2,49,163,12,74,0,0
14,328,175,377,341,1,11,2,49,166,13,74,0,0
15,330,169,381,342,1,11,2,51,173,14,74,0,0
16,331,168,385,350,1,11,2,54,182,15,74,0,0
17,332,168,386,354,1,11,2,54,186,16,74,0,0
18,332,163,388,355,1,11,2,56,192,17,74,0,0
19,333,163,390,359,1,11,2,57,196,18,74,0,0
20,335,171,390,363,1,11,2,55,192,19,74,0,0
21,337,170,394,366,1,11,2,57,196,20,74,0,0
22,338,172,395,371,1,11,2,57,199,21,74,0,0
23,336,172,396,380,1,11,2,60,208,22,74,0,0
24,333,171,395,386,1,11,2,62,215,23,74,0,0
25,329,169,394,390,1,11,2,65,221,24,74,0,0
26,328,171,393,395,1,11,2,65,224,25,74,0,0
27,331,174,395,397,1,11,2,64,223,26,74,0,0
28,332,175,398,402,1,11,2,66,227,27,74,0,0
29,334,179,400,408,1,11,2,66,229,28,74,0,0
30,333,186,399,413,1,11,2,66,227,29,74,0,0
31,331,187,400,420,1,11,2,69,233,30,74,0,0
32,332,184,403,429,1,11,2,71,245,31,74,0,0
33,334,193,406,436,1,11,2,72,243,32,74,0,0
34,338,198,410,444,1,11,2,72,246,33,74,0,0
35,339,200,414,452,1,11,2,75,252,34,74,0,0
36,339,196,418,465,1,11,2,79,269,35,74,0,0
37,338,195,418,469,1,11,2,80,274,36,74,0,0
38,336,192,419,473,1,11,2,83,281,37,74,0,0
39,335,192,422,486,1,11,2,87,294,38,74,0,0
40,340,201,427,495,1,11,2,87,294,39,74,0,0
41,343,204,432,502,1,11,2,89,298,40,74,0,0
42,343,204,436,520,1,11,2,93,316,41,74,0,0
43,342,208,438,534,1,11,2,96,326,42,74,0,0
44,340,210,439,542,1,11,2,99,332,43,74,0,0
45,338,209,440,555,1,11,2,102,346,44,74,0,0
46,338,219,443,575,1,11,2,105,356,45,74,0,0
47,342,226,448,586,1,11,2,106,360,46,74,0,0
48,342,227,452,596,1,11,2,110,369,47,74,0,0
49,341,231,454,618,1,11,2,113,387,48,74,0,0
50,338,237,455,633,1,11,2,117,396,49,74,0,0
51,337,236,457,642,1,11,2,120,406,50,74,0,0
52,338,241,463,666,1,11,2,125,425,51,74,0,0
53,343,253,472,693,1,11,2,129,440,52,74,0,0
54,346,254,478,705,1,11,2,132,451,53,74,0,0
55,342,255,483,739,1,11,2,141,484,54,74,0,0
56,335,267,481,768,1,11,2,146,501,55,74,0,0
57,328,272,477,780,1,11,2,149,508,56,74,0,0
58,326,275,478,791,1,11,2,152,516,57,74,0,0
59,328,289,484,815,1,11,2,156,526,58,74,0,0
60,337,295,498,842,1,11,2,161,547,59,74,0,0
61,345,298,515,873,1,11,2,170,575,60,74,0,0
62,357,313,538,926,1,11,2,181,613,61,74,0,0
63,368,327,555,957,1,11,2,187,630,62,74,0,0
64,377,336,569,971,1,11,2,192,635,63,74,0,0
65,381,344,584,999,1,11,2,203,655,64,74,0,0
66,373,363,586,1049,1,11,2,213,686,65,74,0,0
67,365,380,583,1074,1,11,2,218,694,66,74,0,0
68,357,394,575,1080,1,11,2,218,686,67,74,0,0
69,344,420,561,1080,1,11,2,217,660,68,74,0,0
70,315,453,536,1080,1,11,2,221,627,69,74,0,0
71,234,466,460,1080,1,11,2,226,614,70,74,0,0
72,146,489,366,1077,1,11,2,220,588,71,74,0,0
73,77,547,283,1080,1,11,2,206,533,72,74,0,0
74,25,594,216,1080,1,11,2,191,486,73,74,0,0
75,0,617,184,1080,1,11,2,184,463,74,74,1,0
58,1,802,171,1079,2,11,2,170,277,0,10,0,0
59,0,546,257,1073,2,11,2,257,527,1,10,0,0
60,0,479,301,1068,2,11,2,301,589,2,10,0,0
61,0,468,337,1070,2,11,2,337,602,3,10,0,0
62,0,487,340,1076,2,11,2,340,589,4,10,0,0
63,2,536,326,1076,2,11,2,324,540,5,10,0,0
64,55,593,353,1073,2,11,2,298,480,6,10,0,0
65,72,649,348,1077,2,11,2,276,428,7,10,0,0
66,63,718,303,1079,2,11,2,240,361,8,10,0,0
67,55,835,225,1079,2,11,2,170,244,9,10,0,0
68,62,864,213,1080,2,11,2,151,216,10,10,0,0
89,0,872,146,1080,3,11,2,146,208,0,73,0,1
90,17,794,217,1080,3,11,2,200,286,1,73,0,0
91,31,727,275,1075,3,11,2,244,348,2,73,0,0
92,54,656,345,1073,3,11,2,291,417,3,73,0,0
93,99,606,423,1072,3,11,2,324,466,4,73,0,0
94,126,558,480,1071,3,11,2,354,513,5,73,0,0
95,141,500,530,1072,3,11,2,389,572,6,73,0,0
96,149,455,559,1070,3,11,2,410,615,7,73,0,0
97,151,425,570,1070,3,11,2,419,645,8,73,0,0
98,156,394,584,1073,3,11,2,428,679,9,73,0,0
99,178,376,582,1036,3,11,2,404,660,10,73,0,0
100,192,348,573,991,3,11,2,381,643,11,73,0,0
101,204,328,555,943,3,11,2,351,615,12,73,0,0
102,212,316,539,910,3,11,2,327,594,13,73,0,0
103,224,297,517,847,3,11,2,293,550,14,73,0,0
104,237,285,514,819,3,11,2,277,534,15,73,0,0
105,250,272,504,774,3,11,2,254,502,16,73,0,0
106,254,264,483,731,3,11,2,229,467,17,73,0,0
107,260,264,464,695,3,11,2,204,431,18,73,0,0
108,258,250,448,661,3,11,2,190,411,19,73,0,0
109,263,244,443,642,3,11,2,180,398,20,73,0,0
110,269,236,436,612,3,11,2,167,376,21,73,0,0
111,271,228,426,585,3,11,2,155,357,22,73,0,0
112,275,229,416,565,3,11,2,141,336,23,73,0,0
113,274,221,408,544,3,11,2,134,323,24,73,0,0
114,277,218,405,525,3,11,2,128,307,25,73,0,0
115,282,213,402,508,3,11,2,120,295,26,73,0,0
116,283,207,397,494,3,11,2,114,287,27,73,0,0
117,281,207,389,486,3,11,2,108,279,28,73,0,0
118,280,202,383,468,3,11,2,103,266,29,73,0,0
119,283,200,383,458,3,11,2,100,258,30,73,0,0
120,285,198,380,443,3,11,2,95,245,31,73,0,0
121,283,194,374,434,3,11,2,91,240,32,73,0,0
122,279,192,366,427,3,11,2,87,235,33,73,0,0
123,278,188,363,417,3,11,2,85,229,34,73,0,0
124,279,188,363,413,3,11,2,84,225,35,73,0,0
125,280,183,361,402,3,11,2,81,219,36,73,0,0
126,279,178,357,394,3,11,2,78,216,37,73,0,0
127,275,179,350,390,3,11,2,75,211,38,73,0,0
128,273,175,345,379,3,11,2,72,204,39,73,0,0
129,273,176,344,372,3,11,2,71,196,40,73,0,0
130,273,175,342,364,3,11,2,69,189,41,73,0,0
131,272,174,339,360,3,11,2,67,186,42,73,0,0
132,270,173,335,357,3,11,2,65,184,43,73,0,0
133,271,168,335,349,3,11,2,64,181,44,73,0,0
134,276,169,337,342,3,11,2,61,173,45,73,0,0
135,280,166,340,335,3,11,2,60,169,46,73,0,0
136,284,166,343,333,3,11,2,59,167,47,73,0,0
137,286,166,342,328,3,11,2,56,162,48,73,0,0
138,290,164,345,323,3,11,2,55,159,49,73,0,0
139,294,163,348,319,3,11,2,54,156,50,73,0,0
140,299,162,350,313,3,11,2,51,151,51,73,0,0
141,300,161,350,310,3,11,2,50,149,52,73,0,0
142,299,162,347,307,3,11,2,48,145,53,73,0,0
143,298,157,346,303,3,11,2,48,146,54,73,0,0
144,298,156,345,300,3,11,2,47,144,55,73,0,0
145,297,152,344,297,3,11,2,47,145,56,73,0,0
146,297,151,342,292,3,11,2,45,141,57,73,0,0
147,294,151,337,288,3,11,2,43,137,58,73,0,0
148,292,149,335,285,3,11,2,43,136,59,73,0,0
149,290,149,333,284,3,11,2,43,135,60,73,0,0
150,288,149,330,279,3,11,2,42,130,61,73,0,0
151,287,150,327,277,3,11,2,40,127,62,73,0,0
152,284,150,323,275,3,11,2,39,125,63,73,0,0
153,283,149,322,272,3,11,2,39,123,64,73,0,0
154,284,146,323,271,3,11,2,39,125,65,73,0,0
155,284,145,323,268,3,11,2,39,123,66,73,0,0
156,285,145,322,264,3,11,2,37,119,67,73,0,0
157,287,144,323,261,3,11,2,36,117,68,73,0,0
158,289,135,327,259,3,11,2,38,124,69,73,0,0
159,293,138,330,258,3,11,2,37,120,70,73,0,0
160,298,136,334,253,3,11,2,36,117,71,73,0,0
161,300,132,336,252,3,11,2,36,120,72,73,0,0
162,303,131,339,251,3,11,2,36,120,73,73,1,0
781,2,540,210,1069,6,11,2,208,529,0,82,0,1
782,33,511,257,1078,6,11,2,224,567,1,82,0,0
783,66,487,298,1077,6,11,2,232,590,2,82,0,0
784,147,471,382,1072,6,11,2,235,601,3,82,0,0
785,203,441,440,1053,6,11,2,237,612,4,82,0,0
786,279,426,513,1025,6,11,2,234,599,5,82,0,0
787,331,411,559,1001,6,11,2,228,590,6,82,0,0
788,369,396,584,957,6,11,2,215,561,7,82,0,0
789,408,389,624,946,6,11,2,216,557,8,82,0,0
790,429,372,643,916,6,11,2,214,544,9,82,0,0
791,438,359,639,864,6,11,2,201,505,10,82,0,0
792,434,340,632,848,6,11,2,198,508,11,82,0,0
793,445,329,629,810,6,11,2,184,481,12,82,0,0
794,459,321,632,773,6,11,2,173,452,13,82,0,0
795,468,320,636,752,6,11,2,168,432,14,82,0,0
796,462,302,626,719,6,11,2,164,417,15,82,0,0
797,451,290,612,703,6,11,2,161,413,16,82,0,0
798,452,287,605,681,6,11,2,153,394,17,82,0,0
799,460,277,603,653,6,11,2,143,376,18,82,0,0
800,463,273,601,637,6,11,2,138,364,19,82,0,0
801,456,267,593,628,6,11,2,137,361,20,82,0,0
802,441,259,572,603,6,11,2,131,344,21,82,0,0
803,427,256,554,592,6,11,2,127,336,22,82,0,0
804,421,250,544,578,6,11,2,123,328,23,82,0,0
805,423,242,541,562,6,11,2,118,320,24,82,0,0
806,422,243,536,551,6,11,2,114,308,25,82,0,0
807,406,237,517,535,6,11,2,111,298,26,82,0,0
808,388,233,497,527,6,11,2,109,294,27,82,0,0
809,380,231,488,521,6,11,2,108,290,28,82,0,0
810,382,228,484,504,6,11,2,102,276,29,82,0,0
811,383,224,483,496,6,11,2,100,272,30,82,0,0
812,380,225,477,488,6,11,2,97,263,31,82,0,0
813,378,220,470,470,6,11,2,92,250,32,82,0,0
814,377,219,467,462,6,11,2,90,243,33,82,0,0
815,382,214,469,449,6,11,2,87,235,34,82,0,0
816,387,205,472,439,6,11,2,85,234,35,82,0,0
817,389,204,472,433,6,11,2,83,229,36,82,0,0
818,385,200,467,428,6,11,2,82,228,37,82,0,0
819,378,198,460,425,6,11,2,82,227,38,82,0,0
820,377,197,458,420,6,11,2,81,223,39,82,0,0
821,382,197,457,408,6,11,2,75,211,40,82,0,0
822,382,198,455,401,6,11,2,73,203,41,82,0,0
823,377,198,448,397,6,11,2,71,199,42,82,0,0
824,371,195,440,392,6,11,2,69,197,43,82,0,0
825,367,195,436,390,6,11,2,69,195,44,82,0,0
826,366,186,435,382,6,11,2,69,196,45,82,0,0
827,366,181,434,377,6,11,2,68,196,46,82,0,0
828,363,181,430,374,6,11,2,67,193,47,82,0,0
829,356,180,421,367,6,11,2,65,187,48,82,0,0
830,350,179,414,364,6,11,2,64,185,49,82,0,0
831,348,178,410,360,6,11,2,62,182,50,82,0,0
832,347,178,406,355,6,11,2,59,177,51,82,0,0
833,343,178,401,351,6,11,2,58,173,52,82,0,0
834,337,178,394,348,6,11,2,57,170,53,82,0,0
835,332,181,386,343,6,11,2,54,162,54,82,0,0
836,328,179,381,342,6,11,2,53,163,55,82,0,0
837,329,180,380,334,6,11,2,51,154,56,82,0,0
838,326,178,376,331,6,11,2,50,153,57,82,0,0
839,321,177,371,331,6,11,2,50,154,58,82,0,0
840,317,175,365,324,6,11,2,48,149,59,82,0,0
841,312,174,360,324,6,11,2,48,150,60,82,0,0
842,311,172,357,320,6,11,2,46,148,61,82,0,0
843,310,169,356,317,6,11,2,46,148,62,82,0,0
844,309,172,353,314,6,11,2,44,142,63,82,0,0
845,302,169,346,310,6,11,2,44,141,64,82,0,0
846,296,166,341,309,6,11,2,45,143,65,82,0,0
847,295,164,338,305,6,11,2,43,141,66,82,0,0
848,294,162,336,302,6,11,2,42,140,67,82,0,0
849,291,163,333,301,6,11,2,42,138,68,82,0,0
850,288,161,329,298,6,11,2,41,137,69,82,0,0
851,285,160,326,297,6,11,2,41,137,70,82,0,0
852,282,157,323,296,6,11,2,41,139,71,82,0,0
853,283,155,323,289,6,11,2,40,134,72,82,0,0
854,285,155,324,287,6,11,2,39,132,73,82,0,0
855,283,154,322,287,6,11,2,39,133,74,82,0,0
856,279,150,320,287,6,11,2,41,137,75,82,0,0
857,277,152,316,285,6,11,2,39,133,76,82,0,0
858,277,154,313,279,6,11,2,36,125,77,82,0,0
859,277,153,313,277,6,11,2,36,124,78,82,0,0
860,276,152,314,281,6,11,2,38,129,79,82,0,0
861,276,151,314,279,6,11,2,38,128,80,82,0,0
862,276,152,312,276,6,11,2,36,124,81,82,0,0
863,277,152,312,272,6,11,2,35,120,82,82,1,0
866,282,148,317,269,6,11,2,35,121,0,82,0,0
883,3,620,217,1072,7,11,2,214,452,0,76,0,1
884,38,589,266,1073,7,11,2,228,484,1,76,0,0
885,105,557,352,1077,7,11,2,247,520,2,76,0,0
886,195,542,451,1079,7,11,2,256,537,3,76,0,0
887,243,514,508,1071,7,11,2,265,557,4,76,0,0
888,279,488,552,1068,7,11,2,273,580,5,76,0,0
889,302,465,580,1063,7,11,2,278,598,6,76,0,0
890,332,438,590,1000,7,11,2,258,562,7,76,0,0
891,351,421,602,971,7,11,2,251,550,8,76,0,0
892,366,396,602,924,7,11,2,236,528,9,76,0,0
893,376,378,593,870,7,11,2,217,492,10,76,0,0
894,372,368,582,850,7,11,2,210,482,11,76,0,0
895,357,348,551,800,7,11,2,194,452,12,76,0,0
896,336,333,522,776,7,11,2,186,443,13,76,0,0
897,329,331,503,752,7,11,2,174,421,14,76,0,0
898,322,317,482,711,7,11,2,160,394,15,76,0,0
899,318,313,469,690,7,11,2,151,377,16,76,0,0
900,308,302,449,659,7,11,2,141,357,17,76,0,0
901,296,293,432,644,7,11,2,136,351,18,76,0,0
902,290,290,422,639,7,11,2,132,349,19,76,0,0
903,294,282,415,607,7,11,2,121,325,20,76,0,0
904,296,274,412,589,7,11,2,116,315,21,76,0,0
905,294,272,405,575,7,11,2,111,303,22,76,0,0
906,289,265,395,556,7,11,2,106,291,23,76,0,0
907,287,262,390,547,7,11,2,103,285,24,76,0,0
908,292,259,386,523,7,11,2,94,264,25,76,0,0
909,293,252,384,511,7,11,2,91,259,26,76,0,0
910,294,250,383,501,7,11,2,89,251,27,76,0,0
911,289,243,375,488,7,11,2,86,245,28,76,0,0
912,285,237,370,482,7,11,2,85,245,29,76,0,0
913,286,235,370,477,7,11,2,84,242,30,76,0,0
914,287,229,367,463,7,11,2,80,234,31,76,0,0
915,289,227,367,454,7,11,2,78,227,32,76,0,0
916,286,228,359,436,7,11,2,73,208,33,76,0,0
917,281,223,355,436,7,11,2,74,213,34,76,0,0
918,280,225,351,427,7,11,2,71,202,35,76,0,0
919,279,219,349,422,7,11,2,70,203,36,76,0,0
920,277,214,348,417,7,11,2,71,203,37,76,0,0
921,275,212,344,411,7,11,2,69,199,38,76,0,0
922,270,207,338,403,7,11,2,68,196,39,76,0,0
923,267,207,334,402,7,11,2,67,195,40,76,0,0
924,268,206,333,396,7,11,2,65,190,41,76,0,0
925,269,203,333,389,7,11,2,64,186,42,76,0,0
926,270,204,332,384,7,11,2,62,180,43,76,0,0
927,270,203,329,377,7,11,2,59,174,44,76,0,0
928,271,200,329,371,7,11,2,58,171,45,76,0,0
929,274,201,329,365,7,11,2,55,164,46,76,0,0
930,276,193,332,359,7,11,2,56,166,47,76,0,0
931,278,189,335,358,7,11,2,57,169,48,76,0,0
932,278,186,334,356,7,11,2,56,170,49,76,0,0
933,278,187,332,351,7,11,2,54,164,50,76,0,0
934,279,185,333,349,7,11,2,54,164,51,76,0,0
935,283,184,334,340,7,11,2,51,156,52,76,0,0
936,285,183,335,336,7,11,2,50,153,53,76,0,0
937,286,183,335,335,7,11,2,49,152,54,76,0,0
938,284,180,333,328,7,11,2,49,148,55,76,0,0
939,283,178,332,327,7,11,2,49,149,56,76,0,0
940,284,178,331,321,7,11,2,47,143,57,76,0,0
941,285,176,330,315,7,11,2,45,139,58,76,0,0
942,284,176,329,314,7,11,2,45,138,59,76,0,0
943,283,175,327,310,7,11,2,44,135,60,76,0,0
944,281,172,326,308,7,11,2,45,136,61,76,0,0
945,281,172,325,306,7,11,2,44,134,62,76,0,0
946,282,171,325,302,7,11,2,43,131,63,76,0,0
947,283,170,326,302,7,11,2,43,132,64,76,0,0
948,283,171,325,300,7,11,2,42,129,65,76,0,0
949,281,168,323,296,7,11,2,42,128,66,76,0,0
950,281,168,322,294,7,11,2,41,126,67,76,0,0
951,281,167,321,289,7,11,2,40,122,68,76,0,0
952,281,164,322,288,7,11,2,41,124,69,76,0,0
953,282,166,321,286,7,11,2,39,120,70,76,0,0
954,280,165,318,283,7,11,2,38,118,71,76,0,0
955,279,164,317,285,7,11,2,38,121,72,76,0,0
956,279,164,316,282,7,11,2,37,118,73,76,0,0
957,279,161,315,277,7,11,2,36,116,74,76,0,0
958,280,160,315,275,7,11,2,35,115,75,76,0,0
959,279,161,314,273,7,11,2,35,112,76,76,1,0
908,672,434,1291,1055,9,11,2,619,621,0,3,0,0
909,616,402,1220,1037,9,11,2,604,635,1,3,0,0
910,568,377,1148,1016,9,11,2,580,639,2,3,0,0
911,485,338,1097,1012,9,11,2,612,674,3,3,0,0
911,738,359,933,983,10,11,2,195,624,0,83,0,1
912,711,344,888,910,10,11,2,177,566,1,83,0,0
913,694,330,876,910,10,11,2,182,580,2,83,0,0
914,680,320,852,868,10,11,2,172,548,3,83,0,0
915,657,299,818,812,10,11,2,161,513,4,83,0,0
916,632,290,789,791,10,11,2,157,501,5,83,0,0
917,614,279,761,751,10,11,2,147,472,6,83,0,0
918,597,266,739,719,10,11,2,142,453,7,83,0,0
919,582,262,719,701,10,11,2,137,439,8,83,0,0
920,571,257,698,667,10,11,2,127,410,9,83,0,0
921,553,247,677,645,10,11,2,124,398,10,83,0,0
922,540,244,661,637,10,11,2,121,393,11,83,0,0
923,527,235,642,608,10,11,2,115,373,12,83,0,0
924,513,227,626,595,10,11,2,113,368,13,83,0,0
925,506,228,614,585,10,11,2,108,357,14,83,0,0
926,501,219,604,560,10,11,2,103,341,15,83,0,0
927,493,214,594,548,10,11,2,101,334,16,83,0,0
928,484,214,582,539,10,11,2,98,325,17,83,0,0
929,476,212,568,520,10,11,2,92,308,18,83,0,0
930,469,209,560,512,10,11,2,91,303,19,83,0,0
931,467,210,556,505,10,11,2,89,295,20,83,0,0
932,466,206,551,487,10,11,2,85,281,21,83,0,0
933,459,204,541,478,10,11,2,82,274,22,83,0,0
934,452,202,533,471,10,11,2,81,269,23,83,0,0
935,448,196,526,455,10,11,2,78,259,24,83,0,0
936,444,194,521,449,10,11,2,77,255,25,83,0,0
937,445,197,519,439,10,11,2,74,242,26,83,0,0
938,444,191,517,429,10,11,2,73,238,27,83,0,0
939,441,192,511,423,10,11,2,70,231,28,83,0,0
940,437,191,505,414,10,11,2,68,223,29,83,0,0
941,432,182,500,407,10,11,2,68,225,30,83,0,0
942,427,178,495,404,10,11,2,68,226,31,83,0,0
943,427,179,489,388,10,11,2,62,209,32,83,0,0
944,421,174,485,387,10,11,2,64,213,33,83,0,0
945,416,173,479,385,10,11,2,63,212,34,83,0,0
946,411,170,472,377,10,11,2,61,207,35,83,0,0
947,407,169,467,371,10,11,2,60,202,36,83,0,0
948,404,172,463,370,10,11,2,59,198,37,83,0,0
949,402,171,459,361,10,11,2,57,190,38,83,0,0
950,398,169,455,357,10,11,2,57,188,39,83,0,0
951,397,169,453,357,10,11,2,56,188,40,83,0,0
952,393,167,448,353,10,11,2,55,186,41,83,0,0
953,391,168,444,347,10,11,2,53,179,42,83,0,0
954,391,169,443,345,10,11,2,52,176,43,83,0,0
955,391,168,442,339,10,11,2,51,171,44,83,0,0
956,388,166,439,332,10,11,2,51,166,45,83,0,0
957,386,167,436,331,10,11,2,50,164,46,83,0,0
958,383,164,432,328,10,11,2,49,164,47,83,0,0
959,382,162,430,322,10,11,2,48,160,48,83,0,0
960,381,162,429,320,10,11,2,48,158,49,83,0,0
961,380,161,427,316,10,11,2,47,155,50,83,0,0
962,376,157,424,316,10,11,2,48,159,51,83,0,0
963,374,156,422,316,10,11,2,48,160,52,83,0,0
964,373,154,421,310,10,11,2,48,156,53,83,0,0
965,373,154,419,307,10,11,2,46,153,54,83,0,0
966,373,154,418,303,10,11,2,45,149,55,83,0,0
967,372,151,416,298,10,11,2,44,147,56,83,0,0
968,370,151,414,295,10,11,2,44,144,57,83,0,0
969,366,152,410,295,10,11,2,44,143,58,83,0,0
970,362,149,406,292,10,11,2,44,143,59,83,0,0
971,359,149,402,288,10,11,2,43,139,60,83,0,0
972,358,149,400,287,10,11,2,42,138,61,83,0,0
973,356,148,398,282,10,11,2,42,134,62,83,0,0
974,355,146,397,280,10,11,2,42,134,63,83,0,0
975,354,146,396,280,10,11,2,42,134,64,83,0,0
976,353,143,395,277,10,11,2,42,134,65,83,0,0
977,353,144,394,274,10,11,2,41,130,66,83,0,0
978,355,145,396,274,10,11,2,41,129,67,83,0,0
979,356,144,397,272,10,11,2,41,128,68,83,0,0
980,355,143,397,270,10,11,2,42,127,69,83,0,0
981,356,144,397,271,10,11,2,41,127,70,83,0,0
982,357,143,398,269,10,11,2,41,126,71,83,0,0
983,357,143,397,265,10,11,2,40,122,72,83,0,0
984,358,144,396,261,10,11,2,38,117,73,83,0,0
985,356,143,395,261,10,11,2,39,118,74,83,0,0
986,355,143,394,262,10,11,2,39,119,75,83,0,0
987,352,142,392,260,10,11,2,40,118,76,83,0,0
988,351,143,390,259,10,11,2,39,116,77,83,0,0
989,350,145,388,257,10,11,2,38,112,78,83,0,0
990,350,145,385,251,10,11,2,35,106,79,83,0,0
991,348,145,383,250,10,11,2,35,105,80,83,0,0
992,346,144,382,251,10,11,2,36,107,81,83,0,0
993,345,145,380,249,10,11,2,35,104,82,83,0,0
994,344,144,379,248,10,11,2,35,104,83,83,1,0
996,344,143,379,245,10,11,2,35,102,0,83,0,0
997,344,141,379,245,10,11,2,35,104,1,83,0,0
1010,335,133,371,227,10,11,2,36,94,0,83,0,0
1011,333,130,370,226,10,11,2,37,96,1,83,0,0
1012,331,128,369,225,10,11,2,38,97,2,83,0,0
1013,333,130,369,224,10,11,2,36,94,3,83,0,0
1014,331,128,369,225,10,11,2,38,97,4,83,0,0
1015,330,127,368,225,10,11,2,38,98,5,83,0,0
1016,330,128,367,223,10,11,2,37,95,6,83,0,0
1017,330,126,365,220,10,11,2,35,94,7,83,0,0
1088,4,614,208,1077,13,11,2,204,463,0,64,0,1
1089,47,577,267,1073,13,11,2,220,496,1,64,0,0
1090,99,516,346,1072,13,11,2,247,556,2,64,0,0
1091,188,480,452,1066,13,11,2,264,586,3,64,0,0
1092,241,447,517,1057,13,11,2,276,610,4,64,0,0
1093,279,404,562,1029,13,11,2,283,625,5,64,0,0
1094,309,382,588,1004,13,11,2,279,622,6,64,0,0
1095,337,348,590,916,13,11,2,253,568,7,64,0,0
1096,350,334,588,874,13,11,2,238,540,8,64,0,0
1097,370,317,591,822,13,11,2,221,505,9,64,0,0
1098,387,296,589,762,13,11,2,202,466,10,64,0,0
1099,387,292,577,736,13,11,2,190,444,11,64,0,0
1100,389,275,562,685,13,11,2,173,410,12,64,0,0
1101,381,265,549,666,13,11,2,168,401,13,64,0,0
1102,381,261,538,642,13,11,2,157,381,14,64,0,0
1103,376,245,523,603,13,11,2,147,358,15,64,0,0
1104,371,243,512,588,13,11,2,141,345,16,64,0,0
1105,368,235,502,564,13,11,2,134,329,17,64,0,0
1106,365,230,492,546,13,11,2,127,316,18,64,0,0
1107,363,227,482,527,13,11,2,119,300,19,64,0,0
1108,364,219,474,501,13,11,2,110,282,20,64,0,0
1109,362,217,468,492,13,11,2,106,275,21,64,0,0
1110,364,217,460,471,13,11,2,96,254,22,64,0,0
1111,361,210,454,457,13,11,2,93,247,23,64,0,0
1112,361,210,451,454,13,11,2,90,244,24,64,0,0
1113,361,203,448,439,13,11,2,87,236,25,64,0,0
1114,363,201,446,430,13,11,2,83,229,26,64,0,0
1115,360,199,441,423,13,11,2,81,224,27,64,0,0
1116,357,196,436,412,13,11,2,79,216,28,64,0,0
1117,357,199,431,405,13,11,2,74,206,29,64,0,0
1118,357,193,429,393,13,11,2,72,200,30,64,0,0
1119,356,188,429,388,13,11,2,73,200,31,64,0,0
1120,354,189,424,382,13,11,2,70,193,32,64,0,0
1121,349,179,419,374,13,11,2,70,195,33,64,0,0
1122,346,178,415,370,13,11,2,69,192,34,64,0,0
1123,345,173,413,362,13,11,2,68,189,35,64,0,0
1124,343,171,409,357,13,11,2,66,186,36,64,0,0
1125,343,173,406,353,13,11,2,63,180,37,64,0,0
1126,340,172,401,346,13,11,2,61,174,38,64,0,0
1127,338,170,397,342,13,11,2,59,172,39,64,0,0
1128,339,170,394,333,13,11,2,55,163,40,64,0,0
1129,338,167,392,329,13,11,2,54,162,41,64,0,0
1130,337,169,391,329,13,11,2,54,160,42,64,0,0
1131,335,167,387,322,13,11,2,52,155,43,64,0,0
1132,331,164,382,317,13,11,2,51,153,44,64,0,0
1133,331,170,378,311,13,11,2,47,141,45,64,0,0
1134,330,165,378,307,13,11,2,48,142,46,64,0,0
1135,329,166,375,304,13,11,2,46,138,47,64,0,0
1136,328,167,373,299,13,11,2,45,132,48,64,0,0
1137,324,163,371,298,13,11,2,47,135,49,64,0,0
1138,325,166,368,291,13,11,2,43,125,50,64,0,0
1139,326,163,371,292,13,11,2,45,129,51,64,0,0
1140,325,161,370,291,13,11,2,45,130,52,64,0,0
1141,322,157,367,287,13,11,2,45,130,53,64,0,0
1142,320,153,364,282,13,11,2,44,129,54,64,0,0
1143,319,154,362,281,13,11,2,43,127,55,64,0,0
1144,318,148,361,278,13,11,2,43,130,56,64,0,0
1145,319,150,360,275,13,11,2,41,125,57,64,0,0
1146,319,152,359,273,13,11,2,40,121,58,64,0,0
1147,317,150,356,268,13,11,2,39,118,59,64,0,0
1148,315,155,351,262,13,11,2,36,107,60,64,0,0
1149,315,152,352,263,13,11,2,37,111,61,64,0,0
1150,314,145,352,260,13,11,2,38,115,62,64,0,0
1151,313,146,351,260,13,11,2,38,114,63,64,0,0
1152,310,145,347,257,13,11,2,37,112,64,64,1,0
1155,307,144,342,248,13,11,2,35,104,0,64,0,0
1159,306,134,341,239,13,11,2,35,105,0,64,0,0
1164,297,120,333,233,13,11,2,36,113,0,64,0,0
1165,295,120,330,231,13,11,2,35,111,1,64,0,0
1151,818,349,880,477,15,11,2,62,128,0,5,0,0
1152,818,349,880,477,15,11,2,62,128,1,5,0,0
1153,817,349,879,476,15,11,2,62,127,2,5,0,0
1154,817,349,879,476,15,11,2,62,127,3,5,0,0
1155,818,349,879,476,15,11,2,61,127,4,5,0,0
1156,818,349,879,476,15,11,2,61,127,5,5,0,0
1457,327,140,364,266,19,11,2,37,126,0,57,0,1
1458,327,141,365,268,19,11,2,38,127,1,57,0,0
1459,329,142,367,270,19,11,2,38,128,2,57,0,0
1460,331,144,369,272,19,11,2,38,128,3,57,0,0
1461,331,143,371,275,19,11,2,40,132,4,57,0,0
1462,331,146,371,279,19,11,2,40,133,5,57,0,0
1463,331,147,371,279,19,11,2,40,132,6,57,0,0
1464,331,152,371,283,19,11,2,40,131,7,57,0,0
1465,330,150,372,288,19,11,2,42,138,8,57,0,0
1466,331,151,373,290,19,11,2,42,139,9,57,0,0
1467,330,154,374,295,19,11,2,44,141,10,57,0,0
1468,329,154,373,297,19,11,2,44,143,11,57,0,0
1469,330,155,374,300,19,11,2,44,145,12,57,0,0
1470,330,155,376,306,19,11,2,46,151,13,57,0,0
1471,330,158,378,313,19,11,2,48,155,14,57,0,0
1472,330,159,379,315,19,11,2,49,156,15,57,0,0
1473,330,163,380,324,19,11,2,50,161,16,57,0,0
1474,331,162,384,331,19,11,2,53,169,17,57,0,0
1475,331,161,384,333,19,11,2,53,172,18,57,0,0
1476,330,169,382,336,19,11,2,52,167,19,57,0,0
1477,327,169,382,342,19,11,2,55,173,20,57,0,0
1478,327,172,383,351,19,11,2,56,179,21,57,0,0
1479,327,173,385,356,19,11,2,58,183,22,57,0,0
1480,326,175,385,362,19,11,2,59,187,23,57,0,0
1481,325,176,386,369,19,11,2,61,193,24,57,0,0
1482,324,176,387,377,19,11,2,63,201,25,57,0,0
1483,324,177,390,385,19,11,2,66,208,26,57,0,0
1484,326,174,395,392,19,11,2,69,218,27,57,0,0
1485,328,184,397,399,19,11,2,69,215,28,57,0,0
1486,327,184,398,405,19,11,2,71,221,29,57,0,0
1487,326,185,400,418,19,11,2,74,233,30,57,0,0
1488,329,190,406,429,19,11,2,77,239,31,57,0,0
1489,330,188,412,442,19,11,2,82,254,32,57,0,0
1490,329,193,414,456,19,11,2,85,263,33,57,0,0
1491,330,194,418,466,19,11,2,88,272,34,57,0,0
1492,332,197,425,485,19,11,2,93,288,35,57,0,0
1493,339,203,433,494,19,11,2,94,291,36,57,0,0
1494,342,206,442,511,19,11,2,100,305,37,57,0,0
1495,346,212,451,531,19,11,2,105,319,38,57,0,0
1496,348,215,457,547,19,11,2,109,332,39,57,0,0
1497,350,225,463,570,19,11,2,113,345,40,57,0,0
1498,358,230,477,588,19,11,2,119,358,41,57,0,0
1499,361,238,490,621,19,11,2,129,383,42,57,0,0
1500,360,242,497,647,19,11,2,137,405,43,57,0,0
1501,354,252,498,674,19,11,2,144,422,44,57,0,0
1502,355,264,505,703,19,11,2,150,439,45,57,0,0
1503,356,264,520,742,19,11,2,164,478,46,57,0,0
1504,350,281,529,804,19,11,2,179,523,47,57,0,0
1505,343,296,527,830,19,11,2,184,534,48,57,0,0
1506,325,314,525,888,19,11,2,200,574,49,57,0,0
1507,318,335,535,948,19,11,2,217,613,50,57,0,0
1508,300,353,535,1018,19,11,2,235,665,51,57,0,0
1509,279,383,520,1058,19,11,2,241,675,52,57,0,0
1510,225,412,468,1075,19,11,2,243,663,53,57,0,0
1511,161,452,404,1080,19,11,2,243,628,54,57,0,0
1512,100,496,335,1080,19,11,2,235,584,55,57,0,0
1513,33,560,245,1080,19,11,2,212,520,56,57,0,0
1514,13,581,225,1080,19,11,2,212,499,57,57,1,0
1593,3,691,173,1078,20,11,2,170,387,0,108,0,1
1594,13,503,265,1076,20,11,2,252,573,1,108,0,0
1595,30,472,297,1075,20,11,2,267,603,2,108,0,0
1596,51,445,328,1070,20,11,2,277,625,3,108,0,0
1597,83,412,372,1066,20,11,2,289,654,4,108,0,0
1598,147,389,442,1053,20,11,2,295,664,5,108,0,0
1599,188,377,489,1060,20,11,2,301,683,6,108,0,0
1600,220,350,516,1034,20,11,2,296,684,7,108,0,0
1601,244,333,531,1007,20,11,2,287,674,8,108,0,0
1602,263,327,544,996,20,11,2,281,669,9,108,0,0
1603,286,320,551,961,20,11,2,265,641,10,108,0,0
1604,309,306,553,902,20,11,2,244,596,11,108,0,0
1605,318,299,553,884,20,11,2,235,585,12,108,0,0
1606,332,289,553,850,20,11,2,221,561,13,108,0,0
1607,343,265,556,815,20,11,2,213,550,14,108,0,0
1608,351,260,549,776,20,11,2,198,516,15,108,0,0
1609,351,261,541,763,20,11,2,190,502,16,108,0,0
1610,351,254,527,723,20,11,2,176,469,17,108,0,0
1611,347,244,517,702,20,11,2,170,458,18,108,0,0
1612,349,241,514,694,20,11,2,165,453,19,108,0,0
1613,354,232,513,673,20,11,2,159,441,20,108,0,0
1614,360,225,508,644,20,11,2,148,419,21,108,0,0
1615,361,226,503,632,20,11,2,142,406,22,108,0,0
1616,358,224,492,607,20,11,2,134,383,23,108,0,0
1617,355,220,482,584,20,11,2,127,364,24,108,0,0
1618,353,216,477,576,20,11,2,124,360,25,108,0,0
1619,354,215,475,567,20,11,2,121,352,26,108,0,0
1620,355,208,472,550,20,11,2,117,342,27,108,0,0
1621,353,203,466,535,20,11,2,113,332,28,108,0,0
1622,348,204,458,528,20,11,2,110,324,29,108,0,0
1623,342,199,446,510,20,11,2,104,311,30,108,0,0
1624,338,194,439,497,20,11,2,101,303,31,108,0,0
1625,336,192,435,489,20,11,2,99,297,32,108,0,0
1626,338,193,433,478,20,11,2,95,285,33,108,0,0
1627,337,189,430,470,20,11,2,93,281,34,108,0,0
1628,338,191,428,463,20,11,2,90,272,35,108,0,0
1629,335,194,421,454,20,11,2,86,260,36,108,0,0
1630,334,193,416,444,20,11,2,82,251,37,108,0,0
1631,332,191,413,437,20,11,2,81,246,38,108,0,0
1632,334,191,412,430,20,11,2,78,239,39,108,0,0
1633,335,185,413,424,20,11,2,78,239,40,108,0,0
1634,335,179,412,416,20,11,2,77,237,41,108,0,0
1635,333,184,407,410,20,11,2,74,226,42,108,0,0
1636,327,175,400,402,20,11,2,73,227,43,108,0,0
1637,323,170,396,397,20,11,2,73,227,44,108,0,0
1638,323,171,394,396,20,11,2,71,225,45,108,0,0
1639,324,169,394,393,20,11,2,70,224,46,108,0,0
1640,324,169,393,387,20,11,2,69,218,47,108,0,0
1641,325,171,391,382,20,11,2,66,211,48,108,0,0
1642,324,172,388,377,20,11,2,64,205,49,108,0,0
1643,323,170,384,368,20,11,2,61,198,50,108,0,0
1644,323,171,383,364,20,11,2,60,193,51,108,0,0
1645,325,171,385,362,20,11,2,60,191,52,108,0,0
1646,326,169,385,358,20,11,2,59,189,53,108,0,0
1647,327,166,385,353,20,11,2,58,187,54,108,0,0
1648,328,168,384,351,20,11,2,56,183,55,108,0,0
1649,327,167,383,346,20,11,2,56,179,56,108,0,0
1650,327,163,383,339,20,11,2,56,176,57,108,0,0
1651,328,162,383,336,20,11,2,55,174,58,108,0,0
1652,328,158,384,334,20,11,2,56,176,59,108,0,0
1653,328,154,384,329,20,11,2,56,175,60,108,0,0
1654,328,153,384,327,20,11,2,56,174,61,108,0,0
1655,328,154,382,325,20,11,2,54,171,62,108,0,0
1656,327,154,380,321,20,11,2,53,167,63,108,0,0
1657,327,153,380,318,20,11,2,53,165,64,108,0,0
1658,328,152,381,316,20,11,2,53,164,65,108,0,0
1659,329,150,381,313,20,11,2,52,163,66,108,0,0
1660,330,150,381,309,20,11,2,51,159,67,108,0,0
1661,331,153,380,305,20,11,2,49,152,68,108,0,0
1662,330,154,377,300,20,11,2,47,146,69,108,0,0
1663,328,152,375,297,20,11,2,47,145,70,108,0,0
1664,328,152,374,295,20,11,2,46,143,71,108,0,0
1665,329,149,375,294,20,11,2,46,145,72,108,0,0
1666,330,145,377,291,20,11,2,47,146,73,108,0,0
1667,330,146,375,289,20,11,2,45,143,74,108,0,0
1668,328,147,373,289,20,11,2,45,142,75,108,0,0
1669,326,148,370,285,20,11,2,44,137,76,108,0,0
1670,324,145,368,284,20,11,2,44,139,77,108,0,0
1671,324,145,367,281,20,11,2,43,136,78,108,0,0
1672,324,142,367,279,20,11,2,43,137,79,108,0,0
1673,324,141,366,277,20,11,2,42,136,80,108,0,0
1674,324,145,364,276,20,11,2,40,131,81,108,0,0
1675,322,144,361,272,20,11,2,39,128,82,108,0,0
1676,321,142,360,270,20,11,2,39,128,83,108,0,0
1677,321,141,360,269,20,11,2,39,128,84,108,0,0
1678,322,139,361,267,20,11,2,39,128,85,108,0,0
1679,324,138,363,265,20,11,2,39,127,86,108,0,0
1680,325,138,363,263,20,11,2,38,125,87,108,0,0
1681,323,136,361,262,20,11,2,38,126,88,108,0,0
1682,322,134,360,259,20,11,2,38,125,89,108,0,0
1683,322,133,360,257,20,11,2,38,124,90,108,0,0
1684,325,134,361,255,20,11,2,36,121,91,108,0,0
1685,326,132,364,255,20,11,2,38,123,92,108,0,0
1686,326,132,364,255,20,11,2,38,123,93,108,0,0
1687,326,132,363,255,20,11,2,37,123,94,108,0,0
1688,324,130,361,253,20,11,2,37,123,95,108,0,0
1689,324,130,360,251,20,11,2,36,121,96,108,0,0
1690,325,131,361,249,20,11,2,36,118,97,108,0,0
1691,326,132,361,248,20,11,2,35,116,98,108,0,0
1692,326,133,361,246,20,11,2,35,113,99,108,0,0
1693,326,133,361,245,20,11,2,35,112,100,108,0,0
1694,324,130,360,245,20,11,2,36,115,101,108,0,0
1695,324,132,359,243,20,11,2,35,111,102,108,0,0
1696,323,129,359,242,20,11,2,36,113,103,108,0,0
1697,324,131,359,241,20,11,2,35,110,104,108,0,0
1698,324,129,359,239,20,11,2,35,110,105,108,0,0
1699,323,130,358,238,20,11,2,35,108,106,108,0,0
1700,321,128,357,238,20,11,2,36,110,107,108,0,0
1701,322,126,357,235,20,11,2,35,109,108,108,1,0
1706,322,128,357,228,20,11,2,35,100,0,108,0,0
1711,322,124,357,224,20,11,2,35,100,0,108,0,0
1712,322,125,357,224,20,11,2,35,99,1,108,0,0
1714,321,123,357,222,20,11,2,36,99,0,108,0,0
1715,322,124,357,218,20,11,2,35,94,1,108,0,0
1716,321,123,356,219,20,11,2,35,96,2,108,0,0
1717,321,121,357,217,20,11,2,36,96,3,108,0,0
1718,320,121,355,217,20,11,2,35,96,4,108,0,0
1720,313,122,348,218,20,11,2,35,96,0,108,0,0
1960,352,156,388,252,21,11,2,36,96,0,1,0,0
1961,353,158,390,254,21,11,2,37,96,1,1,0,0
2000,348,154,384,270,24,11,2,36,116,0,66,0,1
2001,350,157,386,274,24,11,2,36,117,1,66,0,0
2002,351,158,387,275,24,11,2,36,117,2,66,0,0
2003,350,157,388,283,24,11,2,38,126,3,66,0,0
2004,351,156,391,289,24,11,2,40,133,4,66,0,0
2005,352,153,393,290,24,11,2,41,137,5,66,0,0
2006,353,159,394,295,24,11,2,41,136,6,66,0,0
2007,355,163,395,296,24,11,2,40,133,7,66,0,0
2008,354,164,394,299,24,11,2,40,135,8,66,0,0
2009,356,167,395,299,24,11,2,39,132,9,66,0,0
2010,359,168,398,300,24,11,2,39,132,10,66,0,0
2011,358,167,399,306,24,11,2,41,139,11,66,0,0
2012,357,168,398,309,24,11,2,41,141,12,66,0,0
2013,356,167,398,313,24,11,2,42,146,13,66,0,0
2014,356,168,399,318,24,11,2,43,150,14,66,0,0
2015,357,168,401,319,24,11,2,44,151,15,66,0,0
2016,358,173,402,327,24,11,2,44,154,16,66,0,0
2017,359,172,403,329,24,11,2,44,157,17,66,0,0
2018,359,174,405,336,24,11,2,46,162,18,66,0,0
2019,362,173,410,341,24,11,2,48,168,19,66,0,0
2020,366,172,416,347,24,11,2,50,175,20,66,0,0
2021,367,174,418,355,24,11,2,51,181,21,66,0,0
2022,368,174,420,357,24,11,2,52,183,22,66,0,0
2023,369,178,422,363,24,11,2,53,185,23,66,0,0
2024,373,180,428,368,24,11,2,55,188,24,66,0,0
2025,377,180,432,370,24,11,2,55,190,25,66,0,0
2026,379,185,435,380,24,11,2,56,195,26,66,0,0
2027,380,183,438,387,24,11,2,58,204,27,66,0,0
2028,382,189,442,396,24,11,2,60,207,28,66,0,0
2029,387,190,447,400,24,11,2,60,210,29,66,0,0
2030,390,191,451,404,24,11,2,61,213,30,66,0,0
2031,395,196,457,414,24,11,2,62,218,31,66,0,0
2032,398,199,463,424,24,11,2,65,225,32,66,0,0
2033,403,204,470,432,24,11,2,67,228,33,66,0,0
2034,409,206,477,437,24,11,2,68,231,34,66,0,0
2035,414,208,484,448,24,11,2,70,240,35,66,0,0
2036,420,215,491,454,24,11,2,71,239,36,66,0,0
2037,424,212,500,466,24,11,2,76,254,37,66,0,0
2038,430,212,510,481,24,11,2,80,269,38,66,0,0
2039,440,217,520,485,24,11,2,80,268,39,66,0,0
2040,444,225,527,500,24,11,2,83,275,40,66,0,0
2041,445,231,531,515,24,11,2,86,284,41,66,0,0
2042,450,236,539,530,24,11,2,89,294,42,66,0,0
2043,454,242,548,549,24,11,2,94,307,43,66,0,0
2044,460,242,559,559,24,11,2,99,317,44,66,0,0
2045,461,254,565,590,24,11,2,104,336,45,66,0,0
2046,466,263,573,607,24,11,2,107,344,46,66,0,0
2047,475,270,590,638,24,11,2,115,368,47,66,0,0
2048,484,278,604,661,24,11,2,120,383,48,66,0,0
2049,495,281,621,680,24,11,2,126,399,49,66,0,0
2050,501,295,634,721,24,11,2,133,426,50,66,0,0
2051,514,304,651,742,24,11,2,137,438,51,66,0,0
2052,518,315,664,778,24,11,2,146,463,52,66,0,0
2053,528,332,680,813,24,11,2,152,481,53,66,0,0
2054,538,343,698,844,24,11,2,160,501,54,66,0,0
2055,542,368,714,902,24,11,2,172,534,55,66,0,0
2056,545,389,722,935,24,11,2,177,546,56,66,0,0
2057,537,405,726,986,24,11,2,189,581,57,66,0,0
2058,542,426,742,1040,24,11,2,200,614,58,66,0,0
2059,555,437,763,1067,24,11,2,208,630,59,66,0,0
2060,576,468,782,1080,24,11,2,206,612,60,66,0,0
2061,610,501,813,1080,24,11,2,203,579,61,66,0,0
2062,647,533,848,1080,24,11,2,201,547,62,66,0,0
2063,702,582,896,1080,24,11,2,194,498,63,66,0,0
2064,778,627,969,1080,24,11,2,191,453,64,66,0,0
2065,851,699,1035,1080,24,11,2,184,381,65,66,0,0
2066,885,728,1062,1080,24,11,2,177,352,66,66,1,0
1912,322,132,358,210,26,11,2,36,78,0,1,0,0
1913,318,131,354,209,26,11,2,36,78,1,1,0,0
1940,332,136,367,251,27,11,2,35,115,0,63,0,0
1941,333,135,369,254,27,11,2,36,119,1,63,0,0
1942,328,128,363,243,27,11,2,35,115,2,63,0,0
1943,328,136,364,253,27,11,2,36,117,3,63,0,0
1945,329,142,365,259,27,11,2,36,117,0,63,0,0
1946,328,140,366,263,27,11,2,38,123,1,63,0,0
1947,328,140,366,264,27,11,2,38,124,2,63,0,0
1948,328,140,367,266,27,11,2,39,126,3,63,0,0
1950,332,145,368,263,27,11,2,36,118,0,63,0,0
1952,338,144,373,262,27,11,2,35,118,0,63,0,0
1953,339,144,374,263,27,11,2,35,119,1,63,0,0
2003,313,152,349,280,27,11,2,36,128,0,63,0,1
2004,313,156,348,285,27,11,2,35,129,1,63,0,0
2005,311,156,347,285,27,11,2,36,129,2,63,0,0
2006,310,165,345,291,27,11,2,35,126,3,63,0,0
2007,307,167,343,296,27,11,2,36,129,4,63,0,0
2008,306,168,342,299,27,11,2,36,131,5,63,0,0
2009,307,170,343,300,27,11,2,36,130,6,63,0,0
2010,307,173,344,304,27,11,2,37,131,7,63,0,0
2011,307,178,344,306,27,11,2,37,128,8,63,0,0
2012,306,176,346,311,27,11,2,40,135,9,63,0,0
2013,306,169,350,317,27,11,2,44,148,10,63,0,0
2014,309,171,355,325,27,11,2,46,154,11,63,0,0
2015,311,173,358,328,27,11,2,47,155,12,63,0,0
2016,310,178,358,333,27,11,2,48,155,13,63,0,0
2017,308,182,355,334,27,11,2,47,152,14,63,0,0
2018,309,182,359,339,27,11,2,50,157,15,63,0,0
2019,310,184,361,348,27,11,2,51,164,16,63,0,0
2020,311,184,364,351,27,11,2,53,167,17,63,0,0
2021,311,184,366,356,27,11,2,55,172,18,63,0,0
2022,310,184,367,364,27,11,2,57,180,19,63,0,0
2023,310,183,370,370,27,11,2,60,187,20,63,0,0
2024,314,189,374,374,27,11,2,60,185,21,63,0,0
2025,316,188,377,377,27,11,2,61,189,22,63,0,0
2026,316,195,377,387,27,11,2,61,192,23,63,0,0
2027,317,198,379,393,27,11,2,62,195,24,63,0,0
2028,319,200,382,400,27,11,2,63,200,25,63,0,0
2029,323,203,387,407,27,11,2,64,204,26,63,0,0
2030,323,204,388,410,27,11,2,65,206,27,63,0,0
2031,323,208,391,422,27,11,2,68,214,28,63,0,0
2032,322,207,392,429,27,11,2,70,222,29,63,0,0
2033,321,212,393,439,27,11,2,72,227,30,63,0,0
2034,323,220,398,453,27,11,2,75,233,31,63,0,0
2035,323,218,401,461,27,11,2,78,243,32,63,0,0
2036,321,225,401,475,27,11,2,80,250,33,63,0,0
2037,318,227,400,484,27,11,2,82,257,34,63,0,0
2038,318,229,403,499,27,11,2,85,270,35,63,0,0
2039,321,240,408,512,27,11,2,87,272,36,63,0,0
2040,325,240,416,522,27,11,2,91,282,37,63,0,0
2041,325,244,422,545,27,11,2,97,301,38,63,0,0
2042,327,247,427,561,27,11,2,100,314,39,63,0,0
2043,333,253,435,575,27,11,2,102,322,40,63,0,0
2044,340,264,445,596,27,11,2,105,332,41,63,0,0
2045,344,264,454,608,27,11,2,110,344,42,63,0,0
2046,346,274,463,638,27,11,2,117,364,43,63,0,0
2047,355,281,478,657,27,11,2,123,376,44,63,0,0
2048,361,286,490,679,27,11,2,129,393,45,63,0,0
2049,367,296,501,708,27,11,2,134,412,46,63,0,0
2050,368,299,507,724,27,11,2,139,425,47,63,0,0
2051,364,319,514,767,27,11,2,150,448,48,63,0,0
2052,358,331,516,800,27,11,2,158,469,49,63,0,0
2053,363,346,529,834,27,11,2,166,488,50,63,0,0
2054,367,367,540,879,27,11,2,173,512,51,63,0,0
2055,372,385,548,901,27,11,2,176,516,52,63,0,0
2056,360,399,555,969,27,11,2,195,570,53,63,0,0
2057,357,427,559,1019,27,11,2,202,592,54,63,0,0
2058,368,442,581,1059,27,11,2,213,617,55,63,0,0
2059,373,474,586,1080,27,11,2,213,606,56,63,0,0
2060,385,506,596,1080,27,11,2,211,574,57,63,0,0
2061,389,549,598,1080,27,11,2,209,531,58,63,0,0
2062,386,621,583,1080,27,11,2,197,459,59,63,0,0
2063,385,674,576,1080,27,11,2,191,406,60,63,0,0
2064,423,778,589,1080,27,11,2,166,302,61,63,0,0
2065,496,888,612,1078,27,11,2,116,190,62,63,0,0
2066,522,940,614,1080,27,11,2,92,140,63,63,1,0
1940,348,168,383,253,35,11,2,35,85,0,48,0,0
1941,346,165,383,256,35,11,2,37,91,1,48,0,0
1965,367,193,416,326,35,11,2,49,133,0,48,0,1
1966,362,174,416,326,35,11,2,54,152,1,48,0,0
1967,362,168,417,324,35,11,2,55,156,2,48,0,0
1968,363,167,419,329,35,11,2,56,162,3,48,0,0
1969,367,166,426,335,35,11,2,59,169,4,48,0,0
1970,369,170,430,344,35,11,2,61,174,5,48,0,0
1971,372,168,435,351,35,11,2,63,183,6,48,0,0
1972,376,169,439,353,35,11,2,63,184,7,48,0,0
1973,376,171,440,356,35,11,2,64,185,8,48,0,0
1974,376,170,443,366,35,11,2,67,196,9,48,0,0
1975,375,173,443,372,35,11,2,68,199,10,48,0,0
1976,380,175,449,375,35,11,2,69,200,11,48,0,0
1977,386,178,456,381,35,11,2,70,203,12,48,0,0
1978,388,180,461,387,35,11,2,73,207,13,48,0,0
1979,384,183,463,400,35,11,2,79,217,14,48,0,0
1980,381,187,465,418,35,11,2,84,231,15,48,0,0
1981,384,190,470,424,35,11,2,86,234,16,48,0,0
1982,387,193,475,435,35,11,2,88,242,17,48,0,0
1983,391,198,478,438,35,11,2,87,240,18,48,0,0
1984,384,196,477,445,35,11,2,93,249,19,48,0,0
1985,385,199,482,458,35,11,2,97,259,20,48,0,0
1986,392,201,492,468,35,11,2,100,267,21,48,0,0
1987,401,207,503,479,35,11,2,102,272,22,48,0,0
1988,400,212,507,496,35,11,2,107,284,23,48,0,0
1989,399,214,510,503,35,11,2,111,289,24,48,0,0
1990,405,223,519,518,35,11,2,114,295,25,48,0,0
1991,414,226,531,529,35,11,2,117,303,26,48,0,0
1992,421,228,543,549,35,11,2,122,321,27,48,0,0
1993,425,236,553,573,35,11,2,128,337,28,48,0,0
1994,425,234,560,585,35,11,2,135,351,29,48,0,0
1995,433,242,572,602,35,11,2,139,360,30,48,0,0
1996,445,246,589,617,35,11,2,144,371,31,48,0,0
1997,453,254,605,649,35,11,2,152,395,32,48,0,0
1998,463,268,622,678,35,11,2,159,410,33,48,0,0
1999,464,270,630,696,35,11,2,166,426,34,48,0,0
2000,470,282,644,727,35,11,2,174,445,35,48,0,0
2001,479,291,659,749,35,11,2,180,458,36,48,0,0
2002,485,300,675,786,35,11,2,190,486,37,48,0,0
2003,473,316,675,837,35,11,2,202,521,38,48,0,0
2004,454,324,665,856,35,11,2,211,532,39,48,0,0
2005,416,339,649,914,35,11,2,233,575,40,48,0,0
2006,394,357,641,956,35,11,2,247,599,41,48,0,0
2007,381,376,632,988,35,11,2,251,612,42,48,0,0
2008,358,394,628,1041,35,11,2,270,647,43,48,0,0
2009,291,417,560,1069,35,11,2,269,652,44,48,0,0
2010,214,430,492,1080,35,11,2,278,650,45,48,0,0
2011,153,459,433,1079,35,11,2,280,620,46,48,0,0
2012,100,474,383,1075,35,11,2,283,601,47,48,0,0
2013,79,486,366,1080,35,11,2,287,594,48,48,1,0
1942,408,420,633,1076,38,11,2,225,656,0,64,0,1
1943,414,390,630,1022,38,11,2,216,632,1,64,0,0
1944,411,379,622,998,38,11,2,211,619,2,64,0,0
1945,394,352,588,920,38,11,2,194,568,3,64,0,0
1946,384,333,573,881,38,11,2,189,548,4,64,0,0
1947,376,324,561,853,38,11,2,185,529,5,64,0,0
1948,357,297,527,786,38,11,2,170,489,6,64,0,0
1949,343,287,506,762,38,11,2,163,475,7,64,0,0
1950,335,281,482,715,38,11,2,147,434,8,64,0,0
1951,325,264,467,685,38,11,2,142,421,9,64,0,0
1952,328,259,468,668,38,11,2,140,409,10,64,0,0
1953,328,241,459,623,38,11,2,131,382,11,64,0,0
1954,321,226,448,607,38,11,2,127,381,12,64,0,0
1955,318,223,437,583,38,11,2,119,360,13,64,0,0
1956,317,215,431,562,38,11,2,114,347,14,64,0,0
1957,319,220,428,551,38,11,2,109,331,15,64,0,0
1958,321,212,423,527,38,11,2,102,315,16,64,0,0
1959,320,206,417,512,38,11,2,97,306,17,64,0,0
1960,317,205,410,499,38,11,2,93,294,18,64,0,0
1961,314,200,401,478,38,11,2,87,278,19,64,0,0
1962,314,201,398,470,38,11,2,84,269,20,64,0,0
1963,316,197,397,457,38,11,2,81,260,21,64,0,0
1964,315,191,394,447,38,11,2,79,256,22,64,0,0
1965,313,193,387,435,38,11,2,74,242,23,64,0,0
1966,307,190,378,423,38,11,2,71,233,24,64,0,0
1967,303,187,374,418,38,11,2,71,231,25,64,0,0
1968,301,181,373,415,38,11,2,72,234,26,64,0,0
1969,297,172,367,404,38,11,2,70,232,27,64,0,0
1970,294,187,358,396,38,11,2,64,209,28,64,0,0
1971,289,177,352,387,38,11,2,63,210,29,64,0,0
1972,282,165,347,383,38,11,2,65,218,30,64,0,0
1973,281,170,342,377,38,11,2,61,207,31,64,0,0
1974,280,167,339,367,38,11,2,59,200,32,64,0,0
1975,279,163,336,362,38,11,2,57,199,33,64,0,0
1976,279,165,333,354,38,11,2,54,189,34,64,0,0
1977,278,167,330,350,38,11,2,52,183,35,64,0,0
1978,279,170,329,345,38,11,2,50,175,36,64,0,0
1979,279,149,333,339,38,11,2,54,190,37,64,0,0
1980,280,158,330,334,38,11,2,50,176,38,64,0,0
1981,283,162,330,329,38,11,2,47,167,39,64,0,0
1982,283,158,330,324,38,11,2,47,166,40,64,0,0
1983,283,149,333,322,38,11,2,50,173,41,64,0,0
1984,285,156,330,315,38,11,2,45,159,42,64,0,0
1985,286,161,330,311,38,11,2,44,150,43,64,0,0
1986,286,160,330,309,38,11,2,44,149,44,64,0,0
1987,286,158,330,304,38,11,2,44,146,45,64,0,0
1988,287,160,329,300,38,11,2,42,140,46,64,0,0
1989,285,157,328,297,38,11,2,43,140,47,64,0,0
1990,286,153,329,296,38,11,2,43,143,48,64,0,0
1991,284,150,328,297,38,11,2,44,147,49,64,0,0
1992,282,149,326,294,38,11,2,44,145,50,64,0,0
1993,281,150,320,280,38,11,2,39,130,51,64,0,0
1994,280,149,321,281,38,11,2,41,132,52,64,0,0
1995,279,148,320,281,38,11,2,41,133,53,64,0,0
1996,278,145,318,279,38,11,2,40,134,54,64,0,0
1997,277,149,315,274,38,11,2,38,125,55,64,0,0
1998,277,150,313,272,38,11,2,36,122,56,64,0,0
1999,277,147,314,270,38,11,2,37,123,57,64,0,0
2000,277,147,314,268,38,11,2,37,121,58,64,0,0
2001,277,148,314,269,38,11,2,37,121,59,64,0,0
2002,276,145,313,266,38,11,2,37,121,60,64,0,0
2003,277,147,313,264,38,11,2,36,117,61,64,0,0
2004,279,140,316,260,38,11,2,37,120,62,64,0,0
2005,280,127,323,267,38,11,2,43,140,63,64,0,0
2006,280,124,324,266,38,11,2,44,142,64,64,1,0
2013,5,632,215,1061,42,11,2,210,429,0,0,0,0
2094,0,552,153,1070,45,11,2,153,518,0,77,0,1
2095,100,510,269,1067,45,11,2,169,557,1,77,0,0
2096,160,489,340,1072,45,11,2,180,583,2,77,0,0
2097,222,450,417,1073,45,11,2,195,623,3,77,0,0
2098,316,438,518,1071,45,11,2,202,633,4,77,0,0
2099,388,409,600,1056,45,11,2,212,647,5,77,0,0
2100,450,393,674,1050,45,11,2,224,657,6,77,0,0
2101,486,379,708,1007,45,11,2,222,628,7,77,0,0
2102,500,357,709,940,45,11,2,209,583,8,77,0,0
2103,513,349,715,908,45,11,2,202,559,9,77,0,0
2104,543,332,733,841,45,11,2,190,509,10,77,0,0
2105,532,314,722,812,45,11,2,190,498,11,77,0,0
2106,525,297,707,769,45,11,2,182,472,12,77,0,0
2107,520,278,693,725,45,11,2,173,447,13,77,0,0
2108,517,276,685,706,45,11,2,168,430,14,77,0,0
2109,516,260,675,669,45,11,2,159,409,15,77,0,0
2110,500,254,652,641,45,11,2,152,387,16,77,0,0
2111,487,242,635,622,45,11,2,148,380,17,77,0,0
2112,475,231,615,596,45,11,2,140,365,18,77,0,0
2113,465,230,597,581,45,11,2,132,351,19,77,0,0
2114,454,225,579,555,45,11,2,125,330,20,77,0,0
2115,443,225,563,547,45,11,2,120,322,21,77,0,0
2116,432,218,545,529,45,11,2,113,311,22,77,0,0
2117,416,217,525,514,45,11,2,109,297,23,77,0,0
2118,412,214,515,500,45,11,2,103,286,24,77,0,0
2119,409,205,509,485,45,11,2,100,280,25,77,0,0
2120,404,205,500,477,45,11,2,96,272,26,77,0,0
2121,398,213,487,464,45,11,2,89,251,27,77,0,0
2122,392,205,478,449,45,11,2,86,244,28,77,0,0
2123,390,207,473,444,45,11,2,83,237,29,77,0,0
2124,387,197,471,433,45,11,2,84,236,30,77,0,0
2125,379,185,465,431,45,11,2,86,246,31,77,0,0
2126,372,188,455,421,45,11,2,83,233,32,77,0,0
2127,368,187,447,410,45,11,2,79,223,33,77,0,0
2128,366,190,441,398,45,11,2,75,208,34,77,0,0
2129,365,192,438,393,45,11,2,73,201,35,77,0,0
2130,361,187,436,389,45,11,2,75,202,36,77,0,0
2131,355,175,430,378,45,11,2,75,203,37,77,0,0
2132,351,175,421,367,45,11,2,70,192,38,77,0,0
2133,351,176,419,363,45,11,2,68,187,39,77,0,0
2134,350,174,418,362,45,11,2,68,188,40,77,0,0
2135,347,172,415,362,45,11,2,68,190,41,77,0,0
2136,347,167,413,353,45,11,2,66,186,42,77,0,0
2137,346,169,408,342,45,11,2,62,173,43,77,0,0
2138,345,166,407,339,45,11,2,62,173,44,77,0,0
2139,348,180,404,336,45,11,2,56,156,45,77,0,0
2140,345,178,402,336,45,11,2,57,158,46,77,0,0
2141,347,169,404,329,45,11,2,57,160,47,77,0,0
2142,347,163,404,321,45,11,2,57,158,48,77,0,0
2143,352,167,406,319,45,11,2,54,152,49,77,0,0
2144,353,166,407,316,45,11,2,54,150,50,77,0,0
2145,355,168,407,313,45,11,2,52,145,51,77,0,0
2146,358,162,408,302,45,11,2,50,140,52,77,0,0
2147,360,157,409,293,45,11,2,49,136,53,77,0,0
2148,366,157,414,293,45,11,2,48,136,54,77,0,0
2149,367,155,415,292,45,11,2,48,137,55,77,0,0
2150,365,156,414,293,45,11,2,49,137,56,77,0,0
2151,366,153,412,285,45,11,2,46,132,57,77,0,0
2152,369,152,408,266,45,11,2,39,114,58,77,0,0
2153,367,151,409,271,45,11,2,42,120,59,77,0,0
2154,366,152,408,272,45,11,2,42,120,60,77,0,0
2155,362,148,406,276,45,11,2,44,128,61,77,0,0
2156,360,145,403,271,45,11,2,43,126,62,77,0,0
2157,359,146,402,270,45,11,2,43,124,63,77,0,0
2158,359,147,401,265,45,11,2,42,118,64,77,0,0
2159,357,145,400,268,45,11,2,43,123,65,77,0,0
2160,353,144,397,268,45,11,2,44,124,66,77,0,0
2161,352,146,394,264,45,11,2,42,118,67,77,0,0
2162,352,147,392,259,45,11,2,40,112,68,77,0,0
2163,352,145,392,255,45,11,2,40,110,69,77,0,0
2164,349,145,389,254,45,11,2,40,109,70,77,0,0
2165,347,147,386,252,45,11,2,39,105,71,77,0,0
2166,345,143,383,249,45,11,2,38,106,72,77,0,0
2167,343,148,379,248,45,11,2,36,100,73,77,0,0
2168,342,149,378,247,45,11,2,36,98,74,77,0,0
2169,341,151,376,248,45,11,2,35,97,75,77,0,0
2170,338,147,373,244,45,11,2,35,97,76,77,0,0
2171,335,145,370,241,45,11,2,35,96,77,77,1,0
2173,334,144,369,241,45,11,2,35,97,0,77,0,0
2154,775,298,869,461,48,11,2,94,163,0,0,0,0
2210,287,150,322,254,50,11,2,35,104,0,51,0,0
2213,288,144,324,253,50,11,2,36,109,0,51,0,0
2214,288,140,324,251,50,11,2,36,111,1,51,0,0
2215,286,130,328,261,50,11,2,42,131,2,51,0,0
2216,289,134,329,262,50,11,2,40,128,3,51,0,0
2217,292,133,330,256,50,11,2,38,123,4,51,0,0
2218,292,126,333,263,50,11,2,41,137,5,51,0,0
2219,293,133,333,268,50,11,2,40,135,6,51,0,0
2220,294,137,334,272,50,11,2,40,135,7,51,0,0
2222,301,145,338,273,50,11,2,37,128,0,51,0,0
2223,303,156,338,273,50,11,2,35,117,1,51,0,0
2224,302,153,339,279,50,11,2,37,126,2,51,0,0
2225,303,165,339,287,50,11,2,36,122,3,51,0,0
2230,309,181,346,303,50,11,2,37,122,0,51,0,1
2231,312,185,348,303,50,11,2,36,118,1,51,0,0
2232,312,185,350,308,50,11,2,38,123,2,51,0,0
2233,313,187,351,312,50,11,2,38,125,3,51,0,0
2234,311,187,352,318,50,11,2,41,131,4,51,0,0
2235,312,190,354,325,50,11,2,42,135,5,51,0,0
2236,314,190,356,327,50,11,2,42,137,6,51,0,0
2237,314,191,358,332,50,11,2,44,141,7,51,0,0
2238,314,189,360,338,50,11,2,46,149,8,51,0,0
2239,314,193,360,341,50,11,2,46,148,9,51,0,0
2240,314,197,361,351,50,11,2,47,154,10,51,0,0
2241,316,198,364,352,50,11,2,48,154,11,51,0,0
2242,316,198,365,358,50,11,2,49,160,12,51,0,0
2243,317,201,366,362,50,11,2,49,161,13,51,0,0
2244,315,202,365,364,50,11,2,50,162,14,51,0,0
2245,314,206,366,377,50,11,2,52,171,15,51,0,0
2246,314,207,368,385,50,11,2,54,178,16,51,0,0
2247,313,210,368,391,50,11,2,55,181,17,51,0,0
2248,313,213,369,397,50,11,2,56,184,18,51,0,0
2249,312,217,368,399,50,11,2,56,182,19,51,0,0
2250,313,223,370,407,50,11,2,57,184,20,51,0,0
2251,316,226,375,418,50,11,2,59,192,21,51,0,0
2252,317,228,379,426,50,11,2,62,198,22,51,0,0
2253,320,232,382,432,50,11,2,62,200,23,51,0,0
2254,319,233,385,443,50,11,2,66,210,24,51,0,0
2255,325,238,392,453,50,11,2,67,215,25,51,0,0
2256,329,235,400,460,50,11,2,71,225,26,51,0,0
2257,332,241,405,472,50,11,2,73,231,27,51,0,0
2258,336,243,412,485,50,11,2,76,242,28,51,0,0
2259,339,247,418,497,50,11,2,79,250,29,51,0,0
2260,347,249,431,514,50,11,2,84,265,30,51,0,0
2261,356,252,441,521,50,11,2,85,269,31,51,0,0
2262,358,261,447,546,50,11,2,89,285,32,51,0,0
2263,362,265,455,561,50,11,2,93,296,33,51,0,0
2264,364,266,462,579,50,11,2,98,313,34,51,0,0
2265,369,279,470,602,50,11,2,101,323,35,51,0,0
2266,373,283,476,612,50,11,2,103,329,36,51,0,0
2267,370,292,479,646,50,11,2,109,354,37,51,0,0
2268,367,302,482,673,50,11,2,115,371,38,51,0,0
2269,364,313,484,701,50,11,2,120,388,39,51,0,0
2270,365,329,492,739,50,11,2,127,410,40,51,0,0
2271,369,336,499,754,50,11,2,130,418,41,51,0,0
2272,365,351,506,804,50,11,2,141,453,42,51,0,0
2273,365,363,511,834,50,11,2,146,471,43,51,0,0
2274,365,385,520,877,50,11,2,155,492,44,51,0,0
2275,359,408,525,932,50,11,2,166,524,45,51,0,0
2276,354,431,522,956,50,11,2,168,525,46,51,0,0
2277,330,459,513,1029,50,11,2,183,570,47,51,0,0
2278,295,486,487,1067,50,11,2,192,581,48,51,0,0
2279,241,513,437,1080,50,11,2,196,567,49,51,0,0
2280,179,560,376,1080,50,11,2,197,520,50,51,0,0
2281,168,577,368,1080,50,11,2,200,503,51,51,1,0
2281,6,589,260,1075,57,11,2,254,486,0,1,0,0
2282,0,686,204,1079,57,11,2,204,393,1,1,0,0
2396,827,351,872,471,58,11,2,45,120,0,1,0,0
2397,827,353,871,472,58,11,2,44,119,1,1,0,0
2632,344,442,562,1056,60,11,2,218,614,0,71,0,1
2633,355,416,556,983,60,11,2,201,567,1,71,0,0
2634,347,404,545,961,60,11,2,198,557,2,71,0,0
2635,336,383,517,894,60,11,2,181,511,3,71,0,0
2636,316,368,492,862,60,11,2,176,494,4,71,0,0
2637,308,356,482,846,60,11,2,174,490,5,71,0,0
2638,313,339,474,793,60,11,2,161,454,6,71,0,0
2639,319,329,473,765,60,11,2,154,436,7,71,0,0
2640,313,318,461,743,60,11,2,148,425,8,71,0,0
2641,302,303,445,714,60,11,2,143,411,9,71,0,0
2642,292,300,433,705,60,11,2,141,405,10,71,0,0
2643,294,288,427,671,60,11,2,133,383,11,71,0,0
2644,300,283,426,645,60,11,2,126,362,12,71,0,0
2645,300,281,420,632,60,11,2,120,351,13,71,0,0
2646,294,271,407,604,60,11,2,113,333,14,71,0,0
2647,286,265,398,595,60,11,2,112,330,15,71,0,0
2648,284,262,392,583,60,11,2,108,321,16,71,0,0
2649,284,254,387,565,60,11,2,103,311,17,71,0,0
2650,286,254,380,544,60,11,2,94,290,18,71,0,0
2651,276,245,370,537,60,11,2,94,292,19,71,0,0
2652,273,241,363,523,60,11,2,90,282,20,71,0,0
2653,269,240,358,518,60,11,2,89,278,21,71,0,0
2654,268,234,353,501,60,11,2,85,267,22,71,0,0
2655,268,231,351,492,60,11,2,83,261,23,71,0,0
2656,265,231,345,485,60,11,2,80,254,24,71,0,0
2657,262,226,340,475,60,11,2,78,249,25,71,0,0
2658,261,225,337,469,60,11,2,76,244,26,71,0,0
2659,263,222,338,460,60,11,2,75,238,27,71,0,0
2660,267,218,339,446,60,11,2,72,228,28,71,0,0
2661,269,217,339,441,60,11,2,70,224,29,71,0,0
2662,268,213,337,432,60,11,2,69,219,30,71,0,0
2663,266,208,335,426,60,11,2,69,218,31,71,0,0
2664,266,206,334,421,60,11,2,68,215,32,71,0,0
2665,269,203,334,409,60,11,2,65,206,33,71,0,0
2666,272,203,335,401,60,11,2,63,198,34,71,0,0
2667,271,202,333,398,60,11,2,62,196,35,71,0,0
2668,269,200,330,391,60,11,2,61,191,36,71,0,0
2669,268,199,328,388,60,11,2,60,189,37,71,0,0
2670,270,196,330,384,60,11,2,60,188,38,71,0,0
2671,272,194,331,379,60,11,2,59,185,39,71,0,0
2672,273,196,330,374,60,11,2,57,178,40,71,0,0
2673,272,189,328,365,60,11,2,56,176,41,71,0,0
2674,270,187,326,361,60,11,2,56,174,42,71,0,0
2675,272,186,328,359,60,11,2,56,173,43,71,0,0
2676,275,183,331,355,60,11,2,56,172,44,71,0,0
2677,278,181,332,352,60,11,2,54,171,45,71,0,0
2678,279,180,332,348,60,11,2,53,168,46,71,0,0
2679,281,179,332,341,60,11,2,51,162,47,71,0,0
2680,283,179,332,338,60,11,2,49,159,48,71,0,0
2681,287,178,335,332,60,11,2,48,154,49,71,0,0
2682,289,176,337,329,60,11,2,48,153,50,71,0,0
2683,290,176,337,328,60,11,2,47,152,51,71,0,0
2684,290,174,336,323,60,11,2,46,149,52,71,0,0
2685,291,173,335,318,60,11,2,44,145,53,71,0,0
2686,292,172,336,315,60,11,2,44,143,54,71,0,0
2687,294,169,337,311,60,11,2,43,142,55,71,0,0
2688,295,169,337,308,60,11,2,42,139,56,71,0,0
2689,293,167,335,304,60,11,2,42,137,57,71,0,0
2690,292,164,334,303,60,11,2,42,139,58,71,0,0
2691,293,164,334,301,60,11,2,41,137,59,71,0,0
2692,294,162,335,298,60,11,2,41,136,60,71,0,0
2693,294,162,335,296,60,11,2,41,134,61,71,0,0
2694,294,162,334,295,60,11,2,40,133,62,71,0,0
2695,294,159,333,292,60,11,2,39,133,63,71,0,0
2696,295,158,333,287,60,11,2,38,129,64,71,0,0
2697,295,156,332,283,60,11,2,37,127,65,71,0,0
2698,296,155,333,280,60,11,2,37,125,66,71,0,0
2699,295,154,332,279,60,11,2,37,125,67,71,0,0
2700,294,153,331,276,60,11,2,37,123,68,71,0,0
2701,294,152,330,275,60,11,2,36,123,69,71,0,0
2702,294,150,330,276,60,11,2,36,126,70,71,0,0
2703,294,151,330,272,60,11,2,36,121,71,71,1,0
3520,302,114,338,234,61,11,2,36,120,0,53,0,0
3522,304,118,339,234,61,11,2,35,116,0,53,0,0
3543,277,167,313,284,61,11,2,36,117,0,53,0,1
3544,275,166,313,292,61,11,2,38,126,1,53,0,0
3545,275,165,315,295,61,11,2,40,130,2,53,0,0
3546,276,168,316,300,61,11,2,40,132,3,53,0,0
3547,276,170,316,298,61,11,2,40,128,4,53,0,0
3548,277,173,318,303,61,11,2,41,130,5,53,0,0
3549,278,172,320,309,61,11,2,42,137,6,53,0,0
3550,281,175,324,312,61,11,2,43,137,7,53,0,0
3551,281,174,326,316,61,11,2,45,142,8,53,0,0
3552,279,176,326,322,61,11,2,47,146,9,53,0,0
3553,276,179,323,325,61,11,2,47,146,10,53,0,0
3554,275,180,324,331,61,11,2,49,151,11,53,0,0
3555,275,183,325,337,61,11,2,50,154,12,53,0,0
3556,273,183,324,340,61,11,2,51,157,13,53,0,0
3557,268,183,322,349,61,11,2,54,166,14,53,0,0
3558,264,185,318,351,61,11,2,54,166,15,53,0,0
3559,262,186,318,361,61,11,2,56,175,16,53,0,0
3560,261,190,317,364,61,11,2,56,174,17,53,0,0
3561,259,193,316,371,61,11,2,57,178,18,53,0,0
3562,257,200,315,383,61,11,2,58,183,19,53,0,0
3563,257,201,315,389,61,11,2,58,188,20,53,0,0
3564,257,206,316,396,61,11,2,59,190,21,53,0,0
3565,257,207,317,401,61,11,2,60,194,22,53,0,0
3566,257,209,318,410,61,11,2,61,201,23,53,0,0
3567,257,213,318,419,61,11,2,61,206,24,53,0,0
3568,259,217,321,428,61,11,2,62,211,25,53,0,0
3569,262,223,326,436,61,11,2,64,213,26,53,0,0
3570,260,224,326,446,61,11,2,66,222,27,53,0,0
3571,259,231,327,461,61,11,2,68,230,28,53,0,0
3572,260,234,329,470,61,11,2,69,236,29,53,0,0
3573,263,239,334,483,61,11,2,71,244,30,53,0,0
3574,265,246,338,496,61,11,2,73,250,31,53,0,0
3575,267,245,344,508,61,11,2,77,263,32,53,0,0
3576,270,251,352,531,61,11,2,82,280,33,53,0,0
3577,272,252,359,547,61,11,2,87,295,34,53,0,0
3578,283,261,372,561,61,11,2,89,300,35,53,0,0
3579,293,265,388,579,61,11,2,95,314,36,53,0,0
3580,294,268,396,606,61,11,2,102,338,37,53,0,0
3581,294,277,405,635,61,11,2,111,358,38,53,0,0
3582,306,285,419,646,61,11,2,113,361,39,53,0,0
3583,314,298,431,670,61,11,2,117,372,40,53,0,0
3584,317,303,441,701,61,11,2,124,398,41,53,0,0
3585,313,317,450,752,61,11,2,137,435,42,53,0,0
3586,308,330,453,785,61,11,2,145,455,43,53,0,0
3587,313,345,466,822,61,11,2,153,477,44,53,0,0
3588,315,370,477,870,61,11,2,162,500,45,53,0,0
3589,312,392,477,900,61,11,2,165,508,46,53,0,0
3590,295,416,478,981,61,11,2,183,565,47,53,0,0
3591,273,441,467,1029,61,11,2,194,588,48,53,0,0
3592,226,470,427,1067,61,11,2,201,597,49,53,0,0
3593,169,509,373,1080,61,11,2,204,571,50,53,0,0
3594,97,542,298,1080,61,11,2,201,538,51,53,0,0
3595,39,603,221,1080,61,11,2,182,477,52,53,0,0
3596,22,623,205,1080,61,11,2,183,457,53,53,1,0
3571,288,245,327,328,62,11,2,39,83,0,0,0,0
4060,285,150,320,268,64,11,2,35,118,0,62,0,1
4061,287,149,324,271,64,11,2,37,122,1,62,0,0
4062,288,151,325,273,64,11,2,37,122,2,62,0,0
4063,288,150,326,276,64,11,2,38,126,3,62,0,0
4064,290,151,328,275,64,11,2,38,124,4,62,0,0
4065,292,152,330,278,64,11,2,38,126,5,62,0,0
4066,294,151,333,280,64,11,2,39,129,6,62,0,0
4067,295,154,334,282,64,11,2,39,128,7,62,0,0
4068,295,155,334,282,64,11,2,39,127,8,62,0,0
4069,297,154,337,288,64,11,2,40,134,9,62,0,0
4070,298,159,339,294,64,11,2,41,135,10,62,0,0
4071,298,158,340,295,64,11,2,42,137,11,62,0,0
4072,297,162,339,300,64,11,2,42,138,12,62,0,0
4073,296,165,338,302,64,11,2,42,137,13,62,0,0
4074,293,165,337,305,64,11,2,44,140,14,62,0,0
4075,290,167,336,312,64,11,2,46,145,15,62,0,0
4076,288,165,336,315,64,11,2,48,150,16,62,0,0
4077,286,168,335,322,64,11,2,49,154,17,62,0,0
4078,283,169,332,324,64,11,2,49,155,18,62,0,0
4079,282,172,333,330,64,11,2,51,158,19,62,0,0
4080,281,176,332,337,64,11,2,51,161,20,62,0,0
4081,279,177,332,340,64,11,2,53,163,21,62,0,0
4082,276,178,329,345,64,11,2,53,167,22,62,0,0
4083,273,182,328,354,64,11,2,55,172,23,62,0,0
4084,271,181,330,362,64,11,2,59,181,24,62,0,0
4085,271,183,331,368,64,11,2,60,185,25,62,0,0
4086,272,184,334,371,64,11,2,62,187,26,62,0,0
4087,272,190,335,383,64,11,2,63,193,27,62,0,0
4088,271,195,335,393,64,11,2,64,198,28,62,0,0
4089,270,196,337,399,64,11,2,67,203,29,62,0,0
4090,269,199,339,412,64,11,2,70,213,30,62,0,0
4091,269,199,341,418,64,11,2,72,219,31,62,0,0
4092,268,204,341,429,64,11,2,73,225,32,62,0,0
4093,265,208,342,443,64,11,2,77,235,33,62,0,0
4094,268,209,347,450,64,11,2,79,241,34,62,0,0
4095,272,216,352,461,64,11,2,80,245,35,62,0,0
4096,275,215,358,472,64,11,2,83,257,36,62,0,0
4097,273,219,361,489,64,11,2,88,270,37,62,0,0
4098,272,225,364,503,64,11,2,92,278,38,62,0,0
4099,276,227,372,516,64,11,2,96,289,39,62,0,0
4100,285,237,382,531,64,11,2,97,294,40,62,0,0
4101,290,238,389,541,64,11,2,99,303,41,62,0,0
4102,289,245,396,570,64,11,2,107,325,42,62,0,0
4103,289,253,402,594,64,11,2,113,341,43,62,0,0
4104,300,257,416,609,64,11,2,116,352,44,62,0,0
4105,312,272,433,637,64,11,2,121,365,45,62,0,0
4106,315,274,443,659,64,11,2,128,385,46,62,0,0
4107,311,283,451,702,64,11,2,140,419,47,62,0,0
4108,306,293,455,740,64,11,2,149,447,48,62,0,0
4109,310,303,465,764,64,11,2,155,461,49,62,0,0
4110,310,325,474,816,64,11,2,164,491,50,62,0,0
4111,309,343,475,843,64,11,2,166,500,51,62,0,0
4112,301,362,482,905,64,11,2,181,543,52,62,0,0
4113,292,390,484,969,64,11,2,192,579,53,62,0,0
4114,285,408,490,1023,64,11,2,205,615,54,62,0,0
4115,269,446,478,1063,64,11,2,209,617,55,62,0,0
4116,255,476,464,1080,64,11,2,209,604,56,62,0,0
4117,232,516,438,1080,64,11,2,206,564,57,62,0,0
4118,193,579,385,1080,64,11,2,192,501,58,62,0,0
4119,158,629,347,1078,64,11,2,189,449,59,62,0,0
4120,124,719,298,1076,64,11,2,174,357,60,62,0,0
4121,98,827,241,1080,64,11,2,143,253,61,62,0,0
4122,88,872,214,1080,64,11,2,126,208,62,62,1,0
4076,817,351,877,474,65,11,2,60,123,0,0,0,0
4078,819,355,875,475,66,11,2,56,120,0,0,0,0
4080,817,351,877,475,67,11,2,60,124,0,0,0,0
4170,298,122,337,234,68,11,2,39,112,0,74,0,0
4171,301,120,340,236,68,11,2,39,116,1,74,0,0
4177,329,136,364,244,68,11,2,35,108,0,74,0,1
4178,330,134,366,245,68,11,2,36,111,1,74,0,0
4179,332,137,368,248,68,11,2,36,111,2,74,0,0
4180,333,138,370,250,68,11,2,37,112,3,74,0,0
4181,333,141,370,252,68,11,2,37,111,4,74,0,0
4182,331,142,368,253,68,11,2,37,111,5,74,0,0
4183,329,139,367,256,68,11,2,38,117,6,74,0,0
4184,329,144,366,258,68,11,2,37,114,7,74,0,0
4185,329,145,366,259,68,11,2,37,114,8,74,0,0
4186,328,148,366,263,68,11,2,38,115,9,74,0,0
4187,328,151,365,265,68,11,2,37,114,10,74,0,0
4188,327,150,365,268,68,11,2,38,118,11,74,0,0
4189,327,152,366,272,68,11,2,39,120,12,74,0,0
4190,328,155,367,274,68,11,2,39,119,13,74,0,0
4191,327,154,367,278,68,11,2,40,124,14,74,0,0
4192,327,159,367,281,68,11,2,40,122,15,74,0,0
4193,326,159,365,282,68,11,2,39,123,16,74,0,0
4194,324,160,364,285,68,11,2,40,125,17,74,0,0
4195,323,163,362,288,68,11,2,39,125,18,74,0,0
4196,323,164,362,290,68,11,2,39,126,19,74,0,0
4197,323,169,361,292,68,11,2,38,123,20,74,0,0
4198,321,173,358,294,68,11,2,37,121,21,74,0,0
4199,321,175,358,298,68,11,2,37,123,22,74,0,0
4200,323,177,361,302,68,11,2,38,125,23,74,0,0
4201,326,177,364,303,68,11,2,38,126,24,74,0,0
4202,327,179,366,309,68,11,2,39,130,25,74,0,0
4203,327,180,368,312,68,11,2,41,132,26,74,0,0
4204,328,180,370,317,68,11,2,42,137,27,74,0,0
4205,330,184,373,323,68,11,2,43,139,28,74,0,0
4206,331,181,377,328,68,11,2,46,147,29,74,0,0
4207,333,184,379,333,68,11,2,46,149,30,74,0,0
4208,334,185,380,335,68,11,2,46,150,31,74,0,0
4209,336,185,384,341,68,11,2,48,156,32,74,0,0
4210,338,185,388,348,68,11,2,50,163,33,74,0,0
4211,341,184,394,354,68,11,2,53,170,34,74,0,0
4212,343,190,397,360,68,11,2,54,170,35,74,0,0
4213,344,191,398,363,68,11,2,54,172,36,74,0,0
4214,346,196,402,370,68,11,2,56,174,37,74,0,0
4215,349,202,406,379,68,11,2,57,177,38,74,0,0
4216,353,202,411,384,68,11,2,58,182,39,74,0,0
4217,356,206,415,390,68,11,2,59,184,40,74,0,0
4218,356,207,417,396,68,11,2,61,189,41,74,0,0
4219,358,207,421,406,68,11,2,63,199,42,74,0,0
4220,361,210,427,417,68,11,2,66,207,43,74,0,0
4221,364,207,433,422,68,11,2,69,215,44,74,0,0
4222,365,212,437,431,68,11,2,72,219,45,74,0,0
4223,367,217,440,439,68,11,2,73,222,46,74,0,0
4224,368,221,443,449,68,11,2,75,228,47,74,0,0
4225,372,226,450,464,68,11,2,78,238,48,74,0,0
4226,381,228,461,471,68,11,2,80,243,49,74,0,0
4227,384,234,468,488,68,11,2,84,254,50,74,0,0
4228,388,238,474,496,68,11,2,86,258,51,74,0,0
4229,392,241,483,514,68,11,2,91,273,52,74,0,0
4230,399,252,493,535,68,11,2,94,283,53,74,0,0
4231,407,255,505,549,68,11,2,98,294,54,74,0,0
4232,413,260,518,573,68,11,2,105,313,55,74,0,0
4233,419,268,530,594,68,11,2,111,326,56,74,0,0
4234,427,274,540,605,68,11,2,113,331,57,74,0,0
4235,438,291,555,636,68,11,2,117,345,58,74,0,0
4236,450,296,571,655,68,11,2,121,359,59,74,0,0
4237,453,306,585,695,68,11,2,132,389,60,74,0,0
4238,459,318,599,729,68,11,2,140,411,61,74,0,0
4239,465,326,609,749,68,11,2,144,423,62,74,0,0
4240,476,346,628,796,68,11,2,152,450,63,74,0,0
4241,488,362,644,827,68,11,2,156,465,64,74,0,0
4242,494,379,664,882,68,11,2,170,503,65,74,0,0
4243,502,399,691,948,68,11,2,189,549,66,74,0,0
4244,510,420,698,970,68,11,2,188,550,67,74,0,0
4245,531,456,736,1041,68,11,2,205,585,68,74,0,0
4246,555,496,759,1073,68,11,2,204,577,69,74,0,0
4247,587,527,794,1080,68,11,2,207,553,70,74,0,0
4248,635,597,831,1080,68,11,2,196,483,71,74,0,0
4249,663,648,851,1080,68,11,2,188,432,72,74,0,0
4250,719,752,881,1080,68,11,2,162,328,73,74,0,0
4251,742,786,898,1080,68,11,2,156,294,74,74,1,0
4501,825,358,874,471,70,11,2,49,113,0,5,0,0
4502,824,358,873,471,70,11,2,49,113,1,5,0,0
4503,824,358,874,472,70,11,2,50,114,2,5,0,0
4504,824,357,874,472,70,11,2,50,115,3,5,0,0
4505,824,356,874,472,70,11,2,50,116,4,5,0,0
4506,824,356,874,472,70,11,2,50,116,5,5,0,0
4607,313,152,348,280,71,11,2,35,128,0,60,0,1
4608,314,154,350,284,71,11,2,36,130,1,60,0,0
4609,315,156,351,287,71,11,2,36,131,2,60,0,0
4610,316,159,352,289,71,11,2,36,130,3,60,0,0
4611,317,161,354,292,71,11,2,37,131,4,60,0,0
4612,318,162,355,297,71,11,2,37,135,5,60,0,0
4613,320,167,357,301,71,11,2,37,134,6,60,0,0
4614,321,167,359,303,71,11,2,38,136,7,60,0,0
4615,322,166,362,307,71,11,2,40,141,8,60,0,0
4616,322,168,363,312,71,11,2,41,144,9,60,0,0
4617,323,169,364,313,71,11,2,41,144,10,60,0,0
4618,322,167,367,322,71,11,2,45,155,11,60,0,0
4619,323,166,369,327,71,11,2,46,161,12,60,0,0
4620,324,169,370,330,71,11,2,46,161,13,60,0,0
4621,324,169,371,334,71,11,2,47,165,14,60,0,0
4622,323,168,372,337,71,11,2,49,169,15,60,0,0
4623,324,168,375,344,71,11,2,51,176,16,60,0,0
4624,326,172,378,351,71,11,2,52,179,17,60,0,0
4625,327,175,379,354,71,11,2,52,179,18,60,0,0
4626,327,174,380,361,71,11,2,53,187,19,60,0,0
4627,327,175,382,365,71,11,2,55,190,20,60,0,0
4628,330,175,386,370,71,11,2,56,195,21,60,0,0
4629,334,178,392,376,71,11,2,58,198,22,60,0,0
4630,339,179,397,381,71,11,2,58,202,23,60,0,0
4631,341,184,402,390,71,11,2,61,206,24,60,0,0
4632,342,187,405,399,71,11,2,63,212,25,60,0,0
4633,345,191,408,405,71,11,2,63,214,26,60,0,0
4634,348,196,412,412,71,11,2,64,216,27,60,0,0
4635,353,196,418,418,71,11,2,65,222,28,60,0,0
4636,358,197,427,429,71,11,2,69,232,29,60,0,0
4637,360,198,432,439,71,11,2,72,241,30,60,0,0
4638,362,201,435,444,71,11,2,73,243,31,60,0,0
4639,367,208,441,454,71,11,2,74,246,32,60,0,0
4640,372,203,450,462,71,11,2,78,259,33,60,0,0
4641,377,203,460,478,71,11,2,83,275,34,60,0,0
4642,379,205,466,493,71,11,2,87,288,35,60,0,0
4643,380,208,471,504,71,11,2,91,296,36,60,0,0
4644,383,216,476,517,71,11,2,93,301,37,60,0,0
4645,389,219,485,532,71,11,2,96,313,38,60,0,0
4646,394,225,491,543,71,11,2,97,318,39,60,0,0
4647,396,233,500,570,71,11,2,104,337,40,60,0,0
4648,396,234,503,582,71,11,2,107,348,41,60,0,0
4649,395,242,509,613,71,11,2,114,371,42,60,0,0
4650,396,251,514,637,71,11,2,118,386,43,60,0,0
4651,399,255,522,651,71,11,2,123,396,44,60,0,0
4652,401,268,527,674,71,11,2,126,406,45,60,0,0
4653,394,271,529,706,71,11,2,135,435,46,60,0,0
4654,385,278,529,740,71,11,2,144,462,47,60,0,0
4655,383,293,534,773,71,11,2,151,480,48,60,0,0
4656,383,301,541,802,71,11,2,158,501,49,60,0,0
4657,379,328,547,854,71,11,2,168,526,50,60,0,0
4658,361,338,542,905,71,11,2,181,567,51,60,0,0
4659,339,355,535,964,71,11,2,196,609,52,60,0,0
4660,312,379,524,1033,71,11,2,212,654,53,60,0,0
4661,295,395,513,1063,71,11,2,218,668,54,60,0,0
4662,278,437,493,1079,71,11,2,215,642,55,60,0,0
4663,235,470,449,1080,71,11,2,214,610,56,60,0,0
4664,176,512,385,1080,71,11,2,209,568,57,60,0,0
4665,118,573,320,1080,71,11,2,202,507,58,60,0,0
4666,53,624,242,1080,71,11,2,189,456,59,60,0,0
4667,31,649,218,1080,71,11,2,187,431,60,60,1,0
4778,0,900,101,1078,72,11,2,101,178,0,0,0,0
4779,9,509,300,1079,73,11,2,291,570,0,65,0,1
4780,47,477,349,1072,73,11,2,302,595,1,65,0,0
4781,142,447,459,1070,73,11,2,317,623,2,65,0,0
4782,210,425,534,1067,73,11,2,324,642,3,65,0,0
4783,268,388,599,1045,73,11,2,331,657,4,65,0,0
4784,298,365,623,1013,73,11,2,325,648,5,65,0,0
4785,325,344,618,935,73,11,2,293,591,6,65,0,0
4786,339,336,614,906,73,11,2,275,570,7,65,0,0
4787,372,316,620,835,73,11,2,248,519,8,65,0,0
4788,375,298,619,813,73,11,2,244,515,9,65,0,0
4789,379,285,599,756,73,11,2,220,471,10,65,0,0
4790,377,273,582,721,73,11,2,205,448,11,65,0,0
4791,381,270,574,700,73,11,2,193,430,12,65,0,0
4792,387,261,565,660,73,11,2,178,399,13,65,0,0
4793,376,254,545,640,73,11,2,169,386,14,65,0,0
4794,366,245,520,600,73,11,2,154,355,15,65,0,0
4795,361,235,511,590,73,11,2,150,355,16,65,0,0
4796,364,231,503,561,73,11,2,139,330,17,65,0,0
4797,356,225,489,544,73,11,2,133,319,18,65,0,0
4798,349,221,476,533,73,11,2,127,312,19,65,0,0
4799,341,219,461,519,73,11,2,120,300,20,65,0,0
4800,339,217,454,510,73,11,2,115,293,21,65,0,0
4801,338,209,447,488,73,11,2,109,279,22,65,0,0
4802,339,204,443,474,73,11,2,104,270,23,65,0,0
4803,335,203,434,462,73,11,2,99,259,24,65,0,0
4804,331,201,426,454,73,11,2,95,253,25,65,0,0
4805,330,201,422,446,73,11,2,92,245,26,65,0,0
4806,332,197,419,431,73,11,2,87,234,27,65,0,0
4807,329,196,414,427,73,11,2,85,231,28,65,0,0
4808,327,196,406,414,73,11,2,79,218,29,65,0,0
4809,326,195,403,409,73,11,2,77,214,30,65,0,0
4810,326,187,401,396,73,11,2,75,209,31,65,0,0
4811,325,180,399,390,73,11,2,74,210,32,65,0,0
4812,324,183,396,387,73,11,2,72,204,33,65,0,0
4813,322,180,391,380,73,11,2,69,200,34,65,0,0
4814,322,179,388,372,73,11,2,66,193,35,65,0,0
4815,323,178,386,363,73,11,2,63,185,36,65,0,0
4816,323,177,384,360,73,11,2,61,183,37,65,0,0
4817,321,174,380,353,73,11,2,59,179,38,65,0,0
4818,319,173,377,349,73,11,2,58,176,39,65,0,0
4819,320,174,376,342,73,11,2,56,168,40,65,0,0
4820,320,174,374,336,73,11,2,54,162,41,65,0,0
4821,317,172,370,334,73,11,2,53,162,42,65,0,0
4822,314,170,366,329,73,11,2,52,159,43,65,0,0
4823,312,168,364,328,73,11,2,52,160,44,65,0,0
4824,312,165,363,322,73,11,2,51,157,45,65,0,0
4825,312,163,362,320,73,11,2,50,157,46,65,0,0
4826,311,163,359,315,73,11,2,48,152,47,65,0,0
4827,310,162,356,309,73,11,2,46,147,48,65,0,0
4828,311,162,355,305,73,11,2,44,143,49,65,0,0
4829,311,159,354,299,73,11,2,43,140,50,65,0,0
4830,311,160,353,296,73,11,2,42,136,51,65,0,0
4831,308,153,351,293,73,11,2,43,140,52,65,0,0
4832,305,150,348,291,73,11,2,43,141,53,65,0,0
4833,305,148,347,285,73,11,2,42,137,54,65,0,0
4834,304,147,345,282,73,11,2,41,135,55,65,0,0
4835,302,147,343,281,73,11,2,41,134,56,65,0,0
4836,301,147,341,279,73,11,2,40,132,57,65,0,0
4837,300,147,339,278,73,11,2,39,131,58,65,0,0
4838,299,144,338,272,73,11,2,39,128,59,65,0,0
4839,299,145,336,270,73,11,2,37,125,60,65,0,0
4840,297,147,334,268,73,11,2,37,121,61,65,0,0
4841,296,146,332,267,73,11,2,36,121,62,65,0,0
4842,297,147,332,262,73,11,2,35,115,63,65,0,0
4843,297,144,332,262,73,11,2,35,118,64,65,0,0
4844,297,144,332,260,73,11,2,35,116,65,65,1,0
4851,816,365,876,476,74,11,2,60,111,0,1,0,0
4852,814,361,877,477,74,11,2,63,116,1,1,0,0
4855,815,365,876,476,75,11,2,61,111,0,0,0,0
4936,816,355,873,471,76,11,2,57,116,0,5,0,0
4937,816,355,873,471,76,11,2,57,116,1,5,0,0
4938,816,355,873,471,76,11,2,57,116,2,5,0,0
4939,816,355,874,472,76,11,2,58,117,3,5,0,0
4940,816,355,873,472,76,11,2,57,117,4,5,0,0
4941,816,355,874,472,76,11,2,58,117,5,5,0,0
4972,0,860,73,1077,77,11,2,73,217,0,207,0,1
4973,31,836,114,1079,77,11,2,83,243,1,207,0,0
4974,68,790,170,1077,77,11,2,102,287,2,207,0,0
4975,123,750,245,1075,77,11,2,122,325,3,207,0,0
4976,169,711,314,1074,77,11,2,145,363,4,207,0,0
4977,191,678,356,1071,77,11,2,165,393,5,207,0,0
4978,198,638,386,1068,77,11,2,188,430,6,207,0,0
4979,207,606,417,1063,77,11,2,210,457,7,207,0,0
4980,220,579,452,1067,77,11,2,232,488,8,207,0,0
4981,230,563,475,1067,77,11,2,245,504,9,207,0,0
4982,254,542,514,1066,77,11,2,260,524,10,207,0,0
4983,281,519,557,1067,77,11,2,276,548,11,207,0,0
4984,304,497,593,1065,77,11,2,289,568,12,207,0,0
4985,314,481,613,1066,77,11,2,299,585,13,207,0,0
4986,315,475,618,1068,77,11,2,303,593,14,207,0,0
4987,303,463,611,1070,77,11,2,308,607,15,207,0,0
4988,284,450,596,1073,77,11,2,312,623,16,207,0,0
4989,278,439,594,1073,77,11,2,316,634,17,207,0,0
4990,278,433,589,1066,77,11,2,311,633,18,207,0,0
4991,284,417,596,1069,77,11,2,312,652,19,207,0,0
4992,306,399,609,1049,77,11,2,303,650,20,207,0,0
4993,318,386,607,1021,77,11,2,289,635,21,207,0,0
4994,322,380,599,1004,77,11,2,277,624,22,207,0,0
4995,321,371,590,991,77,11,2,269,620,23,207,0,0
4996,317,362,572,956,77,11,2,255,594,24,207,0,0
4997,310,353,554,930,77,11,2,244,577,25,207,0,0
4998,317,350,552,914,77,11,2,235,564,26,207,0,0
4999,324,341,549,896,77,11,2,225,555,27,207,0,0
5000,331,338,546,879,77,11,2,215,541,28,207,0,0
5001,335,342,542,869,77,11,2,207,527,29,207,0,0
5002,335,343,536,866,77,11,2,201,523,30,207,0,0
5003,331,335,537,872,77,11,2,206,537,31,207,0,0
5004,329,331,537,874,77,11,2,208,543,32,207,0,0
5005,329,331,536,873,77,11,2,207,542,33,207,0,0
5006,329,333,536,873,77,11,2,207,540,34,207,0,0
5007,328,333,536,873,77,11,2,208,540,35,207,0,0
5008,327,333,535,872,77,11,2,208,539,36,207,0,0
5009,327,338,534,873,77,11,2,207,535,37,207,0,0
5010,325,334,535,873,77,11,2,210,539,38,207,0,0
5011,325,335,534,873,77,11,2,209,538,39,207,0,0
5012,324,335,534,874,77,11,2,210,539,40,207,0,0
5013,324,334,535,872,77,11,2,211,538,41,207,0,0
5014,323,334,534,873,77,11,2,211,539,42,207,0,0
5015,322,335,534,874,77,11,2,212,539,43,207,0,0
5016,322,334,535,876,77,11,2,213,542,44,207,0,0
5017,321,333,535,875,77,11,2,214,542,45,207,0,0
5018,321,333,535,875,77,11,2,214,542,46,207,0,0
5019,321,333,535,875,77,11,2,214,542,47,207,0,0
5020,320,333,535,874,77,11,2,215,541,48,207,0,0
5021,321,332,535,871,77,11,2,214,539,49,207,0,0
5022,321,333,535,870,77,11,2,214,537,50,207,0,0
5023,320,333,534,870,77,11,2,214,537,51,207,0,0
5024,320,332,535,871,77,11,2,215,539,52,207,0,0
5025,320,332,535,871,77,11,2,215,539,53,207,0,0
5026,320,333,537,873,77,11,2,217,540,54,207,0,0
5027,321,334,537,874,77,11,2,216,540,55,207,0,0
5028,320,334,538,874,77,11,2,218,540,56,207,0,0
5029,320,334,538,874,77,11,2,218,540,57,207,0,0
5030,320,334,538,874,77,11,2,218,540,58,207,0,0
5031,319,332,538,875,77,11,2,219,543,59,207,0,0
5032,318,331,537,874,77,11,2,219,543,60,207,0,0
5033,318,330,536,873,77,11,2,218,543,61,207,0,0
5034,318,330,536,873,77,11,2,218,543,62,207,0,0
5035,318,330,536,872,77,11,2,218,542,63,207,0,0
5036,319,332,537,872,77,11,2,218,540,64,207,0,0
5037,319,331,537,872,77,11,2,218,541,65,207,0,0
5038,319,331,538,873,77,11,2,219,542,66,207,0,0
5039,320,331,538,873,77,11,2,218,542,67,207,0,0
5040,320,331,538,873,77,11,2,218,542,68,207,0,0
5041,319,331,538,873,77,11,2,219,542,69,207,0,0
5042,319,329,538,873,77,11,2,219,544,70,207,0,0
5043,319,328,538,872,77,11,2,219,544,71,207,0,0
5044,319,328,538,872,77,11,2,219,544,72,207,0,0
5045,319,328,538,872,77,11,2,219,544,73,207,0,0
5046,318,327,538,872,77,11,2,220,545,74,207,0,0
5047,318,326,538,872,77,11,2,220,546,75,207,0,0
5048,318,326,538,872,77,11,2,220,546,76,207,0,0
5049,318,326,538,872,77,11,2,220,546,77,207,0,0
5050,318,327,538,872,77,11,2,220,545,78,207,0,0
5051,318,329,537,872,77,11,2,219,543,79,207,0,0
5052,318,329,537,872,77,11,2,219,543,80,207,0,0
5053,318,329,537,871,77,11,2,219,542,81,207,0,0
5054,319,329,537,871,77,11,2,218,542,82,207,0,0
5055,319,329,537,871,77,11,2,218,542,83,207,0,0
5056,319,329,537,871,77,11,2,218,542,84,207,0,0
5057,318,328,537,871,77,11,2,219,543,85,207,0,0
5058,318,328,537,871,77,11,2,219,543,86,207,0,0
5059,318,328,538,872,77,11,2,220,544,87,207,0,0
5060,318,328,538,872,77,11,2,220,544,88,207,0,0
5061,318,330,537,872,77,11,2,219,542,89,207,0,0
5062,317,331,537,872,77,11,2,220,541,90,207,0,0
5063,317,331,537,872,77,11,2,220,541,91,207,0,0
5064,318,332,537,872,77,11,2,219,540,92,207,0,0
5065,318,332,537,872,77,11,2,219,540,93,207,0,0
5066,318,330,537,872,77,11,2,219,542,94,207,0,0
5067,318,331,537,872,77,11,2,219,541,95,207,0,0
5068,318,332,537,871,77,11,2,219,539,96,207,0,0
5069,318,333,537,871,77,11,2,219,538,97,207,0,0
5070,318,333,537,871,77,11,2,219,538,98,207,0,0
5071,318,334,537,873,77,11,2,219,539,99,207,0,0
5072,319,336,537,873,77,11,2,218,537,100,207,0,0
5073,319,337,537,873,77,11,2,218,536,101,207,0,0
5074,319,338,537,874,77,11,2,218,536,102,207,0,0
5075,319,336,538,874,77,11,2,219,538,103,207,0,0
5076,318,335,537,874,77,11,2,219,539,104,207,0,0
5077,319,337,538,874,77,11,2,219,537,105,207,0,0
5078,318,335,537,873,77,11,2,219,538,106,207,0,0
5079,318,335,537,873,77,11,2,219,538,107,207,0,0
5080,317,334,538,873,77,11,2,221,539,108,207,0,0
5081,317,334,537,873,77,11,2,220,539,109,207,0,0
5082,317,334,537,873,77,11,2,220,539,110,207,0,0
5083,318,334,537,873,77,11,2,219,539,111,207,0,0
5084,318,334,537,872,77,11,2,219,538,112,207,0,0
5085,317,334,537,872,77,11,2,220,538,113,207,0,0
5086,318,335,537,873,77,11,2,219,538,114,207,0,0
5087,319,339,538,874,77,11,2,219,535,115,207,0,0
5088,319,337,538,874,77,11,2,219,537,116,207,0,0
5089,318,336,538,874,77,11,2,220,538,117,207,0,0
5090,318,336,538,874,77,11,2,220,538,118,207,0,0
5091,319,338,537,872,77,11,2,218,534,119,207,0,0
5092,320,338,537,871,77,11,2,217,533,120,207,0,0
5093,320,338,537,871,77,11,2,217,533,121,207,0,0
5094,320,338,538,871,77,11,2,218,533,122,207,0,0
5095,320,338,538,871,77,11,2,218,533,123,207,0,0
5096,319,336,538,872,77,11,2,219,536,124,207,0,0
5097,318,334,538,872,77,11,2,220,538,125,207,0,0
5098,319,334,538,872,77,11,2,219,538,126,207,0,0
5099,319,334,538,872,77,11,2,219,538,127,207,0,0
5100,318,333,537,872,77,11,2,219,539,128,207,0,0
5101,319,332,536,866,77,11,2,217,534,129,207,0,0
5102,325,331,539,860,77,11,2,214,529,130,207,0,0
5103,335,332,539,843,77,11,2,204,511,131,207,0,0
5104,338,326,538,836,77,11,2,200,510,132,207,0,0
5105,351,313,540,809,77,11,2,189,496,133,207,0,0
5106,366,300,548,786,77,11,2,182,486,134,207,0,0
5107,377,294,552,766,77,11,2,175,472,135,207,0,0
5108,378,290,550,757,77,11,2,172,467,136,207,0,0
5109,376,284,543,744,77,11,2,167,460,137,207,0,0
5110,373,277,535,727,77,11,2,162,450,138,207,0,0
5111,370,274,529,722,77,11,2,159,448,139,207,0,0
5112,370,270,525,714,77,11,2,155,444,140,207,0,0
5113,378,265,523,682,77,11,2,145,417,141,207,0,0
5114,383,261,522,661,77,11,2,139,400,142,207,0,0
5115,375,255,511,649,77,11,2,136,394,143,207,0,0
5116,364,250,497,636,77,11,2,133,386,144,207,0,0
5117,351,244,479,616,77,11,2,128,372,145,207,0,0
5118,344,243,469,610,77,11,2,125,367,146,207,0,0
5119,341,240,464,602,77,11,2,123,362,147,207,0,0
5120,342,234,459,577,77,11,2,117,343,148,207,0,0
5121,339,230,451,562,77,11,2,112,332,149,207,0,0
5122,334,229,442,551,77,11,2,108,322,150,207,0,0
5123,327,227,430,533,77,11,2,103,306,151,207,0,0
5124,323,223,423,526,77,11,2,100,303,152,207,0,0
5125,321,224,418,520,77,11,2,97,296,153,207,0,0
5126,324,221,415,499,77,11,2,91,278,154,207,0,0
5127,324,218,412,488,77,11,2,88,270,155,207,0,0
5128,320,217,406,480,77,11,2,86,263,156,207,0,0
5129,318,211,401,468,77,11,2,83,257,157,207,0,0
5130,313,204,397,464,77,11,2,84,260,158,207,0,0
5131,311,204,393,462,77,11,2,82,258,159,207,0,0
5132,315,202,394,450,77,11,2,79,248,160,207,0,0
5133,316,199,394,447,77,11,2,78,248,161,207,0,0
5134,315,199,390,440,77,11,2,75,241,162,207,0,0
5135,313,197,385,430,77,11,2,72,233,163,207,0,0
5136,310,197,381,425,77,11,2,71,228,164,207,0,0
5137,311,196,380,423,77,11,2,69,227,165,207,0,0
5138,317,192,383,409,77,11,2,66,217,166,207,0,0
5139,322,190,387,403,77,11,2,65,213,167,207,0,0
5140,322,195,383,394,77,11,2,61,199,168,207,0,0
5141,320,184,383,393,77,11,2,63,209,169,207,0,0
5142,319,183,380,386,77,11,2,61,203,170,207,0,0
5143,320,182,381,381,77,11,2,61,199,171,207,0,0
5144,324,177,384,375,77,11,2,60,198,172,207,0,0
5145,326,176,385,370,77,11,2,59,194,173,207,0,0
5146,324,177,382,368,77,11,2,58,191,174,207,0,0
5147,321,176,378,365,77,11,2,57,189,175,207,0,0
5148,319,175,375,364,77,11,2,56,189,176,207,0,0
5149,319,175,374,360,77,11,2,55,185,177,207,0,0
5150,322,176,375,353,77,11,2,53,177,178,207,0,0
5151,324,176,377,349,77,11,2,53,173,179,207,0,0
5152,323,175,375,346,77,11,2,52,171,180,207,0,0
5153,320,174,371,342,77,11,2,51,168,181,207,0,0
5154,318,170,368,339,77,11,2,50,169,182,207,0,0
5155,317,171,367,336,77,11,2,50,165,183,207,0,0
5156,319,170,367,330,77,11,2,48,160,184,207,0,0
5157,318,167,367,328,77,11,2,49,161,185,207,0,0
5158,315,166,363,327,77,11,2,48,161,186,207,0,0
5159,311,165,359,323,77,11,2,48,158,187,207,0,0
5160,307,161,354,321,77,11,2,47,160,188,207,0,0
5161,307,164,352,317,77,11,2,45,153,189,207,0,0
5162,306,163,349,314,77,11,2,43,151,190,207,0,0
5163,304,161,347,309,77,11,2,43,148,191,207,0,0
5164,301,159,343,309,77,11,2,42,150,192,207,0,0
5165,298,158,340,304,77,11,2,42,146,193,207,0,0
5166,296,157,337,302,77,11,2,41,145,194,207,0,0
5167,296,155,336,299,77,11,2,40,144,195,207,0,0
5168,296,153,336,295,77,11,2,40,142,196,207,0,0
5169,297,152,337,295,77,11,2,40,143,197,207,0,0
5170,297,150,336,292,77,11,2,39,142,198,207,0,0
5171,297,150,336,288,77,11,2,39,138,199,207,0,0
5172,298,150,336,285,77,11,2,38,135,200,207,0,0
5173,299,149,337,281,77,11,2,38,132,201,207,0,0
5174,300,146,337,279,77,11,2,37,133,202,207,0,0
5175,300,145,337,278,77,11,2,37,133,203,207,0,0
5176,300,143,337,276,77,11,2,37,133,204,207,0,0
5177,300,146,336,275,77,11,2,36,129,205,207,0,0
5178,302,145,337,272,77,11,2,35,127,206,207,0,0
5179,305,143,340,268,77,11,2,35,125,207,207,1,0
5181,309,139,344,266,77,11,2,35,127,0,207,0,0
4988,825,352,877,473,78,11,2,52,121,0,1,0,0
4989,824,352,876,473,78,11,2,52,121,1,1,0,0
5005,0,897,79,1080,79,11,2,79,183,0,0,0,0
5006,819,357,878,480,80,11,2,59,123,0,5,0,0
5007,819,357,877,479,80,11,2,58,122,1,5,0,0
5008,818,357,877,478,80,11,2,59,121,2,5,0,0
5009,818,357,877,479,80,11,2,59,122,3,5,0,0
5010,819,357,877,479,80,11,2,58,122,4,5,0,0
5011,819,357,877,479,80,11,2,58,122,5,5,0,0
5211,819,360,877,477,81,11,2,58,117,0,5,0,0
5212,818,360,876,476,81,11,2,58,116,1,5,0,0
5213,818,359,877,476,81,11,2,59,117,2,5,0,0
5214,818,358,876,476,81,11,2,58,118,3,5,0,0
5215,818,358,876,476,81,11,2,58,118,4,5,0,0
5216,818,358,876,475,81,11,2,58,117,5,5,0,0
5313,0,948,116,1080,82,11,2,116,132,0,0,0,0
5314,5,589,182,1070,83,11,2,177,481,0,55,0,1
5315,32,569,216,1068,83,11,2,184,499,1,55,0,0
5316,117,548,311,1067,83,11,2,194,519,2,55,0,0
5317,180,525,384,1065,83,11,2,204,540,3,55,0,0
5318,233,493,449,1062,83,11,2,216,569,4,55,0,0
5319,290,473,512,1055,83,11,2,222,582,5,55,0,0
5320,339,451,553,1010,83,11,2,214,559,6,55,0,0
5321,364,428,570,969,83,11,2,206,541,7,55,0,0
5322,389,416,589,945,83,11,2,200,529,8,55,0,0
5323,403,391,587,882,83,11,2,184,491,9,55,0,0
5324,408,374,582,843,83,11,2,174,469,10,55,0,0
5325,413,361,577,814,83,11,2,164,453,11,55,0,0
5326,414,338,567,765,83,11,2,153,427,12,55,0,0
5327,413,332,559,740,83,11,2,146,408,13,55,0,0
5328,409,322,545,705,83,11,2,136,383,14,55,0,0
5329,400,307,530,678,83,11,2,130,371,15,55,0,0
5330,387,300,515,669,83,11,2,128,369,16,55,0,0
5331,378,290,499,644,83,11,2,121,354,17,55,0,0
5332,370,285,483,614,83,11,2,113,329,18,55,0,0
5333,362,281,471,597,83,11,2,109,316,19,55,0,0
5334,350,272,454,578,83,11,2,104,306,20,55,0,0
5335,340,267,441,566,83,11,2,101,299,21,55,0,0
5336,334,265,433,558,83,11,2,99,293,22,55,0,0
5337,335,259,428,533,83,11,2,93,274,23,55,0,0
5338,335,255,424,519,83,11,2,89,264,24,55,0,0
5339,334,252,422,510,83,11,2,88,258,25,55,0,0
5340,335,245,420,492,83,11,2,85,247,26,55,0,0
5341,338,238,425,490,83,11,2,87,252,27,55,0,0
5342,344,233,429,479,83,11,2,85,246,28,55,0,0
5343,348,228,430,462,83,11,2,82,234,29,55,0,0
5344,356,230,432,447,83,11,2,76,217,30,55,0,0
5345,355,228,431,444,83,11,2,76,216,31,55,0,0
5346,353,223,427,436,83,11,2,74,213,32,55,0,0
5347,352,222,424,430,83,11,2,72,208,33,55,0,0
5348,352,214,423,422,83,11,2,71,208,34,55,0,0
5349,351,209,420,415,83,11,2,69,206,35,55,0,0
5350,351,211,416,404,83,11,2,65,193,36,55,0,0
5351,347,206,411,399,83,11,2,64,193,37,55,0,0
5352,345,204,408,395,83,11,2,63,191,38,55,0,0
5353,347,202,408,390,83,11,2,61,188,39,55,0,0
5354,349,203,407,382,83,11,2,58,179,40,55,0,0
5355,351,211,404,376,83,11,2,53,165,41,55,0,0
5356,350,210,401,369,83,11,2,51,159,42,55,0,0
5357,352,209,400,362,83,11,2,48,153,43,55,0,0
5358,350,207,398,359,83,11,2,48,152,44,55,0,0
5359,351,203,398,354,83,11,2,47,151,45,55,0,0
5360,347,193,396,354,83,11,2,49,161,46,55,0,0
5361,349,200,394,352,83,11,2,45,152,47,55,0,0
5362,344,191,390,346,83,11,2,46,155,48,55,0,0
5363,342,185,388,343,83,11,2,46,158,49,55,0,0
5364,341,186,385,337,83,11,2,44,151,50,55,0,0
5365,342,186,385,333,83,11,2,43,147,51,55,0,0
5366,342,184,384,330,83,11,2,42,146,52,55,0,0
5367,341,186,382,329,83,11,2,41,143,53,55,0,0
5368,339,190,377,322,83,11,2,38,132,54,55,0,0
5369,335,181,375,319,83,11,2,40,138,55,55,1,0
5371,335,184,372,311,83,11,2,37,127,0,55,0,0
5372,335,184,370,306,83,11,2,35,122,1,55,0,0
5466,776,301,868,467,84,11,2,92,166,0,5,0,0
5467,776,301,868,467,84,11,2,92,166,1,5,0,0
5468,775,301,868,468,84,11,2,93,167,2,5,0,0
5469,776,301,868,467,84,11,2,92,166,3,5,0,0
5470,776,302,868,467,84,11,2,92,165,4,5,0,0
5471,777,302,868,467,84,11,2,91,165,5,5,0,0
15,568,166,613,369,1,11,3,45,203,0,39,0,1
16,554,167,599,367,1,11,3,45,200,1,39,0,0
17,536,170,582,373,1,11,3,46,203,2,39,0,0
18,521,171,570,376,1,11,3,49,205,3,39,0,0
19,513,171,565,387,1,11,3,52,216,4,39,0,0
20,508,176,562,396,1,11,3,54,220,5,39,0,0
21,505,174,562,400,1,11,3,57,226,6,39,0,0
22,504,179,563,410,1,11,3,59,231,7,39,0,0
23,501,180,564,417,1,11,3,63,237,8,39,0,0
24,501,183,567,427,1,11,3,66,244,9,39,0,0
25,505,189,573,440,1,11,3,68,251,10,39,0,0
26,515,187,585,444,1,11,3,70,257,11,39,0,0
27,521,192,598,462,1,11,3,77,270,12,39,0,0
28,528,194,610,473,1,11,3,82,279,13,39,0,0
29,533,197,618,483,1,11,3,85,286,14,39,0,0
30,541,205,628,495,1,11,3,87,290,15,39,0,0
31,554,207,646,512,1,11,3,92,305,16,39,0,0
32,564,213,663,533,1,11,3,99,320,17,39,0,0
33,574,220,679,547,1,11,3,105,327,18,39,0,0
34,580,220,688,559,1,11,3,108,339,19,39,0,0
35,587,230,697,577,1,11,3,110,347,20,39,0,0
36,606,236,718,587,1,11,3,112,351,21,39,0,0
37,615,240,742,620,1,11,3,127,380,22,39,0,0
38,624,251,762,652,1,11,3,138,401,23,39,0,0
39,635,258,776,670,1,11,3,141,412,24,39,0,0
40,650,268,795,699,1,11,3,145,431,25,39,0,0
41,676,277,827,723,1,11,3,151,446,26,39,0,0
42,691,291,859,771,1,11,3,168,480,27,39,0,0
43,713,305,897,810,1,11,3,184,505,28,39,0,0
44,741,312,931,836,1,11,3,190,524,29,39,0,0
45,769,335,970,896,1,11,3,201,561,30,39,0,0
46,814,354,1018,927,1,11,3,204,573,31,39,0,0
47,860,378,1090,1000,1,11,3,230,622,32,39,0,0
48,907,404,1156,1052,1,11,3,249,648,33,39,0,0
49,969,417,1220,1076,1,11,3,251,659,34,39,0,0
50,1024,455,1272,1080,1,11,3,248,625,35,39,0,0
51,1146,491,1385,1080,1,11,3,239,589,36,39,0,0
52,1257,545,1493,1080,1,11,3,236,535,37,39,0,0
53,1370,613,1599,1080,1,11,3,229,467,38,39,0,0
54,1423,638,1649,1080,1,11,3,226,442,39,39,1,0
54,1542,665,1840,1071,2,11,3,298,406,0,1,0,0
55,1632,716,1896,1075,2,11,3,264,359,1,1,0,0
57,1791,917,1920,1077,3,11,3,129,160,0,0,0,0
75,1289,836,1521,1072,7,11,3,232,236,0,1,0,0
76,1165,816,1415,1068,7,11,3,250,252,1,1,0,0
256,351,138,386,230,14,11,3,35,92,0,9,0,0
257,349,140,384,232,14,11,3,35,92,1,9,0,0
258,347,139,383,232,14,11,3,36,93,2,9,0,0
259,347,140,383,233,14,11,3,36,93,3,9,0,0
260,347,141,384,234,14,11,3,37,93,4,9,0,0
261,346,142,383,236,14,11,3,37,94,5,9,0,0
262,344,143,382,238,14,11,3,38,95,6,9,0,0
263,342,142,380,239,14,11,3,38,97,7,9,0,0
264,335,145,384,272,14,11,3,49,127,8,9,0,0
265,333,146,384,277,14,11,3,51,131,9,9,0,0
270,328,149,370,262,14,11,3,42,113,0,9,0,0
271,326,152,363,254,14,11,3,37,102,1,9,0,0
272,320,155,355,252,14,11,3,35,97,2,9,0,0
273,308,154,347,260,14,11,3,39,106,3,9,0,0
274,301,154,343,267,14,11,3,42,113,4,9,0,0
275,297,155,340,270,14,11,3,43,115,5,9,0,0
276,294,165,332,266,14,11,3,38,101,6,9,0,0
277,290,167,328,269,14,11,3,38,102,7,9,0,0
255,514,156,559,322,15,11,3,45,166,0,17,0,0
256,503,166,541,308,15,11,3,38,142,1,17,0,0
257,483,164,525,316,15,11,3,42,152,2,17,0,0
258,465,168,506,315,15,11,3,41,147,3,17,0,0
259,446,169,484,308,15,11,3,38,139,4,17,0,0
260,428,166,468,312,15,11,3,40,146,5,17,0,0
261,408,166,448,311,15,11,3,40,145,6,17,0,0
262,391,165,430,303,15,11,3,39,138,7,17,0,0
263,373,165,414,306,15,11,3,41,141,8,17,0,0
264,358,163,399,302,15,11,3,41,139,9,17,0,0
265,344,158,387,305,15,11,3,43,147,10,17,0,0
266,332,159,376,306,15,11,3,44,147,11,17,0,0
267,326,158,369,302,15,11,3,43,144,12,17,0,0
268,323,157,364,294,15,11,3,41,137,13,17,0,0
269,316,157,357,292,15,11,3,41,135,14,17,0,0
270,305,150,347,291,15,11,3,42,141,15,17,0,0
271,296,152,336,285,15,11,3,40,133,16,17,0,0
272,289,160,324,277,15,11,3,35,117,17,17,0,0
336,547,179,609,374,19,11,3,62,195,0,47,0,1
337,532,179,593,370,19,11,3,61,191,1,47,0,0
338,512,177,573,371,19,11,3,61,194,2,47,0,0
339,487,180,551,377,19,11,3,64,197,3,47,0,0
340,468,180,533,380,19,11,3,65,200,4,47,0,0
341,449,183,516,390,19,11,3,67,207,5,47,0,0
342,431,184,501,397,19,11,3,70,213,6,47,0,0
343,414,184,484,399,19,11,3,70,215,7,47,0,0
344,394,189,464,402,19,11,3,70,213,8,47,0,0
345,380,193,451,410,19,11,3,71,217,9,47,0,0
346,370,194,443,413,19,11,3,73,219,10,47,0,0
347,362,199,436,425,19,11,3,74,226,11,47,0,0
348,361,203,436,429,19,11,3,75,226,12,47,0,0
349,361,206,439,440,19,11,3,78,234,13,47,0,0
350,360,209,443,455,19,11,3,83,246,14,47,0,0
351,362,210,444,453,19,11,3,82,243,15,47,0,0
352,363,213,448,467,19,11,3,85,254,16,47,0,0
353,369,219,456,480,19,11,3,87,261,17,47,0,0
354,379,220,472,494,19,11,3,93,274,18,47,0,0
355,384,223,484,511,19,11,3,100,288,19,47,0,0
356,387,225,489,519,19,11,3,102,294,20,47,0,0
357,390,232,496,540,19,11,3,106,308,21,47,0,0
358,397,233,507,553,19,11,3,110,320,22,47,0,0
359,421,238,537,566,19,11,3,116,328,23,47,0,0
360,420,247,540,591,19,11,3,120,344,24,47,0,0
361,429,253,553,605,19,11,3,124,352,25,47,0,0
362,429,262,559,631,19,11,3,130,369,26,47,0,0
363,438,264,575,654,19,11,3,137,390,27,47,0,0
364,455,271,603,677,19,11,3,148,406,28,47,0,0
365,460,283,621,708,19,11,3,161,425,29,47,0,0
366,455,290,624,733,19,11,3,169,443,30,47,0,0
367,440,302,624,787,19,11,3,184,485,31,47,0,0
368,442,315,626,807,19,11,3,184,492,32,47,0,0
369,461,328,655,835,19,11,3,194,507,33,47,0,0
370,465,349,676,886,19,11,3,211,537,34,47,0,0
371,452,364,671,914,19,11,3,219,550,35,47,0,0
372,426,385,662,984,19,11,3,236,599,36,47,0,0
373,423,406,673,1041,19,11,3,250,635,37,47,0,0
374,444,429,703,1068,19,11,3,259,639,38,47,0,0
375,464,462,727,1077,19,11,3,263,615,39,47,0,0
376,462,498,725,1080,19,11,3,263,582,40,47,0,0
377,447,543,697,1080,19,11,3,250,537,41,47,0,0
378,460,607,693,1080,19,11,3,233,473,42,47,0,0
379,465,661,692,1080,19,11,3,227,419,43,47,0,0
380,449,725,664,1077,19,11,3,215,352,44,47,0,0
381,437,820,623,1080,19,11,3,186,260,45,47,0,0
382,429,910,572,1079,19,11,3,143,169,46,47,0,0
383,437,964,542,1080,19,11,3,105,116,47,47,1,0
609,350,129,385,222,21,11,3,35,93,0,90,0,1
610,348,128,383,222,21,11,3,35,94,1,90,0,0
611,346,128,383,225,21,11,3,37,97,2,90,0,0
612,348,131,383,224,21,11,3,35,93,3,90,0,0
613,349,132,385,227,21,11,3,36,95,4,90,0,0
614,350,135,386,232,21,11,3,36,97,5,90,0,0
615,351,136,386,231,21,11,3,35,95,6,90,0,0
616,350,137,386,232,21,11,3,36,95,7,90,0,0
617,351,139,386,234,21,11,3,35,95,8,90,0,0
618,351,136,389,236,21,11,3,38,100,9,90,0,0
619,352,137,390,239,21,11,3,38,102,10,90,0,0
620,351,139,390,242,21,11,3,39,103,11,90,0,0
621,349,137,389,245,21,11,3,40,108,12,90,0,0
622,347,139,388,249,21,11,3,41,110,13,90,0,0
623,347,140,387,248,21,11,3,40,108,14,90,0,0
624,347,140,388,250,21,11,3,41,110,15,90,0,0
625,348,144,387,251,21,11,3,39,107,16,90,0,0
626,346,143,387,253,21,11,3,41,110,17,90,0,0
627,344,144,386,256,21,11,3,42,112,18,90,0,0
628,343,145,386,258,21,11,3,43,113,19,90,0,0
629,343,144,388,263,21,11,3,45,119,20,90,0,0
630,343,147,389,269,21,11,3,46,122,21,90,0,0
631,343,147,388,265,21,11,3,45,118,22,90,0,0
632,342,146,388,269,21,11,3,46,123,23,90,0,0
633,341,147,388,273,21,11,3,47,126,24,90,0,0
634,342,146,389,272,21,11,3,47,126,25,90,0,0
635,342,148,390,276,21,11,3,48,128,26,90,0,0
636,342,149,389,276,21,11,3,47,127,27,90,0,0
637,339,148,388,281,21,11,3,49,133,28,90,0,0
638,338,150,388,288,21,11,3,50,138,29,90,0,0
639,338,152,389,292,21,11,3,51,140,30,90,0,0
640,338,150,391,297,21,11,3,53,147,31,90,0,0
641,339,152,392,302,21,11,3,53,150,32,90,0,0
642,340,154,392,302,21,11,3,52,148,33,90,0,0
643,341,154,393,305,21,11,3,52,151,34,90,0,0
644,343,156,394,308,21,11,3,51,152,35,90,0,0
645,348,157,399,309,21,11,3,51,152,36,90,0,0
646,355,166,407,315,21,11,3,52,149,37,90,0,0
647,360,169,412,320,21,11,3,52,151,38,90,0,0
648,365,168,418,322,21,11,3,53,154,39,90,0,0
649,371,173,424,327,21,11,3,53,154,40,90,0,0
650,377,175,431,329,21,11,3,54,154,41,90,0,0
651,383,172,439,334,21,11,3,56,162,42,90,0,0
652,390,175,448,346,21,11,3,58,171,43,90,0,0
653,396,174,457,354,21,11,3,61,180,44,90,0,0
654,401,174,464,358,21,11,3,63,184,45,90,0,0
655,406,176,470,364,21,11,3,64,188,46,90,0,0
656,416,176,481,366,21,11,3,65,190,47,90,0,0
657,422,180,489,372,21,11,3,67,192,48,90,0,0
658,426,189,493,380,21,11,3,67,191,49,90,0,0
659,429,189,497,385,21,11,3,68,196,50,90,0,0
660,431,191,502,395,21,11,3,71,204,51,90,0,0
661,439,192,511,400,21,11,3,72,208,52,90,0,0
662,446,190,521,404,21,11,3,75,214,53,90,0,0
663,452,193,528,415,21,11,3,76,222,54,90,0,0
664,452,191,532,426,21,11,3,80,235,55,90,0,0
665,454,193,535,434,21,11,3,81,241,56,90,0,0
666,458,201,541,446,21,11,3,83,245,57,90,0,0
667,466,202,551,450,21,11,3,85,248,58,90,0,0
668,474,205,564,468,21,11,3,90,263,59,90,0,0
669,482,211,574,480,21,11,3,92,269,60,90,0,0
670,487,210,581,487,21,11,3,94,277,61,90,0,0
671,493,217,590,504,21,11,3,97,287,62,90,0,0
672,501,219,602,520,21,11,3,101,301,63,90,0,0
673,512,223,616,531,21,11,3,104,308,64,90,0,0
674,519,235,628,555,21,11,3,109,320,65,90,0,0
675,522,239,635,569,21,11,3,113,330,66,90,0,0
676,524,244,641,586,21,11,3,117,342,67,90,0,0
677,534,253,653,603,21,11,3,119,350,68,90,0,0
678,551,253,673,614,21,11,3,122,361,69,90,0,0
679,567,267,697,648,21,11,3,130,381,70,90,0,0
680,581,282,719,681,21,11,3,138,399,71,90,0,0
681,592,284,734,697,21,11,3,142,413,72,90,0,0
682,611,297,759,729,21,11,3,148,432,73,90,0,0
683,627,306,780,756,21,11,3,153,450,74,90,0,0
684,646,319,807,783,21,11,3,161,464,75,90,0,0
685,653,337,828,842,21,11,3,175,505,76,90,0,0
686,662,349,843,869,21,11,3,181,520,77,90,0,0
687,673,357,866,910,21,11,3,193,553,78,90,0,0
688,687,382,894,981,21,11,3,207,599,79,90,0,0
689,711,393,924,1005,21,11,3,213,612,80,90,0,0
690,733,418,955,1055,21,11,3,222,637,81,90,0,0
691,748,464,963,1070,21,11,3,215,606,82,90,0,0
692,751,486,968,1079,21,11,3,217,593,83,90,0,0
693,755,519,970,1080,21,11,3,215,561,84,90,0,0
694,781,568,991,1080,21,11,3,210,512,85,90,0,0
695,811,611,1018,1080,21,11,3,207,469,86,90,0,0
696,830,672,1032,1080,21,11,3,202,408,87,90,0,0
697,812,749,997,1080,21,11,3,185,331,88,90,0,0
698,798,818,967,1078,21,11,3,169,260,89,90,0,0
699,812,860,961,1080,21,11,3,149,220,90,90,1,0
619,519,410,731,1004,23,11,3,212,594,0,17,0,0
620,515,383,724,964,23,11,3,209,581,1,17,0,0
621,497,367,704,938,23,11,3,207,571,2,17,0,0
622,475,342,664,860,23,11,3,189,518,3,17,0,0
623,459,331,637,824,23,11,3,178,493,4,17,0,0
624,440,321,612,795,23,11,3,172,474,5,17,0,0
625,431,305,598,757,23,11,3,167,452,6,17,0,0
626,418,295,583,730,23,11,3,165,435,7,17,0,0
627,404,287,555,690,23,11,3,151,403,8,17,0,0
628,389,276,535,672,23,11,3,146,396,9,17,0,0
629,372,270,512,649,23,11,3,140,379,10,17,0,0
630,342,259,478,628,23,11,3,136,369,11,17,0,0
631,324,257,456,615,23,11,3,132,358,12,17,0,0
632,298,252,418,579,23,11,3,120,327,13,17,0,0
633,272,249,390,574,23,11,3,118,325,14,17,0,0
634,250,241,373,577,23,11,3,123,336,15,17,0,0
635,224,240,333,551,23,11,3,109,311,16,17,0,0
636,202,233,307,530,23,11,3,105,297,17,17,0,0
646,417,224,452,308,24,11,3,35,84,0,0,0,0
706,255,160,351,266,25,11,3,96,106,0,5,0,0
707,254,161,365,286,25,11,3,111,125,1,5,0,0
708,258,158,378,296,25,11,3,120,138,2,5,0,0
709,267,156,392,303,25,11,3,125,147,3,5,0,0
710,275,158,400,309,25,11,3,125,151,4,5,0,0
711,276,158,410,320,25,11,3,134,162,5,5,0,0
711,319,158,364,300,26,11,3,45,142,0,68,0,1
712,320,160,365,302,26,11,3,45,142,1,68,0,0
713,325,163,371,310,26,11,3,46,147,2,68,0,0
714,332,160,379,310,26,11,3,47,150,3,68,0,0
715,338,160,386,314,26,11,3,48,154,4,68,0,0
716,340,163,388,314,26,11,3,48,151,5,68,0,0
717,341,163,390,316,26,11,3,49,153,6,68,0,0
718,344,165,393,321,26,11,3,49,156,7,68,0,0
719,351,166,401,324,26,11,3,50,158,8,68,0,0
720,360,169,409,325,26,11,3,49,156,9,68,0,0
721,366,172,415,328,26,11,3,49,156,10,68,0,0
722,370,171,421,334,26,11,3,51,163,11,68,0,0
723,374,172,429,345,26,11,3,55,173,12,68,0,0
724,380,173,437,350,26,11,3,57,177,13,68,0,0
725,392,173,450,353,26,11,3,58,180,14,68,0,0
726,401,175,460,357,26,11,3,59,182,15,68,0,0
727,406,175,467,363,26,11,3,61,188,16,68,0,0
728,410,176,472,366,26,11,3,62,190,17,68,0,0
729,415,178,478,370,26,11,3,63,192,18,68,0,0
730,425,179,489,372,26,11,3,64,193,19,68,0,0
731,432,182,500,385,26,11,3,68,203,20,68,0,0
732,438,183,507,391,26,11,3,69,208,21,68,0,0
733,446,184,515,393,26,11,3,69,209,22,68,0,0
734,455,190,524,398,26,11,3,69,208,23,68,0,0
735,465,191,535,402,26,11,3,70,211,24,68,0,0
736,474,194,546,414,26,11,3,72,220,25,68,0,0
737,483,194,556,418,26,11,3,73,224,26,68,0,0
738,486,193,560,418,26,11,3,74,225,27,68,0,0
739,490,201,566,430,26,11,3,76,229,28,68,0,0
740,496,205,573,435,26,11,3,77,230,29,68,0,0
741,509,209,588,444,26,11,3,79,235,30,68,0,0
742,515,215,597,457,26,11,3,82,242,31,68,0,0
743,520,217,603,461,26,11,3,83,244,32,68,0,0
744,524,222,611,473,26,11,3,87,251,33,68,0,0
745,531,224,620,480,26,11,3,89,256,34,68,0,0
746,542,225,636,492,26,11,3,94,267,35,68,0,0
747,551,233,647,509,26,11,3,96,276,36,68,0,0
748,561,236,658,515,26,11,3,97,279,37,68,0,0
749,568,243,668,530,26,11,3,100,287,38,68,0,0
750,578,250,682,544,26,11,3,104,294,39,68,0,0
751,598,253,704,553,26,11,3,106,300,40,68,0,0
752,616,261,724,570,26,11,3,108,309,41,68,0,0
753,632,267,743,585,26,11,3,111,318,42,68,0,0
754,647,273,760,593,26,11,3,113,320,43,68,0,0
755,662,287,779,611,26,11,3,117,324,44,68,0,0
756,687,293,807,624,26,11,3,120,331,45,68,0,0
757,713,299,839,648,26,11,3,126,349,46,68,0,0
758,735,308,865,668,26,11,3,130,360,47,68,0,0
759,754,314,885,677,26,11,3,131,363,48,68,0,0
760,774,328,913,704,26,11,3,139,376,49,68,0,0
761,800,338,944,725,26,11,3,144,387,50,68,0,0
762,839,344,988,741,26,11,3,149,397,51,68,0,0
763,867,356,1029,785,26,11,3,162,429,52,68,0,0
764,890,360,1057,807,26,11,3,167,447,53,68,0,0
765,914,374,1086,833,26,11,3,172,459,54,68,0,0
766,941,386,1123,872,26,11,3,182,486,55,68,0,0
767,985,398,1170,889,26,11,3,185,491,56,68,0,0
768,1017,422,1219,959,26,11,3,202,537,57,68,0,0
769,1050,439,1259,996,26,11,3,209,557,58,68,0,0
770,1082,459,1296,1022,26,11,3,214,563,59,68,0,0
771,1123,499,1341,1060,26,11,3,218,561,60,68,0,0
772,1185,523,1407,1073,26,11,3,222,550,61,68,0,0
773,1253,563,1474,1079,26,11,3,221,516,62,68,0,0
774,1316,598,1534,1080,26,11,3,218,482,63,68,0,0
775,1388,627,1609,1080,26,11,3,221,453,64,68,0,0
776,1494,674,1704,1080,26,11,3,210,406,65,68,0,0
777,1611,712,1813,1080,26,11,3,202,368,66,68,0,0
778,1698,752,1882,1080,26,11,3,184,328,67,68,0,0
779,1763,779,1920,1080,26,11,3,157,301,68,68,1,0
781,395,418,1020,1053,29,11,3,625,635,0,2,0,0
782,365,395,972,1041,29,11,3,607,646,1,2,0,0
783,316,359,953,1037,29,11,3,637,678,2,2,0,0
805,344,164,379,257,30,11,3,35,93,0,75,0,1
806,340,162,378,264,30,11,3,38,102,1,75,0,0
807,338,162,377,271,30,11,3,39,109,2,75,0,0
808,339,161,379,272,30,11,3,40,111,3,75,0,0
809,339,162,380,272,30,11,3,41,110,4,75,0,0
810,338,162,379,276,30,11,3,41,114,5,75,0,0
811,339,164,380,278,30,11,3,41,114,6,75,0,0
812,339,164,381,281,30,11,3,42,117,7,75,0,0
813,342,166,384,284,30,11,3,42,118,8,75,0,0
814,342,166,385,289,30,11,3,43,123,9,75,0,0
815,342,167,387,297,30,11,3,45,130,10,75,0,0
816,345,168,390,298,30,11,3,45,130,11,75,0,0
817,346,169,392,302,30,11,3,46,133,12,75,0,0
818,352,169,399,305,30,11,3,47,136,13,75,0,0
819,356,166,405,309,30,11,3,49,143,14,75,0,0
820,363,168,411,310,30,11,3,48,142,15,75,0,0
821,371,170,420,313,30,11,3,49,143,16,75,0,0
822,377,172,427,316,30,11,3,50,144,17,75,0,0
823,384,176,433,317,30,11,3,49,141,18,75,0,0
824,394,175,444,318,30,11,3,50,143,19,75,0,0
825,399,178,450,325,30,11,3,51,147,20,75,0,0
826,405,180,457,328,30,11,3,52,148,21,75,0,0
827,410,180,464,333,30,11,3,54,153,22,75,0,0
828,419,184,473,339,30,11,3,54,155,23,75,0,0
829,429,183,484,341,30,11,3,55,158,24,75,0,0
830,434,184,492,350,30,11,3,58,166,25,75,0,0
831,436,187,495,355,30,11,3,59,168,26,75,0,0
832,442,186,502,356,30,11,3,60,170,27,75,0,0
833,450,192,510,364,30,11,3,60,172,28,75,0,0
834,458,194,519,366,30,11,3,61,172,29,75,0,0
835,466,195,527,368,30,11,3,61,173,30,75,0,0
836,469,198,533,380,30,11,3,64,182,31,75,0,0
837,475,199,540,384,30,11,3,65,185,32,75,0,0
838,479,200,548,395,30,11,3,69,195,33,75,0,0
839,485,203,555,401,30,11,3,70,198,34,75,0,0
840,494,204,567,408,30,11,3,73,204,35,75,0,0
841,500,207,575,423,30,11,3,75,216,36,75,0,0
842,506,209,583,427,30,11,3,77,218,37,75,0,0
843,513,214,591,434,30,11,3,78,220,38,75,0,0
844,522,221,601,443,30,11,3,79,222,39,75,0,0
845,534,224,613,445,30,11,3,79,221,40,75,0,0
846,540,228,624,462,30,11,3,84,234,41,75,0,0
847,545,233,631,471,30,11,3,86,238,42,75,0,0
848,552,232,639,471,30,11,3,87,239,43,75,0,0
849,557,239,650,490,30,11,3,93,251,44,75,0,0
850,574,245,667,501,30,11,3,93,256,45,75,0,0
851,583,249,682,520,30,11,3,99,271,46,75,0,0
852,589,257,690,534,30,11,3,101,277,47,75,0,0
853,593,260,695,539,30,11,3,102,279,48,75,0,0
854,599,267,706,559,30,11,3,107,292,49,75,0,0
855,611,273,722,574,30,11,3,111,301,50,75,0,0
856,625,277,741,593,30,11,3,116,316,51,75,0,0
857,636,291,755,619,30,11,3,119,328,52,75,0,0
858,647,297,768,630,30,11,3,121,333,53,75,0,0
859,659,303,787,655,30,11,3,128,352,54,75,0,0
860,676,315,806,671,30,11,3,130,356,55,75,0,0
861,697,320,831,688,30,11,3,134,368,56,75,0,0
862,717,335,857,725,30,11,3,140,390,57,75,0,0
863,730,345,874,748,30,11,3,144,403,58,75,0,0
864,744,352,895,775,30,11,3,151,423,59,75,0,0
865,767,373,925,808,30,11,3,158,435,60,75,0,0
866,803,383,965,831,30,11,3,162,448,61,75,0,0
867,834,402,1008,886,30,11,3,174,484,62,75,0,0
868,864,422,1044,921,30,11,3,180,499,63,75,0,0
869,900,444,1083,952,30,11,3,183,508,64,75,0,0
870,931,469,1128,1012,30,11,3,197,543,65,75,0,0
871,986,493,1188,1042,30,11,3,202,549,66,75,0,0
872,1047,523,1251,1071,30,11,3,204,548,67,75,0,0
873,1101,565,1299,1080,30,11,3,198,515,68,75,0,0
874,1166,597,1359,1080,30,11,3,193,483,69,75,0,0
875,1232,641,1417,1080,30,11,3,185,439,70,75,0,0
876,1318,676,1499,1080,30,11,3,181,404,71,75,0,0
877,1414,711,1590,1076,30,11,3,176,365,72,75,0,0
878,1514,773,1675,1080,30,11,3,161,307,73,75,0,0
879,1634,822,1779,1080,30,11,3,145,258,74,75,0,0
880,1707,855,1838,1080,30,11,3,131,225,75,75,1,0
783,512,379,721,925,31,11,3,209,546,0,77,0,1
784,477,354,693,918,31,11,3,216,564,1,77,0,0
785,453,347,668,911,31,11,3,215,564,2,77,0,0
786,436,326,634,849,31,11,3,198,523,3,77,0,0
787,419,305,610,810,31,11,3,191,505,4,77,0,0
788,403,299,586,788,31,11,3,183,489,5,77,0,0
789,391,289,560,744,31,11,3,169,455,6,77,0,0
790,381,284,544,724,31,11,3,163,440,7,77,0,0
791,378,281,529,689,31,11,3,151,408,8,77,0,0
792,376,267,521,660,31,11,3,145,393,9,77,0,0
793,376,257,519,651,31,11,3,143,394,10,77,0,0
794,368,249,501,619,31,11,3,133,370,11,77,0,0
795,358,232,488,599,31,11,3,130,367,12,77,0,0
796,355,228,482,591,31,11,3,127,363,13,77,0,0
797,353,225,470,560,31,11,3,117,335,14,77,0,0
798,346,228,458,547,31,11,3,112,319,15,77,0,0
799,339,230,446,538,31,11,3,107,308,16,77,0,0
800,327,223,430,518,31,11,3,103,295,17,77,0,0
801,319,220,419,509,31,11,3,100,289,18,77,0,0
802,309,214,407,497,31,11,3,98,283,19,77,0,0
803,303,207,398,482,31,11,3,95,275,20,77,0,0
804,296,207,390,478,31,11,3,94,271,21,77,0,0
805,287,208,374,460,31,11,3,87,252,22,77,0,0
806,277,205,360,447,31,11,3,83,242,23,77,0,0
807,274,212,353,444,31,11,3,79,232,24,77,0,0
808,274,212,348,430,31,11,3,74,218,25,77,0,0
809,275,210,347,420,31,11,3,72,210,26,77,0,0
810,272,206,345,418,31,11,3,73,212,27,77,0,0
811,270,197,341,404,31,11,3,71,207,28,77,0,0
812,267,195,339,404,31,11,3,72,209,29,77,0,0
813,267,194,339,402,31,11,3,72,208,30,77,0,0
814,267,187,337,391,31,11,3,70,204,31,77,0,0
815,267,187,334,383,31,11,3,67,196,32,77,0,0
816,267,181,332,370,31,11,3,65,189,33,77,0,0
817,266,178,330,363,31,11,3,64,185,34,77,0,0
818,266,176,329,358,31,11,3,63,182,35,77,0,0
819,270,173,331,350,31,11,3,61,177,36,77,0,0
820,275,172,333,341,31,11,3,58,169,37,77,0,0
821,276,172,333,337,31,11,3,57,165,38,77,0,0
822,277,168,332,329,31,11,3,55,161,39,77,0,0
823,281,172,333,323,31,11,3,52,151,40,77,0,0
824,286,174,337,320,31,11,3,51,146,41,77,0,0
825,293,166,345,318,31,11,3,52,152,42,77,0,0
826,299,165,350,317,31,11,3,51,152,43,77,0,0
827,302,159,355,318,31,11,3,53,159,44,77,0,0
828,306,159,356,309,31,11,3,50,150,45,77,0,0
829,309,161,358,308,31,11,3,49,147,46,77,0,0
830,314,157,362,301,31,11,3,48,144,47,77,0,0
831,317,155,366,300,31,11,3,49,145,48,77,0,0
832,320,155,368,297,31,11,3,48,142,49,77,0,0
833,323,154,368,291,31,11,3,45,137,50,77,0,0
834,324,153,368,285,31,11,3,44,132,51,77,0,0
835,326,154,368,282,31,11,3,42,128,52,77,0,0
836,327,152,369,277,31,11,3,42,125,53,77,0,0
837,327,153,369,278,31,11,3,42,125,54,77,0,0
838,327,152,369,274,31,11,3,42,122,55,77,0,0
839,328,150,369,269,31,11,3,41,119,56,77,0,0
840,330,149,371,267,31,11,3,41,118,57,77,0,0
841,333,145,375,266,31,11,3,42,121,58,77,0,0
842,336,146,378,264,31,11,3,42,118,59,77,0,0
843,338,145,380,264,31,11,3,42,119,60,77,0,0
844,338,142,380,260,31,11,3,42,118,61,77,0,0
845,339,142,380,259,31,11,3,41,117,62,77,0,0
846,341,143,381,257,31,11,3,40,114,63,77,0,0
847,342,141,382,254,31,11,3,40,113,64,77,0,0
848,343,142,382,253,31,11,3,39,111,65,77,0,0
849,341,138,381,251,31,11,3,40,113,66,77,0,0
850,339,137,379,249,31,11,3,40,112,67,77,0,0
851,339,139,378,249,31,11,3,39,110,68,77,0,0
852,340,137,379,247,31,11,3,39,110,69,77,0,0
853,342,138,380,243,31,11,3,38,105,70,77,0,0
854,343,137,380,241,31,11,3,37,104,71,77,0,0
855,341,135,378,238,31,11,3,37,103,72,77,0,0
856,341,136,377,236,31,11,3,36,100,73,77,0,0
857,342,136,377,235,31,11,3,35,99,74,77,0,0
858,344,135,379,233,31,11,3,35,98,75,77,0,0
859,345,136,380,232,31,11,3,35,96,76,77,0,0
860,344,136,379,230,31,11,3,35,94,77,77,1,0
881,1824,964,1917,1073,32,11,3,93,109,0,0,0,0
940,409,156,454,288,33,11,3,45,132,0,54,0,1
941,395,152,442,288,33,11,3,47,136,1,54,0,0
942,384,155,431,292,33,11,3,47,137,2,54,0,0
943,372,157,419,294,33,11,3,47,137,3,54,0,0
944,357,161,406,303,33,11,3,49,142,4,54,0,0
945,345,158,397,308,33,11,3,52,150,5,54,0,0
946,339,162,393,316,33,11,3,54,154,6,54,0,0
947,335,166,389,321,33,11,3,54,155,7,54,0,0
948,331,164,387,324,33,11,3,56,160,8,54,0,0
949,329,169,385,332,33,11,3,56,163,9,54,0,0
950,329,168,386,334,33,11,3,57,166,10,54,0,0
951,332,171,390,339,33,11,3,58,168,11,54,0,0
952,335,172,394,346,33,11,3,59,174,12,54,0,0
953,338,170,401,354,33,11,3,63,184,13,54,0,0
954,342,176,407,364,33,11,3,65,188,14,54,0,0
955,349,176,417,372,33,11,3,68,196,15,54,0,0
956,357,181,426,384,33,11,3,69,203,16,54,0,0
957,365,183,434,388,33,11,3,69,205,17,54,0,0
958,370,183,444,401,33,11,3,74,218,18,54,0,0
959,372,191,448,412,33,11,3,76,221,19,54,0,0
960,382,190,459,417,33,11,3,77,227,20,54,0,0
961,390,197,470,431,33,11,3,80,234,21,54,0,0
962,400,199,481,440,33,11,3,81,241,22,54,0,0
963,404,205,490,458,33,11,3,86,253,23,54,0,0
964,406,212,496,472,33,11,3,90,260,24,54,0,0
965,418,210,510,477,33,11,3,92,267,25,54,0,0
966,431,221,526,497,33,11,3,95,276,26,54,0,0
967,443,223,543,513,33,11,3,100,290,27,54,0,0
968,447,225,552,528,33,11,3,105,303,28,54,0,0
969,452,233,565,553,33,11,3,113,320,29,54,0,0
970,469,235,584,562,33,11,3,115,327,30,54,0,0
971,485,243,606,590,33,11,3,121,347,31,54,0,0
972,501,251,624,605,33,11,3,123,354,32,54,0,0
973,510,256,643,639,33,11,3,133,383,33,54,0,0
974,520,274,657,667,33,11,3,137,393,34,54,0,0
975,541,278,681,681,33,11,3,140,403,35,54,0,0
976,561,292,709,723,33,11,3,148,431,36,54,0,0
977,582,308,733,751,33,11,3,151,443,37,54,0,0
978,591,315,754,792,33,11,3,163,477,38,54,0,0
979,597,340,772,849,33,11,3,175,509,39,54,0,0
980,609,351,792,877,33,11,3,183,526,40,54,0,0
981,623,378,814,930,33,11,3,191,552,41,54,0,0
982,635,402,835,988,33,11,3,200,586,42,54,0,0
983,644,413,858,1035,33,11,3,214,622,43,54,0,0
984,645,447,865,1066,33,11,3,220,619,44,54,0,0
985,640,482,859,1080,33,11,3,219,598,45,54,0,0
986,630,513,847,1080,33,11,3,217,567,46,54,0,0
987,624,569,831,1080,33,11,3,207,511,47,54,0,0
988,608,615,808,1080,33,11,3,200,465,48,54,0,0
989,575,674,763,1080,33,11,3,188,406,49,54,0,0
990,532,741,700,1080,33,11,3,168,339,50,54,0,0
991,467,794,619,1080,33,11,3,152,286,51,54,0,0
992,408,869,535,1079,33,11,3,127,210,52,54,0,0
993,353,946,446,1080,33,11,3,93,134,53,54,0,0
994,287,989,359,1080,33,11,3,72,91,54,54,1,0
971,349,123,389,213,34,11,3,40,90,0,116,0,1
972,346,123,390,222,34,11,3,44,99,1,116,0,0
973,343,126,387,225,34,11,3,44,99,2,116,0,0
974,341,126,385,228,34,11,3,44,102,3,116,0,0
975,338,127,385,233,34,11,3,47,106,4,116,0,0
976,339,127,386,234,34,11,3,47,107,5,116,0,0
977,338,127,386,237,34,11,3,48,110,6,116,0,0
978,337,129,384,238,34,11,3,47,109,7,116,0,0
979,336,127,384,239,34,11,3,48,112,8,116,0,0
980,336,128,385,243,34,11,3,49,115,9,116,0,0
981,338,130,386,243,34,11,3,48,113,10,116,0,0
982,338,129,387,247,34,11,3,49,118,11,116,0,0
983,339,134,388,250,34,11,3,49,116,12,116,0,0
984,340,135,387,249,34,11,3,47,114,13,116,0,0
985,342,135,389,249,34,11,3,47,114,14,116,0,0
986,343,137,391,252,34,11,3,48,115,15,116,0,0
987,344,136,393,254,34,11,3,49,118,16,116,0,0
988,344,136,394,261,34,11,3,50,125,17,116,0,0
989,344,137,394,262,34,11,3,50,125,18,116,0,0
990,343,137,393,263,34,11,3,50,126,19,116,0,0
991,343,140,392,265,34,11,3,49,125,20,116,0,0
992,343,139,392,266,34,11,3,49,127,21,116,0,0
993,342,140,391,268,34,11,3,49,128,22,116,0,0
994,339,142,389,272,34,11,3,50,130,23,116,0,0
995,336,141,387,273,34,11,3,51,132,24,116,0,0
996,333,141,387,279,34,11,3,54,138,25,116,0,0
997,333,143,387,282,34,11,3,54,139,26,116,0,0
998,332,143,387,286,34,11,3,55,143,27,116,0,0
999,331,145,387,290,34,11,3,56,145,28,116,0,0
1000,330,146,386,292,34,11,3,56,146,29,116,0,0
1001,329,147,387,297,34,11,3,58,150,30,116,0,0
1002,331,150,389,304,34,11,3,58,154,31,116,0,0
1003,334,150,393,305,34,11,3,59,155,32,116,0,0
1004,339,151,398,308,34,11,3,59,157,33,116,0,0
1005,344,152,404,313,34,11,3,60,161,34,116,0,0
1006,354,154,415,317,34,11,3,61,163,35,116,0,0
1007,365,157,425,318,34,11,3,60,161,36,116,0,0
1008,376,159,437,321,34,11,3,61,162,37,116,0,0
1009,392,159,454,322,34,11,3,62,163,38,116,0,0
1010,407,165,469,324,34,11,3,62,159,39,116,0,0
1011,419,164,484,327,34,11,3,65,163,40,116,0,0
1012,436,163,500,328,34,11,3,64,165,41,116,0,0
1013,451,167,516,332,34,11,3,65,165,42,116,0,0
1014,461,157,532,337,34,11,3,71,180,43,116,0,0
1015,475,154,551,345,34,11,3,76,191,44,116,0,0
1016,482,156,560,350,34,11,3,78,194,45,116,0,0
1017,486,157,564,352,34,11,3,78,195,46,116,0,0
1018,492,161,568,354,34,11,3,76,193,47,116,0,0
1019,494,163,570,354,34,11,3,76,191,48,116,0,0
1020,495,164,570,357,34,11,3,75,193,49,116,0,0
1021,494,165,568,358,34,11,3,74,193,50,116,0,0
1022,497,166,572,359,34,11,3,75,193,51,116,0,0
1023,504,165,580,359,34,11,3,76,194,52,116,0,0
1024,509,165,583,356,34,11,3,74,191,53,116,0,0
1025,510,162,583,353,34,11,3,73,191,54,116,0,0
1026,512,165,583,355,34,11,3,71,190,55,116,0,0
1027,513,164,582,355,34,11,3,69,191,56,116,0,0
1028,513,164,580,354,34,11,3,67,190,57,116,0,0
1029,513,164,579,355,34,11,3,66,191,58,116,0,0
1030,512,165,577,358,34,11,3,65,193,59,116,0,0
1031,510,166,575,359,34,11,3,65,193,60,116,0,0
1032,509,166,575,360,34,11,3,66,194,61,116,0,0
1033,509,167,575,363,34,11,3,66,196,62,116,0,0
1034,506,169,573,365,34,11,3,67,196,63,116,0,0
1035,501,169,570,369,34,11,3,69,200,64,116,0,0
1036,493,171,563,374,34,11,3,70,203,65,116,0,0
1037,488,172,558,374,34,11,3,70,202,66,116,0,0
1038,485,173,555,374,34,11,3,70,201,67,116,0,0
1039,485,174,554,373,34,11,3,69,199,68,116,0,0
1040,488,173,557,374,34,11,3,69,201,69,116,0,0
1041,493,174,561,373,34,11,3,68,199,70,116,0,0
1042,498,177,564,372,34,11,3,66,195,71,116,0,0
1043,504,176,568,371,34,11,3,64,195,72,116,0,0
1044,509,178,570,367,34,11,3,61,189,73,116,0,0
1045,511,178,574,376,34,11,3,63,198,74,116,0,0
1046,514,177,577,380,34,11,3,63,203,75,116,0,0
1047,516,177,577,379,34,11,3,61,202,76,116,0,0
1048,517,179,577,378,34,11,3,60,199,77,116,0,0
1049,519,179,579,379,34,11,3,60,200,78,116,0,0
1050,519,179,579,379,34,11,3,60,200,79,116,0,0
1051,515,176,577,380,34,11,3,62,204,80,116,0,0
1052,510,176,572,382,34,11,3,62,206,81,116,0,0
1053,505,170,567,382,34,11,3,62,212,82,116,0,0
1054,502,172,562,381,34,11,3,60,209,83,116,0,0
1055,499,173,560,385,34,11,3,61,212,84,116,0,0
1056,497,173,558,390,34,11,3,61,217,85,116,0,0
1057,496,173,557,393,34,11,3,61,220,86,116,0,0
1058,498,174,557,391,34,11,3,59,217,87,116,0,0
1059,500,172,560,392,34,11,3,60,220,88,116,0,0
1060,504,176,565,394,34,11,3,61,218,89,116,0,0
1061,508,174,573,397,34,11,3,65,223,90,116,0,0
1062,515,177,581,399,34,11,3,66,222,91,116,0,0
1063,522,178,590,399,34,11,3,68,221,92,116,0,0
1064,527,178,597,398,34,11,3,70,220,93,116,0,0
1065,534,179,603,395,34,11,3,69,216,94,116,0,0
1066,540,179,608,392,34,11,3,68,213,95,116,0,0
1067,544,177,612,391,34,11,3,68,214,96,116,0,0
1068,544,175,611,393,34,11,3,67,218,97,116,0,0
1069,539,173,607,394,34,11,3,68,221,98,116,0,0
1070,533,173,599,394,34,11,3,66,221,99,116,0,0
1071,524,163,591,390,34,11,3,67,227,100,116,0,0
1072,511,171,578,387,34,11,3,67,216,101,116,0,0
1073,505,170,573,386,34,11,3,68,216,102,116,0,0
1074,489,167,557,380,34,11,3,68,213,103,116,0,0
1075,480,163,550,377,34,11,3,70,214,104,116,0,0
1076,475,166,542,371,34,11,3,67,205,105,116,0,0
1077,468,165,533,362,34,11,3,65,197,106,116,0,0
1078,463,164,527,358,34,11,3,64,194,107,116,0,0
1079,459,158,523,351,34,11,3,64,193,108,116,0,0
1080,461,154,525,344,34,11,3,64,190,109,116,0,0
1081,466,155,529,340,34,11,3,63,185,110,116,0,0
1082,474,155,535,336,34,11,3,61,181,111,116,0,0
1083,485,154,545,332,34,11,3,60,178,112,116,0,0
1084,493,156,553,331,34,11,3,60,175,113,116,0,0
1085,504,155,562,328,34,11,3,58,173,114,116,0,0
1086,514,156,568,324,34,11,3,54,168,115,116,0,0
1087,517,155,571,320,34,11,3,54,165,116,116,1,0
1007,271,157,314,263,36,11,3,43,106,0,67,0,1
1008,275,154,328,284,36,11,3,53,130,1,67,0,0
1009,285,154,342,297,36,11,3,57,143,2,67,0,0
1010,293,153,352,300,36,11,3,59,147,3,67,0,0
1011,302,152,364,308,36,11,3,62,156,4,67,0,0
1012,310,150,374,312,36,11,3,64,162,5,67,0,0
1013,314,152,377,313,36,11,3,63,161,6,67,0,0
1014,317,154,380,316,36,11,3,63,162,7,67,0,0
1015,319,157,381,316,36,11,3,62,159,8,67,0,0
1016,321,158,383,317,36,11,3,62,159,9,67,0,0
1017,321,163,382,323,36,11,3,61,160,10,67,0,0
1018,321,164,381,323,36,11,3,60,159,11,67,0,0
1019,319,166,379,326,36,11,3,60,160,12,67,0,0
1020,320,171,379,331,36,11,3,59,160,13,67,0,0
1021,323,172,383,334,36,11,3,60,162,14,67,0,0
1022,328,173,388,337,36,11,3,60,164,15,67,0,0
1023,332,173,394,348,36,11,3,62,175,16,67,0,0
1024,338,173,399,345,36,11,3,61,172,17,67,0,0
1025,340,173,402,349,36,11,3,62,176,18,67,0,0
1026,346,176,409,352,36,11,3,63,176,19,67,0,0
1027,359,174,423,353,36,11,3,64,179,20,67,0,0
1028,377,168,441,350,36,11,3,64,182,21,67,0,0
1029,388,169,451,352,36,11,3,63,183,22,67,0,0
1030,393,168,457,352,36,11,3,64,184,23,67,0,0
1031,398,166,462,350,36,11,3,64,184,24,67,0,0
1032,405,168,466,350,36,11,3,61,182,25,67,0,0
1033,409,168,470,351,36,11,3,61,183,26,67,0,0
1034,410,172,470,349,36,11,3,60,177,27,67,0,0
1035,416,173,474,348,36,11,3,58,175,28,67,0,0
1036,418,176,476,348,36,11,3,58,172,29,67,0,0
1037,417,174,475,350,36,11,3,58,176,30,67,0,0
1038,418,175,476,349,36,11,3,58,174,31,67,0,0
1039,417,173,475,350,36,11,3,58,177,32,67,0,0
1040,414,173,472,349,36,11,3,58,176,33,67,0,0
1041,412,174,469,348,36,11,3,57,174,34,67,0,0
1042,411,174,467,348,36,11,3,56,174,35,67,0,0
1043,412,173,467,348,36,11,3,55,175,36,67,0,0
1044,414,174,469,347,36,11,3,55,173,37,67,0,0
1045,415,176,470,349,36,11,3,55,173,38,67,0,0
1046,413,172,470,351,36,11,3,57,179,39,67,0,0
1047,411,170,470,351,36,11,3,59,181,40,67,0,0
1048,410,169,470,351,36,11,3,60,182,41,67,0,0
1049,410,169,470,351,36,11,3,60,182,42,67,0,0
1050,409,168,471,351,36,11,3,62,183,43,67,0,0
1051,410,167,472,351,36,11,3,62,184,44,67,0,0
1052,411,167,473,351,36,11,3,62,184,45,67,0,0
1053,410,167,472,350,36,11,3,62,183,46,67,0,0
1054,409,169,471,350,36,11,3,62,181,47,67,0,0
1055,410,170,470,350,36,11,3,60,180,48,67,0,0
1056,411,171,470,350,36,11,3,59,179,49,67,0,0
1057,411,171,469,349,36,11,3,58,178,50,67,0,0
1058,410,171,469,349,36,11,3,59,178,51,67,0,0
1059,409,169,468,349,36,11,3,59,180,52,67,0,0
1060,409,168,469,350,36,11,3,60,182,53,67,0,0
1061,409,168,469,351,36,11,3,60,183,54,67,0,0
1062,411,169,470,351,36,11,3,59,182,55,67,0,0
1063,413,168,472,352,36,11,3,59,184,56,67,0,0
1064,414,170,472,349,36,11,3,58,179,57,67,0,0
1065,419,167,478,348,36,11,3,59,181,58,67,0,0
1066,423,173,478,343,36,11,3,55,170,59,67,0,0
1067,436,176,488,338,36,11,3,52,162,60,67,0,0
1068,431,171,485,341,36,11,3,54,170,61,67,0,0
1069,432,171,484,339,36,11,3,52,168,62,67,0,0
1070,436,172,487,334,36,11,3,51,162,63,67,0,0
1071,441,172,493,337,36,11,3,52,165,64,67,0,0
1072,448,176,498,335,36,11,3,50,159,65,67,0,0
1073,454,174,505,335,36,11,3,51,161,66,67,0,0
1074,457,174,508,334,36,11,3,51,160,67,67,1,0
1022,374,157,409,316,37,11,3,35,159,0,6,0,0
1023,382,160,417,321,37,11,3,35,161,1,6,0,0
1024,388,158,425,323,37,11,3,37,165,2,6,0,0
1025,396,161,434,321,37,11,3,38,160,3,6,0,0
1026,403,164,442,321,37,11,3,39,157,4,6,0,0
1027,405,163,443,323,37,11,3,38,160,5,6,0,0
1028,410,164,448,324,37,11,3,38,160,6,6,0,0
1036,403,170,439,311,37,11,3,36,141,0,6,0,0
1037,403,170,440,313,37,11,3,37,143,1,6,0,0
1039,401,170,440,312,37,11,3,39,142,0,6,0,0
1040,402,171,441,312,37,11,3,39,141,1,6,0,0
1068,470,169,513,330,37,11,3,43,161,0,6,0,0
1069,477,170,523,329,37,11,3,46,159,1,6,0,0
1070,483,167,534,331,37,11,3,51,164,2,6,0,0
1071,486,167,538,332,37,11,3,52,165,3,6,0,0
1077,517,160,565,324,37,11,3,48,164,0,6,0,0
1078,521,160,565,321,37,11,3,44,161,1,6,0,0
1079,525,159,569,320,37,11,3,44,161,2,6,0,0
1035,396,171,438,281,38,11,3,42,110,0,0,0,0
1150,769,408,1023,1000,49,11,3,254,592,0,124,0,1
1151,723,398,974,981,49,11,3,251,583,1,124,0,0
1152,706,372,939,914,49,11,3,233,542,2,124,0,0
1153,697,352,921,876,49,11,3,224,524,3,124,0,0
1154,692,341,899,828,49,11,3,207,487,4,124,0,0
1155,674,319,867,775,49,11,3,193,456,5,124,0,0
1156,657,306,844,752,49,11,3,187,446,6,124,0,0
1157,641,289,814,701,49,11,3,173,412,7,124,0,0
1158,628,280,796,684,49,11,3,168,404,8,124,0,0
1159,623,271,780,655,49,11,3,157,384,9,124,0,0
1160,612,256,759,619,49,11,3,147,363,10,124,0,0
1161,590,249,735,610,49,11,3,145,361,11,124,0,0
1162,569,238,705,580,49,11,3,136,342,12,124,0,0
1163,557,236,687,567,49,11,3,130,331,13,124,0,0
1164,551,230,673,544,49,11,3,122,314,14,124,0,0
1165,545,224,662,529,49,11,3,117,305,15,124,0,0
1166,533,223,646,522,49,11,3,113,299,16,124,0,0
1167,521,213,631,502,49,11,3,110,289,17,124,0,0
1168,515,211,619,491,49,11,3,104,280,18,124,0,0
1169,510,207,608,469,49,11,3,98,262,19,124,0,0
1170,500,199,597,459,49,11,3,97,260,20,124,0,0
1171,488,200,581,449,49,11,3,93,249,21,124,0,0
1172,482,195,571,435,49,11,3,89,240,22,124,0,0
1173,473,194,560,431,49,11,3,87,237,23,124,0,0
1174,470,190,553,418,49,11,3,83,228,24,124,0,0
1175,466,188,547,411,49,11,3,81,223,25,124,0,0
1176,463,189,541,408,49,11,3,78,219,26,124,0,0
1177,461,181,537,397,49,11,3,76,216,27,124,0,0
1178,467,184,539,389,49,11,3,72,205,28,124,0,0
1179,473,177,544,382,49,11,3,71,205,29,124,0,0
1180,482,178,551,375,49,11,3,69,197,30,124,0,0
1181,489,176,557,369,49,11,3,68,193,31,124,0,0
1182,496,175,562,365,49,11,3,66,190,32,124,0,0
1183,505,173,569,360,49,11,3,64,187,33,124,0,0
1184,511,169,574,354,49,11,3,63,185,34,124,0,0
1185,514,168,575,350,49,11,3,61,182,35,124,0,0
1186,514,167,574,349,49,11,3,60,182,36,124,0,0
1187,510,168,567,342,49,11,3,57,174,37,124,0,0
1188,504,170,559,338,49,11,3,55,168,38,124,0,0
1189,498,170,554,336,49,11,3,56,166,39,124,0,0
1190,497,169,552,333,49,11,3,55,164,40,124,0,0
1191,493,165,550,333,49,11,3,57,168,41,124,0,0
1192,491,167,547,331,49,11,3,56,164,42,124,0,0
1193,486,167,541,329,49,11,3,55,162,43,124,0,0
1194,479,167,535,327,49,11,3,56,160,44,124,0,0
1195,471,167,526,327,49,11,3,55,160,45,124,0,0
1196,465,165,522,327,49,11,3,57,162,46,124,0,0
1197,463,163,520,328,49,11,3,57,165,47,124,0,0
1198,462,159,520,326,49,11,3,58,167,48,124,0,0
1199,463,158,520,324,49,11,3,57,166,49,124,0,0
1200,463,155,520,320,49,11,3,57,165,50,124,0,0
1201,467,154,523,318,49,11,3,56,164,51,124,0,0
1202,470,157,524,321,49,11,3,54,164,52,124,0,0
1203,472,162,525,321,49,11,3,53,159,53,124,0,0
1204,472,159,525,322,49,11,3,53,163,54,124,0,0
1205,473,159,526,322,49,11,3,53,163,55,124,0,0
1206,473,159,527,321,49,11,3,54,162,56,124,0,0
1207,475,159,528,315,49,11,3,53,156,57,124,0,0
1208,474,158,528,316,49,11,3,54,158,58,124,0,0
1209,473,159,527,317,49,11,3,54,158,59,124,0,0
1210,472,159,527,317,49,11,3,55,158,60,124,0,0
1211,473,158,527,318,49,11,3,54,160,61,124,0,0
1212,473,158,527,317,49,11,3,54,159,62,124,0,0
1213,472,158,527,317,49,11,3,55,159,63,124,0,0
1214,472,157,527,317,49,11,3,55,160,64,124,0,0
1215,472,157,527,318,49,11,3,55,161,65,124,0,0
1216,472,157,528,319,49,11,3,56,162,66,124,0,0
1217,472,157,528,319,49,11,3,56,162,67,124,0,0
1218,472,157,528,319,49,11,3,56,162,68,124,0,0
1219,472,157,528,319,49,11,3,56,162,69,124,0,0
1220,473,158,529,320,49,11,3,56,162,70,124,0,0
1221,473,157,529,319,49,11,3,56,162,71,124,0,0
1222,473,157,530,319,49,11,3,57,162,72,124,0,0
1223,472,157,529,319,49,11,3,57,162,73,124,0,0
1224,471,157,528,319,49,11,3,57,162,74,124,0,0
1225,472,157,528,319,49,11,3,56,162,75,124,0,0
1226,471,159,527,319,49,11,3,56,160,76,124,0,0
1227,472,159,527,319,49,11,3,55,160,77,124,0,0
1228,471,159,527,318,49,11,3,56,159,78,124,0,0
1229,471,159,527,318,49,11,3,56,159,79,124,0,0
1230,471,158,528,319,49,11,3,57,161,80,124,0,0
1231,472,158,528,319,49,11,3,56,161,81,124,0,0
1232,472,158,528,318,49,11,3,56,160,82,124,0,0
1233,472,158,528,318,49,11,3,56,160,83,124,0,0
1234,472,158,529,318,49,11,3,57,160,84,124,0,0
1235,473,158,528,318,49,11,3,55,160,85,124,0,0
1236,472,159,528,318,49,11,3,56,159,86,124,0,0
1237,472,159,528,317,49,11,3,56,158,87,124,0,0
1238,472,159,528,318,49,11,3,56,159,88,124,0,0
1239,472,159,527,318,49,11,3,55,159,89,124,0,0
1240,472,159,527,318,49,11,3,55,159,90,124,0,0
1241,472,159,527,318,49,11,3,55,159,91,124,0,0
1242,472,159,527,318,49,11,3,55,159,92,124,0,0
1243,472,159,527,318,49,11,3,55,159,93,124,0,0
1244,472,159,527,318,49,11,3,55,159,94,124,0,0
1245,472,159,527,318,49,11,3,55,159,95,124,0,0
1246,473,159,528,317,49,11,3,55,158,96,124,0,0
1247,474,157,530,318,49,11,3,56,161,97,124,0,0
1248,474,157,531,318,49,11,3,57,161,98,124,0,0
1249,473,157,530,320,49,11,3,57,163,99,124,0,0
1250,474,156,532,319,49,11,3,58,163,100,124,0,0
1251,473,157,530,319,49,11,3,57,162,101,124,0,0
1252,472,157,529,319,49,11,3,57,162,102,124,0,0
1253,472,156,529,318,49,11,3,57,162,103,124,0,0
1254,472,156,528,318,49,11,3,56,162,104,124,0,0
1255,472,156,528,318,49,11,3,56,162,105,124,0,0
1256,471,154,529,319,49,11,3,58,165,106,124,0,0
1257,472,154,530,320,49,11,3,58,166,107,124,0,0
1258,475,155,533,318,49,11,3,58,163,108,124,0,0
1259,478,158,535,317,49,11,3,57,159,109,124,0,0
1260,480,156,537,317,49,11,3,57,161,110,124,0,0
1261,481,156,538,316,49,11,3,57,160,111,124,0,0
1262,484,156,541,318,49,11,3,57,162,112,124,0,0
1263,485,154,543,322,49,11,3,58,168,113,124,0,0
1264,487,154,543,320,49,11,3,56,166,114,124,0,0
1265,487,155,542,319,49,11,3,55,164,115,124,0,0
1266,488,156,542,319,49,11,3,54,163,116,124,0,0
1267,489,156,542,318,49,11,3,53,162,117,124,0,0
1268,489,155,542,318,49,11,3,53,163,118,124,0,0
1269,490,155,542,317,49,11,3,52,162,119,124,0,0
1270,494,155,546,317,49,11,3,52,162,120,124,0,0
1271,501,156,555,321,49,11,3,54,165,121,124,0,0
1272,507,159,560,322,49,11,3,53,163,122,124,0,0
1273,516,173,564,324,49,11,3,48,151,123,124,0,0
1274,519,174,566,324,49,11,3,47,150,124,124,1,0
1496,325,134,360,239,51,11,3,35,105,0,17,0,0
1497,326,136,362,242,51,11,3,36,106,1,17,0,0
1498,327,136,363,243,51,11,3,36,107,2,17,0,0
1499,327,136,363,245,51,11,3,36,109,3,17,0,0
1500,326,138,363,247,51,11,3,37,109,4,17,0,0
1501,326,138,363,249,51,11,3,37,111,5,17,0,0
1502,326,139,364,251,51,11,3,38,112,6,17,0,0
1503,326,141,365,252,51,11,3,39,111,7,17,0,0
1504,325,140,365,255,51,11,3,40,115,8,17,0,0
1505,324,142,363,255,51,11,3,39,113,9,17,0,0
1506,320,145,359,257,51,11,3,39,112,10,17,0,0
1507,315,144,356,261,51,11,3,41,117,11,17,0,0
1508,312,146,353,263,51,11,3,41,117,12,17,0,0
1509,309,148,349,263,51,11,3,40,115,13,17,0,0
1510,304,153,343,265,51,11,3,39,112,14,17,0,0
1511,298,159,336,267,51,11,3,38,108,15,17,0,0
1512,289,155,328,266,51,11,3,39,111,16,17,0,0
1513,286,156,324,267,51,11,3,38,111,17,17,0,0
1511,1811,914,1920,1075,52,11,3,109,161,0,0,0,0
1592,1674,819,1920,1071,60,11,3,246,252,0,0,0,0
1893,514,171,554,322,61,11,3,40,151,0,0,0,0
1895,475,174,513,320,62,11,3,38,146,0,30,0,1
1896,450,173,489,320,62,11,3,39,147,1,30,0,0
1897,433,174,470,315,62,11,3,37,141,2,30,0,0
1898,411,169,450,314,62,11,3,39,145,3,30,0,0
1899,390,168,430,315,62,11,3,40,147,4,30,0,0
1900,374,165,415,314,62,11,3,41,149,5,30,0,0
1901,359,168,400,313,62,11,3,41,145,6,30,0,0
1902,348,164,390,309,62,11,3,42,145,7,30,0,0
1903,341,159,382,303,62,11,3,41,144,8,30,0,0
1904,335,159,377,303,62,11,3,42,144,9,30,0,0
1905,331,160,372,295,62,11,3,41,135,10,30,0,0
1906,329,162,369,293,62,11,3,40,131,11,30,0,0
1907,331,160,369,286,62,11,3,38,126,12,30,0,0
1908,331,160,370,282,62,11,3,39,122,13,30,0,0
1909,330,161,369,281,62,11,3,39,120,14,30,0,0
1910,329,160,367,276,62,11,3,38,116,15,30,0,0
1911,330,160,368,275,62,11,3,38,115,16,30,0,0
1912,331,159,369,272,62,11,3,38,113,17,30,0,0
1913,332,156,370,269,62,11,3,38,113,18,30,0,0
1914,332,155,370,267,62,11,3,38,112,19,30,0,0
1915,333,153,371,264,62,11,3,38,111,20,30,0,0
1916,334,152,371,262,62,11,3,37,110,21,30,0,0
1917,337,149,375,261,62,11,3,38,112,22,30,0,0
1918,339,148,378,259,62,11,3,39,111,23,30,0,0
1919,340,147,379,259,62,11,3,39,112,24,30,0,0
1920,339,146,377,254,62,11,3,38,108,25,30,0,0
1921,339,149,376,254,62,11,3,37,105,26,30,0,0
1922,341,149,377,251,62,11,3,36,102,27,30,0,0
1923,341,148,377,249,62,11,3,36,101,28,30,0,0
1924,341,149,376,248,62,11,3,35,99,29,30,0,0
1925,340,147,375,244,62,11,3,35,97,30,30,1,0
2011,1802,836,1918,1075,64,11,3,116,239,0,0,0,0
2012,1664,757,1889,1076,65,11,3,225,319,0,0,0,0
2013,1515,709,1783,1080,66,11,3,268,371,0,0,0,0
2014,1286,686,1646,1074,67,11,3,360,388,0,29,0,1
2015,1192,636,1597,1075,67,11,3,405,439,1,29,0,0
2016,1093,601,1521,1070,67,11,3,428,469,2,29,0,0
2017,964,557,1427,1070,67,11,3,463,513,3,29,0,0
2018,793,509,1289,1065,67,11,3,496,556,4,29,0,0
2019,660,478,1175,1065,67,11,3,515,587,5,29,0,0
2020,583,445,1115,1072,67,11,3,532,627,6,29,0,0
2021,531,411,1073,1069,67,11,3,542,658,7,29,0,0
2022,489,389,1017,1050,67,11,3,528,661,8,29,0,0
2023,447,362,926,984,67,11,3,479,622,9,29,0,0
2024,411,349,861,958,67,11,3,450,609,10,29,0,0
2025,392,330,795,896,67,11,3,403,566,11,29,0,0
2026,377,314,755,862,67,11,3,378,548,12,29,0,0
2027,366,302,723,836,67,11,3,357,534,13,29,0,0
2028,362,290,679,779,67,11,3,317,489,14,29,0,0
2029,347,282,652,770,67,11,3,305,488,15,29,0,0
2030,345,273,621,730,67,11,3,276,457,16,29,0,0
2031,344,264,599,703,67,11,3,255,439,17,29,0,0
2032,342,262,580,686,67,11,3,238,424,18,29,0,0
2033,343,253,561,651,67,11,3,218,398,19,29,0,0
2034,333,241,545,644,67,11,3,212,403,20,29,0,0
2035,324,241,520,628,67,11,3,196,387,21,29,0,0
2036,304,233,494,621,67,11,3,190,388,22,29,0,0
2037,291,235,468,604,67,11,3,177,369,23,29,0,0
2038,276,236,446,601,67,11,3,170,365,24,29,0,0
2039,255,233,411,580,67,11,3,156,347,25,29,0,0
2040,238,236,387,576,67,11,3,149,340,26,29,0,0
2041,218,234,356,560,67,11,3,138,326,27,29,0,0
2042,208,254,329,556,67,11,3,121,302,28,29,0,0
2043,186,252,303,542,67,11,3,117,290,29,29,1,0
2063,245,275,319,505,68,11,3,74,230,0,26,0,1
2064,235,233,322,503,68,11,3,87,270,1,26,0,0
2065,245,223,339,518,68,11,3,94,295,2,26,0,0
2066,268,225,368,535,68,11,3,100,310,3,26,0,0
2067,300,231,402,547,68,11,3,102,316,4,26,0,0
2068,336,230,442,559,68,11,3,106,329,5,26,0,0
2069,366,232,475,571,68,11,3,109,339,6,26,0,0
2070,392,230,506,584,68,11,3,114,354,7,26,0,0
2071,415,240,531,596,68,11,3,116,356,8,26,0,0
2072,440,243,561,606,68,11,3,121,363,9,26,0,0
2073,475,247,599,618,68,11,3,124,371,10,26,0,0
2074,505,261,634,646,68,11,3,129,385,11,26,0,0
2075,533,270,665,664,68,11,3,132,394,12,26,0,0
2076,549,284,691,703,68,11,3,142,419,13,26,0,0
2077,567,296,716,729,68,11,3,149,433,14,26,0,0
2078,609,302,767,756,68,11,3,158,454,15,26,0,0
2079,653,321,818,791,68,11,3,165,470,16,26,0,0
2080,685,332,854,808,68,11,3,169,476,17,26,0,0
2081,710,350,900,877,68,11,3,190,527,18,26,0,0
2082,744,369,947,914,68,11,3,203,545,19,26,0,0
2083,814,390,1023,950,68,11,3,209,560,20,26,0,0
2084,879,422,1098,1010,68,11,3,219,588,21,26,0,0
2085,930,446,1159,1059,68,11,3,229,613,22,26,0,0
2086,979,485,1209,1076,68,11,3,230,591,23,26,0,0
2087,1059,527,1287,1080,68,11,3,228,553,24,26,0,0
2088,1178,565,1401,1080,68,11,3,223,515,25,26,0,0
2089,1227,584,1452,1080,68,11,3,225,496,26,26,1,0
2089,1353,626,1590,1074,69,11,3,237,448,0,1,0,0
2090,1426,670,1638,1064,69,11,3,212,394,1,1,0,0
2174,345,127,380,226,71,11,3,35,99,0,34,0,1
2175,344,129,379,229,71,11,3,35,100,1,34,0,0
2176,340,132,375,232,71,11,3,35,100,2,34,0,0
2177,337,131,374,235,71,11,3,37,104,3,34,0,0
2178,336,133,372,235,71,11,3,36,102,4,34,0,0
2179,337,135,372,235,71,11,3,35,100,5,34,0,0
2180,336,134,373,236,71,11,3,37,102,6,34,0,0
2181,335,136,372,237,71,11,3,37,101,7,34,0,0
2182,333,137,369,239,71,11,3,36,102,8,34,0,0
2183,329,137,367,241,71,11,3,38,104,9,34,0,0
2184,328,137,366,244,71,11,3,38,107,10,34,0,0
2185,329,139,367,246,71,11,3,38,107,11,34,0,0
2186,328,138,368,248,71,11,3,40,110,12,34,0,0
2187,328,136,368,249,71,11,3,40,113,13,34,0,0
2188,327,137,366,249,71,11,3,39,112,14,34,0,0
2189,325,137,365,250,71,11,3,40,113,15,34,0,0
2190,324,137,364,252,71,11,3,40,115,16,34,0,0
2191,325,138,365,252,71,11,3,40,114,17,34,0,0
2192,325,139,366,256,71,11,3,41,117,18,34,0,0
2193,324,141,365,256,71,11,3,41,115,19,34,0,0
2194,321,143,363,258,71,11,3,42,115,20,34,0,0
2195,319,143,361,259,71,11,3,42,116,21,34,0,0
2196,318,143,360,263,71,11,3,42,120,22,34,0,0
2197,317,144,361,265,71,11,3,44,121,23,34,0,0
2198,316,144,361,268,71,11,3,45,124,24,34,0,0
2199,316,146,361,269,71,11,3,45,123,25,34,0,0
2200,313,146,358,269,71,11,3,45,123,26,34,0,0
2201,312,147,357,270,71,11,3,45,123,27,34,0,0
2202,312,150,357,274,71,11,3,45,124,28,34,0,0
2203,314,151,359,275,71,11,3,45,124,29,34,0,0
2204,314,146,363,278,71,11,3,49,132,30,34,0,0
2205,313,148,362,282,71,11,3,49,134,31,34,0,0
2206,313,154,356,273,71,11,3,43,119,32,34,0,0
2207,312,155,356,274,71,11,3,44,119,33,34,0,0
2209,314,152,363,289,71,11,3,49,137,0,34,0,1
2210,315,151,366,292,71,11,3,51,141,1,34,0,0
2211,315,151,370,298,71,11,3,55,147,2,34,0,0
2212,314,153,369,301,71,11,3,55,148,3,34,0,0
2213,314,151,370,303,71,11,3,56,152,4,34,0,0
2214,314,152,371,307,71,11,3,57,155,5,34,0,0
2215,318,155,374,310,71,11,3,56,155,6,34,0,0
2216,321,154,378,313,71,11,3,57,159,7,34,0,0
2217,322,154,383,321,71,11,3,61,167,8,34,0,0
2218,322,156,382,320,71,11,3,60,164,9,34,0,0
2219,324,155,384,322,71,11,3,60,167,10,34,0,0
2220,328,155,388,325,71,11,3,60,170,11,34,0,0
2221,333,159,393,328,71,11,3,60,169,12,34,0,0
2222,338,158,400,332,71,11,3,62,174,13,34,0,0
2223,341,160,406,339,71,11,3,65,179,14,34,0,0
2224,341,165,405,341,71,11,3,64,176,15,34,0,0
2225,340,165,404,344,71,11,3,64,179,16,34,0,0
2226,340,167,404,347,71,11,3,64,180,17,34,0,0
2227,341,168,407,354,71,11,3,66,186,18,34,0,0
2228,343,168,411,358,71,11,3,68,190,19,34,0,0
2229,342,170,412,364,71,11,3,70,194,20,34,0,0
2230,341,172,413,370,71,11,3,72,198,21,34,0,0
2231,337,171,410,372,71,11,3,73,201,22,34,0,0
2232,336,174,409,376,71,11,3,73,202,23,34,0,0
2233,336,175,411,384,71,11,3,75,209,24,34,0,0
2234,335,173,415,390,71,11,3,80,217,25,34,0,0
2235,331,176,413,399,71,11,3,82,223,26,34,0,0
2236,321,180,404,405,71,11,3,83,225,27,34,0,0
2237,303,179,387,407,71,11,3,84,228,28,34,0,0
2238,288,180,372,410,71,11,3,84,230,29,34,0,0
2239,274,185,359,422,71,11,3,85,237,30,34,0,0
2240,259,186,344,427,71,11,3,85,241,31,34,0,0
2241,244,187,330,432,71,11,3,86,245,32,34,0,0
2242,248,261,310,431,71,11,3,62,170,33,34,0,0
2243,242,270,303,436,71,11,3,61,166,34,34,1,0
2194,518,153,563,329,72,11,3,45,176,0,17,0,0
2195,503,163,548,335,72,11,3,45,172,1,17,0,0
2196,490,165,533,333,72,11,3,43,168,2,17,0,0
2197,476,164,523,340,72,11,3,47,176,3,17,0,0
2198,468,166,517,344,72,11,3,49,178,4,17,0,0
2199,455,162,508,352,72,11,3,53,190,5,17,0,0
2200,440,169,494,363,72,11,3,54,194,6,17,0,0
2201,423,169,480,367,72,11,3,57,198,7,17,0,0
2202,406,172,468,379,72,11,3,62,207,8,17,0,0
2203,393,172,457,379,72,11,3,64,207,9,17,0,0
2204,376,175,442,384,72,11,3,66,209,10,17,0,0
2205,356,178,425,395,72,11,3,69,217,11,17,0,0
2206,334,178,406,406,72,11,3,72,228,12,17,0,0
2207,307,169,386,417,72,11,3,79,248,13,17,0,0
2208,284,175,361,422,72,11,3,77,247,14,17,0,0
2209,261,182,340,431,72,11,3,79,249,15,17,0,0
2210,233,189,311,435,72,11,3,78,246,16,17,0,0
2211,216,191,294,442,72,11,3,78,251,17,17,0,0
2206,416,219,452,308,73,11,3,36,89,0,0,0,0
2208,320,147,360,242,74,11,3,40,95,0,0,0,0
2236,414,220,451,307,76,11,3,37,87,0,0,0,0
2290,695,470,880,1027,79,11,3,185,557,0,48,0,1
2291,657,446,837,986,79,11,3,180,540,1,48,0,0
2292,619,418,786,920,79,11,3,167,502,2,48,0,0
2293,576,396,739,884,79,11,3,163,488,3,48,0,0
2294,535,368,687,824,79,11,3,152,456,4,48,0,0
2295,502,353,652,802,79,11,3,150,449,5,48,0,0
2296,476,341,617,765,79,11,3,141,424,6,48,0,0
2297,451,326,584,728,79,11,3,133,402,7,48,0,0
2298,428,320,558,711,79,11,3,130,391,8,48,0,0
2299,404,302,529,676,79,11,3,125,374,9,48,0,0
2300,395,296,514,652,79,11,3,119,356,10,48,0,0
2301,382,287,490,612,79,11,3,108,325,11,48,0,0
2302,372,278,478,591,79,11,3,106,313,12,48,0,0
2303,359,275,461,577,79,11,3,102,302,13,48,0,0
2304,345,263,447,569,79,11,3,102,306,14,48,0,0
2305,341,258,440,553,79,11,3,99,295,15,48,0,0
2306,334,248,433,544,79,11,3,99,296,16,48,0,0
2307,334,243,427,525,79,11,3,93,282,17,48,0,0
2308,331,245,420,513,79,11,3,89,268,18,48,0,0
2309,327,241,411,495,79,11,3,84,254,19,48,0,0
2310,329,237,410,482,79,11,3,81,245,20,48,0,0
2311,326,235,403,466,79,11,3,77,231,21,48,0,0
2312,326,227,401,453,79,11,3,75,226,22,48,0,0
2313,322,224,397,444,79,11,3,75,220,23,48,0,0
2314,315,217,388,435,79,11,3,73,218,24,48,0,0
2315,313,214,384,427,79,11,3,71,213,25,48,0,0
2316,310,208,379,419,79,11,3,69,211,26,48,0,0
2317,312,211,376,403,79,11,3,64,192,27,48,0,0
2318,309,206,372,398,79,11,3,63,192,28,48,0,0
2319,304,199,367,390,79,11,3,63,191,29,48,0,0
2320,302,198,362,383,79,11,3,60,185,30,48,0,0
2321,298,193,357,379,79,11,3,59,186,31,48,0,0
2322,296,192,354,373,79,11,3,58,181,32,48,0,0
2323,294,190,351,369,79,11,3,57,179,33,48,0,0
2324,290,185,346,363,79,11,3,56,178,34,48,0,0
2325,292,184,347,358,79,11,3,55,174,35,48,0,0
2326,293,182,345,348,79,11,3,52,166,36,48,0,0
2327,297,181,346,340,79,11,3,49,159,37,48,0,0
2328,298,182,346,336,79,11,3,48,154,38,48,0,0
2329,298,179,344,328,79,11,3,46,149,39,48,0,0
2330,301,176,346,323,79,11,3,45,147,40,48,0,0
2331,303,174,348,320,79,11,3,45,146,41,48,0,0
2332,307,173,350,319,79,11,3,43,146,42,48,0,0
2333,309,173,352,318,79,11,3,43,145,43,48,0,0
2334,310,170,352,314,79,11,3,42,144,44,48,0,0
2335,313,170,353,310,79,11,3,40,140,45,48,0,0
2336,315,169,354,304,79,11,3,39,135,46,48,0,0
2337,317,169,354,294,79,11,3,37,125,47,48,0,0
2338,314,172,349,290,79,11,3,35,118,48,48,1,0
2361,285,154,321,277,79,11,3,36,123,0,48,0,1
2362,289,156,328,282,79,11,3,39,126,1,48,0,0
2363,297,153,339,286,79,11,3,42,133,2,48,0,0
2364,307,150,352,290,79,11,3,45,140,3,48,0,0
2365,316,152,361,294,79,11,3,45,142,4,48,0,0
2366,322,155,366,296,79,11,3,44,141,5,48,0,0
2367,327,156,373,299,79,11,3,46,143,6,48,0,0
2368,332,157,380,305,79,11,3,48,148,7,48,0,0
2369,336,156,385,308,79,11,3,49,152,8,48,0,0
2370,338,157,388,310,79,11,3,50,153,9,48,0,0
2371,339,160,389,315,79,11,3,50,155,10,48,0,0
2372,339,161,391,319,79,11,3,52,158,11,48,0,0
2373,340,164,393,325,79,11,3,53,161,12,48,0,0
2374,342,164,396,328,79,11,3,54,164,13,48,0,0
2375,341,165,397,333,79,11,3,56,168,14,48,0,0
2376,341,170,396,337,79,11,3,55,167,15,48,0,0
2377,339,171,396,344,79,11,3,57,173,16,48,0,0
2378,338,172,398,353,79,11,3,60,181,17,48,0,0
2379,338,173,399,358,79,11,3,61,185,18,48,0,0
2380,333,172,398,365,79,11,3,65,193,19,48,0,0
2381,328,178,392,371,79,11,3,64,193,20,48,0,0
2382,320,177,386,379,79,11,3,66,202,21,48,0,0
2383,310,178,380,391,79,11,3,70,213,22,48,0,0
2384,300,181,372,401,79,11,3,72,220,23,48,0,0
2385,289,182,360,402,79,11,3,71,220,24,48,0,0
2386,276,192,348,415,79,11,3,72,223,25,48,0,0
2387,259,197,329,414,79,11,3,70,217,26,48,0,0
2388,237,198,309,425,79,11,3,72,227,27,48,0,0
2389,231,200,304,431,79,11,3,73,231,28,48,0,0
2379,414,220,452,308,82,11,3,38,88,0,0,0,0
2415,514,172,557,319,83,11,3,43,147,0,21,0,1
2416,501,172,545,322,83,11,3,44,150,1,21,0,0
2417,484,171,528,319,83,11,3,44,148,2,21,0,0
2418,466,178,506,315,83,11,3,40,137,3,21,0,0
2419,443,178,483,312,83,11,3,40,134,4,21,0,0
2420,427,174,467,312,83,11,3,40,138,5,21,0,0
2421,407,174,450,314,83,11,3,43,140,6,21,0,0
2422,393,174,435,312,83,11,3,42,138,7,21,0,0
2423,381,172,424,313,83,11,3,43,141,8,21,0,0
2424,370,172,414,316,83,11,3,44,144,9,21,0,0
2425,362,171,405,310,83,11,3,43,139,10,21,0,0
2426,355,169,397,306,83,11,3,42,137,11,21,0,0
2427,348,169,391,306,83,11,3,43,137,12,21,0,0
2428,341,166,384,305,83,11,3,43,139,13,21,0,0
2429,336,165,378,301,83,11,3,42,136,14,21,0,0
2430,334,168,375,302,83,11,3,41,134,15,21,0,0
2431,332,167,371,296,83,11,3,39,129,16,21,0,0
2432,329,168,367,294,83,11,3,38,126,17,21,0,0
2433,324,170,361,290,83,11,3,37,120,18,21,0,0
2434,316,166,354,288,83,11,3,38,122,19,21,0,0
2435,308,163,346,288,83,11,3,38,125,20,21,0,0
2436,300,168,338,288,83,11,3,38,120,21,21,1,0
2771,351,128,386,227,87,11,3,35,99,0,118,0,1
2772,344,128,382,232,87,11,3,38,104,1,118,0,0
2773,339,127,378,235,87,11,3,39,108,2,118,0,0
2774,336,127,375,238,87,11,3,39,111,3,118,0,0
2775,338,130,377,237,87,11,3,39,107,4,118,0,0
2776,339,131,377,239,87,11,3,38,108,5,118,0,0
2777,338,134,376,241,87,11,3,38,107,6,118,0,0
2778,336,130,375,242,87,11,3,39,112,7,118,0,0
2779,334,130,374,243,87,11,3,40,113,8,118,0,0
2780,334,133,374,247,87,11,3,40,114,9,118,0,0
2781,335,136,374,247,87,11,3,39,111,10,118,0,0
2782,334,135,374,250,87,11,3,40,115,11,118,0,0
2783,334,136,374,252,87,11,3,40,116,12,118,0,0
2784,333,137,372,252,87,11,3,39,115,13,118,0,0
2785,330,137,370,255,87,11,3,40,118,14,118,0,0
2786,330,138,371,257,87,11,3,41,119,15,118,0,0
2787,330,135,373,260,87,11,3,43,125,16,118,0,0
2788,328,137,372,264,87,11,3,44,127,17,118,0,0
2789,328,143,370,264,87,11,3,42,121,18,118,0,0
2790,326,144,369,266,87,11,3,43,122,19,118,0,0
2791,323,144,367,269,87,11,3,44,125,20,118,0,0
2792,323,145,367,270,87,11,3,44,125,21,118,0,0
2793,322,142,367,271,87,11,3,45,129,22,118,0,0
2794,320,144,366,275,87,11,3,46,131,23,118,0,0
2795,318,145,363,276,87,11,3,45,131,24,118,0,0
2796,315,144,362,278,87,11,3,47,134,25,118,0,0
2797,316,144,364,280,87,11,3,48,136,26,118,0,0
2798,317,145,367,285,87,11,3,50,140,27,118,0,0
2799,318,145,369,289,87,11,3,51,144,28,118,0,0
2800,319,150,370,295,87,11,3,51,145,29,118,0,0
2801,321,150,372,295,87,11,3,51,145,30,118,0,0
2802,321,149,374,301,87,11,3,53,152,31,118,0,0
2803,323,149,378,304,87,11,3,55,155,32,118,0,0
2804,328,149,384,307,87,11,3,56,158,33,118,0,0
2805,334,150,392,310,87,11,3,58,160,34,118,0,0
2806,337,153,397,314,87,11,3,60,161,35,118,0,0
2807,345,150,405,314,87,11,3,60,164,36,118,0,0
2808,351,150,414,319,87,11,3,63,169,37,118,0,0
2809,359,154,421,319,87,11,3,62,165,38,118,0,0
2810,373,153,438,323,87,11,3,65,170,39,118,0,0
2811,393,164,452,321,87,11,3,59,157,40,118,0,0
2812,407,168,469,333,87,11,3,62,165,41,118,0,0
2813,421,166,486,333,87,11,3,65,167,42,118,0,0
2814,434,172,500,334,87,11,3,66,162,43,118,0,0
2815,442,170,516,343,87,11,3,74,173,44,118,0,0
2816,445,159,524,348,87,11,3,79,189,45,118,0,0
2817,455,162,531,350,87,11,3,76,188,46,118,0,0
2818,460,167,533,350,87,11,3,73,183,47,118,0,0
2819,459,164,530,348,87,11,3,71,184,48,118,0,0
2820,455,168,523,346,87,11,3,68,178,49,118,0,0
2821,450,164,522,350,87,11,3,72,186,50,118,0,0
2822,444,160,519,355,87,11,3,75,195,51,118,0,0
2823,441,149,522,358,87,11,3,81,209,52,118,0,0
2824,444,148,526,360,87,11,3,82,212,53,118,0,0
2828,432,157,498,331,87,11,3,66,174,0,118,0,0
2829,433,157,499,331,87,11,3,66,174,1,118,0,0
2836,418,161,467,288,87,11,3,49,127,0,118,0,0
2837,417,163,467,295,87,11,3,50,132,1,118,0,0
2838,416,164,465,293,87,11,3,49,129,2,118,0,0
2841,417,165,474,316,87,11,3,57,151,0,118,0,0
2842,417,166,474,317,87,11,3,57,151,1,118,0,0
2843,416,164,474,319,87,11,3,58,155,2,118,0,0
2844,418,163,467,290,87,11,3,49,127,3,118,0,0
2845,422,162,465,274,87,11,3,43,112,4,118,0,0
2846,422,162,464,271,87,11,3,42,109,5,118,0,0
2854,402,170,459,320,87,11,3,57,150,0,118,0,1
2855,402,173,458,319,87,11,3,56,146,1,118,0,0
2856,402,174,459,323,87,11,3,57,149,2,118,0,0
2857,403,173,461,326,87,11,3,58,153,3,118,0,0
2858,402,174,460,329,87,11,3,58,155,4,118,0,0
2859,406,177,460,320,87,11,3,54,143,5,118,0,0
2860,405,173,460,320,87,11,3,55,147,6,118,0,0
2861,402,169,461,328,87,11,3,59,159,7,118,0,0
2862,401,169,460,328,87,11,3,59,159,8,118,0,0
2863,400,168,459,331,87,11,3,59,163,9,118,0,0
2864,399,167,456,330,87,11,3,57,163,10,118,0,0
2865,399,167,455,329,87,11,3,56,162,11,118,0,0
2866,400,166,453,321,87,11,3,53,155,12,118,0,0
2867,401,165,451,314,87,11,3,50,149,13,118,0,0
2868,401,166,450,312,87,11,3,49,146,14,118,0,0
2869,402,164,449,304,87,11,3,47,140,15,118,0,0
2870,402,166,451,313,87,11,3,49,147,16,118,0,0
2871,401,167,452,323,87,11,3,51,156,17,118,0,0
2872,401,169,452,325,87,11,3,51,156,18,118,0,0
2873,401,170,451,324,87,11,3,50,154,19,118,0,0
2874,402,170,452,325,87,11,3,50,155,20,118,0,0
2875,402,170,452,326,87,11,3,50,156,21,118,0,0
2876,402,170,452,324,87,11,3,50,154,22,118,0,0
2877,403,171,452,323,87,11,3,49,152,23,118,0,0
2878,402,169,452,323,87,11,3,50,154,24,118,0,0
2879,402,169,452,322,87,11,3,50,153,25,118,0,0
2880,402,169,451,322,87,11,3,49,153,26,118,0,0
2881,402,169,452,323,87,11,3,50,154,27,118,0,0
2882,402,170,451,325,87,11,3,49,155,28,118,0,0
2883,401,170,451,326,87,11,3,50,156,29,118,0,0
2884,401,170,451,327,87,11,3,50,157,30,118,0,0
2885,401,169,450,326,87,11,3,49,157,31,118,0,0
2886,401,168,450,324,87,11,3,49,156,32,118,0,0
2887,401,168,450,323,87,11,3,49,155,33,118,0,0
2888,401,168,450,321,87,11,3,49,153,34,118,0,0
2889,401,168,450,322,87,11,3,49,154,35,118,0,0
2890,401,168,450,322,87,11,3,49,154,36,118,0,0
2891,401,169,450,325,87,11,3,49,156,37,118,0,0
2892,401,169,451,326,87,11,3,50,157,38,118,0,0
2893,401,169,450,324,87,11,3,49,155,39,118,0,0
2894,401,168,450,322,87,11,3,49,154,40,118,0,0
2895,401,168,449,322,87,11,3,48,154,41,118,0,0
2896,402,170,450,323,87,11,3,48,153,42,118,0,0
2897,402,170,451,327,87,11,3,49,157,43,118,0,0
2898,402,170,451,330,87,11,3,49,160,44,118,0,0
2899,402,170,451,332,87,11,3,49,162,45,118,0,0
2900,402,171,451,332,87,11,3,49,161,46,118,0,0
2901,401,171,451,335,87,11,3,50,164,47,118,0,0
2902,401,170,451,336,87,11,3,50,166,48,118,0,0
2903,401,170,451,336,87,11,3,50,166,49,118,0,0
2904,400,170,450,336,87,11,3,50,166,50,118,0,0
2905,400,170,449,331,87,11,3,49,161,51,118,0,0
2906,400,170,447,325,87,11,3,47,155,52,118,0,0
2907,400,169,445,321,87,11,3,45,152,53,118,0,0
2908,400,171,446,322,87,11,3,46,151,54,118,0,0
2909,401,171,446,321,87,11,3,45,150,55,118,0,0
2910,401,168,446,318,87,11,3,45,150,56,118,0,0
2912,402,164,442,287,87,11,3,40,123,0,118,0,1
2913,400,165,442,291,87,11,3,42,126,1,118,0,0
2914,399,169,443,303,87,11,3,44,134,2,118,0,0
2915,398,169,443,307,87,11,3,45,138,3,118,0,0
2916,398,168,440,298,87,11,3,42,130,4,118,0,0
2917,398,165,441,299,87,11,3,43,134,5,118,0,0
2918,398,165,443,310,87,11,3,45,145,6,118,0,0
2919,399,165,445,314,87,11,3,46,149,7,118,0,0
2920,401,167,447,311,87,11,3,46,144,8,118,0,0
2921,403,167,446,301,87,11,3,43,134,9,118,0,0
2922,404,167,446,301,87,11,3,42,134,10,118,0,0
2923,403,167,446,300,87,11,3,43,133,11,118,0,0
2924,402,166,445,304,87,11,3,43,138,12,118,0,0
2925,401,166,444,302,87,11,3,43,136,13,118,0,0
2926,402,167,444,300,87,11,3,42,133,14,118,0,0
2927,402,165,443,297,87,11,3,41,132,15,118,0,0
2928,402,165,443,294,87,11,3,41,129,16,118,0,0
2929,401,163,443,297,87,11,3,42,134,17,118,0,0
2930,400,163,443,303,87,11,3,43,140,18,118,0,0
2931,399,164,443,309,87,11,3,44,145,19,118,0,0
2932,398,165,443,310,87,11,3,45,145,20,118,0,0
2933,398,165,443,311,87,11,3,45,146,21,118,0,0
2934,399,163,442,304,87,11,3,43,141,22,118,0,0
2935,399,165,441,301,87,11,3,42,136,23,118,0,0
2936,399,163,440,297,87,11,3,41,134,24,118,0,0
2937,399,165,441,301,87,11,3,42,136,25,118,0,0
2938,399,166,441,302,87,11,3,42,136,26,118,0,0
2939,397,166,440,306,87,11,3,43,140,27,118,0,0
2940,397,166,440,308,87,11,3,43,142,28,118,0,0
2941,397,166,439,304,87,11,3,42,138,29,118,0,0
2942,396,164,437,301,87,11,3,41,137,30,118,0,0
2943,396,164,436,297,87,11,3,40,133,31,118,0,0
2944,394,164,436,303,87,11,3,42,139,32,118,0,0
2945,387,162,437,327,87,11,3,50,165,33,118,0,0
2946,383,159,436,337,87,11,3,53,178,34,118,0,0
2947,379,161,433,346,87,11,3,54,185,35,118,0,0
2948,377,165,431,351,87,11,3,54,186,36,118,0,0
2949,374,167,427,354,87,11,3,53,187,37,118,0,0
2950,372,167,423,354,87,11,3,51,187,38,118,0,0
2951,371,167,421,353,87,11,3,50,186,39,118,0,0
2952,371,165,420,353,87,11,3,49,188,40,118,0,0
2953,370,165,419,355,87,11,3,49,190,41,118,0,0
2954,370,166,418,354,87,11,3,48,188,42,118,0,0
2955,371,165,418,355,87,11,3,47,190,43,118,0,0
2956,371,165,419,355,87,11,3,48,190,44,118,0,0
2957,372,165,419,354,87,11,3,47,189,45,118,0,0
2958,372,165,418,354,87,11,3,46,189,46,118,0,0
2959,373,165,418,352,87,11,3,45,187,47,118,0,0
2960,373,165,419,354,87,11,3,46,189,48,118,0,0
2961,373,165,419,355,87,11,3,46,190,49,118,0,0
2962,372,167,418,356,87,11,3,46,189,50,118,0,0
2963,372,170,418,356,87,11,3,46,186,51,118,0,0
2964,373,172,417,354,87,11,3,44,182,52,118,0,0
2965,373,173,417,353,87,11,3,44,180,53,118,0,0
2966,373,173,417,354,87,11,3,44,181,54,118,0,0
2967,373,173,416,355,87,11,3,43,182,55,118,0,0
2968,373,173,417,355,87,11,3,44,182,56,118,0,0
2969,373,173,417,355,87,11,3,44,182,57,118,0,0
2970,373,175,416,353,87,11,3,43,178,58,118,0,0
2971,373,174,416,352,87,11,3,43,178,59,118,0,0
2972,373,173,416,350,87,11,3,43,177,60,118,0,0
2973,374,173,416,350,87,11,3,42,177,61,118,0,0
2974,374,174,416,349,87,11,3,42,175,62,118,0,0
2975,373,174,416,349,87,11,3,43,175,63,118,0,0
2976,373,174,416,349,87,11,3,43,175,64,118,0,0
2977,373,175,416,351,87,11,3,43,176,65,118,0,0
2978,373,175,416,351,87,11,3,43,176,66,118,0,0
2979,373,175,416,351,87,11,3,43,176,67,118,0,0
2980,373,175,416,352,87,11,3,43,177,68,118,0,0
2981,372,174,415,348,87,11,3,43,174,69,118,0,0
2982,372,168,416,350,87,11,3,44,182,70,118,0,0
2983,372,166,417,350,87,11,3,45,184,71,118,0,0
2984,372,165,417,352,87,11,3,45,187,72,118,0,0
2985,372,164,418,356,87,11,3,46,192,73,118,0,0
2986,373,165,418,354,87,11,3,45,189,74,118,0,0
2987,373,165,418,354,87,11,3,45,189,75,118,0,0
2988,373,166,417,352,87,11,3,44,186,76,118,0,0
2989,373,165,417,352,87,11,3,44,187,77,118,0,0
2990,373,164,417,352,87,11,3,44,188,78,118,0,0
2991,374,163,417,351,87,11,3,43,188,79,118,0,0
2992,374,164,417,353,87,11,3,43,189,80,118,0,0
2993,374,165,417,354,87,11,3,43,189,81,118,0,0
2994,374,165,417,354,87,11,3,43,189,82,118,0,0
2995,374,164,417,354,87,11,3,43,190,83,118,0,0
2996,375,164,417,353,87,11,3,42,189,84,118,0,0
2997,374,163,416,353,87,11,3,42,190,85,118,0,0
2998,375,163,416,353,87,11,3,41,190,86,118,0,0
2999,374,163,415,352,87,11,3,41,189,87,118,0,0
3000,374,164,415,353,87,11,3,41,189,88,118,0,0
3001,374,164,415,353,87,11,3,41,189,89,118,0,0
3002,374,164,415,353,87,11,3,41,189,90,118,0,0
3003,374,164,414,353,87,11,3,40,189,91,118,0,0
3004,374,164,414,353,87,11,3,40,189,92,118,0,0
3005,374,164,414,352,87,11,3,40,188,93,118,0,0
3006,374,164,414,351,87,11,3,40,187,94,118,0,0
3007,374,163,414,351,87,11,3,40,188,95,118,0,0
3008,374,164,414,351,87,11,3,40,187,96,118,0,0
3009,374,164,414,351,87,11,3,40,187,97,118,0,0
3010,375,164,414,350,87,11,3,39,186,98,118,0,0
3011,375,164,414,350,87,11,3,39,186,99,118,0,0
3012,375,164,414,350,87,11,3,39,186,100,118,0,0
3013,376,167,415,347,87,11,3,39,180,101,118,0,0
3014,375,167,416,352,87,11,3,41,185,102,118,0,0
3015,376,165,417,353,87,11,3,41,188,103,118,0,0
3016,377,166,418,353,87,11,3,41,187,104,118,0,0
3017,380,168,421,353,87,11,3,41,185,105,118,0,0
3018,382,168,423,354,87,11,3,41,186,106,118,0,0
3019,388,166,429,353,87,11,3,41,187,107,118,0,0
3020,396,164,435,339,87,11,3,39,175,108,118,0,0
3021,404,166,442,336,87,11,3,38,170,109,118,0,0
3022,415,164,458,340,87,11,3,43,176,110,118,0,0
3023,419,163,462,339,87,11,3,43,176,111,118,0,0
3024,436,160,473,309,87,11,3,37,149,112,118,0,0
3025,447,146,495,331,87,11,3,48,185,113,118,0,0
3026,454,143,501,330,87,11,3,47,187,114,118,0,0
3027,461,150,506,331,87,11,3,45,181,115,118,0,0
3028,472,149,517,329,87,11,3,45,180,116,118,0,0
3029,479,147,523,325,87,11,3,44,178,117,118,0,0
3030,486,146,530,324,87,11,3,44,178,118,118,1,0
2834,428,163,471,242,89,11,3,43,79,0,4,0,0
2835,426,163,473,248,89,11,3,47,85,1,4,0,0
2836,423,163,475,258,89,11,3,52,95,2,4,0,0
2838,420,158,471,255,89,11,3,51,97,0,4,0,0
2839,423,161,468,245,89,11,3,45,84,1,4,0,0
2840,422,162,468,247,89,11,3,46,85,2,4,0,0
2841,425,162,467,239,89,11,3,42,77,3,4,0,0
2842,425,160,469,242,89,11,3,44,82,4,4,0,0
3484,334,149,369,247,94,11,3,35,98,0,44,0,1
3485,331,150,367,253,94,11,3,36,103,1,44,0,0
3486,325,149,364,262,94,11,3,39,113,2,44,0,0
3487,322,148,363,265,94,11,3,41,117,3,44,0,0
3488,320,149,361,269,94,11,3,41,120,4,44,0,0
3489,320,149,361,272,94,11,3,41,123,5,44,0,0
3490,319,150,360,274,94,11,3,41,124,6,44,0,0
3491,317,150,359,277,94,11,3,42,127,7,44,0,0
3492,316,151,357,279,94,11,3,41,128,8,44,0,0
3493,317,153,357,279,94,11,3,40,126,9,44,0,0
3494,318,153,359,282,94,11,3,41,129,10,44,0,0
3495,320,151,362,285,94,11,3,42,134,11,44,0,0
3496,322,152,364,288,94,11,3,42,136,12,44,0,0
3497,325,151,368,292,94,11,3,43,141,13,44,0,0
3498,329,155,372,299,94,11,3,43,144,14,44,0,0
3499,336,162,378,302,94,11,3,42,140,15,44,0,0
3500,342,157,386,307,94,11,3,44,150,16,44,0,0
3501,349,158,392,307,94,11,3,43,149,17,44,0,0
3502,357,161,400,309,94,11,3,43,148,18,44,0,0
3503,367,158,412,312,94,11,3,45,154,19,44,0,0
3504,375,162,422,318,94,11,3,47,156,20,44,0,0
3505,390,164,434,310,94,11,3,44,146,21,44,0,0
3506,404,168,448,312,94,11,3,44,144,22,44,0,0
3507,414,172,459,317,94,11,3,45,145,23,44,0,0
3508,426,168,475,323,94,11,3,49,155,24,44,0,0
3509,436,169,486,326,94,11,3,50,157,25,44,0,0
3510,452,176,502,330,94,11,3,50,154,26,44,0,0
3511,466,177,515,330,94,11,3,49,153,27,44,0,0
3512,475,171,527,332,94,11,3,52,161,28,44,0,0
3513,484,170,532,323,94,11,3,48,153,29,44,0,0
3514,489,164,540,328,94,11,3,51,164,30,44,0,0
3515,492,164,541,321,94,11,3,49,157,31,44,0,0
3516,494,165,541,318,94,11,3,47,153,32,44,0,0
3517,495,163,542,322,94,11,3,47,159,33,44,0,0
3518,495,163,543,326,94,11,3,48,163,34,44,0,0
3519,495,162,545,331,94,11,3,50,169,35,44,0,0
3520,495,162,543,330,94,11,3,48,168,36,44,0,0
3521,495,162,544,333,94,11,3,49,171,37,44,0,0
3522,494,162,542,332,94,11,3,48,170,38,44,0,0
3523,494,163,536,310,94,11,3,42,147,39,44,0,0
3524,497,163,539,309,94,11,3,42,146,40,44,0,0
3526,474,176,519,329,94,11,3,45,153,0,44,0,0
3527,469,181,514,331,94,11,3,45,150,1,44,0,0
3528,468,183,513,333,94,11,3,45,150,2,44,0,0
3530,440,174,486,321,94,11,3,46,147,0,44,0,1
3531,434,172,483,329,94,11,3,49,157,1,44,0,0
3532,432,173,480,329,94,11,3,48,156,2,44,0,0
3533,431,171,480,333,94,11,3,49,162,3,44,0,0
3534,431,170,481,335,94,11,3,50,165,4,44,0,0
3535,431,170,481,336,94,11,3,50,166,5,44,0,0
3536,431,169,481,335,94,11,3,50,166,6,44,0,0
3537,431,168,482,335,94,11,3,51,167,7,44,0,0
3538,431,168,482,335,94,11,3,51,167,8,44,0,0
3539,431,170,481,335,94,11,3,50,165,9,44,0,0
3540,430,170,480,335,94,11,3,50,165,10,44,0,0
3541,430,169,480,335,94,11,3,50,166,11,44,0,0
3542,430,169,480,336,94,11,3,50,167,12,44,0,0
3543,430,169,480,336,94,11,3,50,167,13,44,0,0
3544,430,169,480,336,94,11,3,50,167,14,44,0,0
3545,431,169,480,336,94,11,3,49,167,15,44,0,0
3546,431,170,480,335,94,11,3,49,165,16,44,0,0
3547,431,170,480,335,94,11,3,49,165,17,44,0,0
3548,431,170,481,335,94,11,3,50,165,18,44,0,0
3549,431,170,481,336,94,11,3,50,166,19,44,0,0
3550,431,170,481,336,94,11,3,50,166,20,44,0,0
3551,431,169,481,336,94,11,3,50,167,21,44,0,0
3552,431,168,481,336,94,11,3,50,168,22,44,0,0
3553,431,167,481,336,94,11,3,50,169,23,44,0,0
3554,431,168,481,336,94,11,3,50,168,24,44,0,0
3555,431,168,481,336,94,11,3,50,168,25,44,0,0
3556,431,167,481,336,94,11,3,50,169,26,44,0,0
3557,432,168,481,335,94,11,3,49,167,27,44,0,0
3558,434,171,481,330,94,11,3,47,159,28,44,0,0
3559,434,169,483,332,94,11,3,49,163,29,44,0,0
3560,440,181,486,332,94,11,3,46,151,30,44,0,0
3561,447,182,493,334,94,11,3,46,152,31,44,0,0
3562,457,188,501,332,94,11,3,44,144,32,44,0,0
3563,460,180,507,332,94,11,3,47,152,33,44,0,0
3564,462,167,513,335,94,11,3,51,168,34,44,0,0
3565,465,157,520,337,94,11,3,55,180,35,44,0,0
3566,471,156,526,338,94,11,3,55,182,36,44,0,0
3567,480,154,533,334,94,11,3,53,180,37,44,0,0
3568,487,158,537,328,94,11,3,50,170,38,44,0,0
3569,494,164,540,322,94,11,3,46,158,39,44,0,0
3570,497,161,545,327,94,11,3,48,166,40,44,0,0
3571,503,159,551,327,94,11,3,48,168,41,44,0,0
3572,510,164,555,321,94,11,3,45,157,42,44,0,0
3573,516,161,560,316,94,11,3,44,155,43,44,0,0
3574,521,161,564,315,94,11,3,43,154,44,44,1,0
3596,1313,772,1576,1071,97,11,3,263,299,0,0,0,0
3597,1135,699,1426,1069,98,11,3,291,370,0,0,0,0
3598,967,655,1279,1074,99,11,3,312,419,0,67,0,1
3599,848,598,1198,1071,99,11,3,350,473,1,67,0,0
3600,738,554,1119,1073,99,11,3,381,519,2,67,0,0
3601,647,518,1045,1069,99,11,3,398,551,3,67,0,0
3602,569,467,980,1050,99,11,3,411,583,4,67,0,0
3603,534,436,937,1020,99,11,3,403,584,5,67,0,0
3604,503,396,863,935,99,11,3,360,539,6,67,0,0
3605,476,377,814,900,99,11,3,338,523,7,67,0,0
3606,463,349,764,831,99,11,3,301,482,8,67,0,0
3607,463,332,746,798,99,11,3,283,466,9,67,0,0
3608,470,316,721,742,99,11,3,251,426,10,67,0,0
3609,465,298,697,705,99,11,3,232,407,11,67,0,0
3610,458,292,671,681,99,11,3,213,389,12,67,0,0
3611,460,279,652,639,99,11,3,192,360,13,67,0,0
3612,464,274,645,624,99,11,3,181,350,14,67,0,0
3613,461,259,626,587,99,11,3,165,328,15,67,0,0
3614,448,254,598,560,99,11,3,150,306,16,67,0,0
3615,440,248,582,544,99,11,3,142,296,17,67,0,0
3616,438,240,572,526,99,11,3,134,286,18,67,0,0
3617,440,238,566,511,99,11,3,126,273,19,67,0,0
3618,436,231,555,495,99,11,3,119,264,20,67,0,0
3619,431,229,544,487,99,11,3,113,258,21,67,0,0
3620,427,224,530,465,99,11,3,103,241,22,67,0,0
3621,425,220,526,458,99,11,3,101,238,23,67,0,0
3622,427,213,523,447,99,11,3,96,234,24,67,0,0
3623,422,207,516,438,99,11,3,94,231,25,67,0,0
3624,423,204,511,428,99,11,3,88,224,26,67,0,0
3625,421,198,507,417,99,11,3,86,219,27,67,0,0
3626,427,200,508,405,99,11,3,81,205,28,67,0,0
3627,435,196,513,395,99,11,3,78,199,29,67,0,0
3628,441,193,516,389,99,11,3,75,196,30,67,0,0
3629,446,191,519,383,99,11,3,73,192,31,67,0,0
3630,454,186,523,370,99,11,3,69,184,32,67,0,0
3631,460,185,528,364,99,11,3,68,179,33,67,0,0
3632,465,181,532,357,99,11,3,67,176,34,67,0,0
3633,471,180,537,351,99,11,3,66,171,35,67,0,0
3634,481,180,547,344,99,11,3,66,164,36,67,0,0
3635,485,178,552,338,99,11,3,67,160,37,67,0,0
3636,479,177,543,334,99,11,3,64,157,38,67,0,0
3637,478,176,541,332,99,11,3,63,156,39,67,0,0
3638,478,173,540,330,99,11,3,62,157,40,67,0,0
3639,477,172,538,329,99,11,3,61,157,41,67,0,0
3640,474,170,536,329,99,11,3,62,159,42,67,0,0
3641,471,171,529,327,99,11,3,58,156,43,67,0,0
3642,470,173,526,325,99,11,3,56,152,44,67,0,0
3643,463,177,520,327,99,11,3,57,150,45,67,0,0
3644,455,178,513,328,99,11,3,58,150,46,67,0,0
3645,449,176,507,329,99,11,3,58,153,47,67,0,0
3646,441,178,497,326,99,11,3,56,148,48,67,0,0
3647,433,176,490,326,99,11,3,57,150,49,67,0,0
3648,429,175,485,324,99,11,3,56,149,50,67,0,0
3649,429,175,483,321,99,11,3,54,146,51,67,0,0
3650,428,174,483,322,99,11,3,55,148,52,67,0,0
3651,427,174,483,324,99,11,3,56,150,53,67,0,0
3652,427,174,483,325,99,11,3,56,151,54,67,0,0
3653,427,173,483,326,99,11,3,56,153,55,67,0,0
3654,426,173,483,327,99,11,3,57,154,56,67,0,0
3655,428,172,484,326,99,11,3,56,154,57,67,0,0
3656,431,176,487,329,99,11,3,56,153,58,67,0,0
3657,438,179,494,331,99,11,3,56,152,59,67,0,0
3658,446,177,504,336,99,11,3,58,159,60,67,0,0
3659,458,180,517,338,99,11,3,59,158,61,67,0,0
3660,470,179,532,347,99,11,3,62,168,62,67,0,0
3661,487,179,550,350,99,11,3,63,171,63,67,0,0
3662,503,180,568,356,99,11,3,65,176,64,67,0,0
3663,524,181,589,360,99,11,3,65,179,65,67,0,0
3664,534,180,601,364,99,11,3,67,184,66,67,0,0
3665,541,180,610,367,99,11,3,69,187,67,67,1,0
3832,417,159,454,288,102,11,3,37,129,0,70,0,1
3833,412,156,450,291,102,11,3,38,135,1,70,0,0
3834,408,157,443,279,102,11,3,35,122,2,70,0,0
3835,399,158,435,282,102,11,3,36,124,3,70,0,0
3836,392,157,431,288,102,11,3,39,131,4,70,0,0
3837,382,156,423,294,102,11,3,41,138,5,70,0,0
3838,372,159,414,300,102,11,3,42,141,6,70,0,0
3839,363,158,407,303,102,11,3,44,145,7,70,0,0
3840,356,158,401,303,102,11,3,45,145,8,70,0,0
3841,351,158,396,304,102,11,3,45,146,9,70,0,0
3842,349,160,393,306,102,11,3,44,146,10,70,0,0
3843,348,161,393,307,102,11,3,45,146,11,70,0,0
3844,348,161,394,311,102,11,3,46,150,12,70,0,0
3845,348,164,394,316,102,11,3,46,152,13,70,0,0
3846,346,165,392,317,102,11,3,46,152,14,70,0,0
3847,346,164,392,318,102,11,3,46,154,15,70,0,0
3848,348,168,394,321,102,11,3,46,153,16,70,0,0
3849,352,169,399,323,102,11,3,47,154,17,70,0,0
3850,357,170,405,327,102,11,3,48,157,18,70,0,0
3851,359,173,411,333,102,11,3,52,160,19,70,0,0
3852,361,174,414,336,102,11,3,53,162,20,70,0,0
3853,361,173,417,341,102,11,3,56,168,21,70,0,0
3854,358,175,417,348,102,11,3,59,173,22,70,0,0
3855,361,177,423,354,102,11,3,62,177,23,70,0,0
3856,366,176,429,358,102,11,3,63,182,24,70,0,0
3857,365,177,431,368,102,11,3,66,191,25,70,0,0
3858,363,180,429,372,102,11,3,66,192,26,70,0,0
3859,361,179,429,376,102,11,3,68,197,27,70,0,0
3860,361,179,432,383,102,11,3,71,204,28,70,0,0
3861,364,183,435,386,102,11,3,71,203,29,70,0,0
3862,368,182,441,389,102,11,3,73,207,30,70,0,0
3863,369,189,442,397,102,11,3,73,208,31,70,0,0
3864,367,192,441,404,102,11,3,74,212,32,70,0,0
3865,367,192,444,410,102,11,3,77,218,33,70,0,0
3866,369,197,447,420,102,11,3,78,223,34,70,0,0
3867,373,198,454,426,102,11,3,81,228,35,70,0,0
3868,376,201,458,431,102,11,3,82,230,36,70,0,0
3869,377,207,460,438,102,11,3,83,231,37,70,0,0
3870,374,207,458,442,102,11,3,84,235,38,70,0,0
3871,374,208,464,455,102,11,3,90,247,39,70,0,0
3872,378,215,470,466,102,11,3,92,251,40,70,0,0
3873,385,217,480,474,102,11,3,95,257,41,70,0,0
3874,386,222,487,488,102,11,3,101,266,42,70,0,0
3875,383,224,490,505,102,11,3,107,281,43,70,0,0
3876,378,224,488,515,102,11,3,110,291,44,70,0,0
3877,376,223,492,529,102,11,3,116,306,45,70,0,0
3878,382,221,505,543,102,11,3,123,322,46,70,0,0
3879,387,222,514,555,102,11,3,127,333,47,70,0,0
3880,383,226,518,584,102,11,3,135,358,48,70,0,0
3881,380,231,518,600,102,11,3,138,369,49,70,0,0
3882,378,232,523,620,102,11,3,145,388,50,70,0,0
3883,388,258,532,640,102,11,3,144,382,51,70,0,0
3884,400,271,547,660,102,11,3,147,389,52,70,0,0
3885,405,286,558,686,102,11,3,153,400,53,70,0,0
3886,401,296,566,720,102,11,3,165,424,54,70,0,0
3887,398,300,568,734,102,11,3,170,434,55,70,0,0
3888,404,319,583,773,102,11,3,179,454,56,70,0,0
3889,424,341,608,807,102,11,3,184,466,57,70,0,0
3890,439,358,636,851,102,11,3,197,493,58,70,0,0
3891,450,390,661,906,102,11,3,211,516,59,70,0,0
3892,449,407,667,931,102,11,3,218,524,60,70,0,0
3893,453,435,683,983,102,11,3,230,548,61,70,0,0
3894,471,466,717,1042,102,11,3,246,576,62,70,0,0
3895,497,484,753,1071,102,11,3,256,587,63,70,0,0
3896,506,523,765,1080,102,11,3,259,557,64,70,0,0
3897,495,558,748,1080,102,11,3,253,522,65,70,0,0
3898,482,591,732,1080,102,11,3,250,489,66,70,0,0
3899,470,665,709,1080,102,11,3,239,415,67,70,0,0
3900,471,745,687,1080,102,11,3,216,335,68,70,0,0
3901,462,819,650,1080,102,11,3,188,261,69,70,0,0
3902,469,860,638,1080,102,11,3,169,220,70,70,1,0
3848,415,218,453,310,103,11,3,38,92,0,0,0,0
3949,506,183,541,357,106,11,3,35,174,0,26,0,0
3952,455,189,490,351,106,11,3,35,162,0,26,0,1
3953,437,187,473,347,106,11,3,36,160,1,26,0,0
3954,427,183,464,343,106,11,3,37,160,2,26,0,0
3955,411,185,448,338,106,11,3,37,153,3,26,0,0
3956,398,182,437,338,106,11,3,39,156,4,26,0,0
3957,380,177,422,336,106,11,3,42,159,5,26,0,0
3958,370,177,413,335,106,11,3,43,158,6,26,0,0
3959,363,178,405,331,106,11,3,42,153,7,26,0,0
3960,358,177,400,329,106,11,3,42,152,8,26,0,0
3961,352,178,393,325,106,11,3,41,147,9,26,0,0
3962,345,175,387,323,106,11,3,42,148,10,26,0,0
3963,340,174,381,319,106,11,3,41,145,11,26,0,0
3964,339,171,381,316,106,11,3,42,145,12,26,0,0
3965,339,171,381,314,106,11,3,42,143,13,26,0,0
3966,340,167,382,308,106,11,3,42,141,14,26,0,0
3967,343,166,383,303,106,11,3,40,137,15,26,0,0
3968,343,165,384,301,106,11,3,41,136,16,26,0,0
3969,343,163,384,301,106,11,3,41,138,17,26,0,0
3970,348,162,389,300,106,11,3,41,138,18,26,0,0
3971,349,156,392,298,106,11,3,43,142,19,26,0,0
3972,350,154,392,296,106,11,3,42,142,20,26,0,0
3973,349,155,392,295,106,11,3,43,140,21,26,0,0
3974,350,155,390,285,106,11,3,40,130,22,26,0,0
3975,352,153,390,281,106,11,3,38,128,23,26,0,0
3976,354,154,390,274,106,11,3,36,120,24,26,0,0
3977,355,155,390,273,106,11,3,35,118,25,26,0,0
3978,353,155,388,272,106,11,3,35,117,26,26,1,0
3981,347,152,382,267,106,11,3,35,115,0,26,0,0
3982,341,145,378,264,106,11,3,37,119,1,26,0,0
3983,341,145,381,269,106,11,3,40,124,2,26,0,0
3984,342,145,383,270,106,11,3,41,125,3,26,0,0
3985,341,142,382,270,106,11,3,41,128,4,26,0,0
3986,341,141,383,268,106,11,3,42,127,5,26,0,0
3987,343,140,384,264,106,11,3,41,124,6,26,0,0
3988,342,139,382,264,106,11,3,40,125,7,26,0,0
3989,340,144,377,258,106,11,3,37,114,8,26,0,0
3990,337,142,373,253,106,11,3,36,111,9,26,0,0
3991,335,143,370,251,106,11,3,35,108,10,26,0,0
3964,795,224,868,451,108,11,3,73,227,0,171,0,1
3965,798,222,872,451,108,11,3,74,229,1,171,0,0
3966,770,220,847,455,108,11,3,77,235,2,171,0,0
3967,749,225,826,460,108,11,3,77,235,3,171,0,0
3968,723,226,800,458,108,11,3,77,232,4,171,0,0
3969,681,222,761,458,108,11,3,80,236,5,171,0,0
3970,662,224,737,445,108,11,3,75,221,6,171,0,0
3971,635,217,715,453,108,11,3,80,236,7,171,0,0
3972,608,217,689,455,108,11,3,81,238,8,171,0,0
3973,577,217,657,452,108,11,3,80,235,9,171,0,0
3974,548,212,628,445,108,11,3,80,233,10,171,0,0
3975,523,212,604,440,108,11,3,81,228,11,171,0,0
3976,499,206,578,430,108,11,3,79,224,12,171,0,0
3977,477,202,554,421,108,11,3,77,219,13,171,0,0
3978,464,202,524,367,108,11,3,60,165,14,171,0,0
3979,439,200,513,406,108,11,3,74,206,15,171,0,0
3980,418,199,497,417,108,11,3,79,218,16,171,0,0
3981,398,198,478,418,108,11,3,80,220,17,171,0,0
3982,382,197,460,413,108,11,3,78,216,18,171,0,0
3983,371,199,448,413,108,11,3,77,214,19,171,0,0
3984,365,197,442,410,108,11,3,77,213,20,171,0,0
3985,364,193,439,401,108,11,3,75,208,21,171,0,0
3986,363,193,442,409,108,11,3,79,216,22,171,0,0
3987,367,188,442,393,108,11,3,75,205,23,171,0,0
3988,375,186,447,383,108,11,3,72,197,24,171,0,0
3989,383,185,456,381,108,11,3,73,196,25,171,0,0
3990,398,181,471,378,108,11,3,73,197,26,171,0,0
3991,415,180,485,367,108,11,3,70,187,27,171,0,0
3992,426,178,494,361,108,11,3,68,183,28,171,0,0
3993,434,178,500,356,108,11,3,66,178,29,171,0,0
3994,446,177,512,352,108,11,3,66,175,30,171,0,0
3995,455,180,519,349,108,11,3,64,169,31,171,0,0
3996,465,179,531,348,108,11,3,66,169,32,171,0,0
3997,475,174,544,344,108,11,3,69,170,33,171,0,0
3998,479,175,550,344,108,11,3,71,169,34,171,0,0
3999,476,176,549,343,108,11,3,73,167,35,171,0,0
4000,469,177,538,340,108,11,3,69,163,36,171,0,0
4001,464,177,530,335,108,11,3,66,158,37,171,0,0
4002,460,178,524,334,108,11,3,64,156,38,171,0,0
4003,458,178,522,333,108,11,3,64,155,39,171,0,0
4004,460,178,522,332,108,11,3,62,154,40,171,0,0
4005,463,176,523,329,108,11,3,60,153,41,171,0,0
4006,465,173,525,327,108,11,3,60,154,42,171,0,0
4007,463,173,522,327,108,11,3,59,154,43,171,0,0
4008,462,173,521,325,108,11,3,59,152,44,171,0,0
4009,460,172,519,325,108,11,3,59,153,45,171,0,0
4010,458,174,515,323,108,11,3,57,149,46,171,0,0
4011,461,174,504,287,108,11,3,43,113,47,171,0,0
4012,461,172,502,277,108,11,3,41,105,48,171,0,0
4013,454,171,507,309,108,11,3,53,138,49,171,0,0
4014,455,172,510,319,108,11,3,55,147,50,171,0,0
4015,456,175,511,324,108,11,3,55,149,51,171,0,0
4016,459,178,512,323,108,11,3,53,145,52,171,0,0
4017,464,176,518,324,108,11,3,54,148,53,171,0,0
4018,468,176,524,328,108,11,3,56,152,54,171,0,0
4019,473,174,530,328,108,11,3,57,154,55,171,0,0
4020,481,174,538,331,108,11,3,57,157,56,171,0,0
4021,485,170,546,335,108,11,3,61,165,57,171,0,0
4022,487,172,549,336,108,11,3,62,164,58,171,0,0
4023,486,174,549,341,108,11,3,63,167,59,171,0,0
4024,484,175,546,341,108,11,3,62,166,60,171,0,0
4025,480,175,544,345,108,11,3,64,170,61,171,0,0
4026,477,177,541,349,108,11,3,64,172,62,171,0,0
4027,474,179,539,351,108,11,3,65,172,63,171,0,0
4028,471,179,536,353,108,11,3,65,174,64,171,0,0
4029,467,180,533,355,108,11,3,66,175,65,171,0,0
4030,462,180,530,359,108,11,3,68,179,66,171,0,0
4031,458,181,525,361,108,11,3,67,180,67,171,0,0
4032,454,183,520,364,108,11,3,66,181,68,171,0,0
4033,448,185,513,363,108,11,3,65,178,69,171,0,0
4034,444,186,507,359,108,11,3,63,173,70,171,0,0
4035,450,189,501,324,108,11,3,51,135,71,171,0,0
4036,453,188,497,300,108,11,3,44,112,72,171,0,0
4037,451,189,498,308,108,11,3,47,119,73,171,0,0
4038,448,189,503,330,108,11,3,55,141,74,171,0,0
4039,447,189,506,341,108,11,3,59,152,75,171,0,0
4040,445,188,508,353,108,11,3,63,165,76,171,0,0
4041,443,186,508,358,108,11,3,65,172,77,171,0,0
4042,445,189,503,344,108,11,3,58,155,78,171,0,0
4043,448,187,499,320,108,11,3,51,133,79,171,0,0
4044,450,186,496,306,108,11,3,46,120,80,171,0,0
4045,451,186,496,301,108,11,3,45,115,81,171,0,0
4046,451,186,496,299,108,11,3,45,113,82,171,0,0
4047,447,188,496,312,108,11,3,49,124,83,171,0,0
4048,441,186,503,343,108,11,3,62,157,84,171,0,0
4049,440,185,505,354,108,11,3,65,169,85,171,0,0
4050,439,185,505,361,108,11,3,66,176,86,171,0,0
4051,440,186,505,363,108,11,3,65,177,87,171,0,0
4052,438,185,503,362,108,11,3,65,177,88,171,0,0
4053,439,185,502,361,108,11,3,63,176,89,171,0,0
4054,440,183,503,361,108,11,3,63,178,90,171,0,0
4055,439,182,502,362,108,11,3,63,180,91,171,0,0
4056,440,185,501,361,108,11,3,61,176,92,171,0,0
4057,441,187,501,360,108,11,3,60,173,93,171,0,0
4058,440,185,500,360,108,11,3,60,175,94,171,0,0
4059,440,187,500,359,108,11,3,60,172,95,171,0,0
4060,441,187,500,359,108,11,3,59,172,96,171,0,0
4061,440,185,499,360,108,11,3,59,175,97,171,0,0
4062,439,183,499,360,108,11,3,60,177,98,171,0,0
4063,439,183,498,360,108,11,3,59,177,99,171,0,0
4064,440,183,500,361,108,11,3,60,178,100,171,0,0
4065,441,183,500,361,108,11,3,59,178,101,171,0,0
4066,441,183,500,360,108,11,3,59,177,102,171,0,0
4067,442,183,500,360,108,11,3,58,177,103,171,0,0
4068,442,184,500,360,108,11,3,58,176,104,171,0,0
4069,442,184,499,360,108,11,3,57,176,105,171,0,0
4070,443,184,499,360,108,11,3,56,176,106,171,0,0
4071,444,184,500,360,108,11,3,56,176,107,171,0,0
4072,444,184,500,360,108,11,3,56,176,108,171,0,0
4073,445,184,500,360,108,11,3,55,176,109,171,0,0
4074,445,184,501,360,108,11,3,56,176,110,171,0,0
4075,446,185,501,360,108,11,3,55,175,111,171,0,0
4076,446,185,501,360,108,11,3,55,175,112,171,0,0
4077,446,185,501,361,108,11,3,55,176,113,171,0,0
4078,446,185,501,361,108,11,3,55,176,114,171,0,0
4079,446,185,501,361,108,11,3,55,176,115,171,0,0
4080,446,185,500,360,108,11,3,54,175,116,171,0,0
4081,446,185,501,360,108,11,3,55,175,117,171,0,0
4082,446,185,500,361,108,11,3,54,176,118,171,0,0
4083,446,185,501,361,108,11,3,55,176,119,171,0,0
4084,446,185,501,361,108,11,3,55,176,120,171,0,0
4085,446,185,500,361,108,11,3,54,176,121,171,0,0
4086,446,185,500,360,108,11,3,54,175,122,171,0,0
4087,446,185,500,360,108,11,3,54,175,123,171,0,0
4088,446,185,499,360,108,11,3,53,175,124,171,0,0
4089,446,185,499,360,108,11,3,53,175,125,171,0,0
4090,446,185,499,360,108,11,3,53,175,126,171,0,0
4091,446,185,499,360,108,11,3,53,175,127,171,0,0
4092,446,185,500,360,108,11,3,54,175,128,171,0,0
4093,446,185,499,361,108,11,3,53,176,129,171,0,0
4094,445,185,499,361,108,11,3,54,176,130,171,0,0
4095,445,185,499,361,108,11,3,54,176,131,171,0,0
4096,446,185,499,360,108,11,3,53,175,132,171,0,0
4097,446,185,499,360,108,11,3,53,175,133,171,0,0
4098,446,185,499,360,108,11,3,53,175,134,171,0,0
4099,445,186,498,360,108,11,3,53,174,135,171,0,0
4100,445,186,498,360,108,11,3,53,174,136,171,0,0
4101,446,188,498,359,108,11,3,52,171,137,171,0,0
4102,446,188,498,359,108,11,3,52,171,138,171,0,0
4103,446,188,498,359,108,11,3,52,171,139,171,0,0
4104,446,188,499,359,108,11,3,53,171,140,171,0,0
4105,446,186,499,360,108,11,3,53,174,141,171,0,0
4106,446,186,499,360,108,11,3,53,174,142,171,0,0
4107,446,185,500,360,108,11,3,54,175,143,171,0,0
4108,446,185,500,360,108,11,3,54,175,144,171,0,0
4109,446,184,500,360,108,11,3,54,176,145,171,0,0
4110,446,184,500,359,108,11,3,54,175,146,171,0,0
4111,447,185,500,359,108,11,3,53,174,147,171,0,0
4112,447,185,500,359,108,11,3,53,174,148,171,0,0
4113,447,185,500,358,108,11,3,53,173,149,171,0,0
4114,447,185,500,358,108,11,3,53,173,150,171,0,0
4115,447,185,499,358,108,11,3,52,173,151,171,0,0
4116,445,185,499,359,108,11,3,54,174,152,171,0,0
4117,445,185,498,359,108,11,3,53,174,153,171,0,0
4118,446,187,499,358,108,11,3,53,171,154,171,0,0
4119,446,188,498,358,108,11,3,52,170,155,171,0,0
4120,447,186,500,358,108,11,3,53,172,156,171,0,0
4121,447,185,500,358,108,11,3,53,173,157,171,0,0
4122,445,184,498,357,108,11,3,53,173,158,171,0,0
4123,445,182,499,355,108,11,3,54,173,159,171,0,0
4124,448,182,500,350,108,11,3,52,168,160,171,0,0
4125,452,183,504,349,108,11,3,52,166,161,171,0,0
4126,457,182,508,343,108,11,3,51,161,162,171,0,0
4127,461,183,511,339,108,11,3,50,156,163,171,0,0
4128,464,181,513,334,108,11,3,49,153,164,171,0,0
4129,468,178,518,331,108,11,3,50,153,165,171,0,0
4130,473,177,523,328,108,11,3,50,151,166,171,0,0
4131,485,173,535,324,108,11,3,50,151,167,171,0,0
4132,497,170,548,324,108,11,3,51,154,168,171,0,0
4133,504,167,557,324,108,11,3,53,157,169,171,0,0
4134,516,176,562,318,108,11,3,46,142,170,171,0,0
4135,521,176,567,315,108,11,3,46,139,171,171,1,0
3974,332,150,371,267,110,11,3,39,117,0,7,0,0
3975,326,144,364,260,110,11,3,38,116,1,7,0,0
3976,324,147,361,256,110,11,3,37,109,2,7,0,0
3977,322,140,362,257,110,11,3,40,117,3,7,0,0
3978,324,137,363,255,110,11,3,39,118,4,7,0,0
3979,326,138,364,251,110,11,3,38,113,5,7,0,0
3980,327,137,365,250,110,11,3,38,113,6,7,0,0
3981,327,136,365,248,110,11,3,38,112,7,7,0,0
4130,507,181,544,324,112,11,3,37,143,0,0,0,0
4483,563,182,598,360,114,11,3,35,178,0,37,0,1
4484,546,186,582,364,114,11,3,36,178,1,37,0,0
4485,526,181,562,357,114,11,3,36,176,2,37,0,0
4486,503,178,542,354,114,11,3,39,176,3,37,0,0
4487,487,177,526,349,114,11,3,39,172,4,37,0,0
4488,473,184,510,342,114,11,3,37,158,5,37,0,0
4489,455,183,493,338,114,11,3,38,155,6,37,0,0
4490,438,178,476,333,114,11,3,38,155,7,37,0,0
4491,421,176,460,329,114,11,3,39,153,8,37,0,0
4492,407,172,448,328,114,11,3,41,156,9,37,0,0
4493,399,170,440,321,114,11,3,41,151,10,37,0,0
4494,390,170,430,321,114,11,3,40,151,11,37,0,0
4495,381,169,422,320,114,11,3,41,151,12,37,0,0
4496,372,167,415,314,114,11,3,43,147,13,37,0,0
4497,367,167,411,312,114,11,3,44,145,14,37,0,0
4498,366,164,410,305,114,11,3,44,141,15,37,0,0
4499,363,163,407,304,114,11,3,44,141,16,37,0,0
4500,360,161,403,303,114,11,3,43,142,17,37,0,0
4501,358,159,402,298,114,11,3,44,139,18,37,0,0
4502,359,159,402,297,114,11,3,43,138,19,37,0,0
4503,360,156,402,291,114,11,3,42,135,20,37,0,0
4504,360,154,402,287,114,11,3,42,133,21,37,0,0
4505,361,156,401,284,114,11,3,40,128,22,37,0,0
4506,360,155,400,279,114,11,3,40,124,23,37,0,0
4507,360,155,399,277,114,11,3,39,122,24,37,0,0
4508,359,152,398,275,114,11,3,39,123,25,37,0,0
4509,358,151,397,274,114,11,3,39,123,26,37,0,0
4510,356,150,395,271,114,11,3,39,121,27,37,0,0
4511,355,150,394,267,114,11,3,39,117,28,37,0,0
4512,355,151,393,266,114,11,3,38,115,29,37,0,0
4513,356,150,395,266,114,11,3,39,116,30,37,0,0
4514,359,150,396,259,114,11,3,37,109,31,37,0,0
4515,360,149,397,258,114,11,3,37,109,32,37,0,0
4516,360,149,396,255,114,11,3,36,106,33,37,0,0
4517,359,149,395,254,114,11,3,36,105,34,37,0,0
4518,361,149,396,251,114,11,3,35,102,35,37,0,0
4519,361,147,396,249,114,11,3,35,102,36,37,0,0
4520,362,148,397,250,114,11,3,35,102,37,37,1,0
4529,309,153,344,293,116,11,3,35,140,0,249,0,1
4530,316,154,353,296,116,11,3,37,142,1,249,0,0
4531,324,150,362,295,116,11,3,38,145,2,249,0,0
4532,331,150,370,298,116,11,3,39,148,3,249,0,0
4533,339,150,380,302,116,11,3,41,152,4,249,0,0
4534,345,147,388,304,116,11,3,43,157,5,249,0,0
4535,352,147,397,311,116,11,3,45,164,6,249,0,0
4536,361,155,405,312,116,11,3,44,157,7,249,0,0
4537,369,156,414,314,116,11,3,45,158,8,249,0,0
4538,376,161,422,318,116,11,3,46,157,9,249,0,0
4539,386,165,430,313,116,11,3,44,148,10,249,0,0
4540,397,165,444,319,116,11,3,47,154,11,249,0,0
4541,405,168,454,326,116,11,3,49,158,12,249,0,0
4542,417,168,469,331,116,11,3,52,163,13,249,0,0
4543,431,170,484,331,116,11,3,53,161,14,249,0,0
4544,441,177,495,334,116,11,3,54,157,15,249,0,0
4545,453,178,509,337,116,11,3,56,159,16,249,0,0
4546,461,176,518,337,116,11,3,57,161,17,249,0,0
4547,465,174,525,339,116,11,3,60,165,18,249,0,0
4548,473,174,533,338,116,11,3,60,164,19,249,0,0
4549,470,174,532,344,116,11,3,62,170,20,249,0,0
4550,463,176,525,347,116,11,3,62,171,21,249,0,0
4551,460,174,521,347,116,11,3,61,173,22,249,0,0
4552,457,173,520,351,116,11,3,63,178,23,249,0,0
4553,456,174,517,348,116,11,3,61,174,24,249,0,0
4554,452,173,515,352,116,11,3,63,179,25,249,0,0
4555,451,174,514,356,116,11,3,63,182,26,249,0,0
4556,451,176,513,355,116,11,3,62,179,27,249,0,0
4557,450,176,513,358,116,11,3,63,182,28,249,0,0
4558,448,176,512,364,116,11,3,64,188,29,249,0,0
4559,446,179,510,368,116,11,3,64,189,30,249,0,0
4560,442,180,507,369,116,11,3,65,189,31,249,0,0
4561,441,178,506,370,116,11,3,65,192,32,249,0,0
4562,440,178,506,375,116,11,3,66,197,33,249,0,0
4563,441,181,507,381,116,11,3,66,200,34,249,0,0
4564,441,189,506,382,116,11,3,65,193,35,249,0,0
4565,443,183,511,383,116,11,3,68,200,36,249,0,0
4566,445,182,514,385,116,11,3,69,203,37,249,0,0
4567,445,181,516,388,116,11,3,71,207,38,249,0,0
4568,443,180,514,391,116,11,3,71,211,39,249,0,0
4569,441,182,511,391,116,11,3,70,209,40,249,0,0
4570,439,181,508,393,116,11,3,69,212,41,249,0,0
4571,438,182,507,394,116,11,3,69,212,42,249,0,0
4572,434,182,503,395,116,11,3,69,213,43,249,0,0
4573,432,183,500,395,116,11,3,68,212,44,249,0,0
4574,432,184,499,395,116,11,3,67,211,45,249,0,0
4575,432,185,499,394,116,11,3,67,209,46,249,0,0
4576,433,187,498,393,116,11,3,65,206,47,249,0,0
4577,433,186,498,393,116,11,3,65,207,48,249,0,0
4578,432,187,496,392,116,11,3,64,205,49,249,0,0
4579,433,189,496,392,116,11,3,63,203,50,249,0,0
4580,436,189,497,391,116,11,3,61,202,51,249,0,0
4581,439,184,500,389,116,11,3,61,205,52,249,0,0
4582,442,182,503,388,116,11,3,61,206,53,249,0,0
4583,454,220,503,384,116,11,3,49,164,54,249,0,0
4584,459,208,511,377,116,11,3,52,169,55,249,0,0
4585,463,193,520,378,116,11,3,57,185,56,249,0,0
4586,465,187,524,379,116,11,3,59,192,57,249,0,0
4587,471,180,532,378,116,11,3,61,198,58,249,0,0
4588,477,177,539,375,116,11,3,62,198,59,249,0,0
4589,478,177,540,372,116,11,3,62,195,60,249,0,0
4590,474,177,535,369,116,11,3,61,192,61,249,0,0
4591,472,190,528,366,116,11,3,56,176,62,249,0,0
4592,466,188,522,360,116,11,3,56,172,63,249,0,0
4593,462,180,520,360,116,11,3,58,180,64,249,0,0
4594,459,177,518,361,116,11,3,59,184,65,249,0,0
4595,460,177,517,354,116,11,3,57,177,66,249,0,0
4596,459,174,517,354,116,11,3,58,180,67,249,0,0
4597,458,174,515,352,116,11,3,57,178,68,249,0,0
4598,456,174,513,350,116,11,3,57,176,69,249,0,0
4599,452,172,511,350,116,11,3,59,178,70,249,0,0
4600,447,173,506,352,116,11,3,59,179,71,249,0,0
4601,444,178,500,351,116,11,3,56,173,72,249,0,0
4602,440,178,495,349,116,11,3,55,171,73,249,0,0
4603,437,176,493,349,116,11,3,56,173,74,249,0,0
4604,436,176,491,347,116,11,3,55,171,75,249,0,0
4605,436,177,490,344,116,11,3,54,167,76,249,0,0
4606,435,177,489,344,116,11,3,54,167,77,249,0,0
4607,434,175,489,343,116,11,3,55,168,78,249,0,0
4608,432,174,486,336,116,11,3,54,162,79,249,0,0
4609,434,175,485,326,116,11,3,51,151,80,249,0,0
4610,435,177,485,324,116,11,3,50,147,81,249,0,0
4611,434,178,486,329,116,11,3,52,151,82,249,0,0
4612,434,178,485,321,116,11,3,51,143,83,249,0,0
4613,433,178,485,320,116,11,3,52,142,84,249,0,0
4614,432,176,487,326,116,11,3,55,150,85,249,0,0
4615,429,176,485,326,116,11,3,56,150,86,249,0,0
4616,429,176,484,320,116,11,3,55,144,87,249,0,0
4617,428,175,484,319,116,11,3,56,144,88,249,0,0
4618,429,177,484,316,116,11,3,55,139,89,249,0,0
4619,431,177,485,311,116,11,3,54,134,90,249,0,0
4620,429,178,483,308,116,11,3,54,130,91,249,0,0
4621,425,178,486,325,116,11,3,61,147,92,249,0,0
4622,426,177,495,344,116,11,3,69,167,93,249,0,0
4623,427,176,498,352,116,11,3,71,176,94,249,0,0
4624,427,176,498,355,116,11,3,71,179,95,249,0,0
4625,428,175,498,356,116,11,3,70,181,96,249,0,0
4626,428,175,499,356,116,11,3,71,181,97,249,0,0
4627,430,177,499,356,116,11,3,69,179,98,249,0,0
4628,431,177,498,354,116,11,3,67,177,99,249,0,0
4629,431,177,496,351,116,11,3,65,174,100,249,0,0
4630,430,177,494,350,116,11,3,64,173,101,249,0,0
4631,433,177,494,348,116,11,3,61,171,102,249,0,0
4632,436,178,496,345,116,11,3,60,167,103,249,0,0
4633,440,177,499,346,116,11,3,59,169,104,249,0,0
4634,441,177,499,344,116,11,3,58,167,105,249,0,0
4635,442,176,500,342,116,11,3,58,166,106,249,0,0
4636,442,176,498,342,116,11,3,56,166,107,249,0,0
4637,440,174,496,343,116,11,3,56,169,108,249,0,0
4638,440,177,493,339,116,11,3,53,162,109,249,0,0
4639,437,175,490,341,116,11,3,53,166,110,249,0,0
4640,435,175,488,340,116,11,3,53,165,111,249,0,0
4641,434,175,485,338,116,11,3,51,163,112,249,0,0
4642,431,174,482,340,116,11,3,51,166,113,249,0,0
4643,427,172,480,342,116,11,3,53,170,114,249,0,0
4644,426,172,479,344,116,11,3,53,172,115,249,0,0
4645,426,173,478,344,116,11,3,52,171,116,249,0,0
4646,428,172,479,341,116,11,3,51,169,117,249,0,0
4647,431,173,482,343,116,11,3,51,170,118,249,0,0
4648,435,174,487,343,116,11,3,52,169,119,249,0,0
4649,438,176,490,344,116,11,3,52,168,120,249,0,0
4650,445,180,496,343,116,11,3,51,163,121,249,0,0
4651,449,178,501,345,116,11,3,52,167,122,249,0,0
4652,450,176,503,347,116,11,3,53,171,123,249,0,0
4653,449,178,502,349,116,11,3,53,171,124,249,0,0
4654,442,178,496,349,116,11,3,54,171,125,249,0,0
4655,440,177,495,350,116,11,3,55,173,126,249,0,0
4656,439,175,495,352,116,11,3,56,177,127,249,0,0
4657,438,175,494,353,116,11,3,56,178,128,249,0,0
4658,437,175,494,353,116,11,3,57,178,129,249,0,0
4659,438,175,494,353,116,11,3,56,178,130,249,0,0
4660,438,175,495,354,116,11,3,57,179,131,249,0,0
4661,437,175,494,354,116,11,3,57,179,132,249,0,0
4662,437,176,494,354,116,11,3,57,178,133,249,0,0
4663,437,176,494,354,116,11,3,57,178,134,249,0,0
4664,437,176,494,354,116,11,3,57,178,135,249,0,0
4665,437,176,494,354,116,11,3,57,178,136,249,0,0
4666,436,176,493,354,116,11,3,57,178,137,249,0,0
4667,436,176,493,354,116,11,3,57,178,138,249,0,0
4668,435,176,493,354,116,11,3,58,178,139,249,0,0
4669,435,177,493,354,116,11,3,58,177,140,249,0,0
4670,436,176,494,355,116,11,3,58,179,141,249,0,0
4671,436,176,494,355,116,11,3,58,179,142,249,0,0
4672,436,176,494,355,116,11,3,58,179,143,249,0,0
4673,436,175,494,354,116,11,3,58,179,144,249,0,0
4674,436,176,494,354,116,11,3,58,178,145,249,0,0
4675,436,176,494,354,116,11,3,58,178,146,249,0,0
4676,436,176,494,354,116,11,3,58,178,147,249,0,0
4677,437,176,494,354,116,11,3,57,178,148,249,0,0
4678,437,176,494,354,116,11,3,57,178,149,249,0,0
4679,436,176,492,351,116,11,3,56,175,150,249,0,0
4680,436,177,492,353,116,11,3,56,176,151,249,0,0
4681,436,179,491,348,116,11,3,55,169,152,249,0,0
4682,438,179,492,349,116,11,3,54,170,153,249,0,0
4683,439,180,494,350,116,11,3,55,170,154,249,0,0
4684,444,177,499,350,116,11,3,55,173,155,249,0,0
4685,448,176,504,350,116,11,3,56,174,156,249,0,0
4686,454,176,509,348,116,11,3,55,172,157,249,0,0
4687,459,174,513,344,116,11,3,54,170,158,249,0,0
4688,462,174,516,343,116,11,3,54,169,159,249,0,0
4689,462,173,516,344,116,11,3,54,171,160,249,0,0
4690,460,175,515,346,116,11,3,55,171,161,249,0,0
4691,457,175,511,347,116,11,3,54,172,162,249,0,0
4692,453,175,508,349,116,11,3,55,174,163,249,0,0
4693,451,176,505,348,116,11,3,54,172,164,249,0,0
4694,451,176,504,348,116,11,3,53,172,165,249,0,0
4695,452,175,505,350,116,11,3,53,175,166,249,0,0
4696,454,175,507,350,116,11,3,53,175,167,249,0,0
4697,457,176,509,348,116,11,3,52,172,168,249,0,0
4698,459,177,511,348,116,11,3,52,171,169,249,0,0
4699,461,177,512,348,116,11,3,51,171,170,249,0,0
4700,460,177,512,349,116,11,3,52,172,171,249,0,0
4701,460,177,512,349,116,11,3,52,172,172,249,0,0
4702,460,176,512,349,116,11,3,52,173,173,249,0,0
4703,459,176,512,350,116,11,3,53,174,174,249,0,0
4704,458,175,511,350,116,11,3,53,175,175,249,0,0
4705,458,175,511,350,116,11,3,53,175,176,249,0,0
4706,458,175,511,350,116,11,3,53,175,177,249,0,0
4707,458,175,511,351,116,11,3,53,176,178,249,0,0
4708,458,175,511,351,116,11,3,53,176,179,249,0,0
4709,458,174,511,351,116,11,3,53,177,180,249,0,0
4710,459,174,511,351,116,11,3,52,177,181,249,0,0
4711,459,174,511,350,116,11,3,52,176,182,249,0,0
4712,459,174,511,350,116,11,3,52,176,183,249,0,0
4713,459,173,511,350,116,11,3,52,177,184,249,0,0
4714,459,173,511,350,116,11,3,52,177,185,249,0,0
4715,459,174,511,349,116,11,3,52,175,186,249,0,0
4716,459,175,510,349,116,11,3,51,174,187,249,0,0
4717,459,175,511,349,116,11,3,52,174,188,249,0,0
4718,459,175,511,350,116,11,3,52,175,189,249,0,0
4719,460,173,512,350,116,11,3,52,177,190,249,0,0
4720,460,172,513,350,116,11,3,53,178,191,249,0,0
4721,461,171,514,350,116,11,3,53,179,192,249,0,0
4722,462,171,515,348,116,11,3,53,177,193,249,0,0
4723,464,171,516,346,116,11,3,52,175,194,249,0,0
4724,464,170,517,346,116,11,3,53,176,195,249,0,0
4725,464,170,517,346,116,11,3,53,176,196,249,0,0
4726,464,171,517,345,116,11,3,53,174,197,249,0,0
4727,466,171,518,347,116,11,3,52,176,198,249,0,0
4728,468,169,520,345,116,11,3,52,176,199,249,0,0
4729,471,172,522,343,116,11,3,51,171,200,249,0,0
4730,476,175,528,348,116,11,3,52,173,201,249,0,0
4731,481,175,534,352,116,11,3,53,177,202,249,0,0
4732,487,175,540,351,116,11,3,53,176,203,249,0,0
4733,494,177,548,352,116,11,3,54,175,204,249,0,0
4734,499,177,554,353,116,11,3,55,176,205,249,0,0
4735,506,178,562,354,116,11,3,56,176,206,249,0,0
4736,526,176,586,365,116,11,3,60,189,207,249,0,0
4737,524,178,587,376,116,11,3,63,198,208,249,0,0
4738,520,179,585,384,116,11,3,65,205,209,249,0,0
4739,511,178,580,390,116,11,3,69,212,210,249,0,0
4740,503,180,576,401,116,11,3,73,221,211,249,0,0
4741,501,183,575,405,116,11,3,74,222,212,249,0,0
4742,500,188,575,414,116,11,3,75,226,213,249,0,0
4743,494,192,573,424,116,11,3,79,232,214,249,0,0
4744,491,193,572,431,116,11,3,81,238,215,249,0,0
4745,489,199,573,446,116,11,3,84,247,216,249,0,0
4746,494,203,579,448,116,11,3,85,245,217,249,0,0
4747,496,209,585,467,116,11,3,89,258,218,249,0,0
4748,494,210,587,475,116,11,3,93,265,219,249,0,0
4749,494,210,594,490,116,11,3,100,280,220,249,0,0
4750,504,216,606,503,116,11,3,102,287,221,249,0,0
4751,517,220,622,514,116,11,3,105,294,222,249,0,0
4752,523,229,634,539,116,11,3,111,310,223,249,0,0
4753,531,230,645,550,116,11,3,114,320,224,249,0,0
4754,540,237,656,563,116,11,3,116,326,225,249,0,0
4755,556,245,675,578,116,11,3,119,333,226,249,0,0
4756,573,249,699,602,116,11,3,126,353,227,249,0,0
4757,585,259,718,628,116,11,3,133,369,228,249,0,0
4758,601,263,737,641,116,11,3,136,378,229,249,0,0
4759,622,274,764,667,116,11,3,142,393,230,249,0,0
4760,653,284,796,684,116,11,3,143,400,231,249,0,0
4761,677,294,832,724,116,11,3,155,430,232,249,0,0
4762,698,306,860,744,116,11,3,162,438,233,249,0,0
4763,729,313,897,770,116,11,3,168,457,234,249,0,0
4764,759,333,933,809,116,11,3,174,476,235,249,0,0
4765,799,348,977,833,116,11,3,178,485,236,249,0,0
4766,827,372,1027,904,116,11,3,200,532,237,249,0,0
4767,856,389,1065,938,116,11,3,209,549,238,249,0,0
4768,899,411,1118,992,116,11,3,219,581,239,249,0,0
4769,947,443,1174,1037,116,11,3,227,594,240,249,0,0
4770,1003,464,1240,1069,116,11,3,237,605,241,249,0,0
4771,1060,509,1301,1078,116,11,3,241,569,242,249,0,0
4772,1140,533,1380,1076,116,11,3,240,543,243,249,0,0
4773,1246,589,1474,1079,116,11,3,228,490,244,249,0,0
4774,1372,637,1589,1077,116,11,3,217,440,245,249,0,0
4775,1469,685,1684,1080,116,11,3,215,395,246,249,0,0
4776,1625,736,1822,1080,116,11,3,197,344,247,249,0,0
4777,1745,822,1896,1076,116,11,3,151,254,248,249,0,0
4778,1829,862,1920,1080,116,11,3,91,218,249,249,1,0
4594,394,520,926,1066,119,11,3,532,546,0,168,0,1
4595,365,493,906,1069,119,11,3,541,576,1,168,0,0
4596,344,466,890,1073,119,11,3,546,607,2,168,0,0
4597,340,447,879,1073,119,11,3,539,626,3,168,0,0
4598,338,429,859,1064,119,11,3,521,635,4,168,0,0
4599,348,404,829,1019,119,11,3,481,615,5,168,0,0
4600,341,390,791,992,119,11,3,450,602,6,168,0,0
4601,337,383,748,955,119,11,3,411,572,7,168,0,0
4602,329,366,707,916,119,11,3,378,550,8,168,0,0
4603,324,354,683,901,119,11,3,359,547,9,168,0,0
4604,324,350,667,894,119,11,3,343,544,10,168,0,0
4605,329,336,655,873,119,11,3,326,537,11,168,0,0
4606,344,327,641,830,119,11,3,297,503,12,168,0,0
4607,341,318,628,818,119,11,3,287,500,13,168,0,0
4608,337,308,609,791,119,11,3,272,483,14,168,0,0
4609,340,312,594,774,119,11,3,254,462,15,168,0,0
4610,342,318,576,748,119,11,3,234,430,16,168,0,0
4611,342,288,579,736,119,11,3,237,448,17,168,0,0
4612,366,285,578,700,119,11,3,212,415,18,168,0,0
4613,369,238,587,686,119,11,3,218,448,19,168,0,0
4614,372,222,582,673,119,11,3,210,451,20,168,0,0
4615,367,191,577,665,119,11,3,210,474,21,168,0,0
4616,366,190,561,647,119,11,3,195,457,22,168,0,0
4617,364,183,548,634,119,11,3,184,451,23,168,0,0
4618,363,182,536,625,119,11,3,173,443,24,168,0,0
4619,365,182,528,616,119,11,3,163,434,25,168,0,0
4620,366,181,518,602,119,11,3,152,421,26,168,0,0
4621,368,209,503,589,119,11,3,135,380,27,168,0,0
4622,362,235,487,589,119,11,3,125,354,28,168,0,0
4623,353,239,474,583,119,11,3,121,344,29,168,0,0
4624,349,240,462,565,119,11,3,113,325,30,168,0,0
4625,351,241,457,548,119,11,3,106,307,31,168,0,0
4626,356,235,459,537,119,11,3,103,302,32,168,0,0
4627,361,232,462,529,119,11,3,101,297,33,168,0,0
4628,362,228,463,528,119,11,3,101,300,34,168,0,0
4629,363,224,463,525,119,11,3,100,301,35,168,0,0
4630,360,224,458,521,119,11,3,98,297,36,168,0,0
4631,353,224,449,513,119,11,3,96,289,37,168,0,0
4632,349,225,443,504,119,11,3,94,279,38,168,0,0
4633,347,226,438,499,119,11,3,91,273,39,168,0,0
4634,351,224,440,490,119,11,3,89,266,40,168,0,0
4635,355,219,443,480,119,11,3,88,261,41,168,0,0
4636,352,215,441,477,119,11,3,89,262,42,168,0,0
4637,353,214,441,472,119,11,3,88,258,43,168,0,0
4638,348,214,436,470,119,11,3,88,256,44,168,0,0
4639,343,211,430,463,119,11,3,87,252,45,168,0,0
4640,338,209,424,458,119,11,3,86,249,46,168,0,0
4641,336,210,420,451,119,11,3,84,241,47,168,0,0
4642,337,209,422,455,119,11,3,85,246,48,168,0,0
4643,340,206,422,445,119,11,3,82,239,49,168,0,0
4644,341,206,423,441,119,11,3,82,235,50,168,0,0
4645,337,205,418,437,119,11,3,81,232,51,168,0,0
4646,330,205,409,434,119,11,3,79,229,52,168,0,0
4647,324,200,401,424,119,11,3,77,224,53,168,0,0
4648,320,200,394,419,119,11,3,74,219,54,168,0,0
4649,318,200,389,417,119,11,3,71,217,55,168,0,0
4650,316,198,387,415,119,11,3,71,217,56,168,0,0
4651,315,195,384,410,119,11,3,69,215,57,168,0,0
4652,313,194,382,406,119,11,3,69,212,58,168,0,0
4653,307,192,376,405,119,11,3,69,213,59,168,0,0
4654,301,190,369,399,119,11,3,68,209,60,168,0,0
4655,295,187,362,395,119,11,3,67,208,61,168,0,0
4656,294,185,360,391,119,11,3,66,206,62,168,0,0
4657,297,186,360,388,119,11,3,63,202,63,168,0,0
4658,301,184,363,385,119,11,3,62,201,64,168,0,0
4659,305,182,366,379,119,11,3,61,197,65,168,0,0
4660,308,181,368,373,119,11,3,60,192,66,168,0,0
4661,308,179,368,373,119,11,3,60,194,67,168,0,0
4662,307,180,365,371,119,11,3,58,191,68,168,0,0
4663,306,179,365,369,119,11,3,59,190,69,168,0,0
4664,306,177,364,365,119,11,3,58,188,70,168,0,0
4665,306,178,364,365,119,11,3,58,187,71,168,0,0
4666,311,183,366,360,119,11,3,55,177,72,168,0,0
4667,315,180,370,358,119,11,3,55,178,73,168,0,0
4668,319,179,373,353,119,11,3,54,174,74,168,0,0
4669,321,179,374,352,119,11,3,53,173,75,168,0,0
4670,322,180,375,350,119,11,3,53,170,76,168,0,0
4671,322,179,374,347,119,11,3,52,168,77,168,0,0
4672,324,176,376,344,119,11,3,52,168,78,168,0,0
4673,327,177,378,338,119,11,3,51,161,79,168,0,0
4674,331,177,382,336,119,11,3,51,159,80,168,0,0
4675,335,174,385,331,119,11,3,50,157,81,168,0,0
4676,337,173,387,328,119,11,3,50,155,82,168,0,0
4677,336,173,385,327,119,11,3,49,154,83,168,0,0
4678,334,172,382,324,119,11,3,48,152,84,168,0,0
4679,332,172,379,321,119,11,3,47,149,85,168,0,0
4680,333,171,379,317,119,11,3,46,146,86,168,0,0
4681,336,168,382,315,119,11,3,46,147,87,168,0,0
4682,337,166,384,312,119,11,3,47,146,88,168,0,0
4683,339,166,385,311,119,11,3,46,145,89,168,0,0
4684,341,166,385,310,119,11,3,44,144,90,168,0,0
4685,340,164,385,313,119,11,3,45,149,91,168,0,0
4686,339,161,385,311,119,11,3,46,150,92,168,0,0
4687,339,160,384,308,119,11,3,45,148,93,168,0,0
4688,341,161,386,307,119,11,3,45,146,94,168,0,0
4689,343,162,387,306,119,11,3,44,144,95,168,0,0
4690,346,162,391,304,119,11,3,45,142,96,168,0,0
4691,350,160,394,302,119,11,3,44,142,97,168,0,0
4692,351,160,396,301,119,11,3,45,141,98,168,0,0
4693,351,157,397,301,119,11,3,46,144,99,168,0,0
4694,351,159,396,301,119,11,3,45,142,100,168,0,0
4695,350,159,396,304,119,11,3,46,145,101,168,0,0
4696,351,158,396,303,119,11,3,45,145,102,168,0,0
4697,352,160,397,303,119,11,3,45,143,103,168,0,0
4698,353,159,398,303,119,11,3,45,144,104,168,0,0
4699,356,159,401,305,119,11,3,45,146,105,168,0,0
4700,360,162,403,301,119,11,3,43,139,106,168,0,0
4701,366,163,409,302,119,11,3,43,139,107,168,0,0
4702,374,162,418,301,119,11,3,44,139,108,168,0,0
4703,378,161,423,303,119,11,3,45,142,109,168,0,0
4704,383,162,428,302,119,11,3,45,140,110,168,0,0
4705,379,163,424,304,119,11,3,45,141,111,168,0,0
4706,379,163,425,305,119,11,3,46,142,112,168,0,0
4707,380,163,426,306,119,11,3,46,143,113,168,0,0
4708,380,165,426,306,119,11,3,46,141,114,168,0,0
4709,382,165,428,307,119,11,3,46,142,115,168,0,0
4710,382,166,428,307,119,11,3,46,141,116,168,0,0
4711,382,167,428,307,119,11,3,46,140,117,168,0,0
4712,383,169,428,307,119,11,3,45,138,118,168,0,0
4713,383,169,429,306,119,11,3,46,137,119,168,0,0
4714,383,170,430,306,119,11,3,47,136,120,168,0,0
4715,383,171,429,306,119,11,3,46,135,121,168,0,0
4716,383,171,429,305,119,11,3,46,134,122,168,0,0
4717,383,172,430,305,119,11,3,47,133,123,168,0,0
4718,383,171,431,305,119,11,3,48,134,124,168,0,0
4719,382,170,431,305,119,11,3,49,135,125,168,0,0
4720,381,168,430,305,119,11,3,49,137,126,168,0,0
4721,380,166,429,305,119,11,3,49,139,127,168,0,0
4722,379,165,429,306,119,11,3,50,141,128,168,0,0
4723,379,164,428,307,119,11,3,49,143,129,168,0,0
4724,379,164,429,307,119,11,3,50,143,130,168,0,0
4725,379,163,429,308,119,11,3,50,145,131,168,0,0
4726,379,163,429,308,119,11,3,50,145,132,168,0,0
4727,379,163,429,308,119,11,3,50,145,133,168,0,0
4728,379,163,429,308,119,11,3,50,145,134,168,0,0
4729,379,163,428,307,119,11,3,49,144,135,168,0,0
4730,379,163,428,307,119,11,3,49,144,136,168,0,0
4731,378,163,427,307,119,11,3,49,144,137,168,0,0
4732,377,163,425,305,119,11,3,48,142,138,168,0,0
4733,376,163,424,305,119,11,3,48,142,139,168,0,0
4734,374,163,422,307,119,11,3,48,144,140,168,0,0
4735,369,160,418,309,119,11,3,49,149,141,168,0,0
4736,362,161,410,307,119,11,3,48,146,142,168,0,0
4737,359,163,405,305,119,11,3,46,142,143,168,0,0
4738,356,161,403,305,119,11,3,47,144,144,168,0,0
4739,355,160,402,304,119,11,3,47,144,145,168,0,0
4740,356,160,402,304,119,11,3,46,144,146,168,0,0
4741,361,160,406,301,119,11,3,45,141,147,168,0,0
4742,366,158,413,302,119,11,3,47,144,148,168,0,0
4743,370,157,419,301,119,11,3,49,144,149,168,0,0
4744,373,156,423,301,119,11,3,50,145,150,168,0,0
4745,378,157,428,303,119,11,3,50,146,151,168,0,0
4746,383,156,432,299,119,11,3,49,143,152,168,0,0
4747,386,156,434,298,119,11,3,48,142,153,168,0,0
4748,392,159,436,287,119,11,3,44,128,154,168,0,0
4749,395,159,439,286,119,11,3,44,127,155,168,0,0
4750,397,158,441,289,119,11,3,44,131,156,168,0,0
4751,403,158,447,290,119,11,3,44,132,157,168,0,0
4752,409,159,449,277,119,11,3,40,118,158,168,0,0
4753,414,159,452,270,119,11,3,38,111,159,168,0,0
4754,416,159,454,270,119,11,3,38,111,160,168,0,0
4755,417,158,455,272,119,11,3,38,114,161,168,0,0
4756,419,157,456,271,119,11,3,37,114,162,168,0,0
4757,419,157,456,268,119,11,3,37,111,163,168,0,0
4758,418,157,457,274,119,11,3,39,117,164,168,0,0
4759,418,156,457,277,119,11,3,39,121,165,168,0,0
4760,417,156,457,276,119,11,3,40,120,166,168,0,0
4761,416,156,457,284,119,11,3,41,128,167,168,0,0
4762,417,156,458,284,119,11,3,41,128,168,168,1,0
4608,420,146,463,230,120,11,3,43,84,0,12,0,0
4609,397,143,453,252,120,11,3,56,109,1,12,0,0
4610,384,144,447,268,120,11,3,63,124,2,12,0,0
4611,375,145,439,273,120,11,3,64,128,3,12,0,0
4612,361,148,423,274,120,11,3,62,126,4,12,0,0
4613,348,148,411,277,120,11,3,63,129,5,12,0,0
4614,336,147,399,277,120,11,3,63,130,6,12,0,0
4615,324,146,386,276,120,11,3,62,130,7,12,0,0
4616,315,149,375,277,120,11,3,60,128,8,12,0,0
4617,302,148,362,277,120,11,3,60,129,9,12,0,0
4618,291,150,348,277,120,11,3,57,127,10,12,0,0
4619,281,152,335,278,120,11,3,54,126,11,12,0,0
4620,270,153,325,281,120,11,3,55,128,12,12,0,0
4735,565,177,601,373,126,11,3,36,196,0,0,0,0
4738,565,181,609,365,127,11,3,44,184,0,3,0,0
4739,566,181,609,362,127,11,3,43,181,1,3,0,0
4740,565,181,609,362,127,11,3,44,181,2,3,0,0
4741,565,181,609,362,127,11,3,44,181,3,3,0,0
4912,805,205,870,483,128,11,3,65,278,0,34,0,1
4913,806,218,869,487,128,11,3,63,269,1,34,0,0
4914,791,220,856,497,128,11,3,65,277,2,34,0,0
4915,783,224,853,512,128,11,3,70,288,3,34,0,0
4916,783,225,855,519,128,11,3,72,294,4,34,0,0
4917,775,228,851,529,128,11,3,76,301,5,34,0,0
4918,770,233,850,543,128,11,3,80,310,6,34,0,0
4919,759,234,843,552,128,11,3,84,318,7,34,0,0
4920,749,242,839,574,128,11,3,90,332,8,34,0,0
4921,745,249,839,589,128,11,3,94,340,9,34,0,0
4922,743,248,843,602,128,11,3,100,354,10,34,0,0
4923,745,257,849,624,128,11,3,104,367,11,34,0,0
4924,740,263,849,642,128,11,3,109,379,12,34,0,0
4925,728,268,846,666,128,11,3,118,398,13,34,0,0
4926,726,282,850,697,128,11,3,124,415,14,34,0,0
4927,732,287,861,713,128,11,3,129,426,15,34,0,0
4928,738,295,875,742,128,11,3,137,447,16,34,0,0
4929,740,303,885,775,128,11,3,145,472,17,34,0,0
4930,735,309,883,788,128,11,3,148,479,18,34,0,0
4931,729,324,888,832,128,11,3,159,508,19,34,0,0
4932,735,335,905,878,128,11,3,170,543,20,34,0,0
4933,748,344,923,897,128,11,3,175,553,21,34,0,0
4934,755,363,944,960,128,11,3,189,597,22,34,0,0
4935,756,384,954,1002,128,11,3,198,618,23,34,0,0
4936,749,398,956,1038,128,11,3,207,640,24,34,0,0
4937,761,428,970,1065,128,11,3,209,637,25,34,0,0
4938,786,450,998,1077,128,11,3,212,627,26,34,0,0
4939,814,477,1026,1080,128,11,3,212,603,27,34,0,0
4940,836,523,1043,1080,128,11,3,207,557,28,34,0,0
4941,827,567,1035,1080,128,11,3,208,513,29,34,0,0
4942,832,616,1036,1080,128,11,3,204,464,30,34,0,0
4943,866,690,1055,1078,128,11,3,189,388,31,34,0,0
4944,905,760,1080,1075,128,11,3,175,315,32,34,0,0
4945,960,875,1091,1077,128,11,3,131,202,33,34,0,0
4946,991,928,1094,1080,128,11,3,103,152,34,34,1,0
5061,288,169,331,278,133,11,3,43,109,0,1,0,0
5062,291,170,333,278,133,11,3,42,108,1,1,0,0
5063,311,160,346,269,134,11,3,35,109,0,7,0,0
5066,310,168,347,282,134,11,3,37,114,0,7,0,0
5067,311,167,349,284,134,11,3,38,117,1,7,0,0
5068,312,172,348,285,134,11,3,36,113,2,7,0,0
5069,310,175,346,288,134,11,3,36,113,3,7,0,0
5071,310,176,346,288,134,11,3,36,112,0,7,0,0
5072,310,172,348,289,134,11,3,38,117,1,7,0,0
5073,314,178,350,288,134,11,3,36,110,2,7,0,0
5074,318,176,355,287,134,11,3,37,111,3,7,0,0
5075,325,173,363,286,134,11,3,38,113,4,7,0,0
5076,332,173,371,284,134,11,3,39,111,5,7,0,0
5077,341,165,379,280,134,11,3,38,115,6,7,0,0
5078,344,165,383,280,134,11,3,39,115,7,7,0,0
5064,323,180,364,271,135,11,3,41,91,0,1,0,0
5065,335,182,372,265,135,11,3,37,83,1,1,0,0
5066,356,164,392,271,138,11,3,36,107,0,1,0,0
5067,360,156,400,274,138,11,3,40,118,1,1,0,0
5072,362,169,397,284,139,11,3,35,115,0,11,0,0
5073,367,168,403,286,139,11,3,36,118,1,11,0,0
5074,369,168,406,288,139,11,3,37,120,2,11,0,0
5075,371,169,408,288,139,11,3,37,119,3,11,0,0
5076,372,168,410,287,139,11,3,38,119,4,11,0,0
5077,369,167,407,286,139,11,3,38,119,5,11,0,0
5078,365,164,404,286,139,11,3,39,122,6,11,0,0
5079,371,163,412,288,139,11,3,41,125,7,11,0,0
5080,382,161,423,286,139,11,3,41,125,8,11,0,0
5081,397,162,434,270,139,11,3,37,108,9,11,0,0
5082,406,165,444,269,139,11,3,38,104,10,11,0,0
5083,416,169,451,264,139,11,3,35,95,11,11,0,0
5069,347,171,385,277,141,11,3,38,106,0,0,0,0
5072,418,159,453,298,142,11,3,35,139,0,0,0,0
5124,824,228,871,434,143,11,3,47,206,0,50,0,1
5125,819,225,867,433,143,11,3,48,208,1,50,0,0
5126,802,224,852,434,143,11,3,50,210,2,50,0,0
5127,788,226,839,434,143,11,3,51,208,3,50,0,0
5128,772,224,825,440,143,11,3,53,216,4,50,0,0
5129,742,224,798,441,143,11,3,56,217,5,50,0,0
5130,721,226,780,442,143,11,3,59,216,6,50,0,0
5131,704,227,766,448,143,11,3,62,221,7,50,0,0
5132,683,229,748,453,143,11,3,65,224,8,50,0,0
5133,664,232,728,453,143,11,3,64,221,9,50,0,0
5134,645,230,712,458,143,11,3,67,228,10,50,0,0
5135,626,235,695,465,143,11,3,69,230,11,50,0,0
5136,613,236,684,472,143,11,3,71,236,12,50,0,0
5137,603,233,677,477,143,11,3,74,244,13,50,0,0
5138,596,238,672,489,143,11,3,76,251,14,50,0,0
5139,591,241,670,494,143,11,3,79,253,15,50,0,0
5140,586,243,667,501,143,11,3,81,258,16,50,0,0
5141,579,245,664,514,143,11,3,85,269,17,50,0,0
5142,574,246,660,520,143,11,3,86,274,18,50,0,0
5143,568,248,658,534,143,11,3,90,286,19,50,0,0
5144,567,250,661,551,143,11,3,94,301,20,50,0,0
5145,568,253,662,554,143,11,3,94,301,21,50,0,0
5146,566,260,663,572,143,11,3,97,312,22,50,0,0
5147,563,261,663,582,143,11,3,100,321,23,50,0,0
5148,564,272,666,599,143,11,3,102,327,24,50,0,0
5149,569,282,672,610,143,11,3,103,328,25,50,0,0
5150,575,287,680,619,143,11,3,105,332,26,50,0,0
5151,576,294,686,646,143,11,3,110,352,27,50,0,0
5152,576,299,690,661,143,11,3,114,362,28,50,0,0
5153,578,308,696,683,143,11,3,118,375,29,50,0,0
5154,579,323,701,709,143,11,3,122,386,30,50,0,0
5155,584,334,707,717,143,11,3,123,383,31,50,0,0
5156,584,349,714,755,143,11,3,130,406,32,50,0,0
5157,579,358,714,775,143,11,3,135,417,33,50,0,0
5158,573,368,715,805,143,11,3,142,437,34,50,0,0
5159,572,384,717,830,143,11,3,145,446,35,50,0,0
5160,573,394,725,851,143,11,3,152,457,36,50,0,0
5161,571,412,734,905,143,11,3,163,493,37,50,0,0
5162,563,422,732,934,143,11,3,169,512,38,50,0,0
5163,547,438,727,980,143,11,3,180,542,39,50,0,0
5164,541,461,732,1035,143,11,3,191,574,40,50,0,0
5165,544,482,737,1056,143,11,3,193,574,41,50,0,0
5166,548,509,742,1077,143,11,3,194,568,42,50,0,0
5167,556,538,748,1080,143,11,3,192,542,43,50,0,0
5168,558,575,746,1080,143,11,3,188,505,44,50,0,0
5169,599,624,789,1080,143,11,3,190,456,45,50,0,0
5170,627,673,815,1080,143,11,3,188,407,46,50,0,0
5171,654,736,829,1080,143,11,3,175,344,47,50,0,0
5172,696,808,853,1080,143,11,3,157,272,48,50,0,0
5173,775,893,901,1079,143,11,3,126,186,49,50,0,0
5174,811,939,912,1080,143,11,3,101,141,50,50,1,0
5243,349,160,386,254,145,11,3,37,94,0,71,0,1
5244,348,161,388,263,145,11,3,40,102,1,71,0,0
5245,346,158,388,266,145,11,3,42,108,2,71,0,0
5246,345,156,389,269,145,11,3,44,113,3,71,0,0
5247,345,156,388,271,145,11,3,43,115,4,71,0,0
5248,344,155,389,274,145,11,3,45,119,5,71,0,0
5249,343,157,388,277,145,11,3,45,120,6,71,0,0
5250,343,161,386,278,145,11,3,43,117,7,71,0,0
5251,342,162,386,278,145,11,3,44,116,8,71,0,0
5252,342,165,388,288,145,11,3,46,123,9,71,0,0
5253,343,166,388,291,145,11,3,45,125,10,71,0,0
5254,345,169,391,298,145,11,3,46,129,11,71,0,0
5255,346,170,393,303,145,11,3,47,133,12,71,0,0
5256,349,170,396,304,145,11,3,47,134,13,71,0,0
5257,354,171,401,306,145,11,3,47,135,14,71,0,0
5258,362,171,410,310,145,11,3,48,139,15,71,0,0
5259,371,174,419,313,145,11,3,48,139,16,71,0,0
5260,378,175,426,314,145,11,3,48,139,17,71,0,0
5261,384,175,432,311,145,11,3,48,136,18,71,0,0
5262,390,178,439,317,145,11,3,49,139,19,71,0,0
5263,399,180,445,311,145,11,3,46,131,20,71,0,0
5264,404,182,454,327,145,11,3,50,145,21,71,0,0
5265,408,185,463,341,145,11,3,55,156,22,71,0,0
5266,413,184,469,344,145,11,3,56,160,23,71,0,0
5267,419,189,477,355,145,11,3,58,166,24,71,0,0
5268,428,194,486,360,145,11,3,58,166,25,71,0,0
5269,439,198,497,362,145,11,3,58,164,26,71,0,0
5270,447,197,508,373,145,11,3,61,176,27,71,0,0
5271,456,197,516,369,145,11,3,60,172,28,71,0,0
5272,464,200,525,376,145,11,3,61,176,29,71,0,0
5273,473,201,537,388,145,11,3,64,187,30,71,0,0
5274,484,197,549,388,145,11,3,65,191,31,71,0,0
5275,495,202,563,402,145,11,3,68,200,32,71,0,0
5276,505,206,571,403,145,11,3,66,197,33,71,0,0
5277,512,206,581,411,145,11,3,69,205,34,71,0,0
5278,522,210,596,426,145,11,3,74,216,35,71,0,0
5279,535,214,609,431,145,11,3,74,217,36,71,0,0
5280,544,217,621,446,145,11,3,77,229,37,71,0,0
5281,551,225,629,458,145,11,3,78,233,38,71,0,0
5282,559,228,637,461,145,11,3,78,233,39,71,0,0
5283,565,232,647,477,145,11,3,82,245,40,71,0,0
5284,575,235,658,486,145,11,3,83,251,41,71,0,0
5285,582,242,669,503,145,11,3,87,261,42,71,0,0
5286,594,250,682,520,145,11,3,88,270,43,71,0,0
5287,605,254,695,529,145,11,3,90,275,44,71,0,0
5288,617,260,713,551,145,11,3,96,291,45,71,0,0
5289,636,267,733,561,145,11,3,97,294,46,71,0,0
5290,654,271,758,586,145,11,3,104,315,47,71,0,0
5291,673,286,780,613,145,11,3,107,327,48,71,0,0
5292,688,290,796,623,145,11,3,108,333,49,71,0,0
5293,704,297,818,642,145,11,3,114,345,50,71,0,0
5294,724,308,842,663,145,11,3,118,355,51,71,0,0
5295,752,319,873,684,145,11,3,121,365,52,71,0,0
5296,781,334,911,725,145,11,3,130,391,53,71,0,0
5297,804,346,939,750,145,11,3,135,404,54,71,0,0
5298,825,355,964,774,145,11,3,139,419,55,71,0,0
5299,848,376,996,816,145,11,3,148,440,56,71,0,0
5300,886,389,1035,836,145,11,3,149,447,57,71,0,0
5301,929,409,1090,886,145,11,3,161,477,58,71,0,0
5302,965,432,1133,926,145,11,3,168,494,59,71,0,0
5303,995,450,1163,945,145,11,3,168,495,60,71,0,0
5304,1026,481,1202,994,145,11,3,176,513,61,71,0,0
5305,1072,512,1260,1045,145,11,3,188,533,62,71,0,0
5306,1140,537,1333,1075,145,11,3,193,538,63,71,0,0
5307,1197,585,1386,1078,145,11,3,189,493,64,71,0,0
5308,1282,617,1466,1077,145,11,3,184,460,65,71,0,0
5309,1360,652,1542,1080,145,11,3,182,428,66,71,0,0
5310,1437,700,1617,1080,145,11,3,180,380,67,71,0,0
5311,1547,739,1720,1080,145,11,3,173,341,68,71,0,0
5312,1661,789,1819,1080,145,11,3,158,291,69,71,0,0
5313,1764,836,1899,1079,145,11,3,135,243,70,71,0,0
5314,1839,869,1920,1080,145,11,3,81,211,71,71,1,0
5257,414,220,450,308,146,11,3,36,88,0,0,0,0
5325,334,172,369,280,147,11,3,35,108,0,0,0,0
5329,280,176,315,283,147,11,3,35,107,0,0,0,0
5451,281,229,316,470,148,11,3,35,241,0,30,0,1
5452,298,230,336,480,148,11,3,38,250,1,30,0,0
5453,309,237,350,498,148,11,3,41,261,2,30,0,0
5454,328,239,371,500,148,11,3,43,261,3,30,0,0
5455,344,247,392,519,148,11,3,48,272,4,30,0,0
5456,355,252,406,528,148,11,3,51,276,5,30,0,0
5457,360,255,416,547,148,11,3,56,292,6,30,0,0
5458,360,263,423,567,148,11,3,63,304,7,30,0,0
5459,364,267,429,574,148,11,3,65,307,8,30,0,0
5460,367,277,437,594,148,11,3,70,317,9,30,0,0
5461,371,284,445,609,148,11,3,74,325,10,30,0,0
5462,374,289,454,633,148,11,3,80,344,11,30,0,0
5463,376,299,463,663,148,11,3,87,364,12,30,0,0
5464,381,304,472,673,148,11,3,91,369,13,30,0,0
5465,392,317,489,708,148,11,3,97,391,14,30,0,0
5466,405,328,507,729,148,11,3,102,401,15,30,0,0
5467,413,336,525,765,148,11,3,112,429,16,30,0,0
5468,417,351,538,804,148,11,3,121,453,17,30,0,0
5469,421,361,547,821,148,11,3,126,460,18,30,0,0
5470,430,382,564,870,148,11,3,134,488,19,30,0,0
5471,444,399,583,896,148,11,3,139,497,20,30,0,0
5472,451,417,608,963,148,11,3,157,546,21,30,0,0
5473,458,443,629,1021,148,11,3,171,578,22,30,0,0
5474,479,469,653,1047,148,11,3,174,578,23,30,0,0
5475,511,507,684,1070,148,11,3,173,563,24,30,0,0
5476,558,538,730,1079,148,11,3,172,541,25,30,0,0
5477,604,582,771,1080,148,11,3,167,498,26,30,0,0
5478,647,638,814,1080,148,11,3,167,442,27,30,0,0
5479,719,688,879,1080,148,11,3,160,392,28,30,0,0
5480,813,750,956,1078,148,11,3,143,328,29,30,0,0
5481,852,782,989,1080,148,11,3,137,298,30,30,1,0
5490,353,124,388,215,151,11,3,35,91,0,70,0,0
5493,352,126,388,218,151,11,3,36,92,0,70,0,1
5494,352,125,389,220,151,11,3,37,95,1,70,0,0
5495,353,129,388,221,151,11,3,35,92,2,70,0,0
5496,352,128,389,221,151,11,3,37,93,3,70,0,0
5497,351,126,390,223,151,11,3,39,97,4,70,0,0
5498,349,126,387,222,151,11,3,38,96,5,70,0,0
5499,347,128,385,223,151,11,3,38,95,6,70,0,0
5500,339,132,377,226,151,11,3,38,94,7,70,0,0
5501,334,133,371,228,151,11,3,37,95,8,70,0,0
5502,331,135,369,229,151,11,3,38,94,9,70,0,0
5503,331,138,367,229,151,11,3,36,91,10,70,0,0
5504,327,138,364,233,151,11,3,37,95,11,70,0,0
5505,323,137,362,234,151,11,3,39,97,12,70,0,0
5506,320,135,359,236,151,11,3,39,101,13,70,0,0
5507,318,135,358,238,151,11,3,40,103,14,70,0,0
5508,317,135,357,239,151,11,3,40,104,15,70,0,0
5509,317,133,358,240,151,11,3,41,107,16,70,0,0
5510,317,134,358,241,151,11,3,41,107,17,70,0,0
5511,315,140,355,245,151,11,3,40,105,18,70,0,0
5512,312,137,354,248,151,11,3,42,111,19,70,0,0
5513,312,136,353,249,151,11,3,41,113,20,70,0,0
5514,310,134,353,251,151,11,3,43,117,21,70,0,0
5515,310,135,354,253,151,11,3,44,118,22,70,0,0
5516,310,136,353,256,151,11,3,43,120,23,70,0,0
5517,309,138,351,254,151,11,3,42,116,24,70,0,0
5518,311,140,352,256,151,11,3,41,116,25,70,0,0
5519,312,137,355,258,151,11,3,43,121,26,70,0,0
5520,315,139,357,262,151,11,3,42,123,27,70,0,0
5521,315,142,358,265,151,11,3,43,123,28,70,0,0
5522,314,142,358,265,151,11,3,44,123,29,70,0,0
5523,315,143,358,266,151,11,3,43,123,30,70,0,0
5524,315,145,359,268,151,11,3,44,123,31,70,0,0
5525,318,145,361,269,151,11,3,43,124,32,70,0,0
5526,317,146,362,275,151,11,3,45,129,33,70,0,0
5527,316,149,362,277,151,11,3,46,128,34,70,0,0
5528,315,149,361,278,151,11,3,46,129,35,70,0,0
5529,314,148,362,283,151,11,3,48,135,36,70,0,0
5530,316,149,364,283,151,11,3,48,134,37,70,0,0
5531,316,149,365,287,151,11,3,49,138,38,70,0,0
5532,315,151,364,290,151,11,3,49,139,39,70,0,0
5533,314,152,363,292,151,11,3,49,140,40,70,0,0
5534,313,152,363,296,151,11,3,50,144,41,70,0,0
5535,314,153,364,301,151,11,3,50,148,42,70,0,0
5536,314,155,363,300,151,11,3,49,145,43,70,0,0
5537,312,156,361,304,151,11,3,49,148,44,70,0,0
5538,309,157,360,312,151,11,3,51,155,45,70,0,0
5539,308,159,358,314,151,11,3,50,155,46,70,0,0
5540,308,160,357,318,151,11,3,49,158,47,70,0,0
5541,308,169,356,323,151,11,3,48,154,48,70,0,0
5542,309,171,358,324,151,11,3,49,153,49,70,0,0
5543,305,171,356,330,151,11,3,51,159,50,70,0,0
5544,302,173,353,332,151,11,3,51,159,51,70,0,0
5545,300,176,351,335,151,11,3,51,159,52,70,0,0
5546,297,175,351,344,151,11,3,54,169,53,70,0,0
5547,298,175,354,350,151,11,3,56,175,54,70,0,0
5548,300,173,358,353,151,11,3,58,180,55,70,0,0
5549,300,171,361,357,151,11,3,61,186,56,70,0,0
5550,298,167,360,359,151,11,3,62,192,57,70,0,0
5551,296,167,359,365,151,11,3,63,198,58,70,0,0
5552,295,169,360,374,151,11,3,65,205,59,70,0,0
5553,299,172,363,374,151,11,3,64,202,60,70,0,0
5554,301,176,366,379,151,11,3,65,203,61,70,0,0
5555,301,178,366,381,151,11,3,65,203,62,70,0,0
5556,297,179,364,391,151,11,3,67,212,63,70,0,0
5557,296,178,365,397,151,11,3,69,219,64,70,0,0
5558,295,180,365,403,151,11,3,70,223,65,70,0,0
5559,293,181,364,409,151,11,3,71,228,66,70,0,0
5560,288,187,357,411,151,11,3,69,224,67,70,0,0
5561,278,192,347,423,151,11,3,69,231,68,70,0,0
5562,265,194,334,428,151,11,3,69,234,69,70,0,0
5563,262,196,331,433,151,11,3,69,237,70,70,1,0
5521,366,155,402,264,152,11,3,36,109,0,45,0,1
5522,366,155,402,266,152,11,3,36,111,1,45,0,0
5523,367,161,403,267,152,11,3,36,106,2,45,0,0
5524,367,160,404,269,152,11,3,37,109,3,45,0,0
5525,366,160,403,271,152,11,3,37,111,4,45,0,0
5526,365,165,401,273,152,11,3,36,108,5,45,0,0
5527,363,164,401,278,152,11,3,38,114,6,45,0,0
5528,362,167,401,282,152,11,3,39,115,7,45,0,0
5529,363,167,402,284,152,11,3,39,117,8,45,0,0
5530,363,169,402,287,152,11,3,39,118,9,45,0,0
5531,361,169,401,290,152,11,3,40,121,10,45,0,0
5532,359,168,401,294,152,11,3,42,126,11,45,0,0
5533,359,172,401,298,152,11,3,42,126,12,45,0,0
5534,359,172,401,299,152,11,3,42,127,13,45,0,0
5535,357,172,400,302,152,11,3,43,130,14,45,0,0
5536,353,170,397,303,152,11,3,44,133,15,45,0,0
5537,349,170,393,304,152,11,3,44,134,16,45,0,0
5538,347,169,392,310,152,11,3,45,141,17,45,0,0
5539,347,170,392,313,152,11,3,45,143,18,45,0,0
5540,351,170,397,315,152,11,3,46,145,19,45,0,0
5541,359,169,407,318,152,11,3,48,149,20,45,0,0
5542,359,167,409,322,152,11,3,50,155,21,45,0,0
5543,359,167,410,327,152,11,3,51,160,22,45,0,0
5544,360,171,413,336,152,11,3,53,165,23,45,0,0
5545,364,175,418,339,152,11,3,54,164,24,45,0,0
5546,369,180,424,350,152,11,3,55,170,25,45,0,0
5547,371,183,427,356,152,11,3,56,173,26,45,0,0
5548,372,183,429,359,152,11,3,57,176,27,45,0,0
5549,375,186,433,363,152,11,3,58,177,28,45,0,0
5550,379,189,437,365,152,11,3,58,176,29,45,0,0
5551,382,190,440,366,152,11,3,58,176,30,45,0,0
5552,380,196,440,375,152,11,3,60,179,31,45,0,0
5553,378,198,439,381,152,11,3,61,183,32,45,0,0
5554,375,198,440,387,152,11,3,65,189,33,45,0,0
5555,374,201,440,394,152,11,3,66,193,34,45,0,0
5556,374,203,440,395,152,11,3,66,192,35,45,0,0
5557,369,206,436,400,152,11,3,67,194,36,45,0,0
5558,360,210,430,411,152,11,3,70,201,37,45,0,0
5559,350,209,423,422,152,11,3,73,213,38,45,0,0
5560,335,213,407,423,152,11,3,72,210,39,45,0,0
5561,322,218,394,431,152,11,3,72,213,40,45,0,0
5562,303,215,378,436,152,11,3,75,221,41,45,0,0
5563,283,207,365,445,152,11,3,82,238,42,45,0,0
5564,256,205,339,449,152,11,3,83,244,43,45,0,0
5565,233,201,317,458,152,11,3,84,257,44,45,0,0
5566,223,201,309,464,152,11,3,86,263,45,45,1,0
5523,521,183,557,348,153,11,3,36,165,0,18,0,0
5524,504,180,541,345,153,11,3,37,165,1,18,0,0
5525,487,180,524,342,153,11,3,37,162,2,18,0,0
5526,473,182,510,338,153,11,3,37,156,3,18,0,0
5527,462,182,499,335,153,11,3,37,153,4,18,0,0
5528,448,180,487,333,153,11,3,39,153,5,18,0,0
5529,434,178,475,333,153,11,3,41,155,6,18,0,0
5530,421,176,463,331,153,11,3,42,155,7,18,0,0
5531,411,173,454,329,153,11,3,43,156,8,18,0,0
5532,406,173,449,324,153,11,3,43,151,9,18,0,0
5533,402,171,445,316,153,11,3,43,145,10,18,0,0
5534,398,170,442,317,153,11,3,44,147,11,18,0,0
5535,394,171,438,314,153,11,3,44,143,12,18,0,0
5536,391,170,433,309,153,11,3,42,139,13,18,0,0
5537,389,169,433,308,153,11,3,44,139,14,18,0,0
5538,389,166,434,309,153,11,3,45,143,15,18,0,0
5539,389,166,433,306,153,11,3,44,140,16,18,0,0
5540,386,167,430,306,153,11,3,44,139,17,18,0,0
5541,381,166,424,303,153,11,3,43,137,18,18,0,0
5542,413,204,455,310,155,11,3,42,106,0,1,0,0
5543,414,210,454,310,155,11,3,40,100,1,1,0,0
5546,344,159,394,287,156,11,3,50,128,0,1,0,0
5547,341,157,390,283,156,11,3,49,126,1,1,0,0
5678,234,223,309,494,157,11,3,75,271,0,60,0,1
5679,237,216,314,494,157,11,3,77,278,1,60,0,0
5680,249,214,328,496,157,11,3,79,282,2,60,0,0
5681,266,213,346,493,157,11,3,80,280,3,60,0,0
5682,275,214,353,490,157,11,3,78,276,4,60,0,0
5683,283,211,363,491,157,11,3,80,280,5,60,0,0
5684,300,208,382,487,157,11,3,82,279,6,60,0,0
5685,314,207,394,477,157,11,3,80,270,7,60,0,0
5686,324,205,407,478,157,11,3,83,273,8,60,0,0
5687,340,199,423,469,157,11,3,83,270,9,60,0,0
5688,356,198,435,458,157,11,3,79,260,10,60,0,0
5689,368,199,446,451,157,11,3,78,252,11,60,0,0
5690,375,193,452,441,157,11,3,77,248,12,60,0,0
5691,383,189,461,432,157,11,3,78,243,13,60,0,0
5692,399,189,476,423,157,11,3,77,234,14,60,0,0
5693,411,186,488,414,157,11,3,77,228,15,60,0,0
5694,423,185,499,408,157,11,3,76,223,16,60,0,0
5695,429,184,505,406,157,11,3,76,222,17,60,0,0
5696,437,181,512,400,157,11,3,75,219,18,60,0,0
5697,445,179,520,395,157,11,3,75,216,19,60,0,0
5698,454,179,528,392,157,11,3,74,213,20,60,0,0
5699,459,176,533,391,157,11,3,74,215,21,60,0,0
5700,465,174,538,387,157,11,3,73,213,22,60,0,0
5701,464,175,536,382,157,11,3,72,207,23,60,0,0
5702,461,175,532,380,157,11,3,71,205,24,60,0,0
5703,458,175,528,379,157,11,3,70,204,25,60,0,0
5704,459,175,529,377,157,11,3,70,202,26,60,0,0
5705,460,176,530,373,157,11,3,70,197,27,60,0,0
5706,460,177,530,374,157,11,3,70,197,28,60,0,0
5707,464,176,533,371,157,11,3,69,195,29,60,0,0
5708,473,175,540,367,157,11,3,67,192,30,60,0,0
5709,484,176,549,363,157,11,3,65,187,31,60,0,0
5710,491,173,554,363,157,11,3,63,190,32,60,0,0
5711,499,173,559,357,157,11,3,60,184,33,60,0,0
5712,502,172,561,356,157,11,3,59,184,34,60,0,0
5713,504,171,563,355,157,11,3,59,184,35,60,0,0
5714,504,173,561,355,157,11,3,57,182,36,60,0,0
5715,503,170,560,355,157,11,3,57,185,37,60,0,0
5716,503,170,559,354,157,11,3,56,184,38,60,0,0
5717,503,170,558,353,157,11,3,55,183,39,60,0,0
5718,502,171,557,353,157,11,3,55,182,40,60,0,0
5719,502,171,556,353,157,11,3,54,182,41,60,0,0
5720,502,171,555,353,157,11,3,53,182,42,60,0,0
5721,502,171,555,352,157,11,3,53,181,43,60,0,0
5722,501,170,555,354,157,11,3,54,184,44,60,0,0
5723,499,169,553,356,157,11,3,54,187,45,60,0,0
5724,499,170,552,355,157,11,3,53,185,46,60,0,0
5725,499,170,552,355,157,11,3,53,185,47,60,0,0
5726,501,172,553,357,157,11,3,52,185,48,60,0,0
5727,501,171,553,357,157,11,3,52,186,49,60,0,0
5728,502,173,554,357,157,11,3,52,184,50,60,0,0
5729,503,173,555,355,157,11,3,52,182,51,60,0,0
5730,503,173,555,355,157,11,3,52,182,52,60,0,0
5731,503,174,555,354,157,11,3,52,180,53,60,0,0
5732,502,174,555,354,157,11,3,53,180,54,60,0,0
5733,505,173,559,352,157,11,3,54,179,55,60,0,0
5734,509,173,565,355,157,11,3,56,182,56,60,0,0
5735,516,173,576,361,157,11,3,60,188,57,60,0,0
5736,525,172,589,361,157,11,3,64,189,58,60,0,0
5737,547,171,609,363,157,11,3,62,192,59,60,0,0
5738,551,171,614,364,157,11,3,63,193,60,60,1,0
5740,515,181,571,355,157,11,3,56,174,0,60,0,0
5741,519,184,574,357,157,11,3,55,173,1,60,0,0
5742,532,191,584,357,157,11,3,52,166,2,60,0,0
5743,549,195,602,363,157,11,3,53,168,3,60,0,0
5744,553,197,605,364,157,11,3,52,167,4,60,0,0
5684,239,231,284,422,158,11,3,45,191,0,41,0,0
5685,252,217,301,422,158,11,3,49,205,1,41,0,0
5686,264,210,315,421,158,11,3,51,211,2,41,0,0
5687,289,206,338,413,158,11,3,49,207,3,41,0,0
5688,307,205,357,410,158,11,3,50,205,4,41,0,0
5689,325,204,374,404,158,11,3,49,200,5,41,0,0
5690,349,200,395,388,158,11,3,46,188,6,41,0,0
5691,366,197,411,382,158,11,3,45,185,7,41,0,0
5708,457,190,494,338,158,11,3,37,148,0,41,0,1
5709,461,190,499,340,158,11,3,38,150,1,41,0,0
5710,462,184,503,344,158,11,3,41,160,2,41,0,0
5711,463,180,507,346,158,11,3,44,166,3,41,0,0
5712,463,178,509,347,158,11,3,46,169,4,41,0,0
5713,460,177,508,349,158,11,3,48,172,5,41,0,0
5714,459,172,510,351,158,11,3,51,179,6,41,0,0
5715,453,171,508,358,158,11,3,55,187,7,41,0,0
5716,452,173,508,363,158,11,3,56,190,8,41,0,0
5717,451,170,508,368,158,11,3,57,198,9,41,0,0
5718,451,170,510,371,158,11,3,59,201,10,41,0,0
5719,450,168,509,373,158,11,3,59,205,11,41,0,0
5720,449,168,509,372,158,11,3,60,204,12,41,0,0
5721,450,168,509,371,158,11,3,59,203,13,41,0,0
5722,450,169,508,370,158,11,3,58,201,14,41,0,0
5723,450,170,507,369,158,11,3,57,199,15,41,0,0
5724,450,169,507,369,158,11,3,57,200,16,41,0,0
5725,451,170,508,370,158,11,3,57,200,17,41,0,0
5726,452,170,509,369,158,11,3,57,199,18,41,0,0
5727,452,168,509,370,158,11,3,57,202,19,41,0,0
5728,452,166,509,369,158,11,3,57,203,20,41,0,0
5729,452,166,509,369,158,11,3,57,203,21,41,0,0
5730,453,166,510,369,158,11,3,57,203,22,41,0,0
5731,454,166,510,369,158,11,3,56,203,23,41,0,0
5732,453,167,510,370,158,11,3,57,203,24,41,0,0
5733,455,171,509,366,158,11,3,54,195,25,41,0,0
5734,454,172,510,367,158,11,3,56,195,26,41,0,0
5735,455,172,513,373,158,11,3,58,201,27,41,0,0
5736,455,171,515,376,158,11,3,60,205,28,41,0,0
5737,457,171,519,378,158,11,3,62,207,29,41,0,0
5738,462,171,524,375,158,11,3,62,204,30,41,0,0
5739,467,173,530,373,158,11,3,63,200,31,41,0,0
5740,468,174,532,374,158,11,3,64,200,32,41,0,0
5741,470,176,534,372,158,11,3,64,196,33,41,0,0
5742,487,175,550,371,158,11,3,63,196,34,41,0,0
5743,499,179,562,370,158,11,3,63,191,35,41,0,0
5744,517,180,581,368,158,11,3,64,188,36,41,0,0
5745,526,179,591,368,158,11,3,65,189,37,41,0,0
5746,534,178,601,367,158,11,3,67,189,38,41,0,0
5747,537,172,608,372,158,11,3,71,200,39,41,0,0
5748,551,165,622,371,158,11,3,71,206,40,41,0,0
5749,558,164,629,371,158,11,3,71,207,41,41,1,0
5690,240,195,295,441,160,11,3,55,246,0,25,0,1
5691,256,191,311,438,160,11,3,55,247,1,25,0,0
5692,274,190,329,429,160,11,3,55,239,2,25,0,0
5693,283,185,338,423,160,11,3,55,238,3,25,0,0
5694,296,184,350,417,160,11,3,54,233,4,25,0,0
5695,305,181,359,409,160,11,3,54,228,5,25,0,0
5696,320,175,376,403,160,11,3,56,228,6,25,0,0
5697,328,174,384,401,160,11,3,56,227,7,25,0,0
5698,336,175,392,392,160,11,3,56,217,8,25,0,0
5699,345,173,399,384,160,11,3,54,211,9,25,0,0
5700,353,171,408,379,160,11,3,55,208,10,25,0,0
5701,363,173,418,376,160,11,3,55,203,11,25,0,0
5702,373,171,428,373,160,11,3,55,202,12,25,0,0
5703,379,170,434,370,160,11,3,55,200,13,25,0,0
5704,384,169,439,368,160,11,3,55,199,14,25,0,0
5705,389,172,443,367,160,11,3,54,195,15,25,0,0
5706,392,168,446,365,160,11,3,54,197,16,25,0,0
5707,396,169,449,365,160,11,3,53,196,17,25,0,0
5708,399,172,451,366,160,11,3,52,194,18,25,0,0
5709,401,173,453,365,160,11,3,52,192,19,25,0,0
5710,405,174,456,367,160,11,3,51,193,20,25,0,0
5711,407,174,459,369,160,11,3,52,195,21,25,0,0
5712,411,178,463,368,160,11,3,52,190,22,25,0,0
5713,415,177,471,372,160,11,3,56,195,23,25,0,0
5714,424,212,474,374,160,11,3,50,162,24,25,0,0
5715,430,216,478,373,160,11,3,48,157,25,25,1,0
5979,516,173,554,321,161,11,3,38,148,0,18,0,0
5980,508,175,544,313,161,11,3,36,138,1,18,0,0
5981,493,175,529,311,161,11,3,36,136,2,18,0,0
5982,471,182,506,313,161,11,3,35,131,3,18,0,0
5983,449,180,486,314,161,11,3,37,134,4,18,0,0
5984,431,176,469,314,161,11,3,38,138,5,18,0,0
5985,415,173,455,314,161,11,3,40,141,6,18,0,0
5986,403,172,443,314,161,11,3,40,142,7,18,0,0
5987,387,171,428,312,161,11,3,41,141,8,18,0,0
5988,373,173,412,305,161,11,3,39,132,9,18,0,0
5989,359,170,399,306,161,11,3,40,136,10,18,0,0
5990,349,168,391,308,161,11,3,42,140,11,18,0,0
5991,342,167,383,305,161,11,3,41,138,12,18,0,0
5992,338,166,379,305,161,11,3,41,139,13,18,0,0
5993,335,167,376,307,161,11,3,41,140,14,18,0,0
5994,329,167,368,301,161,11,3,39,134,15,18,0,0
5995,323,167,358,288,161,11,3,35,121,16,18,0,0
5996,317,168,352,287,161,11,3,35,119,17,18,0,0
5997,310,166,345,284,161,11,3,35,118,18,18,0,0
5989,415,220,452,310,162,11,3,37,90,0,3,0,0
5990,416,210,455,305,162,11,3,39,95,1,3,0,0
5991,414,211,452,305,162,11,3,38,94,2,3,0,0
5992,414,211,452,305,162,11,3,38,94,3,3,0,0
32,1137,259,1268,418,1,11,4,131,159,0,0,0,0
61,1769,752,1920,1073,3,11,4,151,321,0,34,0,1
62,1697,698,1876,1074,3,11,4,179,376,1,34,0,0
63,1618,623,1836,1072,3,11,4,218,449,2,34,0,0
64,1617,570,1863,1074,3,11,4,246,504,3,34,0,0
65,1632,532,1895,1068,3,11,4,263,536,4,34,0,0
66,1638,506,1915,1071,3,11,4,277,565,5,34,0,0
67,1625,485,1914,1073,3,11,4,289,588,6,34,0,0
68,1634,486,1920,1073,3,11,4,286,587,7,34,0,0
69,1659,486,1914,1005,3,11,4,255,519,8,34,0,0
70,1619,510,1886,1041,3,11,4,267,531,9,34,0,0
71,1635,537,1897,1055,3,11,4,262,518,10,34,0,0
72,1635,578,1887,1067,3,11,4,252,489,11,34,0,0
73,1634,597,1883,1073,3,11,4,249,476,12,34,0,0
74,1638,604,1890,1078,3,11,4,252,474,13,34,0,0
75,1641,612,1891,1077,3,11,4,250,465,14,34,0,0
76,1636,617,1882,1075,3,11,4,246,458,15,34,0,0
77,1635,620,1880,1075,3,11,4,245,455,16,34,0,0
78,1635,620,1883,1076,3,11,4,248,456,17,34,0,0
79,1630,619,1877,1078,3,11,4,247,459,18,34,0,0
80,1629,619,1878,1079,3,11,4,249,460,19,34,0,0
81,1628,623,1874,1076,3,11,4,246,453,20,34,0,0
82,1630,627,1875,1075,3,11,4,245,448,21,34,0,0
83,1635,620,1882,1074,3,11,4,247,454,22,34,0,0
84,1638,571,1909,1070,3,11,4,271,499,23,34,0,0
85,1636,525,1920,1075,3,11,4,284,550,24,34,0,0
86,1643,506,1920,1075,3,11,4,277,569,25,34,0,0
87,1639,502,1920,1078,3,11,4,281,576,26,34,0,0
88,1644,515,1920,1075,3,11,4,276,560,27,34,0,0
89,1640,542,1904,1072,3,11,4,264,530,28,34,0,0
90,1612,576,1861,1068,3,11,4,249,492,29,34,0,0
91,1563,613,1806,1074,3,11,4,243,461,30,34,0,0
92,1539,681,1756,1072,3,11,4,217,391,31,34,0,0
93,1505,763,1697,1069,3,11,4,192,306,32,34,0,0
94,1437,837,1610,1074,3,11,4,173,237,33,34,0,0
95,1419,868,1570,1075,3,11,4,151,207,34,34,1,0
83,1811,596,1915,1035,6,11,4,104,439,0,0,0,0
91,1134,254,1266,419,7,11,4,132,165,0,5,0,0
92,1133,249,1266,415,7,11,4,133,166,1,5,0,0
93,1133,249,1265,414,7,11,4,132,165,2,5,0,0
94,1135,258,1263,418,7,11,4,128,160,3,5,0,0
95,1136,260,1263,419,7,11,4,127,159,4,5,0,0
106,1138,253,1264,411,7,11,4,126,158,0,5,0,0
107,1138,253,1264,410,7,11,4,126,157,1,5,0,0
108,1138,254,1265,413,7,11,4,127,159,2,5,0,0
109,1140,253,1265,408,7,11,4,125,155,3,5,0,0
110,1140,252,1266,406,7,11,4,126,154,4,5,0,0
111,1141,252,1266,405,7,11,4,125,153,5,5,0,0
128,1141,259,1261,407,7,11,4,120,148,0,5,0,0
129,1141,260,1260,407,7,11,4,119,147,1,5,0,0
146,1137,255,1265,412,7,11,4,128,157,0,5,0,0
147,1137,254,1265,413,7,11,4,128,159,1,5,0,0
148,1134,254,1262,411,7,11,4,128,157,2,5,0,0
149,1134,253,1262,411,7,11,4,128,158,3,5,0,0
150,1132,246,1268,415,7,11,4,136,169,4,5,0,0
151,1131,245,1268,415,7,11,4,137,170,5,5,0,0
256,1134,262,1264,407,12,11,4,130,145,0,5,0,0
257,1132,262,1264,410,12,11,4,132,148,1,5,0,0
258,1132,264,1264,411,12,11,4,132,147,2,5,0,0
259,1132,265,1264,412,12,11,4,132,147,3,5,0,0
260,1135,264,1264,408,12,11,4,129,144,4,5,0,0
261,1135,264,1264,408,12,11,4,129,144,5,5,0,0
271,1137,256,1267,403,12,11,4,130,147,0,5,0,0
272,1137,255,1267,402,12,11,4,130,147,1,5,0,0
274,1137,254,1271,409,12,11,4,134,155,0,5,0,0
275,1137,254,1272,409,12,11,4,135,155,1,5,0,0
322,1134,258,1267,411,13,11,4,133,153,0,0,0,0
371,1134,263,1267,410,16,11,4,133,147,0,1,0,0
372,1130,261,1265,410,16,11,4,135,149,1,1,0,0
386,1142,253,1264,411,17,11,4,122,158,0,0,0,0
389,1142,254,1264,404,18,11,4,122,150,0,0,0,0
536,1150,257,1266,408,21,11,4,116,151,0,24,0,0
537,1147,257,1265,410,21,11,4,118,153,1,24,0,0
538,1147,257,1264,410,21,11,4,117,153,2,24,0,0
539,1146,261,1262,411,21,11,4,116,150,3,24,0,0
540,1146,258,1264,412,21,11,4,118,154,4,24,0,0
541,1145,258,1264,412,21,11,4,119,154,5,24,0,0
546,1144,266,1260,415,21,11,4,116,149,0,24,0,0
547,1144,267,1260,416,21,11,4,116,149,1,24,0,0
548,1142,260,1264,416,21,11,4,122,156,2,24,0,0
549,1140,257,1264,414,21,11,4,124,157,3,24,0,0
550,1140,261,1263,414,21,11,4,123,153,4,24,0,0
551,1140,261,1262,414,21,11,4,122,153,5,24,0,0
561,1151,273,1257,400,21,11,4,106,127,0,24,0,0
562,1144,273,1258,406,21,11,4,114,133,1,24,0,0
563,1152,271,1263,401,21,11,4,111,130,2,24,0,0
564,1155,269,1265,399,21,11,4,110,130,3,24,0,0
565,1163,269,1268,393,21,11,4,105,124,4,24,0,0
566,1165,269,1268,391,21,11,4,103,122,5,24,0,0
567,1143,263,1267,411,21,11,4,124,148,6,24,0,0
568,1139,266,1264,415,21,11,4,125,149,7,24,0,0
569,1136,265,1263,416,21,11,4,127,151,8,24,0,0
570,1137,266,1263,416,21,11,4,126,150,9,24,0,0
571,1136,266,1263,417,21,11,4,127,151,10,24,0,0
581,1136,256,1271,418,21,11,4,135,162,0,24,0,0
582,1136,255,1270,418,21,11,4,134,163,1,24,0,0
583,1136,255,1270,418,21,11,4,134,163,2,24,0,0
584,1135,255,1270,419,21,11,4,135,164,3,24,0,0
585,1136,255,1270,418,21,11,4,134,163,4,24,0,0
586,1136,254,1270,418,21,11,4,134,164,5,24,0,0
596,1147,258,1272,413,21,11,4,125,155,0,24,0,0
597,1149,258,1272,412,21,11,4,123,154,1,24,0,0
598,1150,262,1270,412,21,11,4,120,150,2,24,0,0
599,1147,265,1267,413,21,11,4,120,148,3,24,0,0
600,1144,266,1267,413,21,11,4,123,147,4,24,0,0
601,1144,266,1266,413,21,11,4,122,147,5,24,0,0
616,1152,263,1269,405,21,11,4,117,142,0,24,0,0
617,1152,263,1268,404,21,11,4,116,141,1,24,0,0
618,1151,262,1268,404,21,11,4,117,142,2,24,0,0
619,1150,263,1267,406,21,11,4,117,143,3,24,0,0
620,1151,262,1270,406,21,11,4,119,144,4,24,0,0
621,1151,262,1270,406,21,11,4,119,144,5,24,0,0
626,1151,262,1271,407,21,11,4,120,145,0,24,0,0
627,1150,262,1272,407,21,11,4,122,145,1,24,0,0
628,1148,264,1271,408,21,11,4,123,144,2,24,0,0
629,1148,266,1270,408,21,11,4,122,142,3,24,0,0
630,1148,266,1271,409,21,11,4,123,143,4,24,0,0
631,1151,260,1274,405,21,11,4,123,145,5,24,0,0
632,1151,256,1276,406,21,11,4,125,150,6,24,0,0
633,1151,253,1277,407,21,11,4,126,154,7,24,0,0
634,1151,253,1276,407,21,11,4,125,154,8,24,0,0
635,1154,254,1275,404,21,11,4,121,150,9,24,0,0
636,1147,261,1266,408,21,11,4,119,147,10,24,0,0
637,1146,261,1265,408,21,11,4,119,147,11,24,0,0
638,1144,263,1263,411,21,11,4,119,148,12,24,0,0
639,1144,263,1263,411,21,11,4,119,148,13,24,0,0
640,1144,263,1262,410,21,11,4,118,147,14,24,0,0
641,1143,263,1262,410,21,11,4,119,147,15,24,0,0
666,1147,253,1271,411,21,11,4,124,158,0,24,0,1
667,1149,253,1271,409,21,11,4,122,156,1,24,0,0
668,1150,253,1271,409,21,11,4,121,156,2,24,0,0
669,1150,252,1271,409,21,11,4,121,157,3,24,0,0
670,1151,252,1272,409,21,11,4,121,157,4,24,0,0
671,1157,259,1269,404,21,11,4,112,145,5,24,0,0
672,1158,261,1269,403,21,11,4,111,142,6,24,0,0
673,1156,262,1268,403,21,11,4,112,141,7,24,0,0
674,1155,261,1268,402,21,11,4,113,141,8,24,0,0
675,1156,260,1270,403,21,11,4,114,143,9,24,0,0
676,1148,260,1269,410,21,11,4,121,150,10,24,0,0
677,1147,263,1268,410,21,11,4,121,147,11,24,0,0
678,1144,261,1269,414,21,11,4,125,153,12,24,0,0
679,1142,261,1270,415,21,11,4,128,154,13,24,0,0
680,1142,261,1270,416,21,11,4,128,155,14,24,0,0
681,1143,263,1271,415,21,11,4,128,152,15,24,0,0
682,1144,263,1272,415,21,11,4,128,152,16,24,0,0
683,1142,264,1270,414,21,11,4,128,150,17,24,0,0
684,1144,264,1272,414,21,11,4,128,150,18,24,0,0
685,1147,264,1271,409,21,11,4,124,145,19,24,0,0
686,1152,261,1271,401,21,11,4,119,140,20,24,0,0
687,1154,258,1273,400,21,11,4,119,142,21,24,0,0
688,1151,255,1272,401,21,11,4,121,146,22,24,0,0
689,1151,254,1272,402,21,11,4,121,148,23,24,0,0
690,1151,254,1272,401,21,11,4,121,147,24,24,1,0
711,1163,257,1275,396,21,11,4,112,139,0,24,0,0
712,1164,258,1273,396,21,11,4,109,138,1,24,0,0
713,1165,257,1273,396,21,11,4,108,139,2,24,0,0
714,1167,257,1273,395,21,11,4,106,138,3,24,0,0
715,1168,258,1272,395,21,11,4,104,137,4,24,0,0
716,1168,258,1272,395,21,11,4,104,137,5,24,0,0
741,1161,262,1267,399,21,11,4,106,137,0,24,0,0
742,1160,261,1268,400,21,11,4,108,139,1,24,0,0
743,1160,261,1268,400,21,11,4,108,139,2,24,0,0
745,1159,260,1268,401,21,11,4,109,141,0,24,0,0
746,1158,260,1268,402,21,11,4,110,142,1,24,0,0
704,1818,680,1920,1080,22,11,4,102,400,0,39,0,1
705,1818,675,1919,1074,22,11,4,101,399,1,39,0,0
706,1818,678,1920,1078,22,11,4,102,400,2,39,0,0
707,1818,681,1919,1079,22,11,4,101,398,3,39,0,0
708,1818,677,1919,1075,22,11,4,101,398,4,39,0,0
709,1818,677,1920,1078,22,11,4,102,401,5,39,0,0
710,1818,678,1919,1079,22,11,4,101,401,6,39,0,0
711,1819,674,1920,1073,22,11,4,101,399,7,39,0,0
712,1819,670,1920,1072,22,11,4,101,402,8,39,0,0
713,1819,672,1920,1077,22,11,4,101,405,9,39,0,0
714,1820,673,1920,1070,22,11,4,100,397,10,39,0,0
715,1819,673,1920,1076,22,11,4,101,403,11,39,0,0
716,1820,679,1920,1078,22,11,4,100,399,12,39,0,0
717,1820,680,1920,1079,22,11,4,100,399,13,39,0,0
718,1821,675,1920,1076,22,11,4,99,401,14,39,0,0
719,1820,679,1920,1078,22,11,4,100,399,15,39,0,0
720,1821,677,1920,1079,22,11,4,99,402,16,39,0,0
721,1821,678,1920,1079,22,11,4,99,401,17,39,0,0
722,1821,678,1920,1080,22,11,4,99,402,18,39,0,0
723,1821,673,1920,1078,22,11,4,99,405,19,39,0,0
724,1822,678,1920,1079,22,11,4,98,401,20,39,0,0
725,1823,681,1920,1079,22,11,4,97,398,21,39,0,0
726,1822,677,1920,1080,22,11,4,98,403,22,39,0,0
727,1821,676,1919,1076,22,11,4,98,400,23,39,0,0
728,1821,680,1918,1078,22,11,4,97,398,24,39,0,0
729,1821,680,1918,1079,22,11,4,97,399,25,39,0,0
730,1821,677,1918,1079,22,11,4,97,402,26,39,0,0
731,1822,688,1918,1080,22,11,4,96,392,27,39,0,0
732,1824,691,1918,1080,22,11,4,94,389,28,39,0,0
733,1822,684,1918,1078,22,11,4,96,394,29,39,0,0
734,1822,687,1917,1074,22,11,4,95,387,30,39,0,0
735,1821,683,1918,1077,22,11,4,97,394,31,39,0,0
736,1819,688,1916,1079,22,11,4,97,391,32,39,0,0
737,1818,695,1915,1079,22,11,4,97,384,33,39,0,0
738,1817,694,1914,1075,22,11,4,97,381,34,39,0,0
739,1819,671,1919,1067,22,11,4,100,396,35,39,0,0
740,1818,618,1920,1067,22,11,4,102,449,36,39,0,0
741,1825,625,1920,1073,22,11,4,95,448,37,39,0,0
742,1826,623,1920,1076,22,11,4,94,453,38,39,0,0
743,1827,618,1920,1076,22,11,4,93,458,39,39,1,0
756,1825,604,1920,1077,22,11,4,95,473,0,39,0,0
757,1825,602,1920,1078,22,11,4,95,476,1,39,0,0
758,1823,654,1918,1079,22,11,4,95,425,2,39,0,0
759,1820,677,1913,1079,22,11,4,93,402,3,39,0,0
760,1821,686,1913,1080,22,11,4,92,394,4,39,0,0
761,1820,680,1914,1079,22,11,4,94,399,5,39,0,0
762,1821,681,1916,1077,22,11,4,95,396,6,39,0,0
763,1821,683,1916,1079,22,11,4,95,396,7,39,0,0
764,1821,682,1917,1079,22,11,4,96,397,8,39,0,0
765,1820,687,1915,1075,22,11,4,95,388,9,39,0,0
766,1820,695,1915,1077,22,11,4,95,382,10,39,0,0
767,1819,685,1917,1079,22,11,4,98,394,11,39,0,0
768,1819,687,1916,1079,22,11,4,97,392,12,39,0,0
776,1152,262,1267,405,23,11,4,115,143,0,7,0,0
777,1152,262,1267,405,23,11,4,115,143,1,7,0,0
778,1151,262,1266,405,23,11,4,115,143,2,7,0,0
779,1151,264,1265,406,23,11,4,114,142,3,7,0,0
780,1149,262,1266,407,23,11,4,117,145,4,7,0,0
781,1148,262,1266,408,23,11,4,118,146,5,7,0,0
786,1144,255,1270,412,23,11,4,126,157,0,7,0,0
787,1146,258,1268,411,23,11,4,122,153,1,7,0,0
788,1144,259,1267,412,23,11,4,123,153,2,7,0,0
789,1144,256,1269,413,23,11,4,125,157,3,7,0,0
790,1147,258,1268,410,23,11,4,121,152,4,7,0,0
791,1146,258,1268,411,23,11,4,122,153,5,7,0,0
804,1149,270,1268,418,23,11,4,119,148,0,7,0,0
805,1149,269,1265,412,23,11,4,116,143,1,7,0,0
806,1149,270,1264,412,23,11,4,115,142,2,7,0,0
834,1159,259,1273,406,23,11,4,114,147,0,7,0,0
835,1161,259,1272,405,23,11,4,111,146,1,7,0,0
836,1151,264,1264,409,23,11,4,113,145,2,7,0,0
837,1147,267,1264,415,23,11,4,117,148,3,7,0,0
838,1145,261,1266,414,23,11,4,121,153,4,7,0,0
839,1144,259,1266,414,23,11,4,122,155,5,7,0,0
840,1144,263,1265,416,23,11,4,121,153,6,7,0,0
841,1143,263,1265,417,23,11,4,122,154,7,7,0,0
849,1157,264,1269,407,23,11,4,112,143,0,7,0,0
850,1158,265,1269,407,23,11,4,111,142,1,7,0,0
866,1159,266,1265,400,23,11,4,106,134,0,7,0,0
867,1162,264,1267,400,23,11,4,105,136,1,7,0,0
868,1161,265,1266,400,23,11,4,105,135,2,7,0,0
869,1161,265,1266,399,23,11,4,105,134,3,7,0,0
870,1161,264,1267,401,23,11,4,106,137,4,7,0,0
871,1162,264,1268,400,23,11,4,106,136,5,7,0,0
881,1155,265,1265,404,23,11,4,110,139,0,7,0,0
882,1154,266,1266,405,23,11,4,112,139,1,7,0,0
883,1154,266,1268,405,23,11,4,114,139,2,7,0,0
884,1154,264,1268,405,23,11,4,114,141,3,7,0,0
885,1157,264,1267,402,23,11,4,110,138,4,7,0,0
886,1157,264,1267,401,23,11,4,110,137,5,7,0,0
782,259,848,357,976,24,11,4,98,128,0,0,0,0
805,1569,135,1604,226,25,11,4,35,91,0,104,0,1
806,1567,136,1603,227,25,11,4,36,91,1,104,0,0
807,1566,137,1603,227,25,11,4,37,90,2,104,0,0
808,1565,137,1604,229,25,11,4,39,92,3,104,0,0
809,1564,138,1603,230,25,11,4,39,92,4,104,0,0
810,1561,138,1601,230,25,11,4,40,92,5,104,0,0
811,1558,138,1599,230,25,11,4,41,92,6,104,0,0
812,1556,139,1596,229,25,11,4,40,90,7,104,0,0
813,1556,137,1597,230,25,11,4,41,93,8,104,0,0
814,1554,139,1595,231,25,11,4,41,92,9,104,0,0
815,1552,139,1593,233,25,11,4,41,94,10,104,0,0
816,1549,141,1590,234,25,11,4,41,93,11,104,0,0
817,1548,141,1590,239,25,11,4,42,98,12,104,0,0
818,1550,140,1594,242,25,11,4,44,102,13,104,0,0
819,1551,140,1596,242,25,11,4,45,102,14,104,0,0
820,1552,141,1597,245,25,11,4,45,104,15,104,0,0
821,1554,143,1598,247,25,11,4,44,104,16,104,0,0
822,1554,144,1599,249,25,11,4,45,105,17,104,0,0
823,1555,143,1600,251,25,11,4,45,108,18,104,0,0
824,1556,140,1602,251,25,11,4,46,111,19,104,0,0
825,1557,140,1603,253,25,11,4,46,113,20,104,0,0
826,1558,140,1605,255,25,11,4,47,115,21,104,0,0
827,1559,140,1606,256,25,11,4,47,116,22,104,0,0
828,1559,140,1607,259,25,11,4,48,119,23,104,0,0
829,1561,142,1608,261,25,11,4,47,119,24,104,0,0
830,1561,142,1608,261,25,11,4,47,119,25,104,0,0
831,1559,143,1608,267,25,11,4,49,124,26,104,0,0
832,1558,143,1608,270,25,11,4,50,127,27,104,0,0
833,1556,142,1606,269,25,11,4,50,127,28,104,0,0
834,1554,142,1606,273,25,11,4,52,131,29,104,0,0
835,1554,142,1606,275,25,11,4,52,133,30,104,0,0
836,1555,142,1607,275,25,11,4,52,133,31,104,0,0
837,1554,145,1606,279,25,11,4,52,134,32,104,0,0
838,1551,146,1604,283,25,11,4,53,137,33,104,0,0
839,1549,147,1602,284,25,11,4,53,137,34,104,0,0
840,1545,145,1600,288,25,11,4,55,143,35,104,0,0
841,1544,146,1598,287,25,11,4,54,141,36,104,0,0
842,1542,145,1597,290,25,11,4,55,145,37,104,0,0
843,1538,145,1595,294,25,11,4,57,149,38,104,0,0
844,1533,149,1588,294,25,11,4,55,145,39,104,0,0
845,1531,152,1583,293,25,11,4,52,141,40,104,0,0
846,1525,153,1580,301,25,11,4,55,148,41,104,0,0
847,1522,156,1577,305,25,11,4,55,149,42,104,0,0
848,1518,155,1573,307,25,11,4,55,152,43,104,0,0
849,1514,158,1569,311,25,11,4,55,153,44,104,0,0
850,1510,157,1566,315,25,11,4,56,158,45,104,0,0
851,1506,154,1564,319,25,11,4,58,165,46,104,0,0
852,1503,160,1560,323,25,11,4,57,163,47,104,0,0
853,1499,153,1559,326,25,11,4,60,173,48,104,0,0
854,1497,152,1557,331,25,11,4,60,179,49,104,0,0
855,1494,155,1554,336,25,11,4,60,181,50,104,0,0
856,1489,157,1549,338,25,11,4,60,181,51,104,0,0
857,1485,160,1546,346,25,11,4,61,186,52,104,0,0
858,1480,170,1539,352,25,11,4,59,182,53,104,0,0
859,1476,173,1535,354,25,11,4,59,181,54,104,0,0
860,1472,173,1532,358,25,11,4,60,185,55,104,0,0
861,1467,177,1528,363,25,11,4,61,186,56,104,0,0
862,1465,178,1526,365,25,11,4,61,187,57,104,0,0
863,1464,184,1525,372,25,11,4,61,188,58,104,0,0
864,1463,183,1527,382,25,11,4,64,199,59,104,0,0
865,1463,179,1530,386,25,11,4,67,207,60,104,0,0
866,1462,183,1530,396,25,11,4,68,213,61,104,0,0
867,1459,184,1528,399,25,11,4,69,215,62,104,0,0
868,1454,182,1525,405,25,11,4,71,223,63,104,0,0
869,1449,183,1524,418,25,11,4,75,235,64,104,0,0
870,1444,183,1521,422,25,11,4,77,239,65,104,0,0
871,1437,184,1516,430,25,11,4,79,246,66,104,0,0
872,1428,190,1508,436,25,11,4,80,246,67,104,0,0
873,1418,188,1499,443,25,11,4,81,255,68,104,0,0
874,1408,193,1492,456,25,11,4,84,263,69,104,0,0
875,1402,192,1489,467,25,11,4,87,275,70,104,0,0
876,1399,192,1489,472,25,11,4,90,280,71,104,0,0
877,1392,201,1485,489,25,11,4,93,288,72,104,0,0
878,1383,201,1479,497,25,11,4,96,296,73,104,0,0
879,1369,200,1470,510,25,11,4,101,310,74,104,0,0
880,1359,210,1463,533,25,11,4,104,323,75,104,0,0
881,1356,216,1461,544,25,11,4,105,328,76,104,0,0
882,1352,217,1460,556,25,11,4,108,339,77,104,0,0
883,1345,225,1454,571,25,11,4,109,346,78,104,0,0
884,1333,226,1444,581,25,11,4,111,355,79,104,0,0
885,1312,231,1429,606,25,11,4,117,375,80,104,0,0
886,1301,238,1422,624,25,11,4,121,386,81,104,0,0
887,1293,238,1417,637,25,11,4,124,399,82,104,0,0
888,1283,243,1413,659,25,11,4,130,416,83,104,0,0
889,1272,260,1402,682,25,11,4,130,422,84,104,0,0
890,1249,262,1383,701,25,11,4,134,439,85,104,0,0
891,1216,263,1364,736,25,11,4,148,473,86,104,0,0
892,1195,269,1353,768,25,11,4,158,499,87,104,0,0
893,1189,275,1349,783,25,11,4,160,508,88,104,0,0
894,1164,292,1334,833,25,11,4,170,541,89,104,0,0
895,1145,301,1319,862,25,11,4,174,561,90,104,0,0
896,1106,316,1282,877,25,11,4,176,561,91,104,0,0
897,1045,335,1241,945,25,11,4,196,610,92,104,0,0
898,1009,356,1210,974,25,11,4,201,618,93,104,0,0
899,991,375,1194,1002,25,11,4,203,627,94,104,0,0
900,957,400,1163,1032,25,11,4,206,632,95,104,0,0
901,907,418,1119,1063,25,11,4,212,645,96,104,0,0
902,815,442,1033,1080,25,11,4,218,638,97,104,0,0
903,715,488,939,1080,25,11,4,224,592,98,104,0,0
904,670,529,889,1080,25,11,4,219,551,99,104,0,0
905,617,571,827,1080,25,11,4,210,509,100,104,0,0
906,528,654,718,1078,25,11,4,190,424,101,104,0,0
907,415,722,591,1075,25,11,4,176,353,102,104,0,0
908,295,800,453,1077,25,11,4,158,277,103,104,0,0
909,234,843,373,1080,25,11,4,139,237,104,104,1,0
906,257,834,361,979,27,11,4,104,145,0,0,0,0
921,1139,260,1271,416,29,11,4,132,156,0,5,0,0
922,1140,260,1272,416,29,11,4,132,156,1,5,0,0
923,1140,260,1272,415,29,11,4,132,155,2,5,0,0
924,1144,263,1271,412,29,11,4,127,149,3,5,0,0
925,1146,267,1272,414,29,11,4,126,147,4,5,0,0
926,1148,268,1272,414,29,11,4,124,146,5,5,0,0
933,1153,259,1271,400,29,11,4,118,141,0,5,0,0
934,1154,258,1270,398,29,11,4,116,140,1,5,0,0
935,1155,256,1270,397,29,11,4,115,141,2,5,0,0
936,1159,258,1271,397,29,11,4,112,139,3,5,0,0
937,1160,258,1272,395,29,11,4,112,137,4,5,0,0
940,1164,262,1272,396,29,11,4,108,134,0,5,0,0
941,1166,262,1273,395,29,11,4,107,133,1,5,0,0
967,1159,259,1268,396,29,11,4,109,137,0,5,0,0
968,1158,257,1267,398,29,11,4,109,141,1,5,0,0
969,1157,257,1267,398,29,11,4,110,141,2,5,0,0
970,1162,258,1268,397,29,11,4,106,139,3,5,0,0
971,1162,258,1268,397,29,11,4,106,139,4,5,0,0
1002,1140,258,1273,410,30,11,4,133,152,0,0,0,0
1021,1137,255,1268,408,32,11,4,131,153,0,15,0,0
1022,1134,252,1269,409,32,11,4,135,157,1,15,0,0
1023,1131,251,1269,413,32,11,4,138,162,2,15,0,0
1024,1130,250,1270,414,32,11,4,140,164,3,15,0,0
1026,1148,257,1272,403,32,11,4,124,146,0,15,0,0
1027,1152,258,1272,401,32,11,4,120,143,1,15,0,0
1028,1155,259,1273,400,32,11,4,118,141,2,15,0,0
1029,1150,254,1275,404,32,11,4,125,150,3,15,0,0
1030,1153,253,1276,402,32,11,4,123,149,4,15,0,0
1031,1145,249,1271,404,32,11,4,126,155,5,15,0,0
1032,1142,250,1270,408,32,11,4,128,158,6,15,0,0
1033,1139,248,1271,412,32,11,4,132,164,7,15,0,0
1034,1141,251,1272,412,32,11,4,131,161,8,15,0,0
1035,1142,251,1272,412,32,11,4,130,161,9,15,0,0
1036,1152,262,1267,404,32,11,4,115,142,10,15,0,0
1037,1149,263,1269,410,32,11,4,120,147,11,15,0,0
1038,1157,268,1268,403,32,11,4,111,135,12,15,0,0
1039,1154,269,1264,402,32,11,4,110,133,13,15,0,0
1040,1155,269,1264,402,32,11,4,109,133,14,15,0,0
1041,1156,270,1263,401,32,11,4,107,131,15,15,0,0
1046,1145,259,1271,412,32,11,4,126,153,0,15,0,0
1047,1151,258,1272,407,32,11,4,121,149,1,15,0,0
1048,1148,255,1271,407,32,11,4,123,152,2,15,0,0
1049,1155,257,1271,402,32,11,4,116,145,3,15,0,0
1050,1154,260,1268,401,32,11,4,114,141,4,15,0,0
1051,1155,260,1268,400,32,11,4,113,140,5,15,0,0
1069,1142,262,1264,410,32,11,4,122,148,0,15,0,0
1070,1156,262,1269,403,32,11,4,113,141,1,15,0,0
1071,1156,262,1270,402,32,11,4,114,140,2,15,0,0
1097,1151,264,1272,410,32,11,4,121,146,0,15,0,0
1098,1151,264,1272,411,32,11,4,121,147,1,15,0,0
1100,1150,264,1273,411,32,11,4,123,147,0,15,0,0
1101,1150,265,1273,412,32,11,4,123,147,1,15,0,0
1108,1148,265,1273,414,32,11,4,125,149,0,15,0,0
1109,1147,264,1274,415,32,11,4,127,151,1,15,0,0
1110,1146,264,1274,416,32,11,4,128,152,2,15,0,0
1131,1144,266,1268,411,32,11,4,124,145,0,15,0,0
1132,1142,268,1270,413,32,11,4,128,145,1,15,0,0
1133,1142,266,1271,413,32,11,4,129,147,2,15,0,0
1134,1141,265,1271,414,32,11,4,130,149,3,15,0,0
1135,1141,267,1272,416,32,11,4,131,149,4,15,0,0
1136,1138,267,1269,416,32,11,4,131,149,5,15,0,0
1137,1138,268,1269,416,32,11,4,131,148,6,15,0,0
1161,1139,266,1267,411,32,11,4,128,145,0,15,0,0
1162,1138,265,1266,408,32,11,4,128,143,1,15,0,0
1163,1137,265,1266,411,32,11,4,129,146,2,15,0,0
1164,1135,264,1265,412,32,11,4,130,148,3,15,0,0
1165,1134,264,1265,412,32,11,4,131,148,4,15,0,0
1166,1147,266,1267,405,32,11,4,120,139,5,15,0,0
1167,1148,267,1265,405,32,11,4,117,138,6,15,0,0
1168,1149,267,1266,404,32,11,4,117,137,7,15,0,0
1171,1141,259,1270,411,32,11,4,129,152,0,15,0,0
1172,1140,257,1270,413,32,11,4,130,156,1,15,0,0
1173,1140,256,1269,413,32,11,4,129,157,2,15,0,0
1174,1141,256,1269,413,32,11,4,128,157,3,15,0,0
1175,1141,256,1269,413,32,11,4,128,157,4,15,0,0
1176,1140,255,1269,414,32,11,4,129,159,5,15,0,0
1181,1139,267,1262,416,32,11,4,123,149,0,15,0,0
1182,1141,265,1263,413,32,11,4,122,148,1,15,0,0
1183,1142,266,1265,415,32,11,4,123,149,2,15,0,0
1184,1141,267,1266,416,32,11,4,125,149,3,15,0,0
1185,1139,267,1266,417,32,11,4,127,150,4,15,0,0
1186,1139,267,1266,418,32,11,4,127,151,5,15,0,0
1196,1138,266,1266,418,32,11,4,128,152,0,15,0,0
1197,1144,265,1266,411,32,11,4,122,146,1,15,0,0
1198,1141,267,1264,415,32,11,4,123,148,2,15,0,0
1199,1141,268,1264,415,32,11,4,123,147,3,15,0,0
1200,1138,268,1263,418,32,11,4,125,150,4,15,0,0
1201,1137,268,1262,418,32,11,4,125,150,5,15,0,0
1221,1148,268,1271,414,32,11,4,123,146,0,15,0,0
1222,1155,268,1269,404,32,11,4,114,136,1,15,0,0
1223,1151,269,1271,409,32,11,4,120,140,2,15,0,0
1224,1149,269,1271,412,32,11,4,122,143,3,15,0,0
1225,1153,270,1269,404,32,11,4,116,134,4,15,0,0
1226,1154,270,1269,404,32,11,4,115,134,5,15,0,0
1251,1142,268,1265,413,32,11,4,123,145,0,15,0,0
1252,1142,267,1266,414,32,11,4,124,147,1,15,0,0
1253,1142,267,1265,414,32,11,4,123,147,2,15,0,0
1254,1143,266,1266,414,32,11,4,123,148,3,15,0,0
1255,1143,266,1265,414,32,11,4,122,148,4,15,0,0
1256,1142,266,1265,414,32,11,4,123,148,5,15,0,0
1266,1150,266,1267,406,32,11,4,117,140,0,15,0,0
1267,1150,266,1267,405,32,11,4,117,139,1,15,0,0
1268,1150,266,1267,405,32,11,4,117,139,2,15,0,0
1269,1148,265,1268,408,32,11,4,120,143,3,15,0,0
1270,1151,265,1269,405,32,11,4,118,140,4,15,0,0
1271,1152,266,1270,407,32,11,4,118,141,5,15,0,0
1272,1152,268,1268,406,32,11,4,116,138,6,15,0,0
1273,1149,266,1267,407,32,11,4,118,141,7,15,0,0
1274,1148,266,1267,407,32,11,4,119,141,8,15,0,0
1275,1147,266,1267,408,32,11,4,120,142,9,15,0,0
1276,1147,266,1267,408,32,11,4,120,142,10,15,0,0
1034,1825,551,1920,1063,33,11,4,95,512,0,17,0,0
1035,1820,549,1915,1062,33,11,4,95,513,1,17,0,0
1036,1819,567,1910,1057,33,11,4,91,490,2,17,0,0
1037,1810,582,1902,1065,33,11,4,92,483,3,17,0,0
1038,1807,597,1899,1075,33,11,4,92,478,4,17,0,0
1039,1807,606,1900,1077,33,11,4,93,471,5,17,0,0
1040,1805,617,1898,1076,33,11,4,93,459,6,17,0,0
1041,1805,620,1899,1076,33,11,4,94,456,7,17,0,0
1042,1804,622,1901,1076,33,11,4,97,454,8,17,0,0
1043,1807,619,1904,1071,33,11,4,97,452,9,17,0,0
1044,1808,617,1907,1069,33,11,4,99,452,10,17,0,0
1045,1809,618,1909,1061,33,11,4,100,443,11,17,0,0
1046,1809,594,1913,1058,33,11,4,104,464,12,17,0,0
1047,1806,573,1916,1064,33,11,4,110,491,13,17,0,0
1048,1797,556,1914,1074,33,11,4,117,518,14,17,0,0
1049,1803,610,1910,1074,33,11,4,107,464,15,17,0,0
1050,1815,639,1916,1075,33,11,4,101,436,16,17,0,0
1051,1816,644,1916,1076,33,11,4,100,432,17,17,0,0
1036,1612,128,1647,202,34,11,4,35,74,0,0,0,0
1082,1575,151,1611,275,35,11,4,36,124,0,59,0,1
1083,1574,149,1611,278,35,11,4,37,129,1,59,0,0
1084,1573,148,1611,279,35,11,4,38,131,2,59,0,0
1085,1573,153,1610,283,35,11,4,37,130,3,59,0,0
1086,1570,154,1609,285,35,11,4,39,131,4,59,0,0
1087,1566,154,1606,290,35,11,4,40,136,5,59,0,0
1088,1565,156,1606,293,35,11,4,41,137,6,59,0,0
1089,1566,153,1609,295,35,11,4,43,142,7,59,0,0
1090,1565,159,1608,300,35,11,4,43,141,8,59,0,0
1091,1562,159,1605,300,35,11,4,43,141,9,59,0,0
1092,1558,156,1604,304,35,11,4,46,148,10,59,0,0
1093,1557,160,1604,309,35,11,4,47,149,11,59,0,0
1094,1557,162,1604,310,35,11,4,47,148,12,59,0,0
1095,1555,168,1603,317,35,11,4,48,149,13,59,0,0
1096,1552,171,1601,320,35,11,4,49,149,14,59,0,0
1097,1549,175,1598,327,35,11,4,49,152,15,59,0,0
1098,1548,177,1597,329,35,11,4,49,152,16,59,0,0
1099,1549,177,1599,333,35,11,4,50,156,17,59,0,0
1100,1547,181,1599,339,35,11,4,52,158,18,59,0,0
1101,1543,179,1597,345,35,11,4,54,166,19,59,0,0
1102,1537,179,1594,354,35,11,4,57,175,20,59,0,0
1103,1535,181,1593,360,35,11,4,58,179,21,59,0,0
1104,1534,176,1596,364,35,11,4,62,188,22,59,0,0
1105,1532,183,1593,369,35,11,4,61,186,23,59,0,0
1106,1529,187,1590,373,35,11,4,61,186,24,59,0,0
1107,1527,191,1589,380,35,11,4,62,189,25,59,0,0
1108,1527,194,1590,385,35,11,4,63,191,26,59,0,0
1109,1529,195,1593,387,35,11,4,64,192,27,59,0,0
1110,1528,202,1593,400,35,11,4,65,198,28,59,0,0
1111,1526,206,1593,408,35,11,4,67,202,29,59,0,0
1112,1524,204,1595,418,35,11,4,71,214,30,59,0,0
1113,1523,205,1597,429,35,11,4,74,224,31,59,0,0
1114,1524,204,1601,440,35,11,4,77,236,32,59,0,0
1115,1524,210,1603,452,35,11,4,79,242,33,59,0,0
1116,1522,210,1604,458,35,11,4,82,248,34,59,0,0
1117,1523,216,1606,467,35,11,4,83,251,35,59,0,0
1118,1522,224,1608,484,35,11,4,86,260,36,59,0,0
1119,1519,225,1607,488,35,11,4,88,263,37,59,0,0
1120,1513,231,1606,507,35,11,4,93,276,38,59,0,0
1121,1504,232,1601,519,35,11,4,97,287,39,59,0,0
1122,1496,238,1599,540,35,11,4,103,302,40,59,0,0
1123,1490,246,1598,561,35,11,4,108,315,41,59,0,0
1124,1482,246,1599,583,35,11,4,117,337,42,59,0,0
1125,1474,261,1592,601,35,11,4,118,340,43,59,0,0
1126,1457,266,1581,619,35,11,4,124,353,44,59,0,0
1127,1449,280,1582,660,35,11,4,133,380,45,59,0,0
1128,1444,287,1583,682,35,11,4,139,395,46,59,0,0
1129,1440,294,1586,709,35,11,4,146,415,47,59,0,0
1130,1432,304,1587,743,35,11,4,155,439,48,59,0,0
1131,1426,309,1589,771,35,11,4,163,462,49,59,0,0
1132,1427,329,1601,824,35,11,4,174,495,50,59,0,0
1133,1436,340,1617,853,35,11,4,181,513,51,59,0,0
1134,1440,359,1637,910,35,11,4,197,551,52,59,0,0
1135,1440,384,1645,956,35,11,4,205,572,53,59,0,0
1136,1438,398,1659,1011,35,11,4,221,613,54,59,0,0
1137,1453,434,1682,1055,35,11,4,229,621,55,59,0,0
1138,1498,457,1732,1077,35,11,4,234,620,56,59,0,0
1139,1558,493,1795,1080,35,11,4,237,587,57,59,0,0
1140,1652,542,1870,1080,35,11,4,218,538,58,59,0,0
1141,1667,559,1888,1080,35,11,4,221,521,59,59,1,0
1141,1836,745,1919,1062,36,11,4,83,317,0,0,0,0
1297,56,198,167,418,38,11,4,111,220,0,0,0,0
1316,1150,263,1268,410,39,11,4,118,147,0,4,0,0
1317,1146,268,1263,414,39,11,4,117,146,1,4,0,0
1318,1149,264,1267,411,39,11,4,118,147,2,4,0,0
1319,1150,263,1268,410,39,11,4,118,147,3,4,0,0
1320,1151,262,1269,409,39,11,4,118,147,4,4,0,0
1322,1146,257,1271,412,39,11,4,125,155,0,4,0,0
1323,1147,261,1266,408,39,11,4,119,147,1,4,0,0
1324,1147,263,1264,406,39,11,4,117,143,2,4,0,0
1325,1149,261,1267,405,39,11,4,118,144,3,4,0,0
1326,1150,261,1267,405,39,11,4,117,144,4,4,0,0
1339,1149,265,1267,410,39,11,4,118,145,0,4,0,0
1340,1149,266,1267,410,39,11,4,118,144,1,4,0,0
1379,1164,259,1267,405,40,11,4,103,146,0,1,0,0
1380,1163,259,1265,405,40,11,4,102,146,1,1,0,0
1411,1148,260,1266,412,41,11,4,118,152,0,5,0,0
1412,1148,260,1266,412,41,11,4,118,152,1,5,0,0
1413,1148,264,1262,410,41,11,4,114,146,2,5,0,0
1414,1148,265,1261,409,41,11,4,113,144,3,5,0,0
1415,1150,269,1261,409,41,11,4,111,140,4,5,0,0
1416,1151,271,1259,409,41,11,4,108,138,5,5,0,0
1431,1147,265,1264,410,41,11,4,117,145,0,5,0,0
1432,1147,265,1264,411,41,11,4,117,146,1,5,0,0
1433,1146,265,1265,411,41,11,4,119,146,2,5,0,0
1434,1146,265,1265,411,41,11,4,119,146,3,5,0,0
1435,1145,265,1266,412,41,11,4,121,147,4,5,0,0
1436,1145,265,1266,412,41,11,4,121,147,5,5,0,0
1510,1636,745,1917,1072,42,11,4,281,327,0,1,0,0
1511,1708,803,1920,1075,42,11,4,212,272,1,1,0,0
1541,1152,255,1268,404,43,11,4,116,149,0,10,0,0
1542,1152,255,1268,404,43,11,4,116,149,1,10,0,0
1543,1152,255,1268,404,43,11,4,116,149,2,10,0,0
1544,1151,255,1267,404,43,11,4,116,149,3,10,0,0
1545,1152,255,1267,403,43,11,4,115,148,4,10,0,0
1546,1152,255,1267,403,43,11,4,115,148,5,10,0,0
1551,1146,258,1265,409,43,11,4,119,151,0,10,0,0
1552,1148,266,1265,413,43,11,4,117,147,1,10,0,0
1553,1150,266,1264,408,43,11,4,114,142,2,10,0,0
1554,1146,261,1266,410,43,11,4,120,149,3,10,0,0
1555,1147,267,1266,412,43,11,4,119,145,4,10,0,0
1556,1145,260,1269,412,43,11,4,124,152,5,10,0,0
1557,1146,254,1273,411,43,11,4,127,157,6,10,0,0
1558,1146,253,1272,409,43,11,4,126,156,7,10,0,0
1559,1146,251,1273,409,43,11,4,127,158,8,10,0,0
1560,1146,250,1273,409,43,11,4,127,159,9,10,0,0
1561,1146,250,1273,410,43,11,4,127,160,10,10,0,0
1593,1720,864,1918,1075,44,11,4,198,211,0,0,0,0
1616,1149,267,1264,409,45,11,4,115,142,0,5,0,0
1617,1149,267,1263,409,45,11,4,114,142,1,5,0,0
1618,1149,264,1268,411,45,11,4,119,147,2,5,0,0
1619,1150,266,1265,409,45,11,4,115,143,3,5,0,0
1620,1149,266,1264,408,45,11,4,115,142,4,5,0,0
1621,1150,266,1264,408,45,11,4,114,142,5,5,0,0
1671,1166,263,1265,401,46,11,4,99,138,0,5,0,0
1672,1165,262,1266,401,46,11,4,101,139,1,5,0,0
1673,1166,261,1266,401,46,11,4,100,140,2,5,0,0
1674,1165,261,1266,402,46,11,4,101,141,3,5,0,0
1675,1165,261,1265,402,46,11,4,100,141,4,5,0,0
1676,1165,261,1265,402,46,11,4,100,141,5,5,0,0
1713,59,194,168,328,47,11,4,109,134,0,0,0,0
1856,1617,137,1654,247,53,11,4,37,110,0,66,0,0
1857,1618,139,1655,247,53,11,4,37,108,1,66,0,0
1858,1617,138,1655,250,53,11,4,38,112,2,66,0,0
1859,1617,138,1655,251,53,11,4,38,113,3,66,0,0
1874,1611,144,1659,287,53,11,4,48,143,0,66,0,1
1875,1611,141,1660,291,53,11,4,49,150,1,66,0,0
1876,1609,147,1657,291,53,11,4,48,144,2,66,0,0
1877,1609,151,1651,281,53,11,4,42,130,3,66,0,0
1878,1609,150,1654,289,53,11,4,45,139,4,66,0,0
1879,1607,151,1653,294,53,11,4,46,143,5,66,0,0
1880,1605,152,1653,301,53,11,4,48,149,6,66,0,0
1881,1604,155,1652,305,53,11,4,48,150,7,66,0,0
1882,1602,156,1651,306,53,11,4,49,150,8,66,0,0
1883,1603,155,1653,311,53,11,4,50,156,9,66,0,0
1884,1603,156,1654,312,53,11,4,51,156,10,66,0,0
1885,1605,157,1656,316,53,11,4,51,159,11,66,0,0
1886,1605,159,1658,325,53,11,4,53,166,12,66,0,0
1887,1605,161,1659,329,53,11,4,54,168,13,66,0,0
1888,1604,161,1659,334,53,11,4,55,173,14,66,0,0
1889,1604,161,1660,337,53,11,4,56,176,15,66,0,0
1890,1604,162,1660,340,53,11,4,56,178,16,66,0,0
1891,1603,172,1657,344,53,11,4,54,172,17,66,0,0
1892,1600,174,1655,349,53,11,4,55,175,18,66,0,0
1893,1598,172,1656,353,53,11,4,58,181,19,66,0,0
1894,1596,173,1655,360,53,11,4,59,187,20,66,0,0
1895,1594,174,1653,360,53,11,4,59,186,21,66,0,0
1896,1592,174,1655,367,53,11,4,63,193,22,66,0,0
1897,1590,180,1653,373,53,11,4,63,193,23,66,0,0
1898,1587,178,1652,376,53,11,4,65,198,24,66,0,0
1899,1585,176,1654,387,53,11,4,69,211,25,66,0,0
1900,1585,179,1654,390,53,11,4,69,211,26,66,0,0
1901,1581,187,1649,397,53,11,4,68,210,27,66,0,0
1902,1579,196,1645,405,53,11,4,66,209,28,66,0,0
1903,1575,197,1642,411,53,11,4,67,214,29,66,0,0
1904,1572,198,1641,420,53,11,4,69,222,30,66,0,0
1905,1569,201,1639,424,53,11,4,70,223,31,66,0,0
1906,1570,204,1640,430,53,11,4,70,226,32,66,0,0
1907,1567,208,1639,441,53,11,4,72,233,33,66,0,0
1908,1564,210,1639,451,53,11,4,75,241,34,66,0,0
1909,1559,211,1637,461,53,11,4,78,250,35,66,0,0
1910,1555,212,1635,468,53,11,4,80,256,36,66,0,0
1911,1552,218,1634,480,53,11,4,82,262,37,66,0,0
1912,1547,220,1635,494,53,11,4,88,274,38,66,0,0
1913,1544,224,1634,506,53,11,4,90,282,39,66,0,0
1914,1536,223,1630,515,53,11,4,94,292,40,66,0,0
1915,1527,225,1626,534,53,11,4,99,309,41,66,0,0
1916,1522,232,1625,555,53,11,4,103,323,42,66,0,0
1917,1519,237,1624,561,53,11,4,105,324,43,66,0,0
1918,1511,242,1620,577,53,11,4,109,335,44,66,0,0
1919,1502,246,1617,594,53,11,4,115,348,45,66,0,0
1920,1493,253,1612,613,53,11,4,119,360,46,66,0,0
1921,1484,263,1611,644,53,11,4,127,381,47,66,0,0
1922,1475,271,1605,657,53,11,4,130,386,48,66,0,0
1923,1470,279,1604,672,53,11,4,134,393,49,66,0,0
1924,1457,294,1599,702,53,11,4,142,408,50,66,0,0
1925,1442,298,1591,724,53,11,4,149,426,51,66,0,0
1926,1427,309,1587,766,53,11,4,160,457,52,66,0,0
1927,1426,322,1593,800,53,11,4,167,478,53,66,0,0
1928,1424,334,1598,827,53,11,4,174,493,54,66,0,0
1929,1411,353,1598,885,53,11,4,187,532,55,66,0,0
1930,1388,369,1587,932,53,11,4,199,563,56,66,0,0
1931,1365,382,1578,990,53,11,4,213,608,57,66,0,0
1932,1349,409,1571,1044,53,11,4,222,635,58,66,0,0
1933,1340,431,1565,1067,53,11,4,225,636,59,66,0,0
1934,1319,459,1544,1080,53,11,4,225,621,60,66,0,0
1935,1284,499,1504,1080,53,11,4,220,581,61,66,0,0
1936,1238,548,1454,1080,53,11,4,216,532,62,66,0,0
1937,1188,627,1391,1080,53,11,4,203,453,63,66,0,0
1938,1133,713,1319,1080,53,11,4,186,367,64,66,0,0
1939,1028,815,1197,1080,53,11,4,169,265,65,66,0,0
1940,997,860,1147,1080,53,11,4,150,220,66,66,1,0
1872,1614,153,1649,278,54,11,4,35,125,0,1,0,0
1873,1614,150,1651,282,54,11,4,37,132,1,1,0,0
1901,1144,263,1273,412,55,11,4,129,149,0,0,0,0
1906,1141,260,1272,402,56,11,4,131,142,0,30,0,1
1907,1139,260,1271,403,56,11,4,132,143,1,30,0,0
1908,1141,261,1271,402,56,11,4,130,141,2,30,0,0
1909,1142,261,1271,402,56,11,4,129,141,3,30,0,0
1910,1146,262,1273,399,56,11,4,127,137,4,30,0,0
1911,1143,258,1279,406,56,11,4,136,148,5,30,0,0
1912,1142,258,1278,407,56,11,4,136,149,6,30,0,0
1913,1142,259,1277,408,56,11,4,135,149,7,30,0,0
1914,1139,258,1277,411,56,11,4,138,153,8,30,0,0
1915,1142,258,1277,409,56,11,4,135,151,9,30,0,0
1916,1142,258,1278,410,56,11,4,136,152,10,30,0,0
1917,1149,259,1283,408,56,11,4,134,149,11,30,0,0
1918,1150,259,1285,409,56,11,4,135,150,12,30,0,0
1919,1151,258,1291,413,56,11,4,140,155,13,30,0,0
1920,1150,258,1292,415,56,11,4,142,157,14,30,0,0
1921,1144,258,1282,412,56,11,4,138,154,15,30,0,0
1922,1142,258,1278,411,56,11,4,136,153,16,30,0,0
1923,1145,258,1279,409,56,11,4,134,151,17,30,0,0
1924,1140,257,1277,411,56,11,4,137,154,18,30,0,0
1925,1138,257,1277,412,56,11,4,139,155,19,30,0,0
1926,1139,260,1276,414,56,11,4,137,154,20,30,0,0
1927,1141,266,1272,412,56,11,4,131,146,21,30,0,0
1928,1142,263,1271,408,56,11,4,129,145,22,30,0,0
1929,1142,263,1270,408,56,11,4,128,145,23,30,0,0
1930,1145,263,1272,407,56,11,4,127,144,24,30,0,0
1931,1148,262,1273,404,56,11,4,125,142,25,30,0,0
1932,1146,262,1274,408,56,11,4,128,146,26,30,0,0
1933,1151,265,1271,404,56,11,4,120,139,27,30,0,0
1934,1151,264,1272,404,56,11,4,121,140,28,30,0,0
1935,1152,264,1270,403,56,11,4,118,139,29,30,0,0
1936,1152,265,1270,402,56,11,4,118,137,30,30,1,0
1961,1151,261,1273,405,56,11,4,122,144,0,30,0,0
1962,1148,264,1269,406,56,11,4,121,142,1,30,0,0
1963,1148,262,1272,407,56,11,4,124,145,2,30,0,0
1964,1149,260,1272,407,56,11,4,123,147,3,30,0,0
1965,1148,263,1269,406,56,11,4,121,143,4,30,0,0
1966,1148,263,1269,406,56,11,4,121,143,5,30,0,0
1983,59,189,171,367,57,11,4,112,178,0,0,0,0
1988,56,191,175,374,58,11,4,119,183,0,3,0,0
1989,52,191,180,388,58,11,4,128,197,1,3,0,0
1990,54,192,177,381,58,11,4,123,189,2,3,0,0
1991,54,192,176,380,58,11,4,122,188,3,3,0,0
2046,1149,266,1271,405,60,11,4,122,139,0,5,0,0
2047,1149,265,1271,405,60,11,4,122,140,1,5,0,0
2048,1149,265,1270,404,60,11,4,121,139,2,5,0,0
2049,1148,265,1271,404,60,11,4,123,139,3,5,0,0
2050,1148,264,1271,404,60,11,4,123,140,4,5,0,0
2051,1148,263,1271,404,60,11,4,123,141,5,5,0,0
2066,1150,266,1273,410,60,11,4,123,144,0,5,0,0
2067,1150,267,1273,411,60,11,4,123,144,1,5,0,0
2068,1155,266,1274,407,60,11,4,119,141,2,5,0,0
2069,1156,266,1273,408,60,11,4,117,142,3,5,0,0
2070,1156,265,1273,408,60,11,4,117,143,4,5,0,0
2071,1157,265,1273,408,60,11,4,116,143,5,5,0,0
2066,988,442,1604,1069,62,11,4,616,627,0,1,0,0
2067,1017,400,1674,1069,62,11,4,657,669,1,1,0,0
2066,1257,424,1855,1049,63,11,4,598,625,0,1,0,0
2067,1271,382,1907,1047,63,11,4,636,665,1,1,0,0
2067,1219,417,1420,990,64,11,4,201,573,0,54,0,1
2068,1239,392,1437,956,64,11,4,198,564,1,54,0,0
2069,1262,377,1455,929,64,11,4,193,552,2,54,0,0
2070,1295,361,1470,864,64,11,4,175,503,3,54,0,0
2071,1308,345,1483,844,64,11,4,175,499,4,54,0,0
2072,1323,330,1482,784,64,11,4,159,454,5,54,0,0
2073,1336,315,1489,751,64,11,4,153,436,6,54,0,0
2074,1354,307,1498,722,64,11,4,144,415,7,54,0,0
2075,1373,292,1508,682,64,11,4,135,390,8,54,0,0
2076,1391,282,1524,668,64,11,4,133,386,9,54,0,0
2077,1397,271,1521,630,64,11,4,124,359,10,54,0,0
2078,1404,258,1524,607,64,11,4,120,349,11,54,0,0
2079,1415,253,1531,594,64,11,4,116,341,12,54,0,0
2080,1426,241,1540,575,64,11,4,114,334,13,54,0,0
2081,1434,236,1547,568,64,11,4,113,332,14,54,0,0
2082,1447,232,1551,540,64,11,4,104,308,15,54,0,0
2083,1457,232,1556,526,64,11,4,99,294,16,54,0,0
2084,1466,225,1562,515,64,11,4,96,290,17,54,0,0
2085,1474,222,1566,500,64,11,4,92,278,18,54,0,0
2086,1479,219,1570,494,64,11,4,91,275,19,54,0,0
2087,1481,214,1567,477,64,11,4,86,263,20,54,0,0
2088,1488,210,1572,469,64,11,4,84,259,21,54,0,0
2089,1495,209,1574,455,64,11,4,79,246,22,54,0,0
2090,1499,203,1576,447,64,11,4,77,244,23,54,0,0
2091,1501,202,1575,436,64,11,4,74,234,24,54,0,0
2092,1502,199,1573,425,64,11,4,71,226,25,54,0,0
2093,1503,201,1571,420,64,11,4,68,219,26,54,0,0
2094,1505,200,1570,410,64,11,4,65,210,27,54,0,0
2095,1510,201,1573,403,64,11,4,63,202,28,54,0,0
2096,1514,201,1574,392,64,11,4,60,191,29,54,0,0
2097,1516,193,1576,387,64,11,4,60,194,30,54,0,0
2098,1520,196,1578,383,64,11,4,58,187,31,54,0,0
2099,1526,194,1581,372,64,11,4,55,178,32,54,0,0
2100,1528,191,1583,369,64,11,4,55,178,33,54,0,0
2101,1531,187,1585,363,64,11,4,54,176,34,54,0,0
2102,1532,182,1586,358,64,11,4,54,176,35,54,0,0
2103,1535,184,1587,354,64,11,4,52,170,36,54,0,0
2104,1537,183,1588,346,64,11,4,51,163,37,54,0,0
2105,1539,182,1589,344,64,11,4,50,162,38,54,0,0
2106,1541,180,1589,333,64,11,4,48,153,39,54,0,0
2107,1543,178,1590,328,64,11,4,47,150,40,54,0,0
2108,1545,179,1590,326,64,11,4,45,147,41,54,0,0
2109,1547,177,1592,322,64,11,4,45,145,42,54,0,0
2110,1550,177,1593,318,64,11,4,43,141,43,54,0,0
2111,1552,173,1594,308,64,11,4,42,135,44,54,0,0
2112,1554,175,1596,307,64,11,4,42,132,45,54,0,0
2113,1557,176,1597,306,64,11,4,40,130,46,54,0,0
2114,1560,173,1600,301,64,11,4,40,128,47,54,0,0
2115,1562,174,1601,299,64,11,4,39,125,48,54,0,0
2116,1562,172,1601,295,64,11,4,39,123,49,54,0,0
2117,1562,171,1600,294,64,11,4,38,123,50,54,0,0
2118,1562,173,1599,292,64,11,4,37,119,51,54,0,0
2119,1563,165,1602,291,64,11,4,39,126,52,54,0,0
2120,1564,167,1600,284,64,11,4,36,117,53,54,0,0
2121,1564,165,1600,280,64,11,4,36,115,54,54,1,0
2067,1448,409,1646,1027,65,11,4,198,618,0,54,0,1
2068,1452,397,1642,990,65,11,4,190,593,1,54,0,0
2069,1465,368,1642,920,65,11,4,177,552,2,54,0,0
2070,1470,358,1637,880,65,11,4,167,522,3,54,0,0
2071,1483,347,1634,819,65,11,4,151,472,4,54,0,0
2072,1486,328,1633,789,65,11,4,147,461,5,54,0,0
2073,1492,325,1632,766,65,11,4,140,441,6,54,0,0
2074,1498,297,1634,726,65,11,4,136,429,7,54,0,0
2075,1505,291,1635,700,65,11,4,130,409,8,54,0,0
2076,1515,283,1638,670,65,11,4,123,387,9,54,0,0
2077,1522,277,1640,651,65,11,4,118,374,10,54,0,0
2078,1527,274,1640,635,65,11,4,113,361,11,54,0,0
2079,1533,259,1639,600,65,11,4,106,341,12,54,0,0
2080,1536,251,1640,586,65,11,4,104,335,13,54,0,0
2081,1541,248,1640,566,65,11,4,99,318,14,54,0,0
2082,1542,243,1638,549,65,11,4,96,306,15,54,0,0
2083,1545,244,1637,536,65,11,4,92,292,16,54,0,0
2084,1547,237,1634,518,65,11,4,87,281,17,54,0,0
2085,1550,229,1635,511,65,11,4,85,282,18,54,0,0
2086,1553,228,1634,495,65,11,4,81,267,19,54,0,0
2087,1553,224,1631,480,65,11,4,78,256,20,54,0,0
2088,1556,220,1633,475,65,11,4,77,255,21,54,0,0
2089,1560,216,1634,461,65,11,4,74,245,22,54,0,0
2090,1563,215,1635,451,65,11,4,72,236,23,54,0,0
2091,1570,215,1639,442,65,11,4,69,227,24,54,0,0
2092,1576,207,1644,431,65,11,4,68,224,25,54,0,0
2093,1580,208,1645,427,65,11,4,65,219,26,54,0,0
2094,1581,202,1645,415,65,11,4,64,213,27,54,0,0
2095,1582,201,1645,410,65,11,4,63,209,28,54,0,0
2096,1586,200,1645,399,65,11,4,59,199,29,54,0,0
2097,1589,196,1647,390,65,11,4,58,194,30,54,0,0
2098,1590,197,1645,386,65,11,4,55,189,31,54,0,0
2099,1589,193,1642,375,65,11,4,53,182,32,54,0,0
2100,1589,192,1640,371,65,11,4,51,179,33,54,0,0
2101,1589,187,1640,364,65,11,4,51,177,34,54,0,0
2102,1591,182,1642,359,65,11,4,51,177,35,54,0,0
2103,1593,183,1644,357,65,11,4,51,174,36,54,0,0
2104,1594,178,1644,350,65,11,4,50,172,37,54,0,0
2105,1596,179,1645,344,65,11,4,49,165,38,54,0,0
2106,1599,177,1646,339,65,11,4,47,162,39,54,0,0
2107,1601,175,1647,334,65,11,4,46,159,40,54,0,0
2108,1602,177,1647,331,65,11,4,45,154,41,54,0,0
2109,1604,172,1648,326,65,11,4,44,154,42,54,0,0
2110,1604,169,1649,324,65,11,4,45,155,43,54,0,0
2111,1605,168,1649,320,65,11,4,44,152,44,54,0,0
2112,1605,166,1648,314,65,11,4,43,148,45,54,0,0
2113,1605,163,1648,310,65,11,4,43,147,46,54,0,0
2114,1604,159,1646,305,65,11,4,42,146,47,54,0,0
2115,1605,160,1646,302,65,11,4,41,142,48,54,0,0
2116,1607,166,1646,300,65,11,4,39,134,49,54,0,0
2117,1608,167,1646,298,65,11,4,38,131,50,54,0,0
2118,1608,169,1646,295,65,11,4,38,126,51,54,0,0
2119,1610,167,1646,290,65,11,4,36,123,52,54,0,0
2120,1612,168,1647,287,65,11,4,35,119,53,54,0,0
2121,1613,161,1649,286,65,11,4,36,125,54,54,1,0
2141,1140,269,1271,414,66,11,4,131,145,0,5,0,0
2142,1139,269,1270,414,66,11,4,131,145,1,5,0,0
2143,1139,269,1270,414,66,11,4,131,145,2,5,0,0
2144,1140,265,1271,410,66,11,4,131,145,3,5,0,0
2145,1140,267,1271,412,66,11,4,131,145,4,5,0,0
2146,1141,267,1272,412,66,11,4,131,145,5,5,0,0
2191,1151,260,1268,409,68,11,4,117,149,0,5,0,0
2192,1151,264,1261,403,68,11,4,110,139,1,5,0,0
2193,1153,265,1261,402,68,11,4,108,137,2,5,0,0
2194,1153,263,1263,402,68,11,4,110,139,3,5,0,0
2195,1153,262,1264,403,68,11,4,111,141,4,5,0,0
2196,1153,262,1265,403,68,11,4,112,141,5,5,0,0
2197,58,192,166,329,70,11,4,108,137,0,4,0,0
2198,63,189,171,327,70,11,4,108,138,1,4,0,0
2199,64,188,174,329,70,11,4,110,141,2,4,0,0
2200,64,188,173,326,70,11,4,109,138,3,4,0,0
2201,65,188,174,326,70,11,4,109,138,4,4,0,0
2236,1142,261,1271,412,71,11,4,129,151,0,4,0,0
2237,1142,261,1271,412,71,11,4,129,151,1,4,0,0
2238,1148,261,1272,408,71,11,4,124,147,2,4,0,0
2239,1148,259,1273,406,71,11,4,125,147,3,4,0,0
2240,1150,259,1274,404,71,11,4,124,145,4,4,0,0
2248,1147,254,1272,402,71,11,4,125,148,0,4,0,0
2249,1149,256,1273,404,71,11,4,124,148,1,4,0,0
2250,1149,256,1273,405,71,11,4,124,149,2,4,0,0
2251,1150,256,1274,405,71,11,4,124,149,3,4,0,0
2291,1163,259,1268,405,72,11,4,105,146,0,5,0,0
2292,1165,262,1265,401,72,11,4,100,139,1,5,0,0
2293,1164,261,1266,403,72,11,4,102,142,2,5,0,0
2294,1165,261,1267,403,72,11,4,102,142,3,5,0,0
2295,1162,258,1266,402,72,11,4,104,144,4,5,0,0
2296,1162,258,1266,402,72,11,4,104,144,5,5,0,0
2346,1145,267,1268,411,73,11,4,123,144,0,5,0,0
2347,1143,267,1266,411,73,11,4,123,144,1,5,0,0
2348,1144,264,1266,407,73,11,4,122,143,2,5,0,0
2349,1144,263,1265,405,73,11,4,121,142,3,5,0,0
2350,1145,267,1267,410,73,11,4,122,143,4,5,0,0
2351,1145,267,1267,410,73,11,4,122,143,5,5,0,0
2539,1628,158,1665,257,75,11,4,37,99,0,0,0,0
2541,1630,158,1666,262,76,11,4,36,104,0,86,0,1
2542,1629,158,1665,262,76,11,4,36,104,1,86,0,0
2543,1629,159,1665,262,76,11,4,36,103,2,86,0,0
2544,1628,159,1664,264,76,11,4,36,105,3,86,0,0
2545,1628,161,1664,265,76,11,4,36,104,4,86,0,0
2546,1626,160,1663,266,76,11,4,37,106,5,86,0,0
2547,1624,160,1663,269,76,11,4,39,109,6,86,0,0
2548,1623,162,1662,271,76,11,4,39,109,7,86,0,0
2549,1622,162,1661,273,76,11,4,39,111,8,86,0,0
2550,1621,160,1661,275,76,11,4,40,115,9,86,0,0
2551,1621,163,1663,281,76,11,4,42,118,10,86,0,0
2552,1621,163,1663,281,76,11,4,42,118,11,86,0,0
2553,1620,164,1663,285,76,11,4,43,121,12,86,0,0
2554,1617,163,1661,286,76,11,4,44,123,13,86,0,0
2555,1614,161,1659,288,76,11,4,45,127,14,86,0,0
2556,1612,162,1659,294,76,11,4,47,132,15,86,0,0
2557,1611,162,1658,294,76,11,4,47,132,16,86,0,0
2558,1609,162,1657,297,76,11,4,48,135,17,86,0,0
2559,1607,163,1655,299,76,11,4,48,136,18,86,0,0
2560,1606,163,1654,300,76,11,4,48,137,19,86,0,0
2561,1604,164,1652,301,76,11,4,48,137,20,86,0,0
2562,1603,166,1652,303,76,11,4,49,137,21,86,0,0
2563,1604,168,1653,306,76,11,4,49,138,22,86,0,0
2564,1603,170,1653,313,76,11,4,50,143,23,86,0,0
2565,1602,173,1652,314,76,11,4,50,141,24,86,0,0
2566,1599,172,1651,318,76,11,4,52,146,25,86,0,0
2567,1599,175,1651,322,76,11,4,52,147,26,86,0,0
2568,1598,173,1652,327,76,11,4,54,154,27,86,0,0
2569,1598,175,1653,330,76,11,4,55,155,28,86,0,0
2570,1596,177,1651,335,76,11,4,55,158,29,86,0,0
2571,1593,178,1649,336,76,11,4,56,158,30,86,0,0
2572,1592,179,1649,341,76,11,4,57,162,31,86,0,0
2573,1593,180,1650,344,76,11,4,57,164,32,86,0,0
2574,1595,180,1653,348,76,11,4,58,168,33,86,0,0
2575,1595,183,1655,357,76,11,4,60,174,34,86,0,0
2576,1596,187,1654,356,76,11,4,58,169,35,86,0,0
2577,1596,188,1656,361,76,11,4,60,173,36,86,0,0
2578,1598,191,1658,365,76,11,4,60,174,37,86,0,0
2579,1602,192,1662,367,76,11,4,60,175,38,86,0,0
2580,1603,195,1665,377,76,11,4,62,182,39,86,0,0
2581,1604,197,1667,381,76,11,4,63,184,40,86,0,0
2582,1603,197,1667,384,76,11,4,64,187,41,86,0,0
2583,1603,199,1668,393,76,11,4,65,194,42,86,0,0
2584,1604,203,1669,400,76,11,4,65,197,43,86,0,0
2585,1605,205,1671,404,76,11,4,66,199,44,86,0,0
2586,1603,206,1673,416,76,11,4,70,210,45,86,0,0
2587,1601,207,1671,421,76,11,4,70,214,46,86,0,0
2588,1599,209,1670,426,76,11,4,71,217,47,86,0,0
2589,1597,216,1668,435,76,11,4,71,219,48,86,0,0
2590,1598,216,1670,440,76,11,4,72,224,49,86,0,0
2591,1598,222,1671,449,76,11,4,73,227,50,86,0,0
2592,1594,225,1669,457,76,11,4,75,232,51,86,0,0
2593,1588,223,1666,465,76,11,4,78,242,52,86,0,0
2594,1584,229,1663,473,76,11,4,79,244,53,86,0,0
2595,1584,235,1662,480,76,11,4,78,245,54,86,0,0
2596,1583,236,1665,491,76,11,4,82,255,55,86,0,0
2597,1578,243,1664,509,76,11,4,86,266,56,86,0,0
2598,1571,246,1659,521,76,11,4,88,275,57,86,0,0
2599,1564,251,1655,534,76,11,4,91,283,58,86,0,0
2600,1560,257,1654,550,76,11,4,94,293,59,86,0,0
2601,1559,259,1656,558,76,11,4,97,299,60,86,0,0
2602,1558,264,1660,578,76,11,4,102,314,61,86,0,0
2603,1551,266,1659,594,76,11,4,108,328,62,86,0,0
2604,1546,269,1656,605,76,11,4,110,336,63,86,0,0
2605,1539,281,1656,635,76,11,4,117,354,64,86,0,0
2606,1539,287,1659,649,76,11,4,120,362,65,86,0,0
2607,1536,295,1660,666,76,11,4,124,371,66,86,0,0
2608,1531,306,1659,684,76,11,4,128,378,67,86,0,0
2609,1522,310,1656,701,76,11,4,134,391,68,86,0,0
2610,1508,324,1651,741,76,11,4,143,417,69,86,0,0
2611,1503,335,1651,771,76,11,4,148,436,70,86,0,0
2612,1501,343,1654,786,76,11,4,153,443,71,86,0,0
2613,1497,358,1659,822,76,11,4,162,464,72,86,0,0
2614,1489,368,1657,849,76,11,4,168,481,73,86,0,0
2615,1477,377,1655,884,76,11,4,178,507,74,86,0,0
2616,1465,398,1659,956,76,11,4,194,558,75,86,0,0
2617,1462,410,1660,980,76,11,4,198,570,76,86,0,0
2618,1455,431,1663,1021,76,11,4,208,590,77,86,0,0
2619,1446,458,1660,1054,76,11,4,214,596,78,86,0,0
2620,1426,485,1642,1073,76,11,4,216,588,79,86,0,0
2621,1408,528,1618,1080,76,11,4,210,552,80,86,0,0
2622,1400,577,1602,1080,76,11,4,202,503,81,86,0,0
2623,1386,621,1584,1077,76,11,4,198,456,82,86,0,0
2624,1358,685,1549,1080,76,11,4,191,395,83,86,0,0
2625,1297,746,1480,1077,76,11,4,183,331,84,86,0,0
2626,1234,830,1393,1071,76,11,4,159,241,85,86,0,0
2627,1208,971,1296,1080,76,11,4,88,109,86,86,1,0
2561,1143,267,1272,411,77,11,4,129,144,0,4,0,0
2562,1143,267,1272,411,77,11,4,129,144,1,4,0,0
2563,1147,267,1273,408,77,11,4,126,141,2,4,0,0
2564,1149,269,1270,405,77,11,4,121,136,3,4,0,0
2565,1150,270,1270,403,77,11,4,120,133,4,4,0,0
2696,1149,263,1268,410,78,11,4,119,147,0,1,0,0
2697,1151,264,1265,405,78,11,4,114,141,1,1,0,0
2699,1144,266,1269,406,79,11,4,125,140,0,1,0,0
2700,1143,264,1270,406,79,11,4,127,142,1,1,0,0
2726,1169,270,1268,396,82,11,4,99,126,0,5,0,0
2727,1167,269,1267,396,82,11,4,100,127,1,5,0,0
2728,1165,268,1266,397,82,11,4,101,129,2,5,0,0
2729,1164,268,1265,397,82,11,4,101,129,3,5,0,0
2756,1151,263,1269,409,82,11,4,118,146,0,5,0,0
2757,1151,262,1275,414,82,11,4,124,152,1,5,0,0
2758,1151,261,1276,415,82,11,4,125,154,2,5,0,0
2761,1145,262,1265,406,82,11,4,120,144,0,5,0,0
2762,1145,263,1264,404,82,11,4,119,141,1,5,0,0
2763,1143,263,1266,408,82,11,4,123,145,2,5,0,0
2764,1142,262,1268,409,82,11,4,126,147,3,5,0,0
2765,1140,262,1267,410,82,11,4,127,148,4,5,0,0
2766,1140,261,1267,410,82,11,4,127,149,5,5,0,0
2771,1141,263,1268,412,82,11,4,127,149,0,5,0,0
2772,1144,262,1270,409,82,11,4,126,147,1,5,0,0
2773,1146,260,1272,407,82,11,4,126,147,2,5,0,0
2774,1146,259,1272,407,82,11,4,126,148,3,5,0,0
2775,1143,260,1268,405,82,11,4,125,145,4,5,0,0
2776,1143,260,1268,405,82,11,4,125,145,5,5,0,0
2817,1148,267,1271,409,83,11,4,123,142,0,3,0,0
2818,1146,273,1269,414,83,11,4,123,141,1,3,0,0
2819,1144,269,1269,413,83,11,4,125,144,2,3,0,0
2820,1143,268,1269,413,83,11,4,126,145,3,3,0,0
2967,1135,263,1274,417,84,11,4,139,154,0,1,0,0
2968,1133,262,1275,418,84,11,4,142,156,1,1,0,0
2970,1134,264,1274,418,85,11,4,140,154,0,0,0,0
3086,1163,267,1266,405,86,11,4,103,138,0,1,0,0
3087,1162,267,1265,405,86,11,4,103,138,1,1,0,0
3251,63,190,173,339,87,11,4,110,149,0,1,0,0
3252,65,190,171,334,87,11,4,106,144,1,1,0,0
3255,65,194,169,334,88,11,4,104,140,0,0,0,0
3285,1159,266,1271,403,89,11,4,112,137,0,0,0,0
3334,1154,248,1274,404,90,11,4,120,156,0,1,0,0
3335,1153,252,1269,404,90,11,4,116,152,1,1,0,0
3406,1145,265,1270,406,91,11,4,125,141,0,4,0,0
3407,1143,267,1268,408,91,11,4,125,141,1,4,0,0
3408,1149,268,1270,404,91,11,4,121,136,2,4,0,0
3409,1149,268,1267,400,91,11,4,118,132,3,4,0,0
3410,1151,268,1267,398,91,11,4,116,130,4,4,0,0
3450,1146,265,1285,409,92,11,4,139,144,0,0,0,0
3655,1148,260,1273,413,93,11,4,125,153,0,0,0,0
3738,1150,266,1271,401,94,11,4,121,135,0,0,0,0
3809,1133,264,1271,419,95,11,4,138,155,0,0,0,0
3816,1134,256,1273,414,96,11,4,139,158,0,5,0,0
3817,1136,254,1271,407,96,11,4,135,153,1,5,0,0
3818,1136,254,1275,412,96,11,4,139,158,2,5,0,0
3819,1137,252,1277,411,96,11,4,140,159,3,5,0,0
3820,1137,253,1277,412,96,11,4,140,159,4,5,0,0
3821,1137,253,1278,413,96,11,4,141,160,5,5,0,0
3855,1144,262,1268,407,99,11,4,124,145,0,0,0,0
3937,1136,253,1277,417,100,11,4,141,164,0,5,0,0
3938,1135,254,1276,418,100,11,4,141,164,1,5,0,0
3939,1135,254,1276,419,100,11,4,141,165,2,5,0,0
3940,1138,255,1276,417,100,11,4,138,162,3,5,0,0
3941,1138,256,1277,417,100,11,4,139,161,4,5,0,0
3946,1145,254,1278,410,100,11,4,133,156,0,5,0,0
3947,1145,256,1279,414,100,11,4,134,158,1,5,0,0
3948,1147,259,1279,414,100,11,4,132,155,2,5,0,0
3949,1146,256,1277,411,100,11,4,131,155,3,5,0,0
3950,1144,254,1276,410,100,11,4,132,156,4,5,0,0
3951,1144,254,1276,410,100,11,4,132,156,5,5,0,0
3966,1145,256,1274,409,100,11,4,129,153,0,5,0,0
3967,1145,255,1274,410,100,11,4,129,155,1,5,0,0
3968,1141,258,1273,413,100,11,4,132,155,2,5,0,0
3969,1140,260,1272,413,100,11,4,132,153,3,5,0,0
3970,1142,259,1274,413,100,11,4,132,154,4,5,0,0
3971,1142,259,1274,413,100,11,4,132,154,5,5,0,0
3974,1134,264,1264,416,100,11,4,130,152,0,5,0,0
3975,1134,267,1266,419,100,11,4,132,152,1,5,0,0
3976,1134,268,1265,420,100,11,4,131,152,2,5,0,0
3982,1139,259,1275,418,100,11,4,136,159,0,5,0,0
3983,1139,259,1275,418,100,11,4,136,159,1,5,0,0
3984,1141,252,1277,415,100,11,4,136,163,2,5,0,0
3985,1143,258,1274,416,100,11,4,131,158,3,5,0,0
3986,1143,258,1275,416,100,11,4,132,158,4,5,0,0
3996,1134,250,1272,417,100,11,4,138,167,0,5,0,0
3997,1136,251,1272,417,100,11,4,136,166,1,5,0,0
3998,1137,253,1274,418,100,11,4,137,165,2,5,0,0
3999,1137,252,1274,416,100,11,4,137,164,3,5,0,0
4000,1136,252,1274,416,100,11,4,138,164,4,5,0,0
4001,1136,252,1274,416,100,11,4,138,164,5,5,0,0
4036,1158,256,1269,401,101,11,4,111,145,0,11,0,0
4037,1156,254,1271,404,101,11,4,115,150,1,11,0,0
4038,1160,259,1267,398,101,11,4,107,139,2,11,0,0
4039,1156,257,1265,400,101,11,4,109,143,3,11,0,0
4040,1157,256,1266,400,101,11,4,109,144,4,11,0,0
4041,1156,256,1266,400,101,11,4,110,144,5,11,0,0
4046,1146,256,1262,405,101,11,4,116,149,0,11,0,0
4047,1143,253,1265,408,101,11,4,122,155,1,11,0,0
4048,1142,252,1266,409,101,11,4,124,157,2,11,0,0
4049,1144,253,1268,409,101,11,4,124,156,3,11,0,0
4050,1142,253,1268,409,101,11,4,126,156,4,11,0,0
4051,1143,258,1267,411,101,11,4,124,153,5,11,0,0
4052,1143,262,1264,412,101,11,4,121,150,6,11,0,0
4053,1143,264,1263,412,101,11,4,120,148,7,11,0,0
4054,1142,265,1263,412,101,11,4,121,147,8,11,0,0
4055,1144,263,1266,412,101,11,4,122,149,9,11,0,0
4056,1142,265,1266,414,101,11,4,124,149,10,11,0,0
4057,1142,266,1266,415,101,11,4,124,149,11,11,0,0
4059,1142,267,1266,415,101,11,4,124,148,0,11,0,0
4060,1141,267,1266,415,101,11,4,125,148,1,11,0,0
4061,1140,267,1266,416,101,11,4,126,149,2,11,0,0
4120,1421,540,1920,1073,102,11,4,499,533,0,3,0,0
4121,1432,520,1920,1077,102,11,4,488,557,1,3,0,0
4122,1448,510,1920,1077,102,11,4,472,567,2,3,0,0
4123,1440,472,1920,1078,102,11,4,480,606,3,3,0,0
4119,1138,267,1273,415,103,11,4,135,148,0,0,0,0
4123,1669,540,1919,1073,104,11,4,250,533,0,100,0,1
4124,1673,568,1911,1075,104,11,4,238,507,1,100,0,0
4125,1677,591,1905,1076,104,11,4,228,485,2,100,0,0
4126,1678,620,1894,1076,104,11,4,216,456,3,100,0,0
4127,1677,618,1895,1073,104,11,4,218,455,4,100,0,0
4128,1677,617,1897,1072,104,11,4,220,455,5,100,0,0
4129,1677,617,1899,1071,104,11,4,222,454,6,100,0,0
4130,1677,614,1902,1071,104,11,4,225,457,7,100,0,0
4131,1677,615,1904,1071,104,11,4,227,456,8,100,0,0
4132,1677,611,1907,1071,104,11,4,230,460,9,100,0,0
4133,1676,613,1908,1072,104,11,4,232,459,10,100,0,0
4134,1676,612,1909,1072,104,11,4,233,460,11,100,0,0
4135,1674,610,1910,1072,104,11,4,236,462,12,100,0,0
4136,1677,619,1909,1069,104,11,4,232,450,13,100,0,0
4137,1673,613,1908,1066,104,11,4,235,453,14,100,0,0
4138,1676,620,1909,1068,104,11,4,233,448,15,100,0,0
4139,1672,614,1910,1066,104,11,4,238,452,16,100,0,0
4140,1675,619,1912,1068,104,11,4,237,449,17,100,0,0
4141,1671,615,1913,1070,104,11,4,242,455,18,100,0,0
4142,1669,614,1913,1072,104,11,4,244,458,19,100,0,0
4143,1669,614,1914,1073,104,11,4,245,459,20,100,0,0
4144,1669,614,1914,1073,104,11,4,245,459,21,100,0,0
4145,1668,615,1915,1074,104,11,4,247,459,22,100,0,0
4146,1672,621,1914,1070,104,11,4,242,449,23,100,0,0
4147,1670,620,1914,1071,104,11,4,244,451,24,100,0,0
4148,1669,617,1915,1071,104,11,4,246,454,25,100,0,0
4149,1668,618,1915,1071,104,11,4,247,453,26,100,0,0
4150,1668,617,1915,1071,104,11,4,247,454,27,100,0,0
4151,1667,615,1915,1071,104,11,4,248,456,28,100,0,0
4152,1666,614,1915,1070,104,11,4,249,456,29,100,0,0
4153,1666,614,1915,1070,104,11,4,249,456,30,100,0,0
4154,1666,616,1915,1071,104,11,4,249,455,31,100,0,0
4155,1666,612,1917,1071,104,11,4,251,459,32,100,0,0
4156,1662,601,1919,1071,104,11,4,257,470,33,100,0,0
4157,1658,590,1920,1071,104,11,4,262,481,34,100,0,0
4158,1638,579,1908,1069,104,11,4,270,490,35,100,0,0
4159,1596,545,1889,1070,104,11,4,293,525,36,100,0,0
4160,1548,523,1851,1069,104,11,4,303,546,37,100,0,0
4161,1499,496,1813,1070,104,11,4,314,574,38,100,0,0
4162,1455,474,1776,1071,104,11,4,321,597,39,100,0,0
4163,1420,455,1742,1068,104,11,4,322,613,40,100,0,0
4164,1406,420,1710,1014,104,11,4,304,594,41,100,0,0
4165,1395,393,1694,992,104,11,4,299,599,42,100,0,0
4166,1397,375,1676,950,104,11,4,279,575,43,100,0,0
4167,1422,349,1669,869,104,11,4,247,520,44,100,0,0
4168,1437,336,1667,828,104,11,4,230,492,45,100,0,0
4169,1459,313,1665,763,104,11,4,206,450,46,100,0,0
4170,1471,301,1665,735,104,11,4,194,434,47,100,0,0
4171,1482,287,1666,712,104,11,4,184,425,48,100,0,0
4172,1493,272,1658,663,104,11,4,165,391,49,100,0,0
4173,1505,263,1661,641,104,11,4,156,378,50,100,0,0
4174,1523,255,1665,605,104,11,4,142,350,51,100,0,0
4175,1533,246,1669,588,104,11,4,136,342,52,100,0,0
4176,1540,245,1669,578,104,11,4,129,333,53,100,0,0
4177,1552,236,1671,544,104,11,4,119,308,54,100,0,0
4178,1561,235,1673,528,104,11,4,112,293,55,100,0,0
4179,1573,229,1676,506,104,11,4,103,277,56,100,0,0
4180,1574,227,1674,495,104,11,4,100,268,57,100,0,0
4181,1573,224,1671,484,104,11,4,98,260,58,100,0,0
4182,1580,212,1675,467,104,11,4,95,255,59,100,0,0
4183,1586,211,1675,454,104,11,4,89,243,60,100,0,0
4184,1591,205,1676,440,104,11,4,85,235,61,100,0,0
4185,1592,199,1674,429,104,11,4,82,230,62,100,0,0
4186,1590,197,1669,419,104,11,4,79,222,63,100,0,0
4187,1591,191,1668,407,104,11,4,77,216,64,100,0,0
4188,1594,192,1667,400,104,11,4,73,208,65,100,0,0
4189,1598,194,1666,390,104,11,4,68,196,66,100,0,0
4190,1597,189,1664,383,104,11,4,67,194,67,100,0,0
4191,1593,187,1659,377,104,11,4,66,190,68,100,0,0
4192,1593,176,1659,368,104,11,4,66,192,69,100,0,0
4193,1593,177,1656,361,104,11,4,63,184,70,100,0,0
4194,1595,175,1657,356,104,11,4,62,181,71,100,0,0
4195,1597,173,1657,352,104,11,4,60,179,72,100,0,0
4196,1597,172,1657,347,104,11,4,60,175,73,100,0,0
4197,1599,170,1657,341,104,11,4,58,171,74,100,0,0
4198,1603,172,1657,334,104,11,4,54,162,75,100,0,0
4199,1603,170,1656,328,104,11,4,53,158,76,100,0,0
4200,1603,168,1656,324,104,11,4,53,156,77,100,0,0
4201,1603,167,1655,320,104,11,4,52,153,78,100,0,0
4202,1603,162,1654,314,104,11,4,51,152,79,100,0,0
4203,1604,161,1653,309,104,11,4,49,148,80,100,0,0
4204,1604,158,1653,302,104,11,4,49,144,81,100,0,0
4205,1604,160,1651,298,104,11,4,47,138,82,100,0,0
4206,1602,156,1650,298,104,11,4,48,142,83,100,0,0
4207,1600,152,1649,293,104,11,4,49,141,84,100,0,0
4208,1599,155,1645,291,104,11,4,46,136,85,100,0,0
4209,1599,151,1644,284,104,11,4,45,133,86,100,0,0
4210,1599,149,1644,281,104,11,4,45,132,87,100,0,0
4211,1599,148,1643,278,104,11,4,44,130,88,100,0,0
4212,1599,143,1644,276,104,11,4,45,133,89,100,0,0
4213,1602,146,1644,273,104,11,4,42,127,90,100,0,0
4214,1605,141,1647,267,104,11,4,42,126,91,100,0,0
4215,1606,141,1647,266,104,11,4,41,125,92,100,0,0
4216,1609,140,1650,266,104,11,4,41,126,93,100,0,0
4217,1611,140,1652,264,104,11,4,41,124,94,100,0,0
4218,1613,141,1653,262,104,11,4,40,121,95,100,0,0
4219,1615,141,1654,260,104,11,4,39,119,96,100,0,0
4220,1616,139,1655,259,104,11,4,39,120,97,100,0,0
4221,1619,141,1656,256,104,11,4,37,115,98,100,0,0
4222,1620,141,1656,253,104,11,4,36,112,99,100,0,0
4223,1621,140,1656,251,104,11,4,35,111,100,100,1,0
4245,843,758,1127,1069,107,11,4,284,311,0,9,0,0
4246,917,691,1265,1073,107,11,4,348,382,1,9,0,0
4247,977,633,1369,1067,107,11,4,392,434,2,9,0,0
4248,1024,587,1453,1067,107,11,4,429,480,3,9,0,0
4249,1047,519,1530,1071,107,11,4,483,552,4,9,0,0
4250,1083,482,1581,1069,107,11,4,498,587,5,9,0,0
4251,1135,451,1609,1029,107,11,4,474,578,6,9,0,0
4252,1187,413,1640,986,107,11,4,453,573,7,9,0,0
4253,1220,395,1656,966,107,11,4,436,571,8,9,0,0
4254,1255,358,1711,955,107,11,4,456,597,9,9,0,0
4254,1356,356,1518,847,108,11,4,162,491,0,45,0,1
4255,1372,352,1531,835,108,11,4,159,483,1,45,0,0
4256,1399,334,1544,773,108,11,4,145,439,2,45,0,0
4257,1415,310,1558,742,108,11,4,143,432,3,45,0,0
4258,1427,307,1564,724,108,11,4,137,417,4,45,0,0
4259,1437,290,1566,681,108,11,4,129,391,5,45,0,0
4260,1449,283,1570,651,108,11,4,121,368,6,45,0,0
4261,1462,276,1578,626,108,11,4,116,350,7,45,0,0
4262,1474,269,1583,598,108,11,4,109,329,8,45,0,0
4263,1478,267,1585,590,108,11,4,107,323,9,45,0,0
4264,1483,256,1583,561,108,11,4,100,305,10,45,0,0
4265,1490,246,1588,547,108,11,4,98,301,11,45,0,0
4266,1499,243,1593,530,108,11,4,94,287,12,45,0,0
4267,1510,239,1599,511,108,11,4,89,272,13,45,0,0
4268,1516,239,1601,499,108,11,4,85,260,14,45,0,0
4269,1521,236,1600,481,108,11,4,79,245,15,45,0,0
4270,1526,224,1604,466,108,11,4,78,242,16,45,0,0
4271,1531,222,1608,458,108,11,4,77,236,17,45,0,0
4272,1540,216,1615,448,108,11,4,75,232,18,45,0,0
4273,1547,218,1619,443,108,11,4,72,225,19,45,0,0
4274,1551,215,1619,428,108,11,4,68,213,20,45,0,0
4275,1552,208,1619,419,108,11,4,67,211,21,45,0,0
4276,1555,205,1621,414,108,11,4,66,209,22,45,0,0
4277,1561,204,1624,402,108,11,4,63,198,23,45,0,0
4278,1564,200,1625,396,108,11,4,61,196,24,45,0,0
4279,1566,203,1623,385,108,11,4,57,182,25,45,0,0
4280,1566,196,1622,377,108,11,4,56,181,26,45,0,0
4281,1568,195,1623,372,108,11,4,55,177,27,45,0,0
4282,1571,192,1624,364,108,11,4,53,172,28,45,0,0
4283,1573,188,1626,360,108,11,4,53,172,29,45,0,0
4284,1575,189,1627,358,108,11,4,52,169,30,45,0,0
4285,1574,184,1624,348,108,11,4,50,164,31,45,0,0
4286,1575,180,1624,342,108,11,4,49,162,32,45,0,0
4287,1576,178,1625,337,108,11,4,49,159,33,45,0,0
4288,1577,174,1626,335,108,11,4,49,161,34,45,0,0
4289,1579,175,1626,332,108,11,4,47,157,35,45,0,0
4290,1579,175,1623,324,108,11,4,44,149,36,45,0,0
4291,1580,174,1623,319,108,11,4,43,145,37,45,0,0
4292,1581,175,1624,316,108,11,4,43,141,38,45,0,0
4293,1584,171,1625,309,108,11,4,41,138,39,45,0,0
4294,1587,173,1626,307,108,11,4,39,134,40,45,0,0
4295,1590,169,1628,298,108,11,4,38,129,41,45,0,0
4296,1591,165,1631,299,108,11,4,40,134,42,45,0,0
4297,1592,167,1631,295,108,11,4,39,128,43,45,0,0
4298,1595,163,1632,291,108,11,4,37,128,44,45,0,0
4299,1596,164,1632,284,108,11,4,36,120,45,45,1,0
4301,1598,163,1633,280,108,11,4,35,117,0,45,0,0
4302,1599,162,1634,280,108,11,4,35,118,1,45,0,0
4303,1601,159,1636,275,108,11,4,35,116,2,45,0,0
4309,1610,143,1646,261,108,11,4,36,118,0,45,0,0
4311,1614,142,1649,256,108,11,4,35,114,0,45,0,0
4318,1624,131,1659,249,108,11,4,35,118,0,45,0,0
4320,1623,131,1658,245,108,11,4,35,114,0,45,0,0
4328,1621,125,1656,235,108,11,4,35,110,0,45,0,0
4329,1621,123,1656,233,108,11,4,35,110,1,45,0,0
4322,1149,263,1271,407,109,11,4,122,144,0,0,0,0
4327,1156,263,1269,404,110,11,4,113,141,0,0,0,0
4466,1147,257,1270,413,113,11,4,123,156,0,1,0,0
4467,1154,259,1269,406,113,11,4,115,147,1,1,0,0
4469,1143,256,1270,414,114,11,4,127,158,0,1,0,0
4470,1143,256,1270,413,114,11,4,127,157,1,1,0,0
4500,1136,258,1276,417,115,11,4,140,159,0,10,0,0
4501,1137,261,1271,413,115,11,4,134,152,1,10,0,0
4502,1137,262,1270,413,115,11,4,133,151,2,10,0,0
4503,1137,263,1270,413,115,11,4,133,150,3,10,0,0
4504,1136,263,1270,414,115,11,4,134,151,4,10,0,0
4505,1137,263,1271,414,115,11,4,134,151,5,10,0,0
4506,1137,263,1270,414,115,11,4,133,151,6,10,0,0
4511,1142,266,1268,409,115,11,4,126,143,0,10,0,0
4512,1141,267,1268,409,115,11,4,127,142,1,10,0,0
4513,1141,267,1267,409,115,11,4,126,142,2,10,0,0
4514,1141,266,1268,409,115,11,4,127,143,3,10,0,0
4515,1141,266,1267,408,115,11,4,126,142,4,10,0,0
4516,1146,267,1269,406,115,11,4,123,139,5,10,0,0
4517,1149,268,1269,403,115,11,4,120,135,6,10,0,0
4518,1150,268,1269,402,115,11,4,119,134,7,10,0,0
4519,1153,268,1270,401,115,11,4,117,133,8,10,0,0
4520,1154,267,1271,400,115,11,4,117,133,9,10,0,0
4521,1156,267,1271,399,115,11,4,115,132,10,10,0,0
4556,1141,262,1270,398,116,11,4,129,136,0,5,0,0
4557,1142,261,1271,397,116,11,4,129,136,1,5,0,0
4558,1141,260,1272,398,116,11,4,131,138,2,5,0,0
4559,1144,263,1270,396,116,11,4,126,133,3,5,0,0
4560,1143,265,1268,396,116,11,4,125,131,4,5,0,0
4561,1144,266,1267,396,116,11,4,123,130,5,5,0,0
4663,1553,686,1920,1068,118,11,4,367,382,0,1,0,0
4664,1549,656,1920,1066,118,11,4,371,410,1,1,0,0
4696,1150,262,1273,413,119,11,4,123,151,0,0,0,0
4699,1150,262,1273,412,120,11,4,123,150,0,0,0,0
4716,1154,256,1268,410,121,11,4,114,154,0,1,0,0
4717,1153,256,1266,410,121,11,4,113,154,1,1,0,0
4719,1150,255,1268,413,122,11,4,118,158,0,1,0,0
4720,1149,255,1267,413,122,11,4,118,158,1,1,0,0
4781,1147,261,1269,411,123,11,4,122,150,0,5,0,0
4782,1148,261,1268,410,123,11,4,120,149,1,5,0,0
4783,1147,266,1267,413,123,11,4,120,147,2,5,0,0
4784,1147,262,1269,412,123,11,4,122,150,3,5,0,0
4785,1145,263,1265,410,123,11,4,120,147,4,5,0,0
4786,1144,263,1264,410,123,11,4,120,147,5,5,0,0
4954,1834,554,1920,1060,124,11,4,86,506,0,0,0,0
4961,1728,629,1907,1070,125,11,4,179,441,0,0,0,0
4966,1830,554,1920,1066,126,11,4,90,512,0,19,0,1
4967,1822,540,1916,1074,126,11,4,94,534,1,19,0,0
4968,1801,547,1897,1079,126,11,4,96,532,2,19,0,0
4969,1760,562,1858,1079,126,11,4,98,517,3,19,0,0
4970,1762,559,1864,1078,126,11,4,102,519,4,19,0,0
4971,1727,551,1839,1074,126,11,4,112,523,5,19,0,0
4972,1679,551,1801,1071,126,11,4,122,520,6,19,0,0
4973,1641,567,1772,1069,126,11,4,131,502,7,19,0,0
4974,1614,586,1753,1068,126,11,4,139,482,8,19,0,0
4975,1586,605,1734,1069,126,11,4,148,464,9,19,0,0
4976,1564,626,1723,1070,126,11,4,159,444,10,19,0,0
4977,1548,651,1714,1070,126,11,4,166,419,11,19,0,0
4978,1528,675,1700,1072,126,11,4,172,397,12,19,0,0
4979,1486,694,1664,1070,126,11,4,178,376,13,19,0,0
4980,1429,708,1616,1071,126,11,4,187,363,14,19,0,0
4981,1362,732,1555,1068,126,11,4,193,336,15,19,0,0
4982,1312,760,1511,1071,126,11,4,199,311,16,19,0,0
4983,1286,795,1483,1068,126,11,4,197,273,17,19,0,0
4984,1313,867,1477,1072,126,11,4,164,205,18,19,0,0
4985,1282,934,1414,1078,126,11,4,132,144,19,19,0,0
5001,1800,819,1920,1043,127,11,4,120,224,0,0,0,0
5002,1736,548,1917,1080,128,11,4,181,532,0,74,0,1
5003,1684,516,1873,1070,128,11,4,189,554,1,74,0,0
5004,1594,479,1797,1067,128,11,4,203,588,2,74,0,0
5005,1483,450,1702,1069,128,11,4,219,619,3,74,0,0
5006,1425,423,1652,1063,128,11,4,227,640,4,74,0,0
5007,1394,393,1625,1040,128,11,4,231,647,5,74,0,0
5008,1366,372,1594,1012,128,11,4,228,640,6,74,0,0
5009,1363,348,1577,943,128,11,4,214,595,7,74,0,0
5010,1364,333,1570,908,128,11,4,206,575,8,74,0,0
5011,1365,314,1559,859,128,11,4,194,545,9,74,0,0
5012,1369,296,1551,807,128,11,4,182,511,10,74,0,0
5013,1373,288,1541,767,128,11,4,168,479,11,74,0,0
5014,1379,269,1539,725,128,11,4,160,456,12,74,0,0
5015,1380,264,1536,709,128,11,4,156,445,13,74,0,0
5016,1383,256,1530,679,128,11,4,147,423,14,74,0,0
5017,1384,247,1523,647,128,11,4,139,400,15,74,0,0
5018,1388,246,1520,631,128,11,4,132,385,16,74,0,0
5019,1392,236,1513,593,128,11,4,121,357,17,74,0,0
5020,1392,231,1510,579,128,11,4,118,348,18,74,0,0
5021,1394,227,1505,560,128,11,4,111,333,19,74,0,0
5022,1397,222,1502,535,128,11,4,105,313,20,74,0,0
5023,1400,224,1500,524,128,11,4,100,300,21,74,0,0
5024,1406,217,1502,502,128,11,4,96,285,22,74,0,0
5025,1413,209,1508,495,128,11,4,95,286,23,74,0,0
5026,1418,206,1511,486,128,11,4,93,280,24,74,0,0
5027,1421,198,1510,467,128,11,4,89,269,25,74,0,0
5028,1426,200,1511,459,128,11,4,85,259,26,74,0,0
5029,1435,194,1517,444,128,11,4,82,250,27,74,0,0
5030,1445,192,1525,437,128,11,4,80,245,28,74,0,0
5031,1451,189,1528,428,128,11,4,77,239,29,74,0,0
5032,1453,185,1528,415,128,11,4,75,230,30,74,0,0
5033,1456,185,1529,410,128,11,4,73,225,31,74,0,0
5034,1462,181,1533,402,128,11,4,71,221,32,74,0,0
5035,1466,171,1538,398,128,11,4,72,227,33,74,0,0
5036,1470,170,1541,388,128,11,4,71,218,34,74,0,0
5037,1471,166,1539,379,128,11,4,68,213,35,74,0,0
5038,1472,166,1540,376,128,11,4,68,210,36,74,0,0
5039,1477,168,1542,369,128,11,4,65,201,37,74,0,0
5040,1482,166,1546,363,128,11,4,64,197,38,74,0,0
5041,1486,165,1548,358,128,11,4,62,193,39,74,0,0
5042,1489,165,1549,352,128,11,4,60,187,40,74,0,0
5043,1493,167,1550,344,128,11,4,57,177,41,74,0,0
5044,1496,162,1553,338,128,11,4,57,176,42,74,0,0
5045,1499,159,1555,334,128,11,4,56,175,43,74,0,0
5046,1501,154,1557,331,128,11,4,56,177,44,74,0,0
5047,1503,147,1558,324,128,11,4,55,177,45,74,0,0
5048,1503,146,1557,321,128,11,4,54,175,46,74,0,0
5049,1505,148,1558,318,128,11,4,53,170,47,74,0,0
5050,1506,143,1561,318,128,11,4,55,175,48,74,0,0
5051,1508,149,1559,313,128,11,4,51,164,49,74,0,0
5052,1507,147,1557,304,128,11,4,50,157,50,74,0,0
5053,1509,146,1557,301,128,11,4,48,155,51,74,0,0
5054,1511,146,1558,298,128,11,4,47,152,52,74,0,0
5055,1515,144,1563,295,128,11,4,48,151,53,74,0,0
5056,1517,145,1565,291,128,11,4,48,146,54,74,0,0
5057,1519,148,1565,284,128,11,4,46,136,55,74,0,0
5058,1522,148,1569,284,128,11,4,47,136,56,74,0,0
5059,1526,149,1570,281,128,11,4,44,132,57,74,0,0
5060,1529,146,1573,277,128,11,4,44,131,58,74,0,0
5061,1532,149,1575,277,128,11,4,43,128,59,74,0,0
5062,1535,147,1575,266,128,11,4,40,119,60,74,0,0
5063,1536,146,1576,267,128,11,4,40,121,61,74,0,0
5064,1537,145,1578,268,128,11,4,41,123,62,74,0,0
5065,1539,143,1580,265,128,11,4,41,122,63,74,0,0
5066,1540,142,1581,264,128,11,4,41,122,64,74,0,0
5067,1543,141,1583,259,128,11,4,40,118,65,74,0,0
5068,1543,140,1583,256,128,11,4,40,116,66,74,0,0
5069,1542,140,1582,255,128,11,4,40,115,67,74,0,0
5070,1542,139,1583,256,128,11,4,41,117,68,74,0,0
5071,1543,139,1584,253,128,11,4,41,114,69,74,0,0
5072,1545,141,1586,254,128,11,4,41,113,70,74,0,0
5073,1545,141,1586,248,128,11,4,41,107,71,74,0,0
5074,1545,141,1588,250,128,11,4,43,109,72,74,0,0
5075,1545,138,1589,248,128,11,4,44,110,73,74,0,0
5076,1546,138,1589,247,128,11,4,43,109,74,74,1,0
5079,1550,140,1590,238,128,11,4,40,98,0,74,0,0
5080,1552,141,1591,238,128,11,4,39,97,1,74,0,0
5081,1555,139,1594,236,128,11,4,39,97,2,74,0,0
5082,1556,138,1595,234,128,11,4,39,96,3,74,0,0
5083,1557,139,1595,231,128,11,4,38,92,4,74,0,0
5084,1557,139,1595,231,128,11,4,38,92,5,74,0,0
5085,1558,138,1597,230,128,11,4,39,92,6,74,0,0
5086,1561,136,1601,228,128,11,4,40,92,7,74,0,0
5087,1562,136,1602,227,128,11,4,40,91,8,74,0,0
5089,1562,135,1602,226,128,11,4,40,91,0,74,0,0
5090,1563,134,1603,225,128,11,4,40,91,1,74,0,0
5093,1569,136,1604,216,128,11,4,35,80,0,74,0,0
5094,1571,136,1606,218,128,11,4,35,82,1,74,0,0
5095,1572,136,1607,217,128,11,4,35,81,2,74,0,0
5086,253,836,362,996,129,11,4,109,160,0,4,0,0
5087,252,837,359,995,129,11,4,107,158,1,4,0,0
5088,250,834,361,998,129,11,4,111,164,2,4,0,0
5089,250,836,358,994,129,11,4,108,158,3,4,0,0
5090,250,836,357,994,129,11,4,107,158,4,4,0,0
5156,1154,262,1274,411,130,11,4,120,149,0,5,0,0
5157,1156,263,1273,409,130,11,4,117,146,1,5,0,0
5158,1150,265,1270,413,130,11,4,120,148,2,5,0,0
5159,1153,263,1271,410,130,11,4,118,147,3,5,0,0
5160,1154,261,1273,409,130,11,4,119,148,4,5,0,0
5161,1154,261,1273,409,130,11,4,119,148,5,5,0,0
5165,1145,259,1272,413,130,11,4,127,154,0,5,0,0
5166,1144,258,1272,414,130,11,4,128,156,1,5,0,0
5175,1807,805,1920,1034,131,11,4,113,229,0,95,0,1
5176,1731,601,1920,1042,131,11,4,189,441,1,95,0,0
5177,1666,557,1914,1062,131,11,4,248,505,2,95,0,0
5178,1587,528,1853,1072,131,11,4,266,544,3,95,0,0
5179,1501,503,1778,1072,131,11,4,277,569,4,95,0,0
5180,1423,479,1712,1072,131,11,4,289,593,5,95,0,0
5181,1389,455,1677,1055,131,11,4,288,600,6,95,0,0
5182,1351,443,1632,1035,131,11,4,281,592,7,95,0,0
5183,1324,423,1591,995,131,11,4,267,572,8,95,0,0
5184,1297,402,1557,968,131,11,4,260,566,9,95,0,0
5185,1287,391,1535,941,131,11,4,248,550,10,95,0,0
5186,1286,369,1514,884,131,11,4,228,515,11,95,0,0
5187,1278,363,1493,860,131,11,4,215,497,12,95,0,0
5188,1269,346,1468,813,131,11,4,199,467,13,95,0,0
5189,1262,342,1448,787,131,11,4,186,445,14,95,0,0
5190,1259,334,1439,773,131,11,4,180,439,15,95,0,0
5191,1261,320,1429,738,131,11,4,168,418,16,95,0,0
5192,1265,315,1424,716,131,11,4,159,401,17,95,0,0
5193,1265,302,1414,684,131,11,4,149,382,18,95,0,0
5194,1263,290,1408,670,131,11,4,145,380,19,95,0,0
5195,1265,281,1407,661,131,11,4,142,380,20,95,0,0
5196,1271,274,1405,638,131,11,4,134,364,21,95,0,0
5197,1277,271,1405,624,131,11,4,128,353,22,95,0,0
5198,1281,267,1406,618,131,11,4,125,351,23,95,0,0
5199,1290,260,1407,591,131,11,4,117,331,24,95,0,0
5200,1302,259,1413,576,131,11,4,111,317,25,95,0,0
5201,1314,260,1417,562,131,11,4,103,302,26,95,0,0
5202,1328,252,1430,551,131,11,4,102,299,27,95,0,0
5203,1336,244,1439,549,131,11,4,103,305,28,95,0,0
5204,1345,236,1446,536,131,11,4,101,300,29,95,0,0
5205,1357,233,1450,513,131,11,4,93,280,30,95,0,0
5206,1368,230,1456,498,131,11,4,88,268,31,95,0,0
5207,1377,222,1464,490,131,11,4,87,268,32,95,0,0
5208,1384,222,1470,490,131,11,4,86,268,33,95,0,0
5209,1392,216,1474,472,131,11,4,82,256,34,95,0,0
5210,1398,215,1477,465,131,11,4,79,250,35,95,0,0
5211,1402,212,1480,461,131,11,4,78,249,36,95,0,0
5212,1408,209,1484,452,131,11,4,76,243,37,95,0,0
5213,1410,208,1484,445,131,11,4,74,237,38,95,0,0
5214,1412,206,1485,439,131,11,4,73,233,39,95,0,0
5215,1414,206,1484,432,131,11,4,70,226,40,95,0,0
5216,1417,202,1486,424,131,11,4,69,222,41,95,0,0
5217,1424,199,1491,416,131,11,4,67,217,42,95,0,0
5218,1429,197,1494,410,131,11,4,65,213,43,95,0,0
5219,1434,197,1499,405,131,11,4,65,208,44,95,0,0
5220,1439,196,1502,400,131,11,4,63,204,45,95,0,0
5221,1448,198,1509,395,131,11,4,61,197,46,95,0,0
5222,1457,194,1517,392,131,11,4,60,198,47,95,0,0
5223,1462,191,1521,390,131,11,4,59,199,48,95,0,0
5224,1466,193,1523,385,131,11,4,57,192,49,95,0,0
5225,1469,198,1524,379,131,11,4,55,181,50,95,0,0
5226,1473,203,1525,371,131,11,4,52,168,51,95,0,0
5227,1476,200,1527,366,131,11,4,51,166,52,95,0,0
5228,1479,197,1530,362,131,11,4,51,165,53,95,0,0
5229,1481,196,1532,361,131,11,4,51,165,54,95,0,0
5230,1485,190,1537,357,131,11,4,52,167,55,95,0,0
5231,1489,186,1542,354,131,11,4,53,168,56,95,0,0
5232,1493,181,1546,352,131,11,4,53,171,57,95,0,0
5233,1498,183,1549,348,131,11,4,51,165,58,95,0,0
5234,1502,185,1551,342,131,11,4,49,157,59,95,0,0
5235,1503,185,1550,335,131,11,4,47,150,60,95,0,0
5236,1504,183,1552,332,131,11,4,48,149,61,95,0,0
5237,1505,180,1553,332,131,11,4,48,152,62,95,0,0
5238,1508,176,1556,328,131,11,4,48,152,63,95,0,0
5239,1510,176,1557,326,131,11,4,47,150,64,95,0,0
5240,1511,175,1558,322,131,11,4,47,147,65,95,0,0
5241,1515,174,1560,317,131,11,4,45,143,66,95,0,0
5242,1519,180,1562,312,131,11,4,43,132,67,95,0,0
5243,1523,182,1565,310,131,11,4,42,128,68,95,0,0
5244,1526,179,1569,308,131,11,4,43,129,69,95,0,0
5245,1528,180,1570,306,131,11,4,42,126,70,95,0,0
5246,1529,177,1570,301,131,11,4,41,124,71,95,0,0
5247,1528,176,1571,301,131,11,4,43,125,72,95,0,0
5248,1530,176,1573,300,131,11,4,43,124,73,95,0,0
5249,1533,175,1575,295,131,11,4,42,120,74,95,0,0
5250,1535,174,1577,294,131,11,4,42,120,75,95,0,0
5251,1539,171,1580,293,131,11,4,41,122,76,95,0,0
5252,1540,170,1581,291,131,11,4,41,121,77,95,0,0
5253,1541,167,1583,290,131,11,4,42,123,78,95,0,0
5254,1542,166,1583,288,131,11,4,41,122,79,95,0,0
5255,1543,164,1584,286,131,11,4,41,122,80,95,0,0
5256,1544,161,1585,285,131,11,4,41,124,81,95,0,0
5257,1544,156,1587,285,131,11,4,43,129,82,95,0,0
5258,1543,152,1587,281,131,11,4,44,129,83,95,0,0
5259,1544,154,1587,280,131,11,4,43,126,84,95,0,0
5260,1545,154,1586,278,131,11,4,41,124,85,95,0,0
5261,1546,155,1587,275,131,11,4,41,120,86,95,0,0
5262,1546,153,1587,273,131,11,4,41,120,87,95,0,0
5263,1546,153,1586,271,131,11,4,40,118,88,95,0,0
5264,1546,153,1586,270,131,11,4,40,117,89,95,0,0
5265,1547,154,1586,268,131,11,4,39,114,90,95,0,0
5266,1550,159,1586,264,131,11,4,36,105,91,95,0,0
5267,1551,161,1586,264,131,11,4,35,103,92,95,0,0
5268,1551,156,1589,266,131,11,4,38,110,93,95,0,0
5269,1552,156,1590,264,131,11,4,38,108,94,95,0,0
5270,1556,157,1591,259,131,11,4,35,102,95,95,1,0
5273,1563,152,1598,255,131,11,4,35,103,0,95,0,0
5274,1563,151,1599,254,131,11,4,36,103,1,95,0,0
5275,1564,152,1599,254,131,11,4,35,102,2,95,0,0
5276,1563,149,1599,253,131,11,4,36,104,3,95,0,0
5277,1565,147,1602,254,131,11,4,37,107,4,95,0,0
5278,1565,146,1601,251,131,11,4,36,105,5,95,0,0
5279,1563,146,1599,248,131,11,4,36,102,6,95,0,0
5280,1562,145,1598,247,131,11,4,36,102,7,95,0,0
5281,1562,147,1597,247,131,11,4,35,100,8,95,0,0
5284,1564,144,1599,240,131,11,4,35,96,0,95,0,0
5210,1165,268,1273,397,133,11,4,108,129,0,0,0,0
5484,1719,624,1918,1070,134,11,4,199,446,0,74,0,1
5485,1661,582,1875,1063,134,11,4,214,481,1,74,0,0
5486,1584,550,1813,1065,134,11,4,229,515,2,74,0,0
5487,1499,524,1738,1061,134,11,4,239,537,3,74,0,0
5488,1449,491,1699,1060,134,11,4,250,569,4,74,0,0
5489,1390,460,1648,1050,134,11,4,258,590,5,74,0,0
5490,1365,443,1607,1003,134,11,4,242,560,6,74,0,0
5491,1354,416,1587,960,134,11,4,233,544,7,74,0,0
5492,1349,398,1575,934,134,11,4,226,536,8,74,0,0
5493,1361,377,1567,872,134,11,4,206,495,9,74,0,0
5494,1372,363,1568,842,134,11,4,196,479,10,74,0,0
5495,1382,351,1565,809,134,11,4,183,458,11,74,0,0
5496,1393,335,1564,768,134,11,4,171,433,12,74,0,0
5497,1407,328,1569,746,134,11,4,162,418,13,74,0,0
5498,1426,316,1576,708,134,11,4,150,392,14,74,0,0
5499,1442,307,1587,693,134,11,4,145,386,15,74,0,0
5500,1451,302,1591,681,134,11,4,140,379,16,74,0,0
5501,1460,290,1591,646,134,11,4,131,356,17,74,0,0
5502,1467,280,1591,627,134,11,4,124,347,18,74,0,0
5503,1477,276,1596,610,134,11,4,119,334,19,74,0,0
5504,1491,267,1605,591,134,11,4,114,324,20,74,0,0
5505,1502,265,1613,583,134,11,4,111,318,21,74,0,0
5506,1510,261,1613,564,134,11,4,103,303,22,74,0,0
5507,1518,253,1618,546,134,11,4,100,293,23,74,0,0
5508,1528,248,1623,531,134,11,4,95,283,24,74,0,0
5509,1540,242,1631,516,134,11,4,91,274,25,74,0,0
5510,1547,240,1635,513,134,11,4,88,273,26,74,0,0
5511,1553,238,1635,494,134,11,4,82,256,27,74,0,0
5512,1558,236,1638,486,134,11,4,80,250,28,74,0,0
5513,1565,236,1643,481,134,11,4,78,245,29,74,0,0
5514,1575,234,1649,465,134,11,4,74,231,30,74,0,0
5515,1580,230,1652,458,134,11,4,72,228,31,74,0,0
5516,1582,227,1649,438,134,11,4,67,211,32,74,0,0
5517,1581,222,1648,434,134,11,4,67,212,33,74,0,0
5518,1582,221,1648,430,134,11,4,66,209,34,74,0,0
5519,1585,215,1648,418,134,11,4,63,203,35,74,0,0
5520,1587,214,1650,416,134,11,4,63,202,36,74,0,0
5521,1587,210,1647,408,134,11,4,60,198,37,74,0,0
5522,1585,207,1644,401,134,11,4,59,194,38,74,0,0
5523,1584,207,1641,395,134,11,4,57,188,39,74,0,0
5524,1586,204,1641,386,134,11,4,55,182,40,74,0,0
5525,1587,202,1641,384,134,11,4,54,182,41,74,0,0
5526,1589,202,1639,369,134,11,4,50,167,42,74,0,0
5527,1589,203,1638,366,134,11,4,49,163,43,74,0,0
5528,1591,203,1638,362,134,11,4,47,159,44,74,0,0
5529,1593,192,1642,357,134,11,4,49,165,45,74,0,0
5530,1595,187,1644,354,134,11,4,49,167,46,74,0,0
5531,1597,186,1645,348,134,11,4,48,162,47,74,0,0
5532,1598,185,1644,345,134,11,4,46,160,48,74,0,0
5533,1599,185,1645,340,134,11,4,46,155,49,74,0,0
5534,1604,183,1649,334,134,11,4,45,151,50,74,0,0
5535,1606,181,1651,332,134,11,4,45,151,51,74,0,0
5536,1608,181,1653,329,134,11,4,45,148,52,74,0,0
5537,1610,181,1654,327,134,11,4,44,146,53,74,0,0
5538,1613,178,1657,324,134,11,4,44,146,54,74,0,0
5539,1618,178,1661,318,134,11,4,43,140,55,74,0,0
5540,1620,178,1661,312,134,11,4,41,134,56,74,0,0
5541,1621,178,1661,306,134,11,4,40,128,57,74,0,0
5542,1623,175,1664,305,134,11,4,41,130,58,74,0,0
5543,1623,175,1664,302,134,11,4,41,127,59,74,0,0
5544,1625,172,1665,299,134,11,4,40,127,60,74,0,0
5545,1624,174,1664,299,134,11,4,40,125,61,74,0,0
5546,1622,174,1663,298,134,11,4,41,124,62,74,0,0
5547,1621,173,1661,294,134,11,4,40,121,63,74,0,0
5548,1621,168,1662,293,134,11,4,41,125,64,74,0,0
5549,1622,167,1661,286,134,11,4,39,119,65,74,0,0
5550,1621,166,1660,284,134,11,4,39,118,66,74,0,0
5551,1618,166,1656,283,134,11,4,38,117,67,74,0,0
5552,1616,162,1654,277,134,11,4,38,115,68,74,0,0
5553,1616,161,1654,277,134,11,4,38,116,69,74,0,0
5554,1617,162,1653,274,134,11,4,36,112,70,74,0,0
5555,1617,157,1655,274,134,11,4,38,117,71,74,0,0
5556,1618,155,1655,272,134,11,4,37,117,72,74,0,0
5557,1619,155,1655,269,134,11,4,36,114,73,74,0,0
5558,1619,156,1655,269,134,11,4,36,113,74,74,1,0
5706,259,830,360,981,136,11,4,101,151,0,5,0,0
5707,259,831,361,984,136,11,4,102,153,1,5,0,0
5708,262,832,360,977,136,11,4,98,145,2,5,0,0
5709,264,832,360,974,136,11,4,96,142,3,5,0,0
5710,264,832,359,975,136,11,4,95,143,4,5,0,0
5711,265,833,359,974,136,11,4,94,141,5,5,0,0
5711,1146,269,1268,404,137,11,4,122,135,0,5,0,0
5712,1145,269,1267,404,137,11,4,122,135,1,5,0,0
5713,1143,268,1266,404,137,11,4,123,136,2,5,0,0
5714,1144,268,1267,403,137,11,4,123,135,3,5,0,0
5715,1147,268,1267,401,137,11,4,120,133,4,5,0,0
5716,1147,268,1267,401,137,11,4,120,133,5,5,0,0
5728,1144,269,1270,407,137,11,4,126,138,0,5,0,0
5729,1144,264,1272,406,137,11,4,128,142,1,5,0,0
5730,1144,264,1273,406,137,11,4,129,142,2,5,0,0
5736,1138,256,1281,416,137,11,4,143,160,0,5,0,0
5737,1137,255,1282,417,137,11,4,145,162,1,5,0,0
5738,1139,251,1284,415,137,11,4,145,164,2,5,0,0
5739,1138,249,1285,416,137,11,4,147,167,3,5,0,0
5971,1139,272,1273,407,138,11,4,134,135,0,3,0,0
5973,1138,270,1274,408,138,11,4,136,138,0,3,0,0
5974,1137,270,1275,410,138,11,4,138,140,1,3,0,0
5975,1138,271,1274,409,138,11,4,136,138,2,3,0,0
5976,1138,271,1274,409,138,11,4,136,138,3,3,0,0
32,1,746,94,979,1,11,5,93,233,0,0,0,0
33,5,571,210,945,2,11,5,205,374,0,1768,0,1
34,0,328,286,947,2,11,5,286,619,1,1768,0,0
35,0,279,310,952,2,11,5,310,673,2,1768,0,0
36,15,262,382,946,2,11,5,367,684,3,1768,0,0
37,76,248,445,941,2,11,5,369,693,4,1768,0,0
38,121,234,485,932,2,11,5,364,698,5,1768,0,0
39,181,233,540,924,2,11,5,359,691,6,1768,0,0
40,237,237,589,925,2,11,5,352,688,7,1768,0,0
41,274,235,619,921,2,11,5,345,686,8,1768,0,0
42,297,233,634,923,2,11,5,337,690,9,1768,0,0
43,312,225,643,924,2,11,5,331,699,10,1768,0,0
44,320,221,642,927,2,11,5,322,706,11,1768,0,0
45,322,213,637,927,2,11,5,315,714,12,1768,0,0
46,329,211,635,930,2,11,5,306,719,13,1768,0,0
47,340,209,634,931,2,11,5,294,722,14,1768,0,0
48,347,208,629,931,2,11,5,282,723,15,1768,0,0
49,355,207,626,931,2,11,5,271,724,16,1768,0,0
50,360,207,620,927,2,11,5,260,720,17,1768,0,0
51,365,208,615,926,2,11,5,250,718,18,1768,0,0
52,368,207,611,929,2,11,5,243,722,19,1768,0,0
53,372,207,607,929,2,11,5,235,722,20,1768,0,0
54,375,207,604,930,2,11,5,229,723,21,1768,0,0
55,378,207,600,931,2,11,5,222,724,22,1768,0,0
56,381,206,597,929,2,11,5,216,723,23,1768,0,0
57,383,207,593,927,2,11,5,210,720,24,1768,0,0
58,386,213,591,930,2,11,5,205,717,25,1768,0,0
59,387,210,588,927,2,11,5,201,717,26,1768,0,0
60,388,209,585,926,2,11,5,197,717,27,1768,0,0
61,389,208,583,926,2,11,5,194,718,28,1768,0,0
62,390,209,581,926,2,11,5,191,717,29,1768,0,0
63,392,214,579,929,2,11,5,187,715,30,1768,0,0
64,392,211,577,927,2,11,5,185,716,31,1768,0,0
65,393,210,576,927,2,11,5,183,717,32,1768,0,0
66,392,211,573,927,2,11,5,181,716,33,1768,0,0
67,393,215,572,930,2,11,5,179,715,34,1768,0,0
68,394,217,572,931,2,11,5,178,714,35,1768,0,0
69,394,218,571,931,2,11,5,177,713,36,1768,0,0
70,395,218,571,932,2,11,5,176,714,37,1768,0,0
71,396,218,571,931,2,11,5,175,713,38,1768,0,0
72,396,219,570,931,2,11,5,174,712,39,1768,0,0
73,396,219,570,931,2,11,5,174,712,40,1768,0,0
74,397,219,570,931,2,11,5,173,712,41,1768,0,0
75,398,219,570,931,2,11,5,172,712,42,1768,0,0
76,398,217,570,933,2,11,5,172,716,43,1768,0,0
77,397,216,569,933,2,11,5,172,717,44,1768,0,0
78,396,215,569,934,2,11,5,173,719,45,1768,0,0
79,401,214,576,935,2,11,5,175,721,46,1768,0,0
80,404,216,579,935,2,11,5,175,719,47,1768,0,0
81,397,212,574,936,2,11,5,177,724,48,1768,0,0
82,396,213,574,936,2,11,5,178,723,49,1768,0,0
83,393,213,571,938,2,11,5,178,725,50,1768,0,0
84,390,215,569,938,2,11,5,179,723,51,1768,0,0
85,390,216,569,939,2,11,5,179,723,52,1768,0,0
86,389,217,569,937,2,11,5,180,720,53,1768,0,0
87,388,219,567,936,2,11,5,179,717,54,1768,0,0
88,386,219,566,937,2,11,5,180,718,55,1768,0,0
89,383,216,565,937,2,11,5,182,721,56,1768,0,0
90,387,217,567,923,2,11,5,180,706,57,1768,0,0
91,400,220,580,902,2,11,5,180,682,58,1768,0,0
92,420,220,605,875,2,11,5,185,655,59,1768,0,0
93,446,216,635,850,2,11,5,189,634,60,1768,0,0
94,464,218,659,842,2,11,5,195,624,61,1768,0,0
95,479,210,680,844,2,11,5,201,634,62,1768,0,0
96,486,202,692,846,2,11,5,206,644,63,1768,0,0
97,517,214,715,835,2,11,5,198,621,64,1768,0,0
98,548,210,741,834,2,11,5,193,624,65,1768,0,0
99,567,200,762,832,2,11,5,195,632,66,1768,0,0
100,595,186,793,827,2,11,5,198,641,67,1768,0,0
101,638,165,836,806,2,11,5,198,641,68,1768,0,0
102,685,161,875,762,2,11,5,190,601,69,1768,0,0
103,720,163,906,738,2,11,5,186,575,70,1768,0,0
104,740,163,923,724,2,11,5,183,561,71,1768,0,0
105,774,170,951,710,2,11,5,177,540,72,1768,0,0
106,797,165,975,710,2,11,5,178,545,73,1768,0,0
107,804,159,982,705,2,11,5,178,546,74,1768,0,0
108,805,163,978,694,2,11,5,173,531,75,1768,0,0
109,806,157,979,688,2,11,5,173,531,76,1768,0,0
110,804,157,977,691,2,11,5,173,534,77,1768,0,0
111,802,154,972,682,2,11,5,170,528,78,1768,0,0
112,799,155,966,675,2,11,5,167,520,79,1768,0,0
113,800,153,965,673,2,11,5,165,520,80,1768,0,0
114,799,153,961,673,2,11,5,162,520,81,1768,0,0
115,796,154,958,678,2,11,5,162,524,82,1768,0,0
116,796,150,956,679,2,11,5,160,529,83,1768,0,0
117,797,155,953,680,2,11,5,156,525,84,1768,0,0
118,797,155,951,680,2,11,5,154,525,85,1768,0,0
119,798,158,950,680,2,11,5,152,522,86,1768,0,0
120,799,156,949,681,2,11,5,150,525,87,1768,0,0
121,800,156,949,681,2,11,5,149,525,88,1768,0,0
122,801,155,949,681,2,11,5,148,526,89,1768,0,0
123,802,155,949,681,2,11,5,147,526,90,1768,0,0
124,803,157,949,683,2,11,5,146,526,91,1768,0,0
125,804,158,948,683,2,11,5,144,525,92,1768,0,0
126,804,157,948,685,2,11,5,144,528,93,1768,0,0
127,803,157,948,688,2,11,5,145,531,94,1768,0,0
128,802,153,949,693,2,11,5,147,540,95,1768,0,0
129,803,156,948,690,2,11,5,145,534,96,1768,0,0
130,803,156,949,689,2,11,5,146,533,97,1768,0,0
131,804,158,947,685,2,11,5,143,527,98,1768,0,0
132,804,160,947,684,2,11,5,143,524,99,1768,0,0
133,804,162,946,684,2,11,5,142,522,100,1768,0,0
134,805,163,945,684,2,11,5,140,521,101,1768,0,0
135,805,164,944,684,2,11,5,139,520,102,1768,0,0
136,805,162,944,685,2,11,5,139,523,103,1768,0,0
137,804,159,943,683,2,11,5,139,524,104,1768,0,0
138,804,157,943,682,2,11,5,139,525,105,1768,0,0
139,804,157,943,682,2,11,5,139,525,106,1768,0,0
140,804,157,942,682,2,11,5,138,525,107,1768,0,0
141,804,156,944,688,2,11,5,140,532,108,1768,0,0
142,805,159,945,688,2,11,5,140,529,109,1768,0,0
143,805,160,945,686,2,11,5,140,526,110,1768,0,0
144,805,160,945,686,2,11,5,140,526,111,1768,0,0
145,805,160,945,686,2,11,5,140,526,112,1768,0,0
146,804,160,945,689,2,11,5,141,529,113,1768,0,0
147,806,160,946,685,2,11,5,140,525,114,1768,0,0
148,805,160,946,688,2,11,5,141,528,115,1768,0,0
149,805,160,947,690,2,11,5,142,530,116,1768,0,0
150,805,160,948,690,2,11,5,143,530,117,1768,0,0
151,808,157,953,688,2,11,5,145,531,118,1768,0,0
152,813,162,960,695,2,11,5,147,533,119,1768,0,0
153,815,158,966,697,2,11,5,151,539,120,1768,0,0
154,816,160,968,698,2,11,5,152,538,121,1768,0,0
155,816,160,969,693,2,11,5,153,533,122,1768,0,0
156,814,160,968,687,2,11,5,154,527,123,1768,0,0
157,813,160,969,686,2,11,5,156,526,124,1768,0,0
158,811,161,967,685,2,11,5,156,524,125,1768,0,0
159,811,161,968,686,2,11,5,157,525,126,1768,0,0
160,810,161,968,692,2,11,5,158,531,127,1768,0,0
161,809,161,967,688,2,11,5,158,527,128,1768,0,0
162,809,161,967,686,2,11,5,158,525,129,1768,0,0
163,808,162,967,686,2,11,5,159,524,130,1768,0,0
164,808,162,967,685,2,11,5,159,523,131,1768,0,0
165,807,161,967,687,2,11,5,160,526,132,1768,0,0
166,806,158,969,689,2,11,5,163,531,133,1768,0,0
167,807,159,970,691,2,11,5,163,532,134,1768,0,0
168,806,159,970,691,2,11,5,164,532,135,1768,0,0
169,806,158,970,691,2,11,5,164,533,136,1768,0,0
170,806,160,969,688,2,11,5,163,528,137,1768,0,0
171,804,158,968,690,2,11,5,164,532,138,1768,0,0
172,804,158,968,691,2,11,5,164,533,139,1768,0,0
173,804,156,967,691,2,11,5,163,535,140,1768,0,0
174,804,158,967,692,2,11,5,163,534,141,1768,0,0
175,804,158,967,692,2,11,5,163,534,142,1768,0,0
176,805,162,967,692,2,11,5,162,530,143,1768,0,0
177,805,162,967,692,2,11,5,162,530,144,1768,0,0
178,804,162,967,693,2,11,5,163,531,145,1768,0,0
179,804,162,967,691,2,11,5,163,529,146,1768,0,0
180,803,160,967,692,2,11,5,164,532,147,1768,0,0
181,803,160,967,692,2,11,5,164,532,148,1768,0,0
182,803,161,967,692,2,11,5,164,531,149,1768,0,0
183,803,161,967,692,2,11,5,164,531,150,1768,0,0
184,802,160,967,693,2,11,5,165,533,151,1768,0,0
185,801,159,966,693,2,11,5,165,534,152,1768,0,0
186,802,157,966,690,2,11,5,164,533,153,1768,0,0
187,802,156,966,688,2,11,5,164,532,154,1768,0,0
188,803,156,967,688,2,11,5,164,532,155,1768,0,0
189,802,156,967,688,2,11,5,165,532,156,1768,0,0
190,802,156,967,688,2,11,5,165,532,157,1768,0,0
191,802,160,965,690,2,11,5,163,530,158,1768,0,0
192,801,162,964,691,2,11,5,163,529,159,1768,0,0
193,801,162,962,689,2,11,5,161,527,160,1768,0,0
194,800,161,961,689,2,11,5,161,528,161,1768,0,0
195,799,161,961,689,2,11,5,162,528,162,1768,0,0
196,801,163,961,687,2,11,5,160,524,163,1768,0,0
197,802,163,962,686,2,11,5,160,523,164,1768,0,0
198,802,165,962,685,2,11,5,160,520,165,1768,0,0
199,801,163,962,687,2,11,5,161,524,166,1768,0,0
200,801,167,961,682,2,11,5,160,515,167,1768,0,0
201,799,166,963,682,2,11,5,164,516,168,1768,0,0
202,802,165,969,693,2,11,5,167,528,169,1768,0,0
203,801,164,970,701,2,11,5,169,537,170,1768,0,0
204,804,171,969,694,2,11,5,165,523,171,1768,0,0
205,804,171,969,698,2,11,5,165,527,172,1768,0,0
206,807,176,969,696,2,11,5,162,520,173,1768,0,0
207,812,174,973,689,2,11,5,161,515,174,1768,0,0
208,812,175,971,689,2,11,5,159,514,175,1768,0,0
209,809,177,969,689,2,11,5,160,512,176,1768,0,0
210,813,171,974,684,2,11,5,161,513,177,1768,0,0
211,815,167,976,681,2,11,5,161,514,178,1768,0,0
212,818,171,977,684,2,11,5,159,513,179,1768,0,0
213,819,162,980,679,2,11,5,161,517,180,1768,0,0
214,821,161,982,687,2,11,5,161,526,181,1768,0,0
215,821,162,980,679,2,11,5,159,517,182,1768,0,0
216,818,159,981,688,2,11,5,163,529,183,1768,0,0
217,817,158,978,686,2,11,5,161,528,184,1768,0,0
218,816,164,978,695,2,11,5,162,531,185,1768,0,0
219,816,161,978,694,2,11,5,162,533,186,1768,0,0
220,815,160,978,693,2,11,5,163,533,187,1768,0,0
221,814,156,977,692,2,11,5,163,536,188,1768,0,0
222,812,156,974,690,2,11,5,162,534,189,1768,0,0
223,811,155,972,688,2,11,5,161,533,190,1768,0,0
224,811,155,972,687,2,11,5,161,532,191,1768,0,0
225,811,155,972,687,2,11,5,161,532,192,1768,0,0
226,815,158,977,693,2,11,5,162,535,193,1768,0,0
227,818,160,979,694,2,11,5,161,534,194,1768,0,0
228,818,160,980,695,2,11,5,162,535,195,1768,0,0
229,819,160,980,695,2,11,5,161,535,196,1768,0,0
230,819,160,980,694,2,11,5,161,534,197,1768,0,0
231,817,158,978,689,2,11,5,161,531,198,1768,0,0
232,819,158,980,688,2,11,5,161,530,199,1768,0,0
233,816,155,978,687,2,11,5,162,532,200,1768,0,0
234,814,154,977,687,2,11,5,163,533,201,1768,0,0
235,815,154,977,686,2,11,5,162,532,202,1768,0,0
236,815,156,977,688,2,11,5,162,532,203,1768,0,0
237,816,163,979,695,2,11,5,163,532,204,1768,0,0
238,815,159,978,692,2,11,5,163,533,205,1768,0,0
239,813,155,976,690,2,11,5,163,535,206,1768,0,0
240,813,152,976,689,2,11,5,163,537,207,1768,0,0
241,812,153,977,695,2,11,5,165,542,208,1768,0,0
242,812,155,977,698,2,11,5,165,543,209,1768,0,0
243,813,160,978,700,2,11,5,165,540,210,1768,0,0
244,814,162,977,699,2,11,5,163,537,211,1768,0,0
245,814,162,978,700,2,11,5,164,538,212,1768,0,0
246,813,156,978,697,2,11,5,165,541,213,1768,0,0
247,813,154,977,691,2,11,5,164,537,214,1768,0,0
248,813,152,978,693,2,11,5,165,541,215,1768,0,0
249,813,152,978,694,2,11,5,165,542,216,1768,0,0
250,813,152,978,694,2,11,5,165,542,217,1768,0,0
251,815,150,978,687,2,11,5,163,537,218,1768,0,0
252,815,149,978,684,2,11,5,163,535,219,1768,0,0
253,816,148,978,683,2,11,5,162,535,220,1768,0,0
254,818,154,979,685,2,11,5,161,531,221,1768,0,0
255,817,152,980,686,2,11,5,163,534,222,1768,0,0
256,817,154,980,685,2,11,5,163,531,223,1768,0,0
257,816,156,978,685,2,11,5,162,529,224,1768,0,0
258,816,157,978,683,2,11,5,162,526,225,1768,0,0
259,816,166,976,694,2,11,5,160,528,226,1768,0,0
260,817,163,979,692,2,11,5,162,529,227,1768,0,0
261,821,160,984,693,2,11,5,163,533,228,1768,0,0
262,827,161,963,588,2,11,5,136,427,229,1768,0,0
263,819,153,972,636,2,11,5,153,483,230,1768,0,0
264,814,154,978,672,2,11,5,164,518,231,1768,0,0
265,812,153,979,682,2,11,5,167,529,232,1768,0,0
266,815,164,978,687,2,11,5,163,523,233,1768,0,0
267,816,169,977,686,2,11,5,161,517,234,1768,0,0
268,817,172,976,686,2,11,5,159,514,235,1768,0,0
269,817,174,976,686,2,11,5,159,512,236,1768,0,0
270,818,174,975,686,2,11,5,157,512,237,1768,0,0
271,816,169,976,690,2,11,5,160,521,238,1768,0,0
272,815,167,975,692,2,11,5,160,525,239,1768,0,0
273,814,157,978,694,2,11,5,164,537,240,1768,0,0
274,817,157,980,689,2,11,5,163,532,241,1768,0,0
275,817,158,980,686,2,11,5,163,528,242,1768,0,0
276,819,159,984,686,2,11,5,165,527,243,1768,0,0
277,819,159,985,685,2,11,5,166,526,244,1768,0,0
278,820,157,985,682,2,11,5,165,525,245,1768,0,0
279,819,155,987,683,2,11,5,168,528,246,1768,0,0
280,818,153,985,683,2,11,5,167,530,247,1768,0,0
281,817,152,986,688,2,11,5,169,536,248,1768,0,0
282,817,153,987,691,2,11,5,170,538,249,1768,0,0
283,816,156,985,692,2,11,5,169,536,250,1768,0,0
284,817,157,985,691,2,11,5,168,534,251,1768,0,0
285,817,157,986,693,2,11,5,169,536,252,1768,0,0
286,815,160,984,694,2,11,5,169,534,253,1768,0,0
287,815,160,983,695,2,11,5,168,535,254,1768,0,0
288,816,160,985,694,2,11,5,169,534,255,1768,0,0
289,816,161,985,694,2,11,5,169,533,256,1768,0,0
290,815,159,986,695,2,11,5,171,536,257,1768,0,0
291,814,159,984,695,2,11,5,170,536,258,1768,0,0
292,814,159,984,695,2,11,5,170,536,259,1768,0,0
293,814,159,983,694,2,11,5,169,535,260,1768,0,0
294,813,160,982,695,2,11,5,169,535,261,1768,0,0
295,813,159,982,696,2,11,5,169,537,262,1768,0,0
296,813,161,982,695,2,11,5,169,534,263,1768,0,0
297,813,161,982,695,2,11,5,169,534,264,1768,0,0
298,813,163,981,692,2,11,5,168,529,265,1768,0,0
299,815,163,983,690,2,11,5,168,527,266,1768,0,0
300,814,161,983,692,2,11,5,169,531,267,1768,0,0
301,813,154,984,692,2,11,5,171,538,268,1768,0,0
302,814,155,986,696,2,11,5,172,541,269,1768,0,0
303,813,154,985,695,2,11,5,172,541,270,1768,0,0
304,813,152,985,695,2,11,5,172,543,271,1768,0,0
305,811,150,984,699,2,11,5,173,549,272,1768,0,0
306,814,157,982,691,2,11,5,168,534,273,1768,0,0
307,814,159,981,688,2,11,5,167,529,274,1768,0,0
308,815,161,981,687,2,11,5,166,526,275,1768,0,0
309,815,161,981,686,2,11,5,166,525,276,1768,0,0
310,816,161,982,686,2,11,5,166,525,277,1768,0,0
311,813,161,981,692,2,11,5,168,531,278,1768,0,0
312,814,161,982,691,2,11,5,168,530,279,1768,0,0
313,814,162,982,692,2,11,5,168,530,280,1768,0,0
314,812,160,981,694,2,11,5,169,534,281,1768,0,0
315,811,159,980,695,2,11,5,169,536,282,1768,0,0
316,811,159,980,694,2,11,5,169,535,283,1768,0,0
317,812,159,981,695,2,11,5,169,536,284,1768,0,0
318,814,162,981,689,2,11,5,167,527,285,1768,0,0
319,816,168,982,692,2,11,5,166,524,286,1768,0,0
320,814,164,981,694,2,11,5,167,530,287,1768,0,0
321,812,160,978,689,2,11,5,166,529,288,1768,0,0
322,812,160,977,687,2,11,5,165,527,289,1768,0,0
323,812,159,976,687,2,11,5,164,528,290,1768,0,0
324,812,159,976,686,2,11,5,164,527,291,1768,0,0
325,811,155,979,695,2,11,5,168,540,292,1768,0,0
326,813,157,980,693,2,11,5,167,536,293,1768,0,0
327,814,156,981,693,2,11,5,167,537,294,1768,0,0
328,814,157,981,693,2,11,5,167,536,295,1768,0,0
329,814,156,982,693,2,11,5,168,537,296,1768,0,0
330,814,155,982,693,2,11,5,168,538,297,1768,0,0
331,815,154,981,689,2,11,5,166,535,298,1768,0,0
332,814,152,983,693,2,11,5,169,541,299,1768,0,0
333,813,153,981,689,2,11,5,168,536,300,1768,0,0
334,814,153,980,687,2,11,5,166,534,301,1768,0,0
335,814,154,980,687,2,11,5,166,533,302,1768,0,0
336,814,154,982,692,2,11,5,168,538,303,1768,0,0
337,814,155,981,693,2,11,5,167,538,304,1768,0,0
338,813,155,981,696,2,11,5,168,541,305,1768,0,0
339,814,158,979,689,2,11,5,165,531,306,1768,0,0
340,814,157,980,694,2,11,5,166,537,307,1768,0,0
341,813,160,979,696,2,11,5,166,536,308,1768,0,0
342,813,161,979,696,2,11,5,166,535,309,1768,0,0
343,812,161,979,697,2,11,5,167,536,310,1768,0,0
344,812,160,979,697,2,11,5,167,537,311,1768,0,0
345,812,161,979,697,2,11,5,167,536,312,1768,0,0
346,813,159,977,687,2,11,5,164,528,313,1768,0,0
347,815,167,977,693,2,11,5,162,526,314,1768,0,0
348,815,163,976,685,2,11,5,161,522,315,1768,0,0
349,815,162,976,682,2,11,5,161,520,316,1768,0,0
350,815,162,976,682,2,11,5,161,520,317,1768,0,0
351,814,157,977,689,2,11,5,163,532,318,1768,0,0
352,812,157,977,692,2,11,5,165,535,319,1768,0,0
353,812,158,977,694,2,11,5,165,536,320,1768,0,0
354,812,158,976,694,2,11,5,164,536,321,1768,0,0
355,812,159,976,694,2,11,5,164,535,322,1768,0,0
356,815,165,977,691,2,11,5,162,526,323,1768,0,0
357,816,167,978,690,2,11,5,162,523,324,1768,0,0
358,816,164,978,688,2,11,5,162,524,325,1768,0,0
359,817,161,980,687,2,11,5,163,526,326,1768,0,0
360,816,165,979,689,2,11,5,163,524,327,1768,0,0
361,814,161,979,694,2,11,5,165,533,328,1768,0,0
362,812,159,979,696,2,11,5,167,537,329,1768,0,0
363,812,158,979,696,2,11,5,167,538,330,1768,0,0
364,812,160,978,696,2,11,5,166,536,331,1768,0,0
365,813,160,979,696,2,11,5,166,536,332,1768,0,0
366,812,156,980,697,2,11,5,168,541,333,1768,0,0
367,813,154,980,693,2,11,5,167,539,334,1768,0,0
368,813,155,978,692,2,11,5,165,537,335,1768,0,0
369,814,162,978,699,2,11,5,164,537,336,1768,0,0
370,814,162,978,696,2,11,5,164,534,337,1768,0,0
371,816,157,979,691,2,11,5,163,534,338,1768,0,0
372,817,156,981,689,2,11,5,164,533,339,1768,0,0
373,817,155,981,689,2,11,5,164,534,340,1768,0,0
374,817,154,981,688,2,11,5,164,534,341,1768,0,0
375,817,154,981,688,2,11,5,164,534,342,1768,0,0
376,815,157,978,687,2,11,5,163,530,343,1768,0,0
377,813,163,976,692,2,11,5,163,529,344,1768,0,0
378,813,158,977,693,2,11,5,164,535,345,1768,0,0
379,813,156,978,693,2,11,5,165,537,346,1768,0,0
380,808,153,971,682,2,11,5,163,529,347,1768,0,0
381,800,161,959,675,2,11,5,159,514,348,1768,0,0
382,798,166,958,680,2,11,5,160,514,349,1768,0,0
383,799,168,960,684,2,11,5,161,516,350,1768,0,0
384,805,181,964,688,2,11,5,159,507,351,1768,0,0
385,804,176,965,693,2,11,5,161,517,352,1768,0,0
386,805,169,970,697,2,11,5,165,528,353,1768,0,0
387,804,162,970,691,2,11,5,166,529,354,1768,0,0
388,804,160,973,693,2,11,5,169,533,355,1768,0,0
389,804,164,971,691,2,11,5,167,527,356,1768,0,0
390,800,164,965,687,2,11,5,165,523,357,1768,0,0
391,799,169,962,691,2,11,5,163,522,358,1768,0,0
392,798,172,959,687,2,11,5,161,515,359,1768,0,0
393,796,165,958,689,2,11,5,162,524,360,1768,0,0
394,793,162,956,691,2,11,5,163,529,361,1768,0,0
395,793,162,954,694,2,11,5,161,532,362,1768,0,0
396,791,170,948,688,2,11,5,157,518,363,1768,0,0
397,790,165,946,686,2,11,5,156,521,364,1768,0,0
398,790,166,945,687,2,11,5,155,521,365,1768,0,0
399,790,167,946,688,2,11,5,156,521,366,1768,0,0
400,791,161,948,691,2,11,5,157,530,367,1768,0,0
401,794,167,948,685,2,11,5,154,518,368,1768,0,0
402,796,162,950,686,2,11,5,154,524,369,1768,0,0
403,797,166,950,682,2,11,5,153,516,370,1768,0,0
404,796,161,950,686,2,11,5,154,525,371,1768,0,0
405,796,160,949,688,2,11,5,153,528,372,1768,0,0
406,795,166,946,688,2,11,5,151,522,373,1768,0,0
407,795,170,945,689,2,11,5,150,519,374,1768,0,0
408,794,173,943,689,2,11,5,149,516,375,1768,0,0
409,792,167,943,691,2,11,5,151,524,376,1768,0,0
410,792,161,943,692,2,11,5,151,531,377,1768,0,0
411,792,154,945,688,2,11,5,153,534,378,1768,0,0
412,794,157,945,688,2,11,5,151,531,379,1768,0,0
413,796,162,945,686,2,11,5,149,524,380,1768,0,0
414,797,166,946,684,2,11,5,149,518,381,1768,0,0
415,796,166,945,682,2,11,5,149,516,382,1768,0,0
416,796,167,946,686,2,11,5,150,519,383,1768,0,0
417,796,167,947,688,2,11,5,151,521,384,1768,0,0
418,797,167,947,686,2,11,5,150,519,385,1768,0,0
419,796,167,946,686,2,11,5,150,519,386,1768,0,0
420,796,167,946,686,2,11,5,150,519,387,1768,0,0
421,794,158,947,686,2,11,5,153,528,388,1768,0,0
422,795,150,949,687,2,11,5,154,537,389,1768,0,0
423,799,149,954,681,2,11,5,155,532,390,1768,0,0
424,793,140,949,682,2,11,5,156,542,391,1768,0,0
425,787,130,942,674,2,11,5,155,544,392,1768,0,0
426,785,123,938,662,2,11,5,153,539,393,1768,0,0
427,788,131,937,659,2,11,5,149,528,394,1768,0,0
428,786,138,936,663,2,11,5,150,525,395,1768,0,0
429,786,138,937,666,2,11,5,151,528,396,1768,0,0
430,786,139,938,664,2,11,5,152,525,397,1768,0,0
431,789,143,939,657,2,11,5,150,514,398,1768,0,0
432,792,151,942,663,2,11,5,150,512,399,1768,0,0
433,786,157,936,662,2,11,5,150,505,400,1768,0,0
434,787,146,942,665,2,11,5,155,519,401,1768,0,0
435,789,153,946,676,2,11,5,157,523,402,1768,0,0
436,785,154,942,675,2,11,5,157,521,403,1768,0,0
437,788,156,947,684,2,11,5,159,528,404,1768,0,0
438,787,155,946,679,2,11,5,159,524,405,1768,0,0
439,784,151,944,675,2,11,5,160,524,406,1768,0,0
440,783,149,943,673,2,11,5,160,524,407,1768,0,0
441,783,157,943,680,2,11,5,160,523,408,1768,0,0
442,784,160,943,683,2,11,5,159,523,409,1768,0,0
443,784,161,943,684,2,11,5,159,523,410,1768,0,0
444,781,155,942,681,2,11,5,161,526,411,1768,0,0
445,783,157,945,686,2,11,5,162,529,412,1768,0,0
446,782,152,944,677,2,11,5,162,525,413,1768,0,0
447,782,150,943,674,2,11,5,161,524,414,1768,0,0
448,781,150,943,674,2,11,5,162,524,415,1768,0,0
449,781,149,944,674,2,11,5,163,525,416,1768,0,0
450,784,152,948,682,2,11,5,164,530,417,1768,0,0
451,784,153,948,684,2,11,5,164,531,418,1768,0,0
452,785,155,949,685,2,11,5,164,530,419,1768,0,0
453,784,160,946,686,2,11,5,162,526,420,1768,0,0
454,787,151,949,677,2,11,5,162,526,421,1768,0,0
455,791,154,950,675,2,11,5,159,521,422,1768,0,0
456,789,158,945,673,2,11,5,156,515,423,1768,0,0
457,788,158,940,667,2,11,5,152,509,424,1768,0,0
458,785,155,935,664,2,11,5,150,509,425,1768,0,0
459,787,166,935,669,2,11,5,148,503,426,1768,0,0
460,789,163,939,670,2,11,5,150,507,427,1768,0,0
461,793,161,946,676,2,11,5,153,515,428,1768,0,0
462,798,166,951,678,2,11,5,153,512,429,1768,0,0
463,800,167,954,680,2,11,5,154,513,430,1768,0,0
464,802,162,960,688,2,11,5,158,526,431,1768,0,0
465,802,165,958,682,2,11,5,156,517,432,1768,0,0
466,800,162,958,677,2,11,5,158,515,433,1768,0,0
467,798,161,958,675,2,11,5,160,514,434,1768,0,0
468,797,164,960,686,2,11,5,163,522,435,1768,0,0
469,796,167,957,681,2,11,5,161,514,436,1768,0,0
470,795,165,958,678,2,11,5,163,513,437,1768,0,0
471,798,167,960,673,2,11,5,162,506,438,1768,0,0
472,798,168,960,673,2,11,5,162,505,439,1768,0,0
473,797,168,960,673,2,11,5,163,505,440,1768,0,0
474,796,163,961,671,2,11,5,165,508,441,1768,0,0
475,796,165,962,673,2,11,5,166,508,442,1768,0,0
476,794,170,958,675,2,11,5,164,505,443,1768,0,0
477,794,168,960,675,2,11,5,166,507,444,1768,0,0
478,793,167,961,677,2,11,5,168,510,445,1768,0,0
479,793,171,959,678,2,11,5,166,507,446,1768,0,0
480,792,172,958,680,2,11,5,166,508,447,1768,0,0
481,791,164,958,676,2,11,5,167,512,448,1768,0,0
482,790,161,958,675,2,11,5,168,514,449,1768,0,0
483,790,160,957,674,2,11,5,167,514,450,1768,0,0
484,790,159,958,674,2,11,5,168,515,451,1768,0,0
485,789,159,957,674,2,11,5,168,515,452,1768,0,0
486,789,161,955,671,2,11,5,166,510,453,1768,0,0
487,789,162,955,670,2,11,5,166,508,454,1768,0,0
488,789,162,954,669,2,11,5,165,507,455,1768,0,0
489,789,162,954,669,2,11,5,165,507,456,1768,0,0
490,789,162,954,669,2,11,5,165,507,457,1768,0,0
491,791,162,957,672,2,11,5,166,510,458,1768,0,0
492,792,169,956,676,2,11,5,164,507,459,1768,0,0
493,793,165,958,674,2,11,5,165,509,460,1768,0,0
494,793,163,959,673,2,11,5,166,510,461,1768,0,0
495,792,163,959,673,2,11,5,167,510,462,1768,0,0
496,792,161,958,671,2,11,5,166,510,463,1768,0,0
497,792,160,958,671,2,11,5,166,511,464,1768,0,0
498,791,160,958,671,2,11,5,167,511,465,1768,0,0
499,792,160,958,670,2,11,5,166,510,466,1768,0,0
500,792,160,958,670,2,11,5,166,510,467,1768,0,0
501,791,161,957,673,2,11,5,166,512,468,1768,0,0
502,790,161,957,674,2,11,5,167,513,469,1768,0,0
503,790,161,956,675,2,11,5,166,514,470,1768,0,0
504,789,161,956,675,2,11,5,167,514,471,1768,0,0
505,790,162,956,675,2,11,5,166,513,472,1768,0,0
506,790,160,956,674,2,11,5,166,514,473,1768,0,0
507,790,160,956,674,2,11,5,166,514,474,1768,0,0
508,790,159,956,675,2,11,5,166,516,475,1768,0,0
509,790,157,957,675,2,11,5,167,518,476,1768,0,0
510,792,168,955,677,2,11,5,163,509,477,1768,0,0
511,792,174,954,679,2,11,5,162,505,478,1768,0,0
512,793,176,953,679,2,11,5,160,503,479,1768,0,0
513,793,177,952,678,2,11,5,159,501,480,1768,0,0
514,793,177,951,679,2,11,5,158,502,481,1768,0,0
515,794,176,951,679,2,11,5,157,503,482,1768,0,0
516,792,164,953,677,2,11,5,161,513,483,1768,0,0
517,791,160,954,676,2,11,5,163,516,484,1768,0,0
518,791,158,954,675,2,11,5,163,517,485,1768,0,0
519,791,158,955,675,2,11,5,164,517,486,1768,0,0
520,790,157,955,674,2,11,5,165,517,487,1768,0,0
521,792,160,955,673,2,11,5,163,513,488,1768,0,0
522,792,162,956,672,2,11,5,164,510,489,1768,0,0
523,793,170,954,674,2,11,5,161,504,490,1768,0,0
524,793,173,954,676,2,11,5,161,503,491,1768,0,0
525,794,174,954,676,2,11,5,160,502,492,1768,0,0
526,793,164,956,672,2,11,5,163,508,493,1768,0,0
527,793,160,957,671,2,11,5,164,511,494,1768,0,0
528,793,159,958,671,2,11,5,165,512,495,1768,0,0
529,794,167,956,672,2,11,5,162,505,496,1768,0,0
530,795,170,956,673,2,11,5,161,503,497,1768,0,0
531,792,165,956,677,2,11,5,164,512,498,1768,0,0
532,791,162,956,679,2,11,5,165,517,499,1768,0,0
533,790,161,956,680,2,11,5,166,519,500,1768,0,0
534,790,161,956,681,2,11,5,166,520,501,1768,0,0
535,790,161,956,680,2,11,5,166,519,502,1768,0,0
536,791,159,956,673,2,11,5,165,514,503,1768,0,0
537,793,159,957,671,2,11,5,164,512,504,1768,0,0
538,794,159,958,671,2,11,5,164,512,505,1768,0,0
539,793,159,957,670,2,11,5,164,511,506,1768,0,0
540,793,160,957,670,2,11,5,164,510,507,1768,0,0
541,793,168,956,672,2,11,5,163,504,508,1768,0,0
542,794,172,955,673,2,11,5,161,501,509,1768,0,0
543,792,165,957,675,2,11,5,165,510,510,1768,0,0
544,790,167,956,677,2,11,5,166,510,511,1768,0,0
545,789,164,957,678,2,11,5,168,514,512,1768,0,0
546,791,163,958,674,2,11,5,167,511,513,1768,0,0
547,791,163,958,673,2,11,5,167,510,514,1768,0,0
548,793,163,959,672,2,11,5,166,509,515,1768,0,0
549,792,163,958,672,2,11,5,166,509,516,1768,0,0
550,792,163,958,671,2,11,5,166,508,517,1768,0,0
551,791,159,957,671,2,11,5,166,512,518,1768,0,0
552,791,157,958,671,2,11,5,167,514,519,1768,0,0
553,790,156,958,671,2,11,5,168,515,520,1768,0,0
554,790,155,957,671,2,11,5,167,516,521,1768,0,0
555,789,155,957,672,2,11,5,168,517,522,1768,0,0
556,791,166,955,675,2,11,5,164,509,523,1768,0,0
557,792,170,955,676,2,11,5,163,506,524,1768,0,0
558,792,171,954,676,2,11,5,162,505,525,1768,0,0
559,793,172,954,677,2,11,5,161,505,526,1768,0,0
560,793,173,954,676,2,11,5,161,503,527,1768,0,0
561,792,168,953,672,2,11,5,161,504,528,1768,0,0
562,792,164,954,672,2,11,5,162,508,529,1768,0,0
563,791,163,954,671,2,11,5,163,508,530,1768,0,0
564,791,162,954,672,2,11,5,163,510,531,1768,0,0
565,790,161,954,672,2,11,5,164,511,532,1768,0,0
566,789,162,951,670,2,11,5,162,508,533,1768,0,0
567,788,163,950,669,2,11,5,162,506,534,1768,0,0
568,789,162,951,668,2,11,5,162,506,535,1768,0,0
569,788,162,950,669,2,11,5,162,507,536,1768,0,0
570,789,160,951,669,2,11,5,162,509,537,1768,0,0
571,790,160,953,669,2,11,5,163,509,538,1768,0,0
572,791,159,955,670,2,11,5,164,511,539,1768,0,0
573,791,158,955,670,2,11,5,164,512,540,1768,0,0
574,791,158,955,669,2,11,5,164,511,541,1768,0,0
575,791,157,955,669,2,11,5,164,512,542,1768,0,0
576,791,160,955,669,2,11,5,164,509,543,1768,0,0
577,792,162,955,670,2,11,5,163,508,544,1768,0,0
578,792,163,955,670,2,11,5,163,507,545,1768,0,0
579,793,162,957,670,2,11,5,164,508,546,1768,0,0
580,793,161,958,669,2,11,5,165,508,547,1768,0,0
581,793,160,958,670,2,11,5,165,510,548,1768,0,0
582,794,168,957,673,2,11,5,163,505,549,1768,0,0
583,792,163,957,672,2,11,5,165,509,550,1768,0,0
584,792,161,958,672,2,11,5,166,511,551,1768,0,0
585,792,160,958,672,2,11,5,166,512,552,1768,0,0
586,790,163,954,671,2,11,5,164,508,553,1768,0,0
587,789,163,953,671,2,11,5,164,508,554,1768,0,0
588,789,163,952,670,2,11,5,163,507,555,1768,0,0
589,789,163,952,670,2,11,5,163,507,556,1768,0,0
590,789,164,951,669,2,11,5,162,505,557,1768,0,0
591,786,161,951,671,2,11,5,165,510,558,1768,0,0
592,786,159,951,672,2,11,5,165,513,559,1768,0,0
593,785,160,950,672,2,11,5,165,512,560,1768,0,0
594,786,162,950,673,2,11,5,164,511,561,1768,0,0
595,786,159,951,673,2,11,5,165,514,562,1768,0,0
596,791,168,952,673,2,11,5,161,505,563,1768,0,0
597,792,164,955,673,2,11,5,163,509,564,1768,0,0
598,793,168,955,675,2,11,5,162,507,565,1768,0,0
599,795,169,956,676,2,11,5,161,507,566,1768,0,0
600,795,171,955,676,2,11,5,160,505,567,1768,0,0
601,793,173,953,676,2,11,5,160,503,568,1768,0,0
602,793,174,952,676,2,11,5,159,502,569,1768,0,0
603,792,167,954,675,2,11,5,162,508,570,1768,0,0
604,791,161,951,663,2,11,5,160,502,571,1768,0,0
605,786,157,948,663,2,11,5,162,506,572,1768,0,0
606,782,161,942,654,2,11,5,160,493,573,1768,0,0
607,781,169,940,652,2,11,5,159,483,574,1768,0,0
608,783,167,942,643,2,11,5,159,476,575,1768,0,0
609,778,167,939,644,2,11,5,161,477,576,1768,0,0
610,772,156,938,649,2,11,5,166,493,577,1768,0,0
611,766,153,930,647,2,11,5,164,494,578,1768,0,0
612,755,154,916,642,2,11,5,161,488,579,1768,0,0
613,747,149,913,652,2,11,5,166,503,580,1768,0,0
614,744,150,906,646,2,11,5,162,496,581,1768,0,0
615,744,151,906,647,2,11,5,162,496,582,1768,0,0
616,744,148,911,661,2,11,5,167,513,583,1768,0,0
617,746,149,913,668,2,11,5,167,519,584,1768,0,0
618,750,148,917,665,2,11,5,167,517,585,1768,0,0
619,760,143,927,662,2,11,5,167,519,586,1768,0,0
620,766,150,929,663,2,11,5,163,513,587,1768,0,0
621,767,148,930,661,2,11,5,163,513,588,1768,0,0
622,768,151,931,662,2,11,5,163,511,589,1768,0,0
623,770,147,934,664,2,11,5,164,517,590,1768,0,0
624,768,148,933,664,2,11,5,165,516,591,1768,0,0
625,767,147,931,661,2,11,5,164,514,592,1768,0,0
626,765,148,927,659,2,11,5,162,511,593,1768,0,0
627,764,149,928,670,2,11,5,164,521,594,1768,0,0
628,763,149,927,676,2,11,5,164,527,595,1768,0,0
629,763,149,927,677,2,11,5,164,528,596,1768,0,0
630,763,147,924,667,2,11,5,161,520,597,1768,0,0
631,761,144,922,668,2,11,5,161,524,598,1768,0,0
632,761,143,921,668,2,11,5,160,525,599,1768,0,0
633,761,142,922,668,2,11,5,161,526,600,1768,0,0
634,761,143,921,666,2,11,5,160,523,601,1768,0,0
635,762,143,920,666,2,11,5,158,523,602,1768,0,0
636,767,147,921,655,2,11,5,154,508,603,1768,0,0
637,768,147,921,651,2,11,5,153,504,604,1768,0,0
638,770,149,922,649,2,11,5,152,500,605,1768,0,0
639,771,145,926,654,2,11,5,155,509,606,1768,0,0
640,771,143,928,655,2,11,5,157,512,607,1768,0,0
641,770,144,928,656,2,11,5,158,512,608,1768,0,0
642,769,148,928,659,2,11,5,159,511,609,1768,0,0
643,769,150,928,661,2,11,5,159,511,610,1768,0,0
644,769,153,926,663,2,11,5,157,510,611,1768,0,0
645,770,149,928,657,2,11,5,158,508,612,1768,0,0
646,768,149,927,661,2,11,5,159,512,613,1768,0,0
647,768,149,925,657,2,11,5,157,508,614,1768,0,0
648,767,145,925,655,2,11,5,158,510,615,1768,0,0
649,767,144,925,655,2,11,5,158,511,616,1768,0,0
650,767,143,924,654,2,11,5,157,511,617,1768,0,0
651,768,143,927,659,2,11,5,159,516,618,1768,0,0
652,767,146,928,664,2,11,5,161,518,619,1768,0,0
653,766,146,926,664,2,11,5,160,518,620,1768,0,0
654,763,149,923,662,2,11,5,160,513,621,1768,0,0
655,763,147,924,663,2,11,5,161,516,622,1768,0,0
656,763,149,922,666,2,11,5,159,517,623,1768,0,0
657,763,150,921,667,2,11,5,158,517,624,1768,0,0
658,764,152,923,670,2,11,5,159,518,625,1768,0,0
659,766,149,921,655,2,11,5,155,506,626,1768,0,0
660,766,151,922,661,2,11,5,156,510,627,1768,0,0
661,766,148,924,662,2,11,5,158,514,628,1768,0,0
662,767,150,923,664,2,11,5,156,514,629,1768,0,0
663,767,146,925,664,2,11,5,158,518,630,1768,0,0
664,767,143,926,664,2,11,5,159,521,631,1768,0,0
665,767,142,927,664,2,11,5,160,522,632,1768,0,0
666,767,147,926,664,2,11,5,159,517,633,1768,0,0
667,767,148,926,665,2,11,5,159,517,634,1768,0,0
668,767,150,925,664,2,11,5,158,514,635,1768,0,0
669,766,152,924,664,2,11,5,158,512,636,1768,0,0
670,765,154,923,664,2,11,5,158,510,637,1768,0,0
671,766,153,922,667,2,11,5,156,514,638,1768,0,0
672,762,149,919,669,2,11,5,157,520,639,1768,0,0
673,765,145,920,659,2,11,5,155,514,640,1768,0,0
674,766,149,919,665,2,11,5,153,516,641,1768,0,0
675,767,151,918,667,2,11,5,151,516,642,1768,0,0
676,766,150,917,664,2,11,5,151,514,643,1768,0,0
677,765,150,916,662,2,11,5,151,512,644,1768,0,0
678,765,148,918,662,2,11,5,153,514,645,1768,0,0
679,765,148,918,661,2,11,5,153,513,646,1768,0,0
680,765,147,918,661,2,11,5,153,514,647,1768,0,0
681,767,151,919,663,2,11,5,152,512,648,1768,0,0
682,768,153,918,665,2,11,5,150,512,649,1768,0,0
683,769,152,918,665,2,11,5,149,513,650,1768,0,0
684,767,147,918,665,2,11,5,151,518,651,1768,0,0
685,766,146,918,663,2,11,5,152,517,652,1768,0,0
686,771,148,919,653,2,11,5,148,505,653,1768,0,0
687,772,149,919,648,2,11,5,147,499,654,1768,0,0
688,770,149,920,658,2,11,5,150,509,655,1768,0,0
689,769,149,920,661,2,11,5,151,512,656,1768,0,0
690,768,147,918,656,2,11,5,150,509,657,1768,0,0
691,764,145,917,661,2,11,5,153,516,658,1768,0,0
692,763,145,916,662,2,11,5,153,517,659,1768,0,0
693,762,144,916,663,2,11,5,154,519,660,1768,0,0
694,762,143,917,663,2,11,5,155,520,661,1768,0,0
695,766,143,921,662,2,11,5,155,519,662,1768,0,0
696,767,139,922,660,2,11,5,155,521,663,1768,0,0
697,766,137,923,659,2,11,5,157,522,664,1768,0,0
698,767,136,924,659,2,11,5,157,523,665,1768,0,0
699,765,138,923,664,2,11,5,158,526,666,1768,0,0
700,765,138,923,665,2,11,5,158,527,667,1768,0,0
701,764,143,919,660,2,11,5,155,517,668,1768,0,0
702,766,148,918,665,2,11,5,152,517,669,1768,0,0
703,767,148,920,670,2,11,5,153,522,670,1768,0,0
704,767,147,921,671,2,11,5,154,524,671,1768,0,0
705,769,150,919,668,2,11,5,150,518,672,1768,0,0
706,768,143,918,660,2,11,5,150,517,673,1768,0,0
707,766,141,917,658,2,11,5,151,517,674,1768,0,0
708,766,139,916,657,2,11,5,150,518,675,1768,0,0
709,765,132,917,658,2,11,5,152,526,676,1768,0,0
710,765,133,917,658,2,11,5,152,525,677,1768,0,0
711,769,140,920,658,2,11,5,151,518,678,1768,0,0
712,766,141,919,665,2,11,5,153,524,679,1768,0,0
713,765,145,918,666,2,11,5,153,521,680,1768,0,0
714,768,149,917,659,2,11,5,149,510,681,1768,0,0
715,765,142,919,666,2,11,5,154,524,682,1768,0,0
716,766,144,920,668,2,11,5,154,524,683,1768,0,0
717,768,149,919,660,2,11,5,151,511,684,1768,0,0
718,767,146,920,664,2,11,5,153,518,685,1768,0,0
719,771,150,922,659,2,11,5,151,509,686,1768,0,0
720,772,148,923,656,2,11,5,151,508,687,1768,0,0
721,772,149,922,648,2,11,5,150,499,688,1768,0,0
722,770,151,922,656,2,11,5,152,505,689,1768,0,0
723,769,151,924,661,2,11,5,155,510,690,1768,0,0
724,769,150,921,663,2,11,5,152,513,691,1768,0,0
725,772,149,923,653,2,11,5,151,504,692,1768,0,0
726,770,145,923,664,2,11,5,153,519,693,1768,0,0
727,770,143,924,668,2,11,5,154,525,694,1768,0,0
728,769,142,921,669,2,11,5,152,527,695,1768,0,0
729,770,143,920,670,2,11,5,150,527,696,1768,0,0
730,766,139,918,671,2,11,5,152,532,697,1768,0,0
731,767,137,921,669,2,11,5,154,532,698,1768,0,0
732,768,138,922,668,2,11,5,154,530,699,1768,0,0
733,767,137,921,668,2,11,5,154,531,700,1768,0,0
734,768,142,922,675,2,11,5,154,533,701,1768,0,0
735,769,144,920,668,2,11,5,151,524,702,1768,0,0
736,770,148,920,667,2,11,5,150,519,703,1768,0,0
737,770,151,920,667,2,11,5,150,516,704,1768,0,0
738,770,151,922,667,2,11,5,152,516,705,1768,0,0
739,770,152,923,668,2,11,5,153,516,706,1768,0,0
740,770,148,923,663,2,11,5,153,515,707,1768,0,0
741,769,151,920,665,2,11,5,151,514,708,1768,0,0
742,769,151,920,667,2,11,5,151,516,709,1768,0,0
743,769,151,921,666,2,11,5,152,515,710,1768,0,0
744,770,151,919,660,2,11,5,149,509,711,1768,0,0
745,770,153,918,663,2,11,5,148,510,712,1768,0,0
746,768,146,919,662,2,11,5,151,516,713,1768,0,0
747,766,143,920,669,2,11,5,154,526,714,1768,0,0
748,772,145,925,666,2,11,5,153,521,715,1768,0,0
749,773,145,927,666,2,11,5,154,521,716,1768,0,0
750,771,143,924,663,2,11,5,153,520,717,1768,0,0
751,767,141,920,663,2,11,5,153,522,718,1768,0,0
752,765,141,918,662,2,11,5,153,521,719,1768,0,0
753,767,139,920,661,2,11,5,153,522,720,1768,0,0
754,767,139,920,661,2,11,5,153,522,721,1768,0,0
755,768,138,920,658,2,11,5,152,520,722,1768,0,0
756,769,140,920,658,2,11,5,151,518,723,1768,0,0
757,770,142,920,659,2,11,5,150,517,724,1768,0,0
758,771,143,920,658,2,11,5,149,515,725,1768,0,0
759,772,143,921,658,2,11,5,149,515,726,1768,0,0
760,772,142,923,660,2,11,5,151,518,727,1768,0,0
761,772,144,924,659,2,11,5,152,515,728,1768,0,0
762,772,144,925,659,2,11,5,153,515,729,1768,0,0
763,772,145,924,658,2,11,5,152,513,730,1768,0,0
764,771,145,924,657,2,11,5,153,512,731,1768,0,0
765,771,146,924,657,2,11,5,153,511,732,1768,0,0
766,773,146,925,651,2,11,5,152,505,733,1768,0,0
767,774,147,926,650,2,11,5,152,503,734,1768,0,0
768,772,147,927,655,2,11,5,155,508,735,1768,0,0
769,773,146,927,651,2,11,5,154,505,736,1768,0,0
770,773,146,927,650,2,11,5,154,504,737,1768,0,0
771,771,148,927,658,2,11,5,156,510,738,1768,0,0
772,770,148,927,661,2,11,5,157,513,739,1768,0,0
773,769,148,928,662,2,11,5,159,514,740,1768,0,0
774,769,148,928,663,2,11,5,159,515,741,1768,0,0
775,769,149,928,663,2,11,5,159,514,742,1768,0,0
776,771,146,929,659,2,11,5,158,513,743,1768,0,0
777,769,142,929,663,2,11,5,160,521,744,1768,0,0
778,769,141,930,664,2,11,5,161,523,745,1768,0,0
779,768,146,927,664,2,11,5,159,518,746,1768,0,0
780,770,138,932,666,2,11,5,162,528,747,1768,0,0
781,769,140,926,650,2,11,5,157,510,748,1768,0,0
782,769,138,926,644,2,11,5,157,506,749,1768,0,0
783,770,143,924,636,2,11,5,154,493,750,1768,0,0
784,770,145,923,633,2,11,5,153,488,751,1768,0,0
785,769,151,922,639,2,11,5,153,488,752,1768,0,0
786,769,153,921,640,2,11,5,152,487,753,1768,0,0
787,768,152,918,637,2,11,5,150,485,754,1768,0,0
788,768,155,917,645,2,11,5,149,490,755,1768,0,0
789,771,156,916,633,2,11,5,145,477,756,1768,0,0
790,776,153,922,636,2,11,5,146,483,757,1768,0,0
791,777,153,926,642,2,11,5,149,489,758,1768,0,0
792,777,152,927,645,2,11,5,150,493,759,1768,0,0
793,777,153,927,646,2,11,5,150,493,760,1768,0,0
794,777,153,928,646,2,11,5,151,493,761,1768,0,0
795,776,149,930,650,2,11,5,154,501,762,1768,0,0
796,777,146,933,652,2,11,5,156,506,763,1768,0,0
797,777,145,934,652,2,11,5,157,507,764,1768,0,0
798,777,145,934,653,2,11,5,157,508,765,1768,0,0
799,776,145,934,653,2,11,5,158,508,766,1768,0,0
800,776,147,933,652,2,11,5,157,505,767,1768,0,0
801,775,155,928,650,2,11,5,153,495,768,1768,0,0
802,774,158,926,650,2,11,5,152,492,769,1768,0,0
803,774,155,927,653,2,11,5,153,498,770,1768,0,0
804,772,153,927,653,2,11,5,155,500,771,1768,0,0
805,772,153,927,652,2,11,5,155,499,772,1768,0,0
806,771,146,928,655,2,11,5,157,509,773,1768,0,0
807,771,144,928,655,2,11,5,157,511,774,1768,0,0
808,771,142,929,656,2,11,5,158,514,775,1768,0,0
809,771,140,930,656,2,11,5,159,516,776,1768,0,0
810,771,144,926,654,2,11,5,155,510,777,1768,0,0
811,774,149,926,650,2,11,5,152,501,778,1768,0,0
812,774,148,928,651,2,11,5,154,503,779,1768,0,0
813,774,148,928,652,2,11,5,154,504,780,1768,0,0
814,774,148,928,652,2,11,5,154,504,781,1768,0,0
815,774,148,928,652,2,11,5,154,504,782,1768,0,0
816,772,153,924,650,2,11,5,152,497,783,1768,0,0
817,772,155,923,649,2,11,5,151,494,784,1768,0,0
818,772,156,922,648,2,11,5,150,492,785,1768,0,0
819,772,156,922,648,2,11,5,150,492,786,1768,0,0
820,771,151,922,648,2,11,5,151,497,787,1768,0,0
821,771,149,923,649,2,11,5,152,500,788,1768,0,0
822,772,148,924,649,2,11,5,152,501,789,1768,0,0
823,773,148,925,650,2,11,5,152,502,790,1768,0,0
824,773,147,925,650,2,11,5,152,503,791,1768,0,0
825,773,147,924,649,2,11,5,151,502,792,1768,0,0
826,772,143,924,647,2,11,5,152,504,793,1768,0,0
827,772,143,924,646,2,11,5,152,503,794,1768,0,0
828,772,143,923,646,2,11,5,151,503,795,1768,0,0
829,771,140,923,646,2,11,5,152,506,796,1768,0,0
830,772,141,923,646,2,11,5,151,505,797,1768,0,0
831,771,145,921,646,2,11,5,150,501,798,1768,0,0
832,772,145,922,647,2,11,5,150,502,799,1768,0,0
833,772,146,922,647,2,11,5,150,501,800,1768,0,0
834,772,147,921,647,2,11,5,149,500,801,1768,0,0
835,773,147,921,647,2,11,5,148,500,802,1768,0,0
836,775,149,923,646,2,11,5,148,497,803,1768,0,0
837,776,149,924,646,2,11,5,148,497,804,1768,0,0
838,776,150,924,646,2,11,5,148,496,805,1768,0,0
839,777,150,924,646,2,11,5,147,496,806,1768,0,0
840,776,147,926,650,2,11,5,150,503,807,1768,0,0
841,775,149,924,648,2,11,5,149,499,808,1768,0,0
842,775,149,923,647,2,11,5,148,498,809,1768,0,0
843,776,149,923,647,2,11,5,147,498,810,1768,0,0
844,775,148,923,647,2,11,5,148,499,811,1768,0,0
845,774,146,922,647,2,11,5,148,501,812,1768,0,0
846,774,142,924,649,2,11,5,150,507,813,1768,0,0
847,774,140,924,650,2,11,5,150,510,814,1768,0,0
848,774,139,926,653,2,11,5,152,514,815,1768,0,0
849,774,142,926,653,2,11,5,152,511,816,1768,0,0
850,774,143,926,654,2,11,5,152,511,817,1768,0,0
851,773,147,922,648,2,11,5,149,501,818,1768,0,0
852,773,149,920,646,2,11,5,147,497,819,1768,0,0
853,773,150,920,645,2,11,5,147,495,820,1768,0,0
854,773,151,920,646,2,11,5,147,495,821,1768,0,0
855,772,150,919,646,2,11,5,147,496,822,1768,0,0
856,773,149,921,647,2,11,5,148,498,823,1768,0,0
857,774,149,922,648,2,11,5,148,499,824,1768,0,0
858,773,147,925,654,2,11,5,152,507,825,1768,0,0
859,773,144,926,655,2,11,5,153,511,826,1768,0,0
860,773,143,926,656,2,11,5,153,513,827,1768,0,0
861,773,140,927,656,2,11,5,154,516,828,1768,0,0
862,772,139,926,653,2,11,5,154,514,829,1768,0,0
863,771,139,925,653,2,11,5,154,514,830,1768,0,0
864,771,140,925,654,2,11,5,154,514,831,1768,0,0
865,771,143,922,650,2,11,5,151,507,832,1768,0,0
866,772,141,924,651,2,11,5,152,510,833,1768,0,0
867,772,140,924,651,2,11,5,152,511,834,1768,0,0
868,771,142,922,648,2,11,5,151,506,835,1768,0,0
869,772,146,920,647,2,11,5,148,501,836,1768,0,0
870,773,148,920,645,2,11,5,147,497,837,1768,0,0
871,774,148,924,651,2,11,5,150,503,838,1768,0,0
872,774,148,925,653,2,11,5,151,505,839,1768,0,0
873,774,147,926,653,2,11,5,152,506,840,1768,0,0
874,774,149,924,650,2,11,5,150,501,841,1768,0,0
875,774,148,926,653,2,11,5,152,505,842,1768,0,0
876,774,150,926,652,2,11,5,152,502,843,1768,0,0
877,775,150,926,652,2,11,5,151,502,844,1768,0,0
878,775,151,927,652,2,11,5,152,501,845,1768,0,0
879,774,152,926,652,2,11,5,152,500,846,1768,0,0
880,776,150,928,650,2,11,5,152,500,847,1768,0,0
881,774,150,925,648,2,11,5,151,498,848,1768,0,0
882,773,149,924,648,2,11,5,151,499,849,1768,0,0
883,773,149,923,647,2,11,5,150,498,850,1768,0,0
884,772,143,926,653,2,11,5,154,510,851,1768,0,0
885,773,143,926,653,2,11,5,153,510,852,1768,0,0
886,774,149,925,649,2,11,5,151,500,853,1768,0,0
887,775,148,926,649,2,11,5,151,501,854,1768,0,0
888,775,148,926,648,2,11,5,151,500,855,1768,0,0
889,775,151,925,647,2,11,5,150,496,856,1768,0,0
890,775,151,924,647,2,11,5,149,496,857,1768,0,0
891,774,151,924,647,2,11,5,150,496,858,1768,0,0
892,773,151,923,647,2,11,5,150,496,859,1768,0,0
893,773,152,923,646,2,11,5,150,494,860,1768,0,0
894,772,152,924,647,2,11,5,152,495,861,1768,0,0
895,772,151,924,647,2,11,5,152,496,862,1768,0,0
896,772,151,924,649,2,11,5,152,498,863,1768,0,0
897,773,152,924,649,2,11,5,151,497,864,1768,0,0
898,774,158,923,647,2,11,5,149,489,865,1768,0,0
899,775,159,922,647,2,11,5,147,488,866,1768,0,0
900,774,149,926,652,2,11,5,152,503,867,1768,0,0
901,774,147,927,653,2,11,5,153,506,868,1768,0,0
902,774,146,927,655,2,11,5,153,509,869,1768,0,0
903,774,146,928,655,2,11,5,154,509,870,1768,0,0
904,774,147,927,655,2,11,5,153,508,871,1768,0,0
905,774,147,927,654,2,11,5,153,507,872,1768,0,0
906,774,149,924,648,2,11,5,150,499,873,1768,0,0
907,774,149,923,646,2,11,5,149,497,874,1768,0,0
908,774,149,923,645,2,11,5,149,496,875,1768,0,0
909,774,149,923,645,2,11,5,149,496,876,1768,0,0
910,774,149,922,645,2,11,5,148,496,877,1768,0,0
911,774,151,922,645,2,11,5,148,494,878,1768,0,0
912,775,152,921,646,2,11,5,146,494,879,1768,0,0
913,774,153,920,647,2,11,5,146,494,880,1768,0,0
914,776,148,923,647,2,11,5,147,499,881,1768,0,0
915,777,145,925,646,2,11,5,148,501,882,1768,0,0
916,776,153,921,646,2,11,5,145,493,883,1768,0,0
917,776,155,920,646,2,11,5,144,491,884,1768,0,0
918,776,157,919,646,2,11,5,143,489,885,1768,0,0
919,776,158,919,646,2,11,5,143,488,886,1768,0,0
920,776,160,918,644,2,11,5,142,484,887,1768,0,0
921,775,155,919,647,2,11,5,144,492,888,1768,0,0
922,775,153,920,648,2,11,5,145,495,889,1768,0,0
923,774,152,920,648,2,11,5,146,496,890,1768,0,0
924,772,150,919,652,2,11,5,147,502,891,1768,0,0
925,771,147,918,654,2,11,5,147,507,892,1768,0,0
926,775,143,924,654,2,11,5,149,511,893,1768,0,0
927,776,142,925,655,2,11,5,149,513,894,1768,0,0
928,775,146,922,652,2,11,5,147,506,895,1768,0,0
929,775,148,921,650,2,11,5,146,502,896,1768,0,0
930,775,149,921,649,2,11,5,146,500,897,1768,0,0
931,776,148,924,655,2,11,5,148,507,898,1768,0,0
932,777,148,926,655,2,11,5,149,507,899,1768,0,0
933,778,147,928,656,2,11,5,150,509,900,1768,0,0
934,776,154,923,651,2,11,5,147,497,901,1768,0,0
935,776,156,921,649,2,11,5,145,493,902,1768,0,0
936,774,157,919,653,2,11,5,145,496,903,1768,0,0
937,772,155,919,655,2,11,5,147,500,904,1768,0,0
938,772,155,918,655,2,11,5,146,500,905,1768,0,0
939,776,153,921,650,2,11,5,145,497,906,1768,0,0
940,773,155,919,654,2,11,5,146,499,907,1768,0,0
941,774,157,918,649,2,11,5,144,492,908,1768,0,0
942,774,158,917,647,2,11,5,143,489,909,1768,0,0
943,775,158,918,647,2,11,5,143,489,910,1768,0,0
944,776,158,918,646,2,11,5,142,488,911,1768,0,0
945,776,158,918,646,2,11,5,142,488,912,1768,0,0
946,775,152,921,653,2,11,5,146,501,913,1768,0,0
947,773,152,918,653,2,11,5,145,501,914,1768,0,0
948,774,150,921,656,2,11,5,147,506,915,1768,0,0
949,775,150,923,656,2,11,5,148,506,916,1768,0,0
950,775,149,924,656,2,11,5,149,507,917,1768,0,0
951,776,146,926,656,2,11,5,150,510,918,1768,0,0
952,777,144,927,655,2,11,5,150,511,919,1768,0,0
953,776,149,923,650,2,11,5,147,501,920,1768,0,0
954,777,145,926,654,2,11,5,149,509,921,1768,0,0
955,777,143,927,655,2,11,5,150,512,922,1768,0,0
956,776,155,921,651,2,11,5,145,496,923,1768,0,0
957,776,159,919,650,2,11,5,143,491,924,1768,0,0
958,775,152,923,656,2,11,5,148,504,925,1768,0,0
959,776,158,920,652,2,11,5,144,494,926,1768,0,0
960,775,152,923,657,2,11,5,148,505,927,1768,0,0
961,775,149,924,655,2,11,5,149,506,928,1768,0,0
962,775,149,924,655,2,11,5,149,506,929,1768,0,0
963,772,152,919,653,2,11,5,147,501,930,1768,0,0
964,770,152,917,652,2,11,5,147,500,931,1768,0,0
965,774,150,920,648,2,11,5,146,498,932,1768,0,0
966,777,153,920,644,2,11,5,143,491,933,1768,0,0
967,777,154,920,643,2,11,5,143,489,934,1768,0,0
968,778,156,920,645,2,11,5,142,489,935,1768,0,0
969,778,156,920,644,2,11,5,142,488,936,1768,0,0
970,779,151,922,644,2,11,5,143,493,937,1768,0,0
971,776,151,921,647,2,11,5,145,496,938,1768,0,0
972,776,151,922,649,2,11,5,146,498,939,1768,0,0
973,776,152,922,649,2,11,5,146,497,940,1768,0,0
974,775,152,921,649,2,11,5,146,497,941,1768,0,0
975,775,148,922,650,2,11,5,147,502,942,1768,0,0
976,775,152,921,648,2,11,5,146,496,943,1768,0,0
977,775,152,921,648,2,11,5,146,496,944,1768,0,0
978,775,152,921,648,2,11,5,146,496,945,1768,0,0
979,774,150,920,648,2,11,5,146,498,946,1768,0,0
980,774,152,920,648,2,11,5,146,496,947,1768,0,0
981,777,156,920,644,2,11,5,143,488,948,1768,0,0
982,778,157,921,643,2,11,5,143,486,949,1768,0,0
983,778,157,921,643,2,11,5,143,486,950,1768,0,0
984,778,158,921,642,2,11,5,143,484,951,1768,0,0
985,778,155,922,643,2,11,5,144,488,952,1768,0,0
986,777,152,925,650,2,11,5,148,498,953,1768,0,0
987,777,150,926,652,2,11,5,149,502,954,1768,0,0
988,777,149,927,653,2,11,5,150,504,955,1768,0,0
989,776,148,927,654,2,11,5,151,506,956,1768,0,0
990,777,148,927,653,2,11,5,150,505,957,1768,0,0
991,777,153,925,648,2,11,5,148,495,958,1768,0,0
992,778,155,924,646,2,11,5,146,491,959,1768,0,0
993,778,156,924,645,2,11,5,146,489,960,1768,0,0
994,778,157,924,645,2,11,5,146,488,961,1768,0,0
995,777,156,924,646,2,11,5,147,490,962,1768,0,0
996,776,152,927,654,2,11,5,151,502,963,1768,0,0
997,775,150,928,656,2,11,5,153,506,964,1768,0,0
998,775,151,928,658,2,11,5,153,507,965,1768,0,0
999,774,151,928,659,2,11,5,154,508,966,1768,0,0
1000,774,151,928,659,2,11,5,154,508,967,1768,0,0
1001,772,154,922,652,2,11,5,150,498,968,1768,0,0
1002,775,152,925,650,2,11,5,150,498,969,1768,0,0
1003,773,154,921,649,2,11,5,148,495,970,1768,0,0
1004,772,155,919,649,2,11,5,147,494,971,1768,0,0
1005,775,153,923,649,2,11,5,148,496,972,1768,0,0
1006,776,157,922,647,2,11,5,146,490,973,1768,0,0
1007,774,151,923,653,2,11,5,149,502,974,1768,0,0
1008,773,147,924,655,2,11,5,151,508,975,1768,0,0
1009,772,149,923,653,2,11,5,151,504,976,1768,0,0
1010,772,147,924,655,2,11,5,152,508,977,1768,0,0
1011,773,144,924,649,2,11,5,151,505,978,1768,0,0
1012,772,142,922,647,2,11,5,150,505,979,1768,0,0
1013,772,141,922,647,2,11,5,150,506,980,1768,0,0
1014,772,142,922,647,2,11,5,150,505,981,1768,0,0
1015,773,142,921,647,2,11,5,148,505,982,1768,0,0
1016,773,142,922,648,2,11,5,149,506,983,1768,0,0
1017,774,141,923,649,2,11,5,149,508,984,1768,0,0
1018,774,142,922,649,2,11,5,148,507,985,1768,0,0
1019,774,143,922,649,2,11,5,148,506,986,1768,0,0
1020,774,143,922,649,2,11,5,148,506,987,1768,0,0
1021,774,139,923,648,2,11,5,149,509,988,1768,0,0
1022,774,139,923,648,2,11,5,149,509,989,1768,0,0
1023,774,142,921,648,2,11,5,147,506,990,1768,0,0
1024,775,144,922,651,2,11,5,147,507,991,1768,0,0
1025,777,147,922,647,2,11,5,145,500,992,1768,0,0
1026,775,148,920,649,2,11,5,145,501,993,1768,0,0
1027,774,148,919,651,2,11,5,145,503,994,1768,0,0
1028,775,151,918,648,2,11,5,143,497,995,1768,0,0
1029,774,151,917,650,2,11,5,143,499,996,1768,0,0
1030,775,152,917,647,2,11,5,142,495,997,1768,0,0
1031,775,154,916,645,2,11,5,141,491,998,1768,0,0
1032,776,155,915,645,2,11,5,139,490,999,1768,0,0
1033,778,150,919,645,2,11,5,141,495,1000,1768,0,0
1034,778,150,921,645,2,11,5,143,495,1001,1768,0,0
1035,777,154,919,645,2,11,5,142,491,1002,1768,0,0
1036,777,149,923,651,2,11,5,146,502,1003,1768,0,0
1037,778,148,925,652,2,11,5,147,504,1004,1768,0,0
1038,777,145,926,653,2,11,5,149,508,1005,1768,0,0
1039,776,141,927,654,2,11,5,151,513,1006,1768,0,0
1040,775,136,928,655,2,11,5,153,519,1007,1768,0,0
1041,777,147,925,652,2,11,5,148,505,1008,1768,0,0
1042,776,149,924,651,2,11,5,148,502,1009,1768,0,0
1043,775,147,924,651,2,11,5,149,504,1010,1768,0,0
1044,774,149,923,650,2,11,5,149,501,1011,1768,0,0
1045,776,153,923,650,2,11,5,147,497,1012,1768,0,0
1046,778,155,923,646,2,11,5,145,491,1013,1768,0,0
1047,778,156,923,645,2,11,5,145,489,1014,1768,0,0
1048,779,156,924,644,2,11,5,145,488,1015,1768,0,0
1049,779,156,924,644,2,11,5,145,488,1016,1768,0,0
1050,779,157,924,644,2,11,5,145,487,1017,1768,0,0
1051,776,153,922,646,2,11,5,146,493,1018,1768,0,0
1052,775,151,921,649,2,11,5,146,498,1019,1768,0,0
1053,776,145,925,650,2,11,5,149,505,1020,1768,0,0
1054,775,148,923,650,2,11,5,148,502,1021,1768,0,0
1055,774,150,921,650,2,11,5,147,500,1022,1768,0,0
1056,776,150,923,649,2,11,5,147,499,1023,1768,0,0
1057,777,150,924,649,2,11,5,147,499,1024,1768,0,0
1058,778,152,924,648,2,11,5,146,496,1025,1768,0,0
1059,776,156,922,649,2,11,5,146,493,1026,1768,0,0
1060,776,150,923,648,2,11,5,147,498,1027,1768,0,0
1061,775,143,921,636,2,11,5,146,493,1028,1768,0,0
1062,770,149,915,637,2,11,5,145,488,1029,1768,0,0
1063,766,157,912,644,2,11,5,146,487,1030,1768,0,0
1064,767,155,916,644,2,11,5,149,489,1031,1768,0,0
1065,769,148,919,637,2,11,5,150,489,1032,1768,0,0
1066,764,137,917,636,2,11,5,153,499,1033,1768,0,0
1067,753,140,904,639,2,11,5,151,499,1034,1768,0,0
1068,744,139,892,627,2,11,5,148,488,1035,1768,0,0
1069,738,130,889,630,2,11,5,151,500,1036,1768,0,0
1070,745,131,893,629,2,11,5,148,498,1037,1768,0,0
1071,755,134,901,621,2,11,5,146,487,1038,1768,0,0
1072,753,133,901,625,2,11,5,148,492,1039,1768,0,0
1073,741,133,891,623,2,11,5,150,490,1040,1768,0,0
1074,740,133,890,618,2,11,5,150,485,1041,1768,0,0
1075,742,134,891,617,2,11,5,149,483,1042,1768,0,0
1076,743,131,896,624,2,11,5,153,493,1043,1768,0,0
1077,745,132,898,625,2,11,5,153,493,1044,1768,0,0
1078,748,131,901,623,2,11,5,153,492,1045,1768,0,0
1079,748,133,900,620,2,11,5,152,487,1046,1768,0,0
1080,747,135,898,622,2,11,5,151,487,1047,1768,0,0
1081,746,133,897,621,2,11,5,151,488,1048,1768,0,0
1082,746,134,896,621,2,11,5,150,487,1049,1768,0,0
1083,748,134,898,624,2,11,5,150,490,1050,1768,0,0
1084,748,133,900,626,2,11,5,152,493,1051,1768,0,0
1085,749,132,901,626,2,11,5,152,494,1052,1768,0,0
1086,747,132,899,626,2,11,5,152,494,1053,1768,0,0
1087,747,129,900,628,2,11,5,153,499,1054,1768,0,0
1088,746,129,899,628,2,11,5,153,499,1055,1768,0,0
1089,746,129,899,630,2,11,5,153,501,1056,1768,0,0
1090,746,129,899,631,2,11,5,153,502,1057,1768,0,0
1091,747,130,900,632,2,11,5,153,502,1058,1768,0,0
1092,748,127,902,634,2,11,5,154,507,1059,1768,0,0
1093,748,126,902,635,2,11,5,154,509,1060,1768,0,0
1094,749,126,902,636,2,11,5,153,510,1061,1768,0,0
1095,750,129,903,636,2,11,5,153,507,1062,1768,0,0
1096,749,131,901,635,2,11,5,152,504,1063,1768,0,0
1097,746,130,900,643,2,11,5,154,513,1064,1768,0,0
1098,748,131,899,636,2,11,5,151,505,1065,1768,0,0
1099,748,132,899,634,2,11,5,151,502,1066,1768,0,0
1100,748,132,899,633,2,11,5,151,501,1067,1768,0,0
1101,747,130,897,627,2,11,5,150,497,1068,1768,0,0
1102,747,130,896,625,2,11,5,149,495,1069,1768,0,0
1103,747,130,896,624,2,11,5,149,494,1070,1768,0,0
1104,747,130,896,623,2,11,5,149,493,1071,1768,0,0
1105,747,130,896,623,2,11,5,149,493,1072,1768,0,0
1106,749,130,900,624,2,11,5,151,494,1073,1768,0,0
1107,750,130,901,623,2,11,5,151,493,1074,1768,0,0
1108,750,130,902,624,2,11,5,152,494,1075,1768,0,0
1109,750,130,902,624,2,11,5,152,494,1076,1768,0,0
1110,749,130,902,624,2,11,5,153,494,1077,1768,0,0
1111,748,126,904,631,2,11,5,156,505,1078,1768,0,0
1112,748,124,905,633,2,11,5,157,509,1079,1768,0,0
1113,748,124,905,633,2,11,5,157,509,1080,1768,0,0
1114,747,126,904,633,2,11,5,157,507,1081,1768,0,0
1115,748,124,905,633,2,11,5,157,509,1082,1768,0,0
1116,748,127,904,634,2,11,5,156,507,1083,1768,0,0
1117,748,129,904,634,2,11,5,156,505,1084,1768,0,0
1118,748,129,903,632,2,11,5,155,503,1085,1768,0,0
1119,749,129,903,631,2,11,5,154,502,1086,1768,0,0
1120,749,128,904,631,2,11,5,155,503,1087,1768,0,0
1121,748,127,903,630,2,11,5,155,503,1088,1768,0,0
1122,748,125,902,628,2,11,5,154,503,1089,1768,0,0
1123,748,124,902,628,2,11,5,154,504,1090,1768,0,0
1124,747,128,900,628,2,11,5,153,500,1091,1768,0,0
1125,748,124,902,630,2,11,5,154,506,1092,1768,0,0
1126,748,126,902,634,2,11,5,154,508,1093,1768,0,0
1127,749,127,903,634,2,11,5,154,507,1094,1768,0,0
1128,750,127,902,631,2,11,5,152,504,1095,1768,0,0
1129,751,127,902,627,2,11,5,151,500,1096,1768,0,0
1130,751,127,902,627,2,11,5,151,500,1097,1768,0,0
1131,751,128,903,630,2,11,5,152,502,1098,1768,0,0
1132,751,128,903,632,2,11,5,152,504,1099,1768,0,0
1133,752,128,903,632,2,11,5,151,504,1100,1768,0,0
1134,751,129,900,627,2,11,5,149,498,1101,1768,0,0
1135,752,130,901,629,2,11,5,149,499,1102,1768,0,0
1136,749,130,898,629,2,11,5,149,499,1103,1768,0,0
1137,748,130,897,629,2,11,5,149,499,1104,1768,0,0
1138,750,134,897,624,2,11,5,147,490,1105,1768,0,0
1139,751,137,896,622,2,11,5,145,485,1106,1768,0,0
1140,751,138,896,621,2,11,5,145,483,1107,1768,0,0
1141,751,132,900,630,2,11,5,149,498,1108,1768,0,0
1142,751,129,901,629,2,11,5,150,500,1109,1768,0,0
1143,750,127,902,633,2,11,5,152,506,1110,1768,0,0
1144,750,127,902,634,2,11,5,152,507,1111,1768,0,0
1145,749,127,902,635,2,11,5,153,508,1112,1768,0,0
1146,749,127,903,638,2,11,5,154,511,1113,1768,0,0
1147,750,126,902,633,2,11,5,152,507,1114,1768,0,0
1148,749,122,902,632,2,11,5,153,510,1115,1768,0,0
1149,750,123,901,629,2,11,5,151,506,1116,1768,0,0
1150,752,126,900,624,2,11,5,148,498,1117,1768,0,0
1151,751,125,904,634,2,11,5,153,509,1118,1768,0,0
1152,751,124,905,637,2,11,5,154,513,1119,1768,0,0
1153,751,124,905,638,2,11,5,154,514,1120,1768,0,0
1154,749,121,904,639,2,11,5,155,518,1121,1768,0,0
1155,750,124,905,639,2,11,5,155,515,1122,1768,0,0
1156,747,120,902,640,2,11,5,155,520,1123,1768,0,0
1157,746,118,901,637,2,11,5,155,519,1124,1768,0,0
1158,748,123,901,634,2,11,5,153,511,1125,1768,0,0
1159,748,122,900,636,2,11,5,152,514,1126,1768,0,0
1160,749,124,900,636,2,11,5,151,512,1127,1768,0,0
1161,750,128,901,639,2,11,5,151,511,1128,1768,0,0
1162,750,128,902,641,2,11,5,152,513,1129,1768,0,0
1163,751,128,903,641,2,11,5,152,513,1130,1768,0,0
1164,750,129,902,641,2,11,5,152,512,1131,1768,0,0
1165,751,131,902,640,2,11,5,151,509,1132,1768,0,0
1166,752,137,899,630,2,11,5,147,493,1133,1768,0,0
1167,750,133,900,634,2,11,5,150,501,1134,1768,0,0
1168,750,131,900,634,2,11,5,150,503,1135,1768,0,0
1169,752,137,898,627,2,11,5,146,490,1136,1768,0,0
1170,751,133,899,630,2,11,5,148,497,1137,1768,0,0
1171,748,127,900,636,2,11,5,152,509,1138,1768,0,0
1172,751,126,901,627,2,11,5,150,501,1139,1768,0,0
1173,752,128,901,623,2,11,5,149,495,1140,1768,0,0
1174,752,129,901,623,2,11,5,149,494,1141,1768,0,0
1175,753,130,902,624,2,11,5,149,494,1142,1768,0,0
1176,751,128,903,633,2,11,5,152,505,1143,1768,0,0
1177,751,129,903,636,2,11,5,152,507,1144,1768,0,0
1178,751,128,904,637,2,11,5,153,509,1145,1768,0,0
1179,751,126,904,639,2,11,5,153,513,1146,1768,0,0
1180,751,126,904,638,2,11,5,153,512,1147,1768,0,0
1181,751,130,902,633,2,11,5,151,503,1148,1768,0,0
1182,752,132,901,631,2,11,5,149,499,1149,1768,0,0
1183,752,132,901,630,2,11,5,149,498,1150,1768,0,0
1184,751,130,901,631,2,11,5,150,501,1151,1768,0,0
1185,751,128,901,631,2,11,5,150,503,1152,1768,0,0
1186,752,128,902,632,2,11,5,150,504,1153,1768,0,0
1187,750,129,901,632,2,11,5,151,503,1154,1768,0,0
1188,752,135,900,630,2,11,5,148,495,1155,1768,0,0
1189,752,135,902,633,2,11,5,150,498,1156,1768,0,0
1190,752,135,904,635,2,11,5,152,500,1157,1768,0,0
1191,752,137,903,634,2,11,5,151,497,1158,1768,0,0
1192,752,140,903,634,2,11,5,151,494,1159,1768,0,0
1193,751,141,902,632,2,11,5,151,491,1160,1768,0,0
1194,752,142,903,632,2,11,5,151,490,1161,1768,0,0
1195,751,143,903,631,2,11,5,152,488,1162,1768,0,0
1196,749,136,904,637,2,11,5,155,501,1163,1768,0,0
1197,748,131,905,639,2,11,5,157,508,1164,1768,0,0
1198,748,128,906,639,2,11,5,158,511,1165,1768,0,0
1199,746,127,903,638,2,11,5,157,511,1166,1768,0,0
1200,746,136,898,631,2,11,5,152,495,1167,1768,0,0
1201,744,124,897,630,2,11,5,153,506,1168,1768,0,0
1202,743,116,897,629,2,11,5,154,513,1169,1768,0,0
1203,741,110,896,630,2,11,5,155,520,1170,1768,0,0
1204,742,113,895,629,2,11,5,153,516,1171,1768,0,0
1205,745,125,896,642,2,11,5,151,517,1172,1768,0,0
1206,744,119,894,635,2,11,5,150,516,1173,1768,0,0
1207,745,122,892,634,2,11,5,147,512,1174,1768,0,0
1208,745,126,892,640,2,11,5,147,514,1175,1768,0,0
1209,747,130,890,633,2,11,5,143,503,1176,1768,0,0
1210,748,135,890,633,2,11,5,142,498,1177,1768,0,0
1211,751,134,892,626,2,11,5,141,492,1178,1768,0,0
1212,751,134,892,622,2,11,5,141,488,1179,1768,0,0
1213,752,135,894,626,2,11,5,142,491,1180,1768,0,0
1214,751,136,895,631,2,11,5,144,495,1181,1768,0,0
1215,749,138,894,638,2,11,5,145,500,1182,1768,0,0
1216,751,138,893,623,2,11,5,142,485,1183,1768,0,0
1217,751,140,895,626,2,11,5,144,486,1184,1768,0,0
1218,754,142,897,621,2,11,5,143,479,1185,1768,0,0
1219,753,142,896,618,2,11,5,143,476,1186,1768,0,0
1220,754,143,896,613,2,11,5,142,470,1187,1768,0,0
1221,750,141,896,619,2,11,5,146,478,1188,1768,0,0
1222,750,140,895,617,2,11,5,145,477,1189,1768,0,0
1223,751,140,896,613,2,11,5,145,473,1190,1768,0,0
1224,750,139,896,614,2,11,5,146,475,1191,1768,0,0
1225,749,139,897,617,2,11,5,148,478,1192,1768,0,0
1226,748,138,898,624,2,11,5,150,486,1193,1768,0,0
1227,748,138,898,624,2,11,5,150,486,1194,1768,0,0
1228,748,138,900,629,2,11,5,152,491,1195,1768,0,0
1229,748,138,898,626,2,11,5,150,488,1196,1768,0,0
1230,749,136,900,628,2,11,5,151,492,1197,1768,0,0
1231,752,142,900,621,2,11,5,148,479,1198,1768,0,0
1232,753,145,900,618,2,11,5,147,473,1199,1768,0,0
1233,753,147,899,617,2,11,5,146,470,1200,1768,0,0
1234,754,148,899,617,2,11,5,145,469,1201,1768,0,0
1235,751,146,899,620,2,11,5,148,474,1202,1768,0,0
1236,749,145,898,625,2,11,5,149,480,1203,1768,0,0
1237,748,143,899,628,2,11,5,151,485,1204,1768,0,0
1238,749,141,900,628,2,11,5,151,487,1205,1768,0,0
1239,749,140,900,629,2,11,5,151,489,1206,1768,0,0
1240,749,142,900,630,2,11,5,151,488,1207,1768,0,0
1241,748,144,896,622,2,11,5,148,478,1208,1768,0,0
1242,747,142,895,619,2,11,5,148,477,1209,1768,0,0
1243,746,141,895,618,2,11,5,149,477,1210,1768,0,0
1244,746,140,894,617,2,11,5,148,477,1211,1768,0,0
1245,746,139,894,616,2,11,5,148,477,1212,1768,0,0
1246,747,141,896,620,2,11,5,149,479,1213,1768,0,0
1247,745,139,895,625,2,11,5,150,486,1214,1768,0,0
1248,748,141,896,622,2,11,5,148,481,1215,1768,0,0
1249,747,136,898,626,2,11,5,151,490,1216,1768,0,0
1250,749,139,897,623,2,11,5,148,484,1217,1768,0,0
1251,748,137,896,625,2,11,5,148,488,1218,1768,0,0
1252,748,135,898,630,2,11,5,150,495,1219,1768,0,0
1253,749,133,900,632,2,11,5,151,499,1220,1768,0,0
1254,749,132,900,633,2,11,5,151,501,1221,1768,0,0
1255,749,133,899,633,2,11,5,150,500,1222,1768,0,0
1256,747,135,897,632,2,11,5,150,497,1223,1768,0,0
1257,747,136,895,628,2,11,5,148,492,1224,1768,0,0
1258,747,136,895,630,2,11,5,148,494,1225,1768,0,0
1259,749,135,897,630,2,11,5,148,495,1226,1768,0,0
1260,748,136,894,624,2,11,5,146,488,1227,1768,0,0
1261,745,137,888,616,2,11,5,143,479,1228,1768,0,0
1262,745,135,887,615,2,11,5,142,480,1229,1768,0,0
1263,744,138,883,607,2,11,5,139,469,1230,1768,0,0
1264,745,142,885,610,2,11,5,140,468,1231,1768,0,0
1265,745,142,886,611,2,11,5,141,469,1232,1768,0,0
1266,746,136,890,615,2,11,5,144,479,1233,1768,0,0
1267,748,138,892,614,2,11,5,144,476,1234,1768,0,0
1268,748,138,893,616,2,11,5,145,478,1235,1768,0,0
1269,748,137,894,617,2,11,5,146,480,1236,1768,0,0
1270,747,134,895,617,2,11,5,148,483,1237,1768,0,0
1271,747,141,893,616,2,11,5,146,475,1238,1768,0,0
1272,748,144,893,616,2,11,5,145,472,1239,1768,0,0
1273,747,144,892,616,2,11,5,145,472,1240,1768,0,0
1274,747,144,892,616,2,11,5,145,472,1241,1768,0,0
1275,747,143,893,615,2,11,5,146,472,1242,1768,0,0
1276,746,144,892,616,2,11,5,146,472,1243,1768,0,0
1277,746,144,892,616,2,11,5,146,472,1244,1768,0,0
1278,745,144,892,616,2,11,5,147,472,1245,1768,0,0
1279,744,145,892,616,2,11,5,148,471,1246,1768,0,0
1280,744,146,892,616,2,11,5,148,470,1247,1768,0,0
1281,745,144,893,616,2,11,5,148,472,1248,1768,0,0
1282,745,143,893,616,2,11,5,148,473,1249,1768,0,0
1283,744,139,893,617,2,11,5,149,478,1250,1768,0,0
1284,744,135,893,617,2,11,5,149,482,1251,1768,0,0
1285,744,139,892,617,2,11,5,148,478,1252,1768,0,0
1286,745,133,892,611,2,11,5,147,478,1253,1768,0,0
1287,744,131,890,607,2,11,5,146,476,1254,1768,0,0
1288,746,129,893,612,2,11,5,147,483,1255,1768,0,0
1289,747,128,895,616,2,11,5,148,488,1256,1768,0,0
1290,749,130,893,608,2,11,5,144,478,1257,1768,0,0
1291,750,131,893,613,2,11,5,143,482,1258,1768,0,0
1292,751,133,893,613,2,11,5,142,480,1259,1768,0,0
1293,751,133,893,615,2,11,5,142,482,1260,1768,0,0
1294,752,134,893,617,2,11,5,141,483,1261,1768,0,0
1295,753,136,892,618,2,11,5,139,482,1262,1768,0,0
1296,752,129,893,623,2,11,5,141,494,1263,1768,0,0
1297,753,130,893,623,2,11,5,140,493,1264,1768,0,0
1298,754,131,895,632,2,11,5,141,501,1265,1768,0,0
1299,758,133,895,617,2,11,5,137,484,1266,1768,0,0
1300,757,131,896,629,2,11,5,139,498,1267,1768,0,0
1301,758,131,896,625,2,11,5,138,494,1268,1768,0,0
1302,758,134,896,624,2,11,5,138,490,1269,1768,0,0
1303,757,127,898,625,2,11,5,141,498,1270,1768,0,0
1304,757,127,899,627,2,11,5,142,500,1271,1768,0,0
1305,758,128,899,625,2,11,5,141,497,1272,1768,0,0
1306,756,131,897,625,2,11,5,141,494,1273,1768,0,0
1307,756,131,896,623,2,11,5,140,492,1274,1768,0,0
1308,755,131,895,621,2,11,5,140,490,1275,1768,0,0
1309,754,131,896,622,2,11,5,142,491,1276,1768,0,0
1310,754,131,896,621,2,11,5,142,490,1277,1768,0,0
1311,756,134,896,616,2,11,5,140,482,1278,1768,0,0
1312,757,135,896,615,2,11,5,139,480,1279,1768,0,0
1313,757,135,896,614,2,11,5,139,479,1280,1768,0,0
1314,757,136,895,613,2,11,5,138,477,1281,1768,0,0
1315,757,136,895,615,2,11,5,138,479,1282,1768,0,0
1316,755,137,894,617,2,11,5,139,480,1283,1768,0,0
1317,754,137,894,617,2,11,5,140,480,1284,1768,0,0
1318,754,137,894,618,2,11,5,140,481,1285,1768,0,0
1319,754,137,894,618,2,11,5,140,481,1286,1768,0,0
1320,753,138,894,618,2,11,5,141,480,1287,1768,0,0
1321,753,136,895,620,2,11,5,142,484,1288,1768,0,0
1322,754,136,896,621,2,11,5,142,485,1289,1768,0,0
1323,754,136,897,621,2,11,5,143,485,1290,1768,0,0
1324,754,136,897,622,2,11,5,143,486,1291,1768,0,0
1325,753,136,897,622,2,11,5,144,486,1292,1768,0,0
1326,753,142,895,626,2,11,5,142,484,1293,1768,0,0
1327,752,145,894,627,2,11,5,142,482,1294,1768,0,0
1328,752,144,892,616,2,11,5,140,472,1295,1768,0,0
1329,752,145,893,624,2,11,5,141,479,1296,1768,0,0
1330,752,142,893,618,2,11,5,141,476,1297,1768,0,0
1331,752,144,893,619,2,11,5,141,475,1298,1768,0,0
1332,752,145,892,619,2,11,5,140,474,1299,1768,0,0
1333,752,145,892,619,2,11,5,140,474,1300,1768,0,0
1334,752,145,892,619,2,11,5,140,474,1301,1768,0,0
1335,753,145,892,619,2,11,5,139,474,1302,1768,0,0
1336,752,143,894,623,2,11,5,142,480,1303,1768,0,0
1337,752,144,894,624,2,11,5,142,480,1304,1768,0,0
1338,752,144,894,624,2,11,5,142,480,1305,1768,0,0
1339,752,144,894,624,2,11,5,142,480,1306,1768,0,0
1340,752,144,894,624,2,11,5,142,480,1307,1768,0,0
1341,751,143,893,620,2,11,5,142,477,1308,1768,0,0
1342,751,143,892,618,2,11,5,141,475,1309,1768,0,0
1343,751,143,892,618,2,11,5,141,475,1310,1768,0,0
1344,750,142,893,618,2,11,5,143,476,1311,1768,0,0
1345,750,142,892,617,2,11,5,142,475,1312,1768,0,0
1346,751,140,894,618,2,11,5,143,478,1313,1768,0,0
1347,751,138,894,619,2,11,5,143,481,1314,1768,0,0
1348,751,136,895,619,2,11,5,144,483,1315,1768,0,0
1349,752,133,896,619,2,11,5,144,486,1316,1768,0,0
1350,751,132,896,619,2,11,5,145,487,1317,1768,0,0
1351,750,135,894,619,2,11,5,144,484,1318,1768,0,0
1352,747,134,890,617,2,11,5,143,483,1319,1768,0,0
1353,748,137,889,614,2,11,5,141,477,1320,1768,0,0
1354,746,135,887,615,2,11,5,141,480,1321,1768,0,0
1355,746,134,887,611,2,11,5,141,477,1322,1768,0,0
1356,745,136,886,615,2,11,5,141,479,1323,1768,0,0
1357,746,137,886,616,2,11,5,140,479,1324,1768,0,0
1358,744,136,885,616,2,11,5,141,480,1325,1768,0,0
1359,745,139,881,606,2,11,5,136,467,1326,1768,0,0
1360,745,138,883,612,2,11,5,138,474,1327,1768,0,0
1361,744,133,884,616,2,11,5,140,483,1328,1768,0,0
1362,744,131,884,619,2,11,5,140,488,1329,1768,0,0
1363,746,133,885,618,2,11,5,139,485,1330,1768,0,0
1364,746,131,885,617,2,11,5,139,486,1331,1768,0,0
1365,746,132,884,615,2,11,5,138,483,1332,1768,0,0
1366,747,130,884,612,2,11,5,137,482,1333,1768,0,0
1367,747,130,884,610,2,11,5,137,480,1334,1768,0,0
1368,746,127,886,619,2,11,5,140,492,1335,1768,0,0
1369,748,128,886,614,2,11,5,138,486,1336,1768,0,0
1370,748,131,885,614,2,11,5,137,483,1337,1768,0,0
1371,748,132,884,610,2,11,5,136,478,1338,1768,0,0
1372,750,134,884,606,2,11,5,134,472,1339,1768,0,0
1373,747,131,885,617,2,11,5,138,486,1340,1768,0,0
1374,749,133,883,609,2,11,5,134,476,1341,1768,0,0
1375,748,132,884,613,2,11,5,136,481,1342,1768,0,0
1376,748,133,884,613,2,11,5,136,480,1343,1768,0,0
1377,748,133,883,613,2,11,5,135,480,1344,1768,0,0
1378,747,131,884,616,2,11,5,137,485,1345,1768,0,0
1379,748,133,883,614,2,11,5,135,481,1346,1768,0,0
1380,747,129,883,617,2,11,5,136,488,1347,1768,0,0
1381,750,137,883,613,2,11,5,133,476,1348,1768,0,0
1382,748,136,882,613,2,11,5,134,477,1349,1768,0,0
1383,750,138,882,607,2,11,5,132,469,1350,1768,0,0
1384,751,140,883,611,2,11,5,132,471,1351,1768,0,0
1385,749,137,883,612,2,11,5,134,475,1352,1768,0,0
1386,749,129,887,620,2,11,5,138,491,1353,1768,0,0
1387,750,129,888,620,2,11,5,138,491,1354,1768,0,0
1388,749,129,886,615,2,11,5,137,486,1355,1768,0,0
1389,749,128,886,614,2,11,5,137,486,1356,1768,0,0
1390,749,128,888,619,2,11,5,139,491,1357,1768,0,0
1391,748,130,884,612,2,11,5,136,482,1358,1768,0,0
1392,747,132,883,610,2,11,5,136,478,1359,1768,0,0
1393,747,132,882,610,2,11,5,135,478,1360,1768,0,0
1394,747,133,882,609,2,11,5,135,476,1361,1768,0,0
1395,747,133,882,609,2,11,5,135,476,1362,1768,0,0
1396,750,136,886,615,2,11,5,136,479,1363,1768,0,0
1397,751,137,887,617,2,11,5,136,480,1364,1768,0,0
1398,751,138,888,618,2,11,5,137,480,1365,1768,0,0
1399,751,138,888,619,2,11,5,137,481,1366,1768,0,0
1400,751,139,887,618,2,11,5,136,479,1367,1768,0,0
1401,747,135,884,616,2,11,5,137,481,1368,1768,0,0
1402,746,134,883,615,2,11,5,137,481,1369,1768,0,0
1403,746,134,883,614,2,11,5,137,480,1370,1768,0,0
1404,746,134,883,614,2,11,5,137,480,1371,1768,0,0
1405,746,134,883,614,2,11,5,137,480,1372,1768,0,0
1406,747,135,883,611,2,11,5,136,476,1373,1768,0,0
1407,747,136,882,611,2,11,5,135,475,1374,1768,0,0
1408,747,136,882,611,2,11,5,135,475,1375,1768,0,0
1409,747,136,882,611,2,11,5,135,475,1376,1768,0,0
1410,747,134,883,612,2,11,5,136,478,1377,1768,0,0
1411,746,134,882,610,2,11,5,136,476,1378,1768,0,0
1412,745,134,882,611,2,11,5,137,477,1379,1768,0,0
1413,745,132,882,611,2,11,5,137,479,1380,1768,0,0
1414,745,132,882,609,2,11,5,137,477,1381,1768,0,0
1415,747,133,884,611,2,11,5,137,478,1382,1768,0,0
1416,750,137,886,611,2,11,5,136,474,1383,1768,0,0
1417,751,138,886,611,2,11,5,135,473,1384,1768,0,0
1418,748,134,885,611,2,11,5,137,477,1385,1768,0,0
1419,747,133,884,611,2,11,5,137,478,1386,1768,0,0
1420,747,133,885,611,2,11,5,138,478,1387,1768,0,0
1421,748,134,884,606,2,11,5,136,472,1388,1768,0,0
1422,748,134,884,605,2,11,5,136,471,1389,1768,0,0
1423,748,135,884,604,2,11,5,136,469,1390,1768,0,0
1424,749,135,884,603,2,11,5,135,468,1391,1768,0,0
1425,749,135,885,603,2,11,5,136,468,1392,1768,0,0
1426,750,135,884,602,2,11,5,134,467,1393,1768,0,0
1427,748,136,884,605,2,11,5,136,469,1394,1768,0,0
1428,748,136,885,608,2,11,5,137,472,1395,1768,0,0
1429,749,136,884,604,2,11,5,135,468,1396,1768,0,0
1430,747,134,884,607,2,11,5,137,473,1397,1768,0,0
1431,746,132,884,611,2,11,5,138,479,1398,1768,0,0
1432,746,134,884,612,2,11,5,138,478,1399,1768,0,0
1433,746,134,884,612,2,11,5,138,478,1400,1768,0,0
1434,746,133,884,614,2,11,5,138,481,1401,1768,0,0
1435,746,133,884,613,2,11,5,138,480,1402,1768,0,0
1436,746,136,882,611,2,11,5,136,475,1403,1768,0,0
1437,745,137,881,610,2,11,5,136,473,1404,1768,0,0
1438,746,136,883,613,2,11,5,137,477,1405,1768,0,0
1439,746,134,884,613,2,11,5,138,479,1406,1768,0,0
1440,748,137,884,612,2,11,5,136,475,1407,1768,0,0
1441,747,136,883,611,2,11,5,136,475,1408,1768,0,0
1442,746,136,883,611,2,11,5,137,475,1409,1768,0,0
1443,747,138,883,613,2,11,5,136,475,1410,1768,0,0
1444,748,140,885,615,2,11,5,137,475,1411,1768,0,0
1445,753,144,889,610,2,11,5,136,466,1412,1768,0,0
1446,750,135,891,616,2,11,5,141,481,1413,1768,0,0
1447,749,133,892,617,2,11,5,143,484,1414,1768,0,0
1448,748,131,894,618,2,11,5,146,487,1415,1768,0,0
1449,748,131,895,618,2,11,5,147,487,1416,1768,0,0
1450,747,131,896,619,2,11,5,149,488,1417,1768,0,0
1451,749,138,896,616,2,11,5,147,478,1418,1768,0,0
1452,750,141,896,616,2,11,5,146,475,1419,1768,0,0
1453,749,142,896,616,2,11,5,147,474,1420,1768,0,0
1454,749,142,896,615,2,11,5,147,473,1421,1768,0,0
1455,749,143,896,615,2,11,5,147,472,1422,1768,0,0
1456,748,139,897,615,2,11,5,149,476,1423,1768,0,0
1457,747,139,896,615,2,11,5,149,476,1424,1768,0,0
1458,747,140,896,615,2,11,5,149,475,1425,1768,0,0
1459,748,140,897,614,2,11,5,149,474,1426,1768,0,0
1460,748,142,897,614,2,11,5,149,472,1427,1768,0,0
1461,748,146,897,615,2,11,5,149,469,1428,1768,0,0
1462,750,147,898,613,2,11,5,148,466,1429,1768,0,0
1463,749,150,895,611,2,11,5,146,461,1430,1768,0,0
1464,749,149,895,612,2,11,5,146,463,1431,1768,0,0
1465,747,148,893,613,2,11,5,146,465,1432,1768,0,0
1466,746,147,893,615,2,11,5,147,468,1433,1768,0,0
1467,745,147,893,616,2,11,5,148,469,1434,1768,0,0
1468,747,146,894,616,2,11,5,147,470,1435,1768,0,0
1469,748,147,896,617,2,11,5,148,470,1436,1768,0,0
1470,749,147,897,617,2,11,5,148,470,1437,1768,0,0
1471,749,146,899,616,2,11,5,150,470,1438,1768,0,0
1472,746,144,897,617,2,11,5,151,473,1439,1768,0,0
1473,746,143,898,616,2,11,5,152,473,1440,1768,0,0
1474,745,143,897,617,2,11,5,152,474,1441,1768,0,0
1475,746,144,898,616,2,11,5,152,472,1442,1768,0,0
1476,745,147,897,615,2,11,5,152,468,1443,1768,0,0
1477,745,147,897,616,2,11,5,152,469,1444,1768,0,0
1478,745,147,898,616,2,11,5,153,469,1445,1768,0,0
1479,745,147,898,616,2,11,5,153,469,1446,1768,0,0
1480,746,147,900,617,2,11,5,154,470,1447,1768,0,0
1481,743,145,898,617,2,11,5,155,472,1448,1768,0,0
1482,743,145,897,618,2,11,5,154,473,1449,1768,0,0
1483,743,144,897,616,2,11,5,154,472,1450,1768,0,0
1484,743,144,897,616,2,11,5,154,472,1451,1768,0,0
1485,745,145,897,612,2,11,5,152,467,1452,1768,0,0
1486,742,145,896,618,2,11,5,154,473,1453,1768,0,0
1487,742,145,896,620,2,11,5,154,475,1454,1768,0,0
1488,742,145,896,621,2,11,5,154,476,1455,1768,0,0
1489,742,144,896,622,2,11,5,154,478,1456,1768,0,0
1490,744,143,898,620,2,11,5,154,477,1457,1768,0,0
1491,745,143,898,618,2,11,5,153,475,1458,1768,0,0
1492,744,142,897,617,2,11,5,153,475,1459,1768,0,0
1493,744,142,898,617,2,11,5,154,475,1460,1768,0,0
1494,744,142,897,617,2,11,5,153,475,1461,1768,0,0
1495,745,142,898,617,2,11,5,153,475,1462,1768,0,0
1496,746,142,900,619,2,11,5,154,477,1463,1768,0,0
1497,746,142,901,621,2,11,5,155,479,1464,1768,0,0
1498,747,142,903,624,2,11,5,156,482,1465,1768,0,0
1499,746,142,903,624,2,11,5,157,482,1466,1768,0,0
1500,745,142,902,624,2,11,5,157,482,1467,1768,0,0
1501,744,143,899,622,2,11,5,155,479,1468,1768,0,0
1502,744,143,899,621,2,11,5,155,478,1469,1768,0,0
1503,744,144,897,621,2,11,5,153,477,1470,1768,0,0
1504,744,145,897,621,2,11,5,153,476,1471,1768,0,0
1505,744,144,897,621,2,11,5,153,477,1472,1768,0,0
1506,744,144,896,619,2,11,5,152,475,1473,1768,0,0
1507,744,145,895,615,2,11,5,151,470,1474,1768,0,0
1508,744,143,895,615,2,11,5,151,472,1475,1768,0,0
1509,744,143,894,614,2,11,5,150,471,1476,1768,0,0
1510,743,143,894,613,2,11,5,151,470,1477,1768,0,0
1511,742,141,895,617,2,11,5,153,476,1478,1768,0,0
1512,742,140,895,618,2,11,5,153,478,1479,1768,0,0
1513,741,140,895,619,2,11,5,154,479,1480,1768,0,0
1514,740,140,895,620,2,11,5,155,480,1481,1768,0,0
1515,740,140,895,620,2,11,5,155,480,1482,1768,0,0
1516,741,140,896,619,2,11,5,155,479,1483,1768,0,0
1517,741,140,897,619,2,11,5,156,479,1484,1768,0,0
1518,742,140,898,619,2,11,5,156,479,1485,1768,0,0
1519,742,142,898,618,2,11,5,156,476,1486,1768,0,0
1520,742,142,898,618,2,11,5,156,476,1487,1768,0,0
1521,742,143,898,616,2,11,5,156,473,1488,1768,0,0
1522,743,143,897,616,2,11,5,154,473,1489,1768,0,0
1523,742,144,897,615,2,11,5,155,471,1490,1768,0,0
1524,743,144,898,616,2,11,5,155,472,1491,1768,0,0
1525,743,145,898,616,2,11,5,155,471,1492,1768,0,0
1526,741,144,897,617,2,11,5,156,473,1493,1768,0,0
1527,741,144,896,618,2,11,5,155,474,1494,1768,0,0
1528,741,145,896,618,2,11,5,155,473,1495,1768,0,0
1529,741,145,896,618,2,11,5,155,473,1496,1768,0,0
1530,742,143,898,619,2,11,5,156,476,1497,1768,0,0
1531,744,143,899,617,2,11,5,155,474,1498,1768,0,0
1532,744,143,900,617,2,11,5,156,474,1499,1768,0,0
1533,744,141,900,616,2,11,5,156,475,1500,1768,0,0
1534,744,142,899,616,2,11,5,155,474,1501,1768,0,0
1535,744,142,898,616,2,11,5,154,474,1502,1768,0,0
1536,743,140,898,616,2,11,5,155,476,1503,1768,0,0
1537,743,140,898,616,2,11,5,155,476,1504,1768,0,0
1538,743,140,899,616,2,11,5,156,476,1505,1768,0,0
1539,743,141,899,616,2,11,5,156,475,1506,1768,0,0
1540,743,141,899,616,2,11,5,156,475,1507,1768,0,0
1541,741,142,896,616,2,11,5,155,474,1508,1768,0,0
1542,741,142,896,617,2,11,5,155,475,1509,1768,0,0
1543,741,142,897,615,2,11,5,156,473,1510,1768,0,0
1544,741,142,897,615,2,11,5,156,473,1511,1768,0,0
1545,742,143,896,610,2,11,5,154,467,1512,1768,0,0
1546,743,140,896,602,2,11,5,153,462,1513,1768,0,0
1547,746,143,893,585,2,11,5,147,442,1514,1768,0,0
1548,746,139,898,593,2,11,5,152,454,1515,1768,0,0
1549,746,137,900,594,2,11,5,154,457,1516,1768,0,0
1550,745,138,900,598,2,11,5,155,460,1517,1768,0,0
1551,745,139,901,601,2,11,5,156,462,1518,1768,0,0
1552,745,141,900,602,2,11,5,155,461,1519,1768,0,0
1553,742,139,898,602,2,11,5,156,463,1520,1768,0,0
1554,742,138,897,602,2,11,5,155,464,1521,1768,0,0
1555,742,137,897,599,2,11,5,155,462,1522,1768,0,0
1556,744,136,899,600,2,11,5,155,464,1523,1768,0,0
1557,744,135,900,601,2,11,5,156,466,1524,1768,0,0
1558,745,135,900,601,2,11,5,155,466,1525,1768,0,0
1559,744,137,899,600,2,11,5,155,463,1526,1768,0,0
1560,744,136,899,601,2,11,5,155,465,1527,1768,0,0
1561,744,139,898,599,2,11,5,154,460,1528,1768,0,0
1562,744,139,897,599,2,11,5,153,460,1529,1768,0,0
1563,744,141,897,599,2,11,5,153,458,1530,1768,0,0
1564,745,141,897,599,2,11,5,152,458,1531,1768,0,0
1565,745,144,898,602,2,11,5,153,458,1532,1768,0,0
1566,745,143,896,597,2,11,5,151,454,1533,1768,0,0
1567,745,143,896,595,2,11,5,151,452,1534,1768,0,0
1568,745,143,896,595,2,11,5,151,452,1535,1768,0,0
1569,745,141,897,595,2,11,5,152,454,1536,1768,0,0
1570,746,142,898,594,2,11,5,152,452,1537,1768,0,0
1571,748,142,898,589,2,11,5,150,447,1538,1768,0,0
1572,747,143,898,589,2,11,5,151,446,1539,1768,0,0
1573,747,141,899,587,2,11,5,152,446,1540,1768,0,0
1574,746,143,900,591,2,11,5,154,448,1541,1768,0,0
1575,746,144,899,592,2,11,5,153,448,1542,1768,0,0
1576,745,143,900,595,2,11,5,155,452,1543,1768,0,0
1577,745,143,901,597,2,11,5,156,454,1544,1768,0,0
1578,745,143,902,597,2,11,5,157,454,1545,1768,0,0
1579,746,144,902,597,2,11,5,156,453,1546,1768,0,0
1580,745,142,902,597,2,11,5,157,455,1547,1768,0,0
1581,744,137,903,599,2,11,5,159,462,1548,1768,0,0
1582,743,135,903,599,2,11,5,160,464,1549,1768,0,0
1583,744,138,898,588,2,11,5,154,450,1550,1768,0,0
1584,743,138,900,594,2,11,5,157,456,1551,1768,0,0
1585,744,139,901,597,2,11,5,157,458,1552,1768,0,0
1586,743,141,901,601,2,11,5,158,460,1553,1768,0,0
1587,743,143,901,603,2,11,5,158,460,1554,1768,0,0
1588,743,144,901,604,2,11,5,158,460,1555,1768,0,0
1589,743,144,901,604,2,11,5,158,460,1556,1768,0,0
1590,743,144,901,603,2,11,5,158,459,1557,1768,0,0
1591,745,145,899,593,2,11,5,154,448,1558,1768,0,0
1592,745,146,899,591,2,11,5,154,445,1559,1768,0,0
1593,745,146,899,591,2,11,5,154,445,1560,1768,0,0
1594,745,147,898,588,2,11,5,153,441,1561,1768,0,0
1595,745,147,898,590,2,11,5,153,443,1562,1768,0,0
1596,743,146,899,595,2,11,5,156,449,1563,1768,0,0
1597,742,146,898,595,2,11,5,156,449,1564,1768,0,0
1598,743,146,898,595,2,11,5,155,449,1565,1768,0,0
1599,743,147,897,594,2,11,5,154,447,1566,1768,0,0
1600,743,146,899,597,2,11,5,156,451,1567,1768,0,0
1601,743,143,900,598,2,11,5,157,455,1568,1768,0,0
1602,743,142,901,599,2,11,5,158,457,1569,1768,0,0
1603,743,142,901,598,2,11,5,158,456,1570,1768,0,0
1604,743,141,900,597,2,11,5,157,456,1571,1768,0,0
1605,743,142,900,597,2,11,5,157,455,1572,1768,0,0
1606,741,143,898,596,2,11,5,157,453,1573,1768,0,0
1607,741,143,897,596,2,11,5,156,453,1574,1768,0,0
1608,740,143,897,596,2,11,5,157,453,1575,1768,0,0
1609,740,143,897,596,2,11,5,157,453,1576,1768,0,0
1610,741,143,898,595,2,11,5,157,452,1577,1768,0,0
1611,744,143,901,595,2,11,5,157,452,1578,1768,0,0
1612,744,143,902,594,2,11,5,158,451,1579,1768,0,0
1613,743,144,900,594,2,11,5,157,450,1580,1768,0,0
1614,742,144,899,595,2,11,5,157,451,1581,1768,0,0
1615,744,148,898,591,2,11,5,154,443,1582,1768,0,0
1616,744,144,900,590,2,11,5,156,446,1583,1768,0,0
1617,743,143,899,590,2,11,5,156,447,1584,1768,0,0
1618,743,143,899,589,2,11,5,156,446,1585,1768,0,0
1619,742,141,899,590,2,11,5,157,449,1586,1768,0,0
1620,742,140,899,590,2,11,5,157,450,1587,1768,0,0
1621,740,145,897,596,2,11,5,157,451,1588,1768,0,0
1622,739,148,896,599,2,11,5,157,451,1589,1768,0,0
1623,739,147,896,600,2,11,5,157,453,1590,1768,0,0
1624,739,147,895,599,2,11,5,156,452,1591,1768,0,0
1625,740,148,897,600,2,11,5,157,452,1592,1768,0,0
1626,740,144,898,599,2,11,5,158,455,1593,1768,0,0
1627,742,142,900,599,2,11,5,158,457,1594,1768,0,0
1628,742,141,900,596,2,11,5,158,455,1595,1768,0,0
1629,746,143,900,580,2,11,5,154,437,1596,1768,0,0
1630,741,138,901,591,2,11,5,160,453,1597,1768,0,0
1631,742,139,904,597,2,11,5,162,458,1598,1768,0,0
1632,738,140,902,605,2,11,5,164,465,1599,1768,0,0
1633,743,142,900,592,2,11,5,157,450,1600,1768,0,0
1634,748,146,904,599,2,11,5,156,453,1601,1768,0,0
1635,750,147,906,603,2,11,5,156,456,1602,1768,0,0
1636,750,153,905,609,2,11,5,155,456,1603,1768,0,0
1637,754,154,911,625,2,11,5,157,471,1604,1768,0,0
1638,754,153,911,624,2,11,5,157,471,1605,1768,0,0
1639,754,153,911,627,2,11,5,157,474,1606,1768,0,0
1640,757,155,913,628,2,11,5,156,473,1607,1768,0,0
1641,760,153,918,628,2,11,5,158,475,1608,1768,0,0
1642,760,152,918,628,2,11,5,158,476,1609,1768,0,0
1643,758,151,918,630,2,11,5,160,479,1610,1768,0,0
1644,757,154,914,624,2,11,5,157,470,1611,1768,0,0
1645,754,152,914,629,2,11,5,160,477,1612,1768,0,0
1646,752,150,911,630,2,11,5,159,480,1613,1768,0,0
1647,754,148,914,631,2,11,5,160,483,1614,1768,0,0
1648,755,147,916,634,2,11,5,161,487,1615,1768,0,0
1649,754,150,913,630,2,11,5,159,480,1616,1768,0,0
1650,752,148,911,631,2,11,5,159,483,1617,1768,0,0
1651,753,148,912,631,2,11,5,159,483,1618,1768,0,0
1652,754,148,912,630,2,11,5,158,482,1619,1768,0,0
1653,754,148,911,629,2,11,5,157,481,1620,1768,0,0
1654,753,146,911,630,2,11,5,158,484,1621,1768,0,0
1655,753,146,911,630,2,11,5,158,484,1622,1768,0,0
1656,758,145,915,625,2,11,5,157,480,1623,1768,0,0
1657,760,147,915,620,2,11,5,155,473,1624,1768,0,0
1658,759,144,916,624,2,11,5,157,480,1625,1768,0,0
1659,759,146,914,620,2,11,5,155,474,1626,1768,0,0
1660,760,145,914,619,2,11,5,154,474,1627,1768,0,0
1661,754,139,914,632,2,11,5,160,493,1628,1768,0,0
1662,756,140,913,628,2,11,5,157,488,1629,1768,0,0
1663,755,139,910,622,2,11,5,155,483,1630,1768,0,0
1664,754,138,911,632,2,11,5,157,494,1631,1768,0,0
1665,755,140,910,627,2,11,5,155,487,1632,1768,0,0
1666,756,145,911,629,2,11,5,155,484,1633,1768,0,0
1667,756,147,911,630,2,11,5,155,483,1634,1768,0,0
1668,756,148,911,631,2,11,5,155,483,1635,1768,0,0
1669,756,148,911,630,2,11,5,155,482,1636,1768,0,0
1670,756,149,911,630,2,11,5,155,481,1637,1768,0,0
1671,757,148,911,627,2,11,5,154,479,1638,1768,0,0
1672,758,148,911,626,2,11,5,153,478,1639,1768,0,0
1673,758,146,910,626,2,11,5,152,480,1640,1768,0,0
1674,758,146,910,626,2,11,5,152,480,1641,1768,0,0
1675,758,147,909,627,2,11,5,151,480,1642,1768,0,0
1676,758,145,908,623,2,11,5,150,478,1643,1768,0,0
1677,758,145,907,621,2,11,5,149,476,1644,1768,0,0
1678,760,145,908,620,2,11,5,148,475,1645,1768,0,0
1679,761,146,909,620,2,11,5,148,474,1646,1768,0,0
1680,761,146,909,620,2,11,5,148,474,1647,1768,0,0
1681,756,146,908,629,2,11,5,152,483,1648,1768,0,0
1682,754,147,907,633,2,11,5,153,486,1649,1768,0,0
1683,754,147,907,634,2,11,5,153,487,1650,1768,0,0
1684,753,147,907,634,2,11,5,154,487,1651,1768,0,0
1685,753,147,908,634,2,11,5,155,487,1652,1768,0,0
1686,754,146,909,634,2,11,5,155,488,1653,1768,0,0
1687,754,144,909,633,2,11,5,155,489,1654,1768,0,0
1688,755,144,909,632,2,11,5,154,488,1655,1768,0,0
1689,755,144,909,632,2,11,5,154,488,1656,1768,0,0
1690,755,145,909,631,2,11,5,154,486,1657,1768,0,0
1691,756,151,905,624,2,11,5,149,473,1658,1768,0,0
1692,754,147,907,630,2,11,5,153,483,1659,1768,0,0
1693,754,151,903,625,2,11,5,149,474,1660,1768,0,0
1694,756,153,903,622,2,11,5,147,469,1661,1768,0,0
1695,756,151,903,622,2,11,5,147,471,1662,1768,0,0
1696,756,147,906,625,2,11,5,150,478,1663,1768,0,0
1697,757,150,906,624,2,11,5,149,474,1664,1768,0,0
1698,758,151,907,624,2,11,5,149,473,1665,1768,0,0
1699,758,151,906,624,2,11,5,148,473,1666,1768,0,0
1700,756,147,907,628,2,11,5,151,481,1667,1768,0,0
1701,755,147,907,631,2,11,5,152,484,1668,1768,0,0
1702,755,147,908,633,2,11,5,153,486,1669,1768,0,0
1703,755,148,908,634,2,11,5,153,486,1670,1768,0,0
1704,755,148,908,634,2,11,5,153,486,1671,1768,0,0
1705,755,149,908,634,2,11,5,153,485,1672,1768,0,0
1706,760,150,910,623,2,11,5,150,473,1673,1768,0,0
1707,763,151,911,618,2,11,5,148,467,1674,1768,0,0
1708,761,152,913,629,2,11,5,152,477,1675,1768,0,0
1709,763,149,915,625,2,11,5,152,476,1676,1768,0,0
1710,765,148,917,619,2,11,5,152,471,1677,1768,0,0
1711,758,146,915,636,2,11,5,157,490,1678,1768,0,0
1712,757,145,916,642,2,11,5,159,497,1679,1768,0,0
1713,747,142,911,662,2,11,5,164,520,1680,1768,0,0
1714,766,143,901,557,2,11,5,135,414,1681,1768,0,0
1715,757,145,908,614,2,11,5,151,469,1682,1768,0,0
1716,754,148,911,634,2,11,5,157,486,1683,1768,0,0
1717,753,147,912,639,2,11,5,159,492,1684,1768,0,0
1718,753,147,912,640,2,11,5,159,493,1685,1768,0,0
1719,753,146,912,641,2,11,5,159,495,1686,1768,0,0
1720,753,148,911,640,2,11,5,158,492,1687,1768,0,0
1721,753,146,911,638,2,11,5,158,492,1688,1768,0,0
1722,753,145,911,638,2,11,5,158,493,1689,1768,0,0
1723,753,145,911,638,2,11,5,158,493,1690,1768,0,0
1724,753,144,912,639,2,11,5,159,495,1691,1768,0,0
1725,754,145,913,640,2,11,5,159,495,1692,1768,0,0
1726,754,144,913,638,2,11,5,159,494,1693,1768,0,0
1727,755,144,913,638,2,11,5,158,494,1694,1768,0,0
1728,755,144,914,639,2,11,5,159,495,1695,1768,0,0
1729,755,143,914,639,2,11,5,159,496,1696,1768,0,0
1730,755,143,915,641,2,11,5,160,498,1697,1768,0,0
1731,756,145,912,629,2,11,5,156,484,1698,1768,0,0
1732,757,145,913,631,2,11,5,156,486,1699,1768,0,0
1733,757,144,914,633,2,11,5,157,489,1700,1768,0,0
1734,757,144,914,633,2,11,5,157,489,1701,1768,0,0
1735,757,144,914,633,2,11,5,157,489,1702,1768,0,0
1736,756,144,913,635,2,11,5,157,491,1703,1768,0,0
1737,755,144,913,635,2,11,5,158,491,1704,1768,0,0
1738,755,144,913,636,2,11,5,158,492,1705,1768,0,0
1739,755,144,913,636,2,11,5,158,492,1706,1768,0,0
1740,755,145,913,636,2,11,5,158,491,1707,1768,0,0
1741,755,145,912,634,2,11,5,157,489,1708,1768,0,0
1742,754,145,912,634,2,11,5,158,489,1709,1768,0,0
1743,754,146,912,635,2,11,5,158,489,1710,1768,0,0
1744,754,147,912,635,2,11,5,158,488,1711,1768,0,0
1745,754,147,911,635,2,11,5,157,488,1712,1768,0,0
1746,755,145,913,630,2,11,5,158,485,1713,1768,0,0
1747,755,144,913,627,2,11,5,158,483,1714,1768,0,0
1748,756,146,911,628,2,11,5,155,482,1715,1768,0,0
1749,756,145,912,627,2,11,5,156,482,1716,1768,0,0
1750,755,147,910,626,2,11,5,155,479,1717,1768,0,0
1751,755,146,911,633,2,11,5,156,487,1718,1768,0,0
1752,755,145,912,636,2,11,5,157,491,1719,1768,0,0
1753,755,143,913,640,2,11,5,158,497,1720,1768,0,0
1754,755,136,915,643,2,11,5,160,507,1721,1768,0,0
1755,755,133,916,645,2,11,5,161,512,1722,1768,0,0
1756,759,143,912,632,2,11,5,153,489,1723,1768,0,0
1757,760,147,911,628,2,11,5,151,481,1724,1768,0,0
1758,760,148,909,624,2,11,5,149,476,1725,1768,0,0
1759,757,145,911,634,2,11,5,154,489,1726,1768,0,0
1760,757,145,912,636,2,11,5,155,491,1727,1768,0,0
1761,757,146,912,636,2,11,5,155,490,1728,1768,0,0
1762,757,146,911,636,2,11,5,154,490,1729,1768,0,0
1763,757,147,911,635,2,11,5,154,488,1730,1768,0,0
1764,757,147,912,635,2,11,5,155,488,1731,1768,0,0
1765,756,147,912,636,2,11,5,156,489,1732,1768,0,0
1766,757,147,909,628,2,11,5,152,481,1733,1768,0,0
1767,757,147,908,625,2,11,5,151,478,1734,1768,0,0
1768,757,147,908,624,2,11,5,151,477,1735,1768,0,0
1769,758,148,907,623,2,11,5,149,475,1736,1768,0,0
1770,758,148,907,623,2,11,5,149,475,1737,1768,0,0
1771,760,150,909,624,2,11,5,149,474,1738,1768,0,0
1772,765,149,915,624,2,11,5,150,475,1739,1768,0,0
1773,768,148,913,604,2,11,5,145,456,1740,1768,0,0
1774,761,146,912,619,2,11,5,151,473,1741,1768,0,0
1775,759,145,914,632,2,11,5,155,487,1742,1768,0,0
1776,760,142,913,623,2,11,5,153,481,1743,1768,0,0
1777,757,139,914,633,2,11,5,157,494,1744,1768,0,0
1778,759,140,914,628,2,11,5,155,488,1745,1768,0,0
1779,759,139,914,628,2,11,5,155,489,1746,1768,0,0
1780,758,141,913,628,2,11,5,155,487,1747,1768,0,0
1781,760,145,912,622,2,11,5,152,477,1748,1768,0,0
1782,761,145,912,620,2,11,5,151,475,1749,1768,0,0
1783,761,145,912,619,2,11,5,151,474,1750,1768,0,0
1784,759,143,913,625,2,11,5,154,482,1751,1768,0,0
1785,758,143,913,623,2,11,5,155,480,1752,1768,0,0
1786,749,144,904,629,2,11,5,155,485,1753,1768,0,0
1787,739,155,891,627,2,11,5,152,472,1754,1768,0,0
1788,736,150,894,642,2,11,5,158,492,1755,1768,0,0
1789,739,151,903,670,2,11,5,164,519,1756,1768,0,0
1790,750,158,918,689,2,11,5,168,531,1757,1768,0,0
1791,764,171,932,699,2,11,5,168,528,1758,1768,0,0
1792,771,193,955,766,2,11,5,184,573,1759,1768,0,0
1793,768,211,965,822,2,11,5,197,611,1760,1768,0,0
1794,787,222,987,847,2,11,5,200,625,1761,1768,0,0
1795,810,248,1029,930,2,11,5,219,682,1762,1768,0,0
1796,842,276,1074,990,2,11,5,232,714,1763,1768,0,0
1797,888,308,1134,1034,2,11,5,246,726,1764,1768,0,0
1798,962,361,1214,1062,2,11,5,252,701,1765,1768,0,0
1799,1038,411,1287,1074,2,11,5,249,663,1766,1768,0,0
1800,1143,476,1387,1079,2,11,5,244,603,1767,1768,0,0
1801,1174,498,1418,1080,2,11,5,244,582,1768,1768,1,0
238,1876,371,1911,613,3,11,5,35,242,0,33,0,1
239,1857,349,1897,618,3,11,5,40,269,1,33,0,0
240,1844,333,1890,627,3,11,5,46,294,2,33,0,0
241,1834,317,1890,654,3,11,5,56,337,3,33,0,0
242,1822,301,1886,668,3,11,5,64,367,4,33,0,0
243,1797,296,1869,670,3,11,5,72,374,5,33,0,0
244,1764,294,1846,679,3,11,5,82,385,6,33,0,0
245,1744,292,1835,692,3,11,5,91,400,7,33,0,0
246,1713,295,1815,710,3,11,5,102,415,8,33,0,0
247,1687,298,1798,728,3,11,5,111,430,9,33,0,0
248,1637,298,1761,737,3,11,5,124,439,10,33,0,0
249,1590,300,1726,750,3,11,5,136,450,11,33,0,0
250,1562,300,1709,769,3,11,5,147,469,12,33,0,0
251,1517,312,1679,805,3,11,5,162,493,13,33,0,0
252,1483,312,1654,821,3,11,5,171,509,14,33,0,0
253,1413,317,1600,839,3,11,5,187,522,15,33,0,0
254,1357,323,1554,854,3,11,5,197,531,16,33,0,0
255,1309,327,1523,899,3,11,5,214,572,17,33,0,0
256,1246,341,1474,940,3,11,5,228,599,18,33,0,0
257,1185,343,1419,950,3,11,5,234,607,19,33,0,0
258,1079,362,1321,965,3,11,5,242,603,20,33,0,0
259,1004,359,1254,976,3,11,5,250,617,21,33,0,0
260,904,366,1173,1027,3,11,5,269,661,22,33,0,0
261,813,362,1090,1037,3,11,5,277,675,23,33,0,0
262,703,368,981,1053,3,11,5,278,685,24,33,0,0
263,599,396,882,1068,3,11,5,283,672,25,33,0,0
264,484,396,774,1066,3,11,5,290,670,26,33,0,0
265,370,408,664,1073,3,11,5,294,665,27,33,0,0
266,251,434,551,1078,3,11,5,300,644,28,33,0,0
267,120,450,420,1078,3,11,5,300,628,29,33,0,0
268,43,480,338,1078,3,11,5,295,598,30,33,0,0
269,0,544,228,1080,3,11,5,228,536,31,33,0,0
270,0,623,174,1080,3,11,5,174,457,32,33,0,0
271,0,647,96,1080,3,11,5,96,433,33,33,1,0
278,1834,902,1920,1078,4,11,5,86,176,0,0,0,0
279,1663,739,1917,1062,5,11,5,254,323,0,20,0,1
280,1565,661,1888,1071,5,11,5,323,410,1,20,0,0
281,1467,596,1844,1073,5,11,5,377,477,2,20,0,0
282,1429,523,1860,1071,5,11,5,431,548,3,20,0,0
283,1414,473,1875,1067,5,11,5,461,594,4,20,0,0
284,1413,421,1899,1057,5,11,5,486,636,5,20,0,0
285,1425,386,1915,1042,5,11,5,490,656,6,20,0,0
286,1458,351,1918,982,5,11,5,460,631,7,20,0,0
287,1494,333,1909,916,5,11,5,415,583,8,20,0,0
288,1527,319,1911,870,5,11,5,384,551,9,20,0,0
289,1584,310,1920,823,5,11,5,336,513,10,20,0,0
290,1620,306,1920,800,5,11,5,300,494,11,20,0,0
291,1651,289,1920,765,5,11,5,269,476,12,20,0,0
292,1678,282,1920,723,5,11,5,242,441,13,20,0,0
293,1698,286,1920,700,5,11,5,222,414,14,20,0,0
294,1734,290,1920,680,5,11,5,186,390,15,20,0,0
295,1760,309,1920,670,5,11,5,160,361,16,20,0,0
296,1787,311,1920,647,5,11,5,133,336,17,20,0,0
297,1805,318,1920,622,5,11,5,115,304,18,20,0,0
298,1821,352,1920,610,5,11,5,99,258,19,20,0,0
299,1835,353,1920,589,5,11,5,85,236,20,20,1,0
410,349,19,384,143,7,11,5,35,124,0,60,0,1
411,347,20,385,150,7,11,5,38,130,1,60,0,0
412,345,20,384,154,7,11,5,39,134,2,60,0,0
413,344,20,383,157,7,11,5,39,137,3,60,0,0
414,343,22,383,159,7,11,5,40,137,4,60,0,0
415,344,22,384,158,7,11,5,40,136,5,60,0,0
416,343,22,384,163,7,11,5,41,141,6,60,0,0
417,342,25,383,166,7,11,5,41,141,7,60,0,0
418,340,25,382,171,7,11,5,42,146,8,60,0,0
419,340,28,382,175,7,11,5,42,147,9,60,0,0
420,341,29,384,176,7,11,5,43,147,10,60,0,0
421,341,28,385,182,7,11,5,44,154,11,60,0,0
422,342,31,388,191,7,11,5,46,160,12,60,0,0
423,344,32,389,191,7,11,5,45,159,13,60,0,0
424,346,33,393,198,7,11,5,47,165,14,60,0,0
425,351,36,398,199,7,11,5,47,163,15,60,0,0
426,355,36,404,204,7,11,5,49,168,16,60,0,0
427,358,39,408,213,7,11,5,50,174,17,60,0,0
428,360,46,409,213,7,11,5,49,167,18,60,0,0
429,361,49,410,219,7,11,5,49,170,19,60,0,0
430,362,51,414,229,7,11,5,52,178,20,60,0,0
431,363,55,416,235,7,11,5,53,180,21,60,0,0
432,364,57,420,244,7,11,5,56,187,22,60,0,0
433,362,59,420,252,7,11,5,58,193,23,60,0,0
434,360,61,418,254,7,11,5,58,193,24,60,0,0
435,359,68,419,267,7,11,5,60,199,25,60,0,0
436,363,77,423,271,7,11,5,60,194,26,60,0,0
437,363,70,427,276,7,11,5,64,206,27,60,0,0
438,362,73,430,292,7,11,5,68,219,28,60,0,0
439,361,76,431,298,7,11,5,70,222,29,60,0,0
440,361,77,433,309,7,11,5,72,232,30,60,0,0
441,360,72,437,319,7,11,5,77,247,31,60,0,0
442,365,75,441,322,7,11,5,76,247,32,60,0,0
443,368,74,449,339,7,11,5,81,265,33,60,0,0
444,369,76,453,350,7,11,5,84,274,34,60,0,0
445,369,78,455,357,7,11,5,86,279,35,60,0,0
446,373,83,462,375,7,11,5,89,292,36,60,0,0
447,380,85,471,383,7,11,5,91,298,37,60,0,0
448,385,85,481,405,7,11,5,96,320,38,60,0,0
449,388,93,488,430,7,11,5,100,337,39,60,0,0
450,389,98,491,441,7,11,5,102,343,40,60,0,0
451,392,102,499,462,7,11,5,107,360,41,60,0,0
452,399,111,510,487,7,11,5,111,376,42,60,0,0
453,407,111,522,498,7,11,5,115,387,43,60,0,0
454,412,123,533,531,7,11,5,121,408,44,60,0,0
455,416,133,542,557,7,11,5,126,424,45,60,0,0
456,422,142,552,579,7,11,5,130,437,46,60,0,0
457,429,165,565,624,7,11,5,136,459,47,60,0,0
458,438,174,579,645,7,11,5,141,471,48,60,0,0
459,438,184,592,692,7,11,5,154,508,49,60,0,0
460,432,207,592,736,7,11,5,160,529,50,60,0,0
461,418,215,587,767,7,11,5,169,552,51,60,0,0
462,395,234,580,834,7,11,5,185,600,52,60,0,0
463,367,260,565,893,7,11,5,198,633,53,60,0,0
464,335,276,538,914,7,11,5,203,638,54,60,0,0
465,291,306,512,978,7,11,5,221,672,55,60,0,0
466,220,333,456,1023,7,11,5,236,690,56,60,0,0
467,126,358,373,1068,7,11,5,247,710,57,60,0,0
468,74,398,323,1080,7,11,5,249,682,58,60,0,0
469,39,550,236,1075,7,11,5,197,525,59,60,0,0
470,17,579,215,1080,7,11,5,198,501,60,60,1,0
1133,1356,482,1920,1051,8,11,5,564,569,0,1,0,0
1134,1336,444,1920,1049,8,11,5,584,605,1,1,0,0
1134,1632,463,1880,997,9,11,5,248,534,0,10,0,0
1135,1654,451,1878,934,9,11,5,224,483,1,10,0,0
1136,1666,448,1888,921,9,11,5,222,473,2,10,0,0
1137,1693,429,1907,886,9,11,5,214,457,3,10,0,0
1138,1726,417,1920,874,9,11,5,194,457,4,10,0,0
1139,1736,413,1920,872,9,11,5,184,459,5,10,0,0
1140,1773,446,1920,835,9,11,5,147,389,6,10,0,0
1141,1791,458,1920,800,9,11,5,129,342,7,10,0,0
1142,1798,466,1920,790,9,11,5,122,324,8,10,0,0
1143,1830,492,1920,765,9,11,5,90,273,9,10,0,0
1144,1850,501,1920,744,9,11,5,70,243,10,10,0,0
1147,1316,499,1871,1062,10,11,5,555,563,0,9,0,0
1148,1348,477,1904,1054,10,11,5,556,577,1,9,0,0
1149,1369,457,1920,1054,10,11,5,551,597,2,9,0,0
1150,1406,434,1920,1052,10,11,5,514,618,3,9,0,0
1151,1436,421,1920,1045,10,11,5,484,624,4,9,0,0
1152,1467,425,1920,1036,10,11,5,453,611,5,9,0,0
1153,1527,416,1920,998,10,11,5,393,582,6,9,0,0
1154,1570,407,1920,981,10,11,5,350,574,7,9,0,0
1155,1601,404,1920,968,10,11,5,319,564,8,9,0,0
1156,1601,381,1920,959,10,11,5,319,578,9,9,0,0
1156,1787,442,1920,918,11,11,5,133,476,0,3,0,0
1157,1794,460,1916,895,11,11,5,122,435,1,3,0,0
1158,1809,520,1908,871,11,11,5,99,351,2,3,0,0
1159,1816,549,1904,857,11,11,5,88,308,3,3,0,0
1209,4,645,281,1070,13,11,5,277,425,0,40,0,1
1210,57,622,352,1070,13,11,5,295,448,1,40,0,0
1211,141,612,442,1066,13,11,5,301,454,2,40,0,0
1212,252,605,560,1065,13,11,5,308,460,3,40,0,0
1213,354,584,679,1067,13,11,5,325,483,4,40,0,0
1214,457,565,799,1069,13,11,5,342,504,5,40,0,0
1215,541,546,897,1072,13,11,5,356,526,6,40,0,0
1216,643,525,1016,1072,13,11,5,373,547,7,40,0,0
1217,735,509,1120,1067,13,11,5,385,558,8,40,0,0
1218,817,499,1213,1065,13,11,5,396,566,9,40,0,0
1219,915,484,1317,1061,13,11,5,402,577,10,40,0,0
1220,987,475,1392,1058,13,11,5,405,583,11,40,0,0
1221,1038,453,1454,1051,13,11,5,416,598,12,40,0,0
1222,1089,434,1516,1049,13,11,5,427,615,13,40,0,0
1223,1133,440,1553,1036,13,11,5,420,596,14,40,0,0
1224,1182,434,1594,1017,13,11,5,412,583,15,40,0,0
1225,1258,429,1660,1011,13,11,5,402,582,16,40,0,0
1226,1292,422,1688,1004,13,11,5,396,582,17,40,0,0
1227,1346,407,1723,970,13,11,5,377,563,18,40,0,0
1228,1397,394,1749,927,13,11,5,352,533,19,40,0,0
1229,1430,395,1765,900,13,11,5,335,505,20,40,0,0
1230,1473,390,1794,873,13,11,5,321,483,21,40,0,0
1231,1526,393,1832,861,13,11,5,306,468,22,40,0,0
1232,1553,388,1856,854,13,11,5,303,466,23,40,0,0
1233,1590,382,1881,840,13,11,5,291,458,24,40,0,0
1234,1621,379,1892,808,13,11,5,271,429,25,40,0,0
1235,1642,376,1906,796,13,11,5,264,420,26,40,0,0
1236,1671,376,1920,776,13,11,5,249,400,27,40,0,0
1237,1707,369,1920,767,13,11,5,213,398,28,40,0,0
1238,1724,368,1920,763,13,11,5,196,395,29,40,0,0
1239,1742,358,1920,756,13,11,5,178,398,30,40,0,0
1240,1763,365,1920,730,13,11,5,157,365,31,40,0,0
1241,1772,358,1920,716,13,11,5,148,358,32,40,0,0
1242,1780,360,1920,709,13,11,5,140,349,33,40,0,0
1243,1796,357,1920,698,13,11,5,124,341,34,40,0,0
1244,1810,363,1920,694,13,11,5,110,331,35,40,0,0
1245,1822,371,1920,688,13,11,5,98,317,36,40,0,0
1246,1840,402,1920,665,13,11,5,80,263,37,40,0,0
1247,1853,443,1920,649,13,11,5,67,206,38,40,0,0
1248,1865,484,1920,635,13,11,5,55,151,39,40,0,0
1249,1881,499,1920,621,13,11,5,39,122,40,40,1,0
1292,1813,425,1920,826,15,11,5,107,401,0,12,0,0
1293,1796,408,1920,885,15,11,5,124,477,1,12,0,0
1294,1783,420,1914,910,15,11,5,131,490,2,12,0,0
1295,1735,395,1881,927,15,11,5,146,532,3,12,0,0
1296,1684,401,1848,974,15,11,5,164,573,4,12,0,0
1297,1662,405,1845,1024,15,11,5,183,619,5,12,0,0
1298,1631,422,1826,1058,15,11,5,195,636,6,12,0,0
1299,1587,440,1784,1053,15,11,5,197,613,7,12,0,0
1300,1494,462,1704,1065,15,11,5,210,603,8,12,0,0
1301,1399,474,1619,1072,15,11,5,220,598,9,12,0,0
1302,1280,478,1518,1077,15,11,5,238,599,10,12,0,0
1303,1148,525,1385,1078,15,11,5,237,553,11,12,0,0
1304,1089,535,1329,1080,15,11,5,240,545,12,12,0,0
1304,879,572,1193,1067,16,11,5,314,495,0,0,0,0
1305,577,627,932,1065,17,11,5,355,438,0,0,0,0
1306,252,632,663,1077,18,11,5,411,445,0,0,0,0
1307,16,663,401,1072,19,11,5,385,409,0,0,0,0
1689,1870,396,1919,615,20,11,5,49,219,0,32,0,1
1690,1866,386,1920,629,20,11,5,54,243,1,32,0,0
1691,1859,355,1920,656,20,11,5,61,301,2,32,0,0
1692,1857,362,1920,683,20,11,5,63,321,3,32,0,0
1693,1851,370,1920,679,20,11,5,69,309,4,32,0,0
1694,1828,367,1903,695,20,11,5,75,328,5,32,0,0
1695,1813,352,1898,710,20,11,5,85,358,6,32,0,0
1696,1803,339,1897,724,20,11,5,94,385,7,32,0,0
1697,1791,350,1892,751,20,11,5,101,401,8,32,0,0
1698,1776,358,1885,764,20,11,5,109,406,9,32,0,0
1699,1733,361,1855,779,20,11,5,122,418,10,32,0,0
1700,1697,369,1829,787,20,11,5,132,418,11,32,0,0
1701,1667,363,1809,791,20,11,5,142,428,12,32,0,0
1702,1619,365,1783,837,20,11,5,164,472,13,32,0,0
1703,1584,374,1755,848,20,11,5,171,474,14,32,0,0
1704,1507,371,1693,857,20,11,5,186,486,15,32,0,0
1705,1438,367,1641,877,20,11,5,203,510,16,32,0,0
1706,1380,368,1595,894,20,11,5,215,526,17,32,0,0
1707,1301,375,1535,940,20,11,5,234,565,18,32,0,0
1708,1241,387,1479,950,20,11,5,238,563,19,32,0,0
1709,1164,383,1411,966,20,11,5,247,583,20,32,0,0
1710,1056,398,1312,982,20,11,5,256,584,21,32,0,0
1711,965,390,1232,1006,20,11,5,267,616,22,32,0,0
1712,850,394,1133,1044,20,11,5,283,650,23,32,0,0
1713,771,411,1056,1059,20,11,5,285,648,24,32,0,0
1714,680,397,964,1061,20,11,5,284,664,25,32,0,0
1715,589,414,872,1066,20,11,5,283,652,26,32,0,0
1716,500,427,782,1068,20,11,5,282,641,27,32,0,0
1717,365,442,645,1074,20,11,5,280,632,28,32,0,0
1718,273,480,554,1077,20,11,5,281,597,29,32,0,0
1719,158,501,436,1075,20,11,5,278,574,30,32,0,0
1720,47,527,319,1073,20,11,5,272,546,31,32,0,0
1721,0,538,237,1080,20,11,5,237,542,32,32,1,0
1767,6,629,218,1067,21,11,5,212,438,0,20,0,1
1768,65,609,289,1069,21,11,5,224,460,1,20,0,0
1769,166,593,401,1074,21,11,5,235,481,2,20,0,0
1770,284,559,534,1070,21,11,5,250,511,3,20,0,0
1771,408,547,668,1072,21,11,5,260,525,4,20,0,0
1772,524,546,788,1069,21,11,5,264,523,5,20,0,0
1773,635,533,909,1073,21,11,5,274,540,6,20,0,0
1774,719,528,999,1071,21,11,5,280,543,7,20,0,0
1775,784,507,1081,1072,21,11,5,297,565,8,20,0,0
1776,856,505,1159,1072,21,11,5,303,567,9,20,0,0
1777,933,531,1233,1073,21,11,5,300,542,10,20,0,0
1778,1023,568,1314,1075,21,11,5,291,507,11,20,0,0
1779,1093,590,1384,1078,21,11,5,291,488,12,20,0,0
1780,1127,587,1434,1076,21,11,5,307,489,13,20,0,0
1781,1167,580,1490,1076,21,11,5,323,496,14,20,0,0
1782,1230,590,1558,1076,21,11,5,328,486,15,20,0,0
1783,1270,611,1598,1075,21,11,5,328,464,16,20,0,0
1784,1319,647,1641,1075,21,11,5,322,428,17,20,0,0
1785,1372,701,1676,1078,21,11,5,304,377,18,20,0,0
1786,1447,755,1730,1077,21,11,5,283,322,19,20,0,0
1787,1560,833,1799,1079,21,11,5,239,246,20,20,1,0
1789,1785,943,1920,1080,21,11,5,135,137,0,20,0,0
1801,1274,566,1647,1069,22,11,5,373,503,0,3,0,0
1802,1412,626,1742,1069,22,11,5,330,443,1,3,0,0
1803,1592,728,1848,1067,22,11,5,256,339,2,3,0,0
1804,1691,780,1907,1066,22,11,5,216,286,3,3,0,0
1835,5,707,236,1080,24,11,5,231,373,0,4,0,0
1836,117,727,339,1079,24,11,5,222,352,1,4,0,0
1837,279,803,460,1078,24,11,5,181,275,2,4,0,0
1838,430,853,582,1073,24,11,5,152,220,3,4,0,0
1839,545,894,667,1071,24,11,5,122,177,4,4,0,0
1848,1764,780,1920,1072,27,11,5,156,292,0,19,0,1
1849,1649,676,1863,1071,27,11,5,214,395,1,19,0,0
1850,1594,610,1845,1068,27,11,5,251,458,2,19,0,0
1851,1570,536,1864,1067,27,11,5,294,531,3,19,0,0
1852,1546,485,1874,1071,27,11,5,328,586,4,19,0,0
1853,1530,454,1877,1072,27,11,5,347,618,5,19,0,0
1854,1522,417,1885,1066,27,11,5,363,649,6,19,0,0
1855,1520,393,1891,1059,27,11,5,371,666,7,19,0,0
1856,1528,378,1901,1050,27,11,5,373,672,8,19,0,0
1857,1545,360,1903,1003,27,11,5,358,643,9,19,0,0
1858,1588,356,1920,957,27,11,5,332,601,10,19,0,0
1859,1617,358,1920,939,27,11,5,303,581,11,19,0,0
1860,1656,351,1920,898,27,11,5,264,547,12,19,0,0
1861,1682,336,1920,857,27,11,5,238,521,13,19,0,0
1862,1694,332,1920,834,27,11,5,226,502,14,19,0,0
1863,1715,371,1920,814,27,11,5,205,443,15,19,0,0
1864,1743,384,1920,791,27,11,5,177,407,16,19,0,0
1865,1776,422,1920,786,27,11,5,144,364,17,19,0,0
1866,1794,430,1920,774,27,11,5,126,344,18,19,0,0
1867,1806,430,1920,758,27,11,5,114,328,19,19,0,0
2075,1844,632,1919,833,28,11,5,75,201,0,13,0,0
2076,1829,602,1920,863,28,11,5,91,261,1,13,0,0
2077,1817,573,1920,895,28,11,5,103,322,2,13,0,0
2078,1784,551,1920,944,28,11,5,136,393,3,13,0,0
2079,1765,531,1920,970,28,11,5,155,439,4,13,0,0
2080,1710,515,1894,1004,28,11,5,184,489,5,13,0,0
2081,1674,510,1882,1048,28,11,5,208,538,6,13,0,0
2082,1657,522,1874,1069,28,11,5,217,547,7,13,0,0
2083,1631,563,1844,1079,28,11,5,213,516,8,13,0,0
2084,1598,597,1812,1080,28,11,5,214,483,9,13,0,0
2085,1563,661,1769,1080,28,11,5,206,419,10,13,0,0
2086,1546,742,1733,1080,28,11,5,187,338,11,13,0,0
2087,1612,858,1757,1080,28,11,5,145,222,12,13,0,0
2088,1607,886,1744,1080,28,11,5,137,194,13,13,0,0
2121,1703,848,1917,1074,29,11,5,214,226,0,16,0,0
2122,1583,703,1920,1062,29,11,5,337,359,1,16,0,0
2123,1515,630,1920,1062,29,11,5,405,432,2,16,0,0
2124,1436,556,1915,1067,29,11,5,479,511,3,16,0,0
2125,1414,500,1920,1064,29,11,5,506,564,4,16,0,0
2126,1401,460,1920,1063,29,11,5,519,603,5,16,0,0
2127,1431,424,1920,1036,29,11,5,489,612,6,16,0,0
2128,1456,399,1920,1019,29,11,5,464,620,7,16,0,0
2129,1516,375,1920,951,29,11,5,404,576,8,16,0,0
2130,1561,358,1920,892,29,11,5,359,534,9,16,0,0
2131,1588,353,1920,864,29,11,5,332,511,10,16,0,0
2132,1629,327,1920,813,29,11,5,291,486,11,16,0,0
2133,1661,322,1920,792,29,11,5,259,470,12,16,0,0
2134,1694,315,1920,759,29,11,5,226,444,13,16,0,0
2135,1730,335,1920,721,29,11,5,190,386,14,16,0,0
2136,1746,335,1920,699,29,11,5,174,364,15,16,0,0
2137,1753,317,1920,675,29,11,5,167,358,16,16,0,0
2131,328,15,364,128,30,11,5,36,113,0,73,0,1
2132,327,11,364,128,30,11,5,37,117,1,73,0,0
2133,327,8,365,129,30,11,5,38,121,2,73,0,0
2134,328,9,366,130,30,11,5,38,121,3,73,0,0
2135,328,10,367,132,30,11,5,39,122,4,73,0,0
2136,328,11,367,134,30,11,5,39,123,5,73,0,0
2137,326,11,366,136,30,11,5,40,125,6,73,0,0
2138,325,8,367,138,30,11,5,42,130,7,73,0,0
2139,327,13,368,140,30,11,5,41,127,8,73,0,0
2140,327,11,369,145,30,11,5,42,134,9,73,0,0
2141,327,12,370,149,30,11,5,43,137,10,73,0,0
2142,326,10,371,153,30,11,5,45,143,11,73,0,0
2143,328,13,372,153,30,11,5,44,140,12,73,0,0
2144,331,15,374,154,30,11,5,43,139,13,73,0,0
2145,333,19,376,158,30,11,5,43,139,14,73,0,0
2146,331,18,376,162,30,11,5,45,144,15,73,0,0
2147,329,18,374,163,30,11,5,45,145,16,73,0,0
2148,327,17,374,167,30,11,5,47,150,17,73,0,0
2149,327,17,375,169,30,11,5,48,152,18,73,0,0
2150,327,19,376,173,30,11,5,49,154,19,73,0,0
2151,326,23,375,178,30,11,5,49,155,20,73,0,0
2152,324,25,373,181,30,11,5,49,156,21,73,0,0
2153,320,22,371,189,30,11,5,51,167,22,73,0,0
2154,320,26,370,192,30,11,5,50,166,23,73,0,0
2155,319,26,370,193,30,11,5,51,167,24,73,0,0
2156,319,31,370,198,30,11,5,51,167,25,73,0,0
2157,316,34,367,202,30,11,5,51,168,26,73,0,0
2158,316,33,368,205,30,11,5,52,172,27,73,0,0
2159,318,31,372,210,30,11,5,54,179,28,73,0,0
2160,320,30,376,215,30,11,5,56,185,29,73,0,0
2161,322,32,378,220,30,11,5,56,188,30,73,0,0
2162,321,30,380,228,30,11,5,59,198,31,73,0,0
2163,322,33,380,229,30,11,5,58,196,32,73,0,0
2164,326,35,385,232,30,11,5,59,197,33,73,0,0
2165,329,32,391,238,30,11,5,62,206,34,73,0,0
2166,331,37,394,245,30,11,5,63,208,35,73,0,0
2167,330,41,393,251,30,11,5,63,210,36,73,0,0
2168,329,41,394,255,30,11,5,65,214,37,73,0,0
2169,329,47,395,265,30,11,5,66,218,38,73,0,0
2170,331,51,398,271,30,11,5,67,220,39,73,0,0
2171,331,55,400,279,30,11,5,69,224,40,73,0,0
2172,327,55,399,286,30,11,5,72,231,41,73,0,0
2173,320,56,394,288,30,11,5,74,232,42,73,0,0
2174,314,56,393,304,30,11,5,79,248,43,73,0,0
2175,319,59,400,311,30,11,5,81,252,44,73,0,0
2176,321,64,407,328,30,11,5,86,264,45,73,0,0
2177,320,71,407,341,30,11,5,87,270,46,73,0,0
2178,315,70,405,346,30,11,5,90,276,47,73,0,0
2179,316,73,410,362,30,11,5,94,289,48,73,0,0
2180,318,73,416,371,30,11,5,98,298,49,73,0,0
2181,317,73,422,388,30,11,5,105,315,50,73,0,0
2182,316,80,428,416,30,11,5,112,336,51,73,0,0
2183,318,81,434,427,30,11,5,116,346,52,73,0,0
2184,327,87,446,438,30,11,5,119,351,53,73,0,0
2185,337,93,460,456,30,11,5,123,363,54,73,0,0
2186,345,90,474,469,30,11,5,129,379,55,73,0,0
2187,349,102,486,501,30,11,5,137,399,56,73,0,0
2188,353,104,497,521,30,11,5,144,417,57,73,0,0
2189,357,106,507,538,30,11,5,150,432,58,73,0,0
2190,361,119,518,567,30,11,5,157,448,59,73,0,0
2191,370,126,531,580,30,11,5,161,454,60,73,0,0
2192,371,140,542,617,30,11,5,171,477,61,73,0,0
2193,363,150,547,662,30,11,5,184,512,62,73,0,0
2194,356,157,553,702,30,11,5,197,545,63,73,0,0
2195,347,177,559,759,30,11,5,212,582,64,73,0,0
2196,345,191,564,782,30,11,5,219,591,65,73,0,0
2197,325,211,563,857,30,11,5,238,646,66,73,0,0
2198,300,243,545,912,30,11,5,245,669,67,73,0,0
2199,262,259,526,980,30,11,5,264,721,68,73,0,0
2200,224,285,508,1049,30,11,5,284,764,69,73,0,0
2201,164,307,453,1076,30,11,5,289,769,70,73,0,0
2202,113,348,401,1080,30,11,5,288,732,71,73,0,0
2203,66,379,352,1080,30,11,5,286,701,72,73,0,0
2204,50,395,342,1080,30,11,5,292,685,73,73,1,0
2131,1865,370,1918,449,31,11,5,53,79,0,0,0,0
2137,1848,351,1920,664,32,11,5,72,313,0,0,0,0
2204,1,592,123,1072,33,11,5,122,480,0,0,0,0
2290,982,767,1278,1069,34,11,5,296,302,0,0,0,0
2291,726,637,1135,1071,35,11,5,409,434,0,29,0,1
2292,618,535,1121,1071,35,11,5,503,536,1,29,0,0
2293,543,475,1093,1064,35,11,5,550,589,2,29,0,0
2294,469,405,1080,1067,35,11,5,611,662,3,29,0,0
2295,403,352,1051,1070,35,11,5,648,718,4,29,0,0
2296,365,319,1019,1065,35,11,5,654,746,5,29,0,0
2297,354,274,962,988,35,11,5,608,714,6,29,0,0
2298,353,254,917,939,35,11,5,564,685,7,29,0,0
2299,386,225,879,842,35,11,5,493,617,8,29,0,0
2300,390,206,841,793,35,11,5,451,587,9,29,0,0
2301,397,180,807,734,35,11,5,410,554,10,29,0,0
2302,398,166,775,697,35,11,5,377,531,11,29,0,0
2303,409,160,748,656,35,11,5,339,496,12,29,0,0
2304,412,139,717,598,35,11,5,305,459,13,29,0,0
2305,409,124,698,576,35,11,5,289,452,14,29,0,0
2306,405,110,669,539,35,11,5,264,429,15,29,0,0
2307,398,100,644,519,35,11,5,246,419,16,29,0,0
2308,402,95,630,498,35,11,5,228,403,17,29,0,0
2309,412,88,616,459,35,11,5,204,371,18,29,0,0
2310,412,83,602,439,35,11,5,190,356,19,29,0,0
2311,406,70,584,413,35,11,5,178,343,20,29,0,0
2312,392,60,563,400,35,11,5,171,340,21,29,0,0
2313,392,69,547,384,35,11,5,155,315,22,29,0,0
2314,400,78,540,370,35,11,5,140,292,23,29,0,0
2315,395,80,525,358,35,11,5,130,278,24,29,0,0
2316,392,70,520,344,35,11,5,128,274,25,29,0,0
2317,398,63,516,323,35,11,5,118,260,26,29,0,0
2318,402,66,511,308,35,11,5,109,242,27,29,0,0
2319,400,66,506,305,35,11,5,106,239,28,29,0,0
2320,397,62,497,287,35,11,5,100,225,29,29,1,0
2322,391,65,482,278,35,11,5,91,213,0,29,0,0
2323,395,69,476,261,35,11,5,81,192,1,29,0,0
2324,398,80,472,257,35,11,5,74,177,2,29,0,0
2325,396,80,465,245,35,11,5,69,165,3,29,0,0
2328,411,78,473,223,35,11,5,62,145,0,29,0,0
2329,412,77,469,212,35,11,5,57,135,1,29,0,0
2333,430,71,482,195,35,11,5,52,124,0,29,0,0
2334,431,73,479,192,35,11,5,48,119,1,29,0,0
2335,431,69,478,185,35,11,5,47,116,2,29,0,0
2336,426,86,464,182,35,11,5,38,96,3,29,0,0
2337,427,88,462,175,35,11,5,35,87,4,29,0,0
2311,538,172,578,300,36,11,5,40,128,0,0,0,0
2870,1728,876,1885,1078,40,11,5,157,202,0,0,0,0
2871,1595,788,1846,1074,41,11,5,251,286,0,21,0,1
2872,1498,722,1801,1067,41,11,5,303,345,1,21,0,0
2873,1411,651,1775,1066,41,11,5,364,415,2,21,0,0
2874,1376,607,1777,1067,41,11,5,401,460,3,21,0,0
2875,1362,559,1804,1069,41,11,5,442,510,4,21,0,0
2876,1358,515,1831,1069,41,11,5,473,554,5,21,0,0
2877,1369,485,1856,1068,41,11,5,487,583,6,21,0,0
2878,1386,449,1869,1044,41,11,5,483,595,7,21,0,0
2879,1410,432,1863,1004,41,11,5,453,572,8,21,0,0
2880,1436,419,1867,974,41,11,5,431,555,9,21,0,0
2881,1494,406,1883,918,41,11,5,389,512,10,21,0,0
2882,1534,391,1906,896,41,11,5,372,505,11,21,0,0
2883,1569,375,1919,865,41,11,5,350,490,12,21,0,0
2884,1602,357,1920,821,41,11,5,318,464,13,21,0,0
2885,1628,366,1920,797,41,11,5,292,431,14,21,0,0
2886,1661,354,1920,770,41,11,5,259,416,15,21,0,0
2887,1695,348,1920,762,41,11,5,225,414,16,21,0,0
2888,1713,343,1920,757,41,11,5,207,414,17,21,0,0
2889,1743,333,1920,729,41,11,5,177,396,18,21,0,0
2890,1767,362,1920,707,41,11,5,153,345,19,21,0,0
2891,1781,369,1920,694,41,11,5,139,325,20,21,0,0
2892,1795,362,1920,675,41,11,5,125,313,21,21,1,0
2892,1861,400,1919,681,42,11,5,58,281,0,1,0,0
2893,1869,426,1920,673,42,11,5,51,247,1,1,0,0
3919,1857,347,1918,599,43,11,5,61,252,0,19,0,1
3920,1852,329,1920,612,43,11,5,68,283,1,19,0,0
3921,1843,325,1920,644,43,11,5,77,319,2,19,0,0
3922,1834,318,1916,659,43,11,5,82,341,3,19,0,0
3923,1806,316,1895,672,43,11,5,89,356,4,19,0,0
3924,1785,310,1886,694,43,11,5,101,384,5,19,0,0
3925,1777,309,1888,721,43,11,5,111,412,6,19,0,0
3926,1766,326,1888,767,43,11,5,122,441,7,19,0,0
3927,1750,327,1883,794,43,11,5,133,467,8,19,0,0
3928,1719,344,1865,825,43,11,5,146,481,9,19,0,0
3929,1685,365,1847,874,43,11,5,162,509,10,19,0,0
3930,1663,376,1842,924,43,11,5,179,548,11,19,0,0
3931,1639,408,1834,987,43,11,5,195,579,12,19,0,0
3932,1609,432,1818,1029,43,11,5,209,597,13,19,0,0
3933,1581,465,1798,1052,43,11,5,217,587,14,19,0,0
3934,1543,510,1765,1073,43,11,5,222,563,15,19,0,0
3935,1527,553,1751,1080,43,11,5,224,527,16,19,0,0
3936,1550,637,1757,1080,43,11,5,207,443,17,19,0,0
3937,1592,729,1782,1079,43,11,5,190,350,18,19,0,0
3938,1588,761,1773,1080,43,11,5,185,319,19,19,0,0
4183,2,605,222,1061,45,11,5,220,456,0,48,0,1
4184,0,383,303,1039,45,11,5,303,656,1,48,0,0
4185,71,314,399,995,45,11,5,328,681,2,48,0,0
4186,175,286,489,939,45,11,5,314,653,3,48,0,0
4187,236,254,545,900,45,11,5,309,646,4,48,0,0
4188,296,231,593,863,45,11,5,297,632,5,48,0,0
4189,348,202,624,799,45,11,5,276,597,6,48,0,0
4190,388,190,642,745,45,11,5,254,555,7,48,0,0
4191,416,174,642,674,45,11,5,226,500,8,48,0,0
4192,421,158,635,643,45,11,5,214,485,9,48,0,0
4193,424,142,621,593,45,11,5,197,451,10,48,0,0
4194,424,130,615,573,45,11,5,191,443,11,48,0,0
4195,425,119,594,519,45,11,5,169,400,12,48,0,0
4196,409,104,572,496,45,11,5,163,392,13,48,0,0
4197,399,98,549,466,45,11,5,150,368,14,48,0,0
4198,393,93,535,449,45,11,5,142,356,15,48,0,0
4199,387,93,516,421,45,11,5,129,328,16,48,0,0
4200,376,80,501,407,45,11,5,125,327,17,48,0,0
4201,369,80,485,389,45,11,5,116,309,18,48,0,0
4202,362,79,470,370,45,11,5,108,291,19,48,0,0
4203,362,79,462,353,45,11,5,100,274,20,48,0,0
4204,353,75,449,343,45,11,5,96,268,21,48,0,0
4205,346,73,437,330,45,11,5,91,257,22,48,0,0
4206,341,68,427,316,45,11,5,86,248,23,48,0,0
4207,343,68,426,308,45,11,5,83,240,24,48,0,0
4208,341,67,418,293,45,11,5,77,226,25,48,0,0
4209,336,64,411,286,45,11,5,75,222,26,48,0,0
4210,331,60,404,273,45,11,5,73,213,27,48,0,0
4211,333,58,402,260,45,11,5,69,202,28,48,0,0
4212,335,55,402,251,45,11,5,67,196,29,48,0,0
4213,336,51,402,244,45,11,5,66,193,30,48,0,0
4214,335,51,397,233,45,11,5,62,182,31,48,0,0
4215,335,41,398,228,45,11,5,63,187,32,48,0,0
4216,337,45,396,222,45,11,5,59,177,33,48,0,0
4217,338,42,396,215,45,11,5,58,173,34,48,0,0
4218,336,37,394,212,45,11,5,58,175,35,48,0,0
4219,335,31,392,206,45,11,5,57,175,36,48,0,0
4220,335,32,389,201,45,11,5,54,169,37,48,0,0
4221,335,29,387,192,45,11,5,52,163,38,48,0,0
4222,332,28,383,189,45,11,5,51,161,39,48,0,0
4223,330,26,380,182,45,11,5,50,156,40,48,0,0
4224,330,25,378,177,45,11,5,48,152,41,48,0,0
4225,329,21,376,171,45,11,5,47,150,42,48,0,0
4226,327,20,374,167,45,11,5,47,147,43,48,0,0
4227,326,13,373,160,45,11,5,47,147,44,48,0,0
4228,327,14,373,156,45,11,5,46,142,45,48,0,0
4229,326,11,371,150,45,11,5,45,139,46,48,0,0
4230,324,12,368,151,45,11,5,44,139,47,48,0,0
4231,323,10,366,145,45,11,5,43,135,48,48,1,0
4233,323,12,365,140,45,11,5,42,128,0,48,0,0
4234,323,10,363,135,45,11,5,40,125,1,48,0,0
4239,324,7,359,117,46,11,5,35,110,0,0,0,0
4460,1811,651,1919,891,47,11,5,108,240,0,11,0,0
4461,1779,588,1920,912,47,11,5,141,324,1,11,0,0
4462,1749,520,1920,969,47,11,5,171,449,2,11,0,0
4463,1715,510,1920,1028,47,11,5,205,518,3,11,0,0
4464,1700,511,1920,1047,47,11,5,220,536,4,11,0,0
4465,1633,484,1896,1067,47,11,5,263,583,5,11,0,0
4466,1603,495,1869,1069,47,11,5,266,574,6,11,0,0
4467,1584,512,1857,1080,47,11,5,273,568,7,11,0,0
4468,1558,574,1820,1080,47,11,5,262,506,8,11,0,0
4469,1567,644,1812,1080,47,11,5,245,436,9,11,0,0
4470,1641,749,1840,1079,47,11,5,199,330,10,11,0,0
4471,1635,764,1835,1080,47,11,5,200,316,11,11,0,0
4916,1871,365,1916,594,48,11,5,45,229,0,39,0,1
4917,1866,358,1915,610,48,11,5,49,252,1,39,0,0
4918,1856,372,1905,618,48,11,5,49,246,2,39,0,0
4919,1851,377,1901,624,48,11,5,50,247,3,39,0,0
4920,1826,351,1887,636,48,11,5,61,285,4,39,0,0
4921,1819,342,1887,648,48,11,5,68,306,5,39,0,0
4922,1814,348,1887,662,48,11,5,73,314,6,39,0,0
4923,1806,359,1886,682,48,11,5,80,323,7,39,0,0
4924,1796,364,1881,690,48,11,5,85,326,8,39,0,0
4925,1768,366,1862,701,48,11,5,94,335,9,39,0,0
4926,1747,373,1849,716,48,11,5,102,343,10,39,0,0
4927,1734,374,1841,724,48,11,5,107,350,11,39,0,0
4928,1716,377,1834,750,48,11,5,118,373,12,39,0,0
4929,1689,385,1814,769,48,11,5,125,384,13,39,0,0
4930,1656,392,1789,777,48,11,5,133,385,14,39,0,0
4931,1621,401,1765,796,48,11,5,144,395,15,39,0,0
4932,1596,407,1746,807,48,11,5,150,400,16,39,0,0
4933,1568,416,1733,846,48,11,5,165,430,17,39,0,0
4934,1532,430,1706,871,48,11,5,174,441,18,39,0,0
4935,1502,434,1679,876,48,11,5,177,442,19,39,0,0
4936,1430,447,1622,899,48,11,5,192,452,20,39,0,0
4937,1384,452,1586,914,48,11,5,202,462,21,39,0,0
4938,1348,458,1563,949,48,11,5,215,491,22,39,0,0
4939,1278,472,1511,995,48,11,5,233,523,23,39,0,0
4940,1232,492,1468,1018,48,11,5,236,526,24,39,0,0
4941,1142,503,1388,1027,48,11,5,246,524,25,39,0,0
4942,1070,518,1325,1053,48,11,5,255,535,26,39,0,0
4943,1015,511,1273,1062,48,11,5,258,551,27,39,0,0
4944,923,526,1183,1076,48,11,5,260,550,28,39,0,0
4945,859,546,1108,1079,48,11,5,249,533,29,39,0,0
4946,765,560,1006,1077,48,11,5,241,517,30,39,0,0
4947,666,558,911,1076,48,11,5,245,518,31,39,0,0
4948,541,548,794,1078,48,11,5,253,530,32,39,0,0
4949,413,549,670,1080,48,11,5,257,531,33,39,0,0
4950,313,562,570,1079,48,11,5,257,517,34,39,0,0
4951,198,572,454,1075,48,11,5,256,503,35,39,0,0
4952,94,586,349,1077,48,11,5,255,491,36,39,0,0
4953,0,589,247,1076,48,11,5,247,487,37,39,0,0
4954,0,644,170,1075,48,11,5,170,431,38,39,0,0
4955,0,657,88,1080,48,11,5,88,423,39,39,1,0
4955,1,814,78,1067,49,11,5,77,253,0,0,0,0
4963,906,827,1138,1070,51,11,5,232,243,0,8,0,0
4964,794,695,1156,1072,51,11,5,362,377,1,8,0,0
4965,676,590,1131,1069,51,11,5,455,479,2,8,0,0
4966,548,511,1076,1073,51,11,5,528,562,3,8,0,0
4967,440,433,1028,1072,51,11,5,588,639,4,8,0,0
4968,367,369,998,1072,51,11,5,631,703,5,8,0,0
4969,318,313,956,1049,51,11,5,638,736,6,8,0,0
4970,286,268,911,1017,51,11,5,625,749,7,8,0,0
4971,217,208,887,1013,51,11,5,670,805,8,8,0,0
4971,453,262,687,898,52,11,5,234,636,0,61,0,1
4972,430,230,663,865,52,11,5,233,635,1,61,0,0
4973,413,212,641,833,52,11,5,228,621,2,61,0,0
4974,410,191,613,745,52,11,5,203,554,3,61,0,0
4975,387,174,588,725,52,11,5,201,551,4,61,0,0
4976,384,164,564,655,52,11,5,180,491,5,61,0,0
4977,384,156,558,631,52,11,5,174,475,6,61,0,0
4978,385,140,550,588,52,11,5,165,448,7,61,0,0
4979,375,124,534,555,52,11,5,159,431,8,61,0,0
4980,366,118,518,532,52,11,5,152,414,9,61,0,0
4981,361,111,503,501,52,11,5,142,390,10,61,0,0
4982,361,105,500,488,52,11,5,139,383,11,61,0,0
4983,365,93,493,445,52,11,5,128,352,12,61,0,0
4984,361,87,486,430,52,11,5,125,343,13,61,0,0
4985,355,88,471,407,52,11,5,116,319,14,61,0,0
4986,350,79,466,401,52,11,5,116,322,15,61,0,0
4987,354,79,462,378,52,11,5,108,299,16,61,0,0
4988,354,78,457,361,52,11,5,103,283,17,61,0,0
4989,353,76,454,354,52,11,5,101,278,18,61,0,0
4990,349,71,442,331,52,11,5,93,260,19,61,0,0
4991,349,70,441,324,52,11,5,92,254,20,61,0,0
4992,353,68,439,307,52,11,5,86,239,21,61,0,0
4993,353,65,437,298,52,11,5,84,233,22,61,0,0
4994,350,59,434,290,52,11,5,84,231,23,61,0,0
4995,348,54,431,284,52,11,5,83,230,24,61,0,0
4996,349,55,430,281,52,11,5,81,226,25,61,0,0
4997,352,54,429,268,52,11,5,77,214,26,61,0,0
4998,350,51,425,261,52,11,5,75,210,27,61,0,0
4999,347,51,417,248,52,11,5,70,197,28,61,0,0
5000,344,48,411,239,52,11,5,67,191,29,61,0,0
5001,345,47,411,235,52,11,5,66,188,30,61,0,0
5002,347,47,410,229,52,11,5,63,182,31,61,0,0
5003,348,48,408,223,52,11,5,60,175,32,61,0,0
5004,347,44,406,214,52,11,5,59,170,33,61,0,0
5005,346,36,406,212,52,11,5,60,176,34,61,0,0
5006,349,35,406,203,52,11,5,57,168,35,61,0,0
5007,351,34,406,199,52,11,5,55,165,36,61,0,0
5008,352,36,404,195,52,11,5,52,159,37,61,0,0
5009,352,34,403,188,52,11,5,51,154,38,61,0,0
5010,352,32,403,188,52,11,5,51,156,39,61,0,0
5011,354,33,403,180,52,11,5,49,147,40,61,0,0
5012,354,28,403,178,52,11,5,49,150,41,61,0,0
5013,354,26,402,172,52,11,5,48,146,42,61,0,0
5014,353,21,401,168,52,11,5,48,147,43,61,0,0
5015,353,19,401,165,52,11,5,48,146,44,61,0,0
5016,354,15,401,159,52,11,5,47,144,45,61,0,0
5017,353,11,400,157,52,11,5,47,146,46,61,0,0
5018,352,12,397,150,52,11,5,45,138,47,61,0,0
5019,350,12,396,151,52,11,5,46,139,48,61,0,0
5020,350,12,394,147,52,11,5,44,135,49,61,0,0
5021,351,14,394,146,52,11,5,43,132,50,61,0,0
5022,351,15,392,145,52,11,5,41,130,51,61,0,0
5023,350,12,390,137,52,11,5,40,125,52,61,0,0
5024,348,12,388,135,52,11,5,40,123,53,61,0,0
5025,348,10,388,132,52,11,5,40,122,54,61,0,0
5026,348,9,387,131,52,11,5,39,122,55,61,0,0
5027,347,10,384,125,52,11,5,37,115,56,61,0,0
5028,346,8,384,125,52,11,5,38,117,57,61,0,0
5029,346,7,384,123,52,11,5,38,116,58,61,0,0
5030,346,7,383,120,52,11,5,37,113,59,61,0,0
5031,345,9,382,120,52,11,5,37,111,60,61,0,0
5032,344,10,379,115,52,11,5,35,105,61,61,1,0
5034,343,6,378,112,52,11,5,35,106,0,61,0,0
5035,342,5,377,112,52,11,5,35,107,1,61,0,0
5343,1703,845,1919,1073,53,11,5,216,228,0,14,0,0
5344,1612,733,1920,1064,53,11,5,308,331,1,14,0,0
5345,1561,665,1920,1067,53,11,5,359,402,2,14,0,0
5346,1510,590,1920,1069,53,11,5,410,479,3,14,0,0
5347,1479,531,1920,1071,53,11,5,441,540,4,14,0,0
5348,1483,499,1920,1068,53,11,5,437,569,5,14,0,0
5349,1478,466,1920,1070,53,11,5,442,604,6,14,0,0
5350,1516,439,1920,1044,53,11,5,404,605,7,14,0,0
5351,1545,412,1920,1023,53,11,5,375,611,8,14,0,0
5352,1581,393,1920,972,53,11,5,339,579,9,14,0,0
5353,1612,387,1920,926,53,11,5,308,539,10,14,0,0
5354,1650,415,1920,893,53,11,5,270,478,11,14,0,0
5355,1687,403,1920,851,53,11,5,233,448,12,14,0,0
5356,1712,398,1920,845,53,11,5,208,447,13,14,0,0
5357,1715,374,1920,829,53,11,5,205,455,14,14,0,0
5357,1825,400,1918,784,54,11,5,93,384,0,4,0,0
5358,1828,392,1918,764,54,11,5,90,372,1,4,0,0
5359,1826,382,1918,760,54,11,5,92,378,2,4,0,0
5360,1845,428,1916,722,54,11,5,71,294,3,4,0,0
5361,1851,441,1915,706,54,11,5,64,265,4,4,0,0
5545,1346,436,1920,1027,56,11,5,574,591,0,0,0,0
5545,1643,463,1902,948,57,11,5,259,485,0,7,0,0
5546,1662,467,1920,956,57,11,5,258,489,1,7,0,0
5547,1688,443,1920,927,57,11,5,232,484,2,7,0,0
5548,1727,427,1920,870,57,11,5,193,443,3,7,0,0
5549,1753,476,1920,855,57,11,5,167,379,4,7,0,0
5550,1787,482,1920,803,57,11,5,133,321,5,7,0,0
5551,1824,512,1920,783,57,11,5,96,271,6,7,0,0
5552,1851,524,1920,754,57,11,5,69,230,7,7,0,0
1,453,570,709,1080,1,11,6,256,510,0,14,0,0
2,392,522,669,1075,1,11,6,277,553,1,14,0,0
3,348,499,632,1067,1,11,6,284,568,2,14,0,0
4,318,474,614,1073,1,11,6,296,599,3,14,0,0
5,285,437,591,1068,1,11,6,306,631,4,14,0,0
6,253,417,555,1047,1,11,6,302,630,5,14,0,0
7,223,409,522,1034,1,11,6,299,625,6,14,0,0
8,219,398,509,1010,1,11,6,290,612,7,14,0,0
9,204,398,472,976,1,11,6,268,578,8,14,0,0
10,188,384,453,968,1,11,6,265,584,9,14,0,0
11,180,373,441,963,1,11,6,261,590,10,14,0,0
12,177,372,429,953,1,11,6,252,581,11,14,0,0
13,174,367,416,930,1,11,6,242,563,12,14,0,0
14,176,376,406,916,1,11,6,230,540,13,14,0,0
15,160,367,389,903,1,11,6,229,536,14,14,0,0
1,709,185,812,513,2,11,6,103,328,0,32,0,1
2,709,191,809,508,2,11,6,100,317,1,32,0,0
3,711,192,812,513,2,11,6,101,321,2,32,0,0
4,717,194,824,537,2,11,6,107,343,3,32,0,0
5,729,189,842,548,2,11,6,113,359,4,32,0,0
6,743,191,863,574,2,11,6,120,383,5,32,0,0
7,755,198,880,598,2,11,6,125,400,6,32,0,0
8,762,200,890,609,2,11,6,128,409,7,32,0,0
9,776,209,907,627,2,11,6,131,418,8,32,0,0
10,790,219,923,639,2,11,6,133,420,9,32,0,0
11,821,223,958,652,2,11,6,137,429,10,32,0,0
12,850,234,997,692,2,11,6,147,458,11,32,0,0
13,876,244,1027,711,2,11,6,151,467,12,32,0,0
14,905,251,1058,721,2,11,6,153,470,13,32,0,0
15,932,261,1090,750,2,11,6,158,489,14,32,0,0
16,958,279,1119,775,2,11,6,161,496,15,32,0,0
17,987,288,1152,787,2,11,6,165,499,16,32,0,0
18,1015,299,1194,834,2,11,6,179,535,17,32,0,0
19,1035,311,1226,879,2,11,6,191,568,18,32,0,0
20,1068,324,1260,894,2,11,6,192,570,19,32,0,0
21,1093,338,1290,920,2,11,6,197,582,20,32,0,0
22,1115,359,1325,972,2,11,6,210,613,21,32,0,0
23,1151,378,1367,992,2,11,6,216,614,22,32,0,0
24,1202,399,1429,1032,2,11,6,227,633,23,32,0,0
25,1248,431,1480,1062,2,11,6,232,631,24,32,0,0
26,1311,450,1546,1072,2,11,6,235,622,25,32,0,0
27,1364,473,1603,1080,2,11,6,239,607,26,32,0,0
28,1412,509,1653,1080,2,11,6,241,571,27,32,0,0
29,1517,536,1750,1069,2,11,6,233,533,28,32,0,0
30,1585,564,1819,1071,2,11,6,234,507,29,32,0,0
31,1634,599,1862,1063,2,11,6,228,464,30,32,0,0
32,1699,673,1902,1077,2,11,6,203,404,31,32,0,0
33,1751,702,1920,1080,2,11,6,169,378,32,32,1,0
50,264,139,315,336,3,11,6,51,197,0,85,0,1
51,280,138,331,329,3,11,6,51,191,1,85,0,0
52,290,139,342,338,3,11,6,52,199,2,85,0,0
53,302,138,355,341,3,11,6,53,203,3,85,0,0
54,312,141,367,350,3,11,6,55,209,4,85,0,0
55,322,142,378,345,3,11,6,56,203,5,85,0,0
56,351,146,405,343,3,11,6,54,197,6,85,0,0
57,367,150,424,352,3,11,6,57,202,7,85,0,0
58,381,152,440,359,3,11,6,59,207,8,85,0,0
59,395,152,458,367,3,11,6,63,215,9,85,0,0
60,408,154,472,370,3,11,6,64,216,10,85,0,0
61,418,152,485,372,3,11,6,67,220,11,85,0,0
62,425,155,492,372,3,11,6,67,217,12,85,0,0
63,427,158,497,380,3,11,6,70,222,13,85,0,0
64,426,160,496,381,3,11,6,70,221,14,85,0,0
65,423,160,497,391,3,11,6,74,231,15,85,0,0
66,420,163,497,399,3,11,6,77,236,16,85,0,0
67,411,164,493,404,3,11,6,82,240,17,85,0,0
68,406,163,492,407,3,11,6,86,244,18,85,0,0
69,399,166,489,416,3,11,6,90,250,19,85,0,0
70,387,168,482,421,3,11,6,95,253,20,85,0,0
71,370,171,468,426,3,11,6,98,255,21,85,0,0
72,358,174,460,433,3,11,6,102,259,22,85,0,0
73,356,174,459,437,3,11,6,103,263,23,85,0,0
74,357,176,459,438,3,11,6,102,262,24,85,0,0
75,358,177,458,439,3,11,6,100,262,25,85,0,0
76,364,175,463,439,3,11,6,99,264,26,85,0,0
77,366,175,462,438,3,11,6,96,263,27,85,0,0
78,366,174,460,436,3,11,6,94,262,28,85,0,0
79,366,171,459,437,3,11,6,93,266,29,85,0,0
80,365,176,456,437,3,11,6,91,261,30,85,0,0
81,367,173,456,436,3,11,6,89,263,31,85,0,0
82,371,171,458,435,3,11,6,87,264,32,85,0,0
83,373,171,458,435,3,11,6,85,264,33,85,0,0
84,373,170,457,434,3,11,6,84,264,34,85,0,0
85,375,170,456,434,3,11,6,81,264,35,85,0,0
86,375,170,455,435,3,11,6,80,265,36,85,0,0
87,371,174,450,435,3,11,6,79,261,37,85,0,0
88,373,173,451,433,3,11,6,78,260,38,85,0,0
89,377,171,454,433,3,11,6,77,262,39,85,0,0
90,379,169,455,433,3,11,6,76,264,40,85,0,0
91,377,170,453,434,3,11,6,76,264,41,85,0,0
92,376,171,451,434,3,11,6,75,263,42,85,0,0
93,379,174,451,429,3,11,6,72,255,43,85,0,0
94,379,172,451,431,3,11,6,72,259,44,85,0,0
95,379,171,451,433,3,11,6,72,262,45,85,0,0
96,379,169,450,431,3,11,6,71,262,46,85,0,0
97,378,166,449,432,3,11,6,71,266,47,85,0,0
98,378,165,448,434,3,11,6,70,269,48,85,0,0
99,379,168,448,433,3,11,6,69,265,49,85,0,0
100,381,170,448,433,3,11,6,67,263,50,85,0,0
101,380,168,449,435,3,11,6,69,267,51,85,0,0
102,378,170,446,435,3,11,6,68,265,52,85,0,0
103,377,172,445,435,3,11,6,68,263,53,85,0,0
104,380,176,447,431,3,11,6,67,255,54,85,0,0
105,380,170,448,432,3,11,6,68,262,55,85,0,0
106,376,176,445,436,3,11,6,69,260,56,85,0,0
107,364,179,436,439,3,11,6,72,260,57,85,0,0
108,355,178,428,442,3,11,6,73,264,58,85,0,0
109,335,183,412,446,3,11,6,77,263,59,85,0,0
110,329,187,411,461,3,11,6,82,274,60,85,0,0
111,322,189,407,468,3,11,6,85,279,61,85,0,0
112,312,190,400,475,3,11,6,88,285,62,85,0,0
113,294,194,390,498,3,11,6,96,304,63,85,0,0
114,281,198,383,514,3,11,6,102,316,64,85,0,0
115,282,202,387,528,3,11,6,105,326,65,85,0,0
116,282,215,391,553,3,11,6,109,338,66,85,0,0
117,284,220,394,559,3,11,6,110,339,67,85,0,0
118,283,229,401,591,3,11,6,118,362,68,85,0,0
119,284,238,407,614,3,11,6,123,376,69,85,0,0
120,291,243,417,627,3,11,6,126,384,70,85,0,0
121,297,258,429,662,3,11,6,132,404,71,85,0,0
122,313,270,446,677,3,11,6,133,407,72,85,0,0
123,320,281,465,723,3,11,6,145,442,73,85,0,0
124,326,298,480,768,3,11,6,154,470,74,85,0,0
125,329,312,489,795,3,11,6,160,483,75,85,0,0
126,334,332,505,843,3,11,6,171,511,76,85,0,0
127,341,352,521,886,3,11,6,180,534,77,85,0,0
128,344,380,544,972,3,11,6,200,592,78,85,0,0
129,345,404,558,1028,3,11,6,213,624,79,85,0,0
130,369,441,569,1002,3,11,6,200,561,80,85,0,0
131,401,498,606,1055,3,11,6,205,557,81,85,0,0
132,429,553,635,1076,3,11,6,206,523,82,85,0,0
133,464,646,658,1080,3,11,6,194,434,83,85,0,0
134,511,743,690,1080,3,11,6,179,337,84,85,0,0
135,530,781,702,1080,3,11,6,172,299,85,85,1,0
56,308,142,370,341,4,11,6,62,199,0,40,0,1
57,306,144,369,346,4,11,6,63,202,1,40,0,0
58,301,144,365,347,4,11,6,64,203,2,40,0,0
59,296,144,360,348,4,11,6,64,204,3,40,0,0
60,290,147,357,360,4,11,6,67,213,4,40,0,0
61,286,148,353,363,4,11,6,67,215,5,40,0,0
62,283,153,351,372,4,11,6,68,219,6,40,0,0
63,272,156,342,381,4,11,6,70,225,7,40,0,0
64,264,158,334,382,4,11,6,70,224,8,40,0,0
65,256,159,327,389,4,11,6,71,230,9,40,0,0
66,250,161,322,392,4,11,6,72,231,10,40,0,0
67,245,162,315,393,4,11,6,70,231,11,40,0,0
68,239,164,312,404,4,11,6,73,240,12,40,0,0
69,236,166,310,411,4,11,6,74,245,13,40,0,0
70,237,174,309,412,4,11,6,72,238,14,40,0,0
71,245,190,310,412,4,11,6,65,222,15,40,0,0
72,249,191,312,409,4,11,6,63,218,16,40,0,0
73,253,207,311,407,4,11,6,58,200,17,40,0,0
74,254,204,313,406,4,11,6,59,202,18,40,0,0
75,255,212,312,410,4,11,6,57,198,19,40,0,0
76,254,217,310,412,4,11,6,56,195,20,40,0,0
77,253,210,311,412,4,11,6,58,202,21,40,0,0
78,253,208,312,414,4,11,6,59,206,22,40,0,0
79,249,195,311,417,4,11,6,62,222,23,40,0,0
80,249,199,312,419,4,11,6,63,220,24,40,0,0
81,249,199,312,423,4,11,6,63,224,25,40,0,0
82,247,188,312,421,4,11,6,65,233,26,40,0,0
83,247,184,312,420,4,11,6,65,236,27,40,0,0
84,247,181,312,420,4,11,6,65,239,28,40,0,0
85,249,196,310,419,4,11,6,61,223,29,40,0,0
86,249,190,312,420,4,11,6,63,230,30,40,0,0
87,250,197,312,424,4,11,6,62,227,31,40,0,0
88,250,198,312,427,4,11,6,62,229,32,40,0,0
89,251,202,312,425,4,11,6,61,223,33,40,0,0
90,250,192,312,423,4,11,6,62,231,34,40,0,0
91,248,189,311,422,4,11,6,63,233,35,40,0,0
92,252,201,310,415,4,11,6,58,214,36,40,0,0
93,254,207,310,413,4,11,6,56,206,37,40,0,0
94,255,209,310,413,4,11,6,55,204,38,40,0,0
95,254,199,311,411,4,11,6,57,212,39,40,0,0
96,255,199,311,410,4,11,6,56,211,40,40,1,0
99,254,209,309,413,4,11,6,55,204,0,40,0,0
100,248,190,311,422,4,11,6,63,232,1,40,0,0
101,246,187,309,421,4,11,6,63,234,2,40,0,0
102,244,184,308,420,4,11,6,64,236,3,40,0,0
103,242,178,307,419,4,11,6,65,241,4,40,0,0
104,241,171,307,417,4,11,6,66,246,5,40,0,0
105,241,168,306,415,4,11,6,65,247,6,40,0,0
106,241,172,307,418,4,11,6,66,246,7,40,0,0
107,250,201,306,412,4,11,6,56,211,8,40,0,0
108,250,202,306,411,4,11,6,56,209,9,40,0,0
266,1841,934,1920,1072,9,11,6,79,138,0,0,0,0
267,1719,839,1883,1079,10,11,6,164,240,0,0,0,0
268,1553,772,1792,1077,11,11,6,239,305,0,0,0,0
269,1370,708,1671,1070,12,11,6,301,362,0,48,0,1
270,1265,642,1620,1070,12,11,6,355,428,1,48,0,0
271,1151,604,1533,1067,12,11,6,382,463,2,48,0,0
272,1035,543,1466,1073,12,11,6,431,530,3,48,0,0
273,930,492,1397,1075,12,11,6,467,583,4,48,0,0
274,850,453,1333,1071,12,11,6,483,618,5,48,0,0
275,782,417,1277,1072,12,11,6,495,655,6,48,0,0
276,737,390,1215,1046,12,11,6,478,656,7,48,0,0
277,720,358,1149,969,12,11,6,429,611,8,48,0,0
278,696,341,1091,924,12,11,6,395,583,9,48,0,0
279,678,321,1034,867,12,11,6,356,546,10,48,0,0
280,656,303,990,835,12,11,6,334,532,11,48,0,0
281,638,286,954,812,12,11,6,316,526,12,48,0,0
282,635,269,916,757,12,11,6,281,488,13,48,0,0
283,622,262,879,727,12,11,6,257,465,14,48,0,0
284,613,255,839,678,12,11,6,226,423,15,48,0,0
285,608,247,822,664,12,11,6,214,417,16,48,0,0
286,605,234,806,640,12,11,6,201,406,17,48,0,0
287,604,222,791,611,12,11,6,187,389,18,48,0,0
288,598,216,770,585,12,11,6,172,369,19,48,0,0
289,596,204,756,557,12,11,6,160,353,20,48,0,0
290,594,200,748,547,12,11,6,154,347,21,48,0,0
291,601,190,748,529,12,11,6,147,339,22,48,0,0
292,602,188,739,509,12,11,6,137,321,23,48,0,0
293,603,183,734,496,12,11,6,131,313,24,48,0,0
294,607,179,730,479,12,11,6,123,300,25,48,0,0
295,614,178,732,468,12,11,6,118,290,26,48,0,0
296,622,174,735,455,12,11,6,113,281,27,48,0,0
297,632,171,742,447,12,11,6,110,276,28,48,0,0
298,640,168,742,432,12,11,6,102,264,29,48,0,0
299,648,166,746,419,12,11,6,98,253,30,48,0,0
300,658,165,754,417,12,11,6,96,252,31,48,0,0
301,675,163,767,405,12,11,6,92,242,32,48,0,0
302,687,164,775,398,12,11,6,88,234,33,48,0,0
303,697,165,780,389,12,11,6,83,224,34,48,0,0
304,701,169,781,383,12,11,6,80,214,35,48,0,0
305,710,167,789,381,12,11,6,79,214,36,48,0,0
306,717,157,796,369,12,11,6,79,212,37,48,0,0
307,723,152,802,365,12,11,6,79,213,38,48,0,0
308,723,149,802,362,12,11,6,79,213,39,48,0,0
309,724,147,799,352,12,11,6,75,205,40,48,0,0
310,724,147,795,341,12,11,6,71,194,41,48,0,0
311,724,146,793,335,12,11,6,69,189,42,48,0,0
312,723,144,792,331,12,11,6,69,187,43,48,0,0
313,721,149,785,321,12,11,6,64,172,44,48,0,0
314,723,147,785,313,12,11,6,62,166,45,48,0,0
315,702,152,764,317,12,11,6,62,165,46,48,0,0
316,693,151,753,317,12,11,6,60,166,47,48,0,0
317,691,150,749,311,12,11,6,58,161,48,48,1,0
316,723,161,760,304,13,11,6,37,143,0,0,0,0
466,1829,916,1918,1079,17,11,6,89,163,0,0,0,0
467,1720,780,1916,1071,18,11,6,196,291,0,0,0,0
468,1586,732,1826,1077,19,11,6,240,345,0,1,0,0
469,1470,682,1742,1075,19,11,6,272,393,1,1,0,0
470,1302,641,1574,1067,21,11,6,272,426,0,145,0,1
471,1172,585,1485,1076,21,11,6,313,491,1,145,0,0
472,1055,540,1394,1075,21,11,6,339,535,2,145,0,0
473,934,506,1292,1074,21,11,6,358,568,3,145,0,0
474,822,456,1206,1075,21,11,6,384,619,4,145,0,0
475,723,425,1116,1072,21,11,6,393,647,5,145,0,0
476,654,391,1052,1064,21,11,6,398,673,6,145,0,0
477,602,356,976,1006,21,11,6,374,650,7,145,0,0
478,556,337,913,978,21,11,6,357,641,8,145,0,0
479,529,314,851,911,21,11,6,322,597,9,145,0,0
480,495,293,802,880,21,11,6,307,587,10,145,0,0
481,475,282,762,850,21,11,6,287,568,11,145,0,0
482,474,265,727,782,21,11,6,253,517,12,145,0,0
483,465,253,698,746,21,11,6,233,493,13,145,0,0
484,452,243,670,722,21,11,6,218,479,14,145,0,0
485,445,228,643,675,21,11,6,198,447,15,145,0,0
486,435,225,621,656,21,11,6,186,431,16,145,0,0
487,437,220,606,623,21,11,6,169,403,17,145,0,0
488,442,209,598,590,21,11,6,156,381,18,145,0,0
489,442,205,589,577,21,11,6,147,372,19,145,0,0
490,441,194,576,543,21,11,6,135,349,20,145,0,0
491,437,186,567,529,21,11,6,130,343,21,145,0,0
492,436,185,561,521,21,11,6,125,336,22,145,0,0
493,440,179,555,495,21,11,6,115,316,23,145,0,0
494,441,173,551,480,21,11,6,110,307,24,145,0,0
495,441,173,545,469,21,11,6,104,296,25,145,0,0
496,443,164,540,443,21,11,6,97,279,26,145,0,0
497,443,163,536,434,21,11,6,93,271,27,145,0,0
498,443,158,531,418,21,11,6,88,260,28,145,0,0
499,442,153,526,406,21,11,6,84,253,29,145,0,0
500,437,153,519,403,21,11,6,82,250,30,145,0,0
501,431,149,509,388,21,11,6,78,239,31,145,0,0
502,421,144,500,384,21,11,6,79,240,32,145,0,0
503,414,145,492,385,21,11,6,78,240,33,145,0,0
504,410,138,486,370,21,11,6,76,232,34,145,0,0
505,402,138,475,364,21,11,6,73,226,35,145,0,0
506,392,136,464,359,21,11,6,72,223,36,145,0,0
507,383,135,451,348,21,11,6,68,213,37,145,0,0
508,376,136,441,342,21,11,6,65,206,38,145,0,0
509,370,134,433,334,21,11,6,63,200,39,145,0,0
510,363,129,423,324,21,11,6,60,195,40,145,0,0
511,356,131,415,324,21,11,6,59,193,41,145,0,0
512,346,127,405,318,21,11,6,59,191,42,145,0,0
513,335,124,393,314,21,11,6,58,190,43,145,0,0
514,328,127,383,307,21,11,6,55,180,44,145,0,0
515,322,125,376,303,21,11,6,54,178,45,145,0,0
516,311,122,367,302,21,11,6,56,180,46,145,0,0
517,301,122,356,298,21,11,6,55,176,47,145,0,0
518,296,120,351,294,21,11,6,55,174,48,145,0,0
519,290,119,344,294,21,11,6,54,175,49,145,0,0
520,280,117,336,295,21,11,6,56,178,50,145,0,0
521,274,117,330,292,21,11,6,56,175,51,145,0,0
522,271,118,326,292,21,11,6,55,174,52,145,0,0
523,274,119,328,292,21,11,6,54,173,53,145,0,0
524,277,120,328,289,21,11,6,51,169,54,145,0,0
525,280,119,330,292,21,11,6,50,173,55,145,0,0
526,286,121,335,293,21,11,6,49,172,56,145,0,0
527,291,119,339,292,21,11,6,48,173,57,145,0,0
528,297,120,345,293,21,11,6,48,173,58,145,0,0
529,300,119,348,293,21,11,6,48,174,59,145,0,0
530,302,118,351,296,21,11,6,49,178,60,145,0,0
531,305,119,355,302,21,11,6,50,183,61,145,0,0
532,307,120,358,304,21,11,6,51,184,62,145,0,0
533,310,120,359,296,21,11,6,49,176,63,145,0,0
534,313,120,363,301,21,11,6,50,181,64,145,0,0
535,318,124,369,304,21,11,6,51,180,65,145,0,0
536,325,124,377,307,21,11,6,52,183,66,145,0,0
537,334,122,387,307,21,11,6,53,185,67,145,0,0
538,344,121,397,307,21,11,6,53,186,68,145,0,0
539,350,123,403,308,21,11,6,53,185,69,145,0,0
540,355,125,407,309,21,11,6,52,184,70,145,0,0
541,360,126,412,309,21,11,6,52,183,71,145,0,0
542,363,127,417,315,21,11,6,54,188,72,145,0,0
543,368,128,422,316,21,11,6,54,188,73,145,0,0
544,372,126,427,316,21,11,6,55,190,74,145,0,0
545,376,128,431,317,21,11,6,55,189,75,145,0,0
546,376,126,432,318,21,11,6,56,192,76,145,0,0
547,376,127,432,318,21,11,6,56,191,77,145,0,0
548,375,126,430,314,21,11,6,55,188,78,145,0,0
549,374,126,429,314,21,11,6,55,188,79,145,0,0
550,373,126,427,313,21,11,6,54,187,80,145,0,0
551,372,126,426,312,21,11,6,54,186,81,145,0,0
552,372,127,426,314,21,11,6,54,187,82,145,0,0
553,372,125,426,315,21,11,6,54,190,83,145,0,0
554,371,125,426,316,21,11,6,55,191,84,145,0,0
555,371,125,425,315,21,11,6,54,190,85,145,0,0
556,370,125,424,316,21,11,6,54,191,86,145,0,0
557,367,124,422,316,21,11,6,55,192,87,145,0,0
558,365,124,418,314,21,11,6,53,190,88,145,0,0
559,363,125,414,311,21,11,6,51,186,89,145,0,0
560,357,129,408,315,21,11,6,51,186,90,145,0,0
561,344,127,398,317,21,11,6,54,190,91,145,0,0
562,339,128,393,316,21,11,6,54,188,92,145,0,0
563,336,127,390,314,21,11,6,54,187,93,145,0,0
564,327,127,382,316,21,11,6,55,189,94,145,0,0
565,319,127,374,318,21,11,6,55,191,95,145,0,0
566,316,127,370,317,21,11,6,54,190,96,145,0,0
567,317,127,369,315,21,11,6,52,188,97,145,0,0
568,317,126,368,314,21,11,6,51,188,98,145,0,0
569,318,127,367,314,21,11,6,49,187,99,145,0,0
570,318,128,368,320,21,11,6,50,192,100,145,0,0
571,320,129,370,321,21,11,6,50,192,101,145,0,0
572,324,128,372,315,21,11,6,48,187,102,145,0,0
573,326,126,374,311,21,11,6,48,185,103,145,0,0
574,328,126,376,307,21,11,6,48,181,104,145,0,0
575,327,126,378,322,21,11,6,51,196,105,145,0,0
576,325,124,377,325,21,11,6,52,201,106,145,0,0
577,323,123,373,311,21,11,6,50,188,107,145,0,0
578,321,122,370,301,21,11,6,49,179,108,145,0,0
579,323,122,371,295,21,11,6,48,173,109,145,0,0
580,325,124,374,293,21,11,6,49,169,110,145,0,0
581,330,123,380,293,21,11,6,50,170,111,145,0,0
582,336,123,387,288,21,11,6,51,165,112,145,0,0
583,342,120,394,287,21,11,6,52,167,113,145,0,0
584,349,121,399,282,21,11,6,50,161,114,145,0,0
585,352,119,402,280,21,11,6,50,161,115,145,0,0
586,354,120,404,277,21,11,6,50,157,116,145,0,0
587,356,120,406,278,21,11,6,50,158,117,145,0,0
588,358,120,408,277,21,11,6,50,157,118,145,0,0
589,362,119,413,280,21,11,6,51,161,119,145,0,0
590,368,118,421,283,21,11,6,53,165,120,145,0,0
591,374,117,429,284,21,11,6,55,167,121,145,0,0
592,384,119,437,286,21,11,6,53,167,122,145,0,0
593,396,119,447,284,21,11,6,51,165,123,145,0,0
594,406,118,458,282,21,11,6,52,164,124,145,0,0
595,411,118,463,285,21,11,6,52,167,125,145,0,0
596,419,118,471,282,21,11,6,52,164,126,145,0,0
597,426,117,478,282,21,11,6,52,165,127,145,0,0
598,430,116,483,284,21,11,6,53,168,128,145,0,0
599,428,115,483,284,21,11,6,55,169,129,145,0,0
600,421,117,475,284,21,11,6,54,167,130,145,0,0
601,414,117,468,285,21,11,6,54,168,131,145,0,0
602,407,117,461,287,21,11,6,54,170,132,145,0,0
603,402,119,454,287,21,11,6,52,168,133,145,0,0
604,394,121,447,292,21,11,6,53,171,134,145,0,0
605,385,120,439,296,21,11,6,54,176,135,145,0,0
606,374,118,429,298,21,11,6,55,180,136,145,0,0
607,359,117,415,299,21,11,6,56,182,137,145,0,0
608,348,120,405,301,21,11,6,57,181,138,145,0,0
609,338,121,395,304,21,11,6,57,183,139,145,0,0
610,321,123,379,314,21,11,6,58,191,140,145,0,0
611,303,122,361,310,21,11,6,58,188,141,145,0,0
612,292,129,350,315,21,11,6,58,186,142,145,0,0
613,271,128,329,323,21,11,6,58,195,143,145,0,0
614,254,130,316,341,21,11,6,62,211,144,145,0,0
615,244,131,306,345,21,11,6,62,214,145,145,1,0
767,450,101,498,219,32,11,6,48,118,0,1,0,0
768,434,101,481,215,32,11,6,47,114,1,1,0,0
769,406,99,452,224,33,11,6,46,125,0,5,0,0
770,386,105,429,220,33,11,6,43,115,1,5,0,0
771,367,100,411,220,33,11,6,44,120,2,5,0,0
772,344,103,387,221,33,11,6,43,118,3,5,0,0
773,322,106,363,218,33,11,6,41,112,4,5,0,0
774,305,108,345,217,33,11,6,40,109,5,5,0,0
1151,262,147,322,329,34,11,6,60,182,0,56,0,1
1152,261,150,324,341,34,11,6,63,191,1,56,0,0
1153,273,147,336,338,34,11,6,63,191,2,56,0,0
1154,296,147,361,341,34,11,6,65,194,3,56,0,0
1155,305,148,371,340,34,11,6,66,192,4,56,0,0
1156,320,150,386,341,34,11,6,66,191,5,56,0,0
1157,333,154,400,342,34,11,6,67,188,6,56,0,0
1158,340,153,411,347,34,11,6,71,194,7,56,0,0
1159,355,154,424,342,34,11,6,69,188,8,56,0,0
1160,371,156,438,335,34,11,6,67,179,9,56,0,0
1161,378,157,447,338,34,11,6,69,181,10,56,0,0
1162,381,160,454,349,34,11,6,73,189,11,56,0,0
1163,384,165,460,358,34,11,6,76,193,12,56,0,0
1164,391,168,465,357,34,11,6,74,189,13,56,0,0
1165,398,168,471,352,34,11,6,73,184,14,56,0,0
1166,403,173,475,353,34,11,6,72,180,15,56,0,0
1167,402,175,478,364,34,11,6,76,189,16,56,0,0
1168,399,176,484,387,34,11,6,85,211,17,56,0,0
1169,403,181,491,399,34,11,6,88,218,18,56,0,0
1170,409,180,503,411,34,11,6,94,231,19,56,0,0
1171,417,183,512,415,34,11,6,95,232,20,56,0,0
1172,421,189,521,434,34,11,6,100,245,21,56,0,0
1173,424,193,525,443,34,11,6,101,250,22,56,0,0
1174,425,197,531,455,34,11,6,106,258,23,56,0,0
1175,432,205,540,466,34,11,6,108,261,24,56,0,0
1176,442,209,555,482,34,11,6,113,273,25,56,0,0
1177,448,216,564,497,34,11,6,116,281,26,56,0,0
1178,448,220,572,522,34,11,6,124,302,27,56,0,0
1179,448,224,578,538,34,11,6,130,314,28,56,0,0
1180,457,233,587,544,34,11,6,130,311,29,56,0,0
1181,468,237,603,553,34,11,6,135,316,30,56,0,0
1182,474,241,622,589,34,11,6,148,348,31,56,0,0
1183,483,252,640,622,34,11,6,157,370,32,56,0,0
1184,488,263,643,631,34,11,6,155,368,33,56,0,0
1185,493,275,646,637,34,11,6,153,362,34,56,0,0
1186,516,284,673,647,34,11,6,157,363,35,56,0,0
1187,543,287,711,673,34,11,6,168,386,36,56,0,0
1188,560,297,738,710,34,11,6,178,413,37,56,0,0
1189,585,312,766,725,34,11,6,181,413,38,56,0,0
1190,603,326,791,749,34,11,6,188,423,39,56,0,0
1191,610,339,801,764,34,11,6,191,425,40,56,0,0
1192,629,345,833,791,34,11,6,204,446,41,56,0,0
1193,664,358,879,820,34,11,6,215,462,42,56,0,0
1194,694,384,920,865,34,11,6,226,481,43,56,0,0
1195,717,404,953,894,34,11,6,236,490,44,56,0,0
1196,728,429,969,919,34,11,6,241,490,45,56,0,0
1197,752,451,1013,965,34,11,6,261,514,46,56,0,0
1198,777,473,1051,997,34,11,6,274,524,47,56,0,0
1199,832,503,1126,1055,34,11,6,294,552,48,56,0,0
1200,869,537,1159,1073,34,11,6,290,536,49,56,0,0
1201,923,582,1206,1076,34,11,6,283,494,50,56,0,0
1202,983,632,1259,1080,34,11,6,276,448,51,56,0,0
1203,1059,681,1325,1080,34,11,6,266,399,52,56,0,0
1204,1140,735,1386,1080,34,11,6,246,345,53,56,0,0
1205,1225,802,1444,1080,34,11,6,219,278,54,56,0,0
1206,1342,876,1521,1080,34,11,6,179,204,55,56,0,0
1207,1411,918,1563,1080,34,11,6,152,162,56,56,1,0
1310,854,681,1205,1058,40,11,6,351,377,0,9,0,0
1311,675,578,1129,1068,40,11,6,454,490,1,9,0,0
1312,547,506,1066,1069,40,11,6,519,563,2,9,0,0
1313,444,444,1008,1067,40,11,6,564,623,3,9,0,0
1314,366,392,964,1069,40,11,6,598,677,4,9,0,0
1315,299,363,910,1075,40,11,6,611,712,5,9,0,0
1316,235,331,852,1074,40,11,6,617,743,6,9,0,0
1317,200,318,808,1074,40,11,6,608,756,7,9,0,0
1318,189,306,769,1052,40,11,6,580,746,8,9,0,0
1319,121,269,729,1051,40,11,6,608,782,9,9,0,0
1319,387,302,599,931,41,11,6,212,629,0,20,0,1
1320,366,288,576,912,41,11,6,210,624,1,20,0,0
1321,355,275,556,869,41,11,6,201,594,2,20,0,0
1322,353,267,556,861,41,11,6,203,594,3,20,0,0
1323,363,259,558,827,41,11,6,195,568,4,20,0,0
1324,381,245,565,779,41,11,6,184,534,5,20,0,0
1325,392,245,568,760,41,11,6,176,515,6,20,0,0
1326,394,243,576,785,41,11,6,182,542,7,20,0,0
1327,404,251,592,817,41,11,6,188,566,8,20,0,0
1328,402,262,592,837,41,11,6,190,575,9,20,0,0
1329,430,282,632,887,41,11,6,202,605,10,20,0,0
1330,443,299,656,935,41,11,6,213,636,11,20,0,0
1331,473,316,715,1014,41,11,6,242,698,12,20,0,0
1332,510,353,764,1058,41,11,6,254,705,13,20,0,0
1333,528,378,784,1075,41,11,6,256,697,14,20,0,0
1334,555,419,805,1080,41,11,6,250,661,15,20,0,0
1335,615,468,857,1079,41,11,6,242,611,16,20,0,0
1336,699,529,941,1080,41,11,6,242,551,17,20,0,0
1337,764,657,977,1080,41,11,6,213,423,18,20,0,0
1338,863,799,1032,1073,41,11,6,169,274,19,20,0,0
1339,916,853,1057,1080,41,11,6,141,227,20,20,1,0
1688,262,137,312,321,43,11,6,50,184,0,18,0,0
1689,274,137,320,303,43,11,6,46,166,1,18,0,0
1690,282,131,336,329,43,11,6,54,198,2,18,0,0
1691,292,128,350,341,43,11,6,58,213,3,18,0,0
1692,303,126,364,345,43,11,6,61,219,4,18,0,0
1693,314,129,376,350,43,11,6,62,221,5,18,0,0
1694,321,130,386,357,43,11,6,65,227,6,18,0,0
1695,328,133,394,359,43,11,6,66,226,7,18,0,0
1696,332,135,401,365,43,11,6,69,230,8,18,0,0
1697,329,134,402,371,43,11,6,73,237,9,18,0,0
1698,326,136,404,376,43,11,6,78,240,10,18,0,0
1699,321,136,402,378,43,11,6,81,242,11,18,0,0
1700,313,138,395,380,43,11,6,82,242,12,18,0,0
1701,303,143,388,389,43,11,6,85,246,13,18,0,0
1702,290,143,379,399,43,11,6,89,256,14,18,0,0
1703,279,146,370,404,43,11,6,91,258,15,18,0,0
1704,262,151,354,415,43,11,6,92,264,16,18,0,0
1705,253,156,343,414,43,11,6,90,258,17,18,0,0
1706,249,158,341,420,43,11,6,92,262,18,18,0,0
1721,1670,889,1802,1071,45,11,6,132,182,0,0,0,0
1722,1523,809,1704,1072,46,11,6,181,263,0,0,0,0
1723,1378,762,1615,1073,47,11,6,237,311,0,0,0,0
1724,1167,691,1516,1066,48,11,6,349,375,0,127,0,1
1725,1080,630,1486,1066,48,11,6,406,436,1,127,0,0
1726,1022,581,1474,1071,48,11,6,452,490,2,127,0,0
1727,943,540,1430,1073,48,11,6,487,533,3,127,0,0
1728,862,502,1374,1072,48,11,6,512,570,4,127,0,0
1729,787,470,1314,1071,48,11,6,527,601,5,127,0,0
1730,764,431,1274,1027,48,11,6,510,596,6,127,0,0
1731,741,406,1246,1013,48,11,6,505,607,7,127,0,0
1732,719,378,1191,962,48,11,6,472,584,8,127,0,0
1733,705,353,1131,896,48,11,6,426,543,9,127,0,0
1734,677,337,1074,859,48,11,6,397,522,10,127,0,0
1735,666,317,1023,801,48,11,6,357,484,11,127,0,0
1736,653,301,995,775,48,11,6,342,474,12,127,0,0
1737,632,288,962,759,48,11,6,330,471,13,127,0,0
1738,627,274,923,709,48,11,6,296,435,14,127,0,0
1739,613,270,884,683,48,11,6,271,413,15,127,0,0
1740,604,265,854,658,48,11,6,250,393,16,127,0,0
1741,605,264,831,629,48,11,6,226,365,17,127,0,0
1742,595,253,818,623,48,11,6,223,370,18,127,0,0
1743,588,234,797,592,48,11,6,209,358,19,127,0,0
1744,572,222,772,576,48,11,6,200,354,20,127,0,0
1745,555,220,747,568,48,11,6,192,348,21,127,0,0
1746,541,210,721,538,48,11,6,180,328,22,127,0,0
1747,536,208,708,525,48,11,6,172,317,23,127,0,0
1748,531,200,699,512,48,11,6,168,312,24,127,0,0
1749,519,194,677,492,48,11,6,158,298,25,127,0,0
1750,513,195,664,483,48,11,6,151,288,26,127,0,0
1751,506,188,649,469,48,11,6,143,281,27,127,0,0
1752,490,181,659,524,48,11,6,169,343,28,127,0,0
1753,507,180,628,420,48,11,6,121,240,29,127,0,0
1754,486,173,605,405,48,11,6,119,232,30,127,0,0
1755,474,175,595,414,48,11,6,121,239,31,127,0,0
1756,463,175,581,410,48,11,6,118,235,32,127,0,0
1757,452,169,569,402,48,11,6,117,233,33,127,0,0
1758,442,168,559,404,48,11,6,117,236,34,127,0,0
1759,431,165,545,394,48,11,6,114,229,35,127,0,0
1760,421,162,530,386,48,11,6,109,224,36,127,0,0
1761,411,162,516,377,48,11,6,105,215,37,127,0,0
1762,403,155,506,369,48,11,6,103,214,38,127,0,0
1763,392,152,495,367,48,11,6,103,215,39,127,0,0
1764,380,151,482,360,48,11,6,102,209,40,127,0,0
1765,377,151,473,350,48,11,6,96,199,41,127,0,0
1766,362,150,457,348,48,11,6,95,198,42,127,0,0
1767,354,149,446,343,48,11,6,92,194,43,127,0,0
1768,348,146,440,339,48,11,6,92,193,44,127,0,0
1769,343,145,433,334,48,11,6,90,189,45,127,0,0
1770,340,144,426,329,48,11,6,86,185,46,127,0,0
1771,332,143,416,325,48,11,6,84,182,47,127,0,0
1772,323,143,404,323,48,11,6,81,180,48,127,0,0
1773,318,142,396,318,48,11,6,78,176,49,127,0,0
1774,312,140,391,319,48,11,6,79,179,50,127,0,0
1775,309,140,387,315,48,11,6,78,175,51,127,0,0
1776,308,140,383,311,48,11,6,75,171,52,127,0,0
1777,305,140,376,302,48,11,6,71,162,53,127,0,0
1778,300,139,369,300,48,11,6,69,161,54,127,0,0
1779,292,138,361,300,48,11,6,69,162,55,127,0,0
1780,287,139,355,298,48,11,6,68,159,56,127,0,0
1781,285,141,352,294,48,11,6,67,153,57,127,0,0
1782,284,142,351,292,48,11,6,67,150,58,127,0,0
1783,281,139,349,293,48,11,6,68,154,59,127,0,0
1784,282,134,351,292,48,11,6,69,158,60,127,0,0
1785,287,133,355,292,48,11,6,68,159,61,127,0,0
1786,289,128,359,294,48,11,6,70,166,62,127,0,0
1787,295,125,364,294,48,11,6,69,169,63,127,0,0
1788,302,124,370,293,48,11,6,68,169,64,127,0,0
1789,306,124,372,294,48,11,6,66,170,65,127,0,0
1790,308,124,371,291,48,11,6,63,167,66,127,0,0
1791,306,123,368,287,48,11,6,62,164,67,127,0,0
1792,307,123,367,283,48,11,6,60,160,68,127,0,0
1793,310,123,368,281,48,11,6,58,158,69,127,0,0
1794,314,123,371,279,48,11,6,57,156,70,127,0,0
1795,319,122,374,276,48,11,6,55,154,71,127,0,0
1796,322,122,376,273,48,11,6,54,151,72,127,0,0
1797,320,122,372,271,48,11,6,52,149,73,127,0,0
1798,317,121,368,267,48,11,6,51,146,74,127,0,0
1799,315,120,366,265,48,11,6,51,145,75,127,0,0
1800,316,120,366,262,48,11,6,50,142,76,127,0,0
1801,321,119,369,258,48,11,6,48,139,77,127,0,0
1802,324,118,371,256,48,11,6,47,138,78,127,0,0
1803,323,118,369,254,48,11,6,46,136,79,127,0,0
1804,321,115,367,249,48,11,6,46,134,80,127,0,0
1805,322,113,368,248,48,11,6,46,135,81,127,0,0
1806,327,114,372,247,48,11,6,45,133,82,127,0,0
1807,331,111,377,244,48,11,6,46,133,83,127,0,0
1808,334,112,379,242,48,11,6,45,130,84,127,0,0
1809,334,111,379,242,48,11,6,45,131,85,127,0,0
1810,334,110,378,238,48,11,6,44,128,86,127,0,0
1811,336,109,379,236,48,11,6,43,127,87,127,0,0
1812,339,110,381,234,48,11,6,42,124,88,127,0,0
1813,341,109,384,234,48,11,6,43,125,89,127,0,0
1814,344,109,386,234,48,11,6,42,125,90,127,0,0
1815,346,110,388,233,48,11,6,42,123,91,127,0,0
1816,346,109,387,230,48,11,6,41,121,92,127,0,0
1817,347,108,387,226,48,11,6,40,118,93,127,0,0
1818,348,106,389,225,48,11,6,41,119,94,127,0,0
1819,353,107,393,224,48,11,6,40,117,95,127,0,0
1820,356,107,396,222,48,11,6,40,115,96,127,0,0
1821,356,108,395,220,48,11,6,39,112,97,127,0,0
1822,357,108,396,221,48,11,6,39,113,98,127,0,0
1823,356,106,394,220,48,11,6,38,114,99,127,0,0
1824,355,106,392,218,48,11,6,37,112,100,127,0,0
1825,356,105,393,216,48,11,6,37,111,101,127,0,0
1826,358,107,395,216,48,11,6,37,109,102,127,0,0
1827,360,103,398,217,48,11,6,38,114,103,127,0,0
1828,362,102,401,216,48,11,6,39,114,104,127,0,0
1829,364,101,403,216,48,11,6,39,115,105,127,0,0
1830,364,102,403,216,48,11,6,39,114,106,127,0,0
1831,364,102,403,217,48,11,6,39,115,107,127,0,0
1832,363,101,403,218,48,11,6,40,117,108,127,0,0
1833,363,101,404,218,48,11,6,41,117,109,127,0,0
1834,363,101,403,218,48,11,6,40,117,110,127,0,0
1835,362,101,403,218,48,11,6,41,117,111,127,0,0
1836,362,103,402,218,48,11,6,40,115,112,127,0,0
1837,361,104,402,217,48,11,6,41,113,113,127,0,0
1838,361,103,403,217,48,11,6,42,114,114,127,0,0
1839,361,103,403,216,48,11,6,42,113,115,127,0,0
1840,362,104,403,216,48,11,6,41,112,116,127,0,0
1841,361,103,403,217,48,11,6,42,114,117,127,0,0
1842,361,100,404,217,48,11,6,43,117,118,127,0,0
1843,362,103,405,219,48,11,6,43,116,119,127,0,0
1844,364,103,406,217,48,11,6,42,114,120,127,0,0
1845,367,109,405,216,48,11,6,38,107,121,127,0,0
1846,367,110,405,216,48,11,6,38,106,122,127,0,0
1851,352,105,394,223,48,11,6,42,118,0,127,0,1
1852,350,104,391,223,48,11,6,41,119,1,127,0,0
1853,347,104,387,226,48,11,6,40,122,2,127,0,0
1854,345,108,385,227,48,11,6,40,119,3,127,0,0
1855,344,106,386,227,48,11,6,42,121,4,127,0,0
1856,343,109,384,227,48,11,6,41,118,5,127,0,0
1857,340,110,381,229,48,11,6,41,119,6,127,0,0
1858,335,110,376,230,48,11,6,41,120,7,127,0,0
1859,330,110,374,232,48,11,6,44,122,8,127,0,0
1860,330,110,374,234,48,11,6,44,124,9,127,0,0
1861,333,112,377,237,48,11,6,44,125,10,127,0,0
1862,335,111,380,237,48,11,6,45,126,11,127,0,0
1863,336,112,382,240,48,11,6,46,128,12,127,0,0
1864,335,113,381,242,48,11,6,46,129,13,127,0,0
1865,334,113,381,242,48,11,6,47,129,14,127,0,0
1866,336,111,384,246,48,11,6,48,135,15,127,0,0
1867,339,114,387,246,48,11,6,48,132,16,127,0,0
1868,343,113,392,248,48,11,6,49,135,17,127,0,0
1869,344,114,395,252,48,11,6,51,138,18,127,0,0
1870,342,115,395,255,48,11,6,53,140,19,127,0,0
1871,341,115,394,256,48,11,6,53,141,20,127,0,0
1872,341,116,395,260,48,11,6,54,144,21,127,0,0
1873,345,118,400,263,48,11,6,55,145,22,127,0,0
1874,350,117,406,263,48,11,6,56,146,23,127,0,0
1875,354,119,411,267,48,11,6,57,148,24,127,0,0
1876,355,119,413,270,48,11,6,58,151,25,127,0,0
1877,353,120,411,270,48,11,6,58,150,26,127,0,0
1878,353,121,411,273,48,11,6,58,152,27,127,0,0
1879,356,122,415,276,48,11,6,59,154,28,127,0,0
1880,361,122,421,278,48,11,6,60,156,29,127,0,0
1881,366,121,427,279,48,11,6,61,158,30,127,0,0
1882,370,121,433,287,48,11,6,63,166,31,127,0,0
1883,373,124,436,289,48,11,6,63,165,32,127,0,0
1884,374,125,437,288,48,11,6,63,163,33,127,0,0
1885,378,126,442,290,48,11,6,64,164,34,127,0,0
1886,384,128,448,293,48,11,6,64,165,35,127,0,0
1887,390,127,456,295,48,11,6,66,168,36,127,0,0
1888,397,127,464,297,48,11,6,67,170,37,127,0,0
1889,403,128,471,301,48,11,6,68,173,38,127,0,0
1890,409,133,476,303,48,11,6,67,170,39,127,0,0
1891,411,135,478,304,48,11,6,67,169,40,127,0,0
1892,418,138,486,312,48,11,6,68,174,41,127,0,0
1893,425,140,493,315,48,11,6,68,175,42,127,0,0
1894,437,139,507,317,48,11,6,70,178,43,127,0,0
1895,449,138,520,317,48,11,6,71,179,44,127,0,0
1896,451,139,525,323,48,11,6,74,184,45,127,0,0
1897,456,140,528,324,48,11,6,72,184,46,127,0,0
1898,467,142,538,324,48,11,6,71,182,47,127,0,0
1899,476,144,549,329,48,11,6,73,185,48,127,0,0
1900,491,143,565,332,48,11,6,74,189,49,127,0,0
1901,508,141,583,333,48,11,6,75,192,50,127,0,0
1902,519,147,591,332,48,11,6,72,185,51,127,0,0
1903,524,147,598,341,48,11,6,74,194,52,127,0,0
1904,531,146,605,344,48,11,6,74,198,53,127,0,0
1905,544,150,617,344,48,11,6,73,194,54,127,0,0
1906,549,150,626,350,48,11,6,77,200,55,127,0,0
1907,556,149,635,352,48,11,6,79,203,56,127,0,0
1908,569,146,651,353,48,11,6,82,207,57,127,0,0
1909,573,145,656,354,48,11,6,83,209,58,127,0,0
1910,577,145,659,353,48,11,6,82,208,59,127,0,0
1911,577,144,660,353,48,11,6,83,209,60,127,0,0
1912,575,144,659,353,48,11,6,84,209,61,127,0,0
1913,575,144,657,349,48,11,6,82,205,62,127,0,0
1914,578,144,657,345,48,11,6,79,201,63,127,0,0
1915,581,145,658,342,48,11,6,77,197,64,127,0,0
1916,584,144,661,344,48,11,6,77,200,65,127,0,0
1917,588,144,663,342,48,11,6,75,198,66,127,0,0
1918,589,144,663,341,48,11,6,74,197,67,127,0,0
1919,590,145,663,341,48,11,6,73,196,68,127,0,0
1920,590,144,663,341,48,11,6,73,197,69,127,0,0
1921,589,146,661,342,48,11,6,72,196,70,127,0,0
1922,587,145,659,342,48,11,6,72,197,71,127,0,0
1923,585,145,657,343,48,11,6,72,198,72,127,0,0
1924,584,145,655,343,48,11,6,71,198,73,127,0,0
1925,584,145,654,343,48,11,6,70,198,74,127,0,0
1926,583,145,653,343,48,11,6,70,198,75,127,0,0
1927,583,145,653,343,48,11,6,70,198,76,127,0,0
1928,582,145,652,343,48,11,6,70,198,77,127,0,0
1929,580,145,649,343,48,11,6,69,198,78,127,0,0
1930,580,145,649,344,48,11,6,69,199,79,127,0,0
1931,582,144,650,343,48,11,6,68,199,80,127,0,0
1932,580,144,647,343,48,11,6,67,199,81,127,0,0
1933,582,144,648,343,48,11,6,66,199,82,127,0,0
1934,584,144,649,343,48,11,6,65,199,83,127,0,0
1935,583,148,647,345,48,11,6,64,197,84,127,0,0
1936,584,144,647,344,48,11,6,63,200,85,127,0,0
1937,583,143,646,343,48,11,6,63,200,86,127,0,0
1938,584,143,645,343,48,11,6,61,200,87,127,0,0
1939,584,146,644,343,48,11,6,60,197,88,127,0,0
1940,585,147,643,342,48,11,6,58,195,89,127,0,0
1941,585,147,643,343,48,11,6,58,196,90,127,0,0
1942,585,148,643,344,48,11,6,58,196,91,127,0,0
1943,585,148,642,344,48,11,6,57,196,92,127,0,0
1944,585,148,642,344,48,11,6,57,196,93,127,0,0
1945,586,148,643,344,48,11,6,57,196,94,127,0,0
1946,587,147,644,344,48,11,6,57,197,95,127,0,0
1947,588,146,645,343,48,11,6,57,197,96,127,0,0
1948,589,148,645,346,48,11,6,56,198,97,127,0,0
1949,590,148,646,344,48,11,6,56,196,98,127,0,0
1950,589,149,645,346,48,11,6,56,197,99,127,0,0
1951,590,147,646,344,48,11,6,56,197,100,127,0,0
1952,589,150,644,344,48,11,6,55,194,101,127,0,0
1953,575,149,633,346,48,11,6,58,197,102,127,0,0
1954,569,151,629,348,48,11,6,60,197,103,127,0,0
1955,555,150,615,347,48,11,6,60,197,104,127,0,0
1956,536,146,595,344,48,11,6,59,198,105,127,0,0
1957,517,148,578,342,48,11,6,61,194,106,127,0,0
1958,500,147,564,344,48,11,6,64,197,107,127,0,0
1959,482,145,544,341,48,11,6,62,196,108,127,0,0
1960,464,144,528,345,48,11,6,64,201,109,127,0,0
1961,452,148,516,348,48,11,6,64,200,110,127,0,0
1962,436,146,499,346,48,11,6,63,200,111,127,0,0
1963,420,144,482,341,48,11,6,62,197,112,127,0,0
1964,402,143,465,340,48,11,6,63,197,113,127,0,0
1965,391,144,453,336,48,11,6,62,192,114,127,0,0
1966,375,142,437,333,48,11,6,62,191,115,127,0,0
1967,362,141,422,332,48,11,6,60,191,116,127,0,0
1968,349,141,408,330,48,11,6,59,189,117,127,0,0
1969,329,141,389,333,48,11,6,60,192,118,127,0,0
1970,309,141,370,329,48,11,6,61,188,119,127,0,0
1971,300,142,362,326,48,11,6,62,184,120,127,0,0
1972,292,144,355,324,48,11,6,63,180,121,127,0,0
1973,283,144,345,320,48,11,6,62,176,122,127,0,0
1974,274,142,337,322,48,11,6,63,180,123,127,0,0
1975,268,143,330,327,48,11,6,62,184,124,127,0,0
1976,262,143,323,326,48,11,6,61,183,125,127,0,0
1977,253,143,314,327,48,11,6,61,184,126,127,0,0
1978,243,142,303,326,48,11,6,60,184,127,127,1,0
1739,240,189,310,539,49,11,6,70,350,0,27,0,1
1740,249,192,320,548,49,11,6,71,356,1,27,0,0
1741,269,194,345,561,49,11,6,76,367,2,27,0,0
1742,287,198,367,572,49,11,6,80,374,3,27,0,0
1743,297,207,383,591,49,11,6,86,384,4,27,0,0
1744,306,210,398,603,49,11,6,92,393,5,27,0,0
1745,310,216,419,666,49,11,6,109,450,6,27,0,0
1746,312,222,434,705,49,11,6,122,483,7,27,0,0
1747,317,227,439,685,49,11,6,122,458,8,27,0,0
1748,334,241,462,705,49,11,6,128,464,9,27,0,0
1749,350,245,485,713,49,11,6,135,468,10,27,0,0
1750,365,255,510,738,49,11,6,145,483,11,27,0,0
1751,384,272,541,770,49,11,6,157,498,12,27,0,0
1752,405,280,572,798,49,11,6,167,518,13,27,0,0
1753,440,296,624,848,49,11,6,184,552,14,27,0,0
1754,468,302,663,876,49,11,6,195,574,15,27,0,0
1755,494,326,707,951,49,11,6,213,625,16,27,0,0
1756,526,347,748,984,49,11,6,222,637,17,27,0,0
1757,576,362,808,1016,49,11,6,232,654,18,27,0,0
1758,637,393,877,1063,49,11,6,240,670,19,27,0,0
1759,694,423,934,1080,49,11,6,240,657,20,27,0,0
1760,743,457,984,1080,49,11,6,241,623,21,27,0,0
1761,788,516,1025,1080,49,11,6,237,564,22,27,0,0
1762,873,564,1107,1080,49,11,6,234,516,23,27,0,0
1763,984,638,1196,1080,49,11,6,212,442,24,27,0,0
1764,1123,718,1310,1079,49,11,6,187,361,25,27,0,0
1765,1284,812,1447,1080,49,11,6,163,268,26,27,0,0
1766,1371,860,1513,1080,49,11,6,142,220,27,27,1,0
1800,777,177,821,426,52,11,6,44,249,0,34,0,1
1801,754,183,800,441,52,11,6,46,258,1,34,0,0
1802,732,186,779,438,52,11,6,47,252,2,34,0,0
1803,769,191,809,411,52,11,6,40,220,3,34,0,0
1804,776,180,820,421,52,11,6,44,241,4,34,0,0
1805,763,182,811,433,52,11,6,48,251,5,34,0,0
1806,749,183,798,434,52,11,6,49,251,6,34,0,0
1807,730,190,782,448,52,11,6,52,258,7,34,0,0
1808,709,191,767,463,52,11,6,58,272,8,34,0,0
1809,694,194,757,480,52,11,6,63,286,9,34,0,0
1810,684,199,752,499,52,11,6,68,300,10,34,0,0
1811,678,202,751,511,52,11,6,73,309,11,34,0,0
1812,669,212,745,526,52,11,6,76,314,12,34,0,0
1813,660,220,742,548,52,11,6,82,328,13,34,0,0
1814,651,226,740,572,52,11,6,89,346,14,34,0,0
1815,649,237,743,587,52,11,6,94,350,15,34,0,0
1816,653,244,753,609,52,11,6,100,365,16,34,0,0
1817,657,254,767,650,52,11,6,110,396,17,34,0,0
1818,665,262,782,676,52,11,6,117,414,18,34,0,0
1819,678,274,805,710,52,11,6,127,436,19,34,0,0
1820,699,281,838,746,52,11,6,139,465,20,34,0,0
1821,726,291,869,760,52,11,6,143,469,21,34,0,0
1822,746,312,904,822,52,11,6,158,510,22,34,0,0
1823,773,329,938,857,52,11,6,165,528,23,34,0,0
1824,793,350,973,916,52,11,6,180,566,24,34,0,0
1825,824,378,1015,968,52,11,6,191,590,25,34,0,0
1826,863,399,1065,1015,52,11,6,202,616,26,34,0,0
1827,902,440,1109,1065,52,11,6,207,625,27,34,0,0
1828,936,475,1144,1080,52,11,6,208,605,28,34,0,0
1829,975,521,1178,1080,52,11,6,203,559,29,34,0,0
1830,1045,579,1241,1080,52,11,6,196,501,30,34,0,0
1831,1128,637,1313,1080,52,11,6,185,443,31,34,0,0
1832,1205,731,1373,1080,52,11,6,168,349,32,34,0,0
1833,1317,852,1454,1080,52,11,6,137,228,33,34,0,0
1834,1373,902,1489,1080,52,11,6,116,178,34,34,1,0
1803,651,187,782,450,53,11,6,131,263,0,30,0,1
1804,637,175,769,442,53,11,6,132,267,1,30,0,0
1805,620,178,758,458,53,11,6,138,280,2,30,0,0
1806,600,184,737,466,53,11,6,137,282,3,30,0,0
1807,584,185,723,472,53,11,6,139,287,4,30,0,0
1808,559,191,701,488,53,11,6,142,297,5,30,0,0
1809,542,190,684,493,53,11,6,142,303,6,30,0,0
1810,530,197,674,513,53,11,6,144,316,7,30,0,0
1811,524,206,666,525,53,11,6,142,319,8,30,0,0
1812,520,210,663,534,53,11,6,143,324,9,30,0,0
1813,516,219,661,554,53,11,6,145,335,10,30,0,0
1814,511,225,656,567,53,11,6,145,342,11,30,0,0
1815,509,233,662,600,53,11,6,153,367,12,30,0,0
1816,517,240,676,629,53,11,6,159,389,13,30,0,0
1817,510,248,679,668,53,11,6,169,420,14,30,0,0
1818,505,262,685,705,53,11,6,180,443,15,30,0,0
1819,522,271,702,721,53,11,6,180,450,16,30,0,0
1820,539,288,729,769,53,11,6,190,481,17,30,0,0
1821,555,307,747,795,53,11,6,192,488,18,30,0,0
1822,559,325,763,851,53,11,6,204,526,19,30,0,0
1823,566,355,778,909,53,11,6,212,554,20,30,0,0
1824,577,374,789,930,53,11,6,212,556,21,30,0,0
1825,586,406,814,1010,53,11,6,228,604,22,30,0,0
1826,610,430,844,1052,53,11,6,234,622,23,30,0,0
1827,637,458,873,1075,53,11,6,236,617,24,30,0,0
1828,671,516,895,1080,53,11,6,224,564,25,30,0,0
1829,712,558,929,1080,53,11,6,217,522,26,30,0,0
1830,773,639,974,1080,53,11,6,201,441,27,30,0,0
1831,862,711,1058,1080,53,11,6,196,369,28,30,0,0
1832,930,837,1080,1080,53,11,6,150,243,29,30,0,0
1833,968,886,1099,1080,53,11,6,131,194,30,30,1,0
2203,1742,882,1920,1061,58,11,6,178,179,0,0,0,0
2204,1614,732,1914,1074,59,11,6,300,342,0,55,0,1
2205,1510,689,1840,1066,59,11,6,330,377,1,55,0,0
2206,1367,657,1729,1072,59,11,6,362,415,2,55,0,0
2207,1217,597,1626,1068,59,11,6,409,471,3,55,0,0
2208,1060,549,1511,1070,59,11,6,451,521,4,55,0,0
2209,946,497,1434,1067,59,11,6,488,570,5,55,0,0
2210,861,444,1382,1067,59,11,6,521,623,6,55,0,0
2211,763,416,1297,1067,59,11,6,534,651,7,55,0,0
2212,705,382,1223,1035,59,11,6,518,653,8,55,0,0
2213,631,351,1152,1027,59,11,6,521,676,9,55,0,0
2214,590,326,1091,995,59,11,6,501,669,10,55,0,0
2215,581,300,1026,915,59,11,6,445,615,11,55,0,0
2216,558,285,972,877,59,11,6,414,592,12,55,0,0
2217,540,278,905,816,59,11,6,365,538,13,55,0,0
2218,512,256,864,791,59,11,6,352,535,14,55,0,0
2219,492,241,823,760,59,11,6,331,519,15,55,0,0
2220,486,222,788,709,59,11,6,302,487,16,55,0,0
2221,478,217,761,689,59,11,6,283,472,17,55,0,0
2222,465,209,717,643,59,11,6,252,434,18,55,0,0
2223,443,202,680,623,59,11,6,237,421,19,55,0,0
2224,427,199,652,610,59,11,6,225,411,20,55,0,0
2225,424,188,630,573,59,11,6,206,385,21,55,0,0
2226,416,187,609,556,59,11,6,193,369,22,55,0,0
2227,404,181,582,533,59,11,6,178,352,23,55,0,0
2228,387,176,558,520,59,11,6,171,344,24,55,0,0
2229,374,175,537,510,59,11,6,163,335,25,55,0,0
2230,368,167,527,500,59,11,6,159,333,26,55,0,0
2231,363,164,513,484,59,11,6,150,320,27,55,0,0
2232,355,162,493,462,59,11,6,138,300,28,55,0,0
2233,347,157,476,444,59,11,6,129,287,29,55,0,0
2234,341,157,466,441,59,11,6,125,284,30,55,0,0
2235,338,150,459,428,59,11,6,121,278,31,55,0,0
2236,333,147,449,416,59,11,6,116,269,32,55,0,0
2237,329,147,441,411,59,11,6,112,264,33,55,0,0
2238,324,142,431,397,59,11,6,107,255,34,55,0,0
2239,318,141,422,390,59,11,6,104,249,35,55,0,0
2240,318,136,418,382,59,11,6,100,246,36,55,0,0
2241,318,133,416,372,59,11,6,98,239,37,55,0,0
2242,315,135,408,364,59,11,6,93,229,38,55,0,0
2243,316,134,406,357,59,11,6,90,223,39,55,0,0
2244,324,133,412,353,59,11,6,88,220,40,55,0,0
2245,332,134,419,352,59,11,6,87,218,41,55,0,0
2246,358,129,443,349,59,11,6,85,220,42,55,0,0
2247,385,131,471,349,59,11,6,86,218,43,55,0,0
2248,406,131,492,350,59,11,6,86,219,44,55,0,0
2249,444,130,527,345,59,11,6,83,215,45,55,0,0
2250,476,130,563,350,59,11,6,87,220,46,55,0,0
2251,505,131,591,352,59,11,6,86,221,47,55,0,0
2252,534,131,618,352,59,11,6,84,221,48,55,0,0
2253,552,134,640,360,59,11,6,88,226,49,55,0,0
2254,591,134,673,352,59,11,6,82,218,50,55,0,0
2255,623,133,707,352,59,11,6,84,219,51,55,0,0
2256,646,134,728,350,59,11,6,82,216,52,55,0,0
2257,678,131,756,342,59,11,6,78,211,53,55,0,0
2258,694,143,768,345,59,11,6,74,202,54,55,0,0
2259,715,144,788,343,59,11,6,73,199,55,55,1,0
2263,711,148,773,319,59,11,6,62,171,0,55,0,0
2264,724,149,784,315,59,11,6,60,166,1,55,0,0
2312,1047,846,1248,1068,64,11,6,201,222,0,148,0,1
2313,943,753,1231,1070,64,11,6,288,317,1,148,0,0
2314,838,679,1191,1068,64,11,6,353,389,2,148,0,0
2315,715,594,1143,1069,64,11,6,428,475,3,148,0,0
2316,608,533,1088,1070,64,11,6,480,537,4,148,0,0
2317,523,479,1044,1073,64,11,6,521,594,5,148,0,0
2318,471,434,1016,1072,64,11,6,545,638,6,148,0,0
2319,444,398,998,1070,64,11,6,554,672,7,148,0,0
2320,412,367,967,1068,64,11,6,555,701,8,148,0,0
2321,371,339,913,1052,64,11,6,542,713,9,148,0,0
2322,328,321,854,1036,64,11,6,526,715,10,148,0,0
2323,308,302,815,1017,64,11,6,507,715,11,148,0,0
2324,336,282,788,947,64,11,6,452,665,12,148,0,0
2325,353,275,762,907,64,11,6,409,632,13,148,0,0
2326,359,266,718,847,64,11,6,359,581,14,148,0,0
2327,334,256,666,812,64,11,6,332,556,15,148,0,0
2328,303,247,622,795,64,11,6,319,548,16,148,0,0
2329,289,233,592,769,64,11,6,303,536,17,148,0,0
2330,311,223,583,726,64,11,6,272,503,18,148,0,0
2331,316,222,567,705,64,11,6,251,483,19,148,0,0
2332,309,212,542,680,64,11,6,233,468,20,148,0,0
2333,286,207,499,644,64,11,6,213,437,21,148,0,0
2334,276,206,482,635,64,11,6,206,429,22,148,0,0
2335,285,198,478,612,64,11,6,193,414,23,148,0,0
2336,294,195,474,596,64,11,6,180,401,24,148,0,0
2337,293,195,462,585,64,11,6,169,390,25,148,0,0
2338,288,188,443,560,64,11,6,155,372,26,148,0,0
2339,274,183,422,550,64,11,6,148,367,27,148,0,0
2340,258,183,403,552,64,11,6,145,369,28,148,0,0
2341,253,176,390,538,64,11,6,137,362,29,148,0,0
2342,241,174,371,526,64,11,6,130,352,30,148,0,0
2343,232,175,356,521,64,11,6,124,346,31,148,0,0
2344,227,177,346,518,64,11,6,119,341,32,148,0,0
2345,221,174,336,515,64,11,6,115,341,33,148,0,0
2346,218,174,327,514,64,11,6,109,340,34,148,0,0
2347,219,176,324,513,64,11,6,105,337,35,148,0,0
2348,219,174,321,517,64,11,6,102,343,36,148,0,0
2349,221,177,318,517,64,11,6,97,340,37,148,0,0
2350,223,180,317,518,64,11,6,94,338,38,148,0,0
2351,225,182,316,519,64,11,6,91,337,39,148,0,0
2352,226,184,315,519,64,11,6,89,335,40,148,0,0
2353,228,184,314,519,64,11,6,86,335,41,148,0,0
2354,230,181,315,519,64,11,6,85,338,42,148,0,0
2355,231,179,315,518,64,11,6,84,339,43,148,0,0
2356,233,178,315,518,64,11,6,82,340,44,148,0,0
2357,234,177,315,518,64,11,6,81,341,45,148,0,0
2358,235,177,314,518,64,11,6,79,341,46,148,0,0
2359,236,177,314,516,64,11,6,78,339,47,148,0,0
2360,236,177,313,518,64,11,6,77,341,48,148,0,0
2361,237,177,313,520,64,11,6,76,343,49,148,0,0
2362,237,178,313,521,64,11,6,76,343,50,148,0,0
2363,237,178,313,521,64,11,6,76,343,51,148,0,0
2364,238,178,312,521,64,11,6,74,343,52,148,0,0
2365,238,180,311,520,64,11,6,73,340,53,148,0,0
2366,238,178,311,518,64,11,6,73,340,54,148,0,0
2367,239,178,311,517,64,11,6,72,339,55,148,0,0
2368,239,177,311,516,64,11,6,72,339,56,148,0,0
2369,240,178,311,515,64,11,6,71,337,57,148,0,0
2370,240,178,311,516,64,11,6,71,338,58,148,0,0
2371,240,177,311,517,64,11,6,71,340,59,148,0,0
2372,240,177,311,518,64,11,6,71,341,60,148,0,0
2373,241,177,312,520,64,11,6,71,343,61,148,0,0
2374,240,177,311,520,64,11,6,71,343,62,148,0,0
2375,241,177,311,520,64,11,6,70,343,63,148,0,0
2376,240,178,310,520,64,11,6,70,342,64,148,0,0
2377,240,178,310,521,64,11,6,70,343,65,148,0,0
2378,239,181,309,521,64,11,6,70,340,66,148,0,0
2379,239,181,308,521,64,11,6,69,340,67,148,0,0
2380,239,182,308,520,64,11,6,69,338,68,148,0,0
2381,240,180,309,520,64,11,6,69,340,69,148,0,0
2382,241,179,310,519,64,11,6,69,340,70,148,0,0
2383,241,179,310,519,64,11,6,69,340,71,148,0,0
2384,241,178,310,519,64,11,6,69,341,72,148,0,0
2385,241,178,310,521,64,11,6,69,343,73,148,0,0
2386,240,179,309,522,64,11,6,69,343,74,148,0,0
2387,239,180,308,521,64,11,6,69,341,75,148,0,0
2388,240,180,308,521,64,11,6,68,341,76,148,0,0
2389,241,179,309,521,64,11,6,68,342,77,148,0,0
2390,241,178,309,521,64,11,6,68,343,78,148,0,0
2391,241,178,309,518,64,11,6,68,340,79,148,0,0
2392,241,179,309,516,64,11,6,68,337,80,148,0,0
2393,241,179,309,516,64,11,6,68,337,81,148,0,0
2394,241,177,309,517,64,11,6,68,340,82,148,0,0
2395,241,178,309,515,64,11,6,68,337,83,148,0,0
2396,241,180,309,515,64,11,6,68,335,84,148,0,0
2397,241,180,308,514,64,11,6,67,334,85,148,0,0
2398,241,180,308,515,64,11,6,67,335,86,148,0,0
2399,241,180,308,515,64,11,6,67,335,87,148,0,0
2400,240,180,308,515,64,11,6,68,335,88,148,0,0
2401,241,179,309,517,64,11,6,68,338,89,148,0,0
2402,240,179,309,519,64,11,6,69,340,90,148,0,0
2403,241,179,309,520,64,11,6,68,341,91,148,0,0
2404,241,179,309,519,64,11,6,68,340,92,148,0,0
2405,241,179,309,521,64,11,6,68,342,93,148,0,0
2406,241,178,310,520,64,11,6,69,342,94,148,0,0
2407,241,178,310,519,64,11,6,69,341,95,148,0,0
2408,241,179,309,517,64,11,6,68,338,96,148,0,0
2409,241,179,309,516,64,11,6,68,337,97,148,0,0
2410,241,179,309,516,64,11,6,68,337,98,148,0,0
2411,241,179,309,515,64,11,6,68,336,99,148,0,0
2412,241,178,308,515,64,11,6,67,337,100,148,0,0
2413,241,179,308,514,64,11,6,67,335,101,148,0,0
2414,241,179,308,514,64,11,6,67,335,102,148,0,0
2415,240,178,309,518,64,11,6,69,340,103,148,0,0
2416,240,180,308,518,64,11,6,68,338,104,148,0,0
2417,241,180,309,518,64,11,6,68,338,105,148,0,0
2418,241,180,309,518,64,11,6,68,338,106,148,0,0
2419,240,181,308,518,64,11,6,68,337,107,148,0,0
2420,241,180,309,518,64,11,6,68,338,108,148,0,0
2421,240,180,308,518,64,11,6,68,338,109,148,0,0
2422,240,180,308,518,64,11,6,68,338,110,148,0,0
2423,241,179,309,518,64,11,6,68,339,111,148,0,0
2424,241,177,309,519,64,11,6,68,342,112,148,0,0
2425,241,177,310,521,64,11,6,69,344,113,148,0,0
2426,240,180,308,519,64,11,6,68,339,114,148,0,0
2427,241,178,309,522,64,11,6,68,344,115,148,0,0
2428,241,178,310,523,64,11,6,69,345,116,148,0,0
2429,240,178,309,520,64,11,6,69,342,117,148,0,0
2430,241,178,309,521,64,11,6,68,343,118,148,0,0
2431,240,179,308,521,64,11,6,68,342,119,148,0,0
2432,240,179,308,520,64,11,6,68,341,120,148,0,0
2433,240,180,308,520,64,11,6,68,340,121,148,0,0
2434,240,181,308,520,64,11,6,68,339,122,148,0,0
2435,240,181,308,520,64,11,6,68,339,123,148,0,0
2436,241,179,309,520,64,11,6,68,341,124,148,0,0
2437,241,179,309,521,64,11,6,68,342,125,148,0,0
2438,241,179,308,519,64,11,6,67,340,126,148,0,0
2439,240,179,308,518,64,11,6,68,339,127,148,0,0
2440,241,178,309,520,64,11,6,68,342,128,148,0,0
2441,240,179,308,520,64,11,6,68,341,129,148,0,0
2442,240,179,308,520,64,11,6,68,341,130,148,0,0
2443,241,179,308,520,64,11,6,67,341,131,148,0,0
2444,240,180,308,520,64,11,6,68,340,132,148,0,0
2445,240,180,307,519,64,11,6,67,339,133,148,0,0
2446,240,181,307,520,64,11,6,67,339,134,148,0,0
2447,240,181,308,520,64,11,6,68,339,135,148,0,0
2448,240,180,308,520,64,11,6,68,340,136,148,0,0
2449,241,178,309,520,64,11,6,68,342,137,148,0,0
2450,241,177,310,518,64,11,6,69,341,138,148,0,0
2451,241,178,310,518,64,11,6,69,340,139,148,0,0
2452,241,179,310,517,64,11,6,69,338,140,148,0,0
2453,241,180,309,517,64,11,6,68,337,141,148,0,0
2454,241,178,309,517,64,11,6,68,339,142,148,0,0
2455,241,178,309,515,64,11,6,68,337,143,148,0,0
2456,241,180,309,515,64,11,6,68,335,144,148,0,0
2457,241,184,308,516,64,11,6,67,332,145,148,0,0
2458,241,204,304,522,64,11,6,63,318,146,148,0,0
2459,241,206,304,526,64,11,6,63,320,147,148,0,0
2460,241,209,304,527,64,11,6,63,318,148,148,1,0
2758,256,157,304,350,70,11,6,48,193,0,26,0,1
2759,259,141,308,341,70,11,6,49,200,1,26,0,0
2760,262,141,313,348,70,11,6,51,207,2,26,0,0
2761,269,142,322,355,70,11,6,53,213,3,26,0,0
2762,279,141,333,356,70,11,6,54,215,4,26,0,0
2763,285,145,340,361,70,11,6,55,216,5,26,0,0
2764,291,143,348,364,70,11,6,57,221,6,26,0,0
2765,296,146,355,369,70,11,6,59,223,7,26,0,0
2766,300,148,361,374,70,11,6,61,226,8,26,0,0
2767,300,148,365,379,70,11,6,65,231,9,26,0,0
2768,303,153,372,388,70,11,6,69,235,10,26,0,0
2769,310,158,382,391,70,11,6,72,233,11,26,0,0
2770,321,159,399,404,70,11,6,78,245,12,26,0,0
2771,328,161,411,415,70,11,6,83,254,13,26,0,0
2772,337,161,423,421,70,11,6,86,260,14,26,0,0
2773,351,168,439,430,70,11,6,88,262,15,26,0,0
2774,368,169,459,433,70,11,6,91,264,16,26,0,0
2775,403,169,496,440,70,11,6,93,271,17,26,0,0
2776,428,172,526,452,70,11,6,98,280,18,26,0,0
2777,463,178,558,454,70,11,6,95,276,19,26,0,0
2778,501,173,603,461,70,11,6,102,288,20,26,0,0
2779,549,178,645,457,70,11,6,96,279,21,26,0,0
2780,592,180,685,455,70,11,6,93,275,22,26,0,0
2781,619,181,717,460,70,11,6,98,279,23,26,0,0
2782,668,180,768,466,70,11,6,100,286,24,26,0,0
2783,705,185,803,463,70,11,6,98,278,25,26,0,0
2784,732,187,831,467,70,11,6,99,280,26,26,1,0
2803,472,99,508,218,71,11,6,36,119,0,47,0,1
2804,462,98,498,218,71,11,6,36,120,1,47,0,0
2805,447,101,485,226,71,11,6,38,125,2,47,0,0
2806,436,99,476,227,71,11,6,40,128,3,47,0,0
2807,427,99,468,231,71,11,6,41,132,4,47,0,0
2808,417,104,459,234,71,11,6,42,130,5,47,0,0
2809,407,102,450,235,71,11,6,43,133,6,47,0,0
2810,398,104,444,240,71,11,6,46,136,7,47,0,0
2811,392,106,440,244,71,11,6,48,138,8,47,0,0
2812,391,106,439,245,71,11,6,48,139,9,47,0,0
2813,390,109,440,252,71,11,6,50,143,10,47,0,0
2814,386,111,437,252,71,11,6,51,141,11,47,0,0
2815,382,111,437,259,71,11,6,55,148,12,47,0,0
2816,383,112,441,266,71,11,6,58,154,13,47,0,0
2817,386,112,445,268,71,11,6,59,156,14,47,0,0
2818,386,111,452,286,71,11,6,66,175,15,47,0,0
2819,386,113,455,296,71,11,6,69,183,16,47,0,0
2820,388,114,455,286,71,11,6,67,172,17,47,0,0
2821,392,114,459,285,71,11,6,67,171,18,47,0,0
2822,397,112,467,290,71,11,6,70,178,19,47,0,0
2823,399,113,473,301,71,11,6,74,188,20,47,0,0
2824,401,115,476,309,71,11,6,75,194,21,47,0,0
2825,403,112,482,312,71,11,6,79,200,22,47,0,0
2826,409,115,489,320,71,11,6,80,205,23,47,0,0
2827,417,117,496,318,71,11,6,79,201,24,47,0,0
2828,425,120,504,323,71,11,6,79,203,25,47,0,0
2829,430,123,510,333,71,11,6,80,210,26,47,0,0
2830,436,126,522,349,71,11,6,86,223,27,47,0,0
2831,447,126,532,344,71,11,6,85,218,28,47,0,0
2832,460,131,544,350,71,11,6,84,219,29,47,0,0
2833,478,130,565,354,71,11,6,87,224,30,47,0,0
2834,489,132,576,357,71,11,6,87,225,31,47,0,0
2835,499,133,589,361,71,11,6,90,228,32,47,0,0
2836,517,133,607,364,71,11,6,90,231,33,47,0,0
2837,533,133,624,368,71,11,6,91,235,34,47,0,0
2838,546,140,635,373,71,11,6,89,233,35,47,0,0
2839,564,139,653,371,71,11,6,89,232,36,47,0,0
2840,573,140,663,375,71,11,6,90,235,37,47,0,0
2841,589,143,680,377,71,11,6,91,234,38,47,0,0
2842,614,143,702,375,71,11,6,88,232,39,47,0,0
2843,634,148,719,381,71,11,6,85,233,40,47,0,0
2844,657,157,736,373,71,11,6,79,216,41,47,0,0
2845,676,151,761,383,71,11,6,85,232,42,47,0,0
2846,686,154,774,394,71,11,6,88,240,43,47,0,0
2847,702,160,790,403,71,11,6,88,243,44,47,0,0
2848,727,162,813,400,71,11,6,86,238,45,47,0,0
2849,741,164,828,409,71,11,6,87,245,46,47,0,0
2850,756,166,844,413,71,11,6,88,247,47,47,1,0
3086,776,158,822,340,73,11,6,46,182,0,0,0,0
3087,696,162,801,376,74,11,6,105,214,0,19,0,1
3088,679,154,784,370,74,11,6,105,216,1,19,0,0
3089,639,156,744,370,74,11,6,105,214,2,19,0,0
3090,605,153,710,367,74,11,6,105,214,3,19,0,0
3091,581,146,684,360,74,11,6,103,214,4,19,0,0
3092,551,145,653,359,74,11,6,102,214,5,19,0,0
3093,530,143,630,355,74,11,6,100,212,6,19,0,0
3094,504,143,600,343,74,11,6,96,200,7,19,0,0
3095,488,139,584,338,74,11,6,96,199,8,19,0,0
3096,485,137,578,334,74,11,6,93,197,9,19,0,0
3097,479,136,571,336,74,11,6,92,200,10,19,0,0
3098,472,132,560,327,74,11,6,88,195,11,19,0,0
3099,468,126,553,315,74,11,6,85,189,12,19,0,0
3100,481,128,568,314,74,11,6,87,186,13,19,0,0
3101,484,125,568,309,74,11,6,84,184,14,19,0,0
3102,486,126,566,304,74,11,6,80,178,15,19,0,0
3103,492,129,567,300,74,11,6,75,171,16,19,0,0
3104,489,135,556,290,74,11,6,67,155,17,19,0,0
3105,488,132,546,273,74,11,6,58,141,18,19,0,0
3106,482,131,538,266,74,11,6,56,135,19,19,0,0
3096,751,154,820,362,77,11,6,69,208,0,618,0,1
3097,725,151,802,385,77,11,6,77,234,1,618,0,0
3098,706,147,778,365,77,11,6,72,218,2,618,0,0
3099,681,143,739,315,77,11,6,58,172,3,618,0,0
3100,644,148,714,352,77,11,6,70,204,4,618,0,0
3101,614,147,675,326,77,11,6,61,179,5,618,0,0
3102,571,141,648,362,77,11,6,77,221,6,618,0,0
3103,535,133,622,376,77,11,6,87,243,7,618,0,0
3104,514,131,599,364,77,11,6,85,233,8,618,0,0
3105,501,131,585,365,77,11,6,84,234,9,618,0,0
3106,485,129,570,360,77,11,6,85,231,10,618,0,0
3107,473,128,555,349,77,11,6,82,221,11,618,0,0
3108,468,123,543,320,77,11,6,75,197,12,618,0,0
3109,457,121,536,327,77,11,6,79,206,13,618,0,0
3110,447,122,526,328,77,11,6,79,206,14,618,0,0
3111,438,124,515,328,77,11,6,77,204,15,618,0,0
3112,435,123,511,325,77,11,6,76,202,16,618,0,0
3113,439,126,513,320,77,11,6,74,194,17,618,0,0
3114,449,124,522,315,77,11,6,73,191,18,618,0,0
3115,457,122,531,309,77,11,6,74,187,19,618,0,0
3116,458,123,534,309,77,11,6,76,186,20,618,0,0
3117,462,127,537,309,77,11,6,75,182,21,618,0,0
3118,462,128,539,309,77,11,6,77,181,22,618,0,0
3119,464,131,539,305,77,11,6,75,174,23,618,0,0
3120,464,131,539,303,77,11,6,75,172,24,618,0,0
3121,462,131,537,300,77,11,6,75,169,25,618,0,0
3122,462,131,538,299,77,11,6,76,168,26,618,0,0
3123,463,130,540,299,77,11,6,77,169,27,618,0,0
3124,463,130,541,299,77,11,6,78,169,28,618,0,0
3125,462,129,542,299,77,11,6,80,170,29,618,0,0
3126,463,129,543,298,77,11,6,80,169,30,618,0,0
3127,464,129,544,298,77,11,6,80,169,31,618,0,0
3128,463,128,544,298,77,11,6,81,170,32,618,0,0
3129,463,128,544,297,77,11,6,81,169,33,618,0,0
3130,461,128,543,297,77,11,6,82,169,34,618,0,0
3131,460,125,544,298,77,11,6,84,173,35,618,0,0
3132,459,124,545,299,77,11,6,86,175,36,618,0,0
3133,459,123,545,298,77,11,6,86,175,37,618,0,0
3134,457,122,545,300,77,11,6,88,178,38,618,0,0
3135,457,122,545,302,77,11,6,88,180,39,618,0,0
3136,457,121,546,302,77,11,6,89,181,40,618,0,0
3137,458,120,548,304,77,11,6,90,184,41,618,0,0
3138,457,120,547,304,77,11,6,90,184,42,618,0,0
3139,458,120,549,304,77,11,6,91,184,43,618,0,0
3140,455,118,546,303,77,11,6,91,185,44,618,0,0
3141,453,120,543,305,77,11,6,90,185,45,618,0,0
3142,449,123,538,307,77,11,6,89,184,46,618,0,0
3143,446,123,533,310,77,11,6,87,187,47,618,0,0
3144,444,122,531,313,77,11,6,87,191,48,618,0,0
3145,443,121,530,317,77,11,6,87,196,49,618,0,0
3146,444,121,529,317,77,11,6,85,196,50,618,0,0
3147,446,121,528,316,77,11,6,82,195,51,618,0,0
3148,447,121,528,315,77,11,6,81,194,52,618,0,0
3149,448,121,526,314,77,11,6,78,193,53,618,0,0
3150,449,121,526,312,77,11,6,77,191,54,618,0,0
3151,450,121,525,310,77,11,6,75,189,55,618,0,0
3152,450,121,524,309,77,11,6,74,188,56,618,0,0
3153,451,121,524,309,77,11,6,73,188,57,618,0,0
3154,451,121,523,309,77,11,6,72,188,58,618,0,0
3155,452,122,522,308,77,11,6,70,186,59,618,0,0
3156,451,121,521,307,77,11,6,70,186,60,618,0,0
3157,451,121,520,307,77,11,6,69,186,61,618,0,0
3158,452,121,520,307,77,11,6,68,186,62,618,0,0
3159,451,120,519,307,77,11,6,68,187,63,618,0,0
3160,451,120,518,308,77,11,6,67,188,64,618,0,0
3161,451,120,517,308,77,11,6,66,188,65,618,0,0
3162,449,120,516,311,77,11,6,67,191,66,618,0,0
3163,445,118,512,315,77,11,6,67,197,67,618,0,0
3164,444,119,510,316,77,11,6,66,197,68,618,0,0
3165,443,119,510,323,77,11,6,67,204,69,618,0,0
3166,443,121,508,325,77,11,6,65,204,70,618,0,0
3167,445,128,506,320,77,11,6,61,192,71,618,0,0
3168,445,127,506,320,77,11,6,61,193,72,618,0,0
3169,461,129,528,333,77,11,6,67,204,73,618,0,0
3170,461,127,534,348,77,11,6,73,221,74,618,0,0
3171,456,134,527,349,77,11,6,71,215,75,618,0,0
3172,478,136,546,335,77,11,6,68,199,76,618,0,0
3173,491,137,561,339,77,11,6,70,202,77,618,0,0
3174,497,142,566,336,77,11,6,69,194,78,618,0,0
3175,503,150,570,333,77,11,6,67,183,79,618,0,0
3176,503,159,569,331,77,11,6,66,172,80,618,0,0
3177,502,157,570,329,77,11,6,68,172,81,618,0,0
3178,502,147,574,330,77,11,6,72,183,82,618,0,0
3179,500,134,578,332,77,11,6,78,198,83,618,0,0
3180,493,127,574,333,77,11,6,81,206,84,618,0,0
3181,486,124,567,332,77,11,6,81,208,85,618,0,0
3182,483,123,564,333,77,11,6,81,210,86,618,0,0
3183,482,121,563,332,77,11,6,81,211,87,618,0,0
3184,481,119,562,332,77,11,6,81,213,88,618,0,0
3185,479,118,560,332,77,11,6,81,214,89,618,0,0
3186,480,119,560,331,77,11,6,80,212,90,618,0,0
3187,481,121,560,330,77,11,6,79,209,91,618,0,0
3188,482,121,560,330,77,11,6,78,209,92,618,0,0
3189,481,121,559,330,77,11,6,78,209,93,618,0,0
3190,480,120,557,330,77,11,6,77,210,94,618,0,0
3191,480,124,555,329,77,11,6,75,205,95,618,0,0
3192,479,127,551,324,77,11,6,72,197,96,618,0,0
3193,477,125,550,329,77,11,6,73,204,97,618,0,0
3194,479,124,553,329,77,11,6,74,205,98,618,0,0
3195,481,123,555,330,77,11,6,74,207,99,618,0,0
3196,482,122,556,330,77,11,6,74,208,100,618,0,0
3197,482,121,556,332,77,11,6,74,211,101,618,0,0
3198,480,121,555,332,77,11,6,75,211,102,618,0,0
3199,472,125,548,339,77,11,6,76,214,103,618,0,0
3200,465,127,541,341,77,11,6,76,214,104,618,0,0
3201,458,129,534,344,77,11,6,76,215,105,618,0,0
3202,453,128,529,345,77,11,6,76,217,106,618,0,0
3203,451,131,524,340,77,11,6,73,209,107,618,0,0
3204,449,128,524,343,77,11,6,75,215,108,618,0,0
3205,449,127,523,344,77,11,6,74,217,109,618,0,0
3206,449,128,522,344,77,11,6,73,216,110,618,0,0
3207,450,129,522,343,77,11,6,72,214,111,618,0,0
3208,449,129,521,344,77,11,6,72,215,112,618,0,0
3209,449,130,521,345,77,11,6,72,215,113,618,0,0
3210,449,130,522,350,77,11,6,73,220,114,618,0,0
3211,450,131,521,350,77,11,6,71,219,115,618,0,0
3212,438,136,515,375,77,11,6,77,239,116,618,0,0
3213,442,134,520,380,77,11,6,78,246,117,618,0,0
3214,459,148,533,381,77,11,6,74,233,118,618,0,0
3215,451,137,525,371,77,11,6,74,234,119,618,0,0
3216,450,133,521,363,77,11,6,71,230,120,618,0,0
3217,451,132,519,350,77,11,6,68,218,121,618,0,0
3218,451,132,518,346,77,11,6,67,214,122,618,0,0
3219,451,133,517,345,77,11,6,66,212,123,618,0,0
3220,452,133,517,343,77,11,6,65,210,124,618,0,0
3221,453,134,517,338,77,11,6,64,204,125,618,0,0
3222,453,134,518,339,77,11,6,65,205,126,618,0,0
3223,453,133,518,340,77,11,6,65,207,127,618,0,0
3224,453,132,519,341,77,11,6,66,209,128,618,0,0
3225,453,132,519,341,77,11,6,66,209,129,618,0,0
3226,453,131,519,340,77,11,6,66,209,130,618,0,0
3227,453,132,518,339,77,11,6,65,207,131,618,0,0
3228,454,132,519,340,77,11,6,65,208,132,618,0,0
3229,454,132,519,340,77,11,6,65,208,133,618,0,0
3230,454,132,519,340,77,11,6,65,208,134,618,0,0
3231,453,133,518,340,77,11,6,65,207,135,618,0,0
3232,453,133,518,339,77,11,6,65,206,136,618,0,0
3233,453,133,518,339,77,11,6,65,206,137,618,0,0
3234,452,133,518,339,77,11,6,66,206,138,618,0,0
3235,452,133,519,340,77,11,6,67,207,139,618,0,0
3236,452,133,519,340,77,11,6,67,207,140,618,0,0
3237,452,133,519,339,77,11,6,67,206,141,618,0,0
3238,452,133,519,339,77,11,6,67,206,142,618,0,0
3239,452,133,519,339,77,11,6,67,206,143,618,0,0
3240,452,132,519,339,77,11,6,67,207,144,618,0,0
3241,453,133,520,341,77,11,6,67,208,145,618,0,0
3242,455,134,522,342,77,11,6,67,208,146,618,0,0
3243,458,137,525,343,77,11,6,67,206,147,618,0,0
3244,462,137,529,340,77,11,6,67,203,148,618,0,0
3245,463,136,531,343,77,11,6,68,207,149,618,0,0
3246,464,136,532,342,77,11,6,68,206,150,618,0,0
3247,460,137,529,343,77,11,6,69,206,151,618,0,0
3248,455,136,525,344,77,11,6,70,208,152,618,0,0
3249,451,134,522,346,77,11,6,71,212,153,618,0,0
3250,449,134,522,347,77,11,6,73,213,154,618,0,0
3251,445,133,518,349,77,11,6,73,216,155,618,0,0
3252,442,131,514,343,77,11,6,72,212,156,618,0,0
3253,441,131,512,342,77,11,6,71,211,157,618,0,0
3254,440,132,512,343,77,11,6,72,211,158,618,0,0
3255,436,131,508,346,77,11,6,72,215,159,618,0,0
3256,435,133,505,348,77,11,6,70,215,160,618,0,0
3257,436,132,506,346,77,11,6,70,214,161,618,0,0
3258,437,130,507,348,77,11,6,70,218,162,618,0,0
3259,437,126,508,346,77,11,6,71,220,163,618,0,0
3260,438,127,508,346,77,11,6,70,219,164,618,0,0
3261,440,128,508,345,77,11,6,68,217,165,618,0,0
3262,443,128,511,344,77,11,6,68,216,166,618,0,0
3263,446,128,514,343,77,11,6,68,215,167,618,0,0
3264,447,129,514,343,77,11,6,67,214,168,618,0,0
3265,450,132,514,338,77,11,6,64,206,169,618,0,0
3266,453,132,517,335,77,11,6,64,203,170,618,0,0
3267,455,130,520,334,77,11,6,65,204,171,618,0,0
3268,458,128,523,336,77,11,6,65,208,172,618,0,0
3269,463,126,527,333,77,11,6,64,207,173,618,0,0
3270,467,126,531,336,77,11,6,64,210,174,618,0,0
3271,473,126,538,337,77,11,6,65,211,175,618,0,0
3272,478,126,544,336,77,11,6,66,210,176,618,0,0
3273,486,124,552,332,77,11,6,66,208,177,618,0,0
3274,495,124,563,334,77,11,6,68,210,178,618,0,0
3275,507,124,575,330,77,11,6,68,206,179,618,0,0
3276,510,123,580,331,77,11,6,70,208,180,618,0,0
3277,509,124,577,327,77,11,6,68,203,181,618,0,0
3278,515,121,586,325,77,11,6,71,204,182,618,0,0
3279,514,120,586,322,77,11,6,72,202,183,618,0,0
3280,512,120,584,323,77,11,6,72,203,184,618,0,0
3281,511,119,582,318,77,11,6,71,199,185,618,0,0
3282,508,121,578,316,77,11,6,70,195,186,618,0,0
3283,504,120,578,322,77,11,6,74,202,187,618,0,0
3284,502,122,574,324,77,11,6,72,202,188,618,0,0
3285,501,124,573,324,77,11,6,72,200,189,618,0,0
3286,501,124,572,324,77,11,6,71,200,190,618,0,0
3287,501,124,572,323,77,11,6,71,199,191,618,0,0
3288,501,125,571,323,77,11,6,70,198,192,618,0,0
3289,502,124,573,323,77,11,6,71,199,193,618,0,0
3290,502,124,573,327,77,11,6,71,203,194,618,0,0
3291,503,124,573,324,77,11,6,70,200,195,618,0,0
3292,502,122,574,328,77,11,6,72,206,196,618,0,0
3293,503,123,573,324,77,11,6,70,201,197,618,0,0
3294,503,123,573,323,77,11,6,70,200,198,618,0,0
3295,503,126,571,320,77,11,6,68,194,199,618,0,0
3296,504,124,575,321,77,11,6,71,197,200,618,0,0
3297,504,124,575,322,77,11,6,71,198,201,618,0,0
3298,504,123,576,322,77,11,6,72,199,202,618,0,0
3299,505,121,579,322,77,11,6,74,201,203,618,0,0
3300,504,121,578,322,77,11,6,74,201,204,618,0,0
3301,502,122,576,322,77,11,6,74,200,205,618,0,0
3302,502,122,576,322,77,11,6,74,200,206,618,0,0
3303,502,122,576,322,77,11,6,74,200,207,618,0,0
3304,502,122,576,322,77,11,6,74,200,208,618,0,0
3305,501,122,575,322,77,11,6,74,200,209,618,0,0
3306,500,122,573,322,77,11,6,73,200,210,618,0,0
3307,501,122,574,322,77,11,6,73,200,211,618,0,0
3308,499,124,573,325,77,11,6,74,201,212,618,0,0
3309,500,124,573,323,77,11,6,73,199,213,618,0,0
3310,500,124,573,327,77,11,6,73,203,214,618,0,0
3311,502,123,575,324,77,11,6,73,201,215,618,0,0
3312,503,123,576,323,77,11,6,73,200,216,618,0,0
3313,505,121,580,323,77,11,6,75,202,217,618,0,0
3314,503,121,578,324,77,11,6,75,203,218,618,0,0
3315,500,124,574,324,77,11,6,74,200,219,618,0,0
3316,499,124,573,325,77,11,6,74,201,220,618,0,0
3317,499,125,572,325,77,11,6,73,200,221,618,0,0
3318,500,125,572,324,77,11,6,72,199,222,618,0,0
3319,500,126,571,324,77,11,6,71,198,223,618,0,0
3320,500,125,571,324,77,11,6,71,199,224,618,0,0
3321,501,125,571,325,77,11,6,70,200,225,618,0,0
3322,501,125,571,324,77,11,6,70,199,226,618,0,0
3323,501,124,571,324,77,11,6,70,200,227,618,0,0
3324,501,124,570,324,77,11,6,69,200,228,618,0,0
3325,502,124,571,323,77,11,6,69,199,229,618,0,0
3326,502,124,570,323,77,11,6,68,199,230,618,0,0
3327,502,125,570,323,77,11,6,68,198,231,618,0,0
3328,502,125,569,323,77,11,6,67,198,232,618,0,0
3329,502,125,569,323,77,11,6,67,198,233,618,0,0
3330,502,125,569,323,77,11,6,67,198,234,618,0,0
3331,503,125,570,323,77,11,6,67,198,235,618,0,0
3332,503,125,571,323,77,11,6,68,198,236,618,0,0
3333,504,124,570,321,77,11,6,66,197,237,618,0,0
3334,502,124,568,321,77,11,6,66,197,238,618,0,0
3335,503,123,570,321,77,11,6,67,198,239,618,0,0
3336,501,123,568,319,77,11,6,67,196,240,618,0,0
3337,505,122,571,316,77,11,6,66,194,241,618,0,0
3338,505,121,574,320,77,11,6,69,199,242,618,0,0
3339,507,121,575,317,77,11,6,68,196,243,618,0,0
3340,510,121,578,315,77,11,6,68,194,244,618,0,0
3341,513,122,582,318,77,11,6,69,196,245,618,0,0
3342,518,120,584,309,77,11,6,66,189,246,618,0,0
3343,518,119,584,308,77,11,6,66,189,247,618,0,0
3344,517,118,584,309,77,11,6,67,191,248,618,0,0
3345,515,117,582,311,77,11,6,67,194,249,618,0,0
3346,512,117,580,314,77,11,6,68,197,250,618,0,0
3347,509,119,577,317,77,11,6,68,198,251,618,0,0
3348,508,120,575,318,77,11,6,67,198,252,618,0,0
3349,506,121,571,312,77,11,6,65,191,253,618,0,0
3350,498,121,565,316,77,11,6,67,195,254,618,0,0
3351,491,121,560,318,77,11,6,69,197,255,618,0,0
3352,487,122,556,318,77,11,6,69,196,256,618,0,0
3353,486,120,555,317,77,11,6,69,197,257,618,0,0
3354,483,121,551,315,77,11,6,68,194,258,618,0,0
3355,482,121,549,313,77,11,6,67,192,259,618,0,0
3356,482,121,549,312,77,11,6,67,191,260,618,0,0
3357,482,120,549,313,77,11,6,67,193,261,618,0,0
3358,482,120,549,313,77,11,6,67,193,262,618,0,0
3359,483,119,549,312,77,11,6,66,193,263,618,0,0
3360,482,120,548,312,77,11,6,66,192,264,618,0,0
3361,481,120,547,312,77,11,6,66,192,265,618,0,0
3362,480,120,546,313,77,11,6,66,193,266,618,0,0
3363,481,119,547,313,77,11,6,66,194,267,618,0,0
3364,482,119,547,313,77,11,6,65,194,268,618,0,0
3365,484,118,550,314,77,11,6,66,196,269,618,0,0
3366,488,118,554,314,77,11,6,66,196,270,618,0,0
3367,492,119,558,314,77,11,6,66,195,271,618,0,0
3368,492,119,560,317,77,11,6,68,198,272,618,0,0
3369,490,121,559,322,77,11,6,69,201,273,618,0,0
3370,486,121,556,324,77,11,6,70,203,274,618,0,0
3371,482,121,552,325,77,11,6,70,204,275,618,0,0
3372,479,122,549,326,77,11,6,70,204,276,618,0,0
3373,477,122,547,326,77,11,6,70,204,277,618,0,0
3374,478,122,549,332,77,11,6,71,210,278,618,0,0
3375,481,122,552,333,77,11,6,71,211,279,618,0,0
3376,485,122,557,335,77,11,6,72,213,280,618,0,0
3377,490,124,561,336,77,11,6,71,212,281,618,0,0
3378,490,126,562,337,77,11,6,72,211,282,618,0,0
3379,490,128,561,339,77,11,6,71,211,283,618,0,0
3380,488,128,559,339,77,11,6,71,211,284,618,0,0
3381,483,129,555,341,77,11,6,72,212,285,618,0,0
3382,481,130,553,343,77,11,6,72,213,286,618,0,0
3383,481,131,553,343,77,11,6,72,212,287,618,0,0
3384,481,131,553,343,77,11,6,72,212,288,618,0,0
3385,482,135,552,344,77,11,6,70,209,289,618,0,0
3386,482,135,552,341,77,11,6,70,206,290,618,0,0
3387,481,132,553,342,77,11,6,72,210,291,618,0,0
3388,481,129,555,344,77,11,6,74,215,292,618,0,0
3389,485,129,560,343,77,11,6,75,214,293,618,0,0
3390,492,129,567,345,77,11,6,75,216,294,618,0,0
3391,498,131,574,347,77,11,6,76,216,295,618,0,0
3392,501,131,578,351,77,11,6,77,220,296,618,0,0
3393,501,132,579,353,77,11,6,78,221,297,618,0,0
3394,497,133,576,356,77,11,6,79,223,298,618,0,0
3395,497,134,573,351,77,11,6,76,217,299,618,0,0
3396,496,135,573,354,77,11,6,77,219,300,618,0,0
3397,494,133,574,358,77,11,6,80,225,301,618,0,0
3398,495,132,575,359,77,11,6,80,227,302,618,0,0
3399,495,132,575,360,77,11,6,80,228,303,618,0,0
3400,495,132,575,360,77,11,6,80,228,304,618,0,0
3401,495,133,574,357,77,11,6,79,224,305,618,0,0
3402,493,132,573,360,77,11,6,80,228,306,618,0,0
3403,493,132,572,360,77,11,6,79,228,307,618,0,0
3404,493,132,572,360,77,11,6,79,228,308,618,0,0
3405,493,132,572,361,77,11,6,79,229,309,618,0,0
3406,493,132,573,362,77,11,6,80,230,310,618,0,0
3407,494,132,572,357,77,11,6,78,225,311,618,0,0
3408,493,132,572,360,77,11,6,79,228,312,618,0,0
3409,492,132,573,361,77,11,6,81,229,313,618,0,0
3410,493,133,572,354,77,11,6,79,221,314,618,0,0
3411,494,133,573,356,77,11,6,79,223,315,618,0,0
3412,493,132,573,357,77,11,6,80,225,316,618,0,0
3413,493,132,573,357,77,11,6,80,225,317,618,0,0
3414,493,134,573,358,77,11,6,80,224,318,618,0,0
3415,498,135,576,355,77,11,6,78,220,319,618,0,0
3416,503,137,581,357,77,11,6,78,220,320,618,0,0
3417,510,135,589,358,77,11,6,79,223,321,618,0,0
3418,517,134,598,358,77,11,6,81,224,322,618,0,0
3419,523,130,605,360,77,11,6,82,230,323,618,0,0
3420,526,130,608,360,77,11,6,82,230,324,618,0,0
3421,527,130,609,361,77,11,6,82,231,325,618,0,0
3422,528,129,611,361,77,11,6,83,232,326,618,0,0
3423,528,130,611,362,77,11,6,83,232,327,618,0,0
3424,528,130,610,361,77,11,6,82,231,328,618,0,0
3425,526,130,608,361,77,11,6,82,231,329,618,0,0
3426,526,132,608,363,77,11,6,82,231,330,618,0,0
3427,526,132,608,363,77,11,6,82,231,331,618,0,0
3428,526,131,608,362,77,11,6,82,231,332,618,0,0
3429,526,131,608,363,77,11,6,82,232,333,618,0,0
3430,527,130,608,361,77,11,6,81,231,334,618,0,0
3431,526,130,607,361,77,11,6,81,231,335,618,0,0
3432,526,130,606,359,77,11,6,80,229,336,618,0,0
3433,526,130,606,359,77,11,6,80,229,337,618,0,0
3434,525,131,606,359,77,11,6,81,228,338,618,0,0
3435,524,131,604,359,77,11,6,80,228,339,618,0,0
3436,523,131,604,361,77,11,6,81,230,340,618,0,0
3437,522,132,603,361,77,11,6,81,229,341,618,0,0
3438,522,133,603,361,77,11,6,81,228,342,618,0,0
3439,522,133,602,362,77,11,6,80,229,343,618,0,0
3440,521,134,602,361,77,11,6,81,227,344,618,0,0
3441,521,133,601,361,77,11,6,80,228,345,618,0,0
3442,522,131,604,362,77,11,6,82,231,346,618,0,0
3443,521,130,603,364,77,11,6,82,234,347,618,0,0
3444,521,134,601,363,77,11,6,80,229,348,618,0,0
3445,523,138,603,364,77,11,6,80,226,349,618,0,0
3446,518,139,595,361,77,11,6,77,222,350,618,0,0
3447,514,140,591,358,77,11,6,77,218,351,618,0,0
3448,509,141,584,355,77,11,6,75,214,352,618,0,0
3449,504,140,581,359,77,11,6,77,219,353,618,0,0
3450,499,139,576,361,77,11,6,77,222,354,618,0,0
3451,496,139,575,364,77,11,6,79,225,355,618,0,0
3452,493,137,571,361,77,11,6,78,224,356,618,0,0
3453,494,135,572,360,77,11,6,78,225,357,618,0,0
3454,496,134,575,360,77,11,6,79,226,358,618,0,0
3455,499,134,578,360,77,11,6,79,226,359,618,0,0
3456,501,134,580,360,77,11,6,79,226,360,618,0,0
3457,501,135,580,360,77,11,6,79,225,361,618,0,0
3458,501,135,580,360,77,11,6,79,225,362,618,0,0
3459,501,135,580,360,77,11,6,79,225,363,618,0,0
3460,501,135,580,360,77,11,6,79,225,364,618,0,0
3461,501,135,580,360,77,11,6,79,225,365,618,0,0
3462,500,135,580,360,77,11,6,80,225,366,618,0,0
3463,500,135,580,361,77,11,6,80,226,367,618,0,0
3464,501,135,580,360,77,11,6,79,225,368,618,0,0
3465,501,135,580,360,77,11,6,79,225,369,618,0,0
3466,501,135,580,360,77,11,6,79,225,370,618,0,0
3467,500,135,580,360,77,11,6,80,225,371,618,0,0
3468,500,134,580,360,77,11,6,80,226,372,618,0,0
3469,500,134,581,361,77,11,6,81,227,373,618,0,0
3470,500,134,581,361,77,11,6,81,227,374,618,0,0
3471,501,134,581,362,77,11,6,80,228,375,618,0,0
3472,501,135,581,362,77,11,6,80,227,376,618,0,0
3473,501,135,581,362,77,11,6,80,227,377,618,0,0
3474,500,135,581,362,77,11,6,81,227,378,618,0,0
3475,501,135,581,362,77,11,6,80,227,379,618,0,0
3476,501,134,581,362,77,11,6,80,228,380,618,0,0
3477,501,134,581,361,77,11,6,80,227,381,618,0,0
3478,501,134,581,361,77,11,6,80,227,382,618,0,0
3479,501,136,581,361,77,11,6,80,225,383,618,0,0
3480,501,135,581,360,77,11,6,80,225,384,618,0,0
3481,502,136,581,360,77,11,6,79,224,385,618,0,0
3482,502,137,581,360,77,11,6,79,223,386,618,0,0
3483,502,137,581,360,77,11,6,79,223,387,618,0,0
3484,502,139,580,358,77,11,6,78,219,388,618,0,0
3485,502,139,580,360,77,11,6,78,221,389,618,0,0
3486,502,139,580,358,77,11,6,78,219,390,618,0,0
3487,502,139,580,360,77,11,6,78,221,391,618,0,0
3488,502,139,580,360,77,11,6,78,221,392,618,0,0
3489,501,139,579,358,77,11,6,78,219,393,618,0,0
3490,501,139,580,360,77,11,6,79,221,394,618,0,0
3491,501,139,580,360,77,11,6,79,221,395,618,0,0
3492,501,139,580,360,77,11,6,79,221,396,618,0,0
3493,501,139,580,361,77,11,6,79,222,397,618,0,0
3494,501,139,580,361,77,11,6,79,222,398,618,0,0
3495,501,138,579,357,77,11,6,78,219,399,618,0,0
3496,500,138,578,358,77,11,6,78,220,400,618,0,0
3497,497,138,576,360,77,11,6,79,222,401,618,0,0
3498,494,138,573,360,77,11,6,79,222,402,618,0,0
3499,491,137,570,360,77,11,6,79,223,403,618,0,0
3500,490,137,568,358,77,11,6,78,221,404,618,0,0
3501,489,137,569,360,77,11,6,80,223,405,618,0,0
3502,492,136,572,357,77,11,6,80,221,406,618,0,0
3503,497,136,577,356,77,11,6,80,220,407,618,0,0
3504,502,137,581,354,77,11,6,79,217,408,618,0,0
3505,507,137,585,353,77,11,6,78,216,409,618,0,0
3506,508,139,586,353,77,11,6,78,214,410,618,0,0
3507,508,143,583,350,77,11,6,75,207,411,618,0,0
3508,511,148,583,347,77,11,6,72,199,412,618,0,0
3509,515,154,584,345,77,11,6,69,191,413,618,0,0
3510,519,156,586,342,77,11,6,67,186,414,618,0,0
3511,520,150,588,340,77,11,6,68,190,415,618,0,0
3512,519,143,589,341,77,11,6,70,198,416,618,0,0
3513,516,135,588,340,77,11,6,72,205,417,618,0,0
3514,508,129,583,345,77,11,6,75,216,418,618,0,0
3515,500,128,576,345,77,11,6,76,217,419,618,0,0
3516,490,126,564,337,77,11,6,74,211,420,618,0,0
3517,475,127,549,340,77,11,6,74,213,421,618,0,0
3518,462,126,537,339,77,11,6,75,213,422,618,0,0
3519,445,126,517,332,77,11,6,72,206,423,618,0,0
3520,423,123,496,329,77,11,6,73,206,424,618,0,0
3521,404,122,479,332,77,11,6,75,210,425,618,0,0
3522,386,123,458,327,77,11,6,72,204,426,618,0,0
3523,369,121,440,323,77,11,6,71,202,427,618,0,0
3524,353,119,423,320,77,11,6,70,201,428,618,0,0
3525,338,120,406,317,77,11,6,68,197,429,618,0,0
3526,323,120,391,317,77,11,6,68,197,430,618,0,0
3527,310,121,379,321,77,11,6,69,200,431,618,0,0
3528,300,122,365,315,77,11,6,65,193,432,618,0,0
3529,290,126,351,307,77,11,6,61,181,433,618,0,0
3530,281,126,340,306,77,11,6,59,180,434,618,0,0
3531,274,129,331,305,77,11,6,57,176,435,618,0,0
3532,268,137,323,307,77,11,6,55,170,436,618,0,0
3533,266,143,321,309,77,11,6,55,166,437,618,0,0
3534,265,145,319,310,77,11,6,54,165,438,618,0,0
3535,264,145,320,312,77,11,6,56,167,439,618,0,0
3536,265,136,323,309,77,11,6,58,173,440,618,0,0
3537,269,130,326,306,77,11,6,57,176,441,618,0,0
3538,271,125,327,304,77,11,6,56,179,442,618,0,0
3539,272,122,329,307,77,11,6,57,185,443,618,0,0
3540,277,121,333,304,77,11,6,56,183,444,618,0,0
3541,285,121,341,305,77,11,6,56,184,445,618,0,0
3542,295,121,349,302,77,11,6,54,181,446,618,0,0
3543,302,119,357,304,77,11,6,55,185,447,618,0,0
3544,307,116,362,305,77,11,6,55,189,448,618,0,0
3545,313,115,369,310,77,11,6,56,195,449,618,0,0
3546,317,114,371,306,77,11,6,54,192,450,618,0,0
3547,317,114,370,304,77,11,6,53,190,451,618,0,0
3548,320,116,373,302,77,11,6,53,186,452,618,0,0
3549,320,115,373,302,77,11,6,53,187,453,618,0,0
3550,321,115,374,302,77,11,6,53,187,454,618,0,0
3551,321,112,375,304,77,11,6,54,192,455,618,0,0
3552,324,115,376,302,77,11,6,52,187,456,618,0,0
3553,325,117,377,303,77,11,6,52,186,457,618,0,0
3554,325,114,378,303,77,11,6,53,189,458,618,0,0
3555,327,117,379,302,77,11,6,52,185,459,618,0,0
3556,324,118,378,302,77,11,6,54,184,460,618,0,0
3557,327,118,380,301,77,11,6,53,183,461,618,0,0
3558,329,118,382,301,77,11,6,53,183,462,618,0,0
3559,329,118,381,303,77,11,6,52,185,463,618,0,0
3560,327,116,379,302,77,11,6,52,186,464,618,0,0
3561,325,116,377,302,77,11,6,52,186,465,618,0,0
3562,324,113,375,302,77,11,6,51,189,466,618,0,0
3563,324,113,374,302,77,11,6,50,189,467,618,0,0
3564,323,113,372,302,77,11,6,49,189,468,618,0,0
3565,322,113,370,304,77,11,6,48,191,469,618,0,0
3566,321,112,369,305,77,11,6,48,193,470,618,0,0
3567,322,112,369,304,77,11,6,47,192,471,618,0,0
3568,323,114,370,304,77,11,6,47,190,472,618,0,0
3569,325,115,371,304,77,11,6,46,189,473,618,0,0
3570,326,115,372,303,77,11,6,46,188,474,618,0,0
3571,326,116,372,303,77,11,6,46,187,475,618,0,0
3572,326,115,372,303,77,11,6,46,188,476,618,0,0
3573,326,115,372,303,77,11,6,46,188,477,618,0,0
3574,326,115,371,304,77,11,6,45,189,478,618,0,0
3575,326,114,371,304,77,11,6,45,190,479,618,0,0
3576,326,114,371,304,77,11,6,45,190,480,618,0,0
3577,326,113,371,304,77,11,6,45,191,481,618,0,0
3578,326,113,371,305,77,11,6,45,192,482,618,0,0
3579,326,113,370,304,77,11,6,44,191,483,618,0,0
3580,326,113,370,304,77,11,6,44,191,484,618,0,0
3581,326,113,369,304,77,11,6,43,191,485,618,0,0
3582,326,113,369,304,77,11,6,43,191,486,618,0,0
3583,326,114,369,303,77,11,6,43,189,487,618,0,0
3584,326,115,368,304,77,11,6,42,189,488,618,0,0
3585,326,115,368,304,77,11,6,42,189,489,618,0,0
3586,326,116,367,304,77,11,6,41,188,490,618,0,0
3587,325,116,366,303,77,11,6,41,187,491,618,0,0
3588,324,117,365,303,77,11,6,41,186,492,618,0,0
3589,323,117,364,303,77,11,6,41,186,493,618,0,0
3590,322,118,364,303,77,11,6,42,185,494,618,0,0
3591,322,117,363,303,77,11,6,41,186,495,618,0,0
3592,321,117,363,303,77,11,6,42,186,496,618,0,0
3593,321,117,363,303,77,11,6,42,186,497,618,0,0
3594,321,117,363,303,77,11,6,42,186,498,618,0,0
3595,321,115,364,303,77,11,6,43,188,499,618,0,0
3596,322,115,365,303,77,11,6,43,188,500,618,0,0
3597,323,114,365,304,77,11,6,42,190,501,618,0,0
3598,323,114,366,304,77,11,6,43,190,502,618,0,0
3599,324,113,366,303,77,11,6,42,190,503,618,0,0
3600,324,113,366,303,77,11,6,42,190,504,618,0,0
3601,325,114,367,303,77,11,6,42,189,505,618,0,0
3602,325,114,367,303,77,11,6,42,189,506,618,0,0
3603,325,114,367,303,77,11,6,42,189,507,618,0,0
3604,326,114,367,304,77,11,6,41,190,508,618,0,0
3605,326,114,367,304,77,11,6,41,190,509,618,0,0
3606,327,114,368,304,77,11,6,41,190,510,618,0,0
3607,327,114,368,304,77,11,6,41,190,511,618,0,0
3608,327,114,369,304,77,11,6,42,190,512,618,0,0
3609,328,114,369,303,77,11,6,41,189,513,618,0,0
3610,328,115,369,303,77,11,6,41,188,514,618,0,0
3611,328,115,369,303,77,11,6,41,188,515,618,0,0
3612,328,115,369,303,77,11,6,41,188,516,618,0,0
3613,328,115,369,303,77,11,6,41,188,517,618,0,0
3614,328,114,368,302,77,11,6,40,188,518,618,0,0
3615,327,104,370,302,77,11,6,43,198,519,618,0,0
3616,329,110,370,300,77,11,6,41,190,520,618,0,0
3617,330,113,372,302,77,11,6,42,189,521,618,0,0
3618,329,115,371,300,77,11,6,42,185,522,618,0,0
3619,330,117,373,298,77,11,6,43,181,523,618,0,0
3620,337,117,381,301,77,11,6,44,184,524,618,0,0
3621,342,117,387,303,77,11,6,45,186,525,618,0,0
3622,346,117,391,303,77,11,6,45,186,526,618,0,0
3623,349,117,395,303,77,11,6,46,186,527,618,0,0
3624,350,116,396,303,77,11,6,46,187,528,618,0,0
3625,349,120,395,301,77,11,6,46,181,529,618,0,0
3626,347,120,392,299,77,11,6,45,179,530,618,0,0
3627,344,119,389,297,77,11,6,45,178,531,618,0,0
3628,341,116,387,300,77,11,6,46,184,532,618,0,0
3629,337,115,383,298,77,11,6,46,183,533,618,0,0
3630,333,115,379,297,77,11,6,46,182,534,618,0,0
3631,329,114,375,303,77,11,6,46,189,535,618,0,0
3632,327,110,374,303,77,11,6,47,193,536,618,0,0
3633,327,113,372,303,77,11,6,45,190,537,618,0,0
3634,326,113,371,304,77,11,6,45,191,538,618,0,0
3635,326,113,370,304,77,11,6,44,191,539,618,0,0
3636,326,113,369,304,77,11,6,43,191,540,618,0,0
3637,325,113,368,304,77,11,6,43,191,541,618,0,0
3638,323,113,366,305,77,11,6,43,192,542,618,0,0
3639,322,114,365,306,77,11,6,43,192,543,618,0,0
3640,320,114,363,305,77,11,6,43,191,544,618,0,0
3641,319,114,361,305,77,11,6,42,191,545,618,0,0
3642,318,115,360,304,77,11,6,42,189,546,618,0,0
3643,318,117,359,302,77,11,6,41,185,547,618,0,0
3644,317,116,358,302,77,11,6,41,186,548,618,0,0
3645,315,114,357,304,77,11,6,42,190,549,618,0,0
3646,315,116,357,303,77,11,6,42,187,550,618,0,0
3647,313,115,356,307,77,11,6,43,192,551,618,0,0
3648,312,113,355,306,77,11,6,43,193,552,618,0,0
3649,312,114,355,302,77,11,6,43,188,553,618,0,0
3650,314,114,357,299,77,11,6,43,185,554,618,0,0
3651,318,116,362,297,77,11,6,44,181,555,618,0,0
3652,327,116,372,294,77,11,6,45,178,556,618,0,0
3653,333,116,380,292,77,11,6,47,176,557,618,0,0
3654,340,114,388,291,77,11,6,48,177,558,618,0,0
3655,345,114,395,290,77,11,6,50,176,559,618,0,0
3656,349,114,400,290,77,11,6,51,176,560,618,0,0
3657,348,116,400,291,77,11,6,52,175,561,618,0,0
3658,346,116,399,292,77,11,6,53,176,562,618,0,0
3659,341,116,395,293,77,11,6,54,177,563,618,0,0
3660,335,116,389,291,77,11,6,54,175,564,618,0,0
3661,329,115,383,293,77,11,6,54,178,565,618,0,0
3662,324,117,378,293,77,11,6,54,176,566,618,0,0
3663,321,117,375,297,77,11,6,54,180,567,618,0,0
3664,320,117,374,300,77,11,6,54,183,568,618,0,0
3665,318,115,373,303,77,11,6,55,188,569,618,0,0
3666,318,114,372,305,77,11,6,54,191,570,618,0,0
3667,315,112,369,306,77,11,6,54,194,571,618,0,0
3668,315,114,368,308,77,11,6,53,194,572,618,0,0
3669,312,115,364,307,77,11,6,52,192,573,618,0,0
3670,310,115,360,304,77,11,6,50,189,574,618,0,0
3671,308,117,357,303,77,11,6,49,186,575,618,0,0
3672,307,118,356,302,77,11,6,49,184,576,618,0,0
3673,307,118,356,302,77,11,6,49,184,577,618,0,0
3674,307,118,356,302,77,11,6,49,184,578,618,0,0
3675,308,120,355,300,77,11,6,47,180,579,618,0,0
3676,308,122,355,301,77,11,6,47,179,580,618,0,0
3677,307,119,355,302,77,11,6,48,183,581,618,0,0
3678,307,119,355,302,77,11,6,48,183,582,618,0,0
3679,307,119,354,302,77,11,6,47,183,583,618,0,0
3680,306,120,353,300,77,11,6,47,180,584,618,0,0
3681,306,119,353,299,77,11,6,47,180,585,618,0,0
3682,306,118,353,299,77,11,6,47,181,586,618,0,0
3683,306,118,353,298,77,11,6,47,180,587,618,0,0
3684,306,117,354,298,77,11,6,48,181,588,618,0,0
3685,306,117,354,298,77,11,6,48,181,589,618,0,0
3686,307,121,354,297,77,11,6,47,176,590,618,0,0
3687,308,123,354,298,77,11,6,46,175,591,618,0,0
3688,307,120,354,300,77,11,6,47,180,592,618,0,0
3689,306,119,354,301,77,11,6,48,182,593,618,0,0
3690,307,119,355,301,77,11,6,48,182,594,618,0,0
3691,307,119,355,301,77,11,6,48,182,595,618,0,0
3692,307,121,354,297,77,11,6,47,176,596,618,0,0
3693,307,119,354,299,77,11,6,47,180,597,618,0,0
3694,306,119,354,300,77,11,6,48,181,598,618,0,0
3695,306,116,355,301,77,11,6,49,185,599,618,0,0
3696,307,114,356,302,77,11,6,49,188,600,618,0,0
3697,306,114,355,302,77,11,6,49,188,601,618,0,0
3698,307,116,356,304,77,11,6,49,188,602,618,0,0
3699,306,122,355,308,77,11,6,49,186,603,618,0,0
3700,304,126,351,307,77,11,6,47,181,604,618,0,0
3701,298,135,346,306,77,11,6,48,171,605,618,0,0
3702,294,143,341,304,77,11,6,47,161,606,618,0,0
3703,291,148,337,302,77,11,6,46,154,607,618,0,0
3704,286,142,336,300,77,11,6,50,158,608,618,0,0
3705,286,134,337,295,77,11,6,51,161,609,618,0,0
3706,290,132,339,286,77,11,6,49,154,610,618,0,0
3707,291,125,344,295,77,11,6,53,170,611,618,0,0
3708,290,124,344,299,77,11,6,54,175,612,618,0,0
3709,285,122,343,304,77,11,6,58,182,613,618,0,0
3710,284,120,345,315,77,11,6,61,195,614,618,0,0
3711,273,120,336,321,77,11,6,63,201,615,618,0,0
3712,268,121,328,317,77,11,6,60,196,616,618,0,0
3713,255,124,319,338,77,11,6,64,214,617,618,0,0
3714,252,123,317,341,77,11,6,65,218,618,618,1,0
3726,251,155,327,410,77,11,6,76,255,0,618,0,1
3727,263,155,338,397,77,11,6,75,242,1,618,0,0
3728,275,155,350,391,77,11,6,75,236,2,618,0,0
3729,296,146,372,383,77,11,6,76,237,3,618,0,0
3730,316,142,391,374,77,11,6,75,232,4,618,0,0
3731,323,141,396,367,77,11,6,73,226,5,618,0,0
3732,326,139,396,360,77,11,6,70,221,6,618,0,0
3733,328,137,396,355,77,11,6,68,218,7,618,0,0
3734,329,136,397,350,77,11,6,68,214,8,618,0,0
3735,324,132,391,345,77,11,6,67,213,9,618,0,0
3736,314,131,378,334,77,11,6,64,203,10,618,0,0
3737,307,130,368,326,77,11,6,61,196,11,618,0,0
3738,303,124,361,313,77,11,6,58,189,12,618,0,0
3739,302,124,361,310,77,11,6,59,186,13,618,0,0
3740,300,120,357,303,77,11,6,57,183,14,618,0,0
3741,299,117,355,297,77,11,6,56,180,15,618,0,0
3742,298,116,353,294,77,11,6,55,178,16,618,0,0
3743,300,114,353,289,77,11,6,53,175,17,618,0,0
3744,304,114,354,279,77,11,6,50,165,18,618,0,0
3745,309,113,358,273,77,11,6,49,160,19,618,0,0
3746,311,110,360,271,77,11,6,49,161,20,618,0,0
3747,312,111,359,267,77,11,6,47,156,21,618,0,0
3748,312,110,357,260,77,11,6,45,150,22,618,0,0
3749,312,104,357,259,77,11,6,45,155,23,618,0,0
3750,312,102,357,257,77,11,6,45,155,24,618,0,0
3751,312,104,354,250,77,11,6,42,146,25,618,0,0
3752,307,106,349,249,77,11,6,42,143,26,618,0,0
3753,302,107,341,243,77,11,6,39,136,27,618,0,0
3754,290,107,332,253,77,11,6,42,146,28,618,0,0
3755,278,107,324,273,77,11,6,46,166,29,618,0,0
3756,275,106,321,273,77,11,6,46,167,30,618,0,0
3110,505,142,540,299,79,11,6,35,157,0,27,0,0
3111,501,124,541,305,79,11,6,40,181,1,27,0,0
3112,502,121,543,305,79,11,6,41,184,2,27,0,0
3113,501,122,542,306,79,11,6,41,184,3,27,0,0
3114,500,120,542,306,79,11,6,42,186,4,27,0,0
3142,500,117,543,300,79,11,6,43,183,0,27,0,1
3143,502,121,545,303,79,11,6,43,182,1,27,0,0
3144,505,121,547,301,79,11,6,42,180,2,27,0,0
3145,505,121,548,301,79,11,6,43,180,3,27,0,0
3146,506,121,548,301,79,11,6,42,180,4,27,0,0
3147,506,122,549,301,79,11,6,43,179,5,27,0,0
3148,506,122,549,300,79,11,6,43,178,6,27,0,0
3149,506,122,549,300,79,11,6,43,178,7,27,0,0
3150,506,122,548,299,79,11,6,42,177,8,27,0,0
3151,505,121,548,301,79,11,6,43,180,9,27,0,0
3152,505,121,548,302,79,11,6,43,181,10,27,0,0
3153,505,121,548,302,79,11,6,43,181,11,27,0,0
3154,505,123,548,302,79,11,6,43,179,12,27,0,0
3155,504,118,548,302,79,11,6,44,184,13,27,0,0
3156,505,120,548,302,79,11,6,43,182,14,27,0,0
3157,505,121,548,302,79,11,6,43,181,15,27,0,0
3158,505,121,548,302,79,11,6,43,181,16,27,0,0
3159,505,121,548,301,79,11,6,43,180,17,27,0,0
3160,507,123,549,301,79,11,6,42,178,18,27,0,0
3161,508,124,551,302,79,11,6,43,178,19,27,0,0
3162,511,124,555,302,79,11,6,44,178,20,27,0,0
3163,514,125,559,304,79,11,6,45,179,21,27,0,0
3164,514,128,563,314,79,11,6,49,186,22,27,0,0
3165,517,130,566,314,79,11,6,49,184,23,27,0,0
3166,513,132,565,323,79,11,6,52,191,24,27,0,0
3167,506,138,558,326,79,11,6,52,188,25,27,0,0
3168,495,137,551,334,79,11,6,56,197,26,27,0,0
3169,493,139,550,337,79,11,6,57,198,27,27,1,0
3172,436,143,501,359,79,11,6,65,216,0,27,0,0
3173,421,143,486,364,79,11,6,65,221,1,27,0,0
3174,403,143,469,365,79,11,6,66,222,2,27,0,0
3175,386,149,451,370,79,11,6,65,221,3,27,0,0
3176,363,150,427,372,79,11,6,64,222,4,27,0,0
3177,331,155,400,384,79,11,6,69,229,5,27,0,0
3178,311,157,385,395,79,11,6,74,238,6,27,0,0
3179,284,156,358,395,79,11,6,74,239,7,27,0,0
3180,264,161,338,400,79,11,6,74,239,8,27,0,0
3181,242,164,318,416,79,11,6,76,252,9,27,0,0
3182,235,176,307,420,79,11,6,72,244,10,27,0,0
3183,221,179,293,425,79,11,6,72,246,11,27,0,0
3198,242,178,318,434,79,11,6,76,256,0,27,0,0
3199,245,171,326,440,79,11,6,81,269,1,27,0,0
3200,248,172,326,439,79,11,6,78,267,2,27,0,0
3201,263,160,348,438,79,11,6,85,278,3,27,0,0
3202,274,160,360,433,79,11,6,86,273,4,27,0,0
3203,282,160,369,433,79,11,6,87,273,5,27,0,0
3204,292,161,377,424,79,11,6,85,263,6,27,0,0
3205,323,160,406,414,79,11,6,83,254,7,27,0,0
3206,342,159,425,408,79,11,6,83,249,8,27,0,0
3207,350,156,433,405,79,11,6,83,249,9,27,0,0
3208,357,155,437,400,79,11,6,80,245,10,27,0,0
3209,370,158,452,402,79,11,6,82,244,11,27,0,0
3210,377,156,463,404,79,11,6,86,248,12,27,0,0
3211,404,160,484,396,79,11,6,80,236,13,27,0,0
3212,415,160,495,393,79,11,6,80,233,14,27,0,0
3215,487,156,564,381,79,11,6,77,225,0,27,0,0
3216,510,153,588,378,79,11,6,78,225,1,27,0,0
3217,535,151,614,371,79,11,6,79,220,2,27,0,0
3218,552,150,632,374,79,11,6,80,224,3,27,0,0
3219,563,148,645,375,79,11,6,82,227,4,27,0,0
3220,589,150,667,369,79,11,6,78,219,5,27,0,0
3221,604,160,679,367,79,11,6,75,207,6,27,0,0
3222,634,165,708,365,79,11,6,74,200,7,27,0,0
3223,666,166,740,362,79,11,6,74,196,8,27,0,0
3224,687,170,761,363,79,11,6,74,193,9,27,0,0
3225,708,159,784,360,79,11,6,76,201,10,27,0,0
3226,728,158,804,358,79,11,6,76,200,11,27,0,0
3227,739,154,817,357,79,11,6,78,203,12,27,0,0
3228,767,158,837,349,79,11,6,70,191,13,27,0,0
3229,788,158,857,347,79,11,6,69,189,14,27,0,0
3725,238,159,323,424,85,11,6,85,265,0,0,0,0
3728,262,176,303,384,86,11,6,41,208,0,0,0,0
4163,241,187,311,533,87,11,6,70,346,0,18,0,0
4164,254,191,324,536,87,11,6,70,345,1,18,0,0
4165,284,206,357,557,87,11,6,73,351,2,18,0,0
4166,318,210,395,571,87,11,6,77,361,3,18,0,0
4167,353,215,436,595,87,11,6,83,380,4,18,0,0
4168,388,218,476,612,87,11,6,88,394,5,18,0,0
4169,425,231,524,649,87,11,6,99,418,6,18,0,0
4170,460,240,563,670,87,11,6,103,430,7,18,0,0
4171,508,255,620,700,87,11,6,112,445,8,18,0,0
4172,544,267,662,726,87,11,6,118,459,9,18,0,0
4173,579,280,713,779,87,11,6,134,499,10,18,0,0
4174,624,301,769,823,87,11,6,145,522,11,18,0,0
4175,685,321,841,863,87,11,6,156,542,12,18,0,0
4176,733,348,902,917,87,11,6,169,569,13,18,0,0
4177,804,369,992,976,87,11,6,188,607,14,18,0,0
4178,883,409,1092,1049,87,11,6,209,640,15,18,0,0
4179,971,441,1183,1075,87,11,6,212,634,16,18,0,0
4180,1056,494,1273,1080,87,11,6,217,586,17,18,0,0
4181,1109,514,1330,1080,87,11,6,221,566,18,18,0,0
4181,1241,546,1545,1070,90,11,6,304,524,0,1,0,0
4182,1340,612,1609,1070,90,11,6,269,458,1,1,0,0
4183,1532,682,1839,1077,91,11,6,307,395,0,1,0,0
4184,1631,734,1892,1069,91,11,6,261,335,1,1,0,0
4185,1806,885,1918,1067,92,11,6,112,182,0,0,0,0
4288,261,124,306,329,94,11,6,45,205,0,45,0,1
4289,265,122,309,322,94,11,6,44,200,1,45,0,0
4290,266,122,306,303,94,11,6,40,181,2,45,0,0
4291,274,130,311,298,94,11,6,37,168,3,45,0,0
4292,290,128,327,292,94,11,6,37,164,4,45,0,0
4293,298,129,333,285,94,11,6,35,156,5,45,0,0
4294,317,115,359,301,94,11,6,42,186,6,45,0,0
4295,331,114,372,297,94,11,6,41,183,7,45,0,0
4296,345,112,387,295,94,11,6,42,183,8,45,0,0
4297,360,116,401,292,94,11,6,41,176,9,45,0,0
4298,375,115,420,294,94,11,6,45,179,10,45,0,0
4299,385,111,431,292,94,11,6,46,181,11,45,0,0
4300,392,112,438,289,94,11,6,46,177,12,45,0,0
4301,402,115,446,286,94,11,6,44,171,13,45,0,0
4302,409,120,454,292,94,11,6,45,172,14,45,0,0
4303,420,119,468,293,94,11,6,48,174,15,45,0,0
4304,432,117,481,294,94,11,6,49,177,16,45,0,0
4305,446,113,499,291,94,11,6,53,178,17,45,0,0
4306,444,111,502,291,94,11,6,58,180,18,45,0,0
4307,437,111,495,292,94,11,6,58,181,19,45,0,0
4308,429,112,489,298,94,11,6,60,186,20,45,0,0
4309,431,117,489,296,94,11,6,58,179,21,45,0,0
4310,440,124,495,293,94,11,6,55,169,22,45,0,0
4311,445,129,497,290,94,11,6,52,161,23,45,0,0
4312,446,128,497,290,94,11,6,51,162,24,45,0,0
4313,447,128,499,289,94,11,6,52,161,25,45,0,0
4314,449,128,502,289,94,11,6,53,161,26,45,0,0
4315,451,126,502,282,94,11,6,51,156,27,45,0,0
4316,448,126,498,281,94,11,6,50,155,28,45,0,0
4317,444,124,494,279,94,11,6,50,155,29,45,0,0
4318,437,122,487,275,94,11,6,50,153,30,45,0,0
4319,434,122,481,269,94,11,6,47,147,31,45,0,0
4320,430,122,476,263,94,11,6,46,141,32,45,0,0
4321,424,120,468,257,94,11,6,44,137,33,45,0,0
4322,419,121,462,256,94,11,6,43,135,34,45,0,0
4323,413,119,456,256,94,11,6,43,137,35,45,0,0
4324,408,118,450,253,94,11,6,42,135,36,45,0,0
4325,402,117,445,252,94,11,6,43,135,37,45,0,0
4326,398,116,440,247,94,11,6,42,131,38,45,0,0
4327,391,113,432,243,94,11,6,41,130,39,45,0,0
4328,382,114,424,245,94,11,6,42,131,40,45,0,0
4329,373,113,411,235,94,11,6,38,122,41,45,0,0
4330,364,112,402,232,94,11,6,38,120,42,45,0,0
4331,356,112,392,228,94,11,6,36,116,43,45,0,0
4332,343,112,378,226,94,11,6,35,114,44,45,0,0
4333,330,113,365,224,94,11,6,35,111,45,45,1,0
4290,286,143,329,302,95,11,6,43,159,0,27,0,0
4291,303,142,348,307,95,11,6,45,165,1,27,0,0
4292,319,140,364,305,95,11,6,45,165,2,27,0,0
4293,335,140,380,305,95,11,6,45,165,3,27,0,0
4294,353,137,396,297,95,11,6,43,160,4,27,0,0
4295,371,134,415,295,95,11,6,44,161,5,27,0,0
4296,385,129,430,293,95,11,6,45,164,6,27,0,0
4297,392,127,437,292,95,11,6,45,165,7,27,0,0
4298,405,125,450,290,95,11,6,45,165,8,27,0,0
4304,412,123,457,294,95,11,6,45,171,0,27,0,0
4305,413,125,457,293,95,11,6,44,168,1,27,0,0
4306,418,124,463,293,95,11,6,45,169,2,27,0,0
4309,415,116,458,284,95,11,6,43,168,0,27,0,1
4310,411,111,455,285,95,11,6,44,174,1,27,0,0
4311,406,109,451,287,95,11,6,45,178,2,27,0,0
4312,401,107,447,288,95,11,6,46,181,3,27,0,0
4313,396,109,442,285,95,11,6,46,176,4,27,0,0
4314,392,109,439,281,95,11,6,47,172,5,27,0,0
4315,392,109,439,276,95,11,6,47,167,6,27,0,0
4316,394,109,440,274,95,11,6,46,165,7,27,0,0
4317,394,108,441,272,95,11,6,47,164,8,27,0,0
4318,394,109,440,269,95,11,6,46,160,9,27,0,0
4319,393,110,439,268,95,11,6,46,158,10,27,0,0
4320,389,109,435,266,95,11,6,46,157,11,27,0,0
4321,382,107,429,267,95,11,6,47,160,12,27,0,0
4322,377,106,424,265,95,11,6,47,159,13,27,0,0
4323,372,106,419,262,95,11,6,47,156,14,27,0,0
4324,371,107,414,250,95,11,6,43,143,15,27,0,0
4325,366,106,410,250,95,11,6,44,144,16,27,0,0
4326,359,107,403,250,95,11,6,44,143,17,27,0,0
4327,349,102,395,249,95,11,6,46,147,18,27,0,0
4328,342,104,386,246,95,11,6,44,142,19,27,0,0
4329,335,105,377,242,95,11,6,42,137,20,27,0,0
4330,326,102,369,241,95,11,6,43,139,21,27,0,0
4331,319,103,359,235,95,11,6,40,132,22,27,0,0
4332,311,105,348,229,95,11,6,37,124,23,27,0,0
4333,299,106,338,232,95,11,6,39,126,24,27,0,0
4334,290,109,326,230,95,11,6,36,121,25,27,0,0
4335,269,106,319,272,95,11,6,50,166,26,27,0,0
4336,260,106,312,275,95,11,6,52,169,27,27,1,0
4338,749,180,820,442,97,11,6,71,262,0,24,0,1
4339,721,186,798,469,97,11,6,77,283,1,24,0,0
4340,694,176,775,472,97,11,6,81,296,2,24,0,0
4341,651,184,734,480,97,11,6,83,296,3,24,0,0
4342,619,188,703,480,97,11,6,84,292,4,24,0,0
4343,577,190,669,498,97,11,6,92,308,5,24,0,0
4344,545,200,641,516,97,11,6,96,316,6,24,0,0
4345,525,195,629,530,97,11,6,104,335,7,24,0,0
4346,498,208,605,552,97,11,6,107,344,8,24,0,0
4347,463,215,574,564,97,11,6,111,349,9,24,0,0
4348,436,221,559,600,97,11,6,123,379,10,24,0,0
4349,418,230,548,631,97,11,6,130,401,11,24,0,0
4350,392,233,528,640,97,11,6,136,407,12,24,0,0
4351,356,241,504,668,97,11,6,148,427,13,24,0,0
4352,317,257,477,688,97,11,6,160,431,14,24,0,0
4353,281,260,459,719,97,11,6,178,459,15,24,0,0
4354,267,270,462,753,97,11,6,195,483,16,24,0,0
4355,271,277,475,764,97,11,6,204,487,17,24,0,0
4356,280,279,482,763,97,11,6,202,484,18,24,0,0
4357,288,284,482,764,97,11,6,194,480,19,24,0,0
4358,284,284,475,764,97,11,6,191,480,20,24,0,0
4359,263,284,456,765,97,11,6,193,481,21,24,0,0
4360,236,290,398,693,97,11,6,162,403,22,24,0,0
4361,211,292,347,640,97,11,6,136,348,23,24,0,0
4362,191,296,324,638,97,11,6,133,342,24,24,1,0
4955,1665,899,1810,1074,101,11,6,145,175,0,0,0,0
4956,1543,862,1711,1070,103,11,6,168,208,0,0,0,0
4957,1392,818,1614,1073,104,11,6,222,255,0,57,0,1
4958,1312,763,1577,1068,104,11,6,265,305,1,57,0,0
4959,1220,719,1524,1072,104,11,6,304,353,2,57,0,0
4960,1120,667,1467,1075,104,11,6,347,408,3,57,0,0
4961,1034,618,1415,1074,104,11,6,381,456,4,57,0,0
4962,951,587,1352,1076,104,11,6,401,489,5,57,0,0
4963,896,548,1310,1067,104,11,6,414,519,6,57,0,0
4964,852,510,1279,1065,104,11,6,427,555,7,57,0,0
4965,815,478,1236,1049,104,11,6,421,571,8,57,0,0
4966,796,447,1179,984,104,11,6,383,537,9,57,0,0
4967,770,427,1126,944,104,11,6,356,517,10,57,0,0
4968,758,406,1082,893,104,11,6,324,487,11,57,0,0
4969,747,384,1047,856,104,11,6,300,472,12,57,0,0
4970,730,373,1011,833,104,11,6,281,460,13,57,0,0
4971,717,354,969,784,104,11,6,252,430,14,57,0,0
4972,692,338,931,757,104,11,6,239,419,15,57,0,0
4973,674,328,896,731,104,11,6,222,403,16,57,0,0
4974,667,313,869,695,104,11,6,202,382,17,57,0,0
4975,654,309,844,682,104,11,6,190,373,18,57,0,0
4976,622,289,811,659,104,11,6,189,370,19,57,0,0
4979,594,266,757,599,104,11,6,163,333,0,57,0,1
4980,586,262,736,582,104,11,6,150,320,1,57,0,0
4981,579,262,715,565,104,11,6,136,303,2,57,0,0
4982,570,252,697,543,104,11,6,127,291,3,57,0,0
4983,565,245,687,533,104,11,6,122,288,4,57,0,0
4984,562,243,676,518,104,11,6,114,275,5,57,0,0
4985,560,235,671,507,104,11,6,111,272,6,57,0,0
4986,552,232,659,499,104,11,6,107,267,7,57,0,0
4987,550,225,648,476,104,11,6,98,251,8,57,0,0
4988,547,220,641,461,104,11,6,94,241,9,57,0,0
4989,538,217,632,458,104,11,6,94,241,10,57,0,0
4990,526,210,616,443,104,11,6,90,233,11,57,0,0
4991,518,205,604,435,104,11,6,86,230,12,57,0,0
4992,508,203,591,428,104,11,6,83,225,13,57,0,0
4993,498,199,577,416,104,11,6,79,217,14,57,0,0
4994,492,198,568,405,104,11,6,76,207,15,57,0,0
4995,484,194,559,401,104,11,6,75,207,16,57,0,0
4996,477,186,552,394,104,11,6,75,208,17,57,0,0
4997,474,188,546,386,104,11,6,72,198,18,57,0,0
4998,473,181,544,379,104,11,6,71,198,19,57,0,0
4999,472,177,541,371,104,11,6,69,194,20,57,0,0
5000,470,177,537,365,104,11,6,67,188,21,57,0,0
5001,466,171,532,360,104,11,6,66,189,22,57,0,0
5002,464,171,527,353,104,11,6,63,182,23,57,0,0
5003,462,171,523,348,104,11,6,61,177,24,57,0,0
5004,461,166,522,346,104,11,6,61,180,25,57,0,0
5005,458,165,519,344,104,11,6,61,179,26,57,0,0
5006,453,165,512,341,104,11,6,59,176,27,57,0,0
5007,449,163,506,332,104,11,6,57,169,28,57,0,0
5008,445,160,502,332,104,11,6,57,172,29,57,0,0
5009,441,157,497,325,104,11,6,56,168,30,57,0,0
5010,437,153,491,315,104,11,6,54,162,31,57,0,0
5011,431,154,485,316,104,11,6,54,162,32,57,0,0
5012,423,152,475,308,104,11,6,52,156,33,57,0,0
5013,418,152,468,304,104,11,6,50,152,34,57,0,0
5014,412,150,462,303,104,11,6,50,153,35,57,0,0
5015,407,147,456,298,104,11,6,49,151,36,57,0,0
5016,403,145,451,293,104,11,6,48,148,37,57,0,0
5017,399,144,447,291,104,11,6,48,147,38,57,0,0
5018,397,144,442,284,104,11,6,45,140,39,57,0,0
5019,392,143,437,282,104,11,6,45,139,40,57,0,0
5020,388,140,432,280,104,11,6,44,140,41,57,0,0
5021,384,138,428,275,104,11,6,44,137,42,57,0,0
5022,380,138,423,273,104,11,6,43,135,43,57,0,0
5023,376,137,419,271,104,11,6,43,134,44,57,0,0
5024,372,134,414,266,104,11,6,42,132,45,57,0,0
5025,368,133,410,265,104,11,6,42,132,46,57,0,0
5026,365,131,406,260,104,11,6,41,129,47,57,0,0
5027,360,129,400,256,104,11,6,40,127,48,57,0,0
5028,353,130,394,258,104,11,6,41,128,49,57,0,0
5029,346,129,385,253,104,11,6,39,124,50,57,0,0
5030,338,128,376,253,104,11,6,38,125,51,57,0,0
5031,332,127,370,252,104,11,6,38,125,52,57,0,0
5032,326,126,363,248,104,11,6,37,122,53,57,0,0
5033,322,125,358,247,104,11,6,36,122,54,57,0,0
5034,316,124,353,247,104,11,6,37,123,55,57,0,0
5035,311,124,347,244,104,11,6,36,120,56,57,0,0
5036,308,124,343,244,104,11,6,35,120,57,57,1,0
4964,231,281,278,451,105,11,6,47,170,0,0,0,0
4965,230,286,307,640,106,11,6,77,354,0,37,0,1
4966,278,272,360,640,106,11,6,82,368,1,37,0,0
4967,280,274,377,704,106,11,6,97,430,2,37,0,0
4968,306,280,411,733,106,11,6,105,453,3,37,0,0
4969,329,280,439,748,106,11,6,110,468,4,37,0,0
4970,354,280,470,770,106,11,6,116,490,5,37,0,0
4971,395,288,523,813,106,11,6,128,525,6,37,0,0
4972,439,297,570,828,106,11,6,131,531,7,37,0,0
4973,486,302,618,829,106,11,6,132,527,8,37,0,0
4974,524,309,663,833,106,11,6,139,524,9,37,0,0
4975,582,316,715,808,106,11,6,133,492,10,37,0,0
4976,627,307,767,812,106,11,6,140,505,11,37,0,0
4977,664,297,808,805,106,11,6,144,508,12,37,0,0
4978,702,303,848,791,106,11,6,146,488,13,37,0,0
4979,743,305,896,784,106,11,6,153,479,14,37,0,0
4980,760,293,920,776,106,11,6,160,483,15,37,0,0
4981,747,276,905,752,106,11,6,158,476,16,37,0,0
4982,738,280,884,722,106,11,6,146,442,17,37,0,0
4983,741,276,878,696,106,11,6,137,420,18,37,0,0
4984,753,272,890,682,106,11,6,137,410,19,37,0,0
4985,763,258,904,665,106,11,6,141,407,20,37,0,0
4986,758,248,903,652,106,11,6,145,404,21,37,0,0
4987,742,240,887,635,106,11,6,145,395,22,37,0,0
4988,729,230,866,606,106,11,6,137,376,23,37,0,0
4989,730,226,861,589,106,11,6,131,363,24,37,0,0
4990,734,222,857,563,106,11,6,123,341,25,37,0,0
4991,729,218,847,544,106,11,6,118,326,26,37,0,0
4992,717,211,836,536,106,11,6,119,325,27,37,0,0
4993,702,197,818,517,106,11,6,116,320,28,37,0,0
4994,696,193,808,504,106,11,6,112,311,29,37,0,0
4995,696,190,803,485,106,11,6,107,295,30,37,0,0
4996,701,184,807,477,106,11,6,106,293,31,37,0,0
4997,707,182,812,475,106,11,6,105,293,32,37,0,0
4998,714,178,815,461,106,11,6,101,283,33,37,0,0
4999,724,172,822,451,106,11,6,98,279,34,37,0,0
5000,733,171,826,443,106,11,6,93,272,35,37,0,0
5001,758,192,829,403,106,11,6,71,211,36,37,0,0
5002,765,190,830,388,106,11,6,65,198,37,37,1,0
4978,640,287,740,601,107,11,6,100,314,0,0,0,0
5343,292,125,328,229,111,11,6,36,104,0,143,0,1
5344,297,121,333,227,111,11,6,36,106,1,143,0,0
5345,301,117,341,233,111,11,6,40,116,2,143,0,0
5346,306,115,348,238,111,11,6,42,123,3,143,0,0
5347,311,114,354,242,111,11,6,43,128,4,143,0,0
5348,315,114,360,245,111,11,6,45,131,5,143,0,0
5349,321,118,365,247,111,11,6,44,129,6,143,0,0
5350,326,121,370,247,111,11,6,44,126,7,143,0,0
5351,331,127,374,250,111,11,6,43,123,8,143,0,0
5352,332,129,375,252,111,11,6,43,123,9,143,0,0
5353,334,131,376,252,111,11,6,42,121,10,143,0,0
5354,334,133,378,257,111,11,6,44,124,11,143,0,0
5355,334,132,380,261,111,11,6,46,129,12,143,0,0
5356,334,131,381,266,111,11,6,47,135,13,143,0,0
5357,341,126,394,273,111,11,6,53,147,14,143,0,0
5358,344,126,398,277,111,11,6,54,151,15,143,0,0
5359,321,128,379,284,111,11,6,58,156,16,143,0,0
5360,310,128,372,292,111,11,6,62,164,17,143,0,0
5361,301,133,363,293,111,11,6,62,160,18,143,0,0
5362,289,133,352,295,111,11,6,63,162,19,143,0,0
5363,282,137,344,302,111,11,6,62,165,20,143,0,0
5364,274,138,336,305,111,11,6,62,167,21,143,0,0
5365,269,139,329,301,111,11,6,60,162,22,143,0,0
5366,262,139,325,313,111,11,6,63,174,23,143,0,0
5367,258,142,323,321,111,11,6,65,179,24,143,0,0
5368,257,139,322,319,111,11,6,65,180,25,143,0,0
5369,255,141,319,323,111,11,6,64,182,26,143,0,0
5370,256,142,322,333,111,11,6,66,191,27,143,0,0
5371,262,142,326,331,111,11,6,64,189,28,143,0,0
5372,267,143,330,330,111,11,6,63,187,29,143,0,0
5373,272,142,335,332,111,11,6,63,190,30,143,0,0
5374,275,142,336,332,111,11,6,61,190,31,143,0,0
5375,279,141,339,329,111,11,6,60,188,32,143,0,0
5376,282,142,340,327,111,11,6,58,185,33,143,0,0
5377,284,142,341,325,111,11,6,57,183,34,143,0,0
5378,286,143,342,324,111,11,6,56,181,35,143,0,0
5379,288,144,344,325,111,11,6,56,181,36,143,0,0
5380,287,143,343,325,111,11,6,56,182,37,143,0,0
5381,286,142,342,326,111,11,6,56,184,38,143,0,0
5382,285,140,342,329,111,11,6,57,189,39,143,0,0
5383,285,140,341,330,111,11,6,56,190,40,143,0,0
5384,285,140,341,331,111,11,6,56,191,41,143,0,0
5385,286,139,342,332,111,11,6,56,193,42,143,0,0
5386,289,141,343,330,111,11,6,54,189,43,143,0,0
5387,289,141,342,329,111,11,6,53,188,44,143,0,0
5388,289,141,342,328,111,11,6,53,187,45,143,0,0
5389,290,141,344,329,111,11,6,54,188,46,143,0,0
5390,290,141,344,329,111,11,6,54,188,47,143,0,0
5391,290,144,342,326,111,11,6,52,182,48,143,0,0
5392,288,144,338,322,111,11,6,50,178,49,143,0,0
5393,286,146,336,322,111,11,6,50,176,50,143,0,0
5394,287,145,338,325,111,11,6,51,180,51,143,0,0
5395,286,138,338,324,111,11,6,52,186,52,143,0,0
5396,284,138,336,324,111,11,6,52,186,53,143,0,0
5397,284,142,335,326,111,11,6,51,184,54,143,0,0
5398,283,142,335,328,111,11,6,52,186,55,143,0,0
5399,283,142,335,328,111,11,6,52,186,56,143,0,0
5400,282,142,335,330,111,11,6,53,188,57,143,0,0
5401,283,142,334,327,111,11,6,51,185,58,143,0,0
5402,283,144,333,327,111,11,6,50,183,59,143,0,0
5403,281,142,333,326,111,11,6,52,184,60,143,0,0
5404,283,146,330,308,111,11,6,47,162,61,143,0,0
5405,285,151,334,322,111,11,6,49,171,62,143,0,0
5406,285,148,335,323,111,11,6,50,175,63,143,0,0
5407,284,145,335,323,111,11,6,51,178,64,143,0,0
5408,284,144,336,327,111,11,6,52,183,65,143,0,0
5409,283,146,336,337,111,11,6,53,191,66,143,0,0
5410,282,147,336,341,111,11,6,54,194,67,143,0,0
5411,280,145,335,344,111,11,6,55,199,68,143,0,0
5412,280,146,332,333,111,11,6,52,187,69,143,0,0
5413,278,148,330,331,111,11,6,52,183,70,143,0,0
5414,272,149,325,338,111,11,6,53,189,71,143,0,0
5415,267,147,321,339,111,11,6,54,192,72,143,0,0
5416,265,145,319,336,111,11,6,54,191,73,143,0,0
5417,263,145,317,335,111,11,6,54,190,74,143,0,0
5418,262,145,316,336,111,11,6,54,191,75,143,0,0
5419,261,144,315,336,111,11,6,54,192,76,143,0,0
5420,260,144,315,338,111,11,6,55,194,77,143,0,0
5421,261,145,314,335,111,11,6,53,190,78,143,0,0
5422,263,145,317,333,111,11,6,54,188,79,143,0,0
5423,263,145,316,331,111,11,6,53,186,80,143,0,0
5424,262,145,315,329,111,11,6,53,184,81,143,0,0
5425,263,145,315,329,111,11,6,52,184,82,143,0,0
5426,263,146,315,327,111,11,6,52,181,83,143,0,0
5427,263,145,316,330,111,11,6,53,185,84,143,0,0
5428,262,145,315,332,111,11,6,53,187,85,143,0,0
5429,262,145,315,332,111,11,6,53,187,86,143,0,0
5430,263,145,316,333,111,11,6,53,188,87,143,0,0
5431,263,145,316,333,111,11,6,53,188,88,143,0,0
5432,263,145,315,333,111,11,6,52,188,89,143,0,0
5433,263,145,315,333,111,11,6,52,188,90,143,0,0
5434,263,145,315,333,111,11,6,52,188,91,143,0,0
5435,263,145,315,333,111,11,6,52,188,92,143,0,0
5436,263,145,316,335,111,11,6,53,190,93,143,0,0
5437,264,144,316,335,111,11,6,52,191,94,143,0,0
5438,264,144,317,335,111,11,6,53,191,95,143,0,0
5439,264,144,317,336,111,11,6,53,192,96,143,0,0
5440,263,144,317,337,111,11,6,54,193,97,143,0,0
5441,262,143,316,335,111,11,6,54,192,98,143,0,0
5442,262,143,315,336,111,11,6,53,193,99,143,0,0
5443,261,144,315,338,111,11,6,54,194,100,143,0,0
5444,262,144,314,335,111,11,6,52,191,101,143,0,0
5445,262,144,314,335,111,11,6,52,191,102,143,0,0
5446,262,144,313,335,111,11,6,51,191,103,143,0,0
5447,262,145,313,335,111,11,6,51,190,104,143,0,0
5448,262,145,313,335,111,11,6,51,190,105,143,0,0
5449,262,146,311,329,111,11,6,49,183,106,143,0,0
5450,260,147,309,330,111,11,6,49,183,107,143,0,0
5451,261,147,310,332,111,11,6,49,185,108,143,0,0
5452,261,147,311,336,111,11,6,50,189,109,143,0,0
5453,261,146,312,338,111,11,6,51,192,110,143,0,0
5454,262,144,313,337,111,11,6,51,193,111,143,0,0
5455,262,144,313,336,111,11,6,51,192,112,143,0,0
5456,263,144,314,334,111,11,6,51,190,113,143,0,0
5457,265,144,316,333,111,11,6,51,189,114,143,0,0
5458,265,146,316,334,111,11,6,51,188,115,143,0,0
5459,264,146,318,338,111,11,6,54,192,116,143,0,0
5460,265,144,321,340,111,11,6,56,196,117,143,0,0
5461,271,144,328,338,111,11,6,57,194,118,143,0,0
5462,270,147,326,338,111,11,6,56,191,119,143,0,0
5463,268,146,324,338,111,11,6,56,192,120,143,0,0
5464,269,146,325,337,111,11,6,56,191,121,143,0,0
5465,272,146,328,339,111,11,6,56,193,122,143,0,0
5466,277,147,331,334,111,11,6,54,187,123,143,0,0
5467,277,146,332,336,111,11,6,55,190,124,143,0,0
5468,281,146,335,336,111,11,6,54,190,125,143,0,0
5469,287,144,342,336,111,11,6,55,192,126,143,0,0
5470,291,143,346,333,111,11,6,55,190,127,143,0,0
5471,296,144,349,326,111,11,6,53,182,128,143,0,0
5472,298,143,354,333,111,11,6,56,190,129,143,0,0
5473,302,141,360,337,111,11,6,58,196,130,143,0,0
5474,304,142,362,338,111,11,6,58,196,131,143,0,0
5475,307,145,364,337,111,11,6,57,192,132,143,0,0
5476,308,144,365,336,111,11,6,57,192,133,143,0,0
5477,313,145,371,338,111,11,6,58,193,134,143,0,0
5478,315,146,375,337,111,11,6,60,191,135,143,0,0
5479,317,146,377,336,111,11,6,60,190,136,143,0,0
5480,317,146,378,332,111,11,6,61,186,137,143,0,0
5481,321,146,382,334,111,11,6,61,188,138,143,0,0
5482,325,146,387,332,111,11,6,62,186,139,143,0,0
5483,332,146,391,326,111,11,6,59,180,140,143,0,0
5484,337,144,397,328,111,11,6,60,184,141,143,0,0
5485,348,141,412,332,111,11,6,64,191,142,143,0,0
5486,352,141,417,332,111,11,6,65,191,143,143,1,0
5488,349,142,407,321,111,11,6,58,179,0,143,0,0
5489,344,143,402,321,111,11,6,58,178,1,143,0,0
5490,337,143,395,319,111,11,6,58,176,2,143,0,0
5491,324,143,382,320,111,11,6,58,177,3,143,0,0
5492,310,147,369,323,111,11,6,59,176,4,143,0,0
5493,308,147,367,323,111,11,6,59,176,5,143,0,0
5494,266,149,325,331,111,11,6,59,182,6,143,0,0
5495,260,150,319,332,111,11,6,59,182,7,143,0,0
5342,307,117,347,226,113,11,6,40,109,0,144,0,0
5343,320,122,359,228,113,11,6,39,106,1,144,0,0
5344,333,114,374,226,113,11,6,41,112,2,144,0,0
5345,343,112,386,230,113,11,6,43,118,3,144,0,0
5346,353,113,397,234,113,11,6,44,121,4,144,0,0
5347,364,113,406,229,113,11,6,42,116,5,144,0,0
5348,372,116,415,233,113,11,6,43,117,6,144,0,0
5349,381,113,425,236,113,11,6,44,123,7,144,0,0
5350,384,116,430,245,113,11,6,46,129,8,144,0,0
5351,384,119,432,251,113,11,6,48,132,9,144,0,0
5352,384,119,433,255,113,11,6,49,136,10,144,0,0
5353,383,121,433,262,113,11,6,50,141,11,144,0,0
5354,381,121,432,265,113,11,6,51,144,12,144,0,0
5355,377,125,427,268,113,11,6,50,143,13,144,0,0
5356,368,126,418,271,113,11,6,50,145,14,144,0,0
5357,371,127,422,274,113,11,6,51,147,15,144,0,0
5359,369,126,417,269,113,11,6,48,143,0,144,0,1
5360,370,124,417,270,113,11,6,47,146,1,144,0,0
5361,372,126,420,275,113,11,6,48,149,2,144,0,0
5362,378,126,425,275,113,11,6,47,149,3,144,0,0
5363,382,126,430,277,113,11,6,48,151,4,144,0,0
5364,384,128,432,280,113,11,6,48,152,5,144,0,0
5365,384,128,433,282,113,11,6,49,154,6,144,0,0
5366,385,129,434,284,113,11,6,49,155,7,144,0,0
5367,388,131,438,289,113,11,6,50,158,8,144,0,0
5368,393,132,443,290,113,11,6,50,158,9,144,0,0
5369,397,132,447,290,113,11,6,50,158,10,144,0,0
5370,398,134,449,293,113,11,6,51,159,11,144,0,0
5371,396,137,447,295,113,11,6,51,158,12,144,0,0
5372,392,138,444,297,113,11,6,52,159,13,144,0,0
5373,389,138,442,299,113,11,6,53,161,14,144,0,0
5374,388,139,442,302,113,11,6,54,163,15,144,0,0
5375,389,140,444,303,113,11,6,55,163,16,144,0,0
5376,391,140,446,303,113,11,6,55,163,17,144,0,0
5377,392,140,447,304,113,11,6,55,164,18,144,0,0
5378,393,141,448,304,113,11,6,55,163,19,144,0,0
5379,390,142,445,306,113,11,6,55,164,20,144,0,0
5380,391,142,445,305,113,11,6,54,163,21,144,0,0
5381,391,141,445,304,113,11,6,54,163,22,144,0,0
5382,391,142,444,303,113,11,6,53,161,23,144,0,0
5383,390,142,444,303,113,11,6,54,161,24,144,0,0
5384,390,142,443,303,113,11,6,53,161,25,144,0,0
5385,391,142,443,304,113,11,6,52,162,26,144,0,0
5386,390,142,443,304,113,11,6,53,162,27,144,0,0
5387,390,143,443,304,113,11,6,53,161,28,144,0,0
5388,390,145,444,310,113,11,6,54,165,29,144,0,0
5389,389,143,444,317,113,11,6,55,174,30,144,0,0
5390,390,145,445,319,113,11,6,55,174,31,144,0,0
5391,391,146,448,324,113,11,6,57,178,32,144,0,0
5392,394,147,453,328,113,11,6,59,181,33,144,0,0
5393,400,148,459,332,113,11,6,59,184,34,144,0,0
5394,406,148,464,331,113,11,6,58,183,35,144,0,0
5395,411,149,469,333,113,11,6,58,184,36,144,0,0
5396,413,147,472,334,113,11,6,59,187,37,144,0,0
5397,414,144,474,334,113,11,6,60,190,38,144,0,0
5398,414,144,474,334,113,11,6,60,190,39,144,0,0
5399,415,144,473,333,113,11,6,58,189,40,144,0,0
5400,412,142,471,332,113,11,6,59,190,41,144,0,0
5401,411,142,470,333,113,11,6,59,191,42,144,0,0
5402,410,141,470,333,113,11,6,60,192,43,144,0,0
5403,410,141,470,334,113,11,6,60,193,44,144,0,0
5404,409,140,469,334,113,11,6,60,194,45,144,0,0
5405,409,140,469,335,113,11,6,60,195,46,144,0,0
5406,410,141,469,334,113,11,6,59,193,47,144,0,0
5407,410,141,468,333,113,11,6,58,192,48,144,0,0
5408,411,141,469,332,113,11,6,58,191,49,144,0,0
5409,412,141,469,333,113,11,6,57,192,50,144,0,0
5410,412,141,469,333,113,11,6,57,192,51,144,0,0
5411,413,141,470,333,113,11,6,57,192,52,144,0,0
5412,413,141,470,332,113,11,6,57,191,53,144,0,0
5413,413,140,470,332,113,11,6,57,192,54,144,0,0
5414,413,140,470,332,113,11,6,57,192,55,144,0,0
5415,413,141,469,332,113,11,6,56,191,56,144,0,0
5416,414,141,470,332,113,11,6,56,191,57,144,0,0
5417,414,141,470,332,113,11,6,56,191,58,144,0,0
5418,414,140,470,332,113,11,6,56,192,59,144,0,0
5419,414,140,470,332,113,11,6,56,192,60,144,0,0
5420,414,140,470,332,113,11,6,56,192,61,144,0,0
5421,413,140,469,332,113,11,6,56,192,62,144,0,0
5422,414,141,469,332,113,11,6,55,191,63,144,0,0
5423,413,141,469,332,113,11,6,56,191,64,144,0,0
5424,415,142,470,332,113,11,6,55,190,65,144,0,0
5425,416,143,470,333,113,11,6,54,190,66,144,0,0
5426,416,143,471,333,113,11,6,55,190,67,144,0,0
5427,417,143,471,333,113,11,6,54,190,68,144,0,0
5428,417,143,472,333,113,11,6,55,190,69,144,0,0
5429,417,142,472,333,113,11,6,55,191,70,144,0,0
5430,417,142,472,334,113,11,6,55,192,71,144,0,0
5431,417,142,471,333,113,11,6,54,191,72,144,0,0
5432,417,142,472,333,113,11,6,55,191,73,144,0,0
5433,417,143,472,333,113,11,6,55,190,74,144,0,0
5434,418,143,471,333,113,11,6,53,190,75,144,0,0
5435,418,143,472,333,113,11,6,54,190,76,144,0,0
5436,418,143,472,333,113,11,6,54,190,77,144,0,0
5437,418,143,472,333,113,11,6,54,190,78,144,0,0
5438,418,143,472,333,113,11,6,54,190,79,144,0,0
5439,417,143,471,333,113,11,6,54,190,80,144,0,0
5440,417,143,471,333,113,11,6,54,190,81,144,0,0
5441,416,143,470,333,113,11,6,54,190,82,144,0,0
5442,416,143,470,332,113,11,6,54,189,83,144,0,0
5443,416,143,470,332,113,11,6,54,189,84,144,0,0
5444,414,142,469,332,113,11,6,55,190,85,144,0,0
5445,413,142,468,331,113,11,6,55,189,86,144,0,0
5446,413,142,467,331,113,11,6,54,189,87,144,0,0
5447,411,142,466,331,113,11,6,55,189,88,144,0,0
5448,411,142,466,332,113,11,6,55,190,89,144,0,0
5449,414,144,471,337,113,11,6,57,193,90,144,0,0
5450,415,146,471,336,113,11,6,56,190,91,144,0,0
5451,415,148,471,336,113,11,6,56,188,92,144,0,0
5452,416,151,470,333,113,11,6,54,182,93,144,0,0
5453,414,150,469,333,113,11,6,55,183,94,144,0,0
5454,413,149,468,335,113,11,6,55,186,95,144,0,0
5455,412,149,468,335,113,11,6,56,186,96,144,0,0
5456,412,149,467,335,113,11,6,55,186,97,144,0,0
5457,412,150,467,335,113,11,6,55,185,98,144,0,0
5458,413,150,468,335,113,11,6,55,185,99,144,0,0
5459,414,149,470,335,113,11,6,56,186,100,144,0,0
5460,413,147,470,335,113,11,6,57,188,101,144,0,0
5461,412,149,469,338,113,11,6,57,189,102,144,0,0
5462,413,150,470,336,113,11,6,57,186,103,144,0,0
5463,413,149,471,335,113,11,6,58,186,104,144,0,0
5464,413,150,471,335,113,11,6,58,185,105,144,0,0
5465,413,150,469,332,113,11,6,56,182,106,144,0,0
5466,410,150,468,334,113,11,6,58,184,107,144,0,0
5467,408,147,467,336,113,11,6,59,189,108,144,0,0
5468,407,147,466,337,113,11,6,59,190,109,144,0,0
5469,406,146,465,337,113,11,6,59,191,110,144,0,0
5470,407,146,465,337,113,11,6,58,191,111,144,0,0
5471,408,146,465,337,113,11,6,57,191,112,144,0,0
5472,408,146,466,337,113,11,6,58,191,113,144,0,0
5473,409,145,466,337,113,11,6,57,192,114,144,0,0
5474,410,145,466,338,113,11,6,56,193,115,144,0,0
5475,409,145,466,338,113,11,6,57,193,116,144,0,0
5476,409,145,466,338,113,11,6,57,193,117,144,0,0
5477,410,147,465,338,113,11,6,55,191,118,144,0,0
5478,409,145,464,338,113,11,6,55,193,119,144,0,0
5479,409,143,464,337,113,11,6,55,194,120,144,0,0
5480,411,144,465,335,113,11,6,54,191,121,144,0,0
5481,411,146,464,329,113,11,6,53,183,122,144,0,0
5482,405,144,459,328,113,11,6,54,184,123,144,0,0
5483,398,144,452,328,113,11,6,54,184,124,144,0,0
5484,387,140,443,328,113,11,6,56,188,125,144,0,0
5485,385,139,441,327,113,11,6,56,188,126,144,0,0
5486,379,140,443,335,113,11,6,64,195,127,144,0,0
5487,385,140,454,333,113,11,6,69,193,128,144,0,0
5488,383,142,458,335,113,11,6,75,193,129,144,0,0
5489,390,147,466,339,113,11,6,76,192,130,144,0,0
5490,406,149,479,337,113,11,6,73,188,131,144,0,0
5491,429,148,501,333,113,11,6,72,185,132,144,0,0
5492,444,150,522,347,113,11,6,78,197,133,144,0,0
5493,473,152,549,344,113,11,6,76,192,134,144,0,0
5494,500,154,578,347,113,11,6,78,193,135,144,0,0
5495,525,156,607,355,113,11,6,82,199,136,144,0,0
5496,558,155,640,356,113,11,6,82,201,137,144,0,0
5497,581,160,666,361,113,11,6,85,201,138,144,0,0
5498,618,164,699,363,113,11,6,81,199,139,144,0,0
5499,652,181,728,362,113,11,6,76,181,140,144,0,0
5500,678,178,762,374,113,11,6,84,196,141,144,0,0
5501,714,175,800,376,113,11,6,86,201,142,144,0,0
5502,737,175,823,379,113,11,6,86,204,143,144,0,0
5503,758,177,845,381,113,11,6,87,204,144,144,1,0
5364,332,139,367,284,114,11,6,35,145,0,114,0,1
5365,328,139,364,289,114,11,6,36,150,1,114,0,0
5366,327,140,364,291,114,11,6,37,151,2,114,0,0
5367,326,141,364,290,114,11,6,38,149,3,114,0,0
5368,325,141,364,289,114,11,6,39,148,4,114,0,0
5369,324,141,364,290,114,11,6,40,149,5,114,0,0
5370,325,140,365,290,114,11,6,40,150,6,114,0,0
5371,324,140,366,291,114,11,6,42,151,7,114,0,0
5372,325,141,366,290,114,11,6,41,149,8,114,0,0
5373,325,141,367,290,114,11,6,42,149,9,114,0,0
5374,326,140,368,291,114,11,6,42,151,10,114,0,0
5375,326,141,368,289,114,11,6,42,148,11,114,0,0
5376,325,140,368,291,114,11,6,43,151,12,114,0,0
5377,325,138,368,291,114,11,6,43,153,13,114,0,0
5378,325,139,368,291,114,11,6,43,152,14,114,0,0
5379,325,142,367,290,114,11,6,42,148,15,114,0,0
5380,326,141,369,292,114,11,6,43,151,16,114,0,0
5381,329,141,372,291,114,11,6,43,150,17,114,0,0
5382,332,142,376,291,114,11,6,44,149,18,114,0,0
5383,334,142,379,294,114,11,6,45,152,19,114,0,0
5384,334,143,381,299,114,11,6,47,156,20,114,0,0
5385,335,143,382,303,114,11,6,47,160,21,114,0,0
5386,333,144,380,303,114,11,6,47,159,22,114,0,0
5387,332,144,379,300,114,11,6,47,156,23,114,0,0
5388,331,144,379,302,114,11,6,48,158,24,114,0,0
5389,328,144,377,307,114,11,6,49,163,25,114,0,0
5390,327,148,377,314,114,11,6,50,166,26,114,0,0
5391,328,152,376,310,114,11,6,48,158,27,114,0,0
5392,327,151,376,310,114,11,6,49,159,28,114,0,0
5393,327,150,375,307,114,11,6,48,157,29,114,0,0
5394,329,149,378,307,114,11,6,49,158,30,114,0,0
5395,327,148,378,314,114,11,6,51,166,31,114,0,0
5396,325,148,377,317,114,11,6,52,169,32,114,0,0
5397,324,149,375,317,114,11,6,51,168,33,114,0,0
5398,324,150,374,316,114,11,6,50,166,34,114,0,0
5399,325,151,373,315,114,11,6,48,164,35,114,0,0
5400,325,152,373,314,114,11,6,48,162,36,114,0,0
5401,326,151,372,308,114,11,6,46,157,37,114,0,0
5402,326,151,373,306,114,11,6,47,155,38,114,0,0
5403,327,149,376,309,114,11,6,49,160,39,114,0,0
5404,325,149,374,310,114,11,6,49,161,40,114,0,0
5405,325,151,374,310,114,11,6,49,159,41,114,0,0
5406,322,151,373,312,114,11,6,51,161,42,114,0,0
5407,324,151,375,311,114,11,6,51,160,43,114,0,0
5408,324,151,375,311,114,11,6,51,160,44,114,0,0
5409,325,150,376,310,114,11,6,51,160,45,114,0,0
5410,325,150,377,311,114,11,6,52,161,46,114,0,0
5411,325,148,377,311,114,11,6,52,163,47,114,0,0
5412,324,148,377,312,114,11,6,53,164,48,114,0,0
5413,323,150,377,312,114,11,6,54,162,49,114,0,0
5414,323,150,378,314,114,11,6,55,164,50,114,0,0
5415,323,150,379,314,114,11,6,56,164,51,114,0,0
5416,323,150,378,314,114,11,6,55,164,52,114,0,0
5417,323,150,379,314,114,11,6,56,164,53,114,0,0
5418,323,150,380,315,114,11,6,57,165,54,114,0,0
5419,324,149,380,313,114,11,6,56,164,55,114,0,0
5420,323,148,380,313,114,11,6,57,165,56,114,0,0
5421,323,148,380,314,114,11,6,57,166,57,114,0,0
5422,323,149,380,313,114,11,6,57,164,58,114,0,0
5423,323,149,380,313,114,11,6,57,164,59,114,0,0
5424,322,149,380,314,114,11,6,58,165,60,114,0,0
5425,322,149,380,314,114,11,6,58,165,61,114,0,0
5426,323,149,380,313,114,11,6,57,164,62,114,0,0
5427,323,149,381,313,114,11,6,58,164,63,114,0,0
5428,323,149,380,313,114,11,6,57,164,64,114,0,0
5429,323,150,380,314,114,11,6,57,164,65,114,0,0
5430,323,150,381,314,114,11,6,58,164,66,114,0,0
5431,324,150,381,314,114,11,6,57,164,67,114,0,0
5432,324,150,381,314,114,11,6,57,164,68,114,0,0
5433,324,150,381,313,114,11,6,57,163,69,114,0,0
5434,323,150,381,313,114,11,6,58,163,70,114,0,0
5435,323,150,380,313,114,11,6,57,163,71,114,0,0
5436,323,150,380,312,114,11,6,57,162,72,114,0,0
5437,323,150,380,313,114,11,6,57,163,73,114,0,0
5438,323,150,381,313,114,11,6,58,163,74,114,0,0
5439,323,150,380,313,114,11,6,57,163,75,114,0,0
5440,323,152,379,311,114,11,6,56,159,76,114,0,0
5441,323,151,380,312,114,11,6,57,161,77,114,0,0
5442,323,151,380,312,114,11,6,57,161,78,114,0,0
5443,323,151,380,312,114,11,6,57,161,79,114,0,0
5444,324,150,380,309,114,11,6,56,159,80,114,0,0
5445,324,150,380,306,114,11,6,56,156,81,114,0,0
5446,323,151,377,306,114,11,6,54,155,82,114,0,0
5447,319,151,373,306,114,11,6,54,155,83,114,0,0
5448,314,153,367,308,114,11,6,53,155,84,114,0,0
5449,309,151,363,307,114,11,6,54,156,85,114,0,0
5450,307,150,360,306,114,11,6,53,156,86,114,0,0
5451,307,150,360,307,114,11,6,53,157,87,114,0,0
5452,311,153,362,307,114,11,6,51,154,88,114,0,0
5453,315,151,367,306,114,11,6,52,155,89,114,0,0
5454,319,150,371,306,114,11,6,52,156,90,114,0,0
5455,326,151,378,306,114,11,6,52,155,91,114,0,0
5456,334,151,385,303,114,11,6,51,152,92,114,0,0
5457,343,149,395,305,114,11,6,52,156,93,114,0,0
5458,350,148,403,307,114,11,6,53,159,94,114,0,0
5459,356,146,409,304,114,11,6,53,158,95,114,0,0
5460,361,144,414,301,114,11,6,53,157,96,114,0,0
5461,365,144,418,300,114,11,6,53,156,97,114,0,0
5462,365,144,419,303,114,11,6,54,159,98,114,0,0
5463,364,144,418,306,114,11,6,54,162,99,114,0,0
5464,362,146,415,306,114,11,6,53,160,100,114,0,0
5465,360,147,413,306,114,11,6,53,159,101,114,0,0
5466,359,147,412,306,114,11,6,53,159,102,114,0,0
5467,358,147,411,308,114,11,6,53,161,103,114,0,0
5468,358,148,409,307,114,11,6,51,159,104,114,0,0
5469,358,148,409,307,114,11,6,51,159,105,114,0,0
5470,359,148,410,306,114,11,6,51,158,106,114,0,0
5471,359,147,411,314,114,11,6,52,167,107,114,0,0
5472,359,149,410,313,114,11,6,51,164,108,114,0,0
5473,360,150,410,311,114,11,6,50,161,109,114,0,0
5474,360,148,412,315,114,11,6,52,167,110,114,0,0
5475,358,146,410,310,114,11,6,52,164,111,114,0,0
5476,358,145,408,306,114,11,6,50,161,112,114,0,0
5477,354,152,402,304,114,11,6,48,152,113,114,0,0
5478,354,152,401,303,114,11,6,47,151,114,114,1,0
5482,297,147,346,308,114,11,6,49,161,0,114,0,0
5483,289,150,337,310,114,11,6,48,160,1,114,0,0
5484,278,153,326,312,114,11,6,48,159,2,114,0,0
5485,267,155,313,307,114,11,6,46,152,3,114,0,0
5486,256,153,304,317,114,11,6,48,164,4,114,0,0
5487,248,154,297,319,114,11,6,49,165,5,114,0,0
5423,295,152,333,295,116,11,6,38,143,0,1,0,0
5424,294,152,332,295,116,11,6,38,143,1,1,0,0
5786,250,165,307,422,124,11,6,57,257,0,40,0,1
5787,269,171,327,424,124,11,6,58,253,1,40,0,0
5788,292,164,350,416,124,11,6,58,252,2,40,0,0
5789,331,160,389,408,124,11,6,58,248,3,40,0,0
5790,350,163,411,411,124,11,6,61,248,4,40,0,0
5791,380,159,440,404,124,11,6,60,245,5,40,0,0
5792,407,157,467,400,124,11,6,60,243,6,40,0,0
5793,429,155,489,399,124,11,6,60,244,7,40,0,0
5794,454,156,514,399,124,11,6,60,243,8,40,0,0
5795,477,154,541,401,124,11,6,64,247,9,40,0,0
5796,486,152,553,399,124,11,6,67,247,10,40,0,0
5797,513,155,577,393,124,11,6,64,238,11,40,0,0
5798,533,156,598,393,124,11,6,65,237,12,40,0,0
5799,545,159,612,397,124,11,6,67,238,13,40,0,0
5800,576,152,642,390,124,11,6,66,238,14,40,0,0
5801,602,151,670,387,124,11,6,68,236,15,40,0,0
5802,622,149,694,384,124,11,6,72,235,16,40,0,0
5803,653,151,723,377,124,11,6,70,226,17,40,0,0
5804,674,151,743,374,124,11,6,69,223,18,40,0,0
5805,690,149,757,367,124,11,6,67,218,19,40,0,0
5806,699,144,766,362,124,11,6,67,218,20,40,0,0
5807,710,147,776,359,124,11,6,66,212,21,40,0,0
5808,722,147,786,351,124,11,6,64,204,22,40,0,0
5809,732,149,791,334,124,11,6,59,185,23,40,0,0
5810,736,147,796,337,124,11,6,60,190,24,40,0,0
5811,742,144,799,324,124,11,6,57,180,25,40,0,0
5812,746,143,802,321,124,11,6,56,178,26,40,0,0
5813,748,142,807,323,124,11,6,59,181,27,40,0,0
5814,757,140,815,319,124,11,6,58,179,28,40,0,0
5815,764,140,821,319,124,11,6,57,179,29,40,0,0
5816,767,141,823,321,124,11,6,56,180,30,40,0,0
5817,771,140,822,308,124,11,6,51,168,31,40,0,0
5818,771,137,821,302,124,11,6,50,165,32,40,0,0
5819,775,145,820,300,124,11,6,45,155,33,40,0,0
5820,775,148,820,301,124,11,6,45,153,34,40,0,0
5821,775,153,818,302,124,11,6,43,149,35,40,0,0
5822,773,160,814,300,124,11,6,41,140,36,40,0,0
5823,778,162,817,297,124,11,6,39,135,37,40,0,0
5824,765,166,806,303,124,11,6,41,137,38,40,0,0
5825,764,173,803,304,124,11,6,39,131,39,40,0,0
5826,766,175,804,302,124,11,6,38,127,40,40,1,0
136,1576,482,1913,1031,3,11,7,337,549,0,57,0,1
137,1545,436,1908,1031,3,11,7,363,595,1,57,0,0
138,1452,410,1815,1006,3,11,7,363,596,2,57,0,0
139,1392,377,1744,959,3,11,7,352,582,3,57,0,0
140,1368,346,1704,911,3,11,7,336,565,4,57,0,0
141,1349,320,1679,885,3,11,7,330,565,5,57,0,0
142,1351,298,1644,809,3,11,7,293,511,6,57,0,0
143,1357,282,1636,782,3,11,7,279,500,7,57,0,0
144,1369,268,1631,751,3,11,7,262,483,8,57,0,0
145,1392,247,1630,694,3,11,7,238,447,9,57,0,0
146,1419,243,1640,666,3,11,7,221,423,10,57,0,0
147,1454,228,1657,625,3,11,7,203,397,11,57,0,0
148,1477,220,1670,609,3,11,7,193,389,12,57,0,0
149,1499,211,1675,574,3,11,7,176,363,13,57,0,0
150,1522,198,1686,545,3,11,7,164,347,14,57,0,0
151,1544,197,1696,524,3,11,7,152,327,15,57,0,0
152,1562,187,1708,508,3,11,7,146,321,16,57,0,0
153,1579,187,1715,493,3,11,7,136,306,17,57,0,0
154,1591,184,1719,477,3,11,7,128,293,18,57,0,0
155,1601,180,1723,464,3,11,7,122,284,19,57,0,0
156,1614,174,1726,443,3,11,7,112,269,20,57,0,0
157,1622,170,1728,430,3,11,7,106,260,21,57,0,0
158,1626,169,1728,425,3,11,7,102,256,22,57,0,0
159,1632,165,1726,405,3,11,7,94,240,23,57,0,0
160,1637,163,1726,395,3,11,7,89,232,24,57,0,0
161,1642,155,1726,379,3,11,7,84,224,25,57,0,0
162,1647,151,1726,365,3,11,7,79,214,26,57,0,0
163,1648,147,1725,362,3,11,7,77,215,27,57,0,0
164,1650,144,1723,349,3,11,7,73,205,28,57,0,0
165,1652,141,1722,342,3,11,7,70,201,29,57,0,0
166,1653,136,1722,333,3,11,7,69,197,30,57,0,0
167,1654,133,1718,322,3,11,7,64,189,31,57,0,0
168,1652,130,1714,313,3,11,7,62,183,32,57,0,0
169,1652,126,1713,306,3,11,7,61,180,33,57,0,0
170,1653,123,1713,301,3,11,7,60,178,34,57,0,0
171,1653,123,1711,293,3,11,7,58,170,35,57,0,0
172,1653,122,1710,289,3,11,7,57,167,36,57,0,0
173,1653,119,1708,279,3,11,7,55,160,37,57,0,0
174,1654,119,1709,275,3,11,7,55,156,38,57,0,0
175,1656,116,1709,268,3,11,7,53,152,39,57,0,0
176,1656,115,1707,262,3,11,7,51,147,40,57,0,0
177,1655,111,1705,254,3,11,7,50,143,41,57,0,0
178,1654,108,1704,251,3,11,7,50,143,42,57,0,0
179,1655,109,1704,248,3,11,7,49,139,43,57,0,0
180,1657,106,1704,243,3,11,7,47,137,44,57,0,0
181,1656,105,1704,242,3,11,7,48,137,45,57,0,0
182,1657,101,1704,238,3,11,7,47,137,46,57,0,0
183,1657,101,1704,237,3,11,7,47,136,47,57,0,0
184,1659,100,1705,234,3,11,7,46,134,48,57,0,0
185,1660,97,1706,231,3,11,7,46,134,49,57,0,0
186,1661,97,1706,227,3,11,7,45,130,50,57,0,0
187,1662,95,1706,224,3,11,7,44,129,51,57,0,0
188,1664,95,1708,222,3,11,7,44,127,52,57,0,0
189,1668,94,1709,214,3,11,7,41,120,53,57,0,0
190,1670,95,1709,210,3,11,7,39,115,54,57,0,0
191,1673,96,1708,201,3,11,7,35,105,55,57,0,0
192,1672,93,1709,201,3,11,7,37,108,56,57,0,0
193,1673,94,1708,199,3,11,7,35,105,57,57,1,0
205,1602,67,1638,172,5,11,7,36,105,0,86,0,0
207,1603,70,1638,176,5,11,7,35,106,0,86,0,1
208,1602,72,1637,177,5,11,7,35,105,1,86,0,0
209,1602,75,1637,177,5,11,7,35,102,2,86,0,0
210,1602,73,1638,181,5,11,7,36,108,3,86,0,0
211,1602,76,1638,185,5,11,7,36,109,4,86,0,0
212,1601,77,1637,188,5,11,7,36,111,5,86,0,0
213,1599,77,1636,190,5,11,7,37,113,6,86,0,0
214,1597,78,1635,190,5,11,7,38,112,7,86,0,0
215,1597,78,1635,191,5,11,7,38,113,8,86,0,0
216,1598,81,1635,193,5,11,7,37,112,9,86,0,0
217,1599,82,1636,195,5,11,7,37,113,10,86,0,0
218,1597,81,1636,198,5,11,7,39,117,11,86,0,0
219,1596,81,1635,198,5,11,7,39,117,12,86,0,0
220,1594,80,1634,199,5,11,7,40,119,13,86,0,0
221,1594,80,1635,202,5,11,7,41,122,14,86,0,0
222,1594,80,1636,204,5,11,7,42,124,15,86,0,0
223,1592,80,1635,209,5,11,7,43,129,16,86,0,0
224,1589,80,1634,211,5,11,7,45,131,17,86,0,0
225,1588,78,1634,214,5,11,7,46,136,18,86,0,0
226,1588,80,1635,219,5,11,7,47,139,19,86,0,0
227,1588,78,1635,220,5,11,7,47,142,20,86,0,0
228,1585,80,1633,225,5,11,7,48,145,21,86,0,0
229,1583,82,1631,228,5,11,7,48,146,22,86,0,0
230,1581,81,1630,231,5,11,7,49,150,23,86,0,0
231,1578,85,1627,235,5,11,7,49,150,24,86,0,0
232,1576,84,1626,237,5,11,7,50,153,25,86,0,0
233,1574,87,1624,242,5,11,7,50,155,26,86,0,0
234,1571,87,1622,245,5,11,7,51,158,27,86,0,0
235,1570,86,1622,248,5,11,7,52,162,28,86,0,0
236,1569,87,1623,255,5,11,7,54,168,29,86,0,0
237,1570,87,1624,257,5,11,7,54,170,30,86,0,0
238,1569,87,1626,264,5,11,7,57,177,31,86,0,0
239,1568,88,1625,269,5,11,7,57,181,32,86,0,0
240,1566,87,1625,273,5,11,7,59,186,33,86,0,0
241,1565,91,1625,279,5,11,7,60,188,34,86,0,0
242,1565,93,1625,281,5,11,7,60,188,35,86,0,0
243,1562,95,1624,290,5,11,7,62,195,36,86,0,0
244,1561,99,1624,295,5,11,7,63,196,37,86,0,0
245,1559,98,1624,299,5,11,7,65,201,38,86,0,0
246,1559,102,1624,307,5,11,7,65,205,39,86,0,0
247,1560,105,1627,312,5,11,7,67,207,40,86,0,0
248,1559,106,1629,324,5,11,7,70,218,41,86,0,0
249,1557,109,1629,330,5,11,7,72,221,42,86,0,0
250,1553,109,1627,338,5,11,7,74,229,43,86,0,0
251,1549,110,1626,349,5,11,7,77,239,44,86,0,0
252,1545,110,1624,354,5,11,7,79,244,45,86,0,0
253,1536,113,1618,365,5,11,7,82,252,46,86,0,0
254,1528,119,1612,377,5,11,7,84,258,47,86,0,0
255,1520,117,1606,382,5,11,7,86,265,48,86,0,0
256,1512,122,1601,399,5,11,7,89,277,49,86,0,0
257,1502,123,1594,408,5,11,7,92,285,50,86,0,0
258,1488,125,1584,419,5,11,7,96,294,51,86,0,0
259,1475,129,1573,429,5,11,7,98,300,52,86,0,0
260,1464,126,1566,439,5,11,7,102,313,53,86,0,0
261,1456,135,1563,460,5,11,7,107,325,54,86,0,0
262,1447,140,1558,476,5,11,7,111,336,55,86,0,0
263,1436,142,1553,492,5,11,7,117,350,56,86,0,0
264,1421,149,1544,517,5,11,7,123,368,57,86,0,0
265,1408,146,1537,531,5,11,7,129,385,58,86,0,0
266,1399,157,1533,559,5,11,7,134,402,59,86,0,0
267,1387,165,1527,587,5,11,7,140,422,60,86,0,0
268,1369,170,1516,610,5,11,7,147,440,61,86,0,0
269,1345,181,1500,645,5,11,7,155,464,62,86,0,0
270,1322,186,1482,667,5,11,7,160,481,63,86,0,0
271,1297,205,1468,723,5,11,7,171,518,64,86,0,0
272,1266,228,1442,758,5,11,7,176,530,65,86,0,0
273,1212,237,1396,785,5,11,7,184,548,66,86,0,0
274,1147,249,1345,820,5,11,7,198,571,67,86,0,0
275,1065,240,1273,848,5,11,7,208,608,68,86,0,0
276,973,261,1192,873,5,11,7,219,612,69,86,0,0
277,884,298,1107,896,5,11,7,223,598,70,86,0,0
278,756,301,986,902,5,11,7,230,601,71,86,0,0
279,631,310,878,904,5,11,7,247,594,72,86,0,0
280,511,304,755,895,5,11,7,244,591,73,86,0,0
281,433,305,681,885,5,11,7,248,580,74,86,0,0
282,345,307,589,871,5,11,7,244,564,75,86,0,0
283,234,307,475,861,5,11,7,241,554,76,86,0,0
284,160,311,400,844,5,11,7,240,533,77,86,0,0
285,107,302,333,812,5,11,7,226,510,78,86,0,0
286,84,303,298,785,5,11,7,214,482,79,86,0,0
287,48,307,254,768,5,11,7,206,461,80,86,0,0
288,0,304,193,754,5,11,7,193,450,81,86,0,0
289,0,309,164,742,5,11,7,164,433,82,86,0,0
290,0,299,132,710,5,11,7,132,411,83,86,0,0
291,0,339,112,690,5,11,7,112,351,84,86,0,0
292,0,361,92,670,5,11,7,92,309,85,86,0,0
293,0,372,69,660,5,11,7,69,288,86,86,1,0
236,1,371,46,679,7,11,7,45,308,0,26,0,1
237,16,360,64,685,7,11,7,48,325,1,26,0,0
238,21,364,72,702,7,11,7,51,338,2,26,0,0
239,18,339,77,723,7,11,7,59,384,3,26,0,0
240,20,335,87,754,7,11,7,67,419,4,26,0,0
241,24,336,97,770,7,11,7,73,434,5,26,0,0
242,47,343,128,785,7,11,7,81,442,6,26,0,0
243,56,352,145,801,7,11,7,89,449,7,26,0,0
244,50,346,153,837,7,11,7,103,491,8,26,0,0
245,65,357,180,874,7,11,7,115,517,9,26,0,0
246,81,361,206,889,7,11,7,125,528,10,26,0,0
247,123,369,265,911,7,11,7,142,542,11,26,0,0
248,155,380,310,931,7,11,7,155,551,12,26,0,0
249,174,393,347,987,7,11,7,173,594,13,26,0,0
250,205,407,396,1032,7,11,7,191,625,14,26,0,0
251,247,410,454,1051,7,11,7,207,641,15,26,0,0
252,308,427,529,1071,7,11,7,221,644,16,26,0,0
253,345,437,573,1080,7,11,7,228,643,17,26,0,0
254,398,462,628,1080,7,11,7,230,618,18,26,0,0
255,465,502,694,1080,7,11,7,229,578,19,26,0,0
256,545,511,787,1080,7,11,7,242,569,20,26,0,0
257,657,545,899,1080,7,11,7,242,535,21,26,0,0
258,774,561,1028,1079,7,11,7,254,518,22,26,0,0
259,911,615,1169,1080,7,11,7,258,465,23,26,0,0
260,1053,647,1302,1071,7,11,7,249,424,24,26,0,0
261,1183,674,1440,1067,7,11,7,257,393,25,26,0,0
262,1274,696,1521,1073,7,11,7,247,377,26,26,1,0
263,1645,747,1915,1070,9,11,7,270,323,0,0,0,0
978,1662,44,1697,125,13,11,7,35,81,0,116,0,0
991,1661,48,1696,133,13,11,7,35,85,0,116,0,0
992,1661,48,1696,134,13,11,7,35,86,1,116,0,0
993,1661,46,1696,134,13,11,7,35,88,2,116,0,0
994,1661,45,1698,136,13,11,7,37,91,3,116,0,0
995,1661,44,1698,137,13,11,7,37,93,4,116,0,0
996,1659,46,1696,138,13,11,7,37,92,5,116,0,0
997,1661,48,1697,140,13,11,7,36,92,6,116,0,0
998,1660,47,1696,139,13,11,7,36,92,7,116,0,0
999,1663,47,1700,141,13,11,7,37,94,8,116,0,0
1000,1663,46,1700,142,13,11,7,37,96,9,116,0,0
1038,1671,93,1706,193,13,11,7,35,100,0,116,0,0
1039,1671,95,1706,193,13,11,7,35,98,1,116,0,0
1041,1669,95,1705,198,13,11,7,36,103,0,116,0,1
1042,1669,96,1706,202,13,11,7,37,106,1,116,0,0
1043,1669,97,1705,202,13,11,7,36,105,2,116,0,0
1044,1668,96,1705,204,13,11,7,37,108,3,116,0,0
1045,1668,97,1704,204,13,11,7,36,107,4,116,0,0
1046,1667,98,1705,207,13,11,7,38,109,5,116,0,0
1047,1666,99,1704,211,13,11,7,38,112,6,116,0,0
1048,1666,98,1705,210,13,11,7,39,112,7,116,0,0
1049,1665,100,1704,213,13,11,7,39,113,8,116,0,0
1050,1664,100,1703,213,13,11,7,39,113,9,116,0,0
1051,1663,99,1703,213,13,11,7,40,114,10,116,0,0
1052,1662,100,1703,219,13,11,7,41,119,11,116,0,0
1053,1661,99,1704,222,13,11,7,43,123,12,116,0,0
1054,1660,102,1703,224,13,11,7,43,122,13,116,0,0
1055,1656,106,1699,228,13,11,7,43,122,14,116,0,0
1056,1656,106,1697,225,13,11,7,41,119,15,116,0,0
1057,1654,109,1697,233,13,11,7,43,124,16,116,0,0
1058,1654,110,1698,235,13,11,7,44,125,17,116,0,0
1059,1653,109,1697,235,13,11,7,44,126,18,116,0,0
1060,1652,112,1696,239,13,11,7,44,127,19,116,0,0
1061,1651,112,1695,239,13,11,7,44,127,20,116,0,0
1062,1650,113,1695,242,13,11,7,45,129,21,116,0,0
1063,1652,116,1698,246,13,11,7,46,130,22,116,0,0
1064,1654,115,1701,249,13,11,7,47,134,23,116,0,0
1065,1651,116,1700,255,13,11,7,49,139,24,116,0,0
1066,1651,119,1699,257,13,11,7,48,138,25,116,0,0
1067,1651,120,1699,258,13,11,7,48,138,26,116,0,0
1068,1651,123,1702,266,13,11,7,51,143,27,116,0,0
1069,1653,125,1704,267,13,11,7,51,142,28,116,0,0
1070,1655,123,1709,274,13,11,7,54,151,29,116,0,0
1071,1655,124,1711,280,13,11,7,56,156,30,116,0,0
1072,1656,125,1712,282,13,11,7,56,157,31,116,0,0
1073,1656,128,1712,289,13,11,7,56,161,32,116,0,0
1074,1655,129,1713,296,13,11,7,58,167,33,116,0,0
1075,1655,128,1714,299,13,11,7,59,171,34,116,0,0
1076,1654,135,1712,302,13,11,7,58,167,35,116,0,0
1077,1651,136,1710,308,13,11,7,59,172,36,116,0,0
1078,1649,138,1709,309,13,11,7,60,171,37,116,0,0
1079,1647,140,1709,319,13,11,7,62,179,38,116,0,0
1080,1648,143,1710,323,13,11,7,62,180,39,116,0,0
1081,1647,142,1713,330,13,11,7,66,188,40,116,0,0
1082,1647,150,1712,338,13,11,7,65,188,41,116,0,0
1083,1646,147,1714,343,13,11,7,68,196,42,116,0,0
1084,1646,147,1715,350,13,11,7,69,203,43,116,0,0
1085,1646,150,1717,360,13,11,7,71,210,44,116,0,0
1086,1646,151,1717,362,13,11,7,71,211,45,116,0,0
1087,1643,156,1715,370,13,11,7,72,214,46,116,0,0
1088,1640,161,1712,375,13,11,7,72,214,47,116,0,0
1089,1637,161,1709,377,13,11,7,72,216,48,116,0,0
1090,1633,166,1709,392,13,11,7,76,226,49,116,0,0
1091,1633,166,1711,398,13,11,7,78,232,50,116,0,0
1092,1629,167,1711,407,13,11,7,82,240,51,116,0,0
1093,1628,172,1711,418,13,11,7,83,246,52,116,0,0
1094,1626,174,1712,426,13,11,7,86,252,53,116,0,0
1095,1622,180,1710,440,13,11,7,88,260,54,116,0,0
1096,1622,187,1711,455,13,11,7,89,268,55,116,0,0
1097,1623,190,1712,459,13,11,7,89,269,56,116,0,0
1098,1616,194,1710,476,13,11,7,94,282,57,116,0,0
1099,1612,201,1707,487,13,11,7,95,286,58,116,0,0
1100,1605,201,1704,499,13,11,7,99,298,59,116,0,0
1101,1599,207,1704,519,13,11,7,105,312,60,116,0,0
1102,1597,210,1704,528,13,11,7,107,318,61,116,0,0
1103,1594,212,1702,533,13,11,7,108,321,62,116,0,0
1104,1583,227,1698,563,13,11,7,115,336,63,116,0,0
1105,1573,230,1692,578,13,11,7,119,348,64,116,0,0
1106,1566,230,1691,595,13,11,7,125,365,65,116,0,0
1107,1561,241,1694,629,13,11,7,133,388,66,116,0,0
1108,1558,247,1695,648,13,11,7,137,401,67,116,0,0
1109,1550,256,1691,665,13,11,7,141,409,68,116,0,0
1110,1535,271,1681,693,13,11,7,146,422,69,116,0,0
1111,1518,274,1668,708,13,11,7,150,434,70,116,0,0
1112,1500,284,1661,751,13,11,7,161,467,71,116,0,0
1113,1476,300,1642,780,13,11,7,166,480,72,116,0,0
1114,1447,300,1616,790,13,11,7,169,490,73,116,0,0
1115,1385,295,1570,811,13,11,7,185,516,74,116,0,0
1116,1343,307,1532,828,13,11,7,189,521,75,116,0,0
1117,1299,318,1491,853,13,11,7,192,535,76,116,0,0
1118,1219,338,1421,887,13,11,7,202,549,77,116,0,0
1119,1166,350,1364,898,13,11,7,198,548,78,116,0,0
1120,1087,360,1285,901,13,11,7,198,541,79,116,0,0
1121,1014,364,1221,906,13,11,7,207,542,80,116,0,0
1122,942,360,1150,906,13,11,7,208,546,81,116,0,0
1123,853,359,1064,904,13,11,7,211,545,82,116,0,0
1124,797,369,1012,905,13,11,7,215,536,83,116,0,0
1125,703,370,915,902,13,11,7,212,532,84,116,0,0
1126,624,364,838,900,13,11,7,214,536,85,116,0,0
1127,567,367,780,894,13,11,7,213,527,86,116,0,0
1128,493,354,695,861,13,11,7,202,507,87,116,0,0
1129,447,352,643,834,13,11,7,196,482,88,116,0,0
1130,399,347,599,827,13,11,7,200,480,89,116,0,0
1131,332,344,525,812,13,11,7,193,468,90,116,0,0
1132,299,347,486,802,13,11,7,187,455,91,116,0,0
1133,260,337,437,770,13,11,7,177,433,92,116,0,0
1134,229,326,399,745,13,11,7,170,419,93,116,0,0
1135,214,330,380,733,13,11,7,166,403,94,116,0,0
1136,184,328,347,717,13,11,7,163,389,95,116,0,0
1137,148,319,308,707,13,11,7,160,388,96,116,0,0
1138,131,319,289,705,13,11,7,158,386,97,116,0,0
1139,112,308,262,682,13,11,7,150,374,98,116,0,0
1140,104,303,246,657,13,11,7,142,354,99,116,0,0
1141,96,308,234,645,13,11,7,138,337,100,116,0,0
1142,74,300,210,634,13,11,7,136,334,101,116,0,0
1143,55,302,185,627,13,11,7,130,325,102,116,0,0
1144,46,300,171,614,13,11,7,125,314,103,116,0,0
1145,37,297,153,592,13,11,7,116,295,104,116,0,0
1146,32,297,143,577,13,11,7,111,280,105,116,0,0
1147,22,295,133,570,13,11,7,111,275,106,116,0,0
1148,2,292,112,567,13,11,7,110,275,107,116,0,0
1149,0,290,96,562,13,11,7,96,272,108,116,0,0
1150,0,292,85,551,13,11,7,85,259,109,116,0,0
1151,0,287,78,547,13,11,7,78,260,110,116,0,0
1152,0,293,74,539,13,11,7,74,246,111,116,0,0
1153,0,301,66,534,13,11,7,66,233,112,116,0,0
1154,0,301,51,525,13,11,7,51,224,113,116,0,0
1155,0,293,50,524,13,11,7,50,231,114,116,0,0
1156,0,292,38,516,13,11,7,38,224,115,116,0,0
1157,0,298,41,508,13,11,7,41,210,116,116,1,0
1171,0,348,47,533,13,11,7,47,185,0,116,0,0
1172,0,352,46,534,13,11,7,46,182,1,116,0,0
1053,1601,77,1636,173,19,11,7,35,96,0,108,0,0
1054,1599,77,1634,174,19,11,7,35,97,1,108,0,0
1055,1597,74,1633,176,19,11,7,36,102,2,108,0,0
1056,1592,74,1628,176,19,11,7,36,102,3,108,0,0
1057,1591,73,1627,177,19,11,7,36,104,4,108,0,0
1063,1589,82,1627,190,19,11,7,38,108,0,108,0,1
1064,1588,77,1628,192,19,11,7,40,115,1,108,0,0
1065,1588,75,1629,193,19,11,7,41,118,2,108,0,0
1066,1587,78,1626,195,19,11,7,39,117,3,108,0,0
1067,1586,82,1624,195,19,11,7,38,113,4,108,0,0
1068,1584,82,1623,197,19,11,7,39,115,5,108,0,0
1069,1582,80,1623,199,19,11,7,41,119,6,108,0,0
1070,1580,79,1623,200,19,11,7,43,121,7,108,0,0
1071,1578,80,1623,206,19,11,7,45,126,8,108,0,0
1072,1575,82,1621,210,19,11,7,46,128,9,108,0,0
1073,1572,80,1620,210,19,11,7,48,130,10,108,0,0
1074,1569,80,1618,214,19,11,7,49,134,11,108,0,0
1075,1568,80,1616,217,19,11,7,48,137,12,108,0,0
1076,1568,78,1620,221,19,11,7,52,143,13,108,0,0
1077,1563,79,1618,227,19,11,7,55,148,14,108,0,0
1078,1559,84,1612,230,19,11,7,53,146,15,108,0,0
1079,1555,84,1609,230,19,11,7,54,146,16,108,0,0
1080,1552,86,1604,229,19,11,7,52,143,17,108,0,0
1081,1550,87,1602,231,19,11,7,52,144,18,108,0,0
1082,1549,87,1601,232,19,11,7,52,145,19,108,0,0
1083,1546,90,1600,240,19,11,7,54,150,20,108,0,0
1084,1543,91,1597,243,19,11,7,54,152,21,108,0,0
1085,1541,90,1595,243,19,11,7,54,153,22,108,0,0
1086,1538,90,1592,247,19,11,7,54,157,23,108,0,0
1087,1537,90,1592,251,19,11,7,55,161,24,108,0,0
1088,1536,90,1592,255,19,11,7,56,165,25,108,0,0
1089,1534,91,1591,262,19,11,7,57,171,26,108,0,0
1090,1534,93,1589,259,19,11,7,55,166,27,108,0,0
1091,1532,94,1587,260,19,11,7,55,166,28,108,0,0
1092,1530,95,1587,267,19,11,7,57,172,29,108,0,0
1093,1528,96,1586,270,19,11,7,58,174,30,108,0,0
1094,1525,94,1584,275,19,11,7,59,181,31,108,0,0
1095,1523,99,1581,278,19,11,7,58,179,32,108,0,0
1096,1520,101,1578,279,19,11,7,58,178,33,108,0,0
1097,1515,96,1577,287,19,11,7,62,191,34,108,0,0
1098,1511,97,1575,295,19,11,7,64,198,35,108,0,0
1099,1506,99,1571,298,19,11,7,65,199,36,108,0,0
1100,1504,100,1568,299,19,11,7,64,199,37,108,0,0
1101,1499,104,1564,305,19,11,7,65,201,38,108,0,0
1102,1496,105,1561,308,19,11,7,65,203,39,108,0,0
1103,1492,104,1560,317,19,11,7,68,213,40,108,0,0
1104,1490,106,1560,326,19,11,7,70,220,41,108,0,0
1105,1487,106,1558,329,19,11,7,71,223,42,108,0,0
1106,1484,107,1556,334,19,11,7,72,227,43,108,0,0
1107,1480,112,1553,342,19,11,7,73,230,44,108,0,0
1108,1477,111,1553,349,19,11,7,76,238,45,108,0,0
1109,1471,110,1550,359,19,11,7,79,249,46,108,0,0
1110,1468,111,1548,366,19,11,7,80,255,47,108,0,0
1111,1464,112,1546,370,19,11,7,82,258,48,108,0,0
1112,1456,114,1541,380,19,11,7,85,266,49,108,0,0
1113,1451,120,1537,393,19,11,7,86,273,50,108,0,0
1114,1444,121,1531,397,19,11,7,87,276,51,108,0,0
1115,1441,123,1521,373,19,11,7,80,250,52,108,0,0
1116,1435,130,1519,389,19,11,7,84,259,53,108,0,0
1117,1428,130,1519,413,19,11,7,91,283,54,108,0,0
1118,1420,135,1517,434,19,11,7,97,299,55,108,0,0
1119,1412,140,1511,446,19,11,7,99,306,56,108,0,0
1120,1404,137,1507,459,19,11,7,103,322,57,108,0,0
1121,1392,139,1501,478,19,11,7,109,339,58,108,0,0
1122,1388,140,1499,489,19,11,7,111,349,59,108,0,0
1123,1384,140,1498,495,19,11,7,114,355,60,108,0,0
1124,1374,151,1492,516,19,11,7,118,365,61,108,0,0
1125,1365,158,1484,529,19,11,7,119,371,62,108,0,0
1126,1347,155,1474,546,19,11,7,127,391,63,108,0,0
1127,1331,157,1468,583,19,11,7,137,426,64,108,0,0
1128,1323,162,1466,603,19,11,7,143,441,65,108,0,0
1129,1317,167,1461,611,19,11,7,144,444,66,108,0,0
1130,1298,178,1448,641,19,11,7,150,463,67,108,0,0
1131,1281,187,1433,658,19,11,7,152,471,68,108,0,0
1132,1251,188,1413,687,19,11,7,162,499,69,108,0,0
1133,1216,203,1391,737,19,11,7,175,534,70,108,0,0
1134,1191,209,1373,759,19,11,7,182,550,71,108,0,0
1135,1171,217,1355,773,19,11,7,184,556,72,108,0,0
1136,1133,242,1323,813,19,11,7,190,571,73,108,0,0
1137,1099,245,1294,832,19,11,7,195,587,74,108,0,0
1138,1039,246,1250,886,19,11,7,211,640,75,108,0,0
1139,980,250,1204,922,19,11,7,224,672,76,108,0,0
1140,929,277,1145,930,19,11,7,216,653,77,108,0,0
1141,866,286,1081,929,19,11,7,215,643,78,108,0,0
1142,809,295,1034,933,19,11,7,225,638,79,108,0,0
1143,720,293,948,925,19,11,7,228,632,80,108,0,0
1144,644,294,866,910,19,11,7,222,616,81,108,0,0
1145,596,298,821,900,19,11,7,225,602,82,108,0,0
1146,535,289,757,874,19,11,7,222,585,83,108,0,0
1147,474,283,697,859,19,11,7,223,576,84,108,0,0
1148,431,289,652,848,19,11,7,221,559,85,108,0,0
1149,385,285,590,804,19,11,7,205,519,86,108,0,0
1150,347,277,542,770,19,11,7,195,493,87,108,0,0
1151,325,277,515,749,19,11,7,190,472,88,108,0,0
1152,282,267,471,726,19,11,7,189,459,89,108,0,0
1153,241,262,425,705,19,11,7,184,443,90,108,0,0
1154,221,263,405,704,19,11,7,184,441,91,108,0,0
1155,193,254,367,675,19,11,7,174,421,92,108,0,0
1156,179,258,343,655,19,11,7,164,397,93,108,0,0
1157,166,259,326,639,19,11,7,160,380,94,108,0,0
1158,137,249,293,620,19,11,7,156,371,95,108,0,0
1159,116,249,269,613,19,11,7,153,364,96,108,0,0
1160,99,249,248,603,19,11,7,149,354,97,108,0,0
1161,81,247,221,584,19,11,7,140,337,98,108,0,0
1162,72,253,207,574,19,11,7,135,321,99,108,0,0
1163,58,263,188,566,19,11,7,130,303,100,108,0,0
1164,30,262,156,558,19,11,7,126,296,101,108,0,0
1165,15,268,137,555,19,11,7,122,287,102,108,0,0
1166,0,261,118,548,19,11,7,118,287,103,108,0,0
1167,0,259,99,538,19,11,7,99,279,104,108,0,0
1168,0,260,93,533,19,11,7,93,273,105,108,0,0
1169,0,278,81,527,19,11,7,81,249,106,108,0,0
1170,0,288,64,528,19,11,7,64,240,107,108,0,0
1171,0,292,45,520,19,11,7,45,228,108,108,1,0
1004,1649,56,1687,138,20,11,7,38,82,0,0,0,0
1007,1646,56,1691,141,21,11,7,45,85,0,0,0,0
1219,303,490,857,1050,25,11,7,554,560,0,26,0,1
1220,256,473,822,1062,25,11,7,566,589,1,26,0,0
1221,224,459,758,1033,25,11,7,534,574,2,26,0,0
1222,205,446,717,1006,25,11,7,512,560,3,26,0,0
1223,184,428,676,980,25,11,7,492,552,4,26,0,0
1224,138,419,603,962,25,11,7,465,543,5,26,0,0
1225,116,410,570,958,25,11,7,454,548,6,26,0,0
1226,96,401,519,931,25,11,7,423,530,7,26,0,0
1227,87,391,470,886,25,11,7,383,495,8,26,0,0
1228,86,390,443,862,25,11,7,357,472,9,26,0,0
1229,77,380,416,836,25,11,7,339,456,10,26,0,0
1230,49,378,363,817,25,11,7,314,439,11,26,0,0
1231,33,370,337,808,25,11,7,304,438,12,26,0,0
1232,25,359,307,780,25,11,7,282,421,13,26,0,0
1233,23,353,281,747,25,11,7,258,394,14,26,0,0
1234,22,349,269,731,25,11,7,247,382,15,26,0,0
1235,18,349,255,718,25,11,7,237,369,16,26,0,0
1236,0,345,226,704,25,11,7,226,359,17,26,0,0
1237,0,346,208,701,25,11,7,208,355,18,26,0,0
1238,0,349,190,689,25,11,7,190,340,19,26,0,0
1239,0,342,168,678,25,11,7,168,336,20,26,0,0
1240,0,354,156,667,25,11,7,156,313,21,26,0,0
1241,0,360,147,657,25,11,7,147,297,22,26,0,0
1242,0,361,131,649,25,11,7,131,288,23,26,0,0
1243,0,360,109,646,25,11,7,109,286,24,26,0,0
1244,0,355,102,644,25,11,7,102,289,25,26,0,0
1245,0,353,85,634,25,11,7,85,281,26,26,1,0
1245,1,371,43,628,26,11,7,42,257,0,1,0,0
1246,3,388,41,616,26,11,7,38,228,1,1,0,0
1274,2,263,48,494,27,11,7,46,231,0,31,0,1
1275,11,245,62,501,27,11,7,51,256,1,31,0,0
1276,11,235,66,507,27,11,7,55,272,2,31,0,0
1277,13,230,73,521,27,11,7,60,291,3,31,0,0
1278,19,235,80,519,27,11,7,61,284,4,31,0,0
1279,29,234,96,535,27,11,7,67,301,5,31,0,0
1280,42,245,114,548,27,11,7,72,303,6,31,0,0
1281,50,245,127,559,27,11,7,77,314,7,31,0,0
1282,54,243,143,587,27,11,7,89,344,8,31,0,0
1283,68,250,162,599,27,11,7,94,349,9,31,0,0
1284,92,248,196,614,27,11,7,104,366,10,31,0,0
1285,119,254,231,628,27,11,7,112,374,11,31,0,0
1286,134,245,256,645,27,11,7,122,400,12,31,0,0
1287,160,250,295,678,27,11,7,135,428,13,31,0,0
1288,180,241,327,697,27,11,7,147,456,14,31,0,0
1289,223,244,380,709,27,11,7,157,465,15,31,0,0
1290,262,254,429,728,27,11,7,167,474,16,31,0,0
1291,295,250,480,766,27,11,7,185,516,17,31,0,0
1292,345,261,546,806,27,11,7,201,545,18,31,0,0
1293,388,266,593,826,27,11,7,205,560,19,31,0,0
1294,477,281,694,841,27,11,7,217,560,20,31,0,0
1295,545,282,770,858,27,11,7,225,576,21,31,0,0
1296,614,273,874,927,27,11,7,260,654,22,31,0,0
1297,707,301,976,971,27,11,7,269,670,23,31,0,0
1298,799,307,1071,993,27,11,7,272,686,24,31,0,0
1299,907,329,1195,1027,27,11,7,288,698,25,31,0,0
1300,1037,341,1330,1052,27,11,7,293,711,26,31,0,0
1301,1188,359,1493,1064,27,11,7,305,705,27,31,0,0
1302,1336,395,1634,1071,27,11,7,298,676,28,31,0,0
1303,1494,410,1797,1079,27,11,7,303,669,29,31,0,0
1304,1605,462,1887,1076,27,11,7,282,614,30,31,0,0
1305,1690,476,1920,1080,27,11,7,230,604,31,31,1,0
1336,1719,559,1920,1068,28,11,7,201,509,0,57,0,1
1337,1653,416,1913,1073,28,11,7,260,657,1,57,0,0
1338,1559,368,1838,1068,28,11,7,279,700,2,57,0,0
1339,1495,319,1777,1027,28,11,7,282,708,3,57,0,0
1340,1420,289,1703,999,28,11,7,283,710,4,57,0,0
1341,1371,270,1645,960,28,11,7,274,690,5,57,0,0
1342,1348,249,1603,886,28,11,7,255,637,6,57,0,0
1343,1339,235,1583,843,28,11,7,244,608,7,57,0,0
1344,1342,220,1565,777,28,11,7,223,557,8,57,0,0
1345,1356,208,1562,730,28,11,7,206,522,9,57,0,0
1346,1364,198,1552,675,28,11,7,188,477,10,57,0,0
1347,1378,186,1554,636,28,11,7,176,450,11,57,0,0
1348,1390,181,1551,596,28,11,7,161,415,12,57,0,0
1349,1399,164,1557,573,28,11,7,158,409,13,57,0,0
1350,1407,155,1561,558,28,11,7,154,403,14,57,0,0
1351,1418,148,1560,524,28,11,7,142,376,15,57,0,0
1352,1424,142,1558,498,28,11,7,134,356,16,57,0,0
1353,1431,138,1554,471,28,11,7,123,333,17,57,0,0
1354,1439,128,1560,459,28,11,7,121,331,18,57,0,0
1355,1450,126,1568,449,28,11,7,118,323,19,57,0,0
1356,1458,119,1569,427,28,11,7,111,308,20,57,0,0
1357,1469,121,1571,407,28,11,7,102,286,21,57,0,0
1358,1479,119,1578,397,28,11,7,99,278,22,57,0,0
1359,1490,114,1584,384,28,11,7,94,270,23,57,0,0
1360,1499,110,1590,372,28,11,7,91,262,24,57,0,0
1361,1502,103,1590,359,28,11,7,88,256,25,57,0,0
1362,1511,103,1593,348,28,11,7,82,245,26,57,0,0
1363,1517,102,1596,339,28,11,7,79,237,27,57,0,0
1364,1519,98,1598,336,28,11,7,79,238,28,57,0,0
1365,1522,97,1596,320,28,11,7,74,223,29,57,0,0
1366,1526,95,1596,310,28,11,7,70,215,30,57,0,0
1367,1529,96,1597,308,28,11,7,68,212,31,57,0,0
1368,1533,90,1600,300,28,11,7,67,210,32,57,0,0
1369,1535,92,1600,295,28,11,7,65,203,33,57,0,0
1370,1536,89,1598,285,28,11,7,62,196,34,57,0,0
1371,1541,91,1600,278,28,11,7,59,187,35,57,0,0
1372,1545,89,1604,279,28,11,7,59,190,36,57,0,0
1373,1549,86,1607,270,28,11,7,58,184,37,57,0,0
1374,1553,88,1607,264,28,11,7,54,176,38,57,0,0
1375,1554,84,1608,262,28,11,7,54,178,39,57,0,0
1376,1559,85,1610,256,28,11,7,51,171,40,57,0,0
1377,1564,84,1615,253,28,11,7,51,169,41,57,0,0
1378,1568,79,1618,247,28,11,7,50,168,42,57,0,0
1379,1571,81,1619,242,28,11,7,48,161,43,57,0,0
1380,1575,80,1622,238,28,11,7,47,158,44,57,0,0
1381,1580,87,1624,234,28,11,7,44,147,45,57,0,0
1382,1585,87,1627,228,28,11,7,42,141,46,57,0,0
1383,1590,89,1631,226,28,11,7,41,137,47,57,0,0
1384,1592,85,1633,221,28,11,7,41,136,48,57,0,0
1385,1595,86,1635,219,28,11,7,40,133,49,57,0,0
1386,1599,85,1639,219,28,11,7,40,134,50,57,0,0
1387,1603,82,1642,213,28,11,7,39,131,51,57,0,0
1388,1606,82,1644,209,28,11,7,38,127,52,57,0,0
1389,1607,81,1645,205,28,11,7,38,124,53,57,0,0
1390,1609,78,1647,202,28,11,7,38,124,54,57,0,0
1391,1613,79,1649,200,28,11,7,36,121,55,57,0,0
1392,1617,78,1653,197,28,11,7,36,119,56,57,0,0
1393,1620,79,1655,195,28,11,7,35,116,57,57,1,0
1766,1637,81,1672,193,31,11,7,35,112,0,72,0,0
1768,1637,81,1672,197,31,11,7,35,116,0,72,0,1
1769,1635,81,1672,199,31,11,7,37,118,1,72,0,0
1770,1634,79,1671,200,31,11,7,37,121,2,72,0,0
1771,1631,74,1670,204,31,11,7,39,130,3,72,0,0
1772,1630,79,1669,205,31,11,7,39,126,4,72,0,0
1773,1631,82,1668,205,31,11,7,37,123,5,72,0,0
1774,1630,83,1669,208,31,11,7,39,125,6,72,0,0
1775,1628,82,1669,214,31,11,7,41,132,7,72,0,0
1776,1626,80,1667,214,31,11,7,41,134,8,72,0,0
1777,1624,81,1665,214,31,11,7,41,133,9,72,0,0
1778,1623,82,1665,215,31,11,7,42,133,10,72,0,0
1779,1623,84,1665,217,31,11,7,42,133,11,72,0,0
1780,1622,83,1666,221,31,11,7,44,138,12,72,0,0
1781,1623,83,1668,225,31,11,7,45,142,13,72,0,0
1782,1621,86,1667,227,31,11,7,46,141,14,72,0,0
1783,1620,87,1666,229,31,11,7,46,142,15,72,0,0
1784,1619,88,1665,231,31,11,7,46,143,16,72,0,0
1785,1619,91,1665,235,31,11,7,46,144,17,72,0,0
1786,1620,95,1665,234,31,11,7,45,139,18,72,0,0
1787,1620,95,1666,239,31,11,7,46,144,19,72,0,0
1788,1619,95,1667,244,31,11,7,48,149,20,72,0,0
1789,1618,94,1667,247,31,11,7,49,153,21,72,0,0
1790,1617,91,1668,251,31,11,7,51,160,22,72,0,0
1791,1617,93,1669,256,31,11,7,52,163,23,72,0,0
1792,1619,93,1671,257,31,11,7,52,164,24,72,0,0
1793,1621,91,1675,262,31,11,7,54,171,25,72,0,0
1794,1621,89,1678,271,31,11,7,57,182,26,72,0,0
1795,1621,90,1678,275,31,11,7,57,185,27,72,0,0
1796,1622,90,1680,277,31,11,7,58,187,28,72,0,0
1797,1622,92,1681,280,31,11,7,59,188,29,72,0,0
1798,1625,93,1684,282,31,11,7,59,189,30,72,0,0
1799,1629,93,1689,284,31,11,7,60,191,31,72,0,0
1800,1630,97,1693,296,31,11,7,63,199,32,72,0,0
1801,1631,101,1694,302,31,11,7,63,201,33,72,0,0
1802,1632,99,1696,305,31,11,7,64,206,34,72,0,0
1803,1632,100,1697,308,31,11,7,65,208,35,72,0,0
1804,1634,106,1699,312,31,11,7,65,206,36,72,0,0
1805,1638,109,1702,313,31,11,7,64,204,37,72,0,0
1806,1639,108,1706,324,31,11,7,67,216,38,72,0,0
1807,1639,112,1709,334,31,11,7,70,222,39,72,0,0
1808,1638,111,1708,339,31,11,7,70,228,40,72,0,0
1809,1636,109,1708,343,31,11,7,72,234,41,72,0,0
1810,1637,113,1711,350,31,11,7,74,237,42,72,0,0
1811,1639,117,1714,362,31,11,7,75,245,43,72,0,0
1812,1641,116,1718,366,31,11,7,77,250,44,72,0,0
1813,1639,120,1718,375,31,11,7,79,255,45,72,0,0
1814,1636,122,1717,380,31,11,7,81,258,46,72,0,0
1815,1632,119,1714,386,31,11,7,82,267,47,72,0,0
1816,1629,124,1712,394,31,11,7,83,270,48,72,0,0
1817,1628,130,1712,402,31,11,7,84,272,49,72,0,0
1818,1626,130,1712,409,31,11,7,86,279,50,72,0,0
1819,1621,133,1711,426,31,11,7,90,293,51,72,0,0
1820,1614,133,1709,439,31,11,7,95,306,52,72,0,0
1821,1607,131,1705,445,31,11,7,98,314,53,72,0,0
1822,1601,129,1702,452,31,11,7,101,323,54,72,0,0
1823,1598,137,1700,462,31,11,7,102,325,55,72,0,0
1824,1597,140,1702,475,31,11,7,105,335,56,72,0,0
1825,1594,141,1702,485,31,11,7,108,344,57,72,0,0
1826,1585,150,1698,506,31,11,7,113,356,58,72,0,0
1827,1575,153,1690,518,31,11,7,115,365,59,72,0,0
1828,1562,151,1680,522,31,11,7,118,371,60,72,0,0
1829,1550,153,1671,535,31,11,7,121,382,61,72,0,0
1830,1539,160,1668,560,31,11,7,129,400,62,72,0,0
1831,1532,161,1664,572,31,11,7,132,411,63,72,0,0
1832,1518,166,1653,584,31,11,7,135,418,64,72,0,0
1833,1496,171,1635,600,31,11,7,139,429,65,72,0,0
1834,1471,156,1619,619,31,11,7,148,463,66,72,0,0
1835,1452,154,1597,594,31,11,7,145,440,67,72,0,0
1836,1432,169,1561,535,31,11,7,129,366,68,72,0,0
1837,1419,181,1541,509,31,11,7,122,328,69,72,0,0
1838,1404,196,1514,473,31,11,7,110,277,70,72,0,0
1839,1343,200,1489,574,31,11,7,146,374,71,72,0,0
1840,1324,205,1473,586,31,11,7,149,381,72,72,1,0
1686,1,385,44,639,33,11,7,43,254,0,28,0,1
1687,15,352,65,645,33,11,7,50,293,1,28,0,0
1688,31,318,91,654,33,11,7,60,336,2,28,0,0
1689,37,303,103,660,33,11,7,66,357,3,28,0,0
1690,43,305,116,684,33,11,7,73,379,4,28,0,0
1691,48,318,127,704,33,11,7,79,386,5,28,0,0
1692,65,321,150,710,33,11,7,85,389,6,28,0,0
1693,92,325,187,724,33,11,7,95,399,7,28,0,0
1694,116,327,220,736,33,11,7,104,409,8,28,0,0
1695,118,337,238,776,33,11,7,120,439,9,28,0,0
1696,128,348,261,806,33,11,7,133,458,10,28,0,0
1697,155,359,299,821,33,11,7,144,462,11,28,0,0
1698,184,365,344,847,33,11,7,160,482,12,28,0,0
1699,205,373,378,869,33,11,7,173,496,13,28,0,0
1700,222,387,417,924,33,11,7,195,537,14,28,0,0
1701,237,404,456,975,33,11,7,219,571,15,28,0,0
1702,261,412,494,994,33,11,7,233,582,16,28,0,0
1703,304,437,554,1033,33,11,7,250,596,17,28,0,0
1704,346,459,609,1056,33,11,7,263,597,18,28,0,0
1705,386,471,664,1073,33,11,7,278,602,19,28,0,0
1706,438,506,723,1079,33,11,7,285,573,20,28,0,0
1707,513,542,804,1080,33,11,7,291,538,21,28,0,0
1708,588,575,882,1080,33,11,7,294,505,22,28,0,0
1709,703,629,981,1079,33,11,7,278,450,23,28,0,0
1710,802,653,1079,1079,33,11,7,277,426,24,28,0,0
1711,935,705,1194,1078,33,11,7,259,373,25,28,0,0
1712,1078,756,1305,1071,33,11,7,227,315,26,28,0,0
1713,1249,776,1471,1076,33,11,7,222,300,27,28,0,0
1714,1348,804,1556,1080,33,11,7,208,276,28,28,1,0
1764,1636,534,1906,1029,36,11,7,270,495,0,70,0,1
1765,1530,520,1831,1073,36,11,7,301,553,1,70,0,0
1766,1433,492,1747,1071,36,11,7,314,579,2,70,0,0
1767,1339,469,1663,1068,36,11,7,324,599,3,70,0,0
1768,1259,449,1585,1056,36,11,7,326,607,4,70,0,0
1769,1151,428,1494,1071,36,11,7,343,643,5,70,0,0
1770,1074,414,1421,1069,36,11,7,347,655,6,70,0,0
1771,1022,400,1371,1073,36,11,7,349,673,7,70,0,0
1772,989,389,1338,1071,36,11,7,349,682,8,70,0,0
1773,971,382,1320,1072,36,11,7,349,690,9,70,0,0
1774,951,366,1303,1073,36,11,7,352,707,10,70,0,0
1775,924,344,1276,1067,36,11,7,352,723,11,70,0,0
1776,909,327,1258,1068,36,11,7,349,741,12,70,0,0
1777,889,322,1225,1060,36,11,7,336,738,13,70,0,0
1778,894,321,1209,1031,36,11,7,315,710,14,70,0,0
1779,899,312,1211,1036,36,11,7,312,724,15,70,0,0
1780,918,310,1216,1022,36,11,7,298,712,16,70,0,0
1781,954,306,1231,981,36,11,7,277,675,17,70,0,0
1782,978,285,1253,961,36,11,7,275,676,18,70,0,0
1783,996,280,1264,942,36,11,7,268,662,19,70,0,0
1784,1043,271,1301,908,36,11,7,258,637,20,70,0,0
1785,1075,263,1321,863,36,11,7,246,600,21,70,0,0
1786,1106,260,1341,827,36,11,7,235,567,22,70,0,0
1787,1133,249,1361,801,36,11,7,228,552,23,70,0,0
1788,1173,233,1393,764,36,11,7,220,531,24,70,0,0
1789,1213,223,1428,739,36,11,7,215,516,25,70,0,0
1790,1243,209,1447,694,36,11,7,204,485,26,70,0,0
1791,1261,195,1454,660,36,11,7,193,465,27,70,0,0
1792,1282,189,1470,643,36,11,7,188,454,28,70,0,0
1793,1318,176,1501,618,36,11,7,183,442,29,70,0,0
1794,1341,177,1521,606,36,11,7,180,429,30,70,0,0
1795,1363,169,1531,577,36,11,7,168,408,31,70,0,0
1796,1370,166,1525,543,36,11,7,155,377,32,70,0,0
1797,1389,166,1534,524,36,11,7,145,358,33,70,0,0
1798,1409,157,1552,506,36,11,7,143,349,34,70,0,0
1799,1428,152,1567,494,36,11,7,139,342,35,70,0,0
1800,1437,149,1572,480,36,11,7,135,331,36,70,0,0
1801,1443,140,1573,460,36,11,7,130,320,37,70,0,0
1802,1450,140,1574,448,36,11,7,124,308,38,70,0,0
1803,1461,135,1577,429,36,11,7,116,294,39,70,0,0
1804,1459,130,1573,424,36,11,7,114,294,40,70,0,0
1805,1462,126,1570,412,36,11,7,108,286,41,70,0,0
1806,1466,124,1573,407,36,11,7,107,283,42,70,0,0
1807,1467,124,1571,405,36,11,7,104,281,43,70,0,0
1808,1463,119,1566,398,36,11,7,103,279,44,70,0,0
1809,1468,118,1565,387,36,11,7,97,269,45,70,0,0
1810,1462,120,1557,381,36,11,7,95,261,46,70,0,0
1811,1462,117,1554,377,36,11,7,92,260,47,70,0,0
1812,1462,114,1556,384,36,11,7,94,270,48,70,0,0
1813,1471,113,1561,376,36,11,7,90,263,49,70,0,0
1814,1475,114,1560,368,36,11,7,85,254,50,70,0,0
1815,1474,113,1559,366,36,11,7,85,253,51,70,0,0
1816,1467,111,1554,375,36,11,7,87,264,52,70,0,0
1817,1468,111,1551,371,36,11,7,83,260,53,70,0,0
1818,1465,105,1547,368,36,11,7,82,263,54,70,0,0
1819,1468,111,1537,336,36,11,7,69,225,55,70,0,0
1820,1470,109,1544,355,36,11,7,74,246,56,70,0,0
1821,1482,110,1541,306,36,11,7,59,196,57,70,0,0
1822,1487,111,1540,287,36,11,7,53,176,58,70,0,0
1823,1478,105,1548,344,36,11,7,70,239,59,70,0,0
1824,1477,107,1548,352,36,11,7,71,245,60,70,0,0
1825,1478,110,1547,349,36,11,7,69,239,61,70,0,0
1826,1477,109,1548,356,36,11,7,71,247,62,70,0,0
1827,1476,110,1548,364,36,11,7,72,254,63,70,0,0
1828,1478,108,1549,360,36,11,7,71,252,64,70,0,0
1829,1486,111,1558,366,36,11,7,72,255,65,70,0,0
1830,1500,114,1569,356,36,11,7,69,242,66,70,0,0
1831,1514,116,1579,336,36,11,7,65,220,67,70,0,0
1832,1516,117,1580,320,36,11,7,64,203,68,70,0,0
1833,1528,118,1582,278,36,11,7,54,160,69,70,0,0
1834,1550,119,1590,225,36,11,7,40,106,70,70,1,0
1788,1,764,108,1080,37,11,7,107,316,0,0,0,0
1789,47,693,300,1071,38,11,7,253,378,0,0,0,0
1790,162,607,481,1075,39,11,7,319,468,0,0,0,0
1795,543,358,1255,1075,40,11,7,712,717,0,3,0,0
1796,597,312,1332,1072,40,11,7,735,760,1,3,0,0
1797,673,286,1395,1054,40,11,7,722,768,2,3,0,0
1798,722,251,1474,1051,40,11,7,752,800,3,3,0,0
1798,947,273,1200,934,41,11,7,253,661,0,86,0,1
1799,966,254,1220,922,41,11,7,254,668,1,86,0,0
1800,1008,246,1244,866,41,11,7,236,620,2,86,0,0
1801,1062,224,1284,805,41,11,7,222,581,3,86,0,0
1802,1083,220,1299,784,41,11,7,216,564,4,86,0,0
1803,1121,203,1317,715,41,11,7,196,512,5,86,0,0
1804,1152,187,1342,679,41,11,7,190,492,6,86,0,0
1805,1198,156,1387,639,41,11,7,189,483,7,86,0,0
1806,1214,143,1404,623,41,11,7,190,480,8,86,0,0
1807,1232,144,1418,608,41,11,7,186,464,9,86,0,0
1808,1252,145,1441,609,41,11,7,189,464,10,86,0,0
1809,1270,147,1449,573,41,11,7,179,426,11,86,0,0
1810,1267,146,1443,569,41,11,7,176,423,12,86,0,0
1811,1278,150,1446,551,41,11,7,168,401,13,86,0,0
1812,1278,150,1439,541,41,11,7,161,391,14,86,0,0
1813,1287,148,1444,531,41,11,7,157,383,15,86,0,0
1814,1300,147,1457,529,41,11,7,157,382,16,86,0,0
1815,1286,141,1440,522,41,11,7,154,381,17,86,0,0
1816,1286,136,1435,508,41,11,7,149,372,18,86,0,0
1817,1287,136,1432,505,41,11,7,145,369,19,86,0,0
1818,1287,132,1431,505,41,11,7,144,373,20,86,0,0
1819,1287,132,1426,501,41,11,7,139,369,21,86,0,0
1820,1284,130,1422,502,41,11,7,138,372,22,86,0,0
1821,1284,134,1418,502,41,11,7,134,368,23,86,0,0
1822,1283,132,1417,505,41,11,7,134,373,24,86,0,0
1823,1283,133,1415,504,41,11,7,132,371,25,86,0,0
1824,1284,133,1415,504,41,11,7,131,371,26,86,0,0
1825,1285,132,1415,508,41,11,7,130,376,27,86,0,0
1826,1286,134,1414,508,41,11,7,128,374,28,86,0,0
1827,1284,137,1408,503,41,11,7,124,366,29,86,0,0
1828,1283,142,1397,484,41,11,7,114,342,30,86,0,0
1829,1284,148,1396,491,41,11,7,112,343,31,86,0,0
1830,1282,151,1393,496,41,11,7,111,345,32,86,0,0
1831,1281,156,1388,491,41,11,7,107,335,33,86,0,0
1832,1277,159,1382,491,41,11,7,105,332,34,86,0,0
1833,1277,159,1384,499,41,11,7,107,340,35,86,0,0
1834,1277,157,1388,514,41,11,7,111,357,36,86,0,0
1835,1276,156,1387,514,41,11,7,111,358,37,86,0,0
1836,1273,156,1385,519,41,11,7,112,363,38,86,0,0
1837,1269,160,1379,518,41,11,7,110,358,39,86,0,0
1838,1267,157,1382,535,41,11,7,115,378,40,86,0,0
1839,1249,155,1399,660,41,11,7,150,505,41,86,0,0
1840,1254,169,1415,712,41,11,7,161,543,42,86,0,0
1841,1230,169,1401,743,41,11,7,171,574,43,86,0,0
1842,1177,191,1360,791,41,11,7,183,600,44,86,0,0
1843,1126,218,1319,829,41,11,7,193,611,45,86,0,0
1844,1079,227,1271,839,41,11,7,192,612,46,86,0,0
1845,993,237,1188,842,41,11,7,195,605,47,86,0,0
1846,936,244,1142,849,41,11,7,206,605,48,86,0,0
1847,867,239,1083,864,41,11,7,216,625,49,86,0,0
1848,770,246,989,882,41,11,7,219,636,50,86,0,0
1849,689,259,912,870,41,11,7,223,611,51,86,0,0
1850,617,278,836,866,41,11,7,219,588,52,86,0,0
1851,519,279,732,858,41,11,7,213,579,53,86,0,0
1852,452,279,672,856,41,11,7,220,577,54,86,0,0
1853,397,273,619,842,41,11,7,222,569,55,86,0,0
1854,332,263,548,829,41,11,7,216,566,56,86,0,0
1855,301,270,505,798,41,11,7,204,528,57,86,0,0
1856,269,268,473,782,41,11,7,204,514,58,86,0,0
1857,214,268,409,761,41,11,7,195,493,59,86,0,0
1858,169,271,361,754,41,11,7,192,483,60,86,0,0
1859,143,270,334,745,41,11,7,191,475,61,86,0,0
1860,116,261,302,729,41,11,7,186,468,62,86,0,0
1861,105,250,279,697,41,11,7,174,447,63,86,0,0
1862,101,254,266,683,41,11,7,165,429,64,86,0,0
1863,93,256,251,663,41,11,7,158,407,65,86,0,0
1864,76,251,228,642,41,11,7,152,391,66,86,0,0
1865,64,252,212,632,41,11,7,148,380,67,86,0,0
1866,56,249,200,618,41,11,7,144,369,68,86,0,0
1867,43,244,183,611,41,11,7,140,367,69,86,0,0
1868,39,244,170,595,41,11,7,131,351,70,86,0,0
1869,38,251,161,580,41,11,7,123,329,71,86,0,0
1870,31,246,152,567,41,11,7,121,321,72,86,0,0
1871,18,243,134,554,41,11,7,116,311,73,86,0,0
1872,10,240,124,549,41,11,7,114,309,74,86,0,0
1873,2,235,114,540,41,11,7,112,305,75,86,0,0
1874,0,228,107,531,41,11,7,107,303,76,86,0,0
1875,0,228,102,522,41,11,7,102,294,77,86,0,0
1876,0,232,99,520,41,11,7,99,288,78,86,0,0
1877,0,229,89,509,41,11,7,89,280,79,86,0,0
1878,0,230,79,505,41,11,7,79,275,80,86,0,0
1879,0,239,70,500,41,11,7,70,261,81,86,0,0
1880,0,230,64,498,41,11,7,64,268,82,86,0,0
1881,0,230,57,489,41,11,7,57,259,83,86,0,0
1882,0,249,53,483,41,11,7,53,234,84,86,0,0
1883,0,265,48,478,41,11,7,48,213,85,86,0,0
1884,0,269,40,471,41,11,7,40,202,86,86,1,0
1831,1682,542,1904,1071,42,11,7,222,529,0,70,0,1
1832,1633,533,1863,1078,42,11,7,230,545,1,70,0,0
1833,1525,484,1778,1073,42,11,7,253,589,2,70,0,0
1834,1464,422,1740,1059,42,11,7,276,637,3,70,0,0
1835,1506,377,1761,970,42,11,7,255,593,4,70,0,0
1836,1484,350,1754,984,42,11,7,270,634,5,70,0,0
1837,1473,332,1727,933,42,11,7,254,601,6,70,0,0
1838,1467,319,1714,907,42,11,7,247,588,7,70,0,0
1839,1483,305,1710,851,42,11,7,227,546,8,70,0,0
1840,1501,292,1720,829,42,11,7,219,537,9,70,0,0
1841,1511,281,1728,825,42,11,7,217,544,10,70,0,0
1842,1527,271,1722,768,42,11,7,195,497,11,70,0,0
1843,1536,255,1721,738,42,11,7,185,483,12,70,0,0
1844,1549,243,1717,686,42,11,7,168,443,13,70,0,0
1845,1553,227,1716,663,42,11,7,163,436,14,70,0,0
1846,1557,224,1712,647,42,11,7,155,423,15,70,0,0
1847,1561,215,1704,611,42,11,7,143,396,16,70,0,0
1848,1564,203,1701,585,42,11,7,137,382,17,70,0,0
1849,1565,199,1699,576,42,11,7,134,377,18,70,0,0
1850,1567,187,1695,549,42,11,7,128,362,19,70,0,0
1851,1574,188,1691,523,42,11,7,117,335,20,70,0,0
1852,1573,175,1686,503,42,11,7,113,328,21,70,0,0
1853,1576,171,1683,482,42,11,7,107,311,22,70,0,0
1854,1581,172,1682,465,42,11,7,101,293,23,70,0,0
1855,1581,169,1678,455,42,11,7,97,286,24,70,0,0
1856,1580,170,1673,448,42,11,7,93,278,25,70,0,0
1857,1583,164,1670,428,42,11,7,87,264,26,70,0,0
1858,1587,156,1675,420,42,11,7,88,264,27,70,0,0
1859,1575,125,1673,414,42,11,7,98,289,28,70,0,0
1860,1585,137,1675,409,42,11,7,90,272,29,70,0,0
1861,1594,140,1679,401,42,11,7,85,261,30,70,0,0
1862,1600,145,1678,386,42,11,7,78,241,31,70,0,0
1863,1604,141,1681,383,42,11,7,77,242,32,70,0,0
1864,1608,137,1683,372,42,11,7,75,235,33,70,0,0
1865,1611,133,1684,362,42,11,7,73,229,34,70,0,0
1866,1613,133,1684,357,42,11,7,71,224,35,70,0,0
1867,1617,134,1681,339,42,11,7,64,205,36,70,0,0
1868,1618,129,1683,337,42,11,7,65,208,37,70,0,0
1869,1622,131,1685,332,42,11,7,63,201,38,70,0,0
1870,1624,125,1687,327,42,11,7,63,202,39,70,0,0
1871,1624,120,1687,324,42,11,7,63,204,40,70,0,0
1872,1626,119,1686,315,42,11,7,60,196,41,70,0,0
1873,1627,118,1686,310,42,11,7,59,192,42,70,0,0
1874,1629,119,1687,305,42,11,7,58,186,43,70,0,0
1875,1628,117,1685,300,42,11,7,57,183,44,70,0,0
1876,1630,128,1682,294,42,11,7,52,166,45,70,0,0
1877,1630,125,1681,292,42,11,7,51,167,46,70,0,0
1878,1630,124,1679,280,42,11,7,49,156,47,70,0,0
1879,1630,124,1679,282,42,11,7,49,158,48,70,0,0
1880,1631,123,1679,277,42,11,7,48,154,49,70,0,0
1881,1628,100,1683,276,42,11,7,55,176,50,70,0,0
1882,1628,98,1682,274,42,11,7,54,176,51,70,0,0
1883,1628,97,1680,265,42,11,7,52,168,52,70,0,0
1884,1631,110,1678,262,42,11,7,47,152,53,70,0,0
1885,1629,99,1678,262,42,11,7,49,163,54,70,0,0
1886,1628,90,1677,254,42,11,7,49,164,55,70,0,0
1887,1627,88,1676,249,42,11,7,49,161,56,70,0,0
1888,1629,89,1675,242,42,11,7,46,153,57,70,0,0
1889,1629,92,1673,239,42,11,7,44,147,58,70,0,0
1890,1627,89,1672,239,42,11,7,45,150,59,70,0,0
1891,1629,85,1675,237,42,11,7,46,152,60,70,0,0
1892,1630,87,1674,235,42,11,7,44,148,61,70,0,0
1893,1633,87,1676,232,42,11,7,43,145,62,70,0,0
1894,1634,89,1676,231,42,11,7,42,142,63,70,0,0
1895,1637,89,1678,230,42,11,7,41,141,64,70,0,0
1896,1641,88,1681,226,42,11,7,40,138,65,70,0,0
1897,1642,85,1682,225,42,11,7,40,140,66,70,0,0
1898,1646,91,1682,219,42,11,7,36,128,67,70,0,0
1899,1648,91,1684,218,42,11,7,36,127,68,70,0,0
1900,1648,91,1684,216,42,11,7,36,125,69,70,0,0
1901,1649,90,1684,212,42,11,7,35,122,70,70,1,0
1833,1703,407,1828,727,43,11,7,125,320,0,0,0,0
1835,1550,119,1616,290,44,11,7,66,171,0,13,0,0
1836,1546,112,1626,319,44,11,7,80,207,1,13,0,0
1837,1548,111,1632,326,44,11,7,84,215,2,13,0,0
1838,1551,120,1630,324,44,11,7,79,204,3,13,0,0
1839,1556,116,1634,317,44,11,7,78,201,4,13,0,0
1840,1558,112,1639,320,44,11,7,81,208,5,13,0,0
1841,1561,111,1639,310,44,11,7,78,199,6,13,0,0
1842,1561,108,1637,298,44,11,7,76,190,7,13,0,0
1843,1562,102,1639,294,44,11,7,77,192,8,13,0,0
1844,1563,100,1641,291,44,11,7,78,191,9,13,0,0
1845,1564,102,1641,286,44,11,7,77,184,10,13,0,0
1846,1566,100,1642,283,44,11,7,76,183,11,13,0,0
1847,1571,99,1644,273,44,11,7,73,174,12,13,0,0
1848,1574,98,1645,269,44,11,7,71,171,13,13,0,0
1835,1311,251,1633,1019,45,11,7,322,768,0,71,0,1
1836,1314,384,1578,1012,45,11,7,264,628,1,71,0,0
1837,1286,364,1552,998,45,11,7,266,634,2,71,0,0
1838,1284,341,1549,975,45,11,7,265,634,3,71,0,0
1839,1318,323,1556,892,45,11,7,238,569,4,71,0,0
1840,1351,303,1581,858,45,11,7,230,555,5,71,0,0
1841,1366,291,1591,843,45,11,7,225,552,6,71,0,0
1842,1385,266,1590,775,45,11,7,205,509,7,71,0,0
1843,1399,263,1589,740,45,11,7,190,477,8,71,0,0
1844,1414,250,1588,692,45,11,7,174,442,9,71,0,0
1845,1420,228,1593,672,45,11,7,173,444,10,71,0,0
1846,1423,216,1593,660,45,11,7,170,444,11,71,0,0
1847,1432,206,1587,613,45,11,7,155,407,12,71,0,0
1848,1439,203,1584,589,45,11,7,145,386,13,71,0,0
1849,1454,197,1588,557,45,11,7,134,360,14,71,0,0
1850,1463,180,1597,544,45,11,7,134,364,15,71,0,0
1851,1471,173,1602,535,45,11,7,131,362,16,71,0,0
1852,1477,166,1600,508,45,11,7,123,342,17,71,0,0
1853,1487,167,1602,493,45,11,7,115,326,18,71,0,0
1854,1495,169,1604,482,45,11,7,109,313,19,71,0,0
1855,1508,175,1609,464,45,11,7,101,289,20,71,0,0
1856,1513,170,1613,456,45,11,7,100,286,21,71,0,0
1857,1519,151,1618,437,45,11,7,99,286,22,71,0,0
1858,1525,140,1623,428,45,11,7,98,288,23,71,0,0
1859,1529,139,1623,420,45,11,7,94,281,24,71,0,0
1860,1536,138,1625,405,45,11,7,89,267,25,71,0,0
1861,1542,142,1626,397,45,11,7,84,255,26,71,0,0
1862,1545,145,1623,380,45,11,7,78,235,27,71,0,0
1863,1547,136,1624,373,45,11,7,77,237,28,71,0,0
1864,1552,136,1627,367,45,11,7,75,231,29,71,0,0
1865,1553,130,1628,360,45,11,7,75,230,30,71,0,0
1866,1555,129,1629,355,45,11,7,74,226,31,71,0,0
1867,1562,123,1635,341,45,11,7,73,218,32,71,0,0
1868,1561,130,1628,336,45,11,7,67,206,33,71,0,0
1869,1561,129,1628,333,45,11,7,67,204,34,71,0,0
1870,1562,125,1627,325,45,11,7,65,200,35,71,0,0
1871,1561,125,1625,322,45,11,7,64,197,36,71,0,0
1872,1563,127,1623,313,45,11,7,60,186,37,71,0,0
1873,1566,128,1624,305,45,11,7,58,177,38,71,0,0
1874,1567,128,1623,301,45,11,7,56,173,39,71,0,0
1875,1569,117,1627,297,45,11,7,58,180,40,71,0,0
1876,1572,122,1627,293,45,11,7,55,171,41,71,0,0
1877,1573,122,1626,286,45,11,7,53,164,42,71,0,0
1878,1572,121,1624,281,45,11,7,52,160,43,71,0,0
1879,1575,119,1625,274,45,11,7,50,155,44,71,0,0
1880,1577,118,1627,270,45,11,7,50,152,45,71,0,0
1881,1580,116,1629,266,45,11,7,49,150,46,71,0,0
1882,1581,110,1630,263,45,11,7,49,153,47,71,0,0
1883,1582,106,1630,260,45,11,7,48,154,48,71,0,0
1884,1584,110,1630,257,45,11,7,46,147,49,71,0,0
1885,1586,109,1632,252,45,11,7,46,143,50,71,0,0
1886,1588,106,1633,247,45,11,7,45,141,51,71,0,0
1887,1589,98,1636,246,45,11,7,47,148,52,71,0,0
1888,1592,100,1636,241,45,11,7,44,141,53,71,0,0
1889,1593,104,1636,238,45,11,7,43,134,54,71,0,0
1890,1598,104,1640,238,45,11,7,42,134,55,71,0,0
1891,1603,109,1642,231,45,11,7,39,122,56,71,0,0
1892,1607,111,1644,229,45,11,7,37,118,57,71,0,0
1893,1608,108,1644,225,45,11,7,36,117,58,71,0,0
1894,1608,108,1644,224,45,11,7,36,116,59,71,0,0
1895,1609,106,1646,224,45,11,7,37,118,60,71,0,0
1896,1611,99,1649,222,45,11,7,38,123,61,71,0,0
1897,1611,98,1649,220,45,11,7,38,122,62,71,0,0
1898,1611,98,1647,217,45,11,7,36,119,63,71,0,0
1899,1610,94,1646,215,45,11,7,36,121,64,71,0,0
1900,1610,96,1645,212,45,11,7,35,116,65,71,0,0
1901,1611,95,1646,210,45,11,7,35,115,66,71,0,0
1903,1613,87,1649,205,45,11,7,36,118,0,71,0,0
1904,1612,82,1649,204,45,11,7,37,122,1,71,0,0
1905,1613,85,1648,200,45,11,7,35,115,2,71,0,0
2036,1662,45,1701,156,45,11,7,39,111,0,71,0,0
2037,1663,48,1699,155,45,11,7,36,107,1,71,0,0
2038,1664,49,1699,154,45,11,7,35,105,2,71,0,0
2039,1665,51,1700,158,45,11,7,35,107,3,71,0,0
2040,1665,51,1700,159,45,11,7,35,108,4,71,0,0
2041,1664,45,1700,160,45,11,7,36,115,5,71,0,0
2042,1664,45,1700,161,45,11,7,36,116,6,71,0,0
2043,1665,45,1700,161,45,11,7,35,116,7,71,0,0
2045,1664,50,1699,165,45,11,7,35,115,0,71,0,0
2046,1662,40,1699,167,45,11,7,37,127,1,71,0,0
2047,1662,40,1699,168,45,11,7,37,128,2,71,0,0
2048,1662,41,1699,166,45,11,7,37,125,3,71,0,0
2049,1662,47,1697,170,45,11,7,35,123,4,71,0,0
2050,1662,47,1697,171,45,11,7,35,124,5,71,0,0
2061,1665,78,1700,203,45,11,7,35,125,0,71,0,0
2062,1665,77,1701,202,45,11,7,36,125,1,71,0,0
2065,1662,79,1698,204,45,11,7,36,125,0,71,0,1
2066,1659,84,1695,209,45,11,7,36,125,1,71,0,0
2067,1656,87,1693,213,45,11,7,37,126,2,71,0,0
2068,1655,90,1691,214,45,11,7,36,124,3,71,0,0
2069,1652,88,1690,218,45,11,7,38,130,4,71,0,0
2070,1649,88,1689,225,45,11,7,40,137,5,71,0,0
2071,1645,92,1685,229,45,11,7,40,137,6,71,0,0
2072,1642,93,1683,232,45,11,7,41,139,7,71,0,0
2073,1642,92,1683,233,45,11,7,41,141,8,71,0,0
2074,1640,92,1683,237,45,11,7,43,145,9,71,0,0
2075,1639,94,1682,241,45,11,7,43,147,10,71,0,0
2076,1637,93,1682,244,45,11,7,45,151,11,71,0,0
2077,1636,91,1682,247,45,11,7,46,156,12,71,0,0
2078,1637,95,1684,251,45,11,7,47,156,13,71,0,0
2079,1638,95,1686,256,45,11,7,48,161,14,71,0,0
2080,1638,100,1688,265,45,11,7,50,165,15,71,0,0
2081,1636,98,1689,272,45,11,7,53,174,16,71,0,0
2082,1635,96,1689,276,45,11,7,54,180,17,71,0,0
2083,1636,98,1690,280,45,11,7,54,182,18,71,0,0
2084,1637,101,1692,283,45,11,7,55,182,19,71,0,0
2085,1637,106,1693,291,45,11,7,56,185,20,71,0,0
2086,1636,107,1694,296,45,11,7,58,189,21,71,0,0
2087,1635,109,1693,302,45,11,7,58,193,22,71,0,0
2088,1634,112,1694,309,45,11,7,60,197,23,71,0,0
2089,1638,113,1700,319,45,11,7,62,206,24,71,0,0
2090,1639,115,1703,326,45,11,7,64,211,25,71,0,0
2091,1639,119,1703,333,45,11,7,64,214,26,71,0,0
2092,1636,120,1703,341,45,11,7,67,221,27,71,0,0
2093,1635,122,1704,350,45,11,7,69,228,28,71,0,0
2094,1638,126,1709,364,45,11,7,71,238,29,71,0,0
2095,1638,126,1712,371,45,11,7,74,245,30,71,0,0
2096,1637,133,1713,386,45,11,7,76,253,31,71,0,0
2097,1634,135,1713,397,45,11,7,79,262,32,71,0,0
2098,1634,138,1713,406,45,11,7,79,268,33,71,0,0
2099,1632,144,1714,421,45,11,7,82,277,34,71,0,0
2100,1630,146,1713,427,45,11,7,83,281,35,71,0,0
2101,1624,152,1710,441,45,11,7,86,289,36,71,0,0
2102,1616,154,1706,458,45,11,7,90,304,37,71,0,0
2103,1611,155,1705,474,45,11,7,94,319,38,71,0,0
2104,1605,164,1702,494,45,11,7,97,330,39,71,0,0
2105,1596,168,1696,505,45,11,7,100,337,40,71,0,0
2106,1575,171,1685,532,45,11,7,110,361,41,71,0,0
2107,1559,168,1675,553,45,11,7,116,385,42,71,0,0
2108,1544,167,1664,571,45,11,7,120,404,43,71,0,0
2109,1525,167,1655,607,45,11,7,130,440,44,71,0,0
2110,1506,171,1642,630,45,11,7,136,459,45,71,0,0
2111,1463,191,1608,665,45,11,7,145,474,46,71,0,0
2112,1430,208,1577,686,45,11,7,147,478,47,71,0,0
2113,1393,215,1547,714,45,11,7,154,499,48,71,0,0
2114,1344,230,1514,765,45,11,7,170,535,49,71,0,0
2115,1294,235,1470,792,45,11,7,176,557,50,71,0,0
2116,1188,219,1384,815,45,11,7,196,596,51,71,0,0
2117,1109,242,1315,833,45,11,7,206,591,52,71,0,0
2118,1005,258,1210,862,45,11,7,205,604,53,71,0,0
2119,895,272,1114,877,45,11,7,219,605,54,71,0,0
2120,786,281,1007,891,45,11,7,221,610,55,71,0,0
2121,663,281,891,895,45,11,7,228,614,56,71,0,0
2122,553,289,791,889,45,11,7,238,600,57,71,0,0
2123,455,290,680,867,45,11,7,225,577,58,71,0,0
2124,392,296,610,839,45,11,7,218,543,59,71,0,0
2125,324,305,533,815,45,11,7,209,510,60,71,0,0
2126,239,303,445,803,45,11,7,206,500,61,71,0,0
2127,185,309,390,796,45,11,7,205,487,62,71,0,0
2128,128,300,321,763,45,11,7,193,463,63,71,0,0
2129,97,300,280,738,45,11,7,183,438,64,71,0,0
2130,65,299,244,720,45,11,7,179,421,65,71,0,0
2131,13,295,186,706,45,11,7,173,411,66,71,0,0
2132,0,299,155,691,45,11,7,155,392,67,71,0,0
2133,0,297,121,673,45,11,7,121,376,68,71,0,0
2134,0,294,107,655,45,11,7,107,361,69,71,0,0
2135,0,318,90,635,45,11,7,90,317,70,71,0,0
2136,0,331,63,616,45,11,7,63,285,71,71,1,0
1840,1280,160,1384,346,46,11,7,104,186,0,0,0,0
1842,1279,171,1375,334,48,11,7,96,163,0,244,0,1
1843,1226,166,1427,511,48,11,7,201,345,1,244,0,0
1844,1219,166,1436,543,48,11,7,217,377,2,244,0,0
1845,1222,166,1438,549,48,11,7,216,383,3,244,0,0
1846,1225,163,1438,551,48,11,7,213,388,4,244,0,0
1847,1227,161,1436,551,48,11,7,209,390,5,244,0,0
1848,1230,160,1433,549,48,11,7,203,389,6,244,0,0
1849,1233,160,1429,548,48,11,7,196,388,7,244,0,0
1850,1235,158,1425,546,48,11,7,190,388,8,244,0,0
1851,1238,160,1420,544,48,11,7,182,384,9,244,0,0
1852,1241,162,1416,543,48,11,7,175,381,10,244,0,0
1853,1244,161,1413,542,48,11,7,169,381,11,244,0,0
1854,1247,161,1411,542,48,11,7,164,381,12,244,0,0
1855,1249,160,1408,540,48,11,7,159,380,13,244,0,0
1856,1252,161,1405,538,48,11,7,153,377,14,244,0,0
1857,1254,160,1403,537,48,11,7,149,377,15,244,0,0
1858,1256,159,1401,536,48,11,7,145,377,16,244,0,0
1859,1258,159,1399,536,48,11,7,141,377,17,244,0,0
1860,1259,159,1398,536,48,11,7,139,377,18,244,0,0
1861,1263,160,1397,535,48,11,7,134,375,19,244,0,0
1862,1264,159,1396,534,48,11,7,132,375,20,244,0,0
1863,1266,159,1394,533,48,11,7,128,374,21,244,0,0
1864,1267,159,1393,532,48,11,7,126,373,22,244,0,0
1865,1269,159,1394,532,48,11,7,125,373,23,244,0,0
1866,1268,162,1390,531,48,11,7,122,369,24,244,0,0
1867,1269,164,1388,531,48,11,7,119,367,25,244,0,0
1868,1271,164,1389,532,48,11,7,118,368,26,244,0,0
1869,1272,164,1388,532,48,11,7,116,368,27,244,0,0
1870,1273,164,1389,532,48,11,7,116,368,28,244,0,0
1871,1274,165,1388,533,48,11,7,114,368,29,244,0,0
1872,1275,165,1387,533,48,11,7,112,368,30,244,0,0
1873,1275,165,1387,534,48,11,7,112,369,31,244,0,0
1874,1275,164,1386,533,48,11,7,111,369,32,244,0,0
1875,1276,164,1386,533,48,11,7,110,369,33,244,0,0
1876,1276,163,1386,532,48,11,7,110,369,34,244,0,0
1877,1277,163,1385,531,48,11,7,108,368,35,244,0,0
1878,1277,163,1384,531,48,11,7,107,368,36,244,0,0
1879,1277,163,1384,531,48,11,7,107,368,37,244,0,0
1880,1277,163,1383,530,48,11,7,106,367,38,244,0,0
1881,1279,161,1385,531,48,11,7,106,370,39,244,0,0
1882,1279,160,1385,531,48,11,7,106,371,40,244,0,0
1883,1279,159,1385,531,48,11,7,106,372,41,244,0,0
1884,1279,159,1385,532,48,11,7,106,373,42,244,0,0
1885,1279,162,1383,530,48,11,7,104,368,43,244,0,0
1886,1279,164,1383,532,48,11,7,104,368,44,244,0,0
1887,1279,163,1382,533,48,11,7,103,370,45,244,0,0
1888,1278,163,1381,533,48,11,7,103,370,46,244,0,0
1889,1277,163,1380,531,48,11,7,103,368,47,244,0,0
1890,1277,162,1380,531,48,11,7,103,369,48,244,0,0
1891,1279,159,1383,529,48,11,7,104,370,49,244,0,0
1892,1280,158,1385,529,48,11,7,105,371,50,244,0,0
1893,1281,157,1386,529,48,11,7,105,372,51,244,0,0
1894,1280,156,1386,529,48,11,7,106,373,52,244,0,0
1895,1280,156,1386,529,48,11,7,106,373,53,244,0,0
1896,1278,158,1384,531,48,11,7,106,373,54,244,0,0
1897,1277,159,1383,530,48,11,7,106,371,55,244,0,0
1898,1277,157,1383,531,48,11,7,106,374,56,244,0,0
1899,1279,158,1384,532,48,11,7,105,374,57,244,0,0
1900,1279,161,1383,532,48,11,7,104,371,58,244,0,0
1901,1280,162,1385,532,48,11,7,105,370,59,244,0,0
1902,1281,162,1385,532,48,11,7,104,370,60,244,0,0
1903,1281,162,1384,530,48,11,7,103,368,61,244,0,0
1904,1280,162,1383,529,48,11,7,103,367,62,244,0,0
1905,1280,162,1384,531,48,11,7,104,369,63,244,0,0
1906,1280,162,1383,531,48,11,7,103,369,64,244,0,0
1907,1280,162,1383,530,48,11,7,103,368,65,244,0,0
1908,1280,161,1383,530,48,11,7,103,369,66,244,0,0
1909,1280,161,1382,529,48,11,7,102,368,67,244,0,0
1910,1280,161,1382,529,48,11,7,102,368,68,244,0,0
1911,1279,161,1382,530,48,11,7,103,369,69,244,0,0
1912,1279,160,1382,532,48,11,7,103,372,70,244,0,0
1913,1278,161,1382,532,48,11,7,104,371,71,244,0,0
1914,1278,159,1382,532,48,11,7,104,373,72,244,0,0
1915,1278,160,1381,531,48,11,7,103,371,73,244,0,0
1916,1278,160,1381,532,48,11,7,103,372,74,244,0,0
1917,1279,160,1382,532,48,11,7,103,372,75,244,0,0
1918,1279,160,1382,533,48,11,7,103,373,76,244,0,0
1919,1279,160,1382,533,48,11,7,103,373,77,244,0,0
1920,1279,160,1382,533,48,11,7,103,373,78,244,0,0
1921,1279,164,1381,533,48,11,7,102,369,79,244,0,0
1922,1280,166,1381,531,48,11,7,101,365,80,244,0,0
1923,1279,166,1381,533,48,11,7,102,367,81,244,0,0
1924,1279,166,1381,532,48,11,7,102,366,82,244,0,0
1925,1279,166,1381,533,48,11,7,102,367,83,244,0,0
1926,1279,163,1381,531,48,11,7,102,368,84,244,0,0
1927,1278,162,1381,531,48,11,7,103,369,85,244,0,0
1928,1278,162,1381,531,48,11,7,103,369,86,244,0,0
1929,1278,162,1381,530,48,11,7,103,368,87,244,0,0
1930,1279,163,1381,532,48,11,7,102,369,88,244,0,0
1931,1279,164,1381,530,48,11,7,102,366,89,244,0,0
1932,1279,164,1381,529,48,11,7,102,365,90,244,0,0
1933,1279,162,1382,531,48,11,7,103,369,91,244,0,0
1934,1279,164,1382,531,48,11,7,103,367,92,244,0,0
1935,1279,164,1382,530,48,11,7,103,366,93,244,0,0
1936,1279,163,1382,530,48,11,7,103,367,94,244,0,0
1937,1280,163,1383,530,48,11,7,103,367,95,244,0,0
1938,1279,163,1382,530,48,11,7,103,367,96,244,0,0
1939,1279,161,1382,530,48,11,7,103,369,97,244,0,0
1940,1280,163,1383,530,48,11,7,103,367,98,244,0,0
1941,1279,162,1382,529,48,11,7,103,367,99,244,0,0
1942,1279,162,1381,529,48,11,7,102,367,100,244,0,0
1943,1278,161,1381,532,48,11,7,103,371,101,244,0,0
1944,1279,161,1381,532,48,11,7,102,371,102,244,0,0
1945,1280,161,1381,531,48,11,7,101,370,103,244,0,0
1946,1281,160,1383,531,48,11,7,102,371,104,244,0,0
1947,1282,159,1385,534,48,11,7,103,375,105,244,0,0
1948,1282,157,1385,534,48,11,7,103,377,106,244,0,0
1949,1282,157,1385,530,48,11,7,103,373,107,244,0,0
1950,1282,156,1386,534,48,11,7,104,378,108,244,0,0
1951,1281,155,1385,529,48,11,7,104,374,109,244,0,0
1952,1289,158,1394,531,48,11,7,105,373,110,244,0,0
1953,1301,158,1411,531,48,11,7,110,373,111,244,0,0
1954,1298,161,1412,534,48,11,7,114,373,112,244,0,0
1955,1288,166,1399,530,48,11,7,111,364,113,244,0,0
1956,1281,165,1392,530,48,11,7,111,365,114,244,0,0
1957,1279,166,1389,532,48,11,7,110,366,115,244,0,0
1958,1278,162,1390,532,48,11,7,112,370,116,244,0,0
1959,1278,162,1389,531,48,11,7,111,369,117,244,0,0
1960,1277,164,1387,530,48,11,7,110,366,118,244,0,0
1961,1277,162,1387,527,48,11,7,110,365,119,244,0,0
1962,1277,162,1387,528,48,11,7,110,366,120,244,0,0
1963,1277,161,1388,530,48,11,7,111,369,121,244,0,0
1964,1277,161,1388,532,48,11,7,111,371,122,244,0,0
1965,1277,160,1388,533,48,11,7,111,373,123,244,0,0
1966,1277,160,1388,533,48,11,7,111,373,124,244,0,0
1967,1277,160,1388,533,48,11,7,111,373,125,244,0,0
1968,1277,160,1388,532,48,11,7,111,372,126,244,0,0
1969,1277,160,1388,532,48,11,7,111,372,127,244,0,0
1970,1277,160,1387,531,48,11,7,110,371,128,244,0,0
1971,1276,161,1385,533,48,11,7,109,372,129,244,0,0
1972,1277,159,1385,530,48,11,7,108,371,130,244,0,0
1973,1277,159,1385,529,48,11,7,108,370,131,244,0,0
1974,1277,159,1384,528,48,11,7,107,369,132,244,0,0
1975,1277,162,1384,530,48,11,7,107,368,133,244,0,0
1976,1279,164,1384,528,48,11,7,105,364,134,244,0,0
1977,1279,165,1385,527,48,11,7,106,362,135,244,0,0
1978,1280,162,1386,524,48,11,7,106,362,136,244,0,0
1979,1281,161,1387,523,48,11,7,106,362,137,244,0,0
1980,1280,160,1387,523,48,11,7,107,363,138,244,0,0
1981,1279,163,1387,528,48,11,7,108,365,139,244,0,0
1982,1279,164,1386,530,48,11,7,107,366,140,244,0,0
1983,1278,164,1386,530,48,11,7,108,366,141,244,0,0
1984,1278,164,1386,530,48,11,7,108,366,142,244,0,0
1985,1278,164,1386,531,48,11,7,108,367,143,244,0,0
1986,1278,160,1386,532,48,11,7,108,372,144,244,0,0
1987,1278,158,1386,533,48,11,7,108,375,145,244,0,0
1988,1278,158,1386,532,48,11,7,108,374,146,244,0,0
1989,1278,157,1387,532,48,11,7,109,375,147,244,0,0
1990,1278,156,1387,532,48,11,7,109,376,148,244,0,0
1991,1278,156,1386,528,48,11,7,108,372,149,244,0,0
1992,1276,156,1385,529,48,11,7,109,373,150,244,0,0
1993,1279,159,1390,530,48,11,7,111,371,151,244,0,0
1994,1287,160,1398,533,48,11,7,111,373,152,244,0,0
1995,1292,159,1404,533,48,11,7,112,374,153,244,0,0
1996,1293,155,1405,535,48,11,7,112,380,154,244,0,0
1997,1293,157,1404,536,48,11,7,111,379,155,244,0,0
1998,1290,159,1400,530,48,11,7,110,371,156,244,0,0
1999,1286,154,1396,524,48,11,7,110,370,157,244,0,0
2000,1283,157,1395,529,48,11,7,112,372,158,244,0,0
2001,1287,164,1398,532,48,11,7,111,368,159,244,0,0
2002,1291,166,1401,528,48,11,7,110,362,160,244,0,0
2003,1291,163,1404,534,48,11,7,113,371,161,244,0,0
2004,1287,161,1401,537,48,11,7,114,376,162,244,0,0
2005,1278,163,1390,534,48,11,7,112,371,163,244,0,0
2006,1276,157,1391,537,48,11,7,115,380,164,244,0,0
2007,1275,158,1389,530,48,11,7,114,372,165,244,0,0
2008,1274,159,1388,530,48,11,7,114,371,166,244,0,0
2009,1276,162,1389,531,48,11,7,113,369,167,244,0,0
2010,1279,163,1391,531,48,11,7,112,368,168,244,0,0
2011,1280,162,1391,531,48,11,7,111,369,169,244,0,0
2012,1280,162,1391,531,48,11,7,111,369,170,244,0,0
2013,1281,162,1391,531,48,11,7,110,369,171,244,0,0
2014,1281,162,1390,531,48,11,7,109,369,172,244,0,0
2015,1281,162,1390,531,48,11,7,109,369,173,244,0,0
2016,1282,161,1389,530,48,11,7,107,369,174,244,0,0
2017,1282,161,1389,530,48,11,7,107,369,175,244,0,0
2018,1282,162,1387,524,48,11,7,105,362,176,244,0,0
2019,1281,160,1387,528,48,11,7,106,368,177,244,0,0
2020,1281,161,1386,524,48,11,7,105,363,178,244,0,0
2021,1281,161,1386,528,48,11,7,105,367,179,244,0,0
2022,1281,163,1385,529,48,11,7,104,366,180,244,0,0
2023,1281,164,1385,529,48,11,7,104,365,181,244,0,0
2024,1281,164,1384,529,48,11,7,103,365,182,244,0,0
2025,1281,163,1384,529,48,11,7,103,366,183,244,0,0
2026,1282,161,1385,531,48,11,7,103,370,184,244,0,0
2027,1282,160,1384,531,48,11,7,102,371,185,244,0,0
2028,1282,160,1384,531,48,11,7,102,371,186,244,0,0
2029,1282,160,1384,531,48,11,7,102,371,187,244,0,0
2030,1282,158,1384,531,48,11,7,102,373,188,244,0,0
2031,1282,161,1384,532,48,11,7,102,371,189,244,0,0
2032,1282,161,1384,532,48,11,7,102,371,190,244,0,0
2033,1282,161,1385,533,48,11,7,103,372,191,244,0,0
2034,1282,162,1385,533,48,11,7,103,371,192,244,0,0
2035,1283,163,1385,533,48,11,7,102,370,193,244,0,0
2036,1282,161,1386,533,48,11,7,104,372,194,244,0,0
2037,1283,163,1385,534,48,11,7,102,371,195,244,0,0
2038,1283,163,1385,530,48,11,7,102,367,196,244,0,0
2039,1283,163,1386,529,48,11,7,103,366,197,244,0,0
2040,1282,162,1386,532,48,11,7,104,370,198,244,0,0
2041,1282,162,1385,532,48,11,7,103,370,199,244,0,0
2042,1281,162,1385,532,48,11,7,104,370,200,244,0,0
2043,1281,163,1385,532,48,11,7,104,369,201,244,0,0
2044,1281,163,1385,532,48,11,7,104,369,202,244,0,0
2045,1281,163,1385,532,48,11,7,104,369,203,244,0,0
2046,1281,161,1385,532,48,11,7,104,371,204,244,0,0
2047,1280,161,1385,532,48,11,7,105,371,205,244,0,0
2048,1280,161,1385,532,48,11,7,105,371,206,244,0,0
2049,1281,161,1385,530,48,11,7,104,369,207,244,0,0
2050,1282,159,1387,529,48,11,7,105,370,208,244,0,0
2051,1282,161,1386,530,48,11,7,104,369,209,244,0,0
2052,1282,162,1385,529,48,11,7,103,367,210,244,0,0
2053,1282,162,1385,529,48,11,7,103,367,211,244,0,0
2054,1282,162,1385,529,48,11,7,103,367,212,244,0,0
2055,1283,164,1384,529,48,11,7,101,365,213,244,0,0
2056,1282,163,1385,529,48,11,7,103,366,214,244,0,0
2057,1283,163,1385,529,48,11,7,102,366,215,244,0,0
2058,1282,163,1385,529,48,11,7,103,366,216,244,0,0
2059,1282,163,1385,529,48,11,7,103,366,217,244,0,0
2060,1281,163,1384,530,48,11,7,103,367,218,244,0,0
2061,1281,163,1384,531,48,11,7,103,368,219,244,0,0
2062,1281,163,1385,531,48,11,7,104,368,220,244,0,0
2063,1281,164,1385,532,48,11,7,104,368,221,244,0,0
2064,1279,160,1384,532,48,11,7,105,372,222,244,0,0
2065,1278,160,1384,532,48,11,7,106,372,223,244,0,0
2066,1280,162,1385,532,48,11,7,105,370,224,244,0,0
2067,1281,164,1386,533,48,11,7,105,369,225,244,0,0
2068,1281,165,1386,533,48,11,7,105,368,226,244,0,0
2069,1281,165,1386,532,48,11,7,105,367,227,244,0,0
2070,1281,165,1386,532,48,11,7,105,367,228,244,0,0
2071,1282,162,1388,531,48,11,7,106,369,229,244,0,0
2072,1282,161,1388,531,48,11,7,106,370,230,244,0,0
2073,1282,163,1387,531,48,11,7,105,368,231,244,0,0
2074,1281,163,1387,531,48,11,7,106,368,232,244,0,0
2075,1282,162,1388,531,48,11,7,106,369,233,244,0,0
2076,1281,160,1387,529,48,11,7,106,369,234,244,0,0
2077,1281,159,1387,529,48,11,7,106,370,235,244,0,0
2078,1281,159,1388,529,48,11,7,107,370,236,244,0,0
2079,1281,159,1388,529,48,11,7,107,370,237,244,0,0
2080,1281,159,1388,529,48,11,7,107,370,238,244,0,0
2081,1280,159,1387,530,48,11,7,107,371,239,244,0,0
2082,1280,160,1387,530,48,11,7,107,370,240,244,0,0
2083,1281,156,1388,530,48,11,7,107,374,241,244,0,0
2084,1278,158,1387,537,48,11,7,109,379,242,244,0,0
2085,1279,160,1388,543,48,11,7,109,383,243,244,0,0
2086,1279,160,1388,545,48,11,7,109,385,244,244,1,0
2088,1276,167,1366,490,48,11,7,90,323,0,244,0,1
2089,1275,165,1371,513,48,11,7,96,348,1,244,0,0
2090,1279,164,1380,525,48,11,7,101,361,2,244,0,0
2091,1281,164,1383,529,48,11,7,102,365,3,244,0,0
2092,1282,161,1384,528,48,11,7,102,367,4,244,0,0
2093,1281,163,1385,531,48,11,7,104,368,5,244,0,0
2094,1281,163,1386,533,48,11,7,105,370,6,244,0,0
2095,1281,163,1386,534,48,11,7,105,371,7,244,0,0
2096,1281,162,1387,531,48,11,7,106,369,8,244,0,0
2097,1281,161,1387,530,48,11,7,106,369,9,244,0,0
2098,1282,161,1388,529,48,11,7,106,368,10,244,0,0
2099,1281,161,1388,529,48,11,7,107,368,11,244,0,0
2100,1281,161,1387,529,48,11,7,106,368,12,244,0,0
2101,1281,160,1388,530,48,11,7,107,370,13,244,0,0
2102,1281,160,1388,530,48,11,7,107,370,14,244,0,0
2103,1281,162,1388,530,48,11,7,107,368,15,244,0,0
2104,1281,163,1388,530,48,11,7,107,367,16,244,0,0
2105,1282,163,1388,530,48,11,7,106,367,17,244,0,0
2106,1282,161,1387,525,48,11,7,105,364,18,244,0,0
2107,1282,160,1388,524,48,11,7,106,364,19,244,0,0
2108,1281,158,1388,529,48,11,7,107,371,20,244,0,0
2109,1280,161,1388,529,48,11,7,108,368,21,244,0,0
2110,1280,159,1388,530,48,11,7,108,371,22,244,0,0
2111,1283,161,1389,526,48,11,7,106,365,23,244,0,0
2112,1282,161,1389,528,48,11,7,107,367,24,244,0,0
2113,1283,163,1392,530,48,11,7,109,367,25,244,0,0
2114,1276,165,1379,516,48,11,7,103,351,26,244,0,0
2115,1289,164,1356,370,48,11,7,67,206,27,244,0,0
2116,1291,164,1352,352,48,11,7,61,188,28,244,0,0
1861,1591,83,1651,180,49,11,7,60,97,0,1,0,0
1862,1592,82,1653,180,49,11,7,61,98,1,1,0,0
2059,2,272,65,515,53,11,7,63,243,0,49,0,1
2060,4,263,70,517,53,11,7,66,254,1,49,0,0
2061,8,269,74,519,53,11,7,66,250,2,49,0,0
2062,18,277,86,532,53,11,7,68,255,3,49,0,0
2063,32,280,100,532,53,11,7,68,252,4,49,0,0
2064,56,280,131,549,53,11,7,75,269,5,49,0,0
2065,73,283,151,557,53,11,7,78,274,6,49,0,0
2066,88,277,174,574,53,11,7,86,297,7,49,0,0
2067,108,283,201,592,53,11,7,93,309,8,49,0,0
2068,122,277,220,603,53,11,7,98,326,9,49,0,0
2069,152,284,258,620,53,11,7,106,336,10,49,0,0
2070,175,285,287,635,53,11,7,112,350,11,49,0,0
2071,202,287,324,660,53,11,7,122,373,12,49,0,0
2072,234,297,364,682,53,11,7,130,385,13,49,0,0
2073,263,296,399,696,53,11,7,136,400,14,49,0,0
2074,323,304,470,714,53,11,7,147,410,15,49,0,0
2075,364,308,517,731,53,11,7,153,423,16,49,0,0
2076,415,317,582,774,53,11,7,167,457,17,49,0,0
2077,468,327,646,807,53,11,7,178,480,18,49,0,0
2078,522,325,705,818,53,11,7,183,493,19,49,0,0
2079,605,333,804,848,53,11,7,199,515,20,49,0,0
2080,675,334,876,865,53,11,7,201,531,21,49,0,0
2081,784,340,994,878,53,11,7,210,538,22,49,0,0
2082,864,343,1078,884,53,11,7,214,541,23,49,0,0
2083,962,342,1173,886,53,11,7,211,544,24,49,0,0
2084,1033,337,1251,892,53,11,7,218,555,25,49,0,0
2085,1134,320,1341,860,53,11,7,207,540,26,49,0,0
2086,1194,235,1421,832,53,11,7,227,597,27,49,0,0
2087,1255,217,1470,792,53,11,7,215,575,28,49,0,0
2088,1319,253,1505,755,53,11,7,186,502,29,49,0,0
2089,1353,261,1527,731,53,11,7,174,470,30,49,0,0
2090,1394,249,1551,677,53,11,7,157,428,31,49,0,0
2091,1418,245,1564,651,53,11,7,146,406,32,49,0,0
2092,1435,229,1572,611,53,11,7,137,382,33,49,0,0
2093,1442,222,1574,592,53,11,7,132,370,34,49,0,0
2094,1447,212,1572,566,53,11,7,125,354,35,49,0,0
2095,1453,197,1570,529,53,11,7,117,332,36,49,0,0
2096,1454,192,1566,512,53,11,7,112,320,37,49,0,0
2097,1452,183,1556,481,53,11,7,104,298,38,49,0,0
2098,1454,178,1554,466,53,11,7,100,288,39,49,0,0
2099,1453,170,1548,443,53,11,7,95,273,40,49,0,0
2100,1463,165,1553,424,53,11,7,90,259,41,49,0,0
2101,1471,160,1558,413,53,11,7,87,253,42,49,0,0
2102,1487,151,1571,398,53,11,7,84,247,43,49,0,0
2103,1500,148,1581,386,53,11,7,81,238,44,49,0,0
2104,1508,143,1586,375,53,11,7,78,232,45,49,0,0
2105,1517,139,1594,369,53,11,7,77,230,46,49,0,0
2106,1526,136,1601,362,53,11,7,75,226,47,49,0,0
2107,1546,136,1609,326,53,11,7,63,190,48,49,0,0
2108,1559,131,1618,308,53,11,7,59,177,49,49,1,0
2111,1587,134,1650,325,53,11,7,63,191,0,49,0,1
2112,1597,134,1657,320,53,11,7,60,186,1,49,0,0
2113,1601,132,1660,317,53,11,7,59,185,2,49,0,0
2114,1608,131,1665,310,53,11,7,57,179,3,49,0,0
2115,1612,130,1668,307,53,11,7,56,177,4,49,0,0
2116,1618,126,1671,296,53,11,7,53,170,5,49,0,0
2117,1620,124,1671,289,53,11,7,51,165,6,49,0,0
2118,1621,124,1671,285,53,11,7,50,161,7,49,0,0
2119,1622,122,1671,278,53,11,7,49,156,8,49,0,0
2120,1624,122,1672,274,53,11,7,48,152,9,49,0,0
2121,1627,118,1675,267,53,11,7,48,149,10,49,0,0
2122,1630,116,1677,265,53,11,7,47,149,11,49,0,0
2123,1631,113,1676,258,53,11,7,45,145,12,49,0,0
2124,1633,111,1677,251,53,11,7,44,140,13,49,0,0
2125,1636,113,1678,249,53,11,7,42,136,14,49,0,0
2126,1639,108,1681,240,53,11,7,42,132,15,49,0,0
2127,1642,105,1683,237,53,11,7,41,132,16,49,0,0
2128,1646,105,1686,231,53,11,7,40,126,17,49,0,0
2129,1650,108,1688,231,53,11,7,38,123,18,49,0,0
2130,1655,111,1691,229,53,11,7,36,118,19,49,0,0
2131,1658,106,1695,226,53,11,7,37,120,20,49,0,0
2132,1660,104,1696,226,53,11,7,36,122,21,49,0,0
2133,1660,103,1696,222,53,11,7,36,119,22,49,0,0
2134,1661,92,1697,218,53,11,7,36,126,23,49,0,0
2116,1281,164,1387,553,54,11,7,106,389,0,191,0,1
2117,1281,164,1385,543,54,11,7,104,379,1,191,0,0
2118,1284,161,1386,534,54,11,7,102,373,2,191,0,0
2119,1284,160,1386,533,54,11,7,102,373,3,191,0,0
2120,1285,161,1387,533,54,11,7,102,372,4,191,0,0
2121,1284,162,1385,531,54,11,7,101,369,5,191,0,0
2122,1283,162,1384,531,54,11,7,101,369,6,191,0,0
2123,1283,162,1384,531,54,11,7,101,369,7,191,0,0
2124,1283,161,1384,531,54,11,7,101,370,8,191,0,0
2125,1283,162,1384,531,54,11,7,101,369,9,191,0,0
2126,1283,162,1384,529,54,11,7,101,367,10,191,0,0
2127,1282,162,1384,528,54,11,7,102,366,11,191,0,0
2128,1282,162,1384,528,54,11,7,102,366,12,191,0,0
2129,1282,161,1384,528,54,11,7,102,367,13,191,0,0
2130,1282,161,1384,529,54,11,7,102,368,14,191,0,0
2131,1283,160,1385,526,54,11,7,102,366,15,191,0,0
2132,1281,160,1385,529,54,11,7,104,369,16,191,0,0
2133,1281,160,1384,530,54,11,7,103,370,17,191,0,0
2134,1282,160,1385,526,54,11,7,103,366,18,191,0,0
2135,1282,159,1385,525,54,11,7,103,366,19,191,0,0
2136,1281,160,1386,528,54,11,7,105,368,20,191,0,0
2137,1281,160,1386,529,54,11,7,105,369,21,191,0,0
2138,1281,161,1386,529,54,11,7,105,368,22,191,0,0
2139,1280,161,1387,530,54,11,7,107,369,23,191,0,0
2140,1280,161,1387,530,54,11,7,107,369,24,191,0,0
2141,1281,161,1388,527,54,11,7,107,366,25,191,0,0
2142,1281,161,1388,525,54,11,7,107,364,26,191,0,0
2143,1281,161,1388,525,54,11,7,107,364,27,191,0,0
2144,1281,161,1388,525,54,11,7,107,364,28,191,0,0
2145,1280,161,1388,524,54,11,7,108,363,29,191,0,0
2146,1279,161,1388,528,54,11,7,109,367,30,191,0,0
2147,1280,161,1389,528,54,11,7,109,367,31,191,0,0
2148,1279,161,1388,530,54,11,7,109,369,32,191,0,0
2149,1278,161,1388,530,54,11,7,110,369,33,191,0,0
2150,1278,161,1388,530,54,11,7,110,369,34,191,0,0
2151,1278,163,1388,531,54,11,7,110,368,35,191,0,0
2152,1278,163,1388,531,54,11,7,110,368,36,191,0,0
2153,1278,163,1388,532,54,11,7,110,369,37,191,0,0
2154,1279,163,1387,531,54,11,7,108,368,38,191,0,0
2155,1279,164,1387,531,54,11,7,108,367,39,191,0,0
2156,1279,162,1387,532,54,11,7,108,370,40,191,0,0
2157,1279,162,1387,532,54,11,7,108,370,41,191,0,0
2158,1279,162,1387,532,54,11,7,108,370,42,191,0,0
2159,1279,162,1387,532,54,11,7,108,370,43,191,0,0
2160,1279,162,1387,532,54,11,7,108,370,44,191,0,0
2161,1280,164,1386,531,54,11,7,106,367,45,191,0,0
2162,1280,164,1386,531,54,11,7,106,367,46,191,0,0
2163,1280,165,1386,531,54,11,7,106,366,47,191,0,0
2164,1280,165,1386,531,54,11,7,106,366,48,191,0,0
2165,1280,165,1385,531,54,11,7,105,366,49,191,0,0
2166,1280,162,1386,528,54,11,7,106,366,50,191,0,0
2167,1281,162,1386,527,54,11,7,105,365,51,191,0,0
2168,1280,161,1386,526,54,11,7,106,365,52,191,0,0
2169,1280,161,1386,526,54,11,7,106,365,53,191,0,0
2170,1280,161,1386,526,54,11,7,106,365,54,191,0,0
2171,1280,161,1386,525,54,11,7,106,364,55,191,0,0
2172,1281,161,1387,524,54,11,7,106,363,56,191,0,0
2173,1281,161,1387,524,54,11,7,106,363,57,191,0,0
2174,1281,161,1387,524,54,11,7,106,363,58,191,0,0
2175,1280,161,1387,524,54,11,7,107,363,59,191,0,0
2176,1279,160,1387,528,54,11,7,108,368,60,191,0,0
2177,1280,160,1387,530,54,11,7,107,370,61,191,0,0
2178,1279,160,1386,530,54,11,7,107,370,62,191,0,0
2179,1279,160,1386,531,54,11,7,107,371,63,191,0,0
2180,1279,159,1386,531,54,11,7,107,372,64,191,0,0
2181,1279,159,1386,527,54,11,7,107,368,65,191,0,0
2182,1279,162,1385,528,54,11,7,106,366,66,191,0,0
2183,1278,163,1385,528,54,11,7,107,365,67,191,0,0
2184,1279,163,1385,528,54,11,7,106,365,68,191,0,0
2185,1278,164,1385,528,54,11,7,107,364,69,191,0,0
2186,1279,162,1386,527,54,11,7,107,365,70,191,0,0
2187,1280,166,1385,527,54,11,7,105,361,71,191,0,0
2188,1280,167,1385,527,54,11,7,105,360,72,191,0,0
2189,1280,164,1387,527,54,11,7,107,363,73,191,0,0
2190,1279,162,1387,527,54,11,7,108,365,74,191,0,0
2191,1280,160,1388,525,54,11,7,108,365,75,191,0,0
2192,1280,159,1388,524,54,11,7,108,365,76,191,0,0
2193,1278,157,1388,528,54,11,7,110,371,77,191,0,0
2194,1280,159,1388,525,54,11,7,108,366,78,191,0,0
2195,1280,159,1389,524,54,11,7,109,365,79,191,0,0
2196,1279,162,1388,528,54,11,7,109,366,80,191,0,0
2197,1279,164,1387,529,54,11,7,108,365,81,191,0,0
2198,1279,164,1386,529,54,11,7,107,365,82,191,0,0
2199,1279,163,1386,530,54,11,7,107,367,83,191,0,0
2200,1279,163,1386,530,54,11,7,107,367,84,191,0,0
2201,1279,161,1386,530,54,11,7,107,369,85,191,0,0
2202,1278,160,1386,530,54,11,7,108,370,86,191,0,0
2203,1278,160,1386,530,54,11,7,108,370,87,191,0,0
2204,1278,160,1386,530,54,11,7,108,370,88,191,0,0
2205,1278,160,1386,530,54,11,7,108,370,89,191,0,0
2206,1279,160,1386,528,54,11,7,107,368,90,191,0,0
2207,1280,160,1386,526,54,11,7,106,366,91,191,0,0
2208,1279,159,1386,526,54,11,7,107,367,92,191,0,0
2209,1279,160,1386,525,54,11,7,107,365,93,191,0,0
2210,1279,160,1386,525,54,11,7,107,365,94,191,0,0
2211,1280,159,1386,525,54,11,7,106,366,95,191,0,0
2212,1280,159,1387,525,54,11,7,107,366,96,191,0,0
2213,1280,158,1387,525,54,11,7,107,367,97,191,0,0
2214,1280,158,1388,525,54,11,7,108,367,98,191,0,0
2215,1280,158,1387,525,54,11,7,107,367,99,191,0,0
2216,1281,163,1387,525,54,11,7,106,362,100,191,0,0
2217,1281,162,1388,525,54,11,7,107,363,101,191,0,0
2218,1281,162,1388,525,54,11,7,107,363,102,191,0,0
2219,1281,161,1388,525,54,11,7,107,364,103,191,0,0
2220,1281,161,1388,525,54,11,7,107,364,104,191,0,0
2221,1279,162,1387,527,54,11,7,108,365,105,191,0,0
2222,1278,162,1386,529,54,11,7,108,367,106,191,0,0
2223,1277,163,1386,529,54,11,7,109,366,107,191,0,0
2224,1277,163,1386,530,54,11,7,109,367,108,191,0,0
2225,1277,163,1386,530,54,11,7,109,367,109,191,0,0
2226,1278,159,1388,530,54,11,7,110,371,110,191,0,0
2227,1278,158,1388,530,54,11,7,110,372,111,191,0,0
2228,1279,158,1388,529,54,11,7,109,371,112,191,0,0
2229,1279,157,1388,529,54,11,7,109,372,113,191,0,0
2230,1279,159,1387,529,54,11,7,108,370,114,191,0,0
2231,1280,159,1388,525,54,11,7,108,366,115,191,0,0
2232,1281,161,1388,524,54,11,7,107,363,116,191,0,0
2233,1281,161,1388,526,54,11,7,107,365,117,191,0,0
2234,1280,162,1387,529,54,11,7,107,367,118,191,0,0
2235,1280,159,1389,528,54,11,7,109,369,119,191,0,0
2236,1288,161,1400,531,54,11,7,112,370,120,191,0,0
2237,1291,161,1405,529,54,11,7,114,368,121,191,0,0
2238,1291,167,1404,532,54,11,7,113,365,122,191,0,0
2239,1297,174,1408,529,54,11,7,111,355,123,191,0,0
2240,1302,176,1413,529,54,11,7,111,353,124,191,0,0
2241,1299,174,1411,528,54,11,7,112,354,125,191,0,0
2242,1294,171,1408,532,54,11,7,114,361,126,191,0,0
2243,1288,169,1402,534,54,11,7,114,365,127,191,0,0
2244,1283,167,1396,531,54,11,7,113,364,128,191,0,0
2245,1279,165,1393,531,54,11,7,114,366,129,191,0,0
2246,1277,168,1391,538,54,11,7,114,370,130,191,0,0
2247,1278,163,1393,535,54,11,7,115,372,131,191,0,0
2248,1278,163,1393,535,54,11,7,115,372,132,191,0,0
2249,1279,163,1393,535,54,11,7,114,372,133,191,0,0
2250,1280,165,1392,534,54,11,7,112,369,134,191,0,0
2251,1280,163,1392,534,54,11,7,112,371,135,191,0,0
2252,1279,164,1390,535,54,11,7,111,371,136,191,0,0
2253,1279,164,1390,535,54,11,7,111,371,137,191,0,0
2254,1281,162,1391,535,54,11,7,110,373,138,191,0,0
2255,1281,161,1392,536,54,11,7,111,375,139,191,0,0
2256,1280,162,1390,536,54,11,7,110,374,140,191,0,0
2257,1282,160,1391,535,54,11,7,109,375,141,191,0,0
2258,1282,158,1392,535,54,11,7,110,377,142,191,0,0
2259,1283,158,1392,535,54,11,7,109,377,143,191,0,0
2260,1283,160,1391,534,54,11,7,108,374,144,191,0,0
2261,1282,161,1389,533,54,11,7,107,372,145,191,0,0
2262,1281,161,1388,533,54,11,7,107,372,146,191,0,0
2263,1282,160,1389,533,54,11,7,107,373,147,191,0,0
2264,1281,160,1389,533,54,11,7,108,373,148,191,0,0
2265,1281,160,1388,532,54,11,7,107,372,149,191,0,0
2266,1282,160,1389,532,54,11,7,107,372,150,191,0,0
2267,1282,156,1390,533,54,11,7,108,377,151,191,0,0
2268,1283,155,1391,534,54,11,7,108,379,152,191,0,0
2269,1283,158,1391,534,54,11,7,108,376,153,191,0,0
2270,1283,156,1391,534,54,11,7,108,378,154,191,0,0
2271,1285,158,1391,529,54,11,7,106,371,155,191,0,0
2272,1285,160,1391,527,54,11,7,106,367,156,191,0,0
2273,1285,158,1392,529,54,11,7,107,371,157,191,0,0
2274,1284,155,1393,530,54,11,7,109,375,158,191,0,0
2275,1285,152,1394,530,54,11,7,109,378,159,191,0,0
2276,1283,152,1393,533,54,11,7,110,381,160,191,0,0
2277,1283,155,1392,533,54,11,7,109,378,161,191,0,0
2278,1282,155,1391,536,54,11,7,109,381,162,191,0,0
2279,1282,157,1389,534,54,11,7,107,377,163,191,0,0
2280,1282,159,1385,526,54,11,7,103,367,164,191,0,0
2281,1279,157,1381,521,54,11,7,102,364,165,191,0,0
2282,1279,155,1376,501,54,11,7,97,346,166,191,0,0
2283,1278,156,1375,496,54,11,7,97,340,167,191,0,0
2284,1278,153,1380,505,54,11,7,102,352,168,191,0,0
2285,1282,158,1384,507,54,11,7,102,349,169,191,0,0
2286,1296,152,1394,477,54,11,7,98,325,170,191,0,0
2287,1314,160,1404,434,54,11,7,90,274,171,191,0,0
2288,1312,167,1423,502,54,11,7,111,335,172,191,0,0
2289,1302,174,1436,577,54,11,7,134,403,173,191,0,0
2290,1289,174,1434,609,54,11,7,145,435,174,191,0,0
2291,1278,183,1432,648,54,11,7,154,465,175,191,0,0
2292,1278,198,1435,680,54,11,7,157,482,176,191,0,0
2293,1290,201,1453,701,54,11,7,163,500,177,191,0,0
2294,1305,218,1479,746,54,11,7,174,528,178,191,0,0
2295,1311,233,1490,770,54,11,7,179,537,179,191,0,0
2296,1310,254,1487,781,54,11,7,177,527,180,191,0,0
2297,1311,279,1499,833,54,11,7,188,554,181,191,0,0
2298,1321,295,1519,870,54,11,7,198,575,182,191,0,0
2299,1365,299,1570,889,54,11,7,205,590,183,191,0,0
2300,1410,310,1639,968,54,11,7,229,658,184,191,0,0
2301,1450,328,1682,1000,54,11,7,232,672,185,191,0,0
2302,1500,346,1731,1006,54,11,7,231,660,186,191,0,0
2303,1540,372,1787,1050,54,11,7,247,678,187,191,0,0
2304,1572,390,1833,1071,54,11,7,261,681,188,191,0,0
2305,1649,418,1900,1076,54,11,7,251,658,189,191,0,0
2306,1691,550,1900,1080,54,11,7,209,530,190,191,0,0
2307,1717,575,1920,1080,54,11,7,203,505,191,191,1,0
2223,1634,89,1669,193,56,11,7,35,104,0,48,0,1
2224,1632,90,1667,193,56,11,7,35,103,1,48,0,0
2225,1632,88,1668,196,56,11,7,36,108,2,48,0,0
2226,1633,90,1669,198,56,11,7,36,108,3,48,0,0
2227,1633,93,1669,199,56,11,7,36,106,4,48,0,0
2228,1632,93,1669,203,56,11,7,37,110,5,48,0,0
2229,1631,93,1669,204,56,11,7,38,111,6,48,0,0
2230,1629,95,1668,208,56,11,7,39,113,7,48,0,0
2231,1629,99,1667,209,56,11,7,38,110,8,48,0,0
2232,1625,97,1665,211,56,11,7,40,114,9,48,0,0
2233,1624,99,1664,217,56,11,7,40,118,10,48,0,0
2234,1622,97,1663,219,56,11,7,41,122,11,48,0,0
2235,1619,95,1662,221,56,11,7,43,126,12,48,0,0
2236,1615,91,1660,223,56,11,7,45,132,13,48,0,0
2237,1608,89,1656,229,56,11,7,48,140,14,48,0,0
2238,1606,94,1653,231,56,11,7,47,137,15,48,0,0
2239,1602,91,1651,232,56,11,7,49,141,16,48,0,0
2240,1599,92,1649,236,56,11,7,50,144,17,48,0,0
2241,1595,95,1645,238,56,11,7,50,143,18,48,0,0
2242,1592,95,1643,240,56,11,7,51,145,19,48,0,0
2245,1582,93,1639,255,56,11,7,57,162,0,48,0,1
2246,1575,93,1634,256,56,11,7,59,163,1,48,0,0
2247,1571,92,1633,262,56,11,7,62,170,2,48,0,0
2248,1570,87,1636,270,56,11,7,66,183,3,48,0,0
2249,1568,93,1632,270,56,11,7,64,177,4,48,0,0
2250,1567,98,1632,277,56,11,7,65,179,5,48,0,0
2251,1566,99,1633,280,56,11,7,67,181,6,48,0,0
2252,1563,100,1635,290,56,11,7,72,190,7,48,0,0
2253,1564,101,1637,294,56,11,7,73,193,8,48,0,0
2254,1562,102,1636,301,56,11,7,74,199,9,48,0,0
2255,1564,108,1640,311,56,11,7,76,203,10,48,0,0
2256,1565,109,1641,314,56,11,7,76,205,11,48,0,0
2257,1563,113,1642,325,56,11,7,79,212,12,48,0,0
2258,1565,119,1644,329,56,11,7,79,210,13,48,0,0
2259,1566,121,1647,333,56,11,7,81,212,14,48,0,0
2260,1565,121,1652,351,56,11,7,87,230,15,48,0,0
2261,1564,123,1654,359,56,11,7,90,236,16,48,0,0
2262,1563,126,1658,371,56,11,7,95,245,17,48,0,0
2263,1564,128,1661,375,56,11,7,97,247,18,48,0,0
2264,1564,132,1662,383,56,11,7,98,251,19,48,0,0
2265,1560,137,1663,401,56,11,7,103,264,20,48,0,0
2266,1555,138,1663,409,56,11,7,108,271,21,48,0,0
2267,1547,140,1660,420,56,11,7,113,280,22,48,0,0
2268,1543,143,1659,429,56,11,7,116,286,23,48,0,0
2269,1540,144,1661,445,56,11,7,121,301,24,48,0,0
2270,1538,151,1662,463,56,11,7,124,312,25,48,0,0
2271,1525,154,1654,473,56,11,7,129,319,26,48,0,0
2272,1510,161,1647,500,56,11,7,137,339,27,48,0,0
2273,1503,168,1644,509,56,11,7,141,341,28,48,0,0
2274,1498,171,1645,531,56,11,7,147,360,29,48,0,0
2275,1489,181,1641,555,56,11,7,152,374,30,48,0,0
2276,1471,183,1631,575,56,11,7,160,392,31,48,0,0
2277,1468,196,1637,613,56,11,7,169,417,32,48,0,0
2278,1446,197,1628,642,56,11,7,182,445,33,48,0,0
2279,1434,210,1622,670,56,11,7,188,460,34,48,0,0
2280,1421,224,1613,699,56,11,7,192,475,35,48,0,0
2281,1389,235,1595,736,56,11,7,206,501,36,48,0,0
2282,1351,253,1579,789,56,11,7,228,536,37,48,0,0
2283,1352,262,1588,815,56,11,7,236,553,38,48,0,0
2284,1333,285,1589,889,56,11,7,256,604,39,48,0,0
2285,1306,303,1578,947,56,11,7,272,644,40,48,0,0
2286,1236,318,1536,1002,56,11,7,300,684,41,48,0,0
2287,1163,354,1484,1055,56,11,7,321,701,42,48,0,0
2288,1162,384,1481,1078,56,11,7,319,694,43,48,0,0
2289,1138,439,1438,1080,56,11,7,300,641,44,48,0,0
2290,1065,495,1354,1080,56,11,7,289,585,45,48,0,0
2291,900,540,1196,1080,56,11,7,296,540,46,48,0,0
2292,794,635,1065,1080,56,11,7,271,445,47,48,0,0
2293,750,666,1015,1080,56,11,7,265,414,48,48,1,0
2290,998,557,1121,1051,60,11,7,123,494,0,0,0,0
2304,1792,421,1918,986,63,11,7,126,565,0,0,0,0
2788,1667,92,1702,198,65,11,7,35,106,0,107,0,1
2789,1666,92,1701,199,65,11,7,35,107,1,107,0,0
2790,1664,92,1699,200,65,11,7,35,108,2,107,0,0
2791,1661,91,1698,202,65,11,7,37,111,3,107,0,0
2792,1661,91,1698,204,65,11,7,37,113,4,107,0,0
2793,1660,90,1698,206,65,11,7,38,116,5,107,0,0
2794,1659,91,1697,210,65,11,7,38,119,6,107,0,0
2795,1659,92,1696,209,65,11,7,37,117,7,107,0,0
2796,1658,92,1696,211,65,11,7,38,119,8,107,0,0
2797,1657,94,1695,212,65,11,7,38,118,9,107,0,0
2798,1658,93,1696,214,65,11,7,38,121,10,107,0,0
2799,1657,95,1696,217,65,11,7,39,122,11,107,0,0
2800,1656,96,1695,219,65,11,7,39,123,12,107,0,0
2801,1654,98,1693,222,65,11,7,39,124,13,107,0,0
2802,1654,101,1692,224,65,11,7,38,123,14,107,0,0
2803,1655,102,1693,225,65,11,7,38,123,15,107,0,0
2804,1654,99,1695,230,65,11,7,41,131,16,107,0,0
2805,1655,102,1696,235,65,11,7,41,133,17,107,0,0
2806,1655,103,1696,237,65,11,7,41,134,18,107,0,0
2807,1654,102,1696,239,65,11,7,42,137,19,107,0,0
2808,1655,104,1696,241,65,11,7,41,137,20,107,0,0
2809,1656,105,1698,241,65,11,7,42,136,21,107,0,0
2810,1656,107,1699,245,65,11,7,43,138,22,107,0,0
2811,1654,110,1698,250,65,11,7,44,140,23,107,0,0
2812,1652,111,1696,252,65,11,7,44,141,24,107,0,0
2813,1650,112,1696,257,65,11,7,46,145,25,107,0,0
2814,1649,112,1695,260,65,11,7,46,148,26,107,0,0
2815,1648,112,1696,263,65,11,7,48,151,27,107,0,0
2816,1647,116,1694,266,65,11,7,47,150,28,107,0,0
2817,1644,115,1692,269,65,11,7,48,154,29,107,0,0
2818,1642,116,1691,274,65,11,7,49,158,30,107,0,0
2819,1641,117,1691,277,65,11,7,50,160,31,107,0,0
2820,1641,119,1692,282,65,11,7,51,163,32,107,0,0
2821,1640,120,1693,292,65,11,7,53,172,33,107,0,0
2822,1639,121,1693,298,65,11,7,54,177,34,107,0,0
2823,1639,122,1693,301,65,11,7,54,179,35,107,0,0
2824,1638,126,1693,306,65,11,7,55,180,36,107,0,0
2825,1640,125,1695,308,65,11,7,55,183,37,107,0,0
2826,1640,127,1696,312,65,11,7,56,185,38,107,0,0
2827,1638,130,1695,317,65,11,7,57,187,39,107,0,0
2828,1636,131,1694,321,65,11,7,58,190,40,107,0,0
2829,1633,134,1692,325,65,11,7,59,191,41,107,0,0
2830,1633,139,1692,333,65,11,7,59,194,42,107,0,0
2831,1632,141,1693,339,65,11,7,61,198,43,107,0,0
2832,1631,144,1693,348,65,11,7,62,204,44,107,0,0
2833,1627,143,1691,352,65,11,7,64,209,45,107,0,0
2834,1624,143,1689,357,65,11,7,65,214,46,107,0,0
2835,1624,148,1689,364,65,11,7,65,216,47,107,0,0
2836,1625,150,1692,371,65,11,7,67,221,48,107,0,0
2837,1625,155,1694,379,65,11,7,69,224,49,107,0,0
2838,1621,157,1693,390,65,11,7,72,233,50,107,0,0
2839,1618,157,1692,396,65,11,7,74,239,51,107,0,0
2840,1613,162,1689,406,65,11,7,76,244,52,107,0,0
2841,1612,166,1691,417,65,11,7,79,251,53,107,0,0
2842,1610,169,1690,423,65,11,7,80,254,54,107,0,0
2843,1606,175,1688,437,65,11,7,82,262,55,107,0,0
2844,1597,178,1680,440,65,11,7,83,262,56,107,0,0
2845,1592,181,1678,452,65,11,7,86,271,57,107,0,0
2846,1583,186,1671,467,65,11,7,88,281,58,107,0,0
2847,1574,187,1665,477,65,11,7,91,290,59,107,0,0
2848,1554,189,1651,493,65,11,7,97,304,60,107,0,0
2849,1544,192,1642,500,65,11,7,98,308,61,107,0,0
2850,1533,191,1633,506,65,11,7,100,315,62,107,0,0
2851,1523,198,1629,533,65,11,7,106,335,63,107,0,0
2852,1516,205,1624,549,65,11,7,108,344,64,107,0,0
2853,1502,211,1613,559,65,11,7,111,348,65,107,0,0
2854,1480,218,1598,584,65,11,7,118,366,66,107,0,0
2855,1466,220,1588,595,65,11,7,122,375,67,107,0,0
2856,1449,228,1576,617,65,11,7,127,389,68,107,0,0
2857,1434,237,1569,649,65,11,7,135,412,69,107,0,0
2858,1414,247,1552,665,65,11,7,138,418,70,107,0,0
2859,1374,260,1521,689,65,11,7,147,429,71,107,0,0
2860,1346,267,1497,704,65,11,7,151,437,72,107,0,0
2861,1318,279,1473,724,65,11,7,155,445,73,107,0,0
2862,1278,297,1445,776,65,11,7,167,479,74,107,0,0
2863,1238,302,1410,795,65,11,7,172,493,75,107,0,0
2864,1175,304,1356,813,65,11,7,181,509,76,107,0,0
2865,1117,311,1310,836,65,11,7,193,525,77,107,0,0
2866,1059,319,1260,854,65,11,7,201,535,78,107,0,0
2867,982,330,1203,897,65,11,7,221,567,79,107,0,0
2868,895,340,1121,918,65,11,7,226,578,80,107,0,0
2869,813,350,1040,924,65,11,7,227,574,81,107,0,0
2870,737,367,971,932,65,11,7,234,565,82,107,0,0
2871,655,358,889,921,65,11,7,234,563,83,107,0,0
2872,574,359,806,912,65,11,7,232,553,84,107,0,0
2873,516,361,749,904,65,11,7,233,543,85,107,0,0
2874,420,359,647,895,65,11,7,227,536,86,107,0,0
2875,334,359,571,893,65,11,7,237,534,87,107,0,0
2876,281,356,510,868,65,11,7,229,512,88,107,0,0
2877,237,347,457,846,65,11,7,220,499,89,107,0,0
2878,209,352,421,827,65,11,7,212,475,90,107,0,0
2879,164,345,370,807,65,11,7,206,462,91,107,0,0
2880,107,343,311,799,65,11,7,204,456,92,107,0,0
2881,80,340,283,792,65,11,7,203,452,93,107,0,0
2882,62,332,247,753,65,11,7,185,421,94,107,0,0
2883,55,340,229,735,65,11,7,174,395,95,107,0,0
2884,39,333,208,714,65,11,7,169,381,96,107,0,0
2885,11,329,173,698,65,11,7,162,369,97,107,0,0
2886,0,321,152,693,65,11,7,152,372,98,107,0,0
2887,0,313,132,675,65,11,7,132,362,99,107,0,0
2888,0,311,117,652,65,11,7,117,341,100,107,0,0
2889,0,310,115,641,65,11,7,115,331,101,107,0,0
2890,0,327,97,628,65,11,7,97,301,102,107,0,0
2891,0,337,80,621,65,11,7,80,284,103,107,0,0
2892,0,336,68,612,65,11,7,68,276,104,107,0,0
2893,0,328,58,592,65,11,7,58,264,105,107,0,0
2894,0,345,52,582,65,11,7,52,237,106,107,0,0
2895,0,347,35,570,65,11,7,35,223,107,107,1,0
3917,1,349,91,674,70,11,7,90,325,0,74,0,1
3918,0,355,89,682,70,11,7,89,327,1,74,0,0
3919,7,321,113,705,70,11,7,106,384,2,74,0,0
3920,22,323,135,726,70,11,7,113,403,3,74,0,0
3921,68,323,191,738,70,11,7,123,415,4,74,0,0
3922,117,325,247,751,70,11,7,130,426,5,74,0,0
3923,150,311,295,778,70,11,7,145,467,6,74,0,0
3924,200,315,356,799,70,11,7,156,484,7,74,0,0
3925,248,319,411,817,70,11,7,163,498,8,74,0,0
3926,330,316,506,827,70,11,7,176,511,9,74,0,0
3927,408,316,594,838,70,11,7,186,522,10,74,0,0
3928,472,315,668,862,70,11,7,196,547,11,74,0,0
3929,575,323,784,883,70,11,7,209,560,12,74,0,0
3930,670,318,886,893,70,11,7,216,575,13,74,0,0
3931,786,312,1013,893,70,11,7,227,581,14,74,0,0
3932,894,311,1120,877,70,11,7,226,566,15,74,0,0
3933,996,297,1223,874,70,11,7,227,577,16,74,0,0
3934,1075,280,1314,866,70,11,7,239,586,17,74,0,0
3935,1186,280,1412,841,70,11,7,226,561,18,74,0,0
3936,1288,270,1511,815,70,11,7,223,545,19,74,0,0
3937,1356,267,1569,785,70,11,7,213,518,20,74,0,0
3938,1396,248,1595,741,70,11,7,199,493,21,74,0,0
3939,1426,244,1612,709,70,11,7,186,465,22,74,0,0
3940,1471,228,1644,667,70,11,7,173,439,23,74,0,0
3941,1503,220,1670,649,70,11,7,167,429,24,74,0,0
3942,1522,214,1677,619,70,11,7,155,405,25,74,0,0
3943,1535,198,1680,583,70,11,7,145,385,26,74,0,0
3944,1543,192,1683,566,70,11,7,140,374,27,74,0,0
3945,1565,184,1695,533,70,11,7,130,349,28,74,0,0
3946,1577,180,1702,521,70,11,7,125,341,29,74,0,0
3947,1588,179,1708,512,70,11,7,120,333,30,74,0,0
3948,1598,173,1708,482,70,11,7,110,309,31,74,0,0
3949,1605,173,1710,469,70,11,7,105,296,32,74,0,0
3950,1615,167,1712,445,70,11,7,97,278,33,74,0,0
3951,1622,159,1717,433,70,11,7,95,274,34,74,0,0
3952,1622,159,1714,426,70,11,7,92,267,35,74,0,0
3953,1624,152,1711,405,70,11,7,87,253,36,74,0,0
3954,1626,149,1712,395,70,11,7,86,246,37,74,0,0
3955,1629,143,1711,377,70,11,7,82,234,38,74,0,0
3956,1625,136,1707,370,70,11,7,82,234,39,74,0,0
3957,1625,134,1703,361,70,11,7,78,227,40,74,0,0
3958,1626,131,1700,347,70,11,7,74,216,41,74,0,0
3959,1627,128,1699,340,70,11,7,72,212,42,74,0,0
3960,1629,126,1699,329,70,11,7,70,203,43,74,0,0
3961,1629,122,1697,320,70,11,7,68,198,44,74,0,0
3962,1626,120,1692,315,70,11,7,66,195,45,74,0,0
3963,1625,116,1690,307,70,11,7,65,191,46,74,0,0
3964,1628,118,1690,301,70,11,7,62,183,47,74,0,0
3965,1628,114,1690,296,70,11,7,62,182,48,74,0,0
3966,1628,111,1689,291,70,11,7,61,180,49,74,0,0
3967,1627,112,1685,287,70,11,7,58,175,50,74,0,0
3968,1627,110,1683,279,70,11,7,56,169,51,74,0,0
3969,1628,108,1682,273,70,11,7,54,165,52,74,0,0
3970,1630,108,1683,269,70,11,7,53,161,53,74,0,0
3971,1631,105,1683,263,70,11,7,52,158,54,74,0,0
3972,1631,105,1682,259,70,11,7,51,154,55,74,0,0
3973,1632,103,1680,250,70,11,7,48,147,56,74,0,0
3974,1632,99,1681,247,70,11,7,49,148,57,74,0,0
3975,1634,100,1681,244,70,11,7,47,144,58,74,0,0
3976,1637,95,1683,238,70,11,7,46,143,59,74,0,0
3977,1638,96,1684,238,70,11,7,46,142,60,74,0,0
3978,1639,94,1684,233,70,11,7,45,139,61,74,0,0
3979,1641,91,1686,232,70,11,7,45,141,62,74,0,0
3980,1643,93,1686,229,70,11,7,43,136,63,74,0,0
3981,1647,94,1687,222,70,11,7,40,128,64,74,0,0
3982,1649,92,1689,220,70,11,7,40,128,65,74,0,0
3983,1650,93,1688,213,70,11,7,38,120,66,74,0,0
3984,1652,92,1689,212,70,11,7,37,120,67,74,0,0
3985,1653,91,1690,212,70,11,7,37,121,68,74,0,0
3986,1654,89,1692,209,70,11,7,38,120,69,74,0,0
3987,1655,89,1692,207,70,11,7,37,118,70,74,0,0
3988,1654,88,1689,203,70,11,7,35,115,71,74,0,0
3989,1653,85,1689,204,70,11,7,36,119,72,74,0,0
3990,1652,86,1688,203,70,11,7,36,117,73,74,0,0
3991,1652,85,1687,198,70,11,7,35,113,74,74,1,0
3933,1147,387,1213,460,71,11,7,66,73,0,0,0,0
4440,15,228,54,489,73,11,7,39,261,0,82,0,1
4441,19,227,62,500,73,11,7,43,273,1,82,0,0
4442,29,231,75,501,73,11,7,46,270,2,82,0,0
4443,44,234,96,509,73,11,7,52,275,3,82,0,0
4444,55,232,110,511,73,11,7,55,279,4,82,0,0
4445,59,235,121,530,73,11,7,62,295,5,82,0,0
4446,69,238,137,547,73,11,7,68,309,6,82,0,0
4447,81,237,153,551,73,11,7,72,314,7,82,0,0
4448,104,241,183,557,73,11,7,79,316,8,82,0,0
4449,120,235,207,565,73,11,7,87,330,9,82,0,0
4450,131,230,227,591,73,11,7,96,361,10,82,0,0
4451,145,224,252,617,73,11,7,107,393,11,82,0,0
4452,164,229,276,624,73,11,7,112,395,12,82,0,0
4453,203,236,324,637,73,11,7,121,401,13,82,0,0
4454,228,234,355,645,73,11,7,127,411,14,82,0,0
4455,247,230,388,685,73,11,7,141,455,15,82,0,0
4456,281,245,430,713,73,11,7,149,468,16,82,0,0
4457,314,244,469,721,73,11,7,155,477,17,82,0,0
4458,373,256,535,732,73,11,7,162,476,18,82,0,0
4459,423,258,595,752,73,11,7,172,494,19,82,0,0
4460,464,262,645,781,73,11,7,181,519,20,82,0,0
4461,527,267,723,818,73,11,7,196,551,21,82,0,0
4462,598,270,804,850,73,11,7,206,580,22,82,0,0
4463,695,279,907,867,73,11,7,212,588,23,82,0,0
4464,785,279,1008,871,73,11,7,223,592,24,82,0,0
4465,885,272,1106,869,73,11,7,221,597,25,82,0,0
4466,991,255,1222,860,73,11,7,231,605,26,82,0,0
4467,1075,246,1293,819,73,11,7,218,573,27,82,0,0
4468,1170,240,1389,806,73,11,7,219,566,28,82,0,0
4469,1229,233,1450,798,73,11,7,221,565,29,82,0,0
4470,1264,210,1473,752,73,11,7,209,542,30,82,0,0
4471,1290,198,1485,715,73,11,7,195,517,31,82,0,0
4472,1324,192,1502,674,73,11,7,178,482,32,82,0,0
4473,1356,185,1522,640,73,11,7,166,455,33,82,0,0
4474,1375,181,1536,621,73,11,7,161,440,34,82,0,0
4475,1383,164,1532,577,73,11,7,149,413,35,82,0,0
4476,1389,164,1525,548,73,11,7,136,384,36,82,0,0
4477,1402,155,1532,524,73,11,7,130,369,37,82,0,0
4478,1419,146,1542,498,73,11,7,123,352,38,82,0,0
4479,1434,145,1552,484,73,11,7,118,339,39,82,0,0
4480,1441,138,1556,472,73,11,7,115,334,40,82,0,0
4481,1451,140,1559,453,73,11,7,108,313,41,82,0,0
4482,1464,135,1570,444,73,11,7,106,309,42,82,0,0
4483,1480,127,1580,422,73,11,7,100,295,43,82,0,0
4484,1492,131,1587,410,73,11,7,95,279,44,82,0,0
4485,1498,121,1590,395,73,11,7,92,274,45,82,0,0
4486,1502,119,1591,383,73,11,7,89,264,46,82,0,0
4487,1510,116,1596,374,73,11,7,86,258,47,82,0,0
4488,1522,116,1603,361,73,11,7,81,245,48,82,0,0
4489,1529,116,1609,361,73,11,7,80,245,49,82,0,0
4490,1533,113,1608,344,73,11,7,75,231,50,82,0,0
4491,1536,110,1609,337,73,11,7,73,227,51,82,0,0
4492,1540,111,1612,331,73,11,7,72,220,52,82,0,0
4493,1546,109,1616,321,73,11,7,70,212,53,82,0,0
4494,1552,110,1620,319,73,11,7,68,209,54,82,0,0
4495,1553,105,1620,309,73,11,7,67,204,55,82,0,0
4496,1557,104,1622,302,73,11,7,65,198,56,82,0,0
4497,1560,107,1621,293,73,11,7,61,186,57,82,0,0
4498,1563,106,1622,286,73,11,7,59,180,58,82,0,0
4499,1567,106,1626,283,73,11,7,59,177,59,82,0,0
4500,1570,106,1626,277,73,11,7,56,171,60,82,0,0
4501,1570,96,1628,273,73,11,7,58,177,61,82,0,0
4502,1571,96,1627,268,73,11,7,56,172,62,82,0,0
4503,1576,94,1631,264,73,11,7,55,170,63,82,0,0
4504,1579,92,1634,260,73,11,7,55,168,64,82,0,0
4505,1582,91,1635,254,73,11,7,53,163,65,82,0,0
4506,1583,91,1633,248,73,11,7,50,157,66,82,0,0
4507,1583,92,1633,246,73,11,7,50,154,67,82,0,0
4508,1586,91,1635,242,73,11,7,49,151,68,82,0,0
4509,1587,88,1636,237,73,11,7,49,149,69,82,0,0
4510,1589,90,1636,234,73,11,7,47,144,70,82,0,0
4511,1592,89,1637,229,73,11,7,45,140,71,82,0,0
4512,1593,89,1637,226,73,11,7,44,137,72,82,0,0
4513,1595,88,1639,226,73,11,7,44,138,73,82,0,0
4514,1597,83,1642,224,73,11,7,45,141,74,82,0,0
4515,1599,84,1643,220,73,11,7,44,136,75,82,0,0
4516,1601,72,1646,213,73,11,7,45,141,76,82,0,0
4517,1602,72,1647,211,73,11,7,45,139,77,82,0,0
4518,1605,77,1648,210,73,11,7,43,133,78,82,0,0
4519,1609,82,1648,206,73,11,7,39,124,79,82,0,0
4520,1613,85,1651,205,73,11,7,38,120,80,82,0,0
4521,1616,85,1651,199,73,11,7,35,114,81,82,0,0
4522,1617,83,1652,196,73,11,7,35,113,82,82,1,0
4898,1647,78,1682,191,75,11,7,35,113,0,65,0,0
4899,1646,80,1681,193,75,11,7,35,113,1,65,0,0
4901,1642,82,1677,197,75,11,7,35,115,0,65,0,1
4902,1641,82,1677,199,75,11,7,36,117,1,65,0,0
4903,1640,82,1677,203,75,11,7,37,121,2,65,0,0
4904,1638,86,1675,207,75,11,7,37,121,3,65,0,0
4905,1637,84,1674,206,75,11,7,37,122,4,65,0,0
4906,1635,83,1673,210,75,11,7,38,127,5,65,0,0
4907,1636,85,1674,210,75,11,7,38,125,6,65,0,0
4908,1635,86,1674,214,75,11,7,39,128,7,65,0,0
4909,1634,90,1673,216,75,11,7,39,126,8,65,0,0
4910,1632,87,1673,221,75,11,7,41,134,9,65,0,0
4911,1632,90,1674,225,75,11,7,42,135,10,65,0,0
4912,1633,89,1676,227,75,11,7,43,138,11,65,0,0
4913,1633,92,1676,232,75,11,7,43,140,12,65,0,0
4914,1633,91,1678,234,75,11,7,45,143,13,65,0,0
4915,1634,91,1680,238,75,11,7,46,147,14,65,0,0
4916,1638,97,1683,242,75,11,7,45,145,15,65,0,0
4917,1640,97,1687,245,75,11,7,47,148,16,65,0,0
4918,1640,100,1688,252,75,11,7,48,152,17,65,0,0
4919,1640,100,1689,256,75,11,7,49,156,18,65,0,0
4920,1640,102,1690,263,75,11,7,50,161,19,65,0,0
4921,1642,105,1693,269,75,11,7,51,164,20,65,0,0
4922,1641,107,1694,276,75,11,7,53,169,21,65,0,0
4923,1640,111,1693,278,75,11,7,53,167,22,65,0,0
4924,1638,111,1694,287,75,11,7,56,176,23,65,0,0
4925,1638,113,1695,296,75,11,7,57,183,24,65,0,0
4926,1638,112,1698,302,75,11,7,60,190,25,65,0,0
4927,1636,115,1698,309,75,11,7,62,194,26,65,0,0
4928,1634,115,1697,310,75,11,7,63,195,27,65,0,0
4929,1633,118,1697,319,75,11,7,64,201,28,65,0,0
4930,1633,119,1700,327,75,11,7,67,208,29,65,0,0
4931,1633,124,1701,338,75,11,7,68,214,30,65,0,0
4932,1632,129,1701,343,75,11,7,69,214,31,65,0,0
4933,1630,129,1702,353,75,11,7,72,224,32,65,0,0
4934,1629,132,1705,366,75,11,7,76,234,33,65,0,0
4935,1630,133,1707,373,75,11,7,77,240,34,65,0,0
4936,1627,140,1707,387,75,11,7,80,247,35,65,0,0
4937,1621,139,1703,393,75,11,7,82,254,36,65,0,0
4938,1615,144,1701,409,75,11,7,86,265,37,65,0,0
4939,1613,151,1701,421,75,11,7,88,270,38,65,0,0
4940,1609,153,1701,436,75,11,7,92,283,39,65,0,0
4941,1602,158,1698,449,75,11,7,96,291,40,65,0,0
4942,1597,163,1695,457,75,11,7,98,294,41,65,0,0
4943,1589,171,1693,482,75,11,7,104,311,42,65,0,0
4944,1584,174,1692,494,75,11,7,108,320,43,65,0,0
4945,1575,181,1686,509,75,11,7,111,328,44,65,0,0
4946,1562,179,1680,527,75,11,7,118,348,45,65,0,0
4947,1554,185,1678,552,75,11,7,124,367,46,65,0,0
4948,1546,194,1678,583,75,11,7,132,389,47,65,0,0
4949,1537,198,1671,594,75,11,7,134,396,48,65,0,0
4950,1521,211,1663,632,75,11,7,142,421,49,65,0,0
4951,1506,216,1654,650,75,11,7,148,434,50,65,0,0
4952,1481,228,1644,702,75,11,7,163,474,51,65,0,0
4953,1462,241,1635,736,75,11,7,173,495,52,65,0,0
4954,1438,257,1620,769,75,11,7,182,512,53,65,0,0
4955,1408,272,1601,812,75,11,7,193,540,54,65,0,0
4956,1376,281,1585,858,75,11,7,209,577,55,65,0,0
4957,1339,313,1567,928,75,11,7,228,615,56,65,0,0
4958,1322,331,1558,958,75,11,7,236,627,57,65,0,0
4959,1271,366,1528,1039,75,11,7,257,673,58,65,0,0
4960,1238,397,1495,1066,75,11,7,257,669,59,65,0,0
4961,1202,434,1457,1080,75,11,7,255,646,60,65,0,0
4962,1162,494,1408,1080,75,11,7,246,586,61,65,0,0
4963,1106,554,1341,1080,75,11,7,235,526,62,65,0,0
4964,1032,677,1234,1080,75,11,7,202,403,63,65,0,0
4965,918,802,1091,1080,75,11,7,173,278,64,65,0,0
4966,881,852,1035,1080,75,11,7,154,228,65,65,1,0
4916,1,466,59,691,76,11,7,58,225,0,27,0,1
4917,0,433,65,701,76,11,7,65,268,1,27,0,0
4918,11,381,94,701,76,11,7,83,320,2,27,0,0
4919,19,371,108,708,76,11,7,89,337,3,27,0,0
4920,22,372,116,724,76,11,7,94,352,4,27,0,0
4921,34,379,136,747,76,11,7,102,368,5,27,0,0
4922,46,384,154,763,76,11,7,108,379,6,27,0,0
4923,71,386,184,769,76,11,7,113,383,7,27,0,0
4924,94,394,216,787,76,11,7,122,393,8,27,0,0
4925,106,399,232,797,76,11,7,126,398,9,27,0,0
4926,122,404,260,833,76,11,7,138,429,10,27,0,0
4927,147,419,292,854,76,11,7,145,435,11,27,0,0
4928,172,428,321,864,76,11,7,149,436,12,27,0,0
4929,214,438,375,886,76,11,7,161,448,13,27,0,0
4930,242,445,412,907,76,11,7,170,462,14,27,0,0
4931,257,453,439,947,76,11,7,182,494,15,27,0,0
4932,298,467,495,991,76,11,7,197,524,16,27,0,0
4933,329,480,528,1007,76,11,7,199,527,17,27,0,0
4934,397,497,608,1023,76,11,7,211,526,18,27,0,0
4935,451,505,676,1053,76,11,7,225,548,19,27,0,0
4936,488,522,714,1066,76,11,7,226,544,20,27,0,0
4937,547,535,773,1078,76,11,7,226,543,21,27,0,0
4938,614,564,830,1080,76,11,7,216,516,22,27,0,0
4939,701,593,909,1079,76,11,7,208,486,23,27,0,0
4940,789,619,990,1080,76,11,7,201,461,24,27,0,0
4941,882,645,1076,1078,76,11,7,194,433,25,27,0,0
4942,981,674,1168,1078,76,11,7,187,404,26,27,0,0
4943,1041,691,1225,1080,76,11,7,184,389,27,27,1,0
4943,1121,756,1352,1068,77,11,7,231,312,0,0,0,0
5272,1635,86,1670,212,79,11,7,35,126,0,92,0,1
5273,1635,86,1670,213,79,11,7,35,127,1,92,0,0
5274,1633,84,1670,215,79,11,7,37,131,2,92,0,0
5275,1631,85,1670,219,79,11,7,39,134,3,92,0,0
5276,1631,88,1669,221,79,11,7,38,133,4,92,0,0
5277,1627,90,1666,221,79,11,7,39,131,5,92,0,0
5278,1626,94,1664,223,79,11,7,38,129,6,92,0,0
5279,1624,96,1662,225,79,11,7,38,129,7,92,0,0
5280,1622,97,1660,226,79,11,7,38,129,8,92,0,0
5281,1618,99,1657,229,79,11,7,39,130,9,92,0,0
5282,1613,96,1653,233,79,11,7,40,137,10,92,0,0
5283,1607,92,1650,236,79,11,7,43,144,11,92,0,0
5284,1604,91,1647,239,79,11,7,43,148,12,92,0,0
5285,1602,91,1646,242,79,11,7,44,151,13,92,0,0
5286,1600,90,1646,244,79,11,7,46,154,14,92,0,0
5287,1599,92,1645,248,79,11,7,46,156,15,92,0,0
5288,1597,94,1643,250,79,11,7,46,156,16,92,0,0
5289,1596,94,1642,253,79,11,7,46,159,17,92,0,0
5290,1595,99,1641,259,79,11,7,46,160,18,92,0,0
5291,1596,98,1644,262,79,11,7,48,164,19,92,0,0
5292,1597,99,1646,266,79,11,7,49,167,20,92,0,0
5293,1598,102,1646,269,79,11,7,48,167,21,92,0,0
5294,1595,101,1645,272,79,11,7,50,171,22,92,0,0
5295,1591,99,1644,279,79,11,7,53,180,23,92,0,0
5296,1590,105,1643,282,79,11,7,53,177,24,92,0,0
5297,1590,105,1643,284,79,11,7,53,179,25,92,0,0
5298,1587,108,1642,290,79,11,7,55,182,26,92,0,0
5299,1583,108,1640,297,79,11,7,57,189,27,92,0,0
5300,1580,108,1637,295,79,11,7,57,187,28,92,0,0
5301,1574,103,1635,304,79,11,7,61,201,29,92,0,0
5302,1572,109,1634,310,79,11,7,62,201,30,92,0,0
5303,1571,111,1634,313,79,11,7,63,202,31,92,0,0
5304,1571,113,1636,321,79,11,7,65,208,32,92,0,0
5305,1568,114,1635,327,79,11,7,67,213,33,92,0,0
5306,1564,111,1633,331,79,11,7,69,220,34,92,0,0
5307,1561,112,1633,339,79,11,7,72,227,35,92,0,0
5308,1562,112,1636,347,79,11,7,74,235,36,92,0,0
5309,1562,111,1639,353,79,11,7,77,242,37,92,0,0
5310,1559,118,1636,360,79,11,7,77,242,38,92,0,0
5311,1553,121,1632,367,79,11,7,79,246,39,92,0,0
5312,1548,123,1628,374,79,11,7,80,251,40,92,0,0
5313,1544,127,1626,388,79,11,7,82,261,41,92,0,0
5314,1541,126,1626,394,79,11,7,85,268,42,92,0,0
5315,1538,128,1625,402,79,11,7,87,274,43,92,0,0
5316,1535,135,1623,414,79,11,7,88,279,44,92,0,0
5317,1529,138,1619,421,79,11,7,90,283,45,92,0,0
5318,1522,141,1616,436,79,11,7,94,295,46,92,0,0
5319,1520,144,1619,455,79,11,7,99,311,47,92,0,0
5320,1521,146,1623,467,79,11,7,102,321,48,92,0,0
5321,1516,151,1622,481,79,11,7,106,330,49,92,0,0
5322,1507,155,1616,494,79,11,7,109,339,50,92,0,0
5323,1501,156,1612,503,79,11,7,111,347,51,92,0,0
5324,1496,164,1611,527,79,11,7,115,363,52,92,0,0
5325,1491,163,1612,549,79,11,7,121,386,53,92,0,0
5326,1479,167,1604,559,79,11,7,125,392,54,92,0,0
5327,1468,173,1597,576,79,11,7,129,403,55,92,0,0
5328,1461,180,1590,587,79,11,7,129,407,56,92,0,0
5329,1446,191,1583,619,79,11,7,137,428,57,92,0,0
5330,1431,202,1575,651,79,11,7,144,449,58,92,0,0
5331,1421,202,1568,661,79,11,7,147,459,59,92,0,0
5332,1383,212,1540,684,79,11,7,157,472,60,92,0,0
5333,1348,226,1511,708,79,11,7,163,482,61,92,0,0
5334,1317,218,1487,728,79,11,7,170,510,62,92,0,0
5335,1274,233,1454,771,79,11,7,180,538,63,92,0,0
5336,1224,242,1412,804,79,11,7,188,562,64,92,0,0
5337,1161,243,1352,819,79,11,7,191,576,65,92,0,0
5338,1086,257,1284,832,79,11,7,198,575,66,92,0,0
5339,1019,258,1217,841,79,11,7,198,583,67,92,0,0
5340,920,265,1123,855,79,11,7,203,590,68,92,0,0
5341,840,273,1054,859,79,11,7,214,586,69,92,0,0
5342,754,284,965,863,79,11,7,211,579,70,92,0,0
5343,645,278,864,864,79,11,7,219,586,71,92,0,0
5344,562,283,783,840,79,11,7,221,557,72,92,0,0
5345,493,280,703,819,79,11,7,210,539,73,92,0,0
5346,436,277,644,798,79,11,7,208,521,74,92,0,0
5347,387,279,589,779,79,11,7,202,500,75,92,0,0
5348,312,273,509,768,79,11,7,197,495,76,92,0,0
5349,258,284,456,764,79,11,7,198,480,77,92,0,0
5350,212,278,400,733,79,11,7,188,455,78,92,0,0
5351,178,247,371,720,79,11,7,193,473,79,92,0,0
5352,157,269,340,709,79,11,7,183,440,80,92,0,0
5353,112,279,286,697,79,11,7,174,418,81,92,0,0
5354,73,286,243,691,79,11,7,170,405,82,92,0,0
5355,51,289,213,675,79,11,7,162,386,83,92,0,0
5356,28,284,179,653,79,11,7,151,369,84,92,0,0
5357,16,286,161,637,79,11,7,145,351,85,92,0,0
5358,3,285,141,617,79,11,7,138,332,86,92,0,0
5359,0,282,119,613,79,11,7,119,331,87,92,0,0
5360,0,277,105,611,79,11,7,105,334,88,92,0,0
5361,0,275,87,588,79,11,7,87,313,89,92,0,0
5362,0,283,74,575,79,11,7,74,292,90,92,0,0
5363,0,279,70,569,79,11,7,70,290,91,92,0,0
5364,0,279,46,558,79,11,7,46,279,92,92,1,0
5475,1648,99,1684,220,81,11,7,36,121,0,81,0,0
5477,1645,101,1681,220,81,11,7,36,119,0,81,0,1
5478,1645,101,1680,219,81,11,7,35,118,1,81,0,0
5479,1643,103,1679,225,81,11,7,36,122,2,81,0,0
5480,1640,105,1678,231,81,11,7,38,126,3,81,0,0
5481,1639,105,1678,233,81,11,7,39,128,4,81,0,0
5482,1636,106,1677,236,81,11,7,41,130,5,81,0,0
5483,1635,104,1676,235,81,11,7,41,131,6,81,0,0
5484,1633,101,1677,238,81,11,7,44,137,7,81,0,0
5485,1632,106,1675,241,81,11,7,43,135,8,81,0,0
5486,1629,112,1672,247,81,11,7,43,135,9,81,0,0
5487,1626,110,1671,250,81,11,7,45,140,10,81,0,0
5488,1623,115,1668,255,81,11,7,45,140,11,81,0,0
5489,1623,116,1668,255,81,11,7,45,139,12,81,0,0
5490,1622,121,1667,261,81,11,7,45,140,13,81,0,0
5491,1618,122,1665,268,81,11,7,47,146,14,81,0,0
5492,1613,123,1661,271,81,11,7,48,148,15,81,0,0
5493,1609,122,1659,277,81,11,7,50,155,16,81,0,0
5494,1607,121,1658,280,81,11,7,51,159,17,81,0,0
5495,1603,121,1655,283,81,11,7,52,162,18,81,0,0
5496,1600,127,1652,288,81,11,7,52,161,19,81,0,0
5497,1594,126,1650,296,81,11,7,56,170,20,81,0,0
5498,1592,125,1647,295,81,11,7,55,170,21,81,0,0
5499,1589,128,1646,306,81,11,7,57,178,22,81,0,0
5500,1589,131,1647,310,81,11,7,58,179,23,81,0,0
5501,1586,130,1646,318,81,11,7,60,188,24,81,0,0
5502,1584,135,1644,323,81,11,7,60,188,25,81,0,0
5503,1579,136,1641,329,81,11,7,62,193,26,81,0,0
5504,1576,138,1639,339,81,11,7,63,201,27,81,0,0
5505,1576,145,1640,346,81,11,7,64,201,28,81,0,0
5506,1574,145,1639,352,81,11,7,65,207,29,81,0,0
5507,1568,144,1638,366,81,11,7,70,222,30,81,0,0
5508,1563,144,1635,374,81,11,7,72,230,31,81,0,0
5509,1559,147,1631,379,81,11,7,72,232,32,81,0,0
5510,1556,153,1630,394,81,11,7,74,241,33,81,0,0
5511,1555,157,1630,404,81,11,7,75,247,34,81,0,0
5512,1550,162,1627,414,81,11,7,77,252,35,81,0,0
5513,1543,164,1624,429,81,11,7,81,265,36,81,0,0
5514,1543,165,1627,437,81,11,7,84,272,37,81,0,0
5515,1539,176,1624,452,81,11,7,85,276,38,81,0,0
5516,1538,183,1626,468,81,11,7,88,285,39,81,0,0
5517,1534,186,1625,479,81,11,7,91,293,40,81,0,0
5518,1529,196,1622,495,81,11,7,93,299,41,81,0,0
5519,1522,201,1619,511,81,11,7,97,310,42,81,0,0
5520,1510,205,1615,536,81,11,7,105,331,43,81,0,0
5521,1496,214,1607,559,81,11,7,111,345,44,81,0,0
5522,1484,215,1601,575,81,11,7,117,360,45,81,0,0
5523,1459,226,1582,594,81,11,7,123,368,46,81,0,0
5524,1434,233,1564,616,81,11,7,130,383,47,81,0,0
5525,1416,239,1549,628,81,11,7,133,389,48,81,0,0
5526,1388,261,1529,676,81,11,7,141,415,49,81,0,0
5527,1359,269,1507,701,81,11,7,148,432,50,81,0,0
5528,1322,279,1473,717,81,11,7,151,438,51,81,0,0
5529,1272,298,1432,754,81,11,7,160,456,52,81,0,0
5530,1228,304,1391,775,81,11,7,163,471,53,81,0,0
5531,1157,317,1339,836,81,11,7,182,519,54,81,0,0
5532,1093,336,1279,864,81,11,7,186,528,55,81,0,0
5533,1006,334,1194,873,81,11,7,188,539,56,81,0,0
5534,912,348,1111,883,81,11,7,199,535,57,81,0,0
5535,807,348,1007,888,81,11,7,200,540,58,81,0,0
5536,715,351,918,884,81,11,7,203,533,59,81,0,0
5537,648,354,855,877,81,11,7,207,523,60,81,0,0
5538,544,351,746,865,81,11,7,202,514,61,81,0,0
5539,461,352,665,854,81,11,7,204,502,62,81,0,0
5540,390,347,580,812,81,11,7,190,465,63,81,0,0
5541,337,336,522,789,81,11,7,185,453,64,81,0,0
5542,310,344,489,773,81,11,7,179,429,65,81,0,0
5543,263,340,436,745,81,11,7,173,405,66,81,0,0
5544,216,333,384,733,81,11,7,168,400,67,81,0,0
5545,186,327,354,721,81,11,7,168,394,68,81,0,0
5546,149,310,308,689,81,11,7,159,379,69,81,0,0
5547,133,312,282,665,81,11,7,149,353,70,81,0,0
5548,109,310,254,649,81,11,7,145,339,71,81,0,0
5549,70,303,210,634,81,11,7,140,331,72,81,0,0
5550,48,307,181,622,81,11,7,133,315,73,81,0,0
5551,23,304,149,604,81,11,7,126,300,74,81,0,0
5552,9,301,130,592,81,11,7,121,291,75,81,0,0
5553,1,306,116,583,81,11,7,115,277,76,81,0,0
5554,0,298,92,573,81,11,7,92,275,77,81,0,0
5555,0,306,77,570,81,11,7,77,264,78,81,0,0
5556,0,319,66,569,81,11,7,66,250,79,81,0,0
5557,0,312,52,551,81,11,7,52,239,80,81,0,0
5558,0,292,49,543,81,11,7,49,251,81,81,1,0
576,403,522,576,922,1,11,8,173,400,0,8,0,0
577,430,516,647,1019,1,11,8,217,503,1,8,0,0
578,437,515,672,1056,1,11,8,235,541,2,8,0,0
579,434,553,665,1079,1,11,8,231,526,3,8,0,0
580,415,590,637,1080,1,11,8,222,490,4,8,0,0
581,382,626,593,1080,1,11,8,211,454,5,8,0,0
582,388,716,567,1080,1,11,8,179,364,6,8,0,0
583,368,771,531,1075,1,11,8,163,304,7,8,0,0
584,364,810,511,1080,1,11,8,147,270,8,8,0,0
1838,1434,113,1479,262,3,11,8,45,149,0,15,0,0
1839,1438,113,1484,263,3,11,8,46,150,1,15,0,0
1840,1449,113,1492,255,3,11,8,43,142,2,15,0,0
1841,1460,109,1505,255,3,11,8,45,146,3,15,0,0
1842,1468,111,1510,248,3,11,8,42,137,4,15,0,0
1843,1472,110,1515,250,3,11,8,43,140,5,15,0,0
1844,1473,112,1517,251,3,11,8,44,139,6,15,0,0
1845,1472,109,1518,252,3,11,8,46,143,7,15,0,0
1846,1469,111,1517,256,3,11,8,48,145,8,15,0,0
1847,1463,114,1511,258,3,11,8,48,144,9,15,0,0
1848,1459,114,1507,259,3,11,8,48,145,10,15,0,0
1849,1449,115,1498,261,3,11,8,49,146,11,15,0,0
1850,1445,117,1495,265,3,11,8,50,148,12,15,0,0
1851,1436,119,1488,268,3,11,8,52,149,13,15,0,0
1852,1422,119,1475,270,3,11,8,53,151,14,15,0,0
1853,1419,120,1473,271,3,11,8,54,151,15,15,0,0
2108,1418,121,1466,269,4,11,8,48,148,0,12,0,0
2109,1426,118,1474,268,4,11,8,48,150,1,12,0,0
2110,1440,115,1488,261,4,11,8,48,146,2,12,0,0
2111,1455,113,1504,261,4,11,8,49,148,3,12,0,0
2112,1467,117,1510,248,4,11,8,43,131,4,12,0,0
2113,1471,115,1516,246,4,11,8,45,131,5,12,0,0
2114,1470,113,1516,249,4,11,8,46,136,6,12,0,0
2115,1469,113,1515,249,4,11,8,46,136,7,12,0,0
2116,1457,113,1505,251,4,11,8,48,138,8,12,0,0
2117,1451,115,1500,255,4,11,8,49,140,9,12,0,0
2118,1444,112,1493,254,4,11,8,49,142,10,12,0,0
2119,1438,117,1488,261,4,11,8,50,144,11,12,0,0
2120,1437,117,1487,261,4,11,8,50,144,12,12,0,0
2500,1571,114,1606,246,5,11,8,35,132,0,63,0,1
2501,1558,112,1594,249,5,11,8,36,137,1,63,0,0
2502,1547,108,1587,252,5,11,8,40,144,2,63,0,0
2503,1538,114,1579,257,5,11,8,41,143,3,63,0,0
2504,1532,116,1576,264,5,11,8,44,148,4,63,0,0
2505,1526,112,1573,268,5,11,8,47,156,5,63,0,0
2506,1519,112,1567,268,5,11,8,48,156,6,63,0,0
2507,1514,116,1563,270,5,11,8,49,154,7,63,0,0
2508,1509,116,1560,273,5,11,8,51,157,8,63,0,0
2509,1503,116,1558,282,5,11,8,55,166,9,63,0,0
2510,1498,115,1555,287,5,11,8,57,172,10,63,0,0
2511,1492,113,1552,290,5,11,8,60,177,11,63,0,0
2512,1487,113,1550,295,5,11,8,63,182,12,63,0,0
2513,1481,116,1546,301,5,11,8,65,185,13,63,0,0
2514,1474,116,1542,307,5,11,8,68,191,14,63,0,0
2515,1470,122,1534,297,5,11,8,64,175,15,63,0,0
2516,1463,128,1530,306,5,11,8,67,178,16,63,0,0
2517,1456,133,1523,312,5,11,8,67,179,17,63,0,0
2518,1446,131,1518,323,5,11,8,72,192,18,63,0,0
2519,1440,130,1513,324,5,11,8,73,194,19,63,0,0
2520,1437,135,1511,328,5,11,8,74,193,20,63,0,0
2521,1436,139,1511,330,5,11,8,75,191,21,63,0,0
2522,1425,136,1505,342,5,11,8,80,206,22,63,0,0
2523,1416,141,1498,353,5,11,8,82,212,23,63,0,0
2524,1406,142,1491,364,5,11,8,85,222,24,63,0,0
2525,1402,144,1489,368,5,11,8,87,224,25,63,0,0
2526,1400,151,1490,379,5,11,8,90,228,26,63,0,0
2527,1394,149,1483,377,5,11,8,89,228,27,63,0,0
2528,1393,154,1484,387,5,11,8,91,233,28,63,0,0
2529,1393,160,1485,396,5,11,8,92,236,29,63,0,0
2530,1384,158,1480,400,5,11,8,96,242,30,63,0,0
2531,1387,162,1482,400,5,11,8,95,238,31,63,0,0
2532,1388,162,1484,400,5,11,8,96,238,32,63,0,0
2533,1390,168,1490,422,5,11,8,100,254,33,63,0,0
2534,1384,172,1490,439,5,11,8,106,267,34,63,0,0
2535,1378,177,1489,453,5,11,8,111,276,35,63,0,0
2536,1373,181,1490,469,5,11,8,117,288,36,63,0,0
2537,1370,182,1488,473,5,11,8,118,291,37,63,0,0
2538,1356,182,1485,497,5,11,8,129,315,38,63,0,0
2539,1350,196,1478,507,5,11,8,128,311,39,63,0,0
2540,1340,203,1470,514,5,11,8,130,311,40,63,0,0
2541,1330,217,1469,544,5,11,8,139,327,41,63,0,0
2542,1322,216,1471,565,5,11,8,149,349,42,63,0,0
2543,1304,221,1470,596,5,11,8,166,375,43,63,0,0
2544,1291,228,1467,622,5,11,8,176,394,44,63,0,0
2545,1281,232,1465,644,5,11,8,184,412,45,63,0,0
2546,1274,250,1467,683,5,11,8,193,433,46,63,0,0
2547,1272,258,1468,698,5,11,8,196,440,47,63,0,0
2548,1256,272,1464,738,5,11,8,208,466,48,63,0,0
2549,1231,283,1451,770,5,11,8,220,487,49,63,0,0
2550,1210,297,1437,798,5,11,8,227,501,50,63,0,0
2551,1185,317,1430,864,5,11,8,245,547,51,63,0,0
2552,1168,331,1423,900,5,11,8,255,569,52,63,0,0
2553,1138,351,1408,951,5,11,8,270,600,53,63,0,0
2554,1105,381,1389,1005,5,11,8,284,624,54,63,0,0
2555,1064,402,1356,1038,5,11,8,292,636,55,63,0,0
2556,1023,436,1317,1068,5,11,8,294,632,56,63,0,0
2557,977,465,1270,1076,5,11,8,293,611,57,63,0,0
2558,927,498,1221,1078,5,11,8,294,580,58,63,0,0
2559,863,560,1147,1080,5,11,8,284,520,59,63,0,0
2560,776,616,1052,1080,5,11,8,276,464,60,63,0,0
2561,715,712,958,1078,5,11,8,243,366,61,63,0,0
2562,625,816,827,1080,5,11,8,202,264,62,63,0,0
2563,586,863,763,1080,5,11,8,177,217,63,63,1,0
2539,1304,216,1402,396,6,11,8,98,180,0,0,0,0
3768,1434,108,1476,270,8,11,8,42,162,0,12,0,0
3769,1443,121,1479,261,8,11,8,36,140,1,12,0,0
3770,1452,119,1488,252,8,11,8,36,133,2,12,0,0
3771,1469,120,1505,254,8,11,8,36,134,3,12,0,0
3772,1475,119,1512,252,8,11,8,37,133,4,12,0,0
3773,1475,117,1514,254,8,11,8,39,137,5,12,0,0
3774,1473,118,1513,256,8,11,8,40,138,6,12,0,0
3775,1460,118,1503,262,8,11,8,43,144,7,12,0,0
3776,1450,122,1493,266,8,11,8,43,144,8,12,0,0
3777,1439,124,1482,265,8,11,8,43,141,9,12,0,0
3778,1431,125,1475,270,8,11,8,44,145,10,12,0,0
3779,1421,126,1466,270,8,11,8,45,144,11,12,0,0
3780,1418,127,1463,271,8,11,8,45,144,12,12,0,0
4304,1557,114,1618,245,10,11,8,61,131,0,0,0,0
4305,1534,112,1583,253,11,11,8,49,141,0,7,0,0
4306,1509,112,1559,256,11,11,8,50,144,1,7,0,0
4307,1483,115,1533,260,11,11,8,50,145,2,7,0,0
4308,1463,114,1514,261,11,11,8,51,147,3,7,0,0
4309,1440,119,1490,261,11,11,8,50,142,4,7,0,0
4310,1422,116,1475,268,11,11,8,53,152,5,7,0,0
4311,1410,119,1462,269,11,11,8,52,150,6,7,0,0
4312,1393,121,1446,272,11,11,8,53,151,7,7,0,0
5735,1430,124,1479,270,12,11,8,49,146,0,18,0,0
5736,1434,121,1483,268,12,11,8,49,147,1,18,0,0
5737,1446,120,1495,265,12,11,8,49,145,2,18,0,0
5738,1464,122,1512,262,12,11,8,48,140,3,18,0,0
5739,1475,125,1519,253,12,11,8,44,128,4,18,0,0
5740,1482,123,1526,252,12,11,8,44,129,5,18,0,0
5741,1486,123,1530,253,12,11,8,44,130,6,18,0,0
5742,1486,121,1531,254,12,11,8,45,133,7,18,0,0
5743,1484,118,1530,252,12,11,8,46,134,8,18,0,0
5744,1482,119,1528,253,12,11,8,46,134,9,18,0,0
5745,1480,120,1526,252,12,11,8,46,132,10,18,0,0
5746,1478,119,1524,251,12,11,8,46,132,11,18,0,0
5747,1478,121,1523,249,12,11,8,45,128,12,18,0,0
5748,1476,119,1519,246,12,11,8,43,127,13,18,0,0
5749,1473,117,1518,247,12,11,8,45,130,14,18,0,0
5750,1466,118,1513,249,12,11,8,47,131,15,18,0,0
5751,1453,118,1500,251,12,11,8,47,133,16,18,0,0
5752,1439,116,1489,258,12,11,8,50,142,17,18,0,0
5753,1436,116,1486,259,12,11,8,50,143,18,18,0,0
114,1840,978,1886,1048,1,11,9,46,70,0,6,0,0
115,1840,973,1892,1054,1,11,9,52,81,1,6,0,0
116,1842,971,1898,1059,1,11,9,56,88,2,6,0,0
117,1849,969,1902,1053,1,11,9,53,84,3,6,0,0
118,1859,964,1907,1041,1,11,9,48,77,4,6,0,0
119,1867,960,1910,1030,1,11,9,43,70,5,6,0,0
120,1871,957,1915,1028,1,11,9,44,71,6,6,0,0
645,1826,939,1877,1035,4,11,9,51,96,0,1,0,0
646,1826,939,1874,1029,4,11,9,48,90,1,1,0,0
648,1817,952,1866,1033,5,11,9,49,81,0,2,0,0
649,1810,954,1860,1037,5,11,9,50,83,1,2,0,0
650,1807,958,1852,1031,5,11,9,45,73,2,2,0,0
698,1853,937,1908,1014,6,11,9,55,77,0,7,0,0
700,1849,941,1902,1015,6,11,9,53,74,0,7,0,0
701,1844,942,1899,1020,6,11,9,55,78,1,7,0,0
702,1840,946,1894,1024,6,11,9,54,78,2,7,0,0
703,1832,951,1885,1025,6,11,9,53,74,3,7,0,0
704,1825,957,1877,1031,6,11,9,52,74,4,7,0,0
705,1821,960,1872,1032,6,11,9,51,72,5,7,0,0
706,1818,962,1871,1039,6,11,9,53,77,6,7,0,0
707,1815,967,1865,1039,6,11,9,50,72,7,7,0,0
705,1851,964,1896,1034,7,11,9,45,70,0,4,0,0
706,1846,971,1892,1043,7,11,9,46,72,1,4,0,0
707,1838,974,1885,1047,7,11,9,47,73,2,4,0,0
708,1833,980,1880,1053,7,11,9,47,73,3,4,0,0
709,1831,984,1877,1055,7,11,9,46,71,4,4,0,0
772,715,703,1049,1057,10,11,9,334,354,0,6,0,0
773,591,582,1048,1070,10,11,9,457,488,1,6,0,0
774,546,537,1043,1070,10,11,9,497,533,2,6,0,0
775,477,474,1024,1072,10,11,9,547,598,3,6,0,0
776,413,423,989,1070,10,11,9,576,647,4,6,0,0
777,371,392,954,1068,10,11,9,583,676,5,6,0,0
778,322,350,941,1069,10,11,9,619,719,6,6,0,0
778,516,341,728,953,11,11,9,212,612,0,41,0,1
779,518,338,729,945,11,11,9,211,607,1,41,0,0
780,514,315,706,867,11,11,9,192,552,2,41,0,0
781,491,286,674,813,11,11,9,183,527,3,41,0,0
782,481,276,653,775,11,11,9,172,499,4,41,0,0
783,470,253,627,709,11,11,9,157,456,5,41,0,0
784,469,246,622,688,11,11,9,153,442,6,41,0,0
785,471,234,614,645,11,11,9,143,411,7,41,0,0
786,464,219,598,607,11,11,9,134,388,8,41,0,0
787,460,220,588,593,11,11,9,128,373,9,41,0,0
788,461,215,577,552,11,11,9,116,337,10,41,0,0
789,455,214,568,537,11,11,9,113,323,11,41,0,0
790,453,206,562,517,11,11,9,109,311,12,41,0,0
791,453,194,556,490,11,11,9,103,296,13,41,0,0
792,449,193,549,478,11,11,9,100,285,14,41,0,0
793,440,184,535,457,11,11,9,95,273,15,41,0,0
794,429,178,524,449,11,11,9,95,271,16,41,0,0
795,426,175,519,435,11,11,9,93,260,17,41,0,0
796,429,164,519,421,11,11,9,90,257,18,41,0,0
797,431,165,518,414,11,11,9,87,249,19,41,0,0
798,433,163,514,396,11,11,9,81,233,20,41,0,0
799,428,155,510,389,11,11,9,82,234,21,41,0,0
800,425,156,504,383,11,11,9,79,227,22,41,0,0
801,423,155,499,369,11,11,9,76,214,23,41,0,0
802,424,155,498,363,11,11,9,74,208,24,41,0,0
803,424,149,495,351,11,11,9,71,202,25,41,0,0
804,424,147,492,340,11,11,9,68,193,26,41,0,0
805,427,147,492,334,11,11,9,65,187,27,41,0,0
806,433,141,498,326,11,11,9,65,185,28,41,0,0
807,436,140,499,323,11,11,9,63,183,29,41,0,0
808,439,137,499,310,11,11,9,60,173,30,41,0,0
809,440,131,500,303,11,11,9,60,172,31,41,0,0
810,444,129,503,298,11,11,9,59,169,32,41,0,0
811,446,122,505,293,11,11,9,59,171,33,41,0,0
812,447,124,506,291,11,11,9,59,167,34,41,0,0
813,448,116,507,282,11,11,9,59,166,35,41,0,0
814,449,116,507,280,11,11,9,58,164,36,41,0,0
815,451,117,507,274,11,11,9,56,157,37,41,0,0
816,454,117,508,269,11,11,9,54,152,38,41,0,0
817,454,115,508,266,11,11,9,54,151,39,41,0,0
818,451,104,507,261,11,11,9,56,157,40,41,0,0
819,452,100,507,255,11,11,9,55,155,41,41,1,0
828,451,95,496,224,11,11,9,45,129,0,41,0,0
829,448,92,493,222,11,11,9,45,130,1,41,0,0
830,452,96,494,219,11,11,9,42,123,2,41,0,0
831,453,96,493,216,11,11,9,40,120,3,41,0,0
832,453,94,493,215,11,11,9,40,121,4,41,0,0
833,452,91,490,210,11,11,9,38,119,5,41,0,0
834,453,92,489,204,11,11,9,36,112,6,41,0,0
835,452,90,489,206,11,11,9,37,116,7,41,0,0
836,449,89,487,206,11,11,9,38,117,8,41,0,0
837,448,87,487,204,11,11,9,39,117,9,41,0,0
838,451,87,488,200,11,11,9,37,113,10,41,0,0
840,452,88,487,197,11,11,9,35,109,0,41,0,0
841,452,87,487,194,11,11,9,35,107,1,41,0,0
1270,1834,979,1883,1054,12,11,9,49,75,0,10,0,0
1271,1835,971,1887,1052,12,11,9,52,81,1,10,0,0
1272,1837,970,1889,1049,12,11,9,52,79,2,10,0,0
1273,1844,967,1892,1040,12,11,9,48,73,3,10,0,0
1274,1852,961,1901,1036,12,11,9,49,75,4,10,0,0
1275,1859,956,1908,1033,12,11,9,49,77,5,10,0,0
1276,1862,952,1911,1030,12,11,9,49,78,6,10,0,0
1277,1865,949,1912,1026,12,11,9,47,77,7,10,0,0
1278,1867,944,1916,1023,12,11,9,49,79,8,10,0,0
1279,1870,941,1918,1020,12,11,9,48,79,9,10,0,0
1280,1873,937,1920,1018,12,11,9,47,81,10,10,0,0
1275,1819,964,1875,1037,13,11,9,56,73,0,7,0,0
1276,1820,959,1878,1035,13,11,9,58,76,1,7,0,0
1277,1825,955,1881,1030,13,11,9,56,75,2,7,0,0
1278,1830,948,1885,1023,13,11,9,55,75,3,7,0,0
1279,1834,943,1890,1020,13,11,9,56,77,4,7,0,0
1280,1841,938,1895,1013,13,11,9,54,75,5,7,0,0
1281,1844,934,1895,1006,13,11,9,51,72,6,7,0,0
1282,1848,930,1898,1001,13,11,9,50,71,7,7,0,0
1805,0,645,161,1080,20,11,9,161,435,0,63,0,1
1806,27,591,204,1065,20,11,9,177,474,1,63,0,0
1807,67,602,247,1075,20,11,9,180,473,2,63,0,0
1808,122,594,309,1077,20,11,9,187,483,3,63,0,0
1809,196,602,380,1068,20,11,9,184,466,4,63,0,0
1810,282,591,476,1073,20,11,9,194,482,5,63,0,0
1811,355,570,561,1073,20,11,9,206,503,6,63,0,0
1812,435,565,648,1075,20,11,9,213,510,7,63,0,0
1813,528,578,738,1073,20,11,9,210,495,8,63,0,0
1814,627,582,841,1071,20,11,9,214,489,9,63,0,0
1815,719,585,936,1067,20,11,9,217,482,10,63,0,0
1816,798,587,1022,1075,20,11,9,224,488,11,63,0,0
1817,866,575,1095,1074,20,11,9,229,499,12,63,0,0
1818,931,570,1161,1077,20,11,9,230,507,13,63,0,0
1819,1011,588,1234,1075,20,11,9,223,487,14,63,0,0
1820,1085,592,1309,1071,20,11,9,224,479,15,63,0,0
1821,1139,594,1366,1072,20,11,9,227,478,16,63,0,0
1822,1177,596,1407,1075,20,11,9,230,479,17,63,0,0
1823,1207,593,1441,1073,20,11,9,234,480,18,63,0,0
1824,1223,589,1458,1067,20,11,9,235,478,19,63,0,0
1825,1241,574,1481,1058,20,11,9,240,484,20,63,0,0
1826,1254,577,1498,1064,20,11,9,244,487,21,63,0,0
1827,1282,610,1516,1063,20,11,9,234,453,22,63,0,0
1828,1290,597,1539,1068,20,11,9,249,471,23,63,0,0
1829,1307,624,1549,1065,20,11,9,242,441,24,63,0,0
1830,1305,636,1547,1064,20,11,9,242,428,25,63,0,0
1831,1305,638,1553,1064,20,11,9,248,426,26,63,0,0
1832,1305,651,1554,1064,20,11,9,249,413,27,63,0,0
1833,1300,655,1553,1068,20,11,9,253,413,28,63,0,0
1834,1290,652,1549,1067,20,11,9,259,415,29,63,0,0
1835,1286,644,1554,1067,20,11,9,268,423,30,63,0,0
1836,1289,643,1565,1068,20,11,9,276,425,31,63,0,0
1837,1290,634,1574,1065,20,11,9,284,431,32,63,0,0
1838,1282,632,1570,1065,20,11,9,288,433,33,63,0,0
1839,1276,622,1572,1066,20,11,9,296,444,34,63,0,0
1840,1257,604,1568,1069,20,11,9,311,465,35,63,0,0
1841,1258,594,1575,1071,20,11,9,317,477,36,63,0,0
1842,1268,611,1574,1068,20,11,9,306,457,37,63,0,0
1843,1255,595,1576,1073,20,11,9,321,478,38,63,0,0
1844,1265,616,1570,1062,20,11,9,305,446,39,63,0,0
1845,1259,622,1566,1067,20,11,9,307,445,40,63,0,0
1846,1247,619,1558,1066,20,11,9,311,447,41,63,0,0
1847,1223,621,1537,1066,20,11,9,314,445,42,63,0,0
1848,1177,606,1503,1066,20,11,9,326,460,43,63,0,0
1849,1138,608,1462,1064,20,11,9,324,456,44,63,0,0
1850,1088,596,1423,1066,20,11,9,335,470,45,63,0,0
1851,1064,582,1410,1071,20,11,9,346,489,46,63,0,0
1852,1025,562,1377,1073,20,11,9,352,511,47,63,0,0
1853,977,548,1325,1072,20,11,9,348,524,48,63,0,0
1854,941,550,1277,1077,20,11,9,336,527,49,63,0,0
1855,885,564,1203,1077,20,11,9,318,513,50,63,0,0
1856,828,562,1140,1078,20,11,9,312,516,51,63,0,0
1857,762,566,1063,1079,20,11,9,301,513,52,63,0,0
1858,688,570,976,1075,20,11,9,288,505,53,63,0,0
1859,602,554,890,1075,20,11,9,288,521,54,63,0,0
1860,519,545,807,1077,20,11,9,288,532,55,63,0,0
1861,438,565,712,1074,20,11,9,274,509,56,63,0,0
1862,349,584,610,1076,20,11,9,261,492,57,63,0,0
1863,264,587,524,1075,20,11,9,260,488,58,63,0,0
1864,183,598,441,1077,20,11,9,258,479,59,63,0,0
1865,89,600,346,1079,20,11,9,257,479,60,63,0,0
1866,4,602,258,1079,20,11,9,254,477,61,63,0,0
1867,0,647,193,1079,20,11,9,193,432,62,63,0,0
1868,0,654,125,1080,20,11,9,125,426,63,63,1,0
1824,1340,578,1460,861,21,11,9,120,283,0,0,0,0
1827,1399,601,1528,780,22,11,9,129,179,0,0,0,0
1829,1433,629,1573,789,23,11,9,140,160,0,11,0,0
1830,1429,629,1574,795,23,11,9,145,166,1,11,0,0
1831,1430,629,1566,785,23,11,9,136,156,2,11,0,0
1832,1423,626,1565,789,23,11,9,142,163,3,11,0,0
1833,1422,623,1562,784,23,11,9,140,161,4,11,0,0
1834,1419,624,1563,790,23,11,9,144,166,5,11,0,0
1835,1422,621,1561,783,23,11,9,139,162,6,11,0,0
1836,1423,621,1559,779,23,11,9,136,158,7,11,0,0
1837,1426,622,1556,773,23,11,9,130,151,8,11,0,0
1838,1426,620,1561,778,23,11,9,135,158,9,11,0,0
1839,1428,618,1561,774,23,11,9,133,156,10,11,0,0
1840,1428,617,1561,772,23,11,9,133,155,11,11,0,0
1846,1416,626,1535,765,23,11,9,119,139,0,11,0,0
1847,1415,626,1532,764,23,11,9,117,138,1,11,0,0
2256,1809,971,1854,1047,27,11,9,45,76,0,16,0,0
2257,1810,969,1859,1050,27,11,9,49,81,1,16,0,0
2258,1817,964,1865,1044,27,11,9,48,80,2,16,0,0
2259,1821,963,1869,1043,27,11,9,48,80,3,16,0,0
2260,1827,960,1875,1040,27,11,9,48,80,4,16,0,0
2261,1830,957,1878,1036,27,11,9,48,79,5,16,0,0
2262,1832,952,1882,1035,27,11,9,50,83,6,16,0,0
2263,1834,947,1887,1032,27,11,9,53,85,7,16,0,0
2264,1841,945,1894,1030,27,11,9,53,85,8,16,0,0
2265,1845,943,1898,1027,27,11,9,53,84,9,16,0,0
2266,1853,942,1902,1020,27,11,9,49,78,10,16,0,0
2267,1857,939,1905,1014,27,11,9,48,75,11,16,0,0
2268,1859,936,1908,1011,27,11,9,49,75,12,16,0,0
2269,1864,931,1913,1008,27,11,9,49,77,13,16,0,0
2270,1870,929,1918,1004,27,11,9,48,75,14,16,0,0
2271,1873,927,1920,1002,27,11,9,47,75,15,16,0,0
2272,1877,924,1920,999,27,11,9,43,75,16,16,0,0
3438,1843,926,1905,1008,39,11,9,62,82,0,10,0,0
3439,1841,927,1904,1010,39,11,9,63,83,1,10,0,0
3440,1835,926,1900,1012,39,11,9,65,86,2,10,0,0
3441,1832,929,1896,1016,39,11,9,64,87,3,10,0,0
3442,1828,933,1892,1020,39,11,9,64,87,4,10,0,0
3443,1822,935,1885,1023,39,11,9,63,88,5,10,0,0
3444,1816,942,1877,1026,39,11,9,61,84,6,10,0,0
3445,1811,947,1869,1030,39,11,9,58,83,7,10,0,0
3446,1804,948,1861,1031,39,11,9,57,83,8,10,0,0
3447,1801,954,1853,1032,39,11,9,52,78,9,10,0,0
3448,1799,961,1847,1033,39,11,9,48,72,10,10,0,0
3446,1832,958,1876,1037,40,11,9,44,79,0,1,0,0
3447,1828,964,1871,1039,40,11,9,43,75,1,1,0,0
3750,2,498,156,1073,41,11,9,154,575,0,76,0,1
3751,84,463,250,1070,41,11,9,166,607,1,76,0,0
3752,183,447,357,1071,41,11,9,174,624,2,76,0,0
3753,254,416,440,1071,41,11,9,186,655,3,76,0,0
3754,368,401,563,1066,41,11,9,195,665,4,76,0,0
3755,438,387,638,1055,41,11,9,200,668,5,76,0,0
3756,477,357,672,1000,41,11,9,195,643,6,76,0,0
3757,512,340,707,979,41,11,9,195,639,7,76,0,0
3758,539,325,726,933,41,11,9,187,608,8,76,0,0
3759,558,305,733,868,41,11,9,175,563,9,76,0,0
3760,573,293,743,837,41,11,9,170,544,10,76,0,0
3761,590,272,752,784,41,11,9,162,512,11,76,0,0
3762,599,261,752,744,41,11,9,153,483,12,76,0,0
3763,599,254,749,727,41,11,9,150,473,13,76,0,0
3764,594,240,733,676,41,11,9,139,436,14,76,0,0
3765,587,231,723,654,41,11,9,136,423,15,76,0,0
3766,587,228,719,638,41,11,9,132,410,16,76,0,0
3767,591,216,714,596,41,11,9,123,380,17,76,0,0
3768,589,210,709,583,41,11,9,120,373,18,76,0,0
3769,584,204,699,562,41,11,9,115,358,19,76,0,0
3770,576,201,685,534,41,11,9,109,333,20,76,0,0
3771,569,197,675,525,41,11,9,106,328,21,76,0,0
3772,561,193,665,513,41,11,9,104,320,22,76,0,0
3773,554,183,653,491,41,11,9,99,308,23,76,0,0
3774,544,178,642,483,41,11,9,98,305,24,76,0,0
3775,533,173,630,470,41,11,9,97,297,25,76,0,0
3776,526,167,619,451,41,11,9,93,284,26,76,0,0
3777,521,166,615,447,41,11,9,94,281,27,76,0,0
3778,521,164,615,436,41,11,9,94,272,28,76,0,0
3779,517,160,607,424,41,11,9,90,264,29,76,0,0
3780,512,159,598,415,41,11,9,86,256,30,76,0,0
3781,504,158,586,400,41,11,9,82,242,31,76,0,0
3782,495,154,578,394,41,11,9,83,240,32,76,0,0
3783,491,155,570,387,41,11,9,79,232,33,76,0,0
3784,491,149,568,374,41,11,9,77,225,34,76,0,0
3785,486,146,562,368,41,11,9,76,222,35,76,0,0
3786,479,145,553,364,41,11,9,74,219,36,76,0,0
3787,474,145,544,354,41,11,9,70,209,37,76,0,0
3788,471,143,540,351,41,11,9,69,208,38,76,0,0
3789,470,143,536,344,41,11,9,66,201,39,76,0,0
3790,468,143,531,336,41,11,9,63,193,40,76,0,0
3791,465,143,526,332,41,11,9,61,189,41,76,0,0
3792,462,138,522,326,41,11,9,60,188,42,76,0,0
3793,460,133,518,317,41,11,9,58,184,43,76,0,0
3794,461,134,516,311,41,11,9,55,177,44,76,0,0
3795,462,130,517,305,41,11,9,55,175,45,76,0,0
3796,462,122,518,302,41,11,9,56,180,46,76,0,0
3797,461,120,516,300,41,11,9,55,180,47,76,0,0
3798,457,116,513,295,41,11,9,56,179,48,76,0,0
3799,456,113,511,291,41,11,9,55,178,49,76,0,0
3800,459,114,512,287,41,11,9,53,173,50,76,0,0
3801,463,117,512,280,41,11,9,49,163,51,76,0,0
3802,464,117,513,278,41,11,9,49,161,52,76,0,0
3803,465,118,512,274,41,11,9,47,156,53,76,0,0
3804,466,119,512,269,41,11,9,46,150,54,76,0,0
3805,467,120,511,267,41,11,9,44,147,55,76,0,0
3806,470,117,513,262,41,11,9,43,145,56,76,0,0
3807,471,118,513,257,41,11,9,42,139,57,76,0,0
3808,471,120,511,255,41,11,9,40,135,58,76,0,0
3809,467,113,509,252,41,11,9,42,139,59,76,0,0
3810,465,109,507,250,41,11,9,42,141,60,76,0,0
3811,466,112,506,246,41,11,9,40,134,61,76,0,0
3812,466,109,505,242,41,11,9,39,133,62,76,0,0
3813,466,112,504,238,41,11,9,38,126,63,76,0,0
3814,464,107,503,237,41,11,9,39,130,64,76,0,0
3815,463,104,502,234,41,11,9,39,130,65,76,0,0
3816,464,107,501,231,41,11,9,37,124,66,76,0,0
3817,465,103,502,227,41,11,9,37,124,67,76,0,0
3818,465,100,503,225,41,11,9,38,125,68,76,0,0
3819,466,104,502,224,41,11,9,36,120,69,76,0,0
3820,466,101,502,221,41,11,9,36,120,70,76,0,0
3821,466,96,503,219,41,11,9,37,123,71,76,0,0
3822,467,93,505,218,41,11,9,38,125,72,76,0,0
3823,469,93,506,215,41,11,9,37,122,73,76,0,0
3824,471,95,507,215,41,11,9,36,120,74,76,0,0
3825,472,96,507,213,41,11,9,35,117,75,76,0,0
3826,472,96,507,212,41,11,9,35,116,76,76,1,0
4326,0,830,112,1069,44,11,9,112,239,0,112,0,1
4327,15,751,169,1076,44,11,9,154,325,1,112,0,0
4328,0,562,233,1074,44,11,9,233,512,2,112,0,0
4329,29,468,313,1072,44,11,9,284,604,3,112,0,0
4330,65,417,368,1066,44,11,9,303,649,4,112,0,0
4331,124,380,440,1064,44,11,9,316,684,5,112,0,0
4332,187,363,512,1068,44,11,9,325,705,6,112,0,0
4333,244,352,572,1069,44,11,9,328,717,7,112,0,0
4334,292,332,621,1064,44,11,9,329,732,8,112,0,0
4335,343,319,655,1023,44,11,9,312,704,9,112,0,0
4336,381,305,688,1006,44,11,9,307,701,10,112,0,0
4337,401,289,701,987,44,11,9,300,698,11,112,0,0
4338,419,272,695,928,44,11,9,276,656,12,112,0,0
4339,435,260,695,891,44,11,9,260,631,13,112,0,0
4340,448,258,694,868,44,11,9,246,610,14,112,0,0
4341,468,250,693,814,44,11,9,225,564,15,112,0,0
4342,482,244,692,779,44,11,9,210,535,16,112,0,0
4343,489,241,686,756,44,11,9,197,515,17,112,0,0
4344,489,229,680,740,44,11,9,191,511,18,112,0,0
4345,483,219,663,707,44,11,9,180,488,19,112,0,0
4346,479,214,649,683,44,11,9,170,469,20,112,0,0
4347,471,210,635,673,44,11,9,164,463,21,112,0,0
4348,464,204,618,645,44,11,9,154,441,22,112,0,0
4349,463,202,604,615,44,11,9,141,413,23,112,0,0
4350,460,200,599,610,44,11,9,139,410,24,112,0,0
4351,452,192,588,594,44,11,9,136,402,25,112,0,0
4352,447,185,576,568,44,11,9,129,383,26,112,0,0
4353,451,185,577,560,44,11,9,126,375,27,112,0,0
4354,452,179,574,541,44,11,9,122,362,28,112,0,0
4355,456,174,573,523,44,11,9,117,349,29,112,0,0
4356,458,173,573,519,44,11,9,115,346,30,112,0,0
4357,460,170,570,500,44,11,9,110,330,31,112,0,0
4358,460,167,564,481,44,11,9,104,314,32,112,0,0
4359,463,167,565,479,44,11,9,102,312,33,112,0,0
4360,468,166,564,459,44,11,9,96,293,34,112,0,0
4361,468,161,563,450,44,11,9,95,289,35,112,0,0
4362,466,161,559,444,44,11,9,93,283,36,112,0,0
4363,461,159,551,431,44,11,9,90,272,37,112,0,0
4364,454,155,541,421,44,11,9,87,266,38,112,0,0
4365,449,156,534,416,44,11,9,85,260,39,112,0,0
4366,448,156,529,406,44,11,9,81,250,40,112,0,0
4367,448,151,528,399,44,11,9,80,248,41,112,0,0
4368,447,150,525,392,44,11,9,78,242,42,112,0,0
4369,445,147,523,388,44,11,9,78,241,43,112,0,0
4370,442,144,518,381,44,11,9,76,237,44,112,0,0
4371,439,145,513,378,44,11,9,74,233,45,112,0,0
4372,437,141,509,367,44,11,9,72,226,46,112,0,0
4373,436,138,507,364,44,11,9,71,226,47,112,0,0
4374,432,137,502,359,44,11,9,70,222,48,112,0,0
4375,427,133,497,353,44,11,9,70,220,49,112,0,0
4376,422,130,492,352,44,11,9,70,222,50,112,0,0
4377,420,129,489,351,44,11,9,69,222,51,112,0,0
4378,419,127,486,339,44,11,9,67,212,52,112,0,0
4379,419,123,486,335,44,11,9,67,212,53,112,0,0
4380,418,125,484,332,44,11,9,66,207,54,112,0,0
4381,417,126,482,325,44,11,9,65,199,55,112,0,0
4382,418,125,481,321,44,11,9,63,196,56,112,0,0
4383,420,126,481,316,44,11,9,61,190,57,112,0,0
4384,424,121,483,308,44,11,9,59,187,58,112,0,0
4385,427,125,485,309,44,11,9,58,184,59,112,0,0
4386,428,122,486,306,44,11,9,58,184,60,112,0,0
4387,429,120,486,299,44,11,9,57,179,61,112,0,0
4388,430,118,486,297,44,11,9,56,179,62,112,0,0
4389,433,116,489,292,44,11,9,56,176,63,112,0,0
4390,435,116,489,287,44,11,9,54,171,64,112,0,0
4391,436,115,488,282,44,11,9,52,167,65,112,0,0
4392,434,112,486,279,44,11,9,52,167,66,112,0,0
4393,432,109,484,277,44,11,9,52,168,67,112,0,0
4394,432,113,483,275,44,11,9,51,162,68,112,0,0
4395,433,107,485,272,44,11,9,52,165,69,112,0,0
4396,436,108,486,269,44,11,9,50,161,70,112,0,0
4397,438,109,487,267,44,11,9,49,158,71,112,0,0
4398,436,106,485,264,44,11,9,49,158,72,112,0,0
4399,435,104,484,260,44,11,9,49,156,73,112,0,0
4400,434,103,483,259,44,11,9,49,156,74,112,0,0
4401,434,101,483,258,44,11,9,49,157,75,112,0,0
4402,434,97,483,257,44,11,9,49,160,76,112,0,0
4403,435,96,485,258,44,11,9,50,162,77,112,0,0
4404,436,100,484,253,44,11,9,48,153,78,112,0,0
4405,435,95,483,251,44,11,9,48,156,79,112,0,0
4406,435,96,481,246,44,11,9,46,150,80,112,0,0
4407,434,94,480,244,44,11,9,46,150,81,112,0,0
4408,436,95,479,238,44,11,9,43,143,82,112,0,0
4409,436,96,478,239,44,11,9,42,143,83,112,0,0
4410,436,98,478,238,44,11,9,42,140,84,112,0,0
4411,434,93,476,236,44,11,9,42,143,85,112,0,0
4412,430,96,471,235,44,11,9,41,139,86,112,0,0
4413,428,90,470,233,44,11,9,42,143,87,112,0,0
4414,428,90,468,230,44,11,9,40,140,88,112,0,0
4415,427,93,467,229,44,11,9,40,136,89,112,0,0
4416,427,88,468,230,44,11,9,41,142,90,112,0,0
4417,428,86,468,229,44,11,9,40,143,91,112,0,0
4418,428,83,469,226,44,11,9,41,143,92,112,0,0
4419,428,83,468,224,44,11,9,40,141,93,112,0,0
4420,428,83,468,221,44,11,9,40,138,94,112,0,0
4421,429,86,467,219,44,11,9,38,133,95,112,0,0
4422,431,82,470,219,44,11,9,39,137,96,112,0,0
4423,434,79,474,216,44,11,9,40,137,97,112,0,0
4424,435,77,475,214,44,11,9,40,137,98,112,0,0
4425,433,80,472,211,44,11,9,39,131,99,112,0,0
4426,432,79,471,210,44,11,9,39,131,100,112,0,0
4427,431,80,469,208,44,11,9,38,128,101,112,0,0
4428,431,79,469,207,44,11,9,38,128,102,112,0,0
4429,434,80,472,206,44,11,9,38,126,103,112,0,0
4430,436,80,473,205,44,11,9,37,125,104,112,0,0
4431,437,81,473,202,44,11,9,36,121,105,112,0,0
4432,435,81,470,200,44,11,9,35,119,106,112,0,0
4433,435,82,470,198,44,11,9,35,116,107,112,0,0
4434,436,82,471,198,44,11,9,35,116,108,112,0,0
4435,437,81,473,197,44,11,9,36,116,109,112,0,0
4436,438,81,474,198,44,11,9,36,117,110,112,0,0
4437,438,84,473,195,44,11,9,35,111,111,112,0,0
4438,437,82,472,194,44,11,9,35,112,112,112,1,0
4440,437,81,472,192,44,11,9,35,111,0,112,0,0
4441,437,80,472,192,44,11,9,35,112,1,112,0,0
4442,437,78,474,191,44,11,9,37,113,2,112,0,0
4443,437,78,473,190,44,11,9,36,112,3,112,0,0
4444,438,79,474,190,44,11,9,36,111,4,112,0,0
4445,439,79,474,189,44,11,9,35,110,5,112,0,0
4446,438,81,473,188,44,11,9,35,107,6,112,0,0
4330,310,622,514,1077,45,11,9,204,455,0,0,0,0
4331,383,590,752,1065,46,11,9,369,475,0,73,0,1
4332,420,560,813,1066,46,11,9,393,506,1,73,0,0
4333,421,523,845,1076,46,11,9,424,553,2,73,0,0
4334,443,494,880,1073,46,11,9,437,579,3,73,0,0
4335,486,457,927,1055,46,11,9,441,598,4,73,0,0
4336,533,429,964,1025,46,11,9,431,596,5,73,0,0
4337,535,404,963,1012,46,11,9,428,608,6,73,0,0
4338,553,380,936,938,46,11,9,383,558,7,73,0,0
4339,556,360,910,892,46,11,9,354,532,8,73,0,0
4340,569,346,899,859,46,11,9,330,513,9,73,0,0
4341,595,330,887,799,46,11,9,292,469,10,73,0,0
4342,591,316,868,779,46,11,9,277,463,11,73,0,0
4343,588,306,839,743,46,11,9,251,437,12,73,0,0
4344,585,289,816,704,46,11,9,231,415,13,73,0,0
4345,573,281,797,699,46,11,9,224,418,14,73,0,0
4346,571,272,775,663,46,11,9,204,391,15,73,0,0
4347,559,260,751,643,46,11,9,192,383,16,73,0,0
4348,550,253,731,628,46,11,9,181,375,17,73,0,0
4349,550,243,715,596,46,11,9,165,353,18,73,0,0
4350,548,235,706,581,46,11,9,158,346,19,73,0,0
4351,552,235,702,573,46,11,9,150,338,20,73,0,0
4352,556,225,698,549,46,11,9,142,324,21,73,0,0
4353,558,221,693,539,46,11,9,135,318,22,73,0,0
4354,556,208,689,532,46,11,9,133,324,23,73,0,0
4355,557,202,683,514,46,11,9,126,312,24,73,0,0
4356,557,203,678,506,46,11,9,121,303,25,73,0,0
4357,559,201,673,495,46,11,9,114,294,26,73,0,0
4358,556,195,666,480,46,11,9,110,285,27,73,0,0
4359,550,187,657,474,46,11,9,107,287,28,73,0,0
4360,543,183,644,460,46,11,9,101,277,29,73,0,0
4361,538,182,634,449,46,11,9,96,267,30,73,0,0
4362,535,185,626,440,46,11,9,91,255,31,73,0,0
4363,534,181,622,428,46,11,9,88,247,32,73,0,0
4364,531,174,618,423,46,11,9,87,249,33,73,0,0
4365,528,175,610,416,46,11,9,82,241,34,73,0,0
4366,521,173,602,410,46,11,9,81,237,35,73,0,0
4367,515,168,595,404,46,11,9,80,236,36,73,0,0
4368,514,167,593,400,46,11,9,79,233,37,73,0,0
4369,513,165,589,388,46,11,9,76,223,38,73,0,0
4370,509,166,581,385,46,11,9,72,219,39,73,0,0
4371,504,166,574,381,46,11,9,70,215,40,73,0,0
4372,497,161,565,373,46,11,9,68,212,41,73,0,0
4373,492,148,562,365,46,11,9,70,217,42,73,0,0
4374,492,148,560,362,46,11,9,68,214,43,73,0,0
4375,490,145,558,355,46,11,9,68,210,44,73,0,0
4376,490,144,557,354,46,11,9,67,210,45,73,0,0
4377,487,145,551,350,46,11,9,64,205,46,73,0,0
4378,486,144,546,339,46,11,9,60,195,47,73,0,0
4379,486,146,543,332,46,11,9,57,186,48,73,0,0
4380,486,144,542,328,46,11,9,56,184,49,73,0,0
4381,486,146,541,323,46,11,9,55,177,50,73,0,0
4382,485,147,538,323,46,11,9,53,176,51,73,0,0
4383,482,150,533,318,46,11,9,51,168,52,73,0,0
4384,480,149,530,310,46,11,9,50,161,53,73,0,0
4385,481,152,528,302,46,11,9,47,150,54,73,0,0
4386,484,147,531,298,46,11,9,47,151,55,73,0,0
4387,483,142,531,292,46,11,9,48,150,56,73,0,0
4388,483,141,530,292,46,11,9,47,151,57,73,0,0
4389,479,135,527,291,46,11,9,48,156,58,73,0,0
4390,479,130,527,286,46,11,9,48,156,59,73,0,0
4391,482,131,528,282,46,11,9,46,151,60,73,0,0
4392,486,132,531,277,46,11,9,45,145,61,73,0,0
4393,488,133,532,274,46,11,9,44,141,62,73,0,0
4394,486,133,530,274,46,11,9,44,141,63,73,0,0
4395,483,130,527,271,46,11,9,44,141,64,73,0,0
4396,481,128,524,266,46,11,9,43,138,65,73,0,0
4397,481,128,523,266,46,11,9,42,138,66,73,0,0
4398,481,127,522,260,46,11,9,41,133,67,73,0,0
4399,480,125,520,256,46,11,9,40,131,68,73,0,0
4400,478,122,519,258,46,11,9,41,136,69,73,0,0
4401,477,123,517,256,46,11,9,40,133,70,73,0,0
4402,475,117,515,253,46,11,9,40,136,71,73,0,0
4403,475,118,513,249,46,11,9,38,131,72,73,0,0
4404,474,118,511,245,46,11,9,37,127,73,73,1,0
4676,1485,720,1531,790,49,11,9,46,70,0,3,0,0
4677,1491,720,1537,790,49,11,9,46,70,1,3,0,0
4678,1497,718,1544,792,49,11,9,47,74,2,3,0,0
4679,1501,717,1551,795,49,11,9,50,78,3,3,0,0
4724,1203,500,1238,576,58,11,9,35,76,0,1,0,0
4728,1197,495,1233,573,58,11,9,36,78,0,1,0,0
4729,1198,493,1234,573,58,11,9,36,80,1,1,0,0
5030,3,785,124,1079,73,11,9,121,294,0,84,0,1
5031,0,656,172,1079,73,11,9,172,423,1,84,0,0
5032,26,620,216,1080,73,11,9,190,460,2,84,0,0
5033,83,596,282,1079,73,11,9,199,483,3,84,0,0
5034,159,573,367,1072,73,11,9,208,499,4,84,0,0
5035,238,566,453,1072,73,11,9,215,506,5,84,0,0
5036,300,558,518,1073,73,11,9,218,515,6,84,0,0
5037,352,561,570,1077,73,11,9,218,516,7,84,0,0
5038,410,565,626,1073,73,11,9,216,508,8,84,0,0
5039,453,546,676,1072,73,11,9,223,526,9,84,0,0
5040,482,514,715,1075,73,11,9,233,561,10,84,0,0
5041,529,497,763,1065,73,11,9,234,568,11,84,0,0
5042,571,480,804,1045,73,11,9,233,565,12,84,0,0
5043,603,463,826,1010,73,11,9,223,547,13,84,0,0
5044,629,448,839,971,73,11,9,210,523,14,84,0,0
5045,636,428,841,947,73,11,9,205,519,15,84,0,0
5046,631,403,822,893,73,11,9,191,490,16,84,0,0
5047,621,388,805,868,73,11,9,184,480,17,84,0,0
5048,619,375,792,834,73,11,9,173,459,18,84,0,0
5049,617,351,779,784,73,11,9,162,433,19,84,0,0
5050,610,339,767,767,73,11,9,157,428,20,84,0,0
5051,608,337,751,731,73,11,9,143,394,21,84,0,0
5052,604,325,739,701,73,11,9,135,376,22,84,0,0
5053,596,318,725,683,73,11,9,129,365,23,84,0,0
5054,589,301,713,657,73,11,9,124,356,24,84,0,0
5055,581,287,701,636,73,11,9,120,349,25,84,0,0
5056,576,289,689,618,73,11,9,113,329,26,84,0,0
5057,567,275,675,592,73,11,9,108,317,27,84,0,0
5058,558,267,663,580,73,11,9,105,313,28,84,0,0
5059,552,265,654,575,73,11,9,102,310,29,84,0,0
5060,546,253,643,547,73,11,9,97,294,30,84,0,0
5061,539,246,635,539,73,11,9,96,293,31,84,0,0
5062,533,243,623,522,73,11,9,90,279,32,84,0,0
5063,525,239,611,506,73,11,9,86,267,33,84,0,0
5064,516,235,601,501,73,11,9,85,266,34,84,0,0
5065,511,230,593,491,73,11,9,82,261,35,84,0,0
5066,505,221,584,473,73,11,9,79,252,36,84,0,0
5067,498,221,575,467,73,11,9,77,246,37,84,0,0
5068,493,217,566,452,73,11,9,73,235,38,84,0,0
5069,488,213,560,447,73,11,9,72,234,39,84,0,0
5070,484,209,556,445,73,11,9,72,236,40,84,0,0
5071,484,204,552,425,73,11,9,68,221,41,84,0,0
5072,482,199,549,419,73,11,9,67,220,42,84,0,0
5073,480,196,546,416,73,11,9,66,220,43,84,0,0
5074,479,192,542,403,73,11,9,63,211,44,84,0,0
5075,478,192,540,401,73,11,9,62,209,45,84,0,0
5076,477,191,537,391,73,11,9,60,200,46,84,0,0
5077,477,186,535,382,73,11,9,58,196,47,84,0,0
5078,476,184,533,377,73,11,9,57,193,48,84,0,0
5079,472,182,528,367,73,11,9,56,185,49,84,0,0
5080,469,179,524,363,73,11,9,55,184,50,84,0,0
5081,466,178,520,362,73,11,9,54,184,51,84,0,0
5082,466,175,518,352,73,11,9,52,177,52,84,0,0
5083,465,172,517,347,73,11,9,52,175,53,84,0,0
5084,465,171,516,343,73,11,9,51,172,54,84,0,0
5085,465,168,514,336,73,11,9,49,168,55,84,0,0
5086,465,168,514,332,73,11,9,49,164,56,84,0,0
5087,467,167,516,328,73,11,9,49,161,57,84,0,0
5088,471,162,520,323,73,11,9,49,161,58,84,0,0
5089,474,161,522,322,73,11,9,48,161,59,84,0,0
5090,477,162,522,312,73,11,9,45,150,60,84,0,0
5091,479,160,524,308,73,11,9,45,148,61,84,0,0
5092,481,161,525,306,73,11,9,44,145,62,84,0,0
5093,484,160,527,300,73,11,9,43,140,63,84,0,0
5094,487,162,528,296,73,11,9,41,134,64,84,0,0
5095,487,161,529,298,73,11,9,42,137,65,84,0,0
5096,487,157,529,291,73,11,9,42,134,66,84,0,0
5097,487,153,529,287,73,11,9,42,134,67,84,0,0
5098,487,150,529,286,73,11,9,42,136,68,84,0,0
5099,488,149,529,279,73,11,9,41,130,69,84,0,0
5100,489,148,529,275,73,11,9,40,127,70,84,0,0
5101,488,148,529,276,73,11,9,41,128,71,84,0,0
5102,487,146,527,273,73,11,9,40,127,72,84,0,0
5103,486,147,525,270,73,11,9,39,123,73,84,0,0
5104,487,149,523,262,73,11,9,36,113,74,84,0,0
5105,485,146,522,262,73,11,9,37,116,75,84,0,0
5106,483,136,522,264,73,11,9,39,128,76,84,0,0
5107,481,130,521,261,73,11,9,40,131,77,84,0,0
5108,481,131,519,258,73,11,9,38,127,78,84,0,0
5109,482,134,518,254,73,11,9,36,120,79,84,0,0
5110,482,132,518,251,73,11,9,36,119,80,84,0,0
5111,483,130,518,247,73,11,9,35,117,81,84,0,0
5112,483,130,518,246,73,11,9,35,116,82,84,0,0
5113,483,128,518,243,73,11,9,35,115,83,84,0,0
5116,481,120,516,239,73,11,9,35,119,0,84,0,0
5266,514,120,550,229,73,11,9,36,109,0,84,0,1
5267,512,116,549,230,73,11,9,37,114,1,84,0,0
5268,512,114,549,231,73,11,9,37,117,2,84,0,0
5269,513,115,550,233,73,11,9,37,118,3,84,0,0
5270,514,123,550,235,73,11,9,36,112,4,84,0,0
5271,515,127,550,238,73,11,9,35,111,5,84,0,0
5272,515,125,552,242,73,11,9,37,117,6,84,0,0
5273,515,122,553,244,73,11,9,38,122,7,84,0,0
5274,515,121,554,247,73,11,9,39,126,8,84,0,0
5275,516,123,556,249,73,11,9,40,126,9,84,0,0
5276,521,122,561,250,73,11,9,40,128,10,84,0,0
5277,523,120,565,252,73,11,9,42,132,11,84,0,0
5278,523,120,566,255,73,11,9,43,135,12,84,0,0
5279,522,119,567,256,73,11,9,45,137,13,84,0,0
5280,520,119,566,260,73,11,9,46,141,14,84,0,0
5281,520,121,567,262,73,11,9,47,141,15,84,0,0
5282,519,122,565,264,73,11,9,46,142,16,84,0,0
5283,520,124,566,266,73,11,9,46,142,17,84,0,0
5284,520,128,565,268,73,11,9,45,140,18,84,0,0
5285,519,132,564,271,73,11,9,45,139,19,84,0,0
5286,517,134,563,275,73,11,9,46,141,20,84,0,0
5287,518,135,565,279,73,11,9,47,144,21,84,0,0
5288,520,136,568,280,73,11,9,48,144,22,84,0,0
5289,522,136,571,284,73,11,9,49,148,23,84,0,0
5290,523,139,572,288,73,11,9,49,149,24,84,0,0
5291,523,138,573,290,73,11,9,50,152,25,84,0,0
5292,524,137,576,296,73,11,9,52,159,26,84,0,0
5293,526,140,579,299,73,11,9,53,159,27,84,0,0
5294,529,141,582,301,73,11,9,53,160,28,84,0,0
5295,531,142,584,305,73,11,9,53,163,29,84,0,0
5296,531,143,586,311,73,11,9,55,168,30,84,0,0
5297,532,144,588,316,73,11,9,56,172,31,84,0,0
5298,535,145,593,324,73,11,9,58,179,32,84,0,0
5299,540,144,600,328,73,11,9,60,184,33,84,0,0
5300,546,143,608,332,73,11,9,62,189,34,84,0,0
5301,551,148,612,336,73,11,9,61,188,35,84,0,0
5302,554,150,615,340,73,11,9,61,190,36,84,0,0
5303,556,149,620,349,73,11,9,64,200,37,84,0,0
5304,561,154,625,354,73,11,9,64,200,38,84,0,0
5305,566,153,632,361,73,11,9,66,208,39,84,0,0
5306,573,159,639,365,73,11,9,66,206,40,84,0,0
5307,577,166,642,368,73,11,9,65,202,41,84,0,0
5308,579,170,645,375,73,11,9,66,205,42,84,0,0
5309,582,172,651,385,73,11,9,69,213,43,84,0,0
5310,587,173,658,392,73,11,9,71,219,44,84,0,0
5311,593,173,667,398,73,11,9,74,225,45,84,0,0
5312,596,178,672,409,73,11,9,76,231,46,84,0,0
5313,601,182,679,419,73,11,9,78,237,47,84,0,0
5314,606,186,686,429,73,11,9,80,243,48,84,0,0
5315,615,191,697,441,73,11,9,82,250,49,84,0,0
5316,624,195,706,443,73,11,9,82,248,50,84,0,0
5317,631,201,713,452,73,11,9,82,251,51,84,0,0
5318,639,205,724,463,73,11,9,85,258,52,84,0,0
5319,647,207,735,473,73,11,9,88,266,53,84,0,0
5320,656,213,747,488,73,11,9,91,275,54,84,0,0
5321,672,216,765,501,73,11,9,93,285,55,84,0,0
5322,683,223,776,507,73,11,9,93,284,56,84,0,0
5323,689,232,788,535,73,11,9,99,303,57,84,0,0
5324,698,239,800,545,73,11,9,102,306,58,84,0,0
5325,707,244,816,572,73,11,9,109,328,59,84,0,0
5326,717,254,828,589,73,11,9,111,335,60,84,0,0
5327,724,259,838,601,73,11,9,114,342,61,84,0,0
5328,722,272,847,643,73,11,9,125,371,62,84,0,0
5329,724,284,851,659,73,11,9,127,375,63,84,0,0
5330,725,292,858,683,73,11,9,133,391,64,84,0,0
5331,729,307,872,726,73,11,9,143,419,65,84,0,0
5332,742,317,890,750,73,11,9,148,433,66,84,0,0
5333,743,327,907,806,73,11,9,164,479,67,84,0,0
5334,741,344,916,851,73,11,9,175,507,68,84,0,0
5335,743,354,922,872,73,11,9,179,518,69,84,0,0
5336,748,383,936,927,73,11,9,188,544,70,84,0,0
5337,757,405,948,956,73,11,9,191,551,71,84,0,0
5338,759,426,959,1000,73,11,9,200,574,72,84,0,0
5339,742,456,951,1058,73,11,9,209,602,73,84,0,0
5340,692,471,910,1079,73,11,9,218,608,74,84,0,0
5341,638,484,861,1079,73,11,9,223,595,75,84,0,0
5342,623,531,836,1080,73,11,9,213,549,76,84,0,0
5343,550,519,771,1080,73,11,9,221,561,77,84,0,0
5344,508,516,731,1072,73,11,9,223,556,78,84,0,0
5345,464,522,686,1067,73,11,9,222,545,79,84,0,0
5346,382,538,600,1063,73,11,9,218,525,80,84,0,0
5347,320,582,539,1079,73,11,9,219,497,81,84,0,0
5348,218,594,450,1080,73,11,9,232,486,82,84,0,0
5349,139,612,377,1079,73,11,9,238,467,83,84,0,0
5350,98,627,334,1080,73,11,9,236,453,84,84,1,0
5287,485,141,520,273,95,11,9,35,132,0,56,0,1
5288,484,140,521,278,95,11,9,37,138,1,56,0,0
5289,484,142,522,282,95,11,9,38,140,2,56,0,0
5290,484,150,520,284,95,11,9,36,134,3,56,0,0
5291,483,148,520,286,95,11,9,37,138,4,56,0,0
5292,482,148,520,292,95,11,9,38,144,5,56,0,0
5293,482,147,522,296,95,11,9,40,149,6,56,0,0
5294,481,147,523,299,95,11,9,42,152,7,56,0,0
5295,481,151,522,303,95,11,9,41,152,8,56,0,0
5296,478,150,522,306,95,11,9,44,156,9,56,0,0
5297,477,151,522,312,95,11,9,45,161,10,56,0,0
5298,477,155,522,317,95,11,9,45,162,11,56,0,0
5299,478,156,524,321,95,11,9,46,165,12,56,0,0
5300,480,156,526,327,95,11,9,46,171,13,56,0,0
5301,482,159,529,332,95,11,9,47,173,14,56,0,0
5302,485,164,530,334,95,11,9,45,170,15,56,0,0
5303,486,162,534,340,95,11,9,48,178,16,56,0,0
5304,488,163,539,346,95,11,9,51,183,17,56,0,0
5305,491,166,543,352,95,11,9,52,186,18,56,0,0
5306,492,168,545,360,95,11,9,53,192,19,56,0,0
5307,493,168,548,362,95,11,9,55,194,20,56,0,0
5308,494,171,551,371,95,11,9,57,200,21,56,0,0
5309,498,172,557,375,95,11,9,59,203,22,56,0,0
5310,500,172,562,384,95,11,9,62,212,23,56,0,0
5311,504,175,568,393,95,11,9,64,218,24,56,0,0
5312,508,176,572,394,95,11,9,64,218,25,56,0,0
5313,511,179,577,405,95,11,9,66,226,26,56,0,0
5314,514,183,584,419,95,11,9,70,236,27,56,0,0
5315,518,184,589,422,95,11,9,71,238,28,56,0,0
5316,522,186,595,431,95,11,9,73,245,29,56,0,0
5317,524,189,598,439,95,11,9,74,250,30,56,0,0
5318,524,193,601,451,95,11,9,77,258,31,56,0,0
5319,529,200,608,466,95,11,9,79,266,32,56,0,0
5320,535,203,616,477,95,11,9,81,274,33,56,0,0
5321,542,211,625,495,95,11,9,83,284,34,56,0,0
5322,548,212,633,504,95,11,9,85,292,35,56,0,0
5323,556,217,641,511,95,11,9,85,294,36,56,0,0
5324,564,225,651,529,95,11,9,87,304,37,56,0,0
5325,572,230,662,539,95,11,9,90,309,38,56,0,0
5326,579,236,674,562,95,11,9,95,326,39,56,0,0
5327,585,245,684,579,95,11,9,99,334,40,56,0,0
5328,596,252,696,589,95,11,9,100,337,41,56,0,0
5329,608,264,713,618,95,11,9,105,354,42,56,0,0
5330,616,271,724,634,95,11,9,108,363,43,56,0,0
5331,623,283,736,666,95,11,9,113,383,44,56,0,0
5332,626,294,745,696,95,11,9,119,402,45,56,0,0
5333,631,304,752,713,95,11,9,121,409,46,56,0,0
5334,631,316,761,753,95,11,9,130,437,47,56,0,0
5335,633,328,767,771,95,11,9,134,443,48,56,0,0
5336,632,340,776,814,95,11,9,144,474,49,56,0,0
5337,629,359,780,855,95,11,9,151,496,50,56,0,0
5338,624,375,778,879,95,11,9,154,504,51,56,0,0
5339,609,393,777,944,95,11,9,168,551,52,56,0,0
5340,601,417,759,930,95,11,9,158,513,53,56,0,0
5341,610,434,723,771,95,11,9,113,337,54,56,0,0
5342,575,456,707,832,95,11,9,132,376,55,56,0,0
5343,572,469,705,846,95,11,9,133,377,56,56,1,0
5233,443,85,478,177,96,11,9,35,92,0,74,0,0
5235,447,88,482,182,96,11,9,35,94,0,74,0,0
5236,450,85,487,185,96,11,9,37,100,1,74,0,0
5237,444,86,481,185,96,11,9,37,99,2,74,0,0
5238,442,87,478,186,96,11,9,36,99,3,74,0,0
5239,444,87,480,188,96,11,9,36,101,4,74,0,0
5240,444,89,480,187,96,11,9,36,98,5,74,0,0
5241,443,92,478,188,96,11,9,35,96,6,74,0,0
5242,441,91,476,189,96,11,9,35,98,7,74,0,0
5243,438,91,474,190,96,11,9,36,99,8,74,0,0
5244,437,87,474,190,96,11,9,37,103,9,74,0,0
5245,437,84,475,192,96,11,9,38,108,10,74,0,0
5246,439,91,474,192,96,11,9,35,101,11,74,0,0
5267,438,104,479,229,96,11,9,41,125,0,74,0,0
5268,440,115,477,231,96,11,9,37,116,1,74,0,0
5273,449,133,484,240,96,11,9,35,107,0,74,0,1
5274,448,131,483,242,96,11,9,35,111,1,74,0,0
5275,448,132,484,245,96,11,9,36,113,2,74,0,0
5276,448,130,486,249,96,11,9,38,119,3,74,0,0
5277,447,132,484,252,96,11,9,37,120,4,74,0,0
5278,450,132,488,253,96,11,9,38,121,5,74,0,0
5279,448,134,486,258,96,11,9,38,124,6,74,0,0
5280,446,135,485,259,96,11,9,39,124,7,74,0,0
5281,447,139,487,265,96,11,9,40,126,8,74,0,0
5282,447,139,488,269,96,11,9,41,130,9,74,0,0
5283,447,138,489,271,96,11,9,42,133,10,74,0,0
5284,447,140,489,274,96,11,9,42,134,11,74,0,0
5285,445,140,489,278,96,11,9,44,138,12,74,0,0
5286,445,139,489,279,96,11,9,44,140,13,74,0,0
5287,446,144,490,286,96,11,9,44,142,14,74,0,0
5288,445,145,490,286,96,11,9,45,141,15,74,0,0
5289,444,146,490,291,96,11,9,46,145,16,74,0,0
5290,444,150,490,294,96,11,9,46,144,17,74,0,0
5291,439,150,486,297,96,11,9,47,147,18,74,0,0
5292,435,150,484,304,96,11,9,49,154,19,74,0,0
5293,434,153,483,307,96,11,9,49,154,20,74,0,0
5294,433,154,483,309,96,11,9,50,155,21,74,0,0
5295,433,158,484,316,96,11,9,51,158,22,74,0,0
5296,432,159,484,321,96,11,9,52,162,23,74,0,0
5297,431,158,484,325,96,11,9,53,167,24,74,0,0
5298,430,159,485,331,96,11,9,55,172,25,74,0,0
5299,431,160,486,335,96,11,9,55,175,26,74,0,0
5300,433,161,489,339,96,11,9,56,178,27,74,0,0
5301,435,169,491,347,96,11,9,56,178,28,74,0,0
5302,434,171,491,353,96,11,9,57,182,29,74,0,0
5303,433,173,492,359,96,11,9,59,186,30,74,0,0
5304,433,177,493,366,96,11,9,60,189,31,74,0,0
5305,432,177,494,369,96,11,9,62,192,32,74,0,0
5306,431,180,495,376,96,11,9,64,196,33,74,0,0
5307,428,182,494,386,96,11,9,66,204,34,74,0,0
5308,425,181,493,391,96,11,9,68,210,35,74,0,0
5309,425,188,493,400,96,11,9,68,212,36,74,0,0
5310,429,192,497,405,96,11,9,68,213,37,74,0,0
5311,433,194,504,414,96,11,9,71,220,38,74,0,0
5312,435,199,509,425,96,11,9,74,226,39,74,0,0
5313,436,200,512,431,96,11,9,76,231,40,74,0,0
5314,440,205,517,439,96,11,9,77,234,41,74,0,0
5315,445,212,522,446,96,11,9,77,234,42,74,0,0
5316,452,213,531,452,96,11,9,79,239,43,74,0,0
5317,456,217,538,464,96,11,9,82,247,44,74,0,0
5318,456,221,540,476,96,11,9,84,255,45,74,0,0
5319,458,225,544,485,96,11,9,86,260,46,74,0,0
5320,459,234,549,506,96,11,9,90,272,47,74,0,0
5321,464,239,557,516,96,11,9,93,277,48,74,0,0
5322,473,243,567,525,96,11,9,94,282,49,74,0,0
5323,475,249,574,547,96,11,9,99,298,50,74,0,0
5324,477,253,578,558,96,11,9,101,305,51,74,0,0
5325,477,258,583,579,96,11,9,106,321,52,74,0,0
5326,478,268,589,599,96,11,9,111,331,53,74,0,0
5327,485,276,597,607,96,11,9,112,331,54,74,0,0
5328,489,285,608,638,96,11,9,119,353,55,74,0,0
5329,493,292,618,660,96,11,9,125,368,56,74,0,0
5330,493,298,622,676,96,11,9,129,378,57,74,0,0
5331,501,317,632,697,96,11,9,131,380,58,74,0,0
5332,508,328,645,727,96,11,9,137,399,59,74,0,0
5333,514,337,661,771,96,11,9,147,434,60,74,0,0
5334,513,356,663,801,96,11,9,150,445,61,74,0,0
5335,505,366,659,823,96,11,9,154,457,62,74,0,0
5336,500,387,662,870,96,11,9,162,483,63,74,0,0
5337,492,412,661,914,96,11,9,169,502,64,74,0,0
5338,483,430,654,931,96,11,9,171,501,65,74,0,0
5339,462,454,645,986,96,11,9,183,532,66,74,0,0
5340,436,469,627,1022,96,11,9,191,553,67,74,0,0
5341,413,492,613,1054,96,11,9,200,562,68,74,0,0
5342,389,524,588,1080,96,11,9,199,556,69,74,0,0
5343,356,550,551,1080,96,11,9,195,530,70,74,0,0
5344,295,578,483,1080,96,11,9,188,502,71,74,0,0
5345,284,656,451,1080,96,11,9,167,424,72,74,0,0
5346,211,629,409,1080,96,11,9,198,451,73,74,0,0
5347,192,646,390,1080,96,11,9,198,434,74,74,1,0
5285,502,137,537,267,109,11,9,35,130,0,1,0,0
5286,502,137,538,269,109,11,9,36,132,1,1,0,0
5344,387,656,565,1029,115,11,9,178,373,0,0,0,0
5345,159,566,329,948,116,11,9,170,382,0,0,0,0
5347,23,621,287,955,117,11,9,264,334,0,1,0,0
5348,0,656,264,1045,117,11,9,264,389,1,1,0,0
5839,1794,955,1839,1026,145,11,9,45,71,0,4,0,0
5840,1799,952,1848,1028,145,11,9,49,76,1,4,0,0
5841,1806,948,1854,1024,145,11,9,48,76,2,4,0,0
5842,1810,943,1857,1017,145,11,9,47,74,3,4,0,0
5843,1814,939,1863,1018,145,11,9,49,79,4,4,0,0
5852,1866,907,1912,978,145,11,9,46,71,0,4,0,0
5853,1871,903,1917,976,145,11,9,46,73,1,4,0,0
5840,1823,968,1876,1041,146,11,9,53,73,0,12,0,0
5841,1824,960,1881,1041,146,11,9,57,81,1,12,0,0
5842,1826,956,1884,1039,146,11,9,58,83,2,12,0,0
5843,1827,952,1887,1036,146,11,9,60,84,3,12,0,0
5844,1837,951,1891,1026,146,11,9,54,75,4,12,0,0
5845,1834,937,1893,1021,146,11,9,59,84,5,12,0,0
5846,1835,931,1897,1019,146,11,9,62,88,6,12,0,0
5847,1841,926,1902,1015,146,11,9,61,89,7,12,0,0
5848,1841,923,1905,1016,146,11,9,64,93,8,12,0,0
5849,1844,916,1901,1002,146,11,9,57,86,9,12,0,0
5850,1856,919,1915,1009,146,11,9,59,90,10,12,0,0
5851,1860,915,1920,1006,146,11,9,60,91,11,12,0,0
5852,1864,911,1920,1004,146,11,9,56,93,12,12,0,0
5841,1777,935,1833,1011,147,11,9,56,76,0,7,0,0
5842,1784,932,1838,1005,147,11,9,54,73,1,7,0,0
5843,1793,929,1846,1002,147,11,9,53,73,2,7,0,0
5844,1795,927,1849,1001,147,11,9,54,74,3,7,0,0
5845,1798,922,1853,997,147,11,9,55,75,4,7,0,0
5846,1802,917,1859,996,147,11,9,57,79,5,7,0,0
5847,1808,912,1866,994,147,11,9,58,82,6,7,0,0
5848,1820,908,1868,978,147,11,9,48,70,7,7,0,0
5850,1832,901,1881,972,147,11,9,49,71,0,7,0,0
5851,1838,897,1889,970,147,11,9,51,73,1,7,0,0
5852,1843,895,1892,966,147,11,9,49,71,2,7,0,0
5854,1859,886,1907,956,147,11,9,48,70,0,7,0,0
5855,1864,885,1915,961,147,11,9,51,76,1,7,0,0
5856,1864,879,1918,959,147,11,9,54,80,2,7,0,0
5857,1867,877,1918,956,147,11,9,51,79,3,7,0,0
5858,1869,874,1919,950,147,11,9,50,76,4,7,0,0
5859,1874,870,1920,948,147,11,9,46,78,5,7,0,0
1,410,418,551,877,1,13,10,141,459,0,148,0,1
2,410,418,551,877,1,13,10,141,459,1,148,0,0
3,411,418,552,877,1,13,10,141,459,2,148,0,0
4,413,418,554,876,1,13,10,141,458,3,148,0,0
5,416,415,557,876,1,13,10,141,461,4,148,0,0
6,416,411,558,875,1,13,10,142,464,5,148,0,0
7,417,401,560,872,1,13,10,143,471,6,148,0,0
8,422,396,561,855,1,13,10,139,459,7,148,0,0
9,441,401,575,838,1,13,10,134,437,8,148,0,0
10,459,400,594,830,1,13,10,135,430,9,148,0,0
11,466,407,602,832,1,13,10,136,425,10,148,0,0
12,485,406,623,826,1,13,10,138,420,11,148,0,0
13,519,406,657,827,1,13,10,138,421,12,148,0,0
14,545,405,683,825,1,13,10,138,420,13,148,0,0
15,562,405,700,825,1,13,10,138,420,14,148,0,0
16,572,404,713,825,1,13,10,141,421,15,148,0,0
17,591,403,733,822,1,13,10,142,419,16,148,0,0
18,617,402,758,821,1,13,10,141,419,17,148,0,0
19,632,399,773,825,1,13,10,141,426,18,148,0,0
20,639,400,780,829,1,13,10,141,429,19,148,0,0
21,642,402,781,829,1,13,10,139,427,20,148,0,0
22,644,403,781,828,1,13,10,137,425,21,148,0,0
23,647,404,783,832,1,13,10,136,428,22,148,0,0
24,646,407,781,830,1,13,10,135,423,23,148,0,0
25,643,408,776,824,1,13,10,133,416,24,148,0,0
26,634,410,767,823,1,13,10,133,413,25,148,0,0
27,623,412,758,828,1,13,10,135,416,26,148,0,0
28,614,413,751,835,1,13,10,137,422,27,148,0,0
29,598,412,738,838,1,13,10,140,426,28,148,0,0
30,562,408,708,840,1,13,10,146,432,29,148,0,0
31,542,408,691,842,1,13,10,149,434,30,148,0,0
32,529,406,678,839,1,13,10,149,433,31,148,0,0
33,510,402,661,847,1,13,10,151,445,32,148,0,0
34,492,402,643,851,1,13,10,151,449,33,148,0,0
35,482,405,631,845,1,13,10,149,440,34,148,0,0
36,472,410,621,852,1,13,10,149,442,35,148,0,0
37,464,414,612,854,1,13,10,148,440,36,148,0,0
38,460,415,607,856,1,13,10,147,441,37,148,0,0
39,456,417,603,856,1,13,10,147,439,38,148,0,0
40,454,416,598,852,1,13,10,144,436,39,148,0,0
41,457,421,600,856,1,13,10,143,435,40,148,0,0
42,459,424,602,857,1,13,10,143,433,41,148,0,0
43,459,425,602,858,1,13,10,143,433,42,148,0,0
44,460,424,602,857,1,13,10,142,433,43,148,0,0
45,460,424,603,858,1,13,10,143,434,44,148,0,0
46,461,425,603,861,1,13,10,142,436,45,148,0,0
47,461,426,604,862,1,13,10,143,436,46,148,0,0
48,461,425,604,864,1,13,10,143,439,47,148,0,0
49,461,425,604,863,1,13,10,143,438,48,148,0,0
50,462,425,604,862,1,13,10,142,437,49,148,0,0
51,462,425,604,862,1,13,10,142,437,50,148,0,0
52,461,426,603,861,1,13,10,142,435,51,148,0,0
53,461,424,603,862,1,13,10,142,438,52,148,0,0
54,460,424,603,862,1,13,10,143,438,53,148,0,0
55,460,423,603,862,1,13,10,143,439,54,148,0,0
56,461,424,602,858,1,13,10,141,434,55,148,0,0
57,461,424,602,858,1,13,10,141,434,56,148,0,0
58,461,424,602,857,1,13,10,141,433,57,148,0,0
59,461,424,602,857,1,13,10,141,433,58,148,0,0
60,461,424,602,857,1,13,10,141,433,59,148,0,0
61,461,424,602,858,1,13,10,141,434,60,148,0,0
62,461,424,603,858,1,13,10,142,434,61,148,0,0
63,462,424,603,858,1,13,10,141,434,62,148,0,0
64,462,424,603,858,1,13,10,141,434,63,148,0,0
65,461,423,602,858,1,13,10,141,435,64,148,0,0
66,461,423,602,858,1,13,10,141,435,65,148,0,0
67,461,424,602,857,1,13,10,141,433,66,148,0,0
68,460,424,601,857,1,13,10,141,433,67,148,0,0
69,459,424,599,857,1,13,10,140,433,68,148,0,0
70,461,423,603,857,1,13,10,142,434,69,148,0,0
71,461,423,604,861,1,13,10,143,438,70,148,0,0
72,461,421,604,861,1,13,10,143,440,71,148,0,0
73,463,422,605,862,1,13,10,142,440,72,148,0,0
74,465,424,606,860,1,13,10,141,436,73,148,0,0
75,467,419,607,859,1,13,10,140,440,74,148,0,0
76,472,417,612,855,1,13,10,140,438,75,148,0,0
77,478,413,618,851,1,13,10,140,438,76,148,0,0
78,484,405,624,844,1,13,10,140,439,77,148,0,0
79,485,403,624,843,1,13,10,139,440,78,148,0,0
80,494,401,631,841,1,13,10,137,440,79,148,0,0
81,510,403,645,832,1,13,10,135,429,80,148,0,0
82,525,409,659,827,1,13,10,134,418,81,148,0,0
83,531,406,669,828,1,13,10,138,422,82,148,0,0
84,540,408,680,828,1,13,10,140,420,83,148,0,0
85,562,405,706,824,1,13,10,144,419,84,148,0,0
86,595,401,739,825,1,13,10,144,424,85,148,0,0
87,613,402,759,823,1,13,10,146,421,86,148,0,0
88,631,398,782,824,1,13,10,151,426,87,148,0,0
89,682,393,829,813,1,13,10,147,420,88,148,0,0
90,722,392,866,809,1,13,10,144,417,89,148,0,0
91,750,404,889,802,1,13,10,139,398,90,148,0,0
92,775,401,920,802,1,13,10,145,401,91,148,0,0
93,821,399,961,791,1,13,10,140,392,92,148,0,0
94,849,393,991,792,1,13,10,142,399,93,148,0,0
95,862,393,1004,794,1,13,10,142,401,94,148,0,0
96,874,387,1008,767,1,13,10,134,380,95,148,0,0
97,877,377,1009,752,1,13,10,132,375,96,148,0,0
98,885,369,1017,746,1,13,10,132,377,97,148,0,0
99,888,366,1015,726,1,13,10,127,360,98,148,0,0
100,882,371,1010,725,1,13,10,128,354,99,148,0,0
101,880,371,1006,718,1,13,10,126,347,100,148,0,0
102,872,367,1001,719,1,13,10,129,352,101,148,0,0
103,862,369,991,718,1,13,10,129,349,102,148,0,0
104,857,374,983,714,1,13,10,126,340,103,148,0,0
105,852,377,977,711,1,13,10,125,334,104,148,0,0
106,847,367,978,722,1,13,10,131,355,105,148,0,0
107,850,397,983,753,1,13,10,133,356,106,148,0,0
108,829,407,967,773,1,13,10,138,366,107,148,0,0
109,871,390,994,726,1,13,10,123,336,108,148,0,0
110,889,384,1007,709,1,13,10,118,325,109,148,0,0
111,898,376,1013,699,1,13,10,115,323,110,148,0,0
112,907,367,1021,694,1,13,10,114,327,111,148,0,0
113,909,363,1022,689,1,13,10,113,326,112,148,0,0
114,909,363,1020,685,1,13,10,111,322,113,148,0,0
115,904,366,1014,686,1,13,10,110,320,114,148,0,0
116,903,369,1013,692,1,13,10,110,323,115,148,0,0
117,901,371,1011,696,1,13,10,110,325,116,148,0,0
118,899,373,1010,696,1,13,10,111,323,117,148,0,0
119,895,376,1004,691,1,13,10,109,315,118,148,0,0
120,893,380,1001,689,1,13,10,108,309,119,148,0,0
121,891,376,1002,695,1,13,10,111,319,120,148,0,0
122,890,374,1003,698,1,13,10,113,324,121,148,0,0
123,890,374,1003,699,1,13,10,113,325,122,148,0,0
124,890,374,1002,699,1,13,10,112,325,123,148,0,0
125,890,374,1001,700,1,13,10,111,326,124,148,0,0
126,890,375,1001,701,1,13,10,111,326,125,148,0,0
127,890,375,1001,701,1,13,10,111,326,126,148,0,0
128,890,376,1001,701,1,13,10,111,325,127,148,0,0
129,891,376,1001,701,1,13,10,110,325,128,148,0,0
130,890,377,1000,701,1,13,10,110,324,129,148,0,0
131,890,382,997,698,1,13,10,107,316,130,148,0,0
132,890,384,996,697,1,13,10,106,313,131,148,0,0
133,890,385,996,696,1,13,10,106,311,132,148,0,0
134,890,385,996,696,1,13,10,106,311,133,148,0,0
135,890,385,996,696,1,13,10,106,311,134,148,0,0
136,891,386,997,695,1,13,10,106,309,135,148,0,0
137,891,386,998,694,1,13,10,107,308,136,148,0,0
138,891,386,998,694,1,13,10,107,308,137,148,0,0
139,891,385,999,694,1,13,10,108,309,138,148,0,0
140,891,386,999,694,1,13,10,108,308,139,148,0,0
141,891,381,1001,698,1,13,10,110,317,140,148,0,0
142,890,384,999,696,1,13,10,109,312,141,148,0,0
143,890,385,999,695,1,13,10,109,310,142,148,0,0
144,890,385,999,696,1,13,10,109,311,143,148,0,0
145,890,383,999,693,1,13,10,109,310,144,148,0,0
146,891,383,997,682,1,13,10,106,299,145,148,0,0
147,889,384,1000,693,1,13,10,111,309,146,148,0,0
148,891,381,1004,695,1,13,10,113,314,147,148,0,0
149,891,381,1004,695,1,13,10,113,314,148,148,1,0
151,896,382,1009,696,1,13,10,113,314,0,148,0,0
152,896,380,1011,697,1,13,10,115,317,1,148,0,0
153,892,382,1007,694,1,13,10,115,312,2,148,0,0
154,889,375,1007,697,1,13,10,118,322,3,148,0,0
155,888,374,1007,697,1,13,10,119,323,4,148,0,0
156,887,374,1006,697,1,13,10,119,323,5,148,0,0
157,886,374,1006,699,1,13,10,120,325,6,148,0,0
158,885,373,1001,697,1,13,10,116,324,7,148,0,0
159,883,374,997,695,1,13,10,114,321,8,148,0,0
160,883,373,994,689,1,13,10,111,316,9,148,0,0
161,882,373,990,686,1,13,10,108,313,10,148,0,0
162,881,378,982,679,1,13,10,101,301,11,148,0,0
163,880,378,981,677,1,13,10,101,299,12,148,0,0
41,110,179,146,257,2,13,10,36,78,0,63,0,0
84,125,213,160,326,2,13,10,35,113,0,63,0,0
86,130,216,165,333,2,13,10,35,117,0,63,0,1
87,130,220,166,339,2,13,10,36,119,1,63,0,0
88,131,222,167,340,2,13,10,36,118,2,63,0,0
89,134,224,171,341,2,13,10,37,117,3,63,0,0
90,136,225,174,346,2,13,10,38,121,4,63,0,0
91,138,223,178,350,2,13,10,40,127,5,63,0,0
92,137,226,179,353,2,13,10,42,127,6,63,0,0
93,137,226,180,356,2,13,10,43,130,7,63,0,0
94,140,227,184,361,2,13,10,44,134,8,63,0,0
95,142,230,188,366,2,13,10,46,136,9,63,0,0
96,144,228,191,369,2,13,10,47,141,10,63,0,0
97,145,231,193,373,2,13,10,48,142,11,63,0,0
98,146,233,194,375,2,13,10,48,142,12,63,0,0
99,148,232,197,378,2,13,10,49,146,13,63,0,0
100,149,235,200,388,2,13,10,51,153,14,63,0,0
101,152,233,205,391,2,13,10,53,158,15,63,0,0
102,151,236,205,397,2,13,10,54,161,16,63,0,0
103,152,237,207,401,2,13,10,55,164,17,63,0,0
104,153,237,209,405,2,13,10,56,168,18,63,0,0
105,156,239,214,416,2,13,10,58,177,19,63,0,0
106,160,238,220,421,2,13,10,60,183,20,63,0,0
107,162,241,223,426,2,13,10,61,185,21,63,0,0
108,162,243,225,431,2,13,10,63,188,22,63,0,0
109,165,242,229,434,2,13,10,64,192,23,63,0,0
110,166,251,232,448,2,13,10,66,197,24,63,0,0
111,172,254,239,455,2,13,10,67,201,25,63,0,0
112,174,257,241,462,2,13,10,67,205,26,63,0,0
113,173,261,239,465,2,13,10,66,204,27,63,0,0
114,172,261,239,469,2,13,10,67,208,28,63,0,0
115,171,264,242,479,2,13,10,71,215,29,63,0,0
116,172,265,244,485,2,13,10,72,220,30,63,0,0
117,168,267,241,491,2,13,10,73,224,31,63,0,0
118,162,271,237,502,2,13,10,75,231,32,63,0,0
119,157,271,234,507,2,13,10,77,236,33,63,0,0
120,154,274,235,518,2,13,10,81,244,34,63,0,0
121,152,278,236,530,2,13,10,84,252,35,63,0,0
122,146,283,232,540,2,13,10,86,257,36,63,0,0
123,139,291,228,557,2,13,10,89,266,37,63,0,0
124,130,291,223,565,2,13,10,93,274,38,63,0,0
125,126,300,221,580,2,13,10,95,280,39,63,0,0
126,127,306,227,599,2,13,10,100,293,40,63,0,0
127,128,307,233,613,2,13,10,105,306,41,63,0,0
128,123,319,235,646,2,13,10,112,327,42,63,0,0
129,124,322,239,658,2,13,10,115,336,43,63,0,0
130,130,330,250,683,2,13,10,120,353,44,63,0,0
131,143,339,267,704,2,13,10,124,365,45,63,0,0
132,151,339,283,726,2,13,10,132,387,46,63,0,0
133,160,353,300,764,2,13,10,140,411,47,63,0,0
134,177,352,325,786,2,13,10,148,434,48,63,0,0
135,203,359,361,815,2,13,10,158,456,49,63,0,0
136,226,360,393,845,2,13,10,167,485,50,63,0,0
137,259,377,428,869,2,13,10,169,492,51,63,0,0
138,288,404,471,926,2,13,10,183,522,52,63,0,0
139,320,420,511,959,2,13,10,191,539,53,63,0,0
140,373,446,572,999,2,13,10,199,553,54,63,0,0
141,418,476,628,1051,2,13,10,210,575,55,63,0,0
142,474,489,689,1076,2,13,10,215,587,56,63,0,0
143,545,521,764,1078,2,13,10,219,557,57,63,0,0
144,613,553,831,1080,2,13,10,218,527,58,63,0,0
145,684,582,892,1080,2,13,10,208,498,59,63,0,0
146,789,635,979,1080,2,13,10,190,445,60,63,0,0
147,907,673,1086,1080,2,13,10,179,407,61,63,0,0
148,1047,736,1216,1080,2,13,10,169,344,62,63,0,0
149,1113,764,1275,1080,2,13,10,162,316,63,63,1,0
34,240,212,277,345,3,13,10,37,133,0,9,0,0
35,221,213,259,347,3,13,10,38,134,1,9,0,0
36,202,211,242,350,3,13,10,40,139,2,9,0,0
37,172,210,214,353,3,13,10,42,143,3,9,0,0
38,149,212,191,354,3,13,10,42,142,4,9,0,0
39,127,215,169,351,3,13,10,42,136,5,9,0,0
40,101,203,149,355,3,13,10,48,152,6,9,0,0
41,82,197,131,351,3,13,10,49,154,7,9,0,0
42,58,205,105,354,3,13,10,47,149,8,9,0,0
43,38,204,85,356,3,13,10,47,152,9,9,0,0
89,932,347,992,680,4,13,10,60,333,0,9,0,0
90,936,353,995,677,4,13,10,59,324,1,9,0,0
91,941,352,1000,676,4,13,10,59,324,2,9,0,0
92,942,350,1004,686,4,13,10,62,336,3,9,0,0
93,948,355,1008,671,4,13,10,60,316,4,9,0,0
94,956,343,1017,667,4,13,10,61,324,5,9,0,0
95,961,341,1022,667,4,13,10,61,326,6,9,0,0
96,967,348,1021,630,4,13,10,54,282,7,9,0,0
97,970,347,1026,646,4,13,10,56,299,8,9,0,0
98,985,349,1022,532,4,13,10,37,183,9,9,0,0
105,963,425,1016,678,5,13,10,53,253,0,1,0,0
106,939,411,1003,714,5,13,10,64,303,1,1,0,0
107,866,374,962,550,6,13,10,96,176,0,0,0,0
108,929,387,1004,688,7,13,10,75,301,0,0,0,0
109,804,408,906,783,8,13,10,102,375,0,61,0,1
110,750,409,854,789,8,13,10,104,380,1,61,0,0
111,720,412,826,793,8,13,10,106,381,2,61,0,0
112,677,404,786,795,8,13,10,109,391,3,61,0,0
113,621,390,737,795,8,13,10,116,405,4,61,0,0
114,582,382,700,790,8,13,10,118,408,5,61,0,0
115,535,377,653,780,8,13,10,118,403,6,61,0,0
116,488,374,610,780,8,13,10,122,406,7,61,0,0
117,460,369,583,772,8,13,10,123,403,8,61,0,0
118,409,363,535,766,8,13,10,126,403,9,61,0,0
119,382,362,512,765,8,13,10,130,403,10,61,0,0
120,366,352,492,740,8,13,10,126,388,11,61,0,0
121,350,345,474,727,8,13,10,124,382,12,61,0,0
122,341,343,462,723,8,13,10,121,380,13,61,0,0
123,325,340,441,704,8,13,10,116,364,14,61,0,0
124,325,333,438,684,8,13,10,113,351,15,61,0,0
125,327,330,438,671,8,13,10,111,341,16,61,0,0
126,323,319,432,653,8,13,10,109,334,17,61,0,0
127,312,312,423,654,8,13,10,111,342,18,61,0,0
128,304,313,409,639,8,13,10,105,326,19,61,0,0
129,297,314,393,610,8,13,10,96,296,20,61,0,0
130,294,311,390,607,8,13,10,96,296,21,61,0,0
131,292,308,387,598,8,13,10,95,290,22,61,0,0
132,285,303,377,583,8,13,10,92,280,23,61,0,0
133,280,300,369,574,8,13,10,89,274,24,61,0,0
134,274,296,358,558,8,13,10,84,262,25,61,0,0
135,274,292,337,476,8,13,10,63,184,26,61,0,0
136,269,293,330,461,8,13,10,61,168,27,61,0,0
137,254,287,334,515,8,13,10,80,228,28,61,0,0
138,244,282,327,523,8,13,10,83,241,29,61,0,0
139,238,278,322,525,8,13,10,84,247,30,61,0,0
140,231,276,313,519,8,13,10,82,243,31,61,0,0
141,227,274,307,510,8,13,10,80,236,32,61,0,0
142,226,272,307,511,8,13,10,81,239,33,61,0,0
143,227,269,306,504,8,13,10,79,235,34,61,0,0
144,221,267,297,494,8,13,10,76,227,35,61,0,0
145,216,267,289,487,8,13,10,73,220,36,61,0,0
146,213,266,282,474,8,13,10,69,208,37,61,0,0
147,210,263,281,475,8,13,10,71,212,38,61,0,0
148,209,262,279,474,8,13,10,70,212,39,61,0,0
149,207,260,276,466,8,13,10,69,206,40,61,0,0
150,204,256,270,455,8,13,10,66,199,41,61,0,0
151,200,257,267,456,8,13,10,67,199,42,61,0,0
152,200,255,263,446,8,13,10,63,191,43,61,0,0
153,203,253,266,444,8,13,10,63,191,44,61,0,0
154,209,252,271,441,8,13,10,62,189,45,61,0,0
155,215,252,275,433,8,13,10,60,181,46,61,0,0
156,218,244,279,429,8,13,10,61,185,47,61,0,0
157,220,245,282,426,8,13,10,62,181,48,61,0,0
158,232,242,293,421,8,13,10,61,179,49,61,0,0
159,243,238,305,420,8,13,10,62,182,50,61,0,0
160,252,238,318,422,8,13,10,66,184,51,61,0,0
161,260,240,324,416,8,13,10,64,176,52,61,0,0
162,264,239,327,415,8,13,10,63,176,53,61,0,0
163,268,239,330,413,8,13,10,62,174,54,61,0,0
164,277,239,337,409,8,13,10,60,170,55,61,0,0
165,285,238,344,404,8,13,10,59,166,56,61,0,0
166,289,239,348,404,8,13,10,59,165,57,61,0,0
167,289,239,348,406,8,13,10,59,167,58,61,0,0
168,289,240,349,409,8,13,10,60,169,59,61,0,0
169,291,240,353,412,8,13,10,62,172,60,61,0,0
170,295,240,356,411,8,13,10,61,171,61,61,1,0
149,1198,801,1424,1073,9,13,10,226,272,0,0,0,0
219,104,202,139,302,14,13,10,35,100,0,46,0,1
220,104,203,140,305,14,13,10,36,102,1,46,0,0
221,104,204,139,307,14,13,10,35,103,2,46,0,0
222,104,205,140,311,14,13,10,36,106,3,46,0,0
223,105,206,141,314,14,13,10,36,108,4,46,0,0
224,106,205,142,316,14,13,10,36,111,5,46,0,0
225,105,210,142,321,14,13,10,37,111,6,46,0,0
226,106,211,143,324,14,13,10,37,113,7,46,0,0
227,107,211,144,327,14,13,10,37,116,8,46,0,0
228,108,214,145,330,14,13,10,37,116,9,46,0,0
229,112,214,149,332,14,13,10,37,118,10,46,0,0
230,117,215,153,333,14,13,10,36,118,11,46,0,0
231,120,225,155,336,14,13,10,35,111,12,46,0,0
232,120,219,157,338,14,13,10,37,119,13,46,0,0
233,123,227,159,345,14,13,10,36,118,14,46,0,0
234,127,225,166,349,14,13,10,39,124,15,46,0,0
235,131,225,173,353,14,13,10,42,128,16,46,0,0
236,132,228,175,358,14,13,10,43,130,17,46,0,0
237,129,230,173,362,14,13,10,44,132,18,46,0,0
238,126,231,171,368,14,13,10,45,137,19,46,0,0
239,127,229,175,370,14,13,10,48,141,20,46,0,0
240,129,229,178,376,14,13,10,49,147,21,46,0,0
241,129,230,179,380,14,13,10,50,150,22,46,0,0
242,126,229,178,384,14,13,10,52,155,23,46,0,0
243,123,232,177,388,14,13,10,54,156,24,46,0,0
244,122,235,177,392,14,13,10,55,157,25,46,0,0
245,123,234,180,398,14,13,10,57,164,26,46,0,0
246,123,237,181,404,14,13,10,58,167,27,46,0,0
247,120,238,179,410,14,13,10,59,172,28,46,0,0
248,117,239,177,417,14,13,10,60,178,29,46,0,0
249,114,240,178,431,14,13,10,64,191,30,46,0,0
250,116,237,180,431,14,13,10,64,194,31,46,0,0
251,116,244,181,440,14,13,10,65,196,32,46,0,0
252,115,247,179,442,14,13,10,64,195,33,46,0,0
253,111,249,180,460,14,13,10,69,211,34,46,0,0
254,107,253,175,460,14,13,10,68,207,35,46,0,0
255,104,253,174,464,14,13,10,70,211,36,46,0,0
256,101,255,173,472,14,13,10,72,217,37,46,0,0
257,96,258,171,483,14,13,10,75,225,38,46,0,0
258,88,260,165,488,14,13,10,77,228,39,46,0,0
259,75,263,153,494,14,13,10,78,231,40,46,0,0
260,67,265,148,504,14,13,10,81,239,41,46,0,0
261,56,266,142,519,14,13,10,86,253,42,46,0,0
262,45,272,131,530,14,13,10,86,258,43,46,0,0
263,29,273,115,539,14,13,10,86,266,44,46,0,0
264,20,281,103,541,14,13,10,83,260,45,46,0,0
265,14,283,98,549,14,13,10,84,266,46,46,1,0
297,164,218,200,325,15,13,10,36,107,0,11,0,0
298,170,216,207,328,15,13,10,37,112,1,11,0,0
299,175,217,212,328,15,13,10,37,111,2,11,0,0
300,181,218,219,331,15,13,10,38,113,3,11,0,0
301,189,219,229,334,15,13,10,40,115,4,11,0,0
302,199,220,241,336,15,13,10,42,116,5,11,0,0
303,211,227,252,338,15,13,10,41,111,6,11,0,0
304,220,226,261,337,15,13,10,41,111,7,11,0,0
305,229,224,271,337,15,13,10,42,113,8,11,0,0
306,241,218,285,339,15,13,10,44,121,9,11,0,0
307,249,216,292,338,15,13,10,43,122,10,11,0,0
308,255,216,299,340,15,13,10,44,124,11,11,0,0
317,233,223,272,334,15,13,10,39,111,0,11,0,0
318,219,224,259,334,15,13,10,40,110,1,11,0,0
319,209,222,250,333,15,13,10,41,111,2,11,0,0
320,196,221,236,329,15,13,10,40,108,3,11,0,0
321,182,217,223,328,15,13,10,41,111,4,11,0,0
322,172,212,212,324,15,13,10,40,112,5,11,0,0
323,162,215,200,323,15,13,10,38,108,6,11,0,0
324,156,212,192,315,15,13,10,36,103,7,11,0,0
325,148,212,183,313,15,13,10,35,101,8,11,0,0
674,34,312,93,656,17,13,10,59,344,0,22,0,1
675,47,328,111,703,17,13,10,64,375,1,22,0,0
676,65,326,132,706,17,13,10,67,380,2,22,0,0
677,104,341,172,714,17,13,10,68,373,3,22,0,0
678,131,347,203,731,17,13,10,72,384,4,22,0,0
679,157,350,236,755,17,13,10,79,405,5,22,0,0
680,195,361,286,800,17,13,10,91,439,6,22,0,0
681,224,367,321,818,17,13,10,97,451,7,22,0,0
682,263,386,372,867,17,13,10,109,481,8,22,0,0
683,297,397,414,897,17,13,10,117,500,9,22,0,0
684,342,418,476,955,17,13,10,134,537,10,22,0,0
685,391,448,541,1020,17,13,10,150,572,11,22,0,0
686,441,475,594,1044,17,13,10,153,569,12,22,0,0
687,503,504,663,1065,17,13,10,160,561,13,22,0,0
688,601,527,767,1080,17,13,10,166,553,14,22,0,0
689,720,580,892,1080,17,13,10,172,500,15,22,0,0
690,843,632,1020,1080,17,13,10,177,448,16,22,0,0
691,984,671,1157,1080,17,13,10,173,409,17,22,0,0
692,1132,725,1302,1080,17,13,10,170,355,18,22,0,0
693,1298,752,1476,1080,17,13,10,178,328,19,22,0,0
694,1466,819,1634,1080,17,13,10,168,261,20,22,0,0
695,1646,858,1804,1075,17,13,10,158,217,21,22,0,0
696,1778,894,1915,1080,17,13,10,137,186,22,22,1,0
742,112,187,147,257,18,13,10,35,70,0,33,0,0
744,113,189,148,259,18,13,10,35,70,0,33,0,0
745,114,189,149,261,18,13,10,35,72,1,33,0,0
748,115,190,150,267,18,13,10,35,77,0,33,0,0
749,115,190,151,272,18,13,10,36,82,1,33,0,0
750,116,190,151,271,18,13,10,35,81,2,33,0,0
761,126,204,161,295,18,13,10,35,91,0,33,0,0
762,131,200,167,298,18,13,10,36,98,1,33,0,0
763,131,200,168,300,18,13,10,37,100,2,33,0,0
767,140,214,175,321,18,13,10,35,107,0,33,0,1
768,142,215,177,326,18,13,10,35,111,1,33,0,0
769,142,218,177,327,18,13,10,35,109,2,33,0,0
770,141,219,177,331,18,13,10,36,112,3,33,0,0
771,141,223,177,337,18,13,10,36,114,4,33,0,0
772,145,221,181,334,18,13,10,36,113,5,33,0,0
773,147,224,183,337,18,13,10,36,113,6,33,0,0
774,145,223,183,340,18,13,10,38,117,7,33,0,0
775,144,226,184,352,18,13,10,40,126,8,33,0,0
776,145,227,186,355,18,13,10,41,128,9,33,0,0
777,149,228,190,359,18,13,10,41,131,10,33,0,0
778,150,229,192,361,18,13,10,42,132,11,33,0,0
779,146,229,189,364,18,13,10,43,135,12,33,0,0
780,144,232,188,372,18,13,10,44,140,13,33,0,0
781,143,231,189,377,18,13,10,46,146,14,33,0,0
782,143,233,192,389,18,13,10,49,156,15,33,0,0
783,140,235,190,394,18,13,10,50,159,16,33,0,0
784,135,236,186,398,18,13,10,51,162,17,33,0,0
785,134,238,185,403,18,13,10,51,165,18,33,0,0
786,133,238,187,410,18,13,10,54,172,19,33,0,0
787,132,240,188,423,18,13,10,56,183,20,33,0,0
788,126,240,185,429,18,13,10,59,189,21,33,0,0
789,120,247,179,441,18,13,10,59,194,22,33,0,0
790,116,254,174,444,18,13,10,58,190,23,33,0,0
791,113,255,174,452,18,13,10,61,197,24,33,0,0
792,107,260,168,457,18,13,10,61,197,25,33,0,0
793,95,259,157,461,18,13,10,62,202,26,33,0,0
794,83,263,145,466,18,13,10,62,203,27,33,0,0
795,72,262,138,475,18,13,10,66,213,28,33,0,0
796,62,264,130,486,18,13,10,68,222,29,33,0,0
797,47,268,120,508,18,13,10,73,240,30,33,0,0
798,32,271,105,514,18,13,10,73,243,31,33,0,0
799,22,287,93,529,18,13,10,71,242,32,33,0,0
800,15,290,87,537,18,13,10,72,247,33,33,1,0
954,138,198,180,290,20,13,10,42,92,0,1,0,0
955,139,199,177,290,20,13,10,38,91,1,1,0,0
957,142,202,177,295,20,13,10,35,93,0,1,0,0
958,143,201,178,298,20,13,10,35,97,1,1,0,0
927,242,231,281,335,22,13,10,39,104,0,6,0,0
928,231,229,268,328,22,13,10,37,99,1,6,0,0
929,219,229,257,332,22,13,10,38,103,2,6,0,0
930,205,227,243,332,22,13,10,38,105,3,6,0,0
931,193,224,230,325,22,13,10,37,101,4,6,0,0
932,181,224,218,326,22,13,10,37,102,5,6,0,0
933,169,221,207,326,22,13,10,38,105,6,6,0,0
967,110,231,145,327,26,13,10,35,96,0,41,0,1
968,112,232,147,328,26,13,10,35,96,1,41,0,0
969,114,232,150,328,26,13,10,36,96,2,41,0,0
970,117,233,153,330,26,13,10,36,97,3,41,0,0
971,118,230,158,336,26,13,10,40,106,4,41,0,0
972,120,239,157,338,26,13,10,37,99,5,41,0,0
973,121,242,157,336,26,13,10,36,94,6,41,0,0
974,122,245,159,340,26,13,10,37,95,7,41,0,0
975,121,241,161,344,26,13,10,40,103,8,41,0,0
976,118,241,160,351,26,13,10,42,110,9,41,0,0
977,115,241,159,353,26,13,10,44,112,10,41,0,0
978,113,243,157,357,26,13,10,44,114,11,41,0,0
979,111,244,158,363,26,13,10,47,119,12,41,0,0
980,109,244,157,366,26,13,10,48,122,13,41,0,0
981,108,245,157,369,26,13,10,49,124,14,41,0,0
982,107,247,156,372,26,13,10,49,125,15,41,0,0
983,106,246,158,377,26,13,10,52,131,16,41,0,0
984,107,250,159,384,26,13,10,52,134,17,41,0,0
985,107,250,160,386,26,13,10,53,136,18,41,0,0
986,108,253,162,391,26,13,10,54,138,19,41,0,0
987,109,256,163,392,26,13,10,54,136,20,41,0,0
988,108,256,166,404,26,13,10,58,148,21,41,0,0
989,109,257,167,406,26,13,10,58,149,22,41,0,0
990,109,258,168,411,26,13,10,59,153,23,41,0,0
991,109,250,175,416,26,13,10,66,166,24,41,0,0
992,108,247,177,418,26,13,10,69,171,25,41,0,0
993,110,251,180,425,26,13,10,70,174,26,41,0,0
994,110,252,180,427,26,13,10,70,175,27,41,0,0
995,111,262,180,435,26,13,10,69,173,28,41,0,0
996,108,262,178,441,26,13,10,70,179,29,41,0,0
997,105,253,180,447,26,13,10,75,194,30,41,0,0
998,102,267,173,453,26,13,10,71,186,31,41,0,0
999,98,278,165,459,26,13,10,67,181,32,41,0,0
1000,90,278,160,471,26,13,10,70,193,33,41,0,0
1001,86,286,156,481,26,13,10,70,195,34,41,0,0
1002,80,289,151,484,26,13,10,71,195,35,41,0,0
1003,73,296,144,490,26,13,10,71,194,36,41,0,0
1004,58,297,134,503,26,13,10,76,206,37,41,0,0
1005,46,301,123,510,26,13,10,77,209,38,41,0,0
1006,33,300,112,516,26,13,10,79,216,39,41,0,0
1007,22,304,94,512,26,13,10,72,208,40,41,0,0
1008,15,307,89,517,26,13,10,74,210,41,41,1,0
1032,34,284,75,398,26,13,10,41,114,0,41,0,0
1033,35,283,74,392,26,13,10,39,109,1,41,0,0
1034,37,282,72,384,26,13,10,35,102,2,41,0,0
1035,38,285,73,385,26,13,10,35,100,3,41,0,0
957,159,201,194,299,27,13,10,35,98,0,43,0,1
958,160,202,195,301,27,13,10,35,99,1,43,0,0
959,161,204,198,305,27,13,10,37,101,2,43,0,0
960,162,207,199,308,27,13,10,37,101,3,43,0,0
961,164,208,201,311,27,13,10,37,103,4,43,0,0
962,165,211,202,313,27,13,10,37,102,5,43,0,0
963,164,211,201,315,27,13,10,37,104,6,43,0,0
964,163,212,201,317,27,13,10,38,105,7,43,0,0
965,167,212,205,320,27,13,10,38,108,8,43,0,0
966,169,214,208,324,27,13,10,39,110,9,43,0,0
967,169,216,209,326,27,13,10,40,110,10,43,0,0
968,175,220,213,327,27,13,10,38,107,11,43,0,0
969,179,222,217,329,27,13,10,38,107,12,43,0,0
970,188,224,225,329,27,13,10,37,105,13,43,0,0
971,195,229,232,332,27,13,10,37,103,14,43,0,0
972,202,229,239,334,27,13,10,37,105,15,43,0,0
973,214,230,251,335,27,13,10,37,105,16,43,0,0
974,226,238,262,335,27,13,10,36,97,17,43,0,0
975,239,236,276,336,27,13,10,37,100,18,43,0,0
976,249,233,287,336,27,13,10,38,103,19,43,0,0
977,256,234,294,337,27,13,10,38,103,20,43,0,0
988,251,236,290,342,27,13,10,39,106,0,43,0,1
989,246,244,283,342,27,13,10,37,98,1,43,0,0
990,239,241,279,348,27,13,10,40,107,2,43,0,0
991,227,241,269,351,27,13,10,42,110,3,43,0,0
992,220,241,264,353,27,13,10,44,112,4,43,0,0
993,212,242,260,362,27,13,10,48,120,5,43,0,0
994,208,241,258,370,27,13,10,50,129,6,43,0,0
995,208,242,261,377,27,13,10,53,135,7,43,0,0
996,209,243,264,383,27,13,10,55,140,8,43,0,0
997,211,245,267,389,27,13,10,56,144,9,43,0,0
998,215,247,273,400,27,13,10,58,153,10,43,0,0
999,220,247,280,407,27,13,10,60,160,11,43,0,0
1000,224,248,286,413,27,13,10,62,165,12,43,0,0
1001,222,249,286,416,27,13,10,64,167,13,43,0,0
1002,224,255,287,421,27,13,10,63,166,14,43,0,0
1003,228,262,289,425,27,13,10,61,163,15,43,0,0
1004,233,263,294,430,27,13,10,61,167,16,43,0,0
1005,232,265,296,441,27,13,10,64,176,17,43,0,0
1006,234,266,299,445,27,13,10,65,179,18,43,0,0
1007,238,267,304,452,27,13,10,66,185,19,43,0,0
1008,244,268,310,456,27,13,10,66,188,20,43,0,0
1009,254,270,321,461,27,13,10,67,191,21,43,0,0
1010,258,276,327,471,27,13,10,69,195,22,43,0,0
1011,266,277,336,475,27,13,10,70,198,23,43,0,0
1012,280,281,350,483,27,13,10,70,202,24,43,0,0
1013,291,281,362,486,27,13,10,71,205,25,43,0,0
1014,300,286,371,493,27,13,10,71,207,26,43,0,0
1015,301,290,373,494,27,13,10,72,204,27,43,0,0
1016,310,294,380,493,27,13,10,70,199,28,43,0,0
1017,312,297,385,508,27,13,10,73,211,29,43,0,0
1018,313,298,387,516,27,13,10,74,218,30,43,0,0
1019,307,301,384,526,27,13,10,77,225,31,43,0,0
1020,296,305,376,539,27,13,10,80,234,32,43,0,0
1021,278,308,356,541,27,13,10,78,233,33,43,0,0
1022,262,312,344,556,27,13,10,82,244,34,43,0,0
1023,240,312,322,557,27,13,10,82,245,35,43,0,0
1024,214,316,300,569,27,13,10,86,253,36,43,0,0
1025,188,321,276,581,27,13,10,88,260,37,43,0,0
1026,156,323,243,584,27,13,10,87,261,38,43,0,0
1027,125,326,216,596,27,13,10,91,270,39,43,0,0
1028,97,329,187,597,27,13,10,90,268,40,43,0,0
1029,65,332,158,601,27,13,10,93,269,41,43,0,0
1030,41,325,137,604,27,13,10,96,279,42,43,0,0
1031,25,327,123,610,27,13,10,98,283,43,43,1,0
978,154,220,189,326,31,13,10,35,106,0,11,0,0
979,157,218,193,330,31,13,10,36,112,1,11,0,0
980,158,216,195,333,31,13,10,37,117,2,11,0,0
981,158,216,196,335,31,13,10,38,119,3,11,0,0
982,160,216,198,339,31,13,10,38,123,4,11,0,0
983,162,217,200,343,31,13,10,38,126,5,11,0,0
984,162,217,201,345,31,13,10,39,128,6,11,0,0
985,161,218,199,346,31,13,10,38,128,7,11,0,0
986,158,218,198,349,31,13,10,40,131,8,11,0,0
987,157,221,196,349,31,13,10,39,128,9,11,0,0
988,155,221,194,351,31,13,10,39,130,10,11,0,0
989,156,222,191,339,31,13,10,35,117,11,11,0,0
998,133,236,182,419,33,13,10,49,183,0,25,0,1
999,133,236,183,423,33,13,10,50,187,1,25,0,0
1000,138,256,180,415,33,13,10,42,159,2,25,0,0
1001,137,242,181,410,33,13,10,44,168,3,25,0,0
1002,136,238,184,418,33,13,10,48,180,4,25,0,0
1003,138,244,186,428,33,13,10,48,184,5,25,0,0
1004,138,242,187,429,33,13,10,49,187,6,25,0,0
1005,137,240,187,434,33,13,10,50,194,7,25,0,0
1006,133,240,185,440,33,13,10,52,200,8,25,0,0
1007,131,240,183,442,33,13,10,52,202,9,25,0,0
1008,128,242,183,454,33,13,10,55,212,10,25,0,0
1009,127,244,182,454,33,13,10,55,210,11,25,0,0
1010,124,246,180,463,33,13,10,56,217,12,25,0,0
1011,118,254,174,467,33,13,10,56,213,13,25,0,0
1012,111,256,167,470,33,13,10,56,214,14,25,0,0
1013,105,261,161,474,33,13,10,56,213,15,25,0,0
1014,101,258,159,482,33,13,10,58,224,16,25,0,0
1015,95,258,154,487,33,13,10,59,229,17,25,0,0
1016,87,263,148,496,33,13,10,61,233,18,25,0,0
1017,73,263,135,503,33,13,10,62,240,19,25,0,0
1018,62,263,125,508,33,13,10,63,245,20,25,0,0
1019,52,269,115,515,33,13,10,63,246,21,25,0,0
1020,39,269,103,521,33,13,10,64,252,22,25,0,0
1021,30,274,95,526,33,13,10,65,252,23,25,0,0
1022,23,279,86,531,33,13,10,63,252,24,25,0,0
1023,16,282,80,537,33,13,10,64,255,25,25,1,0
1025,17,286,73,520,33,13,10,56,234,0,25,0,0
1026,18,282,75,531,33,13,10,57,249,1,25,0,0
1027,19,284,75,535,33,13,10,56,251,2,25,0,0
1028,14,285,71,538,33,13,10,57,253,3,25,0,0
1031,27,272,100,605,33,13,10,73,333,0,25,0,0
1032,29,298,95,597,33,13,10,66,299,1,25,0,0
1033,27,298,91,597,33,13,10,64,299,2,25,0,0
1034,25,300,90,604,33,13,10,65,304,3,25,0,0
1036,27,282,79,534,33,13,10,52,252,0,25,0,0
1037,26,275,77,534,33,13,10,51,259,1,25,0,0
1038,24,274,76,534,33,13,10,52,260,2,25,0,0
1039,29,269,75,504,33,13,10,46,235,3,25,0,0
1040,29,267,74,500,33,13,10,45,233,4,25,0,0
1045,28,272,77,534,33,13,10,49,262,0,25,0,0
1046,29,274,76,531,33,13,10,47,257,1,25,0,0
1047,29,273,76,531,33,13,10,47,258,2,25,0,0
1048,28,273,75,532,33,13,10,47,259,3,25,0,0
1056,28,288,70,523,33,13,10,42,235,0,25,0,0
1057,28,289,69,523,33,13,10,41,234,1,25,0,0
1115,36,314,86,598,34,13,10,50,284,0,206,0,1
1116,39,322,86,589,34,13,10,47,267,1,206,0,0
1117,50,322,100,594,34,13,10,50,272,2,206,0,0
1118,59,320,111,603,34,13,10,52,283,3,206,0,0
1119,79,324,129,588,34,13,10,50,264,4,206,0,0
1120,96,328,152,598,34,13,10,56,270,5,206,0,0
1121,102,329,162,603,34,13,10,60,274,6,206,0,0
1122,112,338,172,607,34,13,10,60,269,7,206,0,0
1123,126,336,188,604,34,13,10,62,268,8,206,0,0
1124,139,337,203,601,34,13,10,64,264,9,206,0,0
1125,144,334,211,601,34,13,10,67,267,10,206,0,0
1126,151,336,217,603,34,13,10,66,267,11,206,0,0
1127,156,336,223,598,34,13,10,67,262,12,206,0,0
1128,164,337,231,598,34,13,10,67,261,13,206,0,0
1129,166,338,237,609,34,13,10,71,271,14,206,0,0
1130,157,317,239,625,34,13,10,82,308,15,206,0,0
1131,161,324,241,624,34,13,10,80,300,16,206,0,0
1132,157,309,243,628,34,13,10,86,319,17,206,0,0
1133,163,307,257,655,34,13,10,94,348,18,206,0,0
1134,177,317,272,664,34,13,10,95,347,19,206,0,0
1135,191,305,289,668,34,13,10,98,363,20,206,0,0
1136,202,295,307,685,34,13,10,105,390,21,206,0,0
1137,216,304,320,696,34,13,10,104,392,22,206,0,0
1138,228,303,336,706,34,13,10,108,403,23,206,0,0
1139,248,313,357,718,34,13,10,109,405,24,206,0,0
1140,266,327,374,730,34,13,10,108,403,25,206,0,0
1141,287,353,392,736,34,13,10,105,383,26,206,0,0
1142,295,370,402,761,34,13,10,107,391,27,206,0,0
1143,303,390,410,776,34,13,10,107,386,28,206,0,0
1144,309,396,417,784,34,13,10,108,388,29,206,0,0
1145,321,409,434,803,34,13,10,113,394,30,206,0,0
1146,336,418,453,822,34,13,10,117,404,31,206,0,0
1147,356,425,474,829,34,13,10,118,404,32,206,0,0
1148,369,435,493,861,34,13,10,124,426,33,206,0,0
1149,383,446,508,873,34,13,10,125,427,34,206,0,0
1150,396,459,521,874,34,13,10,125,415,35,206,0,0
1151,399,464,526,878,34,13,10,127,414,36,206,0,0
1152,404,464,532,879,34,13,10,128,415,37,206,0,0
1153,407,468,534,878,34,13,10,127,410,38,206,0,0
1154,409,463,538,877,34,13,10,129,414,39,206,0,0
1155,407,460,539,877,34,13,10,132,417,40,206,0,0
1156,405,457,538,878,34,13,10,133,421,41,206,0,0
1157,403,457,537,878,34,13,10,134,421,42,206,0,0
1158,402,456,537,878,34,13,10,135,422,43,206,0,0
1159,402,455,536,872,34,13,10,134,417,44,206,0,0
1160,399,453,534,875,34,13,10,135,422,45,206,0,0
1161,401,454,536,875,34,13,10,135,421,46,206,0,0
1162,401,455,537,876,34,13,10,136,421,47,206,0,0
1163,401,455,536,876,34,13,10,135,421,48,206,0,0
1164,399,455,535,876,34,13,10,136,421,49,206,0,0
1165,397,452,535,877,34,13,10,138,425,50,206,0,0
1166,399,452,536,874,34,13,10,137,422,51,206,0,0
1167,400,451,537,873,34,13,10,137,422,52,206,0,0
1168,400,451,538,873,34,13,10,138,422,53,206,0,0
1169,399,450,537,873,34,13,10,138,423,54,206,0,0
1170,399,450,537,873,34,13,10,138,423,55,206,0,0
1171,400,450,538,867,34,13,10,138,417,56,206,0,0
1172,400,450,538,865,34,13,10,138,415,57,206,0,0
1173,400,452,540,870,34,13,10,140,418,58,206,0,0
1174,400,452,541,872,34,13,10,141,420,59,206,0,0
1175,400,453,542,873,34,13,10,142,420,60,206,0,0
1176,399,452,541,874,34,13,10,142,422,61,206,0,0
1177,399,452,540,873,34,13,10,141,421,62,206,0,0
1178,399,452,540,874,34,13,10,141,422,63,206,0,0
1179,400,452,541,874,34,13,10,141,422,64,206,0,0
1180,397,449,539,870,34,13,10,142,421,65,206,0,0
1181,398,450,540,872,34,13,10,142,422,66,206,0,0
1182,399,450,540,873,34,13,10,141,423,67,206,0,0
1183,398,451,540,873,34,13,10,142,422,68,206,0,0
1184,399,451,540,873,34,13,10,141,422,69,206,0,0
1185,399,451,540,873,34,13,10,141,422,70,206,0,0
1186,398,451,539,873,34,13,10,141,422,71,206,0,0
1187,398,449,538,873,34,13,10,140,424,72,206,0,0
1188,397,451,536,873,34,13,10,139,422,73,206,0,0
1189,398,451,537,873,34,13,10,139,422,74,206,0,0
1190,398,452,537,873,34,13,10,139,421,75,206,0,0
1191,400,454,537,873,34,13,10,137,419,76,206,0,0
1192,400,454,538,873,34,13,10,138,419,77,206,0,0
1193,401,454,539,873,34,13,10,138,419,78,206,0,0
1194,401,452,539,873,34,13,10,138,421,79,206,0,0
1195,401,452,539,873,34,13,10,138,421,80,206,0,0
1196,400,452,537,873,34,13,10,137,421,81,206,0,0
1197,400,452,537,873,34,13,10,137,421,82,206,0,0
1198,400,450,537,873,34,13,10,137,423,83,206,0,0
1199,400,450,537,873,34,13,10,137,423,84,206,0,0
1200,399,449,535,867,34,13,10,136,418,85,206,0,0
1201,400,449,537,871,34,13,10,137,422,86,206,0,0
1202,400,449,538,872,34,13,10,138,423,87,206,0,0
1203,400,449,537,873,34,13,10,137,424,88,206,0,0
1204,400,449,537,873,34,13,10,137,424,89,206,0,0
1205,400,449,537,873,34,13,10,137,424,90,206,0,0
1206,400,449,537,873,34,13,10,137,424,91,206,0,0
1207,400,449,538,873,34,13,10,138,424,92,206,0,0
1208,401,449,538,873,34,13,10,137,424,93,206,0,0
1209,401,449,538,872,34,13,10,137,423,94,206,0,0
1210,401,449,538,872,34,13,10,137,423,95,206,0,0
1211,400,448,538,873,34,13,10,138,425,96,206,0,0
1212,399,448,538,874,34,13,10,139,426,97,206,0,0
1213,400,447,538,874,34,13,10,138,427,98,206,0,0
1214,400,448,538,874,34,13,10,138,426,99,206,0,0
1215,399,448,536,874,34,13,10,137,426,100,206,0,0
1216,400,447,538,873,34,13,10,138,426,101,206,0,0
1217,401,447,539,873,34,13,10,138,426,102,206,0,0
1218,400,445,538,870,34,13,10,138,425,103,206,0,0
1219,400,446,538,868,34,13,10,138,422,104,206,0,0
1220,398,444,537,869,34,13,10,139,425,105,206,0,0
1221,394,445,534,873,34,13,10,140,428,106,206,0,0
1222,395,449,533,874,34,13,10,138,425,107,206,0,0
1223,396,450,532,874,34,13,10,136,424,108,206,0,0
1224,397,449,531,866,34,13,10,134,417,109,206,0,0
1225,396,449,531,872,34,13,10,135,423,110,206,0,0
1226,393,445,531,876,34,13,10,138,431,111,206,0,0
1227,393,443,532,877,34,13,10,139,434,112,206,0,0
1228,396,450,533,876,34,13,10,137,426,113,206,0,0
1229,397,453,532,876,34,13,10,135,423,114,206,0,0
1230,398,453,533,876,34,13,10,135,423,115,206,0,0
1231,397,454,532,876,34,13,10,135,422,116,206,0,0
1232,397,453,532,877,34,13,10,135,424,117,206,0,0
1233,398,454,533,876,34,13,10,135,422,118,206,0,0
1234,399,455,534,875,34,13,10,135,420,119,206,0,0
1235,398,455,534,875,34,13,10,136,420,120,206,0,0
1236,400,454,535,875,34,13,10,135,421,121,206,0,0
1237,400,453,536,875,34,13,10,136,422,122,206,0,0
1238,398,450,535,873,34,13,10,137,423,123,206,0,0
1239,394,446,533,876,34,13,10,139,430,124,206,0,0
1240,394,451,533,875,34,13,10,139,424,125,206,0,0
1241,395,455,534,873,34,13,10,139,418,126,206,0,0
1242,394,455,534,875,34,13,10,140,420,127,206,0,0
1243,394,461,530,872,34,13,10,136,411,128,206,0,0
1244,399,460,536,870,34,13,10,137,410,129,206,0,0
1245,405,459,546,872,34,13,10,141,413,130,206,0,0
1246,409,461,552,874,34,13,10,143,413,131,206,0,0
1247,425,454,571,868,34,13,10,146,414,132,206,0,0
1248,446,447,599,887,34,13,10,153,440,133,206,0,0
1249,459,439,613,890,34,13,10,154,451,134,206,0,0
1250,462,436,617,893,34,13,10,155,457,135,206,0,0
1251,463,434,615,890,34,13,10,152,456,136,206,0,0
1252,450,440,600,888,34,13,10,150,448,137,206,0,0
1253,439,457,584,893,34,13,10,145,436,138,206,0,0
1254,432,470,573,895,34,13,10,141,425,139,206,0,0
1255,429,476,569,896,34,13,10,140,420,140,206,0,0
1256,425,480,564,897,34,13,10,139,417,141,206,0,0
1257,423,477,562,903,34,13,10,139,426,142,206,0,0
1258,422,466,563,903,34,13,10,141,437,143,206,0,0
1259,421,459,562,898,34,13,10,141,439,144,206,0,0
1260,423,451,564,898,34,13,10,141,447,145,206,0,0
1261,429,453,566,890,34,13,10,137,437,146,206,0,0
1262,430,454,566,890,34,13,10,136,436,147,206,0,0
1263,430,454,566,886,34,13,10,136,432,148,206,0,0
1264,429,453,564,883,34,13,10,135,430,149,206,0,0
1265,429,452,564,882,34,13,10,135,430,150,206,0,0
1266,428,454,563,885,34,13,10,135,431,151,206,0,0
1267,430,453,565,886,34,13,10,135,433,152,206,0,0
1268,430,453,564,887,34,13,10,134,434,153,206,0,0
1269,430,454,564,888,34,13,10,134,434,154,206,0,0
1270,430,453,564,888,34,13,10,134,435,155,206,0,0
1271,430,453,565,890,34,13,10,135,437,156,206,0,0
1272,430,452,565,891,34,13,10,135,439,157,206,0,0
1273,428,449,562,886,34,13,10,134,437,158,206,0,0
1274,429,452,562,890,34,13,10,133,438,159,206,0,0
1275,430,452,563,891,34,13,10,133,439,160,206,0,0
1276,431,452,563,892,34,13,10,132,440,161,206,0,0
1277,432,452,564,892,34,13,10,132,440,162,206,0,0
1278,433,454,564,892,34,13,10,131,438,163,206,0,0
1279,433,456,564,893,34,13,10,131,437,164,206,0,0
1280,432,456,563,893,34,13,10,131,437,165,206,0,0
1281,435,454,565,889,34,13,10,130,435,166,206,0,0
1282,435,452,564,887,34,13,10,129,435,167,206,0,0
1283,435,456,563,887,34,13,10,128,431,168,206,0,0
1284,437,455,564,886,34,13,10,127,431,169,206,0,0
1285,436,457,563,887,34,13,10,127,430,170,206,0,0
1286,436,460,562,889,34,13,10,126,429,171,206,0,0
1287,436,457,562,890,34,13,10,126,433,172,206,0,0
1288,436,459,561,889,34,13,10,125,430,173,206,0,0
1289,436,460,560,887,34,13,10,124,427,174,206,0,0
1290,435,459,561,889,34,13,10,126,430,175,206,0,0
1291,435,456,561,891,34,13,10,126,435,176,206,0,0
1292,434,455,561,891,34,13,10,127,436,177,206,0,0
1293,435,454,562,892,34,13,10,127,438,178,206,0,0
1294,435,453,562,892,34,13,10,127,439,179,206,0,0
1295,435,453,561,891,34,13,10,126,438,180,206,0,0
1296,435,451,562,890,34,13,10,127,439,181,206,0,0
1297,435,452,561,890,34,13,10,126,438,182,206,0,0
1298,435,452,561,890,34,13,10,126,438,183,206,0,0
1299,433,451,560,890,34,13,10,127,439,184,206,0,0
1300,435,451,561,890,34,13,10,126,439,185,206,0,0
1301,435,452,561,891,34,13,10,126,439,186,206,0,0
1302,435,452,561,890,34,13,10,126,438,187,206,0,0
1303,435,453,560,890,34,13,10,125,437,188,206,0,0
1304,435,453,561,890,34,13,10,126,437,189,206,0,0
1305,435,453,560,890,34,13,10,125,437,190,206,0,0
1306,435,453,561,890,34,13,10,126,437,191,206,0,0
1307,435,455,561,891,34,13,10,126,436,192,206,0,0
1308,438,455,561,874,34,13,10,123,419,193,206,0,0
1309,455,453,582,878,34,13,10,127,425,194,206,0,0
1310,462,455,593,879,34,13,10,131,424,195,206,0,0
1311,465,450,603,880,34,13,10,138,430,196,206,0,0
1312,480,449,626,882,34,13,10,146,433,197,206,0,0
1313,517,448,669,881,34,13,10,152,433,198,206,0,0
1314,545,444,704,883,34,13,10,159,439,199,206,0,0
1315,544,448,703,886,34,13,10,159,438,200,206,0,0
1316,552,455,712,890,34,13,10,160,435,201,206,0,0
1317,575,453,735,879,34,13,10,160,426,202,206,0,0
1318,611,446,767,860,34,13,10,156,414,203,206,0,0
1319,641,430,804,851,34,13,10,163,421,204,206,0,0
1320,682,439,833,824,34,13,10,151,385,205,206,0,0
1321,701,438,850,818,34,13,10,149,380,206,206,1,0
1325,792,425,923,769,34,13,10,131,344,0,206,0,0
1326,813,423,941,761,34,13,10,128,338,1,206,0,0
1121,38,270,82,473,35,13,10,44,203,0,11,0,0
1122,37,282,91,530,35,13,10,54,248,1,11,0,0
1123,38,286,96,553,35,13,10,58,267,2,11,0,0
1124,47,284,105,550,35,13,10,58,266,3,11,0,0
1125,57,286,118,560,35,13,10,61,274,4,11,0,0
1126,70,290,132,565,35,13,10,62,275,5,11,0,0
1127,86,284,154,582,35,13,10,68,298,6,11,0,0
1128,96,291,165,585,35,13,10,69,294,7,11,0,0
1129,105,291,174,580,35,13,10,69,289,8,11,0,0
1130,117,292,185,580,35,13,10,68,288,9,11,0,0
1131,134,293,190,518,35,13,10,56,225,10,11,0,0
1132,144,295,199,517,35,13,10,55,222,11,11,0,0
1121,143,343,211,572,36,13,10,68,229,0,249,0,1
1122,155,329,232,590,36,13,10,77,261,1,249,0,0
1123,175,326,254,592,36,13,10,79,266,2,249,0,0
1124,200,326,279,593,36,13,10,79,267,3,249,0,0
1125,229,322,312,600,36,13,10,83,278,4,249,0,0
1126,255,329,342,613,36,13,10,87,284,5,249,0,0
1127,279,332,366,616,36,13,10,87,284,6,249,0,0
1128,297,335,387,627,36,13,10,90,292,7,249,0,0
1129,308,340,400,639,36,13,10,92,299,8,249,0,0
1130,324,342,418,650,36,13,10,94,308,9,249,0,0
1131,344,351,442,667,36,13,10,98,316,10,249,0,0
1132,358,356,461,682,36,13,10,103,326,11,249,0,0
1133,371,363,479,701,36,13,10,108,338,12,249,0,0
1134,378,374,492,726,36,13,10,114,352,13,249,0,0
1135,390,380,507,733,36,13,10,117,353,14,249,0,0
1136,407,390,530,757,36,13,10,123,367,15,249,0,0
1137,425,399,553,780,36,13,10,128,381,16,249,0,0
1138,455,408,584,788,36,13,10,129,380,17,249,0,0
1139,480,419,612,808,36,13,10,132,389,18,249,0,0
1140,506,427,642,832,36,13,10,136,405,19,249,0,0
1141,540,438,677,844,36,13,10,137,406,20,249,0,0
1142,571,448,719,861,36,13,10,148,413,21,249,0,0
1143,613,451,764,868,36,13,10,151,417,22,249,0,0
1144,667,457,824,893,36,13,10,157,436,23,249,0,0
1145,718,474,887,922,36,13,10,169,448,24,249,0,0
1146,760,489,942,938,36,13,10,182,449,25,249,0,0
1147,789,498,978,944,36,13,10,189,446,26,249,0,0
1148,799,504,994,947,36,13,10,195,443,27,249,0,0
1149,768,507,962,939,36,13,10,194,432,28,249,0,0
1150,748,506,945,936,36,13,10,197,430,29,249,0,0
1151,736,504,935,935,36,13,10,199,431,30,249,0,0
1152,718,499,919,934,36,13,10,201,435,31,249,0,0
1153,699,494,897,929,36,13,10,198,435,32,249,0,0
1154,682,490,876,923,36,13,10,194,433,33,249,0,0
1155,673,489,863,919,36,13,10,190,430,34,249,0,0
1156,667,485,853,915,36,13,10,186,430,35,249,0,0
1157,665,476,846,906,36,13,10,181,430,36,249,0,0
1158,662,468,837,890,36,13,10,175,422,37,249,0,0
1159,641,471,810,876,36,13,10,169,405,38,249,0,0
1160,625,467,792,871,36,13,10,167,404,39,249,0,0
1161,614,465,778,865,36,13,10,164,400,40,249,0,0
1162,601,465,763,865,36,13,10,162,400,41,249,0,0
1163,594,462,755,864,36,13,10,161,402,42,249,0,0
1164,587,458,747,866,36,13,10,160,408,43,249,0,0
1165,582,455,738,851,36,13,10,156,396,44,249,0,0
1166,571,445,727,842,36,13,10,156,397,45,249,0,0
1167,565,447,719,842,36,13,10,154,395,46,249,0,0
1168,557,443,711,843,36,13,10,154,400,47,249,0,0
1169,550,442,705,843,36,13,10,155,401,48,249,0,0
1170,543,443,698,843,36,13,10,155,400,49,249,0,0
1171,538,445,692,842,36,13,10,154,397,50,249,0,0
1172,536,446,690,842,36,13,10,154,396,51,249,0,0
1173,537,448,691,842,36,13,10,154,394,52,249,0,0
1174,542,448,696,843,36,13,10,154,395,53,249,0,0
1175,548,444,705,844,36,13,10,157,400,54,249,0,0
1176,555,446,712,843,36,13,10,157,397,55,249,0,0
1177,556,444,714,843,36,13,10,158,399,56,249,0,0
1178,553,442,711,843,36,13,10,158,401,57,249,0,0
1179,553,441,711,843,36,13,10,158,402,58,249,0,0
1180,552,439,710,843,36,13,10,158,404,59,249,0,0
1181,554,439,712,843,36,13,10,158,404,60,249,0,0
1182,556,442,712,843,36,13,10,156,401,61,249,0,0
1183,556,441,713,843,36,13,10,157,402,62,249,0,0
1184,556,442,712,843,36,13,10,156,401,63,249,0,0
1185,556,440,712,843,36,13,10,156,403,64,249,0,0
1186,558,440,713,843,36,13,10,155,403,65,249,0,0
1187,557,436,714,843,36,13,10,157,407,66,249,0,0
1188,558,439,715,843,36,13,10,157,404,67,249,0,0
1189,559,440,715,843,36,13,10,156,403,68,249,0,0
1190,556,440,711,843,36,13,10,155,403,69,249,0,0
1191,550,436,706,843,36,13,10,156,407,70,249,0,0
1192,545,423,705,844,36,13,10,160,421,71,249,0,0
1193,548,430,704,844,36,13,10,156,414,72,249,0,0
1194,546,423,703,843,36,13,10,157,420,73,249,0,0
1195,548,429,703,842,36,13,10,155,413,74,249,0,0
1196,549,430,703,842,36,13,10,154,412,75,249,0,0
1197,552,437,704,844,36,13,10,152,407,76,249,0,0
1198,554,439,705,845,36,13,10,151,406,77,249,0,0
1199,554,441,706,846,36,13,10,152,405,78,249,0,0
1200,555,441,706,846,36,13,10,151,405,79,249,0,0
1201,556,444,706,846,36,13,10,150,402,80,249,0,0
1202,557,444,708,846,36,13,10,151,402,81,249,0,0
1203,558,442,709,846,36,13,10,151,404,82,249,0,0
1204,558,441,710,846,36,13,10,152,405,83,249,0,0
1205,557,441,709,846,36,13,10,152,405,84,249,0,0
1206,557,440,710,846,36,13,10,153,406,85,249,0,0
1207,558,440,711,846,36,13,10,153,406,86,249,0,0
1208,559,441,712,846,36,13,10,153,405,87,249,0,0
1209,561,442,715,845,36,13,10,154,403,88,249,0,0
1210,561,440,717,845,36,13,10,156,405,89,249,0,0
1211,561,440,718,845,36,13,10,157,405,90,249,0,0
1212,562,442,719,845,36,13,10,157,403,91,249,0,0
1213,562,442,720,845,36,13,10,158,403,92,249,0,0
1214,559,444,717,844,36,13,10,158,400,93,249,0,0
1215,560,440,718,840,36,13,10,158,400,94,249,0,0
1216,563,423,725,837,36,13,10,162,414,95,249,0,0
1217,573,421,733,832,36,13,10,160,411,96,249,0,0
1218,583,429,738,832,36,13,10,155,403,97,249,0,0
1219,584,428,739,835,36,13,10,155,407,98,249,0,0
1220,584,421,740,836,36,13,10,156,415,99,249,0,0
1221,586,425,740,835,36,13,10,154,410,100,249,0,0
1222,589,426,740,834,36,13,10,151,408,101,249,0,0
1223,591,428,740,833,36,13,10,149,405,102,249,0,0
1224,590,426,739,833,36,13,10,149,407,103,249,0,0
1225,590,427,738,834,36,13,10,148,407,104,249,0,0
1226,590,429,737,834,36,13,10,147,405,105,249,0,0
1227,592,433,737,834,36,13,10,145,401,106,249,0,0
1228,593,434,736,834,36,13,10,143,400,107,249,0,0
1229,594,436,736,834,36,13,10,142,398,108,249,0,0
1230,594,438,735,833,36,13,10,141,395,109,249,0,0
1231,593,438,734,835,36,13,10,141,397,110,249,0,0
1232,595,440,735,834,36,13,10,140,394,111,249,0,0
1233,596,441,734,832,36,13,10,138,391,112,249,0,0
1234,588,445,726,835,36,13,10,138,390,113,249,0,0
1235,587,448,727,839,36,13,10,140,391,114,249,0,0
1236,580,452,722,842,36,13,10,142,390,115,249,0,0
1237,568,454,711,843,36,13,10,143,389,116,249,0,0
1238,567,458,713,850,36,13,10,146,392,117,249,0,0
1239,575,457,727,860,36,13,10,152,403,118,249,0,0
1240,586,460,743,868,36,13,10,157,408,119,249,0,0
1241,602,465,764,879,36,13,10,162,414,120,249,0,0
1242,627,463,793,883,36,13,10,166,420,121,249,0,0
1243,650,468,815,885,36,13,10,165,417,122,249,0,0
1244,661,470,829,885,36,13,10,168,415,123,249,0,0
1245,658,470,830,884,36,13,10,172,414,124,249,0,0
1246,649,471,823,884,36,13,10,174,413,125,249,0,0
1247,639,477,811,885,36,13,10,172,408,126,249,0,0
1248,625,475,800,891,36,13,10,175,416,127,249,0,0
1249,612,476,785,890,36,13,10,173,414,128,249,0,0
1250,603,479,774,891,36,13,10,171,412,129,249,0,0
1251,599,478,770,893,36,13,10,171,415,130,249,0,0
1252,603,479,775,898,36,13,10,172,419,131,249,0,0
1253,613,482,784,902,36,13,10,171,420,132,249,0,0
1254,625,481,799,906,36,13,10,174,425,133,249,0,0
1255,640,480,814,903,36,13,10,174,423,134,249,0,0
1256,645,478,822,903,36,13,10,177,425,135,249,0,0
1257,647,479,824,903,36,13,10,177,424,136,249,0,0
1258,643,477,820,903,36,13,10,177,426,137,249,0,0
1259,631,480,804,899,36,13,10,173,419,138,249,0,0
1260,622,480,790,889,36,13,10,168,409,139,249,0,0
1261,614,473,784,890,36,13,10,170,417,140,249,0,0
1262,608,470,777,890,36,13,10,169,420,141,249,0,0
1263,611,470,780,888,36,13,10,169,418,142,249,0,0
1264,615,472,782,885,36,13,10,167,413,143,249,0,0
1265,627,473,791,882,36,13,10,164,409,144,249,0,0
1266,638,473,802,879,36,13,10,164,406,145,249,0,0
1267,646,472,808,871,36,13,10,162,399,146,249,0,0
1268,653,471,814,866,36,13,10,161,395,147,249,0,0
1269,655,470,817,865,36,13,10,162,395,148,249,0,0
1270,654,469,818,866,36,13,10,164,397,149,249,0,0
1271,650,468,817,870,36,13,10,167,402,150,249,0,0
1272,647,468,814,871,36,13,10,167,403,151,249,0,0
1273,646,474,810,870,36,13,10,164,396,152,249,0,0
1274,639,471,803,872,36,13,10,164,401,153,249,0,0
1275,633,472,795,874,36,13,10,162,402,154,249,0,0
1276,623,468,786,874,36,13,10,163,406,155,249,0,0
1277,616,463,780,875,36,13,10,164,412,156,249,0,0
1278,621,465,781,873,36,13,10,160,408,157,249,0,0
1279,627,463,786,871,36,13,10,159,408,158,249,0,0
1280,638,463,794,867,36,13,10,156,404,159,249,0,0
1281,648,462,803,860,36,13,10,155,398,160,249,0,0
1282,653,462,808,861,36,13,10,155,399,161,249,0,0
1283,656,464,809,855,36,13,10,153,391,162,249,0,0
1284,655,465,809,855,36,13,10,154,390,163,249,0,0
1285,656,466,811,860,36,13,10,155,394,164,249,0,0
1286,649,465,807,865,36,13,10,158,400,165,249,0,0
1287,635,465,797,870,36,13,10,162,405,166,249,0,0
1288,623,468,787,874,36,13,10,164,406,167,249,0,0
1289,617,466,785,878,36,13,10,168,412,168,249,0,0
1290,615,466,787,883,36,13,10,172,417,169,249,0,0
1291,619,466,793,886,36,13,10,174,420,170,249,0,0
1292,630,466,806,886,36,13,10,176,420,171,249,0,0
1293,644,468,821,886,36,13,10,177,418,172,249,0,0
1294,654,472,833,886,36,13,10,179,414,173,249,0,0
1295,659,472,842,887,36,13,10,183,415,174,249,0,0
1296,661,470,848,886,36,13,10,187,416,175,249,0,0
1297,661,469,850,885,36,13,10,189,416,176,249,0,0
1298,656,468,845,885,36,13,10,189,417,177,249,0,0
1299,638,468,826,884,36,13,10,188,416,178,249,0,0
1300,623,470,812,887,36,13,10,189,417,179,249,0,0
1301,612,469,800,886,36,13,10,188,417,180,249,0,0
1302,618,471,801,882,36,13,10,183,411,181,249,0,0
1303,620,472,804,889,36,13,10,184,417,182,249,0,0
1304,624,472,808,898,36,13,10,184,426,183,249,0,0
1305,635,479,817,908,36,13,10,182,429,184,249,0,0
1306,650,484,829,912,36,13,10,179,428,185,249,0,0
1307,669,484,846,915,36,13,10,177,431,186,249,0,0
1308,682,489,853,916,36,13,10,171,427,187,249,0,0
1309,698,485,867,912,36,13,10,169,427,188,249,0,0
1310,725,484,891,905,36,13,10,166,421,189,249,0,0
1311,746,483,916,916,36,13,10,170,433,190,249,0,0
1312,758,488,926,920,36,13,10,168,432,191,249,0,0
1313,795,496,972,932,36,13,10,177,436,192,249,0,0
1314,805,498,985,933,36,13,10,180,435,193,249,0,0
1315,804,497,989,936,36,13,10,185,439,194,249,0,0
1316,802,501,986,934,36,13,10,184,433,195,249,0,0
1317,789,499,975,934,36,13,10,186,435,196,249,0,0
1318,797,486,991,925,36,13,10,194,439,197,249,0,0
1319,799,476,997,907,36,13,10,198,431,198,249,0,0
1320,784,463,979,891,36,13,10,195,428,199,249,0,0
1321,773,454,965,884,36,13,10,192,430,200,249,0,0
1322,788,442,974,864,36,13,10,186,422,201,249,0,0
1323,804,444,983,854,36,13,10,179,410,202,249,0,0
1324,821,448,994,853,36,13,10,173,405,203,249,0,0
1325,838,453,999,834,36,13,10,161,381,204,249,0,0
1326,840,425,1002,809,36,13,10,162,384,205,249,0,0
1327,854,419,1014,810,36,13,10,160,391,206,249,0,0
1328,849,379,1022,815,36,13,10,173,436,207,249,0,0
1329,862,367,1012,753,36,13,10,150,386,208,249,0,0
1330,866,360,1005,718,36,13,10,139,358,209,249,0,0
1331,866,358,1001,708,36,13,10,135,350,210,249,0,0
1332,874,358,1005,704,36,13,10,131,346,211,249,0,0
1333,872,357,1003,704,36,13,10,131,347,212,249,0,0
1334,872,357,1003,705,36,13,10,131,348,213,249,0,0
1335,872,357,1005,705,36,13,10,133,348,214,249,0,0
1336,879,359,1010,706,36,13,10,131,347,215,249,0,0
1337,888,360,1016,705,36,13,10,128,345,216,249,0,0
1338,894,362,1019,705,36,13,10,125,343,217,249,0,0
1339,897,363,1019,706,36,13,10,122,343,218,249,0,0
1340,901,363,1021,705,36,13,10,120,342,219,249,0,0
1341,904,363,1021,700,36,13,10,117,337,220,249,0,0
1342,908,362,1023,697,36,13,10,115,335,221,249,0,0
1343,914,362,1025,694,36,13,10,111,332,222,249,0,0
1344,919,367,1027,692,36,13,10,108,325,223,249,0,0
1345,910,366,1021,696,36,13,10,111,330,224,249,0,0
1346,899,363,1014,701,36,13,10,115,338,225,249,0,0
1347,893,365,1012,708,36,13,10,119,343,226,249,0,0
1348,890,366,1011,711,36,13,10,121,345,227,249,0,0
1349,889,364,1013,712,36,13,10,124,348,228,249,0,0
1350,889,364,1015,714,36,13,10,126,350,229,249,0,0
1351,890,363,1016,712,36,13,10,126,349,230,249,0,0
1352,890,367,1016,712,36,13,10,126,345,231,249,0,0
1353,891,368,1016,712,36,13,10,125,344,232,249,0,0
1354,891,368,1017,711,36,13,10,126,343,233,249,0,0
1355,890,368,1018,712,36,13,10,128,344,234,249,0,0
1356,893,370,1019,709,36,13,10,126,339,235,249,0,0
1357,891,367,1018,710,36,13,10,127,343,236,249,0,0
1358,890,365,1018,711,36,13,10,128,346,237,249,0,0
1359,889,365,1018,711,36,13,10,129,346,238,249,0,0
1360,888,366,1018,711,36,13,10,130,345,239,249,0,0
1361,889,367,1018,711,36,13,10,129,344,240,249,0,0
1362,888,367,1018,711,36,13,10,130,344,241,249,0,0
1363,887,367,1018,711,36,13,10,131,344,242,249,0,0
1364,887,367,1018,712,36,13,10,131,345,243,249,0,0
1365,888,367,1018,711,36,13,10,130,344,244,249,0,0
1366,890,367,1020,710,36,13,10,130,343,245,249,0,0
1367,892,367,1021,708,36,13,10,129,341,246,249,0,0
1368,893,367,1021,708,36,13,10,128,341,247,249,0,0
1369,892,374,1017,709,36,13,10,125,335,248,249,0,0
1370,893,375,1017,709,36,13,10,124,334,249,249,1,0
1133,159,293,250,438,37,13,10,91,145,0,1,0,0
1134,174,293,262,434,37,13,10,88,141,1,1,0,0
1137,232,301,319,424,38,13,10,87,123,0,0,0,0
1140,290,305,381,445,39,13,10,91,140,0,1,0,0
1141,301,309,415,484,39,13,10,114,175,1,1,0,0
1142,362,315,441,665,40,13,10,79,350,0,74,0,1
1143,371,322,440,625,40,13,10,69,303,1,74,0,0
1144,392,319,468,652,40,13,10,76,333,2,74,0,0
1145,405,325,486,677,40,13,10,81,352,3,74,0,0
1146,429,328,513,686,40,13,10,84,358,4,74,0,0
1147,451,337,537,703,40,13,10,86,366,5,74,0,0
1148,463,344,553,722,40,13,10,90,378,6,74,0,0
1149,475,350,566,733,40,13,10,91,383,7,74,0,0
1150,506,353,603,739,40,13,10,97,386,8,74,0,0
1151,506,349,610,757,40,13,10,104,408,9,74,0,0
1152,512,352,618,765,40,13,10,106,413,10,74,0,0
1153,524,355,636,774,40,13,10,112,419,11,74,0,0
1154,526,359,641,779,40,13,10,115,420,12,74,0,0
1155,524,362,639,778,40,13,10,115,416,13,74,0,0
1156,523,365,639,780,40,13,10,116,415,14,74,0,0
1157,521,370,636,780,40,13,10,115,410,15,74,0,0
1158,520,369,637,780,40,13,10,117,411,16,74,0,0
1159,517,371,636,783,40,13,10,119,412,17,74,0,0
1160,515,376,631,780,40,13,10,116,404,18,74,0,0
1161,523,367,643,778,40,13,10,120,411,19,74,0,0
1162,527,365,649,776,40,13,10,122,411,20,74,0,0
1163,525,368,647,775,40,13,10,122,407,21,74,0,0
1164,519,376,640,774,40,13,10,121,398,22,74,0,0
1165,515,378,636,776,40,13,10,121,398,23,74,0,0
1166,512,374,636,783,40,13,10,124,409,24,74,0,0
1167,513,372,639,789,40,13,10,126,417,25,74,0,0
1168,505,381,627,787,40,13,10,122,406,26,74,0,0
1169,504,387,622,785,40,13,10,118,398,27,74,0,0
1170,504,403,615,776,40,13,10,111,373,28,74,0,0
1171,505,407,615,777,40,13,10,110,370,29,74,0,0
1174,512,409,619,765,40,13,10,107,356,0,74,0,1
1175,512,416,620,780,40,13,10,108,364,1,74,0,0
1176,513,393,627,780,40,13,10,114,387,2,74,0,0
1177,514,381,630,779,40,13,10,116,398,3,74,0,0
1178,509,394,620,779,40,13,10,111,385,4,74,0,0
1179,507,396,617,782,40,13,10,110,386,5,74,0,0
1180,508,396,619,792,40,13,10,111,396,6,74,0,0
1181,507,401,614,793,40,13,10,107,392,7,74,0,0
1182,513,383,624,786,40,13,10,111,403,8,74,0,0
1183,515,376,627,783,40,13,10,112,407,9,74,0,0
1184,516,372,630,782,40,13,10,114,410,10,74,0,0
1185,511,391,618,775,40,13,10,107,384,11,74,0,0
1186,509,398,613,772,40,13,10,104,374,12,74,0,0
1187,514,376,626,776,40,13,10,112,400,13,74,0,0
1188,515,369,631,787,40,13,10,116,418,14,74,0,0
1189,514,368,631,787,40,13,10,117,419,15,74,0,0
1190,509,369,625,784,40,13,10,116,415,16,74,0,0
1191,502,381,618,791,40,13,10,116,410,17,74,0,0
1192,501,381,618,792,40,13,10,117,411,18,74,0,0
1193,502,400,610,779,40,13,10,108,379,19,74,0,0
1194,504,404,612,789,40,13,10,108,385,20,74,0,0
1195,506,403,612,784,40,13,10,106,381,21,74,0,0
1196,506,396,615,789,40,13,10,109,393,22,74,0,0
1197,506,395,614,785,40,13,10,108,390,23,74,0,0
1198,503,397,611,789,40,13,10,108,392,24,74,0,0
1199,507,382,620,791,40,13,10,113,409,25,74,0,0
1200,511,371,626,782,40,13,10,115,411,26,74,0,0
1201,512,369,627,781,40,13,10,115,412,27,74,0,0
1202,513,369,629,781,40,13,10,116,412,28,74,0,0
1203,514,378,629,785,40,13,10,115,407,29,74,0,0
1204,508,389,620,786,40,13,10,112,397,30,74,0,0
1205,511,388,624,786,40,13,10,113,398,31,74,0,0
1206,512,385,627,787,40,13,10,115,402,32,74,0,0
1207,514,378,629,781,40,13,10,115,403,33,74,0,0
1208,514,376,630,778,40,13,10,116,402,34,74,0,0
1209,514,375,631,779,40,13,10,117,404,35,74,0,0
1210,512,376,631,786,40,13,10,119,410,36,74,0,0
1211,514,381,632,790,40,13,10,118,409,37,74,0,0
1212,514,381,633,791,40,13,10,119,410,38,74,0,0
1213,514,379,634,793,40,13,10,120,414,39,74,0,0
1214,506,395,619,789,40,13,10,113,394,40,74,0,0
1215,508,385,622,784,40,13,10,114,399,41,74,0,0
1216,513,373,632,788,40,13,10,119,415,42,74,0,0
1217,521,366,642,783,40,13,10,121,417,43,74,0,0
1218,525,362,647,778,40,13,10,122,416,44,74,0,0
1219,527,360,651,781,40,13,10,124,421,45,74,0,0
1220,527,360,651,775,40,13,10,124,415,46,74,0,0
1221,524,362,648,775,40,13,10,124,413,47,74,0,0
1222,523,363,646,774,40,13,10,123,411,48,74,0,0
1223,518,373,641,779,40,13,10,123,406,49,74,0,0
1224,516,379,637,781,40,13,10,121,402,50,74,0,0
1225,516,376,638,779,40,13,10,122,403,51,74,0,0
1226,515,376,639,782,40,13,10,124,406,52,74,0,0
1227,513,377,638,784,40,13,10,125,407,53,74,0,0
1228,511,375,636,785,40,13,10,125,410,54,74,0,0
1229,511,377,635,784,40,13,10,124,407,55,74,0,0
1230,510,378,634,783,40,13,10,124,405,56,74,0,0
1231,512,376,636,780,40,13,10,124,404,57,74,0,0
1232,511,382,634,779,40,13,10,123,397,58,74,0,0
1233,511,382,634,782,40,13,10,123,400,59,74,0,0
1234,515,374,640,782,40,13,10,125,408,60,74,0,0
1235,515,367,642,786,40,13,10,127,419,61,74,0,0
1236,514,364,641,788,40,13,10,127,424,62,74,0,0
1237,513,364,637,781,40,13,10,124,417,63,74,0,0
1238,512,366,635,780,40,13,10,123,414,64,74,0,0
1239,515,365,639,781,40,13,10,124,416,65,74,0,0
1240,524,363,651,782,40,13,10,127,419,66,74,0,0
1241,525,364,653,778,40,13,10,128,414,67,74,0,0
1242,523,367,651,773,40,13,10,128,406,68,74,0,0
1243,522,366,652,775,40,13,10,130,409,69,74,0,0
1244,523,365,652,772,40,13,10,129,407,70,74,0,0
1245,528,366,658,774,40,13,10,130,408,71,74,0,0
1246,530,364,662,773,40,13,10,132,409,72,74,0,0
1247,536,376,661,765,40,13,10,125,389,73,74,0,0
1248,538,377,662,764,40,13,10,124,387,74,74,1,0
1252,546,378,653,701,40,13,10,107,323,0,74,0,1
1253,541,372,668,749,40,13,10,127,377,1,74,0,0
1254,536,366,669,756,40,13,10,133,390,2,74,0,0
1255,533,362,667,761,40,13,10,134,399,3,74,0,0
1256,532,362,667,764,40,13,10,135,402,4,74,0,0
1257,532,363,668,767,40,13,10,136,404,5,74,0,0
1258,529,364,663,767,40,13,10,134,403,6,74,0,0
1259,530,364,663,767,40,13,10,133,403,7,74,0,0
1260,532,364,666,770,40,13,10,134,406,8,74,0,0
1261,531,373,663,771,40,13,10,132,398,9,74,0,0
1262,528,375,658,771,40,13,10,130,396,10,74,0,0
1263,528,376,657,769,40,13,10,129,393,11,74,0,0
1264,527,379,653,766,40,13,10,126,387,12,74,0,0
1265,524,370,650,766,40,13,10,126,396,13,74,0,0
1266,526,366,654,769,40,13,10,128,403,14,74,0,0
1267,530,364,659,766,40,13,10,129,402,15,74,0,0
1268,528,363,658,767,40,13,10,130,404,16,74,0,0
1269,526,369,654,769,40,13,10,128,400,17,74,0,0
1270,523,371,649,769,40,13,10,126,398,18,74,0,0
1271,524,366,650,769,40,13,10,126,403,19,74,0,0
1272,523,369,648,772,40,13,10,125,403,20,74,0,0
1273,524,365,649,770,40,13,10,125,405,21,74,0,0
1274,525,370,647,769,40,13,10,122,399,22,74,0,0
1275,526,374,645,768,40,13,10,119,394,23,74,0,0
1276,527,378,645,769,40,13,10,118,391,24,74,0,0
1277,527,376,644,769,40,13,10,117,393,25,74,0,0
1278,526,378,642,770,40,13,10,116,392,26,74,0,0
1279,525,378,640,772,40,13,10,115,394,27,74,0,0
1280,526,377,640,771,40,13,10,114,394,28,74,0,0
1281,525,377,638,772,40,13,10,113,395,29,74,0,0
1282,525,377,637,770,40,13,10,112,393,30,74,0,0
1283,529,372,643,768,40,13,10,114,396,31,74,0,0
1284,531,372,646,768,40,13,10,115,396,32,74,0,0
1285,535,369,653,770,40,13,10,118,401,33,74,0,0
1286,539,369,653,748,40,13,10,114,379,34,74,0,0
1287,540,366,658,750,40,13,10,118,384,35,74,0,0
1288,533,368,656,763,40,13,10,123,395,36,74,0,0
1289,529,366,655,771,40,13,10,126,405,37,74,0,0
1290,529,365,656,770,40,13,10,127,405,38,74,0,0
1291,530,362,658,769,40,13,10,128,407,39,74,0,0
1292,533,364,662,768,40,13,10,129,404,40,74,0,0
1293,533,364,662,768,40,13,10,129,404,41,74,0,0
1294,531,364,661,768,40,13,10,130,404,42,74,0,0
1295,532,364,662,767,40,13,10,130,403,43,74,0,0
1296,528,364,657,765,40,13,10,129,401,44,74,0,0
1297,527,365,654,765,40,13,10,127,400,45,74,0,0
1298,527,365,655,766,40,13,10,128,401,46,74,0,0
1299,527,370,652,768,40,13,10,125,398,47,74,0,0
1300,532,364,660,767,40,13,10,128,403,48,74,0,0
1301,528,362,656,769,40,13,10,128,407,49,74,0,0
1302,528,367,653,769,40,13,10,125,402,50,74,0,0
1303,529,368,653,767,40,13,10,124,399,51,74,0,0
1304,529,368,652,767,40,13,10,123,399,52,74,0,0
1305,526,370,647,767,40,13,10,121,397,53,74,0,0
1306,531,366,653,764,40,13,10,122,398,54,74,0,0
1307,533,364,657,765,40,13,10,124,401,55,74,0,0
1308,539,367,661,758,40,13,10,122,391,56,74,0,0
1309,548,374,656,705,40,13,10,108,331,57,74,0,0
1310,547,381,667,752,40,13,10,120,371,58,74,0,0
1311,559,427,671,771,40,13,10,112,344,59,74,0,0
1312,585,469,685,771,40,13,10,100,302,60,74,0,0
1313,591,481,688,773,40,13,10,97,292,61,74,0,0
1314,632,509,718,770,40,13,10,86,261,62,74,0,0
1315,643,523,724,771,40,13,10,81,248,63,74,0,0
1162,253,213,289,345,41,13,10,36,132,0,0,0,0
1163,237,214,276,340,42,13,10,39,126,0,14,0,0
1164,227,214,264,333,42,13,10,37,119,1,14,0,0
1165,213,217,251,341,42,13,10,38,124,2,14,0,0
1166,201,215,242,347,42,13,10,41,132,3,14,0,0
1167,188,214,228,342,42,13,10,40,128,4,14,0,0
1168,174,211,214,340,42,13,10,40,129,5,14,0,0
1169,163,211,203,340,42,13,10,40,129,6,14,0,0
1170,153,212,189,329,42,13,10,36,117,7,14,0,0
1171,140,212,178,334,42,13,10,38,122,8,14,0,0
1172,131,210,167,325,42,13,10,36,115,9,14,0,0
1173,123,205,161,328,42,13,10,38,123,10,14,0,0
1174,116,203,155,329,42,13,10,39,126,11,14,0,0
1175,110,202,149,330,42,13,10,39,128,12,14,0,0
1176,106,205,144,326,42,13,10,38,121,13,14,0,0
1177,102,206,139,323,42,13,10,37,117,14,14,0,0
1165,253,222,291,342,43,13,10,38,120,0,14,0,0
1166,247,219,285,339,43,13,10,38,120,1,14,0,0
1167,240,213,281,340,43,13,10,41,127,2,14,0,0
1168,224,213,264,339,43,13,10,40,126,3,14,0,0
1169,218,210,259,338,43,13,10,41,128,4,14,0,0
1170,209,210,251,338,43,13,10,42,128,5,14,0,0
1171,192,215,231,336,43,13,10,39,121,6,14,0,0
1172,178,215,217,335,43,13,10,39,120,7,14,0,0
1173,169,213,206,329,43,13,10,37,116,8,14,0,0
1174,162,211,199,328,43,13,10,37,117,9,14,0,0
1175,155,211,192,328,43,13,10,37,117,10,14,0,0
1176,148,212,185,327,43,13,10,37,115,11,14,0,0
1177,144,210,181,324,43,13,10,37,114,12,14,0,0
1178,140,211,175,320,43,13,10,35,109,13,14,0,0
1179,135,210,170,318,43,13,10,35,108,14,14,0,0
1182,132,208,167,311,43,13,10,35,103,0,14,0,0
1183,131,206,167,311,43,13,10,36,105,1,14,0,0
1170,531,365,637,554,45,13,10,106,189,0,7,0,0
1171,529,363,632,545,45,13,10,103,182,1,7,0,0
1172,533,364,635,544,45,13,10,102,180,2,7,0,0
1173,539,364,641,544,45,13,10,102,180,3,7,0,0
1174,539,361,642,541,45,13,10,103,180,4,7,0,0
1175,547,362,641,524,45,13,10,94,162,5,7,0,0
1176,544,364,639,528,45,13,10,95,164,6,7,0,0
1177,546,364,640,524,45,13,10,94,160,7,7,0,0
1171,220,214,257,331,46,13,10,37,117,0,20,0,1
1172,213,210,249,322,46,13,10,36,112,1,20,0,0
1173,204,209,241,326,46,13,10,37,117,2,20,0,0
1174,197,208,234,324,46,13,10,37,116,3,20,0,0
1175,196,208,231,316,46,13,10,35,108,4,20,0,0
1176,192,207,227,316,46,13,10,35,109,5,20,0,0
1177,188,203,225,316,46,13,10,37,113,6,20,0,0
1178,185,199,224,318,46,13,10,39,119,7,20,0,0
1179,182,201,221,317,46,13,10,39,116,8,20,0,0
1180,180,200,218,315,46,13,10,38,115,9,20,0,0
1181,179,200,216,312,46,13,10,37,112,10,20,0,0
1182,178,199,215,312,46,13,10,37,113,11,20,0,0
1183,179,197,216,309,46,13,10,37,112,12,20,0,0
1184,178,194,216,307,46,13,10,38,113,13,20,0,0
1185,178,195,214,306,46,13,10,36,111,14,20,0,0
1186,177,192,213,304,46,13,10,36,112,15,20,0,0
1187,175,190,212,303,46,13,10,37,113,16,20,0,0
1188,175,191,211,302,46,13,10,36,111,17,20,0,0
1189,176,189,211,300,46,13,10,35,111,18,20,0,0
1190,177,187,212,297,46,13,10,35,110,19,20,0,0
1191,176,185,211,294,46,13,10,35,109,20,20,1,0
1222,135,175,177,286,46,13,10,42,111,0,20,0,0
1223,134,174,177,287,46,13,10,43,113,1,20,0,0
1224,135,174,174,281,46,13,10,39,107,2,20,0,0
1225,134,170,172,279,46,13,10,38,109,3,20,0,0
1226,132,170,172,283,46,13,10,40,113,4,20,0,0
1227,134,171,171,278,46,13,10,37,107,5,20,0,0
1228,134,169,172,280,46,13,10,38,111,6,20,0,0
1229,135,179,170,283,46,13,10,35,104,7,20,0,0
1192,249,235,289,346,47,13,10,40,111,0,10,0,0
1193,243,239,280,342,47,13,10,37,103,1,10,0,0
1196,243,237,278,336,47,13,10,35,99,0,10,0,0
1197,238,232,276,340,47,13,10,38,108,1,10,0,0
1198,230,228,269,339,47,13,10,39,111,2,10,0,0
1199,221,226,261,339,47,13,10,40,113,3,10,0,0
1200,213,224,253,336,47,13,10,40,112,4,10,0,0
1201,206,223,246,334,47,13,10,40,111,5,10,0,0
1202,199,224,239,335,47,13,10,40,111,6,10,0,0
1203,192,228,230,333,47,13,10,38,105,7,10,0,0
1204,188,229,225,329,47,13,10,37,100,8,10,0,0
1205,180,221,215,317,47,13,10,35,96,9,10,0,0
1206,175,220,210,319,47,13,10,35,99,10,10,0,0
1194,227,239,262,343,48,13,10,35,104,0,4,0,0
1196,208,239,243,342,48,13,10,35,103,0,4,0,0
1197,195,237,231,343,48,13,10,36,106,1,4,0,0
1198,183,239,218,340,48,13,10,35,101,2,4,0,0
1199,171,239,206,340,48,13,10,35,101,3,4,0,0
1200,161,238,197,338,48,13,10,36,100,4,4,0,0
1202,150,233,186,333,48,13,10,36,100,0,4,0,0
1203,146,237,182,334,48,13,10,36,97,1,4,0,0
1230,312,247,348,393,56,13,10,36,146,0,31,0,1
1231,300,244,338,398,56,13,10,38,154,1,31,0,0
1232,281,243,322,408,56,13,10,41,165,2,31,0,0
1233,268,242,311,410,56,13,10,43,168,3,31,0,0
1234,257,238,301,409,56,13,10,44,171,4,31,0,0
1235,249,240,293,410,56,13,10,44,170,5,31,0,0
1236,242,241,286,410,56,13,10,44,169,6,31,0,0
1237,236,240,279,401,56,13,10,43,161,7,31,0,0
1238,227,238,271,399,56,13,10,44,161,8,31,0,0
1239,220,238,265,399,56,13,10,45,161,9,31,0,0
1240,212,237,255,392,56,13,10,43,155,10,31,0,0
1241,205,237,249,389,56,13,10,44,152,11,31,0,0
1242,203,239,245,386,56,13,10,42,147,12,31,0,0
1243,201,236,243,380,56,13,10,42,144,13,31,0,0
1244,201,234,243,376,56,13,10,42,142,14,31,0,0
1245,200,239,240,376,56,13,10,40,137,15,31,0,0
1246,199,232,241,373,56,13,10,42,141,16,31,0,0
1247,197,231,240,372,56,13,10,43,141,17,31,0,0
1248,198,233,240,369,56,13,10,42,136,18,31,0,0
1249,201,231,243,364,56,13,10,42,133,19,31,0,0
1250,203,228,245,359,56,13,10,42,131,20,31,0,0
1251,204,229,247,361,56,13,10,43,132,21,31,0,0
1252,207,228,248,351,56,13,10,41,123,22,31,0,0
1253,210,227,251,351,56,13,10,41,124,23,31,0,0
1254,215,228,256,350,56,13,10,41,122,24,31,0,0
1255,221,227,263,351,56,13,10,42,124,25,31,0,0
1256,228,224,270,347,56,13,10,42,123,26,31,0,0
1257,235,224,276,349,56,13,10,41,125,27,31,0,0
1258,244,221,285,344,56,13,10,41,123,28,31,0,0
1259,250,224,289,342,56,13,10,39,118,29,31,0,0
1260,252,225,290,339,56,13,10,38,114,30,31,0,0
1261,255,224,292,336,56,13,10,37,112,31,31,1,0
1248,532,367,640,505,57,13,10,108,138,0,4,0,0
1249,529,363,650,518,57,13,10,121,155,1,4,0,0
1250,524,365,656,535,57,13,10,132,170,2,4,0,0
1251,522,364,650,528,57,13,10,128,164,3,4,0,0
1252,520,364,651,531,57,13,10,131,167,4,4,0,0
1278,596,381,685,681,58,13,10,89,300,0,0,0,0
1310,553,361,649,495,59,13,10,96,134,0,5,0,0
1311,563,362,659,496,59,13,10,96,134,1,5,0,0
1312,570,364,668,500,59,13,10,98,136,2,5,0,0
1313,589,362,692,506,59,13,10,103,144,3,5,0,0
1314,612,360,720,510,59,13,10,108,150,4,5,0,0
1315,625,359,736,513,59,13,10,111,154,5,5,0,0
1325,876,368,1009,556,59,13,10,133,188,0,5,0,0
1326,875,367,1010,556,59,13,10,135,189,1,5,0,0
1327,895,367,1032,559,59,13,10,137,192,2,5,0,0
1315,663,386,794,762,60,13,10,131,376,0,4,0,0
1316,688,379,820,760,60,13,10,132,381,1,4,0,0
1317,712,385,835,738,60,13,10,123,353,2,4,0,0
1318,764,377,842,603,60,13,10,78,226,3,4,0,0
1319,791,375,851,548,60,13,10,60,173,4,4,0,0
1321,850,360,948,530,61,13,10,98,170,0,0,0,0
1323,785,429,915,675,62,13,10,130,246,0,1,0,0
1324,804,409,935,656,62,13,10,131,247,1,1,0,0
1388,160,199,196,306,63,13,10,36,107,0,17,0,0
1389,163,200,198,306,63,13,10,35,106,1,17,0,0
1390,163,201,199,310,63,13,10,36,109,2,17,0,0
1391,165,203,200,311,63,13,10,35,108,3,17,0,0
1392,167,204,202,312,63,13,10,35,108,4,17,0,0
1393,169,206,204,315,63,13,10,35,109,5,17,0,0
1394,172,208,207,318,63,13,10,35,110,6,17,0,0
1395,174,206,212,322,63,13,10,38,116,7,17,0,0
1396,175,207,214,327,63,13,10,39,120,8,17,0,0
1397,180,210,218,326,63,13,10,38,116,9,17,0,0
1398,187,215,223,328,63,13,10,36,113,10,17,0,0
1399,193,216,230,331,63,13,10,37,115,11,17,0,0
1400,200,219,237,333,63,13,10,37,114,12,17,0,0
1401,211,218,249,335,63,13,10,38,117,13,17,0,0
1402,221,220,258,335,63,13,10,37,115,14,17,0,0
1403,233,219,271,336,63,13,10,38,117,15,17,0,0
1404,241,219,281,337,63,13,10,40,118,16,17,0,0
1405,247,220,287,339,63,13,10,40,119,17,17,0,0
1430,1799,915,1920,1079,64,13,10,121,164,0,0,0,0
1431,1697,853,1869,1075,65,13,10,172,222,0,35,0,1
1432,1625,835,1811,1075,65,13,10,186,240,1,35,0,0
1433,1546,828,1735,1072,65,13,10,189,244,2,35,0,0
1434,1425,815,1627,1073,65,13,10,202,258,3,35,0,0
1435,1314,779,1539,1068,65,13,10,225,289,4,35,0,0
1436,1225,751,1470,1071,65,13,10,245,320,5,35,0,0
1437,1120,721,1384,1073,65,13,10,264,352,6,35,0,0
1438,989,676,1284,1073,65,13,10,295,397,7,35,0,0
1439,911,640,1230,1076,65,13,10,319,436,8,35,0,0
1440,832,621,1155,1073,65,13,10,323,452,9,35,0,0
1441,747,596,1079,1076,65,13,10,332,480,10,35,0,0
1442,685,558,1029,1075,65,13,10,344,517,11,35,0,0
1443,628,537,971,1073,65,13,10,343,536,12,35,0,0
1444,579,508,925,1072,65,13,10,346,564,13,35,0,0
1445,537,483,877,1059,65,13,10,340,576,14,35,0,0
1446,485,465,822,1054,65,13,10,337,589,15,35,0,0
1447,455,452,776,1032,65,13,10,321,580,16,35,0,0
1448,433,427,729,985,65,13,10,296,558,17,35,0,0
1449,418,411,696,962,65,13,10,278,551,18,35,0,0
1450,394,399,655,936,65,13,10,261,537,19,35,0,0
1451,394,387,629,885,65,13,10,235,498,20,35,0,0
1452,389,377,610,863,65,13,10,221,486,21,35,0,0
1453,380,370,584,835,65,13,10,204,465,22,35,0,0
1454,372,355,561,796,65,13,10,189,441,23,35,0,0
1455,371,345,554,781,65,13,10,183,436,24,35,0,0
1456,379,343,551,763,65,13,10,172,420,25,35,0,0
1457,394,332,549,720,65,13,10,155,388,26,35,0,0
1458,405,330,554,709,65,13,10,149,379,27,35,0,0
1459,419,330,559,693,65,13,10,140,363,28,35,0,0
1460,427,320,561,669,65,13,10,134,349,29,35,0,0
1461,442,316,571,654,65,13,10,129,338,30,35,0,0
1462,463,311,592,643,65,13,10,129,332,31,35,0,0
1463,490,302,614,625,65,13,10,124,323,32,35,0,0
1464,511,304,630,622,65,13,10,119,318,33,35,0,0
1465,535,307,645,611,65,13,10,110,304,34,35,0,0
1466,541,301,648,596,65,13,10,107,295,35,35,1,0
1439,745,782,990,1071,68,13,10,245,289,0,32,0,1
1440,647,745,922,1071,68,13,10,275,326,1,32,0,0
1441,542,711,850,1077,68,13,10,308,366,2,32,0,0
1442,449,675,781,1073,68,13,10,332,398,3,32,0,0
1443,386,643,744,1075,68,13,10,358,432,4,32,0,0
1444,334,601,718,1073,68,13,10,384,472,5,32,0,0
1445,279,570,680,1076,68,13,10,401,506,6,32,0,0
1446,238,545,642,1073,68,13,10,404,528,7,32,0,0
1447,209,520,603,1051,68,13,10,394,531,8,32,0,0
1448,188,498,571,1031,68,13,10,383,533,9,32,0,0
1449,175,478,544,1008,68,13,10,369,530,10,32,0,0
1450,176,458,511,952,68,13,10,335,494,11,32,0,0
1451,182,446,492,919,68,13,10,310,473,12,32,0,0
1452,186,441,473,894,68,13,10,287,453,13,32,0,0
1453,181,421,447,855,68,13,10,266,434,14,32,0,0
1454,183,409,437,837,68,13,10,254,428,15,32,0,0
1455,202,399,441,813,68,13,10,239,414,16,32,0,0
1456,213,389,432,781,68,13,10,219,392,17,32,0,0
1457,219,377,431,768,68,13,10,212,391,18,32,0,0
1458,229,374,422,742,68,13,10,193,368,19,32,0,0
1459,244,363,425,718,68,13,10,181,355,20,32,0,0
1460,260,357,432,707,68,13,10,172,350,21,32,0,0
1461,290,355,448,683,68,13,10,158,328,22,32,0,0
1462,319,351,469,671,68,13,10,150,320,23,32,0,0
1463,344,351,487,664,68,13,10,143,313,24,32,0,0
1464,376,344,511,647,68,13,10,135,303,25,32,0,0
1465,402,344,531,638,68,13,10,129,294,26,32,0,0
1466,422,346,547,632,68,13,10,125,286,27,32,0,0
1467,464,339,584,622,68,13,10,120,283,28,32,0,0
1468,494,339,612,618,68,13,10,118,279,29,32,0,0
1469,519,334,635,617,68,13,10,116,283,30,32,0,0
1470,543,331,651,606,68,13,10,108,275,31,32,0,0
1471,562,325,667,595,68,13,10,105,270,32,32,1,0
1575,245,235,284,339,69,13,10,39,104,0,9,0,0
1576,239,225,279,333,69,13,10,40,108,1,9,0,0
1577,225,224,267,334,69,13,10,42,110,2,9,0,0
1578,215,222,257,334,69,13,10,42,112,3,9,0,0
1579,203,220,245,332,69,13,10,42,112,4,9,0,0
1580,190,218,234,333,69,13,10,44,115,5,9,0,0
1581,181,216,223,329,69,13,10,42,113,6,9,0,0
1582,172,214,214,328,69,13,10,42,114,7,9,0,0
1583,166,211,207,327,69,13,10,41,116,8,9,0,0
1584,162,208,199,318,69,13,10,37,110,9,9,0,0
1582,251,217,288,339,70,13,10,37,122,0,57,0,0
1583,246,213,284,339,70,13,10,38,126,1,57,0,0
1584,234,214,273,341,70,13,10,39,127,2,57,0,0
1585,220,215,259,342,70,13,10,39,127,3,57,0,0
1586,207,212,246,338,70,13,10,39,126,4,57,0,0
1587,192,216,230,335,70,13,10,38,119,5,57,0,0
1588,178,213,216,335,70,13,10,38,122,6,57,0,0
1589,164,209,204,331,70,13,10,40,122,7,57,0,0
1590,154,210,193,331,70,13,10,39,121,8,57,0,0
1591,147,209,185,330,70,13,10,38,121,9,57,0,0
1592,138,204,177,328,70,13,10,39,124,10,57,0,0
1593,134,205,171,321,70,13,10,37,116,11,57,0,0
1594,131,203,166,313,70,13,10,35,110,12,57,0,0
1595,125,201,161,313,70,13,10,36,112,13,57,0,0
1669,192,213,227,313,70,13,10,35,100,0,57,0,0
1672,185,207,220,308,70,13,10,35,101,0,57,0,0
1734,107,172,142,258,70,13,10,35,86,0,57,0,0
1735,106,171,142,261,70,13,10,36,90,1,57,0,0
1736,105,170,141,258,70,13,10,36,88,2,57,0,0
1737,104,171,140,261,70,13,10,36,90,3,57,0,0
1738,103,175,138,265,70,13,10,35,90,4,57,0,0
1739,103,178,139,269,70,13,10,36,91,5,57,0,0
1740,104,179,141,275,70,13,10,37,96,6,57,0,0
1741,105,183,141,277,70,13,10,36,94,7,57,0,0
1742,106,187,142,280,70,13,10,36,93,8,57,0,0
1743,106,188,143,286,70,13,10,37,98,9,57,0,0
1744,109,194,144,287,70,13,10,35,93,10,57,0,0
1745,109,195,144,289,70,13,10,35,94,11,57,0,0
1754,135,206,170,313,70,13,10,35,107,0,57,0,0
1758,154,213,189,330,70,13,10,35,117,0,57,0,1
1759,160,213,196,332,70,13,10,36,119,1,57,0,0
1760,164,214,201,333,70,13,10,37,119,2,57,0,0
1761,165,214,204,342,70,13,10,39,128,3,57,0,0
1762,167,217,207,349,70,13,10,40,132,4,57,0,0
1763,169,217,210,353,70,13,10,41,136,5,57,0,0
1764,171,219,212,358,70,13,10,41,139,6,57,0,0
1765,172,220,212,358,70,13,10,40,138,7,57,0,0
1766,172,223,213,362,70,13,10,41,139,8,57,0,0
1767,173,225,215,368,70,13,10,42,143,9,57,0,0
1768,175,225,217,370,70,13,10,42,145,10,57,0,0
1769,176,226,218,372,70,13,10,42,146,11,57,0,0
1770,175,227,217,376,70,13,10,42,149,12,57,0,0
1771,173,229,217,385,70,13,10,44,156,13,57,0,0
1772,173,229,219,391,70,13,10,46,162,14,57,0,0
1773,172,232,219,399,70,13,10,47,167,15,57,0,0
1774,164,232,216,413,70,13,10,52,181,16,57,0,0
1775,157,226,212,417,70,13,10,55,191,17,57,0,0
1776,158,229,213,420,70,13,10,55,191,18,57,0,0
1777,162,234,218,427,70,13,10,56,193,19,57,0,0
1778,159,239,216,433,70,13,10,57,194,20,57,0,0
1779,156,240,215,441,70,13,10,59,201,21,57,0,0
1780,152,240,212,448,70,13,10,60,208,22,57,0,0
1781,150,247,212,457,70,13,10,62,210,23,57,0,0
1782,152,248,214,460,70,13,10,62,212,24,57,0,0
1783,155,252,218,468,70,13,10,63,216,25,57,0,0
1784,157,254,221,476,70,13,10,64,222,26,57,0,0
1785,157,255,224,486,70,13,10,67,231,27,57,0,0
1786,160,260,229,497,70,13,10,69,237,28,57,0,0
1787,168,262,236,499,70,13,10,68,237,29,57,0,0
1788,175,266,245,507,70,13,10,70,241,30,57,0,0
1789,179,266,251,517,70,13,10,72,251,31,57,0,0
1790,180,271,253,524,70,13,10,73,253,32,57,0,0
1791,188,277,266,541,70,13,10,78,264,33,57,0,0
1792,193,278,274,552,70,13,10,81,274,34,57,0,0
1793,202,285,287,572,70,13,10,85,287,35,57,0,0
1794,204,286,291,578,70,13,10,87,292,36,57,0,0
1795,208,289,300,596,70,13,10,92,307,37,57,0,0
1796,214,296,311,620,70,13,10,97,324,38,57,0,0
1797,221,300,321,636,70,13,10,100,336,39,57,0,0
1798,230,307,336,662,70,13,10,106,355,40,57,0,0
1799,241,312,347,670,70,13,10,106,358,41,57,0,0
1800,247,322,358,700,70,13,10,111,378,42,57,0,0
1801,256,335,372,726,70,13,10,116,391,43,57,0,0
1802,267,343,390,757,70,13,10,123,414,44,57,0,0
1803,276,357,405,795,70,13,10,129,438,45,57,0,0
1804,281,366,413,813,70,13,10,132,447,46,57,0,0
1805,293,381,434,858,70,13,10,141,477,47,57,0,0
1806,309,394,456,887,70,13,10,147,493,48,57,0,0
1807,323,410,482,944,70,13,10,159,534,49,57,0,0
1808,342,431,511,995,70,13,10,169,564,50,57,0,0
1809,370,453,542,1018,70,13,10,172,565,51,57,0,0
1810,418,480,599,1061,70,13,10,181,581,52,57,0,0
1811,470,499,654,1078,70,13,10,184,579,53,57,0,0
1812,528,536,712,1080,70,13,10,184,544,54,57,0,0
1813,605,582,791,1080,70,13,10,186,498,55,57,0,0
1814,704,621,888,1080,70,13,10,184,459,56,57,0,0
1815,739,641,923,1080,70,13,10,184,439,57,57,1,0
1650,248,236,283,341,71,13,10,35,105,0,11,0,0
1652,225,235,261,340,71,13,10,36,105,0,11,0,0
1654,198,240,233,340,71,13,10,35,100,0,11,0,0
1655,185,235,222,340,71,13,10,37,105,1,11,0,0
1656,174,233,210,338,71,13,10,36,105,2,11,0,0
1657,165,225,204,336,71,13,10,39,111,3,11,0,0
1658,158,221,197,336,71,13,10,39,115,4,11,0,0
1659,151,226,187,332,71,13,10,36,106,5,11,0,0
1660,141,224,178,332,71,13,10,37,108,6,11,0,0
1661,134,222,170,329,71,13,10,36,107,7,11,0,0
1662,132,221,167,326,71,13,10,35,105,8,11,0,0
1666,114,217,149,325,71,13,10,35,108,0,11,0,0
1667,113,212,150,323,71,13,10,37,111,1,11,0,0
1668,111,210,148,319,71,13,10,37,109,2,11,0,0
1669,111,208,148,317,71,13,10,37,109,3,11,0,0
1670,112,208,149,316,71,13,10,37,108,4,11,0,0
1671,112,209,148,313,71,13,10,36,104,5,11,0,0
1672,110,208,145,311,71,13,10,35,103,6,11,0,0
1673,110,206,147,310,71,13,10,37,104,7,11,0,0
1674,111,206,148,309,71,13,10,37,103,8,11,0,0
1675,114,207,149,304,71,13,10,35,97,9,11,0,0
1676,113,206,148,304,71,13,10,35,98,10,11,0,0
1677,112,202,148,302,71,13,10,36,100,11,11,0,0
1679,112,201,147,298,71,13,10,35,97,0,11,0,0
1680,113,200,148,296,71,13,10,35,96,1,11,0,0
1681,114,199,149,296,71,13,10,35,97,2,11,0,0
1652,248,234,289,340,72,13,10,41,106,0,15,0,0
1653,246,220,291,337,72,13,10,45,117,1,15,0,0
1654,246,218,292,339,72,13,10,46,121,2,15,0,0
1655,243,221,287,337,72,13,10,44,116,3,15,0,0
1656,234,222,276,335,72,13,10,42,113,4,15,0,0
1657,223,220,267,335,72,13,10,44,115,5,15,0,0
1658,214,222,257,337,72,13,10,43,115,6,15,0,0
1659,207,222,250,336,72,13,10,43,114,7,15,0,0
1660,199,217,243,335,72,13,10,44,118,8,15,0,0
1661,193,217,236,333,72,13,10,43,116,9,15,0,0
1662,191,218,232,331,72,13,10,41,113,10,15,0,0
1663,188,219,226,329,72,13,10,38,110,11,15,0,0
1664,182,219,221,328,72,13,10,39,109,12,15,0,0
1682,246,214,289,342,72,13,10,43,128,0,15,0,0
1683,247,215,289,342,72,13,10,42,127,1,15,0,0
1684,236,213,280,348,72,13,10,44,135,2,15,0,0
1685,221,215,267,350,72,13,10,46,135,3,15,0,0
1686,209,210,255,351,72,13,10,46,141,4,15,0,0
1687,190,211,237,352,72,13,10,47,141,5,15,0,0
1688,171,207,221,353,72,13,10,50,146,6,15,0,0
1689,158,201,209,353,72,13,10,51,152,7,15,0,0
1690,143,207,192,352,72,13,10,49,145,8,15,0,0
1691,128,210,176,353,72,13,10,48,143,9,15,0,0
1692,113,207,161,354,72,13,10,48,147,10,15,0,0
1693,96,203,145,354,72,13,10,49,151,11,15,0,0
1694,82,212,128,352,72,13,10,46,140,12,15,0,0
1695,68,214,112,351,72,13,10,44,137,13,15,0,0
1696,52,215,95,354,72,13,10,43,139,14,15,0,0
1697,42,216,85,354,72,13,10,43,138,15,15,0,0
1665,190,217,226,335,73,13,10,36,118,0,2,0,0
1666,183,215,220,333,73,13,10,37,118,1,2,0,0
1667,179,214,215,330,73,13,10,36,116,2,2,0,0
1770,82,222,117,351,78,13,10,35,129,0,5,0,0
1772,105,221,141,351,78,13,10,36,130,0,5,0,0
1773,125,219,161,351,78,13,10,36,132,1,5,0,0
1774,138,221,176,359,78,13,10,38,138,2,5,0,0
1775,150,219,189,362,78,13,10,39,143,3,5,0,0
1777,198,219,234,352,78,13,10,36,133,0,5,0,0
1778,214,221,250,352,78,13,10,36,131,1,5,0,0
1779,227,219,264,351,78,13,10,37,132,2,5,0,0
1780,239,222,276,350,78,13,10,37,128,3,5,0,0
1781,252,223,289,349,78,13,10,37,126,4,5,0,0
1782,266,223,303,349,78,13,10,37,126,5,5,0,0
1795,236,223,271,311,80,13,10,35,88,0,14,0,0
1796,220,221,265,336,80,13,10,45,115,1,14,0,0
1797,211,219,259,339,80,13,10,48,120,2,14,0,0
1798,208,220,254,336,80,13,10,46,116,3,14,0,0
1799,208,219,252,332,80,13,10,44,113,4,14,0,0
1800,199,217,242,329,80,13,10,43,112,5,14,0,0
1801,197,216,239,327,80,13,10,42,111,6,14,0,0
1802,192,215,233,323,80,13,10,41,108,7,14,0,0
1803,189,212,230,322,80,13,10,41,110,8,14,0,0
1804,187,211,227,321,80,13,10,40,110,9,14,0,0
1805,186,208,226,319,80,13,10,40,111,10,14,0,0
1806,185,208,224,316,80,13,10,39,108,11,14,0,0
1807,186,209,224,313,80,13,10,38,104,12,14,0,0
1808,187,208,223,311,80,13,10,36,103,13,14,0,0
1809,187,209,223,310,80,13,10,36,101,14,14,0,0
1811,186,207,221,308,80,13,10,35,101,0,14,0,0
1812,185,205,221,307,80,13,10,36,102,1,14,0,0
1813,184,204,220,305,80,13,10,36,101,2,14,0,0
1814,185,204,220,302,80,13,10,35,98,3,14,0,0
1815,824,682,1119,1070,82,13,10,295,388,0,3,0,0
1816,960,736,1220,1076,82,13,10,260,340,1,3,0,0
1817,1126,805,1339,1076,82,13,10,213,271,2,3,0,0
1818,1219,843,1403,1077,82,13,10,184,234,3,3,0,0
1960,113,167,149,237,85,13,10,36,70,0,34,0,0
1961,116,168,152,238,85,13,10,36,70,1,34,0,0
1962,117,168,153,240,85,13,10,36,72,2,34,0,0
1963,118,168,156,243,85,13,10,38,75,3,34,0,0
1964,119,168,157,244,85,13,10,38,76,4,34,0,0
1965,122,172,157,245,85,13,10,35,73,5,34,0,0
2008,197,210,232,312,85,13,10,35,102,0,34,0,0
2009,199,213,235,314,85,13,10,36,101,1,34,0,0
2010,202,214,239,317,85,13,10,37,103,2,34,0,0
2011,206,212,244,319,85,13,10,38,107,3,34,0,0
2012,209,213,248,323,85,13,10,39,110,4,34,0,0
2013,211,216,251,327,85,13,10,40,111,5,34,0,0
2014,212,217,253,330,85,13,10,41,113,6,34,0,0
2015,214,217,256,333,85,13,10,42,116,7,34,0,0
2016,216,215,261,334,85,13,10,45,119,8,34,0,0
2017,221,215,266,336,85,13,10,45,121,9,34,0,0
2018,229,215,274,337,85,13,10,45,122,10,34,0,0
2019,243,217,286,334,85,13,10,43,117,11,34,0,0
2020,248,223,290,339,85,13,10,42,116,12,34,0,0
2021,252,225,294,341,85,13,10,42,116,13,34,0,0
2050,238,225,280,345,85,13,10,42,120,0,34,0,1
2051,224,214,274,344,85,13,10,50,130,1,34,0,0
2052,214,211,263,344,85,13,10,49,133,2,34,0,0
2053,206,213,254,340,85,13,10,48,127,3,34,0,0
2054,195,212,244,340,85,13,10,49,128,4,34,0,0
2055,181,211,230,339,85,13,10,49,128,5,34,0,0
2056,166,210,214,336,85,13,10,48,126,6,34,0,0
2057,156,210,203,334,85,13,10,47,124,7,34,0,0
2058,149,211,194,332,85,13,10,45,121,8,34,0,0
2059,140,211,183,330,85,13,10,43,119,9,34,0,0
2060,131,209,174,329,85,13,10,43,120,10,34,0,0
2061,125,207,168,329,85,13,10,43,122,11,34,0,0
2062,121,204,164,327,85,13,10,43,123,12,34,0,0
2063,120,203,161,323,85,13,10,41,120,13,34,0,0
2064,120,204,159,322,85,13,10,39,118,14,34,0,0
2065,118,204,157,319,85,13,10,39,115,15,34,0,0
2066,117,201,156,317,85,13,10,39,116,16,34,0,0
2067,115,200,154,315,85,13,10,39,115,17,34,0,0
2068,115,199,153,311,85,13,10,38,112,18,34,0,0
2069,116,199,154,310,85,13,10,38,111,19,34,0,0
2070,113,199,152,308,85,13,10,39,109,20,34,0,0
2071,113,199,151,305,85,13,10,38,106,21,34,0,0
2072,112,198,151,305,85,13,10,39,107,22,34,0,0
2073,113,196,152,301,85,13,10,39,105,23,34,0,0
2074,113,196,151,299,85,13,10,38,103,24,34,0,0
2075,115,197,154,298,85,13,10,39,101,25,34,0,0
2076,115,196,154,296,85,13,10,39,100,26,34,0,0
2077,114,196,153,294,85,13,10,39,98,27,34,0,0
2078,114,194,152,294,85,13,10,38,100,28,34,0,0
2079,112,192,151,292,85,13,10,39,100,29,34,0,0
2080,111,192,150,291,85,13,10,39,99,30,34,0,0
2081,110,192,148,289,85,13,10,38,97,31,34,0,0
2082,109,192,146,288,85,13,10,37,96,32,34,0,0
2083,106,190,143,286,85,13,10,37,96,33,34,0,0
2084,105,189,141,284,85,13,10,36,95,34,34,1,0
2049,254,215,289,341,87,13,10,35,126,0,0,0,0
2058,222,218,257,319,89,13,10,35,101,0,6,0,0
2059,218,217,257,330,89,13,10,39,113,1,6,0,0
2060,216,218,255,330,89,13,10,39,112,2,6,0,0
2061,215,214,255,328,89,13,10,40,114,3,6,0,0
2062,214,213,251,318,89,13,10,37,105,4,6,0,0
2063,211,208,250,319,89,13,10,39,111,5,6,0,0
2064,210,210,246,313,89,13,10,36,103,6,6,0,0
2066,201,208,236,312,89,13,10,35,104,0,6,0,0
2130,248,230,286,333,90,13,10,38,103,0,1,0,0
2131,241,227,280,331,90,13,10,39,104,1,1,0,0
2132,213,219,261,335,91,13,10,48,116,0,14,0,0
2133,211,221,257,333,91,13,10,46,112,1,14,0,0
2134,194,218,241,331,91,13,10,47,113,2,14,0,0
2135,180,215,227,330,91,13,10,47,115,3,14,0,0
2136,171,212,218,327,91,13,10,47,115,4,14,0,0
2137,162,208,209,324,91,13,10,47,116,5,14,0,0
2138,156,210,200,322,91,13,10,44,112,6,14,0,0
2139,151,210,192,317,91,13,10,41,107,7,14,0,0
2140,147,211,187,314,91,13,10,40,103,8,14,0,0
2141,144,212,182,313,91,13,10,38,101,9,14,0,0
2142,141,211,177,309,91,13,10,36,98,10,14,0,0
2143,136,210,173,310,91,13,10,37,100,11,14,0,0
2144,133,202,170,306,91,13,10,37,104,12,14,0,0
2145,129,198,167,307,91,13,10,38,109,13,14,0,0
2146,129,196,165,304,91,13,10,36,108,14,14,0,0
100,474,689,824,1074,4,13,15,350,385,0,11,0,0
101,550,647,936,1073,4,13,15,386,426,1,11,0,0
102,622,587,1056,1070,4,13,15,434,483,2,11,0,0
103,679,534,1156,1074,4,13,15,477,540,3,11,0,0
104,732,482,1243,1075,4,13,15,511,593,4,11,0,0
105,793,438,1303,1046,4,13,15,510,608,5,11,0,0
106,859,412,1336,998,4,13,15,477,586,6,11,0,0
107,911,384,1366,961,4,13,15,455,577,7,11,0,0
108,941,372,1371,940,4,13,15,430,568,8,11,0,0
109,1090,339,1489,884,4,13,15,399,545,9,11,0,0
110,1133,332,1518,877,4,13,15,385,545,10,11,0,0
111,1188,302,1581,858,4,13,15,393,556,11,11,0,0
108,1333,560,1413,818,5,13,15,80,258,0,0,0,0
109,1051,347,1247,852,6,13,15,196,505,0,16,0,0
110,1063,347,1253,833,6,13,15,190,486,1,16,0,0
111,1112,335,1339,916,6,13,15,227,581,2,16,0,0
112,1087,351,1335,980,6,13,15,248,629,3,16,0,0
113,1052,368,1307,1012,6,13,15,255,644,4,16,0,0
114,997,378,1255,1029,6,13,15,258,651,5,16,0,0
115,935,408,1198,1067,6,13,15,263,659,6,16,0,0
116,887,446,1138,1077,6,13,15,251,631,7,16,0,0
117,787,454,1044,1080,6,13,15,257,626,8,16,0,0
118,697,501,950,1080,6,13,15,253,579,9,16,0,0
119,636,537,880,1080,6,13,15,244,543,10,16,0,0
120,566,579,797,1080,6,13,15,231,501,11,16,0,0
121,466,653,669,1080,6,13,15,203,427,12,16,0,0
122,323,692,517,1080,6,13,15,194,388,13,16,0,0
123,189,747,366,1079,6,13,15,177,332,14,16,0,0
124,61,839,198,1077,6,13,15,137,238,15,16,0,0
125,0,887,87,1080,6,13,15,87,193,16,16,0,0
112,1273,321,1363,518,7,13,15,90,197,0,0,0,0
113,1262,325,1407,723,8,13,15,145,398,0,1,0,0
114,1297,301,1449,720,8,13,15,152,419,1,1,0,0
378,7,785,211,1076,9,13,15,204,291,0,27,0,1
379,49,749,277,1073,9,13,15,228,324,1,27,0,0
380,122,708,376,1069,9,13,15,254,361,2,27,0,0
381,147,654,437,1074,9,13,15,290,420,3,27,0,0
382,212,615,523,1070,9,13,15,311,455,4,27,0,0
383,275,583,604,1071,9,13,15,329,488,5,27,0,0
384,349,546,699,1076,9,13,15,350,530,6,27,0,0
385,428,517,787,1076,9,13,15,359,559,7,27,0,0
386,478,492,846,1078,9,13,15,368,586,8,27,0,0
387,524,468,897,1074,9,13,15,373,606,9,27,0,0
388,588,444,963,1069,9,13,15,375,625,10,27,0,0
389,644,422,1000,1028,9,13,15,356,606,11,27,0,0
390,696,416,1035,1010,9,13,15,339,594,12,27,0,0
391,749,398,1077,989,9,13,15,328,591,13,27,0,0
392,818,379,1122,948,9,13,15,304,569,14,27,0,0
393,859,369,1153,940,9,13,15,294,571,15,27,0,0
394,888,353,1172,916,9,13,15,284,563,16,27,0,0
395,934,338,1208,897,9,13,15,274,559,17,27,0,0
396,967,331,1221,852,9,13,15,254,521,18,27,0,0
397,1010,330,1252,832,9,13,15,242,502,19,27,0,0
398,1066,328,1297,814,9,13,15,231,486,20,27,0,0
399,1145,326,1360,795,9,13,15,215,469,21,27,0,0
400,1195,322,1402,786,9,13,15,207,464,22,27,0,0
401,1225,309,1433,782,9,13,15,208,473,23,27,0,0
402,1265,295,1465,766,9,13,15,200,471,24,27,0,0
403,1296,298,1477,742,9,13,15,181,444,25,27,0,0
404,1327,384,1463,722,9,13,15,136,338,26,27,0,0
405,1369,385,1498,705,9,13,15,129,320,27,27,1,0
381,324,807,537,1072,10,13,15,213,265,0,0,0,0
382,413,688,723,1072,11,13,15,310,384,0,17,0,0
383,486,629,840,1068,11,13,15,354,439,1,17,0,0
384,587,607,957,1066,11,13,15,370,459,2,17,0,0
385,672,555,1082,1065,11,13,15,410,510,3,17,0,0
386,745,507,1194,1066,11,13,15,449,559,4,17,0,0
387,792,473,1265,1065,11,13,15,473,592,5,17,0,0
388,812,437,1308,1068,11,13,15,496,631,6,17,0,0
389,821,393,1334,1064,11,13,15,513,671,7,17,0,0
390,843,377,1355,1068,11,13,15,512,691,8,17,0,0
391,883,359,1388,1066,11,13,15,505,707,9,17,0,0
392,929,339,1425,1058,11,13,15,496,719,10,17,0,0
393,975,329,1460,1057,11,13,15,485,728,11,17,0,0
394,1020,321,1467,1015,11,13,15,447,694,12,17,0,0
395,1070,306,1469,948,11,13,15,399,642,13,17,0,0
396,1100,312,1462,912,11,13,15,362,600,14,17,0,0
397,1132,304,1475,882,11,13,15,343,578,15,17,0,0
398,1192,292,1514,864,11,13,15,322,572,16,17,0,0
399,1233,273,1557,848,11,13,15,324,575,17,17,0,0
399,1322,339,1427,857,12,13,15,105,518,0,0,0,0
436,1371,159,1450,526,13,13,15,79,367,0,44,0,1
437,1354,221,1419,521,13,13,15,65,300,1,44,0,0
438,1337,218,1402,514,13,13,15,65,296,2,44,0,0
439,1304,218,1369,510,13,13,15,65,292,3,44,0,0
440,1276,213,1339,489,13,13,15,63,276,4,44,0,0
441,1244,204,1310,486,13,13,15,66,282,5,44,0,0
442,1223,206,1289,479,13,13,15,66,273,6,44,0,0
443,1209,200,1274,461,13,13,15,65,261,7,44,0,0
444,1191,189,1257,454,13,13,15,66,265,8,44,0,0
445,1182,187,1244,428,13,13,15,62,241,9,44,0,0
446,1170,181,1234,427,13,13,15,64,246,10,44,0,0
447,1155,180,1219,424,13,13,15,64,244,11,44,0,0
448,1147,174,1209,407,13,13,15,62,233,12,44,0,0
449,1141,175,1203,403,13,13,15,62,228,13,44,0,0
450,1140,171,1201,398,13,13,15,61,227,14,44,0,0
451,1138,168,1198,388,13,13,15,60,220,15,44,0,0
452,1137,167,1195,382,13,13,15,58,215,16,44,0,0
453,1137,163,1194,369,13,13,15,57,206,17,44,0,0
454,1133,162,1188,362,13,13,15,55,200,18,44,0,0
455,1132,158,1186,356,13,13,15,54,198,19,44,0,0
456,1136,155,1189,351,13,13,15,53,196,20,44,0,0
457,1137,153,1189,345,13,13,15,52,192,21,44,0,0
458,1138,150,1189,337,13,13,15,51,187,22,44,0,0
459,1139,150,1189,333,13,13,15,50,183,23,44,0,0
460,1140,147,1190,329,13,13,15,50,182,24,44,0,0
461,1142,145,1192,323,13,13,15,50,178,25,44,0,0
462,1143,144,1193,322,13,13,15,50,178,26,44,0,0
463,1145,141,1193,316,13,13,15,48,175,27,44,0,0
464,1148,139,1195,312,13,13,15,47,173,28,44,0,0
465,1154,139,1201,311,13,13,15,47,172,29,44,0,0
466,1160,137,1205,303,13,13,15,45,166,30,44,0,0
467,1167,139,1208,292,13,13,15,41,153,31,44,0,0
468,1172,140,1213,288,13,13,15,41,148,32,44,0,0
469,1177,142,1218,288,13,13,15,41,146,33,44,0,0
470,1181,137,1223,288,13,13,15,42,151,34,44,0,0
471,1187,132,1230,282,13,13,15,43,150,35,44,0,0
472,1189,132,1232,282,13,13,15,43,150,36,44,0,0
473,1192,132,1233,271,13,13,15,41,139,37,44,0,0
474,1193,132,1235,272,13,13,15,42,140,38,44,0,0
475,1196,133,1236,267,13,13,15,40,134,39,44,0,0
476,1197,130,1238,267,13,13,15,41,137,40,44,0,0
477,1193,132,1233,262,13,13,15,40,130,41,44,0,0
478,1186,129,1226,259,13,13,15,40,130,42,44,0,0
479,1175,125,1215,257,13,13,15,40,132,43,44,0,0
480,1175,123,1214,253,13,13,15,39,130,44,44,1,0
521,1326,285,1431,702,14,13,15,105,417,0,32,0,1
522,1300,281,1403,688,14,13,15,103,407,1,32,0,0
523,1270,275,1371,665,14,13,15,101,390,2,32,0,0
524,1238,267,1340,657,14,13,15,102,390,3,32,0,0
525,1204,262,1305,643,14,13,15,101,381,4,32,0,0
526,1175,249,1275,620,14,13,15,100,371,5,32,0,0
527,1143,240,1245,609,14,13,15,102,369,6,32,0,0
528,1114,233,1217,594,14,13,15,103,361,7,32,0,0
529,1098,228,1199,576,14,13,15,101,348,8,32,0,0
530,1080,223,1180,560,14,13,15,100,337,9,32,0,0
531,1062,221,1161,550,14,13,15,99,329,10,32,0,0
532,1037,213,1135,531,14,13,15,98,318,11,32,0,0
533,1026,213,1122,523,14,13,15,96,310,12,32,0,0
534,1016,208,1115,520,14,13,15,99,312,13,32,0,0
535,1006,203,1100,494,14,13,15,94,291,14,32,0,0
536,995,200,1089,487,14,13,15,94,287,15,32,0,0
537,991,196,1083,476,14,13,15,92,280,16,32,0,0
538,991,192,1082,464,14,13,15,91,272,17,32,0,0
539,993,191,1084,455,14,13,15,91,264,18,32,0,0
540,989,185,1082,443,14,13,15,93,258,19,32,0,0
541,991,183,1086,440,14,13,15,95,257,20,32,0,0
542,1002,185,1095,433,14,13,15,93,248,21,32,0,0
543,1014,180,1104,423,14,13,15,90,243,22,32,0,0
544,1024,181,1111,419,14,13,15,87,238,23,32,0,0
545,1034,180,1118,413,14,13,15,84,233,24,32,0,0
546,1041,179,1117,389,14,13,15,76,210,25,32,0,0
547,1047,183,1116,375,14,13,15,69,192,26,32,0,0
548,1051,179,1116,362,14,13,15,65,183,27,32,0,0
549,1060,173,1110,309,14,13,15,50,136,28,32,0,0
550,1069,170,1106,266,14,13,15,37,96,29,32,0,0
551,1080,160,1120,258,14,13,15,40,98,30,32,0,0
552,1088,156,1129,253,14,13,15,41,97,31,32,0,0
553,1095,152,1132,237,14,13,15,37,85,32,32,1,0
525,1347,206,1445,629,15,13,15,98,423,0,23,0,1
526,1316,209,1413,622,15,13,15,97,413,1,23,0,0
527,1307,199,1409,628,15,13,15,102,429,2,23,0,0
528,1292,196,1393,619,15,13,15,101,423,3,23,0,0
529,1254,187,1360,616,15,13,15,106,429,4,23,0,0
530,1239,187,1344,606,15,13,15,105,419,5,23,0,0
531,1217,186,1321,582,15,13,15,104,396,6,23,0,0
532,1199,182,1303,572,15,13,15,104,390,7,23,0,0
533,1188,173,1293,560,15,13,15,105,387,8,23,0,0
534,1180,171,1283,540,15,13,15,103,369,9,23,0,0
535,1171,168,1271,523,15,13,15,100,355,10,23,0,0
536,1158,165,1258,514,15,13,15,100,349,11,23,0,0
537,1140,164,1241,505,15,13,15,101,341,12,23,0,0
538,1134,157,1235,495,15,13,15,101,338,13,23,0,0
539,1127,151,1228,487,15,13,15,101,336,14,23,0,0
540,1132,158,1225,462,15,13,15,93,304,15,23,0,0
541,1135,167,1227,468,15,13,15,92,301,16,23,0,0
542,1127,184,1224,496,15,13,15,97,312,17,23,0,0
543,1111,166,1216,509,15,13,15,105,343,18,23,0,0
544,1105,169,1206,497,15,13,15,101,328,19,23,0,0
545,1127,158,1206,410,15,13,15,79,252,20,23,0,0
546,1136,155,1209,386,15,13,15,73,231,21,23,0,0
547,1145,153,1214,370,15,13,15,69,217,22,23,0,0
548,1144,151,1210,356,15,13,15,66,205,23,23,1,0
554,1095,156,1130,254,15,13,15,35,98,0,23,0,0
555,1096,155,1131,243,15,13,15,35,88,1,23,0,0
556,1100,155,1136,240,15,13,15,36,85,2,23,0,0
557,1104,152,1142,235,15,13,15,38,83,3,23,0,0
533,1363,298,1434,597,16,13,15,71,299,0,55,0,0
534,1347,296,1421,606,16,13,15,74,310,1,55,0,0
535,1323,287,1397,596,16,13,15,74,309,2,55,0,0
536,1287,281,1359,573,16,13,15,72,292,3,55,0,0
537,1257,277,1331,571,16,13,15,74,294,4,55,0,0
538,1227,271,1301,556,16,13,15,74,285,5,55,0,0
539,1208,267,1281,541,16,13,15,73,274,6,55,0,0
540,1190,266,1265,542,16,13,15,75,276,7,55,0,0
541,1168,262,1242,534,16,13,15,74,272,8,55,0,0
545,1101,253,1170,494,16,13,15,69,241,0,55,0,1
546,1095,211,1175,477,16,13,15,80,266,1,55,0,0
547,1086,231,1158,467,16,13,15,72,236,2,55,0,0
548,1082,213,1155,454,16,13,15,73,241,3,55,0,0
549,1077,199,1153,447,16,13,15,76,248,4,55,0,0
550,1071,207,1144,437,16,13,15,73,230,5,55,0,0
551,1067,220,1138,438,16,13,15,71,218,6,55,0,0
552,1071,221,1141,433,16,13,15,70,212,7,55,0,0
553,1073,177,1153,419,16,13,15,80,242,8,55,0,0
554,1075,165,1156,409,16,13,15,81,244,9,55,0,0
555,1080,181,1155,408,16,13,15,75,227,10,55,0,0
556,1080,192,1152,406,16,13,15,72,214,11,55,0,0
557,1082,192,1153,400,16,13,15,71,208,12,55,0,0
558,1085,163,1160,384,16,13,15,75,221,13,55,0,0
559,1088,155,1164,381,16,13,15,76,226,14,55,0,0
560,1093,153,1167,376,16,13,15,74,223,15,55,0,0
561,1100,151,1170,361,16,13,15,70,210,16,55,0,0
562,1099,168,1166,364,16,13,15,67,196,17,55,0,0
563,1103,171,1169,363,16,13,15,66,192,18,55,0,0
564,1109,165,1174,356,16,13,15,65,191,19,55,0,0
565,1113,155,1178,350,16,13,15,65,195,20,55,0,0
566,1116,164,1178,347,16,13,15,62,183,21,55,0,0
567,1116,173,1175,344,16,13,15,59,171,22,55,0,0
568,1119,176,1177,339,16,13,15,58,163,23,55,0,0
569,1129,170,1187,333,16,13,15,58,163,24,55,0,0
570,1134,171,1191,330,16,13,15,57,159,25,55,0,0
571,1136,166,1194,330,16,13,15,58,164,26,55,0,0
572,1139,164,1197,331,16,13,15,58,167,27,55,0,0
573,1145,165,1200,322,16,13,15,55,157,28,55,0,0
574,1149,164,1204,318,16,13,15,55,154,29,55,0,0
575,1157,159,1210,311,16,13,15,53,152,30,55,0,0
576,1161,158,1213,306,16,13,15,52,148,31,55,0,0
577,1161,152,1212,298,16,13,15,51,146,32,55,0,0
578,1163,150,1214,298,16,13,15,51,148,33,55,0,0
579,1165,146,1218,297,16,13,15,53,151,34,55,0,0
580,1169,142,1223,295,16,13,15,54,153,35,55,0,0
581,1173,139,1228,297,16,13,15,55,158,36,55,0,0
582,1175,139,1228,295,16,13,15,53,156,37,55,0,0
583,1174,136,1228,292,16,13,15,54,156,38,55,0,0
584,1173,135,1226,289,16,13,15,53,154,39,55,0,0
585,1173,133,1226,288,16,13,15,53,155,40,55,0,0
586,1175,133,1229,288,16,13,15,54,155,41,55,0,0
587,1182,125,1238,283,16,13,15,56,158,42,55,0,0
588,1185,123,1240,281,16,13,15,55,158,43,55,0,0
589,1183,114,1238,271,16,13,15,55,157,44,55,0,0
590,1186,111,1240,268,16,13,15,54,157,45,55,0,0
591,1180,121,1232,269,16,13,15,52,148,46,55,0,0
592,1185,137,1231,269,16,13,15,46,132,47,55,0,0
593,1186,143,1231,268,16,13,15,45,125,48,55,0,0
594,1184,142,1229,267,16,13,15,45,125,49,55,0,0
595,1182,143,1225,262,16,13,15,43,119,50,55,0,0
596,1179,146,1219,255,16,13,15,40,109,51,55,0,0
597,1176,144,1217,253,16,13,15,41,109,52,55,0,0
598,1171,140,1212,250,16,13,15,41,110,53,55,0,0
599,1169,141,1207,243,16,13,15,38,102,54,55,0,0
600,1168,141,1204,240,16,13,15,36,99,55,55,1,0
537,1361,271,1440,596,17,13,15,79,325,0,68,0,1
538,1353,257,1436,597,17,13,15,83,340,1,68,0,0
539,1335,256,1419,598,17,13,15,84,342,2,68,0,0
540,1311,256,1393,586,17,13,15,82,330,3,68,0,0
541,1290,251,1371,574,17,13,15,81,323,4,68,0,0
542,1264,245,1347,569,17,13,15,83,324,5,68,0,0
543,1243,237,1326,556,17,13,15,83,319,6,68,0,0
544,1222,231,1303,534,17,13,15,81,303,7,68,0,0
545,1204,227,1288,531,17,13,15,84,304,8,68,0,0
546,1191,220,1280,535,17,13,15,89,315,9,68,0,0
547,1177,216,1261,508,17,13,15,84,292,10,68,0,0
548,1151,177,1243,498,17,13,15,92,321,11,68,0,0
549,1149,180,1236,481,17,13,15,87,301,12,68,0,0
550,1146,160,1235,471,17,13,15,89,311,13,68,0,0
551,1142,149,1235,470,17,13,15,93,321,14,68,0,0
552,1142,146,1233,458,17,13,15,91,312,15,68,0,0
553,1139,145,1227,444,17,13,15,88,299,16,68,0,0
554,1138,141,1226,440,17,13,15,88,299,17,68,0,0
555,1140,137,1226,428,17,13,15,86,291,18,68,0,0
556,1142,132,1227,419,17,13,15,85,287,19,68,0,0
557,1145,132,1229,414,17,13,15,84,282,20,68,0,0
558,1149,134,1230,403,17,13,15,81,269,21,68,0,0
559,1151,133,1230,398,17,13,15,79,265,22,68,0,0
560,1150,129,1230,397,17,13,15,80,268,23,68,0,0
561,1154,125,1232,388,17,13,15,78,263,24,68,0,0
562,1161,128,1235,380,17,13,15,74,252,25,68,0,0
563,1165,131,1236,373,17,13,15,71,242,26,68,0,0
564,1165,126,1236,368,17,13,15,71,242,27,68,0,0
565,1166,126,1236,363,17,13,15,70,237,28,68,0,0
566,1170,125,1239,360,17,13,15,69,235,29,68,0,0
567,1172,124,1241,355,17,13,15,69,231,30,68,0,0
568,1179,124,1246,353,17,13,15,67,229,31,68,0,0
569,1180,121,1249,351,17,13,15,69,230,32,68,0,0
570,1180,123,1246,342,17,13,15,66,219,33,68,0,0
571,1181,123,1246,338,17,13,15,65,215,34,68,0,0
572,1188,142,1248,335,17,13,15,60,193,35,68,0,0
573,1194,148,1250,329,17,13,15,56,181,36,68,0,0
574,1200,153,1254,326,17,13,15,54,173,37,68,0,0
575,1203,149,1259,324,17,13,15,56,175,38,68,0,0
576,1204,147,1258,319,17,13,15,54,172,39,68,0,0
577,1205,145,1261,319,17,13,15,56,174,40,68,0,0
578,1209,139,1265,313,17,13,15,56,174,41,68,0,0
579,1212,138,1267,308,17,13,15,55,170,42,68,0,0
580,1219,128,1275,301,17,13,15,56,173,43,68,0,0
581,1221,131,1276,303,17,13,15,55,172,44,68,0,0
582,1223,124,1273,278,17,13,15,50,154,45,68,0,0
583,1220,127,1274,290,17,13,15,54,163,46,68,0,0
584,1217,121,1273,290,17,13,15,56,169,47,68,0,0
585,1216,114,1273,287,17,13,15,57,173,48,68,0,0
586,1212,115,1267,284,17,13,15,55,169,49,68,0,0
587,1219,127,1269,274,17,13,15,50,147,50,68,0,0
588,1227,138,1275,277,17,13,15,48,139,51,68,0,0
589,1234,139,1278,270,17,13,15,44,131,52,68,0,0
590,1236,136,1285,284,17,13,15,49,148,53,68,0,0
591,1240,135,1289,285,17,13,15,49,150,54,68,0,0
592,1241,134,1291,282,17,13,15,50,148,55,68,0,0
593,1241,135,1288,274,17,13,15,47,139,56,68,0,0
594,1237,134,1282,271,17,13,15,45,137,57,68,0,0
595,1233,135,1276,267,17,13,15,43,132,58,68,0,0
596,1230,135,1273,262,17,13,15,43,127,59,68,0,0
597,1225,133,1267,257,17,13,15,42,124,60,68,0,0
598,1220,132,1259,247,17,13,15,39,115,61,68,0,0
599,1213,133,1252,244,17,13,15,39,111,62,68,0,0
600,1206,129,1243,238,17,13,15,37,109,63,68,0,0
601,1197,128,1237,246,17,13,15,40,118,64,68,0,0
602,1190,129,1230,249,17,13,15,40,120,65,68,0,0
603,1182,129,1219,242,17,13,15,37,113,66,68,0,0
604,1173,129,1208,241,17,13,15,35,112,67,68,0,0
605,1167,129,1203,239,17,13,15,36,110,68,68,1,0
540,1117,157,1168,397,18,13,15,51,240,0,3,0,0
541,1105,149,1160,403,18,13,15,55,254,1,3,0,0
542,1099,151,1152,396,18,13,15,53,245,2,3,0,0
543,1101,151,1147,362,18,13,15,46,211,3,3,0,0
541,1366,242,1438,507,19,13,15,72,265,0,66,0,1
542,1350,233,1430,527,19,13,15,80,294,1,66,0,0
543,1331,239,1405,515,19,13,15,74,276,2,66,0,0
544,1314,234,1388,509,19,13,15,74,275,3,66,0,0
545,1301,228,1375,500,19,13,15,74,272,4,66,0,0
546,1288,221,1362,489,19,13,15,74,268,5,66,0,0
547,1275,215,1351,486,19,13,15,76,271,6,66,0,0
548,1270,220,1342,477,19,13,15,72,257,7,66,0,0
549,1257,211,1329,466,19,13,15,72,255,8,66,0,0
550,1253,208,1325,460,19,13,15,72,252,9,66,0,0
551,1254,205,1325,448,19,13,15,71,243,10,66,0,0
552,1252,196,1324,445,19,13,15,72,249,11,66,0,0
553,1254,197,1324,438,19,13,15,70,241,12,66,0,0
554,1254,195,1323,432,19,13,15,69,237,13,66,0,0
555,1255,194,1322,425,19,13,15,67,231,14,66,0,0
556,1257,193,1323,421,19,13,15,66,228,15,66,0,0
557,1257,191,1323,416,19,13,15,66,225,16,66,0,0
558,1259,189,1324,409,19,13,15,65,220,17,66,0,0
559,1262,187,1325,403,19,13,15,63,216,18,66,0,0
560,1262,184,1325,398,19,13,15,63,214,19,66,0,0
561,1264,182,1325,390,19,13,15,61,208,20,66,0,0
562,1265,184,1326,390,19,13,15,61,206,21,66,0,0
563,1267,180,1329,391,19,13,15,62,211,22,66,0,0
564,1271,177,1332,385,19,13,15,61,208,23,66,0,0
565,1275,177,1335,378,19,13,15,60,201,24,66,0,0
566,1276,175,1333,367,19,13,15,57,192,25,66,0,0
567,1276,172,1333,366,19,13,15,57,194,26,66,0,0
568,1276,172,1333,362,19,13,15,57,190,27,66,0,0
569,1277,170,1333,357,19,13,15,56,187,28,66,0,0
570,1280,167,1335,346,19,13,15,55,179,29,66,0,0
571,1280,170,1335,346,19,13,15,55,176,30,66,0,0
572,1281,170,1334,338,19,13,15,53,168,31,66,0,0
573,1284,168,1336,333,19,13,15,52,165,32,66,0,0
574,1285,166,1337,332,19,13,15,52,166,33,66,0,0
575,1285,161,1338,329,19,13,15,53,168,34,66,0,0
576,1287,161,1339,326,19,13,15,52,165,35,66,0,0
577,1288,159,1339,322,19,13,15,51,163,36,66,0,0
578,1288,154,1339,319,19,13,15,51,165,37,66,0,0
579,1289,154,1340,317,19,13,15,51,163,38,66,0,0
580,1291,157,1340,315,19,13,15,49,158,39,66,0,0
581,1292,161,1337,308,19,13,15,45,147,40,66,0,0
582,1293,156,1339,306,19,13,15,46,150,41,66,0,0
583,1292,152,1338,300,19,13,15,46,148,42,66,0,0
584,1292,148,1339,299,19,13,15,47,151,43,66,0,0
585,1296,152,1341,295,19,13,15,45,143,44,66,0,0
586,1300,148,1344,289,19,13,15,44,141,45,66,0,0
587,1304,146,1348,286,19,13,15,44,140,46,66,0,0
588,1306,147,1349,283,19,13,15,43,136,47,66,0,0
589,1303,144,1348,287,19,13,15,45,143,48,66,0,0
590,1303,143,1346,284,19,13,15,43,141,49,66,0,0
591,1302,143,1345,279,19,13,15,43,136,50,66,0,0
592,1302,143,1343,273,19,13,15,41,130,51,66,0,0
593,1299,142,1338,267,19,13,15,39,125,52,66,0,0
594,1294,140,1334,267,19,13,15,40,127,53,66,0,0
595,1288,139,1329,269,19,13,15,41,130,54,66,0,0
596,1283,137,1322,263,19,13,15,39,126,55,66,0,0
597,1273,135,1314,262,19,13,15,41,127,56,66,0,0
598,1264,135,1303,255,19,13,15,39,120,57,66,0,0
599,1257,135,1295,251,19,13,15,38,116,58,66,0,0
600,1246,134,1284,250,19,13,15,38,116,59,66,0,0
601,1235,134,1272,251,19,13,15,37,117,60,66,0,0
602,1223,133,1261,250,19,13,15,38,117,61,66,0,0
603,1212,130,1248,246,19,13,15,36,116,62,66,0,0
604,1200,129,1236,243,19,13,15,36,114,63,66,0,0
605,1187,132,1224,241,19,13,15,37,109,64,66,0,0
606,1172,126,1210,245,19,13,15,38,119,65,66,0,0
607,1163,125,1201,243,19,13,15,38,118,66,66,1,0
546,1096,146,1153,270,20,13,15,57,124,0,5,0,0
547,1097,141,1153,262,20,13,15,56,121,1,5,0,0
548,1097,142,1154,265,20,13,15,57,123,2,5,0,0
549,1102,145,1159,267,20,13,15,57,122,3,5,0,0
550,1101,141,1166,283,20,13,15,65,142,4,5,0,0
551,1102,141,1170,288,20,13,15,68,147,5,5,0,0
566,1136,140,1189,252,20,13,15,53,112,0,5,0,0
567,1138,140,1191,251,20,13,15,53,111,1,5,0,0
587,1163,122,1207,233,20,13,15,44,111,0,5,0,0
588,1164,121,1208,233,20,13,15,44,112,1,5,0,0
549,1148,159,1231,281,21,13,15,83,122,0,0,0,0
559,1100,146,1162,236,22,13,15,62,90,0,2,0,0
560,1107,147,1162,227,22,13,15,55,80,1,2,0,0
561,1112,149,1163,223,22,13,15,51,74,2,2,0,0
571,1203,123,1257,220,23,13,15,54,97,0,3,0,0
572,1211,123,1257,206,23,13,15,46,83,1,3,0,0
573,1213,119,1261,207,23,13,15,48,88,2,3,0,0
574,1218,121,1263,199,23,13,15,45,78,3,3,0,0
588,1195,111,1246,183,23,13,15,51,72,0,3,0,0
589,1193,111,1244,182,23,13,15,51,71,1,3,0,0
591,1173,110,1224,182,23,13,15,51,72,0,3,0,0
592,1170,110,1221,182,23,13,15,51,72,1,3,0,0
574,1179,116,1220,187,24,13,15,41,71,0,0,0,0
579,1221,120,1277,207,25,13,15,56,87,0,0,0,0
579,1183,132,1227,221,26,13,15,44,89,0,0,0,0
745,1219,129,1255,284,27,13,15,36,155,0,30,0,1
746,1218,134,1255,288,27,13,15,37,154,1,30,0,0
747,1218,138,1258,294,27,13,15,40,156,2,30,0,0
748,1218,139,1260,299,27,13,15,42,160,3,30,0,0
749,1217,141,1261,306,27,13,15,44,165,4,30,0,0
750,1215,141,1260,307,27,13,15,45,166,5,30,0,0
751,1213,141,1260,314,27,13,15,47,173,6,30,0,0
752,1212,143,1261,318,27,13,15,49,175,7,30,0,0
753,1211,142,1262,321,27,13,15,51,179,8,30,0,0
754,1211,142,1264,328,27,13,15,53,186,9,30,0,0
755,1209,142,1265,336,27,13,15,56,194,10,30,0,0
756,1206,141,1266,345,27,13,15,60,204,11,30,0,0
757,1205,143,1268,353,27,13,15,63,210,12,30,0,0
758,1206,142,1271,359,27,13,15,65,217,13,30,0,0
759,1205,148,1274,371,27,13,15,69,223,14,30,0,0
760,1204,150,1274,375,27,13,15,70,225,15,30,0,0
761,1201,153,1273,379,27,13,15,72,226,16,30,0,0
762,1202,165,1276,396,27,13,15,74,231,17,30,0,0
763,1205,169,1281,402,27,13,15,76,233,18,30,0,0
764,1209,175,1288,410,27,13,15,79,235,19,30,0,0
765,1208,179,1291,420,27,13,15,83,241,20,30,0,0
766,1205,184,1291,433,27,13,15,86,249,21,30,0,0
767,1209,190,1300,452,27,13,15,91,262,22,30,0,0
768,1222,191,1316,461,27,13,15,94,270,23,30,0,0
769,1236,193,1335,471,27,13,15,99,278,24,30,0,0
770,1245,193,1348,483,27,13,15,103,290,25,30,0,0
771,1259,196,1370,507,27,13,15,111,311,26,30,0,0
772,1283,206,1396,516,27,13,15,113,310,27,30,0,0
773,1320,212,1431,520,27,13,15,111,308,28,30,0,0
774,1344,233,1446,523,27,13,15,102,290,29,30,0,0
775,1354,238,1457,532,27,13,15,103,294,30,30,1,0
1061,1351,214,1442,520,28,13,15,91,306,0,28,0,1
1062,1328,216,1415,508,28,13,15,87,292,1,28,0,0
1063,1308,203,1399,506,28,13,15,91,303,2,28,0,0
1064,1277,202,1368,503,28,13,15,91,301,3,28,0,0
1065,1252,199,1339,486,28,13,15,87,287,4,28,0,0
1066,1232,193,1317,474,28,13,15,85,281,5,28,0,0
1067,1209,196,1293,469,28,13,15,84,273,6,28,0,0
1068,1196,191,1277,456,28,13,15,81,265,7,28,0,0
1069,1185,186,1265,450,28,13,15,80,264,8,28,0,0
1070,1183,183,1261,439,28,13,15,78,256,9,28,0,0
1071,1186,181,1260,426,28,13,15,74,245,10,28,0,0
1072,1189,180,1260,419,28,13,15,71,239,11,28,0,0
1073,1190,174,1259,408,28,13,15,69,234,12,28,0,0
1074,1191,171,1260,404,28,13,15,69,233,13,28,0,0
1075,1193,171,1261,402,28,13,15,68,231,14,28,0,0
1076,1199,162,1265,391,28,13,15,66,229,15,28,0,0
1077,1203,159,1269,387,28,13,15,66,228,16,28,0,0
1078,1204,158,1269,384,28,13,15,65,226,17,28,0,0
1079,1202,155,1264,374,28,13,15,62,219,18,28,0,0
1080,1202,155,1260,361,28,13,15,58,206,19,28,0,0
1081,1202,157,1257,349,28,13,15,55,192,20,28,0,0
1082,1201,150,1256,344,28,13,15,55,194,21,28,0,0
1083,1199,152,1252,340,28,13,15,53,188,22,28,0,0
1084,1194,148,1247,336,28,13,15,53,188,23,28,0,0
1085,1189,147,1239,327,28,13,15,50,180,24,28,0,0
1086,1186,148,1235,321,28,13,15,49,173,25,28,0,0
1087,1185,141,1236,323,28,13,15,51,182,26,28,0,0
1088,1186,138,1232,296,28,13,15,46,158,27,28,0,0
1089,1184,135,1228,288,28,13,15,44,153,28,28,1,0
1081,1361,280,1439,549,29,13,15,78,269,0,52,0,1
1082,1346,244,1431,535,29,13,15,85,291,1,52,0,0
1083,1327,235,1412,528,29,13,15,85,293,2,52,0,0
1084,1298,227,1386,522,29,13,15,88,295,3,52,0,0
1085,1266,220,1353,513,29,13,15,87,293,4,52,0,0
1086,1238,215,1324,499,29,13,15,86,284,5,52,0,0
1087,1209,213,1294,491,29,13,15,85,278,6,52,0,0
1088,1184,192,1273,483,29,13,15,89,291,7,52,0,0
1089,1160,152,1262,490,29,13,15,102,338,8,52,0,0
1090,1152,136,1250,467,29,13,15,98,331,9,52,0,0
1091,1146,129,1240,452,29,13,15,94,323,10,52,0,0
1092,1142,126,1235,450,29,13,15,93,324,11,52,0,0
1093,1141,156,1220,432,29,13,15,79,276,12,52,0,0
1094,1136,161,1215,436,29,13,15,79,275,13,52,0,0
1095,1147,152,1219,403,29,13,15,72,251,14,52,0,0
1096,1152,143,1224,396,29,13,15,72,253,15,52,0,0
1097,1144,136,1214,386,29,13,15,70,250,16,52,0,0
1098,1148,161,1212,390,29,13,15,64,229,17,52,0,0
1099,1150,163,1213,388,29,13,15,63,225,18,52,0,0
1100,1152,156,1215,385,29,13,15,63,229,19,52,0,0
1101,1153,152,1215,377,29,13,15,62,225,20,52,0,0
1102,1150,156,1210,372,29,13,15,60,216,21,52,0,0
1103,1149,158,1207,367,29,13,15,58,209,22,52,0,0
1104,1147,134,1211,365,29,13,15,64,231,23,52,0,0
1105,1148,128,1211,357,29,13,15,63,229,24,52,0,0
1106,1152,134,1210,348,29,13,15,58,214,25,52,0,0
1107,1152,146,1206,345,29,13,15,54,199,26,52,0,0
1108,1152,149,1204,339,29,13,15,52,190,27,52,0,0
1109,1152,151,1205,341,29,13,15,53,190,28,52,0,0
1110,1158,150,1210,333,29,13,15,52,183,29,52,0,0
1111,1164,152,1212,322,29,13,15,48,170,30,52,0,0
1112,1166,150,1215,319,29,13,15,49,169,31,52,0,0
1113,1165,148,1214,319,29,13,15,49,171,32,52,0,0
1114,1166,146,1216,316,29,13,15,50,170,33,52,0,0
1115,1172,143,1221,312,29,13,15,49,169,34,52,0,0
1116,1175,139,1224,309,29,13,15,49,170,35,52,0,0
1117,1176,136,1224,303,29,13,15,48,167,36,52,0,0
1118,1177,135,1225,299,29,13,15,48,164,37,52,0,0
1119,1180,135,1227,298,29,13,15,47,163,38,52,0,0
1120,1186,134,1233,294,29,13,15,47,160,39,52,0,0
1121,1190,134,1235,286,29,13,15,45,152,40,52,0,0
1122,1191,132,1235,283,29,13,15,44,151,41,52,0,0
1123,1191,132,1236,283,29,13,15,45,151,42,52,0,0
1124,1193,131,1238,284,29,13,15,45,153,43,52,0,0
1125,1196,128,1241,277,29,13,15,45,149,44,52,0,0
1126,1198,128,1242,272,29,13,15,44,144,45,52,0,0
1127,1196,126,1240,271,29,13,15,44,145,46,52,0,0
1128,1194,125,1238,270,29,13,15,44,145,47,52,0,0
1129,1192,126,1233,263,29,13,15,41,137,48,52,0,0
1130,1192,127,1231,255,29,13,15,39,128,49,52,0,0
1131,1190,127,1229,257,29,13,15,39,130,50,52,0,0
1132,1179,125,1216,250,29,13,15,37,125,51,52,0,0
1133,1178,124,1214,246,29,13,15,36,122,52,52,1,0
1085,1373,210,1428,511,30,13,15,55,301,0,13,0,0
1086,1354,213,1407,498,30,13,15,53,285,1,13,0,0
1087,1333,206,1387,496,30,13,15,54,290,2,13,0,0
1088,1311,201,1366,487,30,13,15,55,286,3,13,0,0
1089,1292,199,1347,480,30,13,15,55,281,4,13,0,0
1090,1276,193,1331,466,30,13,15,55,273,5,13,0,0
1091,1264,187,1320,457,30,13,15,56,270,6,13,0,0
1092,1257,185,1316,456,30,13,15,59,271,7,13,0,0
1093,1248,181,1306,443,30,13,15,58,262,8,13,0,0
1094,1243,179,1301,436,30,13,15,58,257,9,13,0,0
1095,1239,180,1297,430,30,13,15,58,250,10,13,0,0
1096,1235,174,1293,416,30,13,15,58,242,11,13,0,0
1097,1234,171,1293,416,30,13,15,59,245,12,13,0,0
1098,1226,168,1284,409,30,13,15,58,241,13,13,0,0
1093,1367,218,1434,502,31,13,15,67,284,0,49,0,1
1094,1338,211,1407,501,31,13,15,69,290,1,49,0,0
1095,1321,205,1390,492,31,13,15,69,287,2,49,0,0
1096,1300,199,1370,485,31,13,15,70,286,3,49,0,0
1097,1283,203,1354,487,31,13,15,71,284,4,49,0,0
1098,1259,194,1331,473,31,13,15,72,279,5,49,0,0
1099,1247,180,1320,458,31,13,15,73,278,6,49,0,0
1100,1236,176,1309,451,31,13,15,73,275,7,49,0,0
1101,1232,174,1304,437,31,13,15,72,263,8,49,0,0
1102,1229,163,1303,430,31,13,15,74,267,9,49,0,0
1103,1224,168,1297,428,31,13,15,73,260,10,49,0,0
1104,1219,171,1290,416,31,13,15,71,245,11,49,0,0
1105,1217,169,1287,410,31,13,15,70,241,12,49,0,0
1106,1220,163,1290,400,31,13,15,70,237,13,49,0,0
1107,1223,157,1295,395,31,13,15,72,238,14,49,0,0
1108,1224,156,1296,392,31,13,15,72,236,15,49,0,0
1109,1220,152,1292,386,31,13,15,72,234,16,49,0,0
1110,1218,152,1289,376,31,13,15,71,224,17,49,0,0
1111,1220,151,1290,372,31,13,15,70,221,18,49,0,0
1112,1224,148,1293,367,31,13,15,69,219,19,49,0,0
1113,1228,147,1295,356,31,13,15,67,209,20,49,0,0
1114,1226,150,1293,354,31,13,15,67,204,21,49,0,0
1115,1224,148,1290,348,31,13,15,66,200,22,49,0,0
1116,1225,145,1290,343,31,13,15,65,198,23,49,0,0
1117,1228,142,1292,337,31,13,15,64,195,24,49,0,0
1118,1232,141,1294,330,31,13,15,62,189,25,49,0,0
1119,1235,139,1296,325,31,13,15,61,186,26,49,0,0
1120,1238,139,1295,311,31,13,15,57,172,27,49,0,0
1121,1237,139,1294,311,31,13,15,57,172,28,49,0,0
1122,1243,138,1298,305,31,13,15,55,167,29,49,0,0
1123,1247,137,1302,300,31,13,15,55,163,30,49,0,0
1124,1251,134,1307,302,31,13,15,56,168,31,49,0,0
1125,1251,137,1305,297,31,13,15,54,160,32,49,0,0
1126,1251,137,1304,295,31,13,15,53,158,33,49,0,0
1127,1251,135,1304,292,31,13,15,53,157,34,49,0,0
1128,1252,134,1304,285,31,13,15,52,151,35,49,0,0
1129,1251,135,1304,287,31,13,15,53,152,36,49,0,0
1130,1250,136,1302,286,31,13,15,52,150,37,49,0,0
1131,1246,131,1300,288,31,13,15,54,157,38,49,0,0
1132,1246,136,1296,280,31,13,15,50,144,39,49,0,0
1133,1243,135,1291,272,31,13,15,48,137,40,49,0,0
1134,1242,133,1288,266,31,13,15,46,133,41,49,0,0
1135,1236,135,1286,277,31,13,15,50,142,42,49,0,0
1136,1226,132,1275,269,31,13,15,49,137,43,49,0,0
1137,1216,128,1264,261,31,13,15,48,133,44,49,0,0
1138,1208,127,1255,257,31,13,15,47,130,45,49,0,0
1139,1200,126,1248,255,31,13,15,48,129,46,49,0,0
1140,1194,126,1237,238,31,13,15,43,112,47,49,0,0
1141,1182,127,1224,235,31,13,15,42,108,48,49,0,0
1142,1177,126,1217,231,31,13,15,40,105,49,49,1,0
1093,1196,134,1241,247,32,13,15,45,113,0,9,0,0
1094,1183,138,1256,323,32,13,15,73,185,1,9,0,0
1095,1184,137,1250,304,32,13,15,66,167,2,9,0,0
1096,1186,135,1246,288,32,13,15,60,153,3,9,0,0
1097,1193,132,1241,257,32,13,15,48,125,4,9,0,0
1098,1188,131,1256,310,32,13,15,68,179,5,9,0,0
1099,1190,133,1254,303,32,13,15,64,170,6,9,0,0
1100,1189,130,1250,294,32,13,15,61,164,7,9,0,0
1101,1180,129,1251,327,32,13,15,71,198,8,9,0,0
1102,1178,128,1252,334,32,13,15,74,206,9,9,0,0
1130,1211,133,1253,253,32,13,15,42,120,0,9,0,0
1131,1213,129,1255,249,32,13,15,42,120,1,9,0,0
1132,1206,124,1251,251,32,13,15,45,127,2,9,0,0
1133,1195,121,1241,252,32,13,15,46,131,3,9,0,0
1134,1186,120,1231,252,32,13,15,45,132,4,9,0,0
1135,1173,120,1217,250,32,13,15,44,130,5,9,0,0
1136,1165,119,1209,249,32,13,15,44,130,6,9,0,0
1102,1192,129,1228,209,33,13,15,36,80,0,1,0,0
1103,1190,125,1228,210,33,13,15,38,85,1,1,0,0
1103,1263,155,1317,311,34,13,15,54,156,0,3,0,0
1104,1263,161,1312,302,34,13,15,49,141,1,3,0,0
1105,1261,153,1312,301,34,13,15,51,148,2,3,0,0
1106,1259,150,1311,300,34,13,15,52,150,3,3,0,0
1130,1308,277,1438,580,39,13,15,130,303,0,67,0,1
1131,1292,267,1418,560,39,13,15,126,293,1,67,0,0
1132,1279,257,1410,561,39,13,15,131,304,2,67,0,0
1133,1269,252,1398,553,39,13,15,129,301,3,67,0,0
1134,1253,247,1381,549,39,13,15,128,302,4,67,0,0
1135,1236,242,1354,522,39,13,15,118,280,5,67,0,0
1136,1212,232,1332,517,39,13,15,120,285,6,67,0,0
1137,1195,225,1314,513,39,13,15,119,288,7,67,0,0
1138,1174,185,1302,501,39,13,15,128,316,8,67,0,0
1139,1170,201,1283,487,39,13,15,113,286,9,67,0,0
1140,1167,203,1274,476,39,13,15,107,273,10,67,0,0
1141,1167,205,1265,460,39,13,15,98,255,11,67,0,0
1142,1164,201,1260,455,39,13,15,96,254,12,67,0,0
1143,1165,199,1254,439,39,13,15,89,240,13,67,0,0
1144,1169,196,1255,432,39,13,15,86,236,14,67,0,0
1145,1170,190,1257,433,39,13,15,87,243,15,67,0,0
1146,1178,189,1263,427,39,13,15,85,238,16,67,0,0
1147,1186,189,1266,415,39,13,15,80,226,17,67,0,0
1148,1190,189,1269,413,39,13,15,79,224,18,67,0,0
1149,1189,183,1266,407,39,13,15,77,224,19,67,0,0
1150,1190,179,1265,400,39,13,15,75,221,20,67,0,0
1151,1190,179,1262,394,39,13,15,72,215,21,67,0,0
1152,1190,176,1260,388,39,13,15,70,212,22,67,0,0
1153,1191,173,1258,373,39,13,15,67,200,23,67,0,0
1154,1192,173,1258,376,39,13,15,66,203,24,67,0,0
1155,1194,172,1258,369,39,13,15,64,197,25,67,0,0
1156,1194,170,1257,365,39,13,15,63,195,26,67,0,0
1157,1197,169,1260,362,39,13,15,63,193,27,67,0,0
1158,1201,167,1264,362,39,13,15,63,195,28,67,0,0
1159,1203,164,1265,357,39,13,15,62,193,29,67,0,0
1160,1204,162,1264,348,39,13,15,60,186,30,67,0,0
1161,1202,156,1262,340,39,13,15,60,184,31,67,0,0
1162,1203,154,1261,335,39,13,15,58,181,32,67,0,0
1163,1205,151,1263,335,39,13,15,58,184,33,67,0,0
1164,1207,147,1265,330,39,13,15,58,183,34,67,0,0
1165,1209,146,1266,327,39,13,15,57,181,35,67,0,0
1166,1210,145,1266,324,39,13,15,56,179,36,67,0,0
1167,1211,145,1265,319,39,13,15,54,174,37,67,0,0
1168,1214,145,1267,314,39,13,15,53,169,38,67,0,0
1169,1218,145,1269,310,39,13,15,51,165,39,67,0,0
1170,1223,144,1273,305,39,13,15,50,161,40,67,0,0
1171,1226,144,1275,300,39,13,15,49,156,41,67,0,0
1172,1227,143,1275,296,39,13,15,48,153,42,67,0,0
1173,1229,142,1276,294,39,13,15,47,152,43,67,0,0
1174,1231,141,1278,293,39,13,15,47,152,44,67,0,0
1175,1234,139,1281,292,39,13,15,47,153,45,67,0,0
1176,1236,139,1283,291,39,13,15,47,152,46,67,0,0
1177,1237,140,1282,283,39,13,15,45,143,47,67,0,0
1178,1236,141,1280,280,39,13,15,44,139,48,67,0,0
1179,1233,141,1277,279,39,13,15,44,138,49,67,0,0
1180,1232,139,1275,277,39,13,15,43,138,50,67,0,0
1181,1233,139,1275,275,39,13,15,42,136,51,67,0,0
1182,1234,136,1276,271,39,13,15,42,135,52,67,0,0
1183,1236,135,1278,269,39,13,15,42,134,53,67,0,0
1184,1235,133,1278,268,39,13,15,43,135,54,67,0,0
1185,1230,132,1273,267,39,13,15,43,135,55,67,0,0
1186,1225,132,1267,265,39,13,15,42,133,56,67,0,0
1187,1222,132,1263,258,39,13,15,41,126,57,67,0,0
1188,1217,131,1257,253,39,13,15,40,122,58,67,0,0
1189,1221,126,1263,254,39,13,15,42,128,59,67,0,0
1190,1213,122,1259,255,39,13,15,46,133,60,67,0,0
1191,1209,122,1256,256,39,13,15,47,134,61,67,0,0
1192,1205,121,1250,252,39,13,15,45,131,62,67,0,0
1193,1197,120,1240,245,39,13,15,43,125,63,67,0,0
1194,1189,119,1232,247,39,13,15,43,128,64,67,0,0
1195,1175,116,1218,245,39,13,15,43,129,65,67,0,0
1196,1168,115,1209,241,39,13,15,41,126,66,67,0,0
1197,1163,113,1203,238,39,13,15,40,125,67,67,1,0
1133,1371,218,1446,540,40,13,15,75,322,0,56,0,1
1134,1361,213,1436,533,40,13,15,75,320,1,56,0,0
1135,1347,212,1418,516,40,13,15,71,304,2,56,0,0
1136,1327,206,1401,516,40,13,15,74,310,3,56,0,0
1137,1312,203,1384,503,40,13,15,72,300,4,56,0,0
1138,1301,197,1372,486,40,13,15,71,289,5,56,0,0
1139,1293,196,1362,474,40,13,15,69,278,6,56,0,0
1140,1287,193,1357,469,40,13,15,70,276,7,56,0,0
1141,1277,190,1346,461,40,13,15,69,271,8,56,0,0
1142,1270,188,1340,458,40,13,15,70,270,9,56,0,0
1143,1262,183,1331,450,40,13,15,69,267,10,56,0,0
1144,1260,179,1327,434,40,13,15,67,255,11,56,0,0
1145,1262,178,1328,425,40,13,15,66,247,12,56,0,0
1146,1264,176,1330,418,40,13,15,66,242,13,56,0,0
1147,1266,175,1330,410,40,13,15,64,235,14,56,0,0
1148,1265,174,1330,409,40,13,15,65,235,15,56,0,0
1149,1263,169,1327,401,40,13,15,64,232,16,56,0,0
1150,1263,167,1325,389,40,13,15,62,222,17,56,0,0
1151,1265,166,1326,383,40,13,15,61,217,18,56,0,0
1152,1266,164,1327,379,40,13,15,61,215,19,56,0,0
1153,1267,162,1328,375,40,13,15,61,213,20,56,0,0
1154,1267,160,1328,374,40,13,15,61,214,21,56,0,0
1155,1267,156,1328,369,40,13,15,61,213,22,56,0,0
1156,1268,154,1328,365,40,13,15,60,211,23,56,0,0
1157,1270,151,1331,363,40,13,15,61,212,24,56,0,0
1158,1274,149,1334,357,40,13,15,60,208,25,56,0,0
1159,1276,151,1335,352,40,13,15,59,201,26,56,0,0
1160,1278,148,1334,344,40,13,15,56,196,27,56,0,0
1161,1279,150,1333,338,40,13,15,54,188,28,56,0,0
1162,1281,148,1334,333,40,13,15,53,185,29,56,0,0
1163,1286,146,1339,327,40,13,15,53,181,30,56,0,0
1164,1291,146,1342,324,40,13,15,51,178,31,56,0,0
1165,1293,147,1344,323,40,13,15,51,176,32,56,0,0
1166,1294,148,1344,318,40,13,15,50,170,33,56,0,0
1167,1294,146,1344,315,40,13,15,50,169,34,56,0,0
1168,1295,146,1346,314,40,13,15,51,168,35,56,0,0
1169,1299,145,1348,308,40,13,15,49,163,36,56,0,0
1170,1299,144,1348,304,40,13,15,49,160,37,56,0,0
1171,1300,143,1348,301,40,13,15,48,158,38,56,0,0
1172,1300,141,1347,296,40,13,15,47,155,39,56,0,0
1173,1299,139,1348,294,40,13,15,49,155,40,56,0,0
1174,1301,139,1348,289,40,13,15,47,150,41,56,0,0
1175,1302,137,1350,286,40,13,15,48,149,42,56,0,0
1176,1303,136,1351,284,40,13,15,48,148,43,56,0,0
1177,1301,134,1347,278,40,13,15,46,144,44,56,0,0
1178,1299,133,1345,278,40,13,15,46,145,45,56,0,0
1179,1296,132,1342,277,40,13,15,46,145,46,56,0,0
1180,1293,131,1337,273,40,13,15,44,142,47,56,0,0
1181,1290,129,1333,268,40,13,15,43,139,48,56,0,0
1182,1285,128,1328,266,40,13,15,43,138,49,56,0,0
1183,1279,127,1322,270,40,13,15,43,143,50,56,0,0
1184,1273,125,1317,269,40,13,15,44,144,51,56,0,0
1185,1268,124,1312,267,40,13,15,44,143,52,56,0,0
1186,1262,123,1305,262,40,13,15,43,139,53,56,0,0
1187,1257,121,1297,255,40,13,15,40,134,54,56,0,0
1188,1251,122,1290,252,40,13,15,39,130,55,56,0,0
1189,1247,121,1286,249,40,13,15,39,128,56,56,1,0
1535,1326,208,1434,586,42,13,15,108,378,0,3,0,0
1536,1318,210,1425,583,42,13,15,107,373,1,3,0,0
1537,1338,225,1419,507,42,13,15,81,282,2,3,0,0
1538,1346,232,1415,475,42,13,15,69,243,3,3,0,0
1537,1261,232,1381,581,43,13,15,120,349,0,44,0,1
1538,1240,228,1351,553,43,13,15,111,325,1,44,0,0
1539,1206,215,1317,538,43,13,15,111,323,2,44,0,0
1540,1183,211,1287,514,43,13,15,104,303,3,44,0,0
1541,1160,194,1262,492,43,13,15,102,298,4,44,0,0
1542,1142,196,1237,478,43,13,15,95,282,5,44,0,0
1543,1132,192,1224,466,43,13,15,92,274,6,44,0,0
1544,1123,184,1210,445,43,13,15,87,261,7,44,0,0
1545,1117,183,1199,432,43,13,15,82,249,8,44,0,0
1546,1110,173,1190,417,43,13,15,80,244,9,44,0,0
1547,1108,171,1184,408,43,13,15,76,237,10,44,0,0
1548,1111,174,1185,404,43,13,15,74,230,11,44,0,0
1549,1113,165,1185,391,43,13,15,72,226,12,44,0,0
1550,1111,168,1180,380,43,13,15,69,212,13,44,0,0
1551,1111,163,1179,370,43,13,15,68,207,14,44,0,0
1552,1116,160,1183,366,43,13,15,67,206,15,44,0,0
1553,1124,161,1187,357,43,13,15,63,196,16,44,0,0
1554,1132,158,1192,345,43,13,15,60,187,17,44,0,0
1555,1135,152,1195,342,43,13,15,60,190,18,44,0,0
1556,1138,149,1196,333,43,13,15,58,184,19,44,0,0
1557,1140,143,1200,332,43,13,15,60,189,20,44,0,0
1558,1146,146,1203,327,43,13,15,57,181,21,44,0,0
1559,1158,145,1212,319,43,13,15,54,174,22,44,0,0
1560,1165,143,1219,317,43,13,15,54,174,23,44,0,0
1561,1170,142,1222,313,43,13,15,52,171,24,44,0,0
1562,1173,138,1225,311,43,13,15,52,173,25,44,0,0
1563,1176,137,1229,311,43,13,15,53,174,26,44,0,0
1564,1179,137,1232,311,43,13,15,53,174,27,44,0,0
1565,1184,134,1236,306,43,13,15,52,172,28,44,0,0
1566,1184,134,1235,300,43,13,15,51,166,29,44,0,0
1567,1184,130,1236,299,43,13,15,52,169,30,44,0,0
1568,1187,131,1238,298,43,13,15,51,167,31,44,0,0
1569,1190,133,1239,295,43,13,15,49,162,32,44,0,0
1570,1192,128,1240,290,43,13,15,48,162,33,44,0,0
1571,1193,126,1241,287,43,13,15,48,161,34,44,0,0
1572,1192,124,1240,285,43,13,15,48,161,35,44,0,0
1573,1192,125,1237,277,43,13,15,45,152,36,44,0,0
1574,1190,126,1236,276,43,13,15,46,150,37,44,0,0
1575,1189,126,1233,275,43,13,15,44,149,38,44,0,0
1576,1191,123,1235,265,43,13,15,44,142,39,44,0,0
1577,1190,122,1233,259,43,13,15,43,137,40,44,0,0
1578,1180,121,1222,253,43,13,15,42,132,41,44,0,0
1579,1178,119,1221,251,43,13,15,43,132,42,44,0,0
1580,1174,120,1212,237,43,13,15,38,117,43,44,0,0
1581,1173,119,1209,232,43,13,15,36,113,44,44,1,0
1538,1308,205,1386,544,44,13,15,78,339,0,27,0,1
1539,1291,206,1356,486,44,13,15,65,280,1,27,0,0
1540,1275,191,1339,466,44,13,15,64,275,2,27,0,0
1541,1246,178,1322,504,44,13,15,76,326,3,27,0,0
1542,1238,176,1307,466,44,13,15,69,290,4,27,0,0
1543,1229,174,1295,447,44,13,15,66,273,5,27,0,0
1544,1222,168,1285,427,44,13,15,63,259,6,27,0,0
1545,1219,170,1279,410,44,13,15,60,240,7,27,0,0
1546,1218,165,1280,410,44,13,15,62,245,8,27,0,0
1547,1215,156,1279,404,44,13,15,64,248,9,27,0,0
1548,1214,157,1277,398,44,13,15,63,241,10,27,0,0
1549,1211,153,1273,391,44,13,15,62,238,11,27,0,0
1550,1211,152,1271,378,44,13,15,60,226,12,27,0,0
1551,1212,151,1275,390,44,13,15,63,239,13,27,0,0
1552,1217,148,1277,373,44,13,15,60,225,14,27,0,0
1553,1219,147,1277,360,44,13,15,58,213,15,27,0,0
1554,1220,146,1278,360,44,13,15,58,214,16,27,0,0
1555,1224,145,1281,353,44,13,15,57,208,17,27,0,0
1556,1228,145,1286,353,44,13,15,58,208,18,27,0,0
1557,1233,141,1290,345,44,13,15,57,204,19,27,0,0
1558,1237,143,1292,337,44,13,15,55,194,20,27,0,0
1559,1241,143,1294,335,44,13,15,53,192,21,27,0,0
1560,1242,142,1294,326,44,13,15,52,184,22,27,0,0
1561,1246,142,1294,311,44,13,15,48,169,23,27,0,0
1562,1257,137,1293,258,44,13,15,36,121,24,27,0,0
1563,1260,137,1296,252,44,13,15,36,115,25,27,0,0
1564,1255,137,1293,253,44,13,15,38,116,26,27,0,0
1565,1255,134,1292,245,44,13,15,37,111,27,27,1,0
1567,1254,133,1289,234,44,13,15,35,101,0,27,0,0
1568,1252,131,1289,231,44,13,15,37,100,1,27,0,0
1569,1253,130,1288,224,44,13,15,35,94,2,27,0,0
1556,1333,234,1438,550,45,13,15,105,316,0,65,0,1
1557,1329,227,1437,555,45,13,15,108,328,1,65,0,0
1558,1319,223,1427,549,45,13,15,108,326,2,65,0,0
1559,1305,226,1412,546,45,13,15,107,320,3,65,0,0
1560,1282,215,1386,526,45,13,15,104,311,4,65,0,0
1561,1266,211,1365,510,45,13,15,99,299,5,65,0,0
1562,1249,213,1346,504,45,13,15,97,291,6,65,0,0
1563,1232,172,1338,493,45,13,15,106,321,7,65,0,0
1564,1230,174,1330,476,45,13,15,100,302,8,65,0,0
1565,1220,151,1327,475,45,13,15,107,324,9,65,0,0
1566,1212,137,1320,463,45,13,15,108,326,10,65,0,0
1567,1207,134,1312,454,45,13,15,105,320,11,65,0,0
1568,1209,143,1307,443,45,13,15,98,300,12,65,0,0
1569,1209,132,1306,434,45,13,15,97,302,13,65,0,0
1570,1214,136,1304,423,45,13,15,90,287,14,65,0,0
1571,1216,130,1311,430,45,13,15,95,300,15,65,0,0
1572,1223,128,1316,421,45,13,15,93,293,16,65,0,0
1573,1230,138,1316,410,45,13,15,86,272,17,65,0,0
1574,1235,149,1315,404,45,13,15,80,255,18,65,0,0
1575,1244,163,1318,398,45,13,15,74,235,19,65,0,0
1576,1254,164,1324,389,45,13,15,70,225,20,65,0,0
1577,1261,165,1331,386,45,13,15,70,221,21,65,0,0
1578,1272,165,1340,378,45,13,15,68,213,22,65,0,0
1579,1286,166,1353,373,45,13,15,67,207,23,65,0,0
1580,1294,164,1359,368,45,13,15,65,204,24,65,0,0
1581,1301,164,1364,359,45,13,15,63,195,25,65,0,0
1582,1307,162,1369,353,45,13,15,62,191,26,65,0,0
1583,1313,161,1375,349,45,13,15,62,188,27,65,0,0
1584,1319,163,1379,345,45,13,15,60,182,28,65,0,0
1585,1322,161,1382,344,45,13,15,60,183,29,65,0,0
1586,1323,154,1386,346,45,13,15,63,192,30,65,0,0
1587,1325,152,1386,339,45,13,15,61,187,31,65,0,0
1588,1324,148,1386,336,45,13,15,62,188,32,65,0,0
1589,1323,149,1384,334,45,13,15,61,185,33,65,0,0
1590,1322,149,1381,328,45,13,15,59,179,34,65,0,0
1591,1322,146,1381,323,45,13,15,59,177,35,65,0,0
1592,1323,147,1380,319,45,13,15,57,172,36,65,0,0
1593,1320,146,1374,308,45,13,15,54,162,37,65,0,0
1594,1319,145,1372,306,45,13,15,53,161,38,65,0,0
1595,1317,144,1371,307,45,13,15,54,163,39,65,0,0
1596,1316,142,1368,300,45,13,15,52,158,40,65,0,0
1597,1315,139,1366,291,45,13,15,51,152,41,65,0,0
1598,1315,138,1365,288,45,13,15,50,150,42,65,0,0
1599,1314,134,1364,287,45,13,15,50,153,43,65,0,0
1600,1313,134,1362,287,45,13,15,49,153,44,65,0,0
1601,1310,132,1360,289,45,13,15,50,157,45,65,0,0
1602,1309,132,1357,285,45,13,15,48,153,46,65,0,0
1603,1310,133,1356,277,45,13,15,46,144,47,65,0,0
1604,1307,131,1353,277,45,13,15,46,146,48,65,0,0
1605,1304,130,1349,271,45,13,15,45,141,49,65,0,0
1606,1300,130,1343,267,45,13,15,43,137,50,65,0,0
1607,1295,131,1337,261,45,13,15,42,130,51,65,0,0
1608,1292,130,1332,256,45,13,15,40,126,52,65,0,0
1609,1287,127,1328,254,45,13,15,41,127,53,65,0,0
1610,1281,126,1321,253,45,13,15,40,127,54,65,0,0
1611,1274,126,1315,252,45,13,15,41,126,55,65,0,0
1612,1264,124,1305,251,45,13,15,41,127,56,65,0,0
1613,1255,125,1297,252,45,13,15,42,127,57,65,0,0
1614,1246,124,1287,250,45,13,15,41,126,58,65,0,0
1615,1236,122,1276,246,45,13,15,40,124,59,65,0,0
1616,1225,122,1264,239,45,13,15,39,117,60,65,0,0
1617,1215,121,1255,240,45,13,15,40,119,61,65,0,0
1618,1201,118,1242,239,45,13,15,41,121,62,65,0,0
1619,1189,118,1229,237,45,13,15,40,119,63,65,0,0
1620,1178,117,1217,235,45,13,15,39,118,64,65,0,0
1621,1169,116,1208,233,45,13,15,39,117,65,65,1,0
1722,1396,363,1433,447,46,13,15,37,84,0,0,0,0
1723,1312,344,1418,823,47,13,15,106,479,0,13,0,0
1724,1259,372,1365,838,47,13,15,106,466,1,13,0,0
1725,1226,379,1335,852,47,13,15,109,473,2,13,0,0
1726,1144,383,1266,885,47,13,15,122,502,3,13,0,0
1727,1087,407,1221,934,47,13,15,134,527,4,13,0,0
1728,1041,413,1182,947,47,13,15,141,534,5,13,0,0
1729,995,443,1157,1035,47,13,15,162,592,6,13,0,0
1730,957,475,1126,1068,47,13,15,169,593,7,13,0,0
1731,930,496,1104,1078,47,13,15,174,582,8,13,0,0
1732,905,538,1079,1080,47,13,15,174,542,9,13,0,0
1733,869,581,1046,1080,47,13,15,177,499,10,13,0,0
1734,863,621,1047,1074,47,13,15,184,453,11,13,0,0
1735,914,681,1109,1079,47,13,15,195,398,12,13,0,0
1736,898,712,1087,1080,47,13,15,189,368,13,13,0,0
1964,1376,198,1444,522,50,13,15,68,324,0,47,0,1
1965,1348,199,1416,522,50,13,15,68,323,1,47,0,0
1966,1325,205,1392,512,50,13,15,67,307,2,47,0,0
1967,1306,192,1374,499,50,13,15,68,307,3,47,0,0
1968,1289,187,1358,492,50,13,15,69,305,4,47,0,0
1969,1272,186,1338,476,50,13,15,66,290,5,47,0,0
1970,1254,181,1323,467,50,13,15,69,286,6,47,0,0
1971,1248,180,1316,454,50,13,15,68,274,7,47,0,0
1972,1240,176,1309,449,50,13,15,69,273,8,47,0,0
1973,1233,178,1303,444,50,13,15,70,266,9,47,0,0
1974,1222,179,1293,444,50,13,15,71,265,10,47,0,0
1975,1220,183,1294,455,50,13,15,74,272,11,47,0,0
1976,1229,184,1304,461,50,13,15,75,277,12,47,0,0
1977,1242,184,1322,466,50,13,15,80,282,13,47,0,0
1978,1261,189,1344,476,50,13,15,83,287,14,47,0,0
1979,1282,190,1368,485,50,13,15,86,295,15,47,0,0
1980,1297,198,1386,499,50,13,15,89,301,16,47,0,0
1981,1303,200,1397,514,50,13,15,94,314,17,47,0,0
1982,1307,205,1407,539,50,13,15,100,334,18,47,0,0
1983,1312,217,1415,555,50,13,15,103,338,19,47,0,0
1984,1311,222,1419,571,50,13,15,108,349,20,47,0,0
1985,1299,234,1412,594,50,13,15,113,360,21,47,0,0
1986,1281,239,1400,614,50,13,15,119,375,22,47,0,0
1987,1252,241,1380,643,50,13,15,128,402,23,47,0,0
1988,1223,248,1359,673,50,13,15,136,425,24,47,0,0
1989,1199,249,1339,685,50,13,15,140,436,25,47,0,0
1990,1154,258,1304,713,50,13,15,150,455,26,47,0,0
1991,1120,266,1275,734,50,13,15,155,468,27,47,0,0
1992,1072,272,1240,773,50,13,15,168,501,28,47,0,0
1993,1026,289,1208,813,50,13,15,182,524,29,47,0,0
1994,999,295,1186,835,50,13,15,187,540,30,47,0,0
1995,952,314,1155,895,50,13,15,203,581,31,47,0,0
1996,914,335,1123,932,50,13,15,209,597,32,47,0,0
1997,868,353,1091,977,50,13,15,223,624,33,47,0,0
1998,828,380,1070,1047,50,13,15,242,667,34,47,0,0
1999,828,405,1073,1073,50,13,15,245,668,35,47,0,0
2000,836,440,1077,1080,50,13,15,241,640,36,47,0,0
2001,851,484,1087,1080,50,13,15,236,596,37,47,0,0
2002,862,514,1099,1080,50,13,15,237,566,38,47,0,0
2003,954,557,1198,1080,50,13,15,244,523,39,47,0,0
2004,1052,601,1302,1078,50,13,15,250,477,40,47,0,0
2005,1074,663,1304,1080,50,13,15,230,417,41,47,0,0
2006,1127,722,1336,1080,50,13,15,209,358,42,47,0,0
2007,1217,779,1407,1078,50,13,15,190,299,43,47,0,0
2008,1289,819,1473,1080,50,13,15,184,261,44,47,0,0
2009,1347,854,1518,1074,50,13,15,171,220,45,47,0,0
2010,1390,866,1561,1075,50,13,15,171,209,46,47,0,0
2011,1442,898,1591,1080,50,13,15,149,182,47,47,1,0
2016,1362,206,1435,511,51,13,15,73,305,0,40,0,1
2017,1323,203,1397,506,51,13,15,74,303,1,40,0,0
2018,1297,198,1372,501,51,13,15,75,303,2,40,0,0
2019,1267,194,1341,490,51,13,15,74,296,3,40,0,0
2020,1238,190,1313,481,51,13,15,75,291,4,40,0,0
2021,1213,181,1289,470,51,13,15,76,289,5,40,0,0
2022,1207,182,1284,464,51,13,15,77,282,6,40,0,0
2023,1190,177,1263,443,51,13,15,73,266,7,40,0,0
2024,1176,173,1249,431,51,13,15,73,258,8,40,0,0
2025,1164,172,1237,430,51,13,15,73,258,9,40,0,0
2026,1159,166,1231,414,51,13,15,72,248,10,40,0,0
2027,1159,166,1233,412,51,13,15,74,246,11,40,0,0
2028,1157,159,1230,397,51,13,15,73,238,12,40,0,0
2029,1155,156,1228,394,51,13,15,73,238,13,40,0,0
2030,1154,156,1226,388,51,13,15,72,232,14,40,0,0
2031,1157,152,1228,379,51,13,15,71,227,15,40,0,0
2032,1161,151,1230,372,51,13,15,69,221,16,40,0,0
2033,1166,145,1233,358,51,13,15,67,213,17,40,0,0
2034,1170,142,1237,354,51,13,15,67,212,18,40,0,0
2035,1173,144,1238,349,51,13,15,65,205,19,40,0,0
2036,1178,141,1241,340,51,13,15,63,199,20,40,0,0
2037,1184,141,1245,334,51,13,15,61,193,21,40,0,0
2038,1188,138,1248,328,51,13,15,60,190,22,40,0,0
2039,1192,137,1249,322,51,13,15,57,185,23,40,0,0
2040,1192,137,1249,319,51,13,15,57,182,24,40,0,0
2041,1193,136,1248,315,51,13,15,55,179,25,40,0,0
2042,1196,137,1250,309,51,13,15,54,172,26,40,0,0
2043,1198,133,1250,301,51,13,15,52,168,27,40,0,0
2044,1198,132,1250,298,51,13,15,52,166,28,40,0,0
2045,1197,131,1248,296,51,13,15,51,165,29,40,0,0
2046,1196,127,1247,292,51,13,15,51,165,30,40,0,0
2047,1197,127,1247,287,51,13,15,50,160,31,40,0,0
2048,1199,126,1248,285,51,13,15,49,159,32,40,0,0
2049,1200,124,1248,280,51,13,15,48,156,33,40,0,0
2050,1199,123,1247,279,51,13,15,48,156,34,40,0,0
2051,1197,121,1244,272,51,13,15,47,151,35,40,0,0
2052,1195,121,1241,267,51,13,15,46,146,36,40,0,0
2053,1193,121,1239,268,51,13,15,46,147,37,40,0,0
2054,1189,120,1235,264,51,13,15,46,144,38,40,0,0
2055,1186,119,1229,256,51,13,15,43,137,39,40,0,0
2056,1181,117,1217,230,51,13,15,36,113,40,40,1,0
2047,1364,354,1430,586,52,13,15,66,232,0,68,0,1
2048,1337,269,1426,581,52,13,15,89,312,1,68,0,0
2049,1324,252,1418,577,52,13,15,94,325,2,68,0,0
2050,1289,246,1385,572,52,13,15,96,326,3,68,0,0
2051,1271,245,1368,562,52,13,15,97,317,4,68,0,0
2052,1241,236,1336,547,52,13,15,95,311,5,68,0,0
2053,1217,234,1312,543,52,13,15,95,309,6,68,0,0
2054,1192,228,1287,536,52,13,15,95,308,7,68,0,0
2055,1175,226,1267,516,52,13,15,92,290,8,68,0,0
2056,1157,214,1251,507,52,13,15,94,293,9,68,0,0
2057,1142,207,1237,498,52,13,15,95,291,10,68,0,0
2058,1129,201,1220,480,52,13,15,91,279,11,68,0,0
2059,1120,200,1209,472,52,13,15,89,272,12,68,0,0
2060,1118,198,1206,465,52,13,15,88,267,13,68,0,0
2061,1117,195,1203,458,52,13,15,86,263,14,68,0,0
2062,1113,195,1196,449,52,13,15,83,254,15,68,0,0
2063,1108,193,1189,437,52,13,15,81,244,16,68,0,0
2064,1103,188,1182,426,52,13,15,79,238,17,68,0,0
2065,1102,188,1182,425,52,13,15,80,237,18,68,0,0
2066,1106,185,1185,417,52,13,15,79,232,19,68,0,0
2067,1111,180,1188,405,52,13,15,77,225,20,68,0,0
2068,1114,178,1190,400,52,13,15,76,222,21,68,0,0
2069,1114,175,1189,394,52,13,15,75,219,22,68,0,0
2070,1113,171,1187,387,52,13,15,74,216,23,68,0,0
2071,1115,171,1188,387,52,13,15,73,216,24,68,0,0
2072,1122,170,1193,381,52,13,15,71,211,25,68,0,0
2073,1130,170,1198,370,52,13,15,68,200,26,68,0,0
2074,1134,170,1202,369,52,13,15,68,199,27,68,0,0
2075,1136,169,1201,359,52,13,15,65,190,28,68,0,0
2076,1136,165,1201,354,52,13,15,65,189,29,68,0,0
2077,1137,165,1201,353,52,13,15,64,188,30,68,0,0
2078,1142,165,1205,349,52,13,15,63,184,31,68,0,0
2079,1146,160,1208,341,52,13,15,62,181,32,68,0,0
2080,1147,157,1211,341,52,13,15,64,184,33,68,0,0
2081,1147,155,1210,335,52,13,15,63,180,34,68,0,0
2082,1147,150,1208,328,52,13,15,61,178,35,68,0,0
2083,1148,149,1208,323,52,13,15,60,174,36,68,0,0
2084,1153,150,1210,315,52,13,15,57,165,37,68,0,0
2085,1156,150,1212,311,52,13,15,56,161,38,68,0,0
2086,1157,149,1213,313,52,13,15,56,164,39,68,0,0
2087,1155,147,1211,313,52,13,15,56,166,40,68,0,0
2088,1152,146,1208,309,52,13,15,56,163,41,68,0,0
2089,1151,145,1207,306,52,13,15,56,161,42,68,0,0
2090,1154,146,1210,305,52,13,15,56,159,43,68,0,0
2091,1160,146,1214,300,52,13,15,54,154,44,68,0,0
2092,1164,145,1218,300,52,13,15,54,155,45,68,0,0
2093,1167,144,1221,301,52,13,15,54,157,46,68,0,0
2094,1169,146,1220,296,52,13,15,51,150,47,68,0,0
2095,1170,145,1220,290,52,13,15,50,145,48,68,0,0
2096,1170,145,1219,286,52,13,15,49,141,49,68,0,0
2097,1172,144,1222,285,52,13,15,50,141,50,68,0,0
2098,1178,139,1228,282,52,13,15,50,143,51,68,0,0
2099,1181,138,1234,287,52,13,15,53,149,52,68,0,0
2100,1184,136,1237,285,52,13,15,53,149,53,68,0,0
2101,1186,135,1238,285,52,13,15,52,150,54,68,0,0
2102,1186,135,1237,282,52,13,15,51,147,55,68,0,0
2103,1187,135,1235,276,52,13,15,48,141,56,68,0,0
2104,1186,134,1235,276,52,13,15,49,142,57,68,0,0
2105,1188,135,1236,276,52,13,15,48,141,58,68,0,0
2106,1194,134,1239,267,52,13,15,45,133,59,68,0,0
2107,1196,134,1241,264,52,13,15,45,130,60,68,0,0
2108,1196,134,1241,265,52,13,15,45,131,61,68,0,0
2109,1191,133,1238,268,52,13,15,47,135,62,68,0,0
2110,1189,131,1234,265,52,13,15,45,134,63,68,0,0
2111,1184,129,1230,263,52,13,15,46,134,64,68,0,0
2112,1183,130,1227,262,52,13,15,44,132,65,68,0,0
2113,1180,128,1223,255,52,13,15,43,127,66,68,0,0
2114,1176,129,1217,252,52,13,15,41,123,67,68,0,0
2115,1173,131,1211,244,52,13,15,38,113,68,68,1,0
2051,1342,200,1444,554,53,13,15,102,354,0,69,0,1
2052,1342,214,1433,529,53,13,15,91,315,1,69,0,0
2053,1325,215,1414,520,53,13,15,89,305,2,69,0,0
2054,1309,214,1397,516,53,13,15,88,302,3,69,0,0
2055,1295,208,1381,500,53,13,15,86,292,4,69,0,0
2056,1280,202,1364,488,53,13,15,84,286,5,69,0,0
2057,1270,203,1353,485,53,13,15,83,282,6,69,0,0
2058,1257,199,1338,472,53,13,15,81,273,7,69,0,0
2059,1246,197,1327,467,53,13,15,81,270,8,69,0,0
2060,1242,194,1322,463,53,13,15,80,269,9,69,0,0
2061,1239,191,1319,460,53,13,15,80,269,10,69,0,0
2062,1236,185,1315,453,53,13,15,79,268,11,69,0,0
2063,1231,183,1308,442,53,13,15,77,259,12,69,0,0
2064,1228,183,1303,438,53,13,15,75,255,13,69,0,0
2065,1227,180,1303,434,53,13,15,76,254,14,69,0,0
2066,1225,177,1301,429,53,13,15,76,252,15,69,0,0
2067,1223,177,1298,427,53,13,15,75,250,16,69,0,0
2068,1217,174,1290,418,53,13,15,73,244,17,69,0,0
2069,1214,172,1285,407,53,13,15,71,235,18,69,0,0
2070,1209,172,1279,402,53,13,15,70,230,19,69,0,0
2071,1205,168,1278,401,53,13,15,73,233,20,69,0,0
2072,1204,166,1274,390,53,13,15,70,224,21,69,0,0
2073,1204,168,1272,386,53,13,15,68,218,22,69,0,0
2074,1200,160,1271,390,53,13,15,71,230,23,69,0,0
2075,1201,153,1270,377,53,13,15,69,224,24,69,0,0
2076,1202,156,1269,373,53,13,15,67,217,25,69,0,0
2077,1204,152,1271,366,53,13,15,67,214,26,69,0,0
2078,1208,151,1271,354,53,13,15,63,203,27,69,0,0
2079,1207,151,1269,353,53,13,15,62,202,28,69,0,0
2080,1208,147,1269,347,53,13,15,61,200,29,69,0,0
2081,1209,145,1270,343,53,13,15,61,198,30,69,0,0
2082,1210,144,1270,340,53,13,15,60,196,31,69,0,0
2083,1211,146,1269,337,53,13,15,58,191,32,69,0,0
2084,1211,148,1268,335,53,13,15,57,187,33,69,0,0
2085,1210,149,1266,330,53,13,15,56,181,34,69,0,0
2086,1211,147,1267,332,53,13,15,56,185,35,69,0,0
2087,1211,145,1267,331,53,13,15,56,186,36,69,0,0
2088,1212,145,1267,328,53,13,15,55,183,37,69,0,0
2089,1212,147,1264,321,53,13,15,52,174,38,69,0,0
2090,1211,142,1264,322,53,13,15,53,180,39,69,0,0
2091,1211,141,1264,320,53,13,15,53,179,40,69,0,0
2092,1211,140,1263,318,53,13,15,52,178,41,69,0,0
2093,1212,139,1264,317,53,13,15,52,178,42,69,0,0
2094,1213,139,1262,310,53,13,15,49,171,43,69,0,0
2095,1213,138,1262,306,53,13,15,49,168,44,69,0,0
2096,1214,137,1263,305,53,13,15,49,168,45,69,0,0
2097,1218,138,1266,301,53,13,15,48,163,46,69,0,0
2098,1223,137,1271,298,53,13,15,48,161,47,69,0,0
2099,1229,135,1278,299,53,13,15,49,164,48,69,0,0
2100,1234,133,1282,295,53,13,15,48,162,49,69,0,0
2101,1239,132,1286,293,53,13,15,47,161,50,69,0,0
2102,1245,131,1292,290,53,13,15,47,159,51,69,0,0
2103,1251,131,1297,287,53,13,15,46,156,52,69,0,0
2104,1255,130,1302,288,53,13,15,47,158,53,69,0,0
2105,1258,130,1305,284,53,13,15,47,154,54,69,0,0
2106,1260,131,1306,282,53,13,15,46,151,55,69,0,0
2107,1260,131,1305,277,53,13,15,45,146,56,69,0,0
2108,1258,129,1302,273,53,13,15,44,144,57,69,0,0
2109,1254,129,1299,273,53,13,15,45,144,58,69,0,0
2110,1252,126,1297,271,53,13,15,45,145,59,69,0,0
2111,1249,125,1292,268,53,13,15,43,143,60,69,0,0
2112,1244,128,1286,267,53,13,15,42,139,61,69,0,0
2113,1237,127,1278,260,53,13,15,41,133,62,69,0,0
2114,1229,125,1268,252,53,13,15,39,127,63,69,0,0
2115,1219,126,1256,246,53,13,15,37,120,64,69,0,0
2116,1204,122,1243,247,53,13,15,39,125,65,69,0,0
2117,1200,121,1238,243,53,13,15,38,122,66,69,0,0
2118,1184,121,1224,246,53,13,15,40,125,67,69,0,0
2119,1172,120,1211,247,53,13,15,39,127,68,69,0,0
2120,1165,119,1204,245,53,13,15,39,126,69,69,1,0
2074,1356,386,1443,774,54,13,15,87,388,0,0,0,0
2075,1195,338,1431,867,55,13,15,236,529,0,18,0,0
2076,1174,346,1418,893,55,13,15,244,547,1,18,0,0
2077,1147,343,1410,940,55,13,15,263,597,2,18,0,0
2078,1098,377,1372,999,55,13,15,274,622,3,18,0,0
2079,1056,394,1333,1027,55,13,15,277,633,4,18,0,0
2080,1011,418,1293,1064,55,13,15,282,646,5,18,0,0
2081,978,452,1252,1078,55,13,15,274,626,6,18,0,0
2082,949,478,1216,1080,55,13,15,267,602,7,18,0,0
2083,953,520,1209,1080,55,13,15,256,560,8,18,0,0
2084,990,563,1239,1080,55,13,15,249,517,9,18,0,0
2085,1018,614,1260,1078,55,13,15,242,464,10,18,0,0
2086,1034,694,1247,1076,55,13,15,213,382,11,18,0,0
2087,1043,749,1243,1075,55,13,15,200,326,12,18,0,0
2088,1082,797,1272,1071,55,13,15,190,274,13,18,0,0
2089,1143,822,1340,1074,55,13,15,197,252,14,18,0,0
2090,1228,825,1444,1076,55,13,15,216,251,15,18,0,0
2091,1296,820,1528,1075,55,13,15,232,255,16,18,0,0
2092,1346,814,1584,1068,55,13,15,238,254,17,18,0,0
2093,1399,831,1623,1070,55,13,15,224,239,18,18,0,0
2280,1077,794,1307,1072,58,13,15,230,278,0,59,0,1
2281,945,721,1236,1072,58,13,15,291,351,1,59,0,0
2282,862,687,1180,1070,58,13,15,318,383,2,59,0,0
2283,759,639,1119,1072,58,13,15,360,433,3,59,0,0
2284,687,572,1098,1068,58,13,15,411,496,4,59,0,0
2285,647,535,1086,1071,58,13,15,439,536,5,59,0,0
2286,643,488,1109,1069,58,13,15,466,581,6,59,0,0
2287,649,446,1120,1049,58,13,15,471,603,7,59,0,0
2288,676,415,1127,1009,58,13,15,451,594,8,59,0,0
2289,726,379,1123,917,58,13,15,397,538,9,59,0,0
2290,754,359,1126,883,58,13,15,372,524,10,59,0,0
2291,805,337,1139,822,58,13,15,334,485,11,59,0,0
2292,855,311,1164,772,58,13,15,309,461,12,59,0,0
2293,891,303,1182,749,58,13,15,291,446,13,59,0,0
2294,928,283,1186,689,58,13,15,258,406,14,59,0,0
2295,949,276,1189,671,58,13,15,240,395,15,59,0,0
2296,981,267,1195,632,58,13,15,214,365,16,59,0,0
2297,1011,248,1214,602,58,13,15,203,354,17,59,0,0
2298,1028,242,1219,586,58,13,15,191,344,18,59,0,0
2299,1047,231,1221,549,58,13,15,174,318,19,59,0,0
2300,1055,226,1217,532,58,13,15,162,306,20,59,0,0
2301,1063,221,1218,519,58,13,15,155,298,21,59,0,0
2302,1078,209,1224,493,58,13,15,146,284,22,59,0,0
2303,1086,208,1226,484,58,13,15,140,276,23,59,0,0
2304,1094,202,1222,458,58,13,15,128,256,24,59,0,0
2305,1096,197,1220,451,58,13,15,124,254,25,59,0,0
2306,1103,193,1224,445,58,13,15,121,252,26,59,0,0
2307,1118,184,1230,419,58,13,15,112,235,27,59,0,0
2308,1132,186,1237,407,58,13,15,105,221,28,59,0,0
2309,1137,180,1242,403,58,13,15,105,223,29,59,0,0
2310,1140,176,1239,394,58,13,15,99,218,30,59,0,0
2311,1149,175,1243,388,58,13,15,94,213,31,59,0,0
2312,1160,171,1252,378,58,13,15,92,207,32,59,0,0
2313,1166,171,1253,369,58,13,15,87,198,33,59,0,0
2314,1169,170,1253,362,58,13,15,84,192,34,59,0,0
2315,1167,164,1247,350,58,13,15,80,186,35,59,0,0
2316,1172,166,1247,346,58,13,15,75,180,36,59,0,0
2317,1179,160,1252,337,58,13,15,73,177,37,59,0,0
2318,1181,158,1254,333,58,13,15,73,175,38,59,0,0
2319,1182,153,1254,328,58,13,15,72,175,39,59,0,0
2320,1181,145,1251,321,58,13,15,70,176,40,59,0,0
2321,1182,146,1249,316,58,13,15,67,170,41,59,0,0
2322,1187,143,1251,308,58,13,15,64,165,42,59,0,0
2323,1191,144,1252,302,58,13,15,61,158,43,59,0,0
2324,1192,143,1251,298,58,13,15,59,155,44,59,0,0
2325,1192,140,1251,294,58,13,15,59,154,45,59,0,0
2326,1194,141,1251,291,58,13,15,57,150,46,59,0,0
2327,1199,139,1255,286,58,13,15,56,147,47,59,0,0
2328,1203,138,1255,278,58,13,15,52,140,48,59,0,0
2329,1203,137,1254,275,58,13,15,51,138,49,59,0,0
2330,1203,133,1254,274,58,13,15,51,141,50,59,0,0
2331,1202,135,1251,271,58,13,15,49,136,51,59,0,0
2332,1200,134,1246,261,58,13,15,46,127,52,59,0,0
2333,1194,133,1242,263,58,13,15,48,130,53,59,0,0
2334,1189,131,1234,258,58,13,15,45,127,54,59,0,0
2335,1184,129,1229,256,58,13,15,45,127,55,59,0,0
2336,1181,129,1225,253,58,13,15,44,124,56,59,0,0
2337,1176,125,1221,251,58,13,15,45,126,57,59,0,0
2338,1172,129,1212,245,58,13,15,40,116,58,59,0,0
2339,1170,128,1209,241,58,13,15,39,113,59,59,1,0
2342,1172,122,1219,258,58,13,15,47,136,0,59,0,1
2343,1178,121,1226,261,58,13,15,48,140,1,59,0,0
2344,1188,122,1235,262,58,13,15,47,140,2,59,0,0
2345,1195,124,1243,265,58,13,15,48,141,3,59,0,0
2346,1202,125,1251,267,58,13,15,49,142,4,59,0,0
2347,1210,126,1260,269,58,13,15,50,143,5,59,0,0
2348,1215,128,1265,271,58,13,15,50,143,6,59,0,0
2349,1219,131,1269,273,58,13,15,50,142,7,59,0,0
2350,1221,134,1272,280,58,13,15,51,146,8,59,0,0
2351,1225,134,1278,284,58,13,15,53,150,9,59,0,0
2352,1228,131,1284,289,58,13,15,56,158,10,59,0,0
2353,1231,130,1288,292,58,13,15,57,162,11,59,0,0
2354,1231,132,1288,295,58,13,15,57,163,12,59,0,0
2355,1232,132,1290,299,58,13,15,58,167,13,59,0,0
2356,1232,132,1291,304,58,13,15,59,172,14,59,0,0
2357,1233,136,1292,303,58,13,15,59,167,15,59,0,0
2358,1233,138,1291,304,58,13,15,58,166,16,59,0,0
2359,1230,141,1289,309,58,13,15,59,168,17,59,0,0
2360,1225,141,1286,315,58,13,15,61,174,18,59,0,0
2361,1222,143,1283,320,58,13,15,61,177,19,59,0,0
2362,1220,143,1283,323,58,13,15,63,180,20,59,0,0
2363,1218,143,1282,326,58,13,15,64,183,21,59,0,0
2364,1214,142,1281,333,58,13,15,67,191,22,59,0,0
2365,1213,143,1279,333,58,13,15,66,190,23,59,0,0
2366,1209,146,1276,336,58,13,15,67,190,24,59,0,0
2367,1204,144,1275,345,58,13,15,71,201,25,59,0,0
2368,1201,147,1275,358,58,13,15,74,211,26,59,0,0
2369,1199,146,1273,361,58,13,15,74,215,27,59,0,0
2370,1197,148,1273,364,58,13,15,76,216,28,59,0,0
2371,1196,154,1271,370,58,13,15,75,216,29,59,0,0
2372,1192,155,1268,370,58,13,15,76,215,30,59,0,0
2373,1189,160,1266,379,58,13,15,77,219,31,59,0,0
2374,1191,163,1267,384,58,13,15,76,221,32,59,0,0
2375,1192,163,1271,390,58,13,15,79,227,33,59,0,0
2376,1196,165,1278,399,58,13,15,82,234,34,59,0,0
2377,1195,169,1279,410,58,13,15,84,241,35,59,0,0
2378,1197,171,1280,407,58,13,15,83,236,36,59,0,0
2379,1200,178,1282,418,58,13,15,82,240,37,59,0,0
2380,1205,177,1292,431,58,13,15,87,254,38,59,0,0
2381,1218,179,1306,435,58,13,15,88,256,39,59,0,0
2382,1230,182,1321,444,58,13,15,91,262,40,59,0,0
2383,1236,185,1330,456,58,13,15,94,271,41,59,0,0
2384,1249,189,1343,463,58,13,15,94,274,42,59,0,0
2385,1260,197,1356,479,58,13,15,96,282,43,59,0,0
2386,1275,197,1373,484,58,13,15,98,287,44,59,0,0
2387,1302,199,1400,490,58,13,15,98,291,45,59,0,0
2388,1319,204,1419,502,58,13,15,100,298,46,59,0,0
2389,1347,206,1443,501,58,13,15,96,295,47,59,0,0
2390,1364,242,1449,507,58,13,15,85,265,48,59,0,0
2391,1375,248,1460,514,58,13,15,85,266,49,59,0,0
2341,1173,119,1211,256,59,13,15,38,137,0,0,0,0
2460,1222,124,1259,272,61,13,15,37,148,0,39,0,1
2461,1228,127,1265,272,61,13,15,37,145,1,39,0,0
2462,1234,127,1273,274,61,13,15,39,147,2,39,0,0
2463,1240,130,1281,279,61,13,15,41,149,3,39,0,0
2464,1245,130,1288,284,61,13,15,43,154,4,39,0,0
2465,1251,131,1294,281,61,13,15,43,150,5,39,0,0
2466,1254,134,1297,284,61,13,15,43,150,6,39,0,0
2467,1256,135,1300,288,61,13,15,44,153,7,39,0,0
2468,1258,135,1304,293,61,13,15,46,158,8,39,0,0
2469,1261,139,1308,299,61,13,15,47,160,9,39,0,0
2470,1265,139,1313,302,61,13,15,48,163,10,39,0,0
2471,1267,140,1317,307,61,13,15,50,167,11,39,0,0
2472,1268,144,1318,311,61,13,15,50,167,12,39,0,0
2473,1267,144,1319,315,61,13,15,52,171,13,39,0,0
2474,1267,143,1320,320,61,13,15,53,177,14,39,0,0
2475,1268,145,1323,327,61,13,15,55,182,15,39,0,0
2476,1269,146,1326,332,61,13,15,57,186,16,39,0,0
2477,1270,149,1328,336,61,13,15,58,187,17,39,0,0
2478,1270,149,1330,344,61,13,15,60,195,18,39,0,0
2479,1269,148,1331,347,61,13,15,62,199,19,39,0,0
2480,1268,147,1333,359,61,13,15,65,212,20,39,0,0
2481,1269,151,1335,365,61,13,15,66,214,21,39,0,0
2482,1274,154,1341,371,61,13,15,67,217,22,39,0,0
2483,1278,157,1347,374,61,13,15,69,217,23,39,0,0
2484,1278,166,1347,384,61,13,15,69,218,24,39,0,0
2485,1275,168,1345,388,61,13,15,70,220,25,39,0,0
2486,1272,170,1344,396,61,13,15,72,226,26,39,0,0
2487,1271,177,1345,410,61,13,15,74,233,27,39,0,0
2488,1271,178,1346,414,61,13,15,75,236,28,39,0,0
2489,1270,181,1349,425,61,13,15,79,244,29,39,0,0
2490,1270,184,1351,436,61,13,15,81,252,30,39,0,0
2491,1268,184,1353,445,61,13,15,85,261,31,39,0,0
2492,1269,188,1356,459,61,13,15,87,271,32,39,0,0
2493,1276,195,1365,467,61,13,15,89,272,33,39,0,0
2494,1286,198,1375,471,61,13,15,89,273,34,39,0,0
2495,1297,200,1389,483,61,13,15,92,283,35,39,0,0
2496,1310,210,1403,496,61,13,15,93,286,36,39,0,0
2497,1327,209,1422,503,61,13,15,95,294,37,39,0,0
2498,1332,211,1430,510,61,13,15,98,299,38,39,0,0
2499,1337,214,1437,518,61,13,15,100,304,39,39,1,0
2700,1368,215,1442,554,62,13,15,74,339,0,52,0,1
2701,1362,234,1428,537,62,13,15,66,303,1,52,0,0
2702,1323,241,1391,538,62,13,15,68,297,2,52,0,0
2703,1300,233,1370,533,62,13,15,70,300,3,52,0,0
2704,1275,224,1346,519,62,13,15,71,295,4,52,0,0
2705,1245,219,1319,519,62,13,15,74,300,5,52,0,0
2706,1219,215,1292,503,62,13,15,73,288,6,52,0,0
2707,1193,207,1266,488,62,13,15,73,281,7,52,0,0
2708,1167,203,1243,484,62,13,15,76,281,8,52,0,0
2709,1144,198,1221,477,62,13,15,77,279,9,52,0,0
2710,1126,194,1201,465,62,13,15,75,271,10,52,0,0
2711,1111,196,1183,456,62,13,15,72,260,11,52,0,0
2712,1100,194,1171,443,62,13,15,71,249,12,52,0,0
2713,1092,189,1162,434,62,13,15,70,245,13,52,0,0
2714,1086,185,1156,428,62,13,15,70,243,14,52,0,0
2715,1081,184,1148,415,62,13,15,67,231,15,52,0,0
2716,1078,183,1143,402,62,13,15,65,219,16,52,0,0
2717,1080,181,1142,392,62,13,15,62,211,17,52,0,0
2718,1085,179,1146,385,62,13,15,61,206,18,52,0,0
2719,1091,177,1152,380,62,13,15,61,203,19,52,0,0
2720,1099,173,1160,378,62,13,15,61,205,20,52,0,0
2721,1106,170,1167,370,62,13,15,61,200,21,52,0,0
2722,1114,168,1175,367,62,13,15,61,199,22,52,0,0
2723,1124,166,1184,363,62,13,15,60,197,23,52,0,0
2724,1136,161,1194,354,62,13,15,58,193,24,52,0,0
2725,1141,160,1199,351,62,13,15,58,191,25,52,0,0
2726,1147,155,1203,341,62,13,15,56,186,26,52,0,0
2727,1153,152,1208,335,62,13,15,55,183,27,52,0,0
2728,1159,151,1214,333,62,13,15,55,182,28,52,0,0
2729,1167,149,1221,326,62,13,15,54,177,29,52,0,0
2730,1170,144,1225,324,62,13,15,55,180,30,52,0,0
2731,1173,143,1226,320,62,13,15,53,177,31,52,0,0
2732,1176,140,1228,315,62,13,15,52,175,32,52,0,0
2733,1179,140,1230,308,62,13,15,51,168,33,52,0,0
2734,1182,140,1233,310,62,13,15,51,170,34,52,0,0
2735,1187,141,1236,305,62,13,15,49,164,35,52,0,0
2736,1191,143,1239,300,62,13,15,48,157,36,52,0,0
2737,1195,141,1242,294,62,13,15,47,153,37,52,0,0
2738,1197,139,1244,291,62,13,15,47,152,38,52,0,0
2739,1201,140,1247,289,62,13,15,46,149,39,52,0,0
2740,1205,139,1252,289,62,13,15,47,150,40,52,0,0
2741,1209,138,1255,285,62,13,15,46,147,41,52,0,0
2742,1212,138,1255,277,62,13,15,43,139,42,52,0,0
2743,1212,135,1254,268,62,13,15,42,133,43,52,0,0
2744,1210,131,1253,268,62,13,15,43,137,44,52,0,0
2745,1210,130,1252,266,62,13,15,42,136,45,52,0,0
2746,1209,129,1249,258,62,13,15,40,129,46,52,0,0
2747,1206,129,1248,262,62,13,15,42,133,47,52,0,0
2748,1202,129,1244,263,62,13,15,42,134,48,52,0,0
2749,1195,128,1236,254,62,13,15,41,126,49,52,0,0
2750,1188,127,1229,252,62,13,15,41,125,50,52,0,0
2751,1179,126,1222,255,62,13,15,43,129,51,52,0,0
2752,1175,134,1211,242,62,13,15,36,108,52,52,1,0
2894,1237,128,1272,259,63,13,15,35,131,0,46,0,1
2895,1242,127,1280,264,63,13,15,38,137,1,46,0,0
2896,1248,129,1289,274,63,13,15,41,145,2,46,0,0
2897,1256,132,1298,281,63,13,15,42,149,3,46,0,0
2898,1263,130,1307,285,63,13,15,44,155,4,46,0,0
2899,1268,131,1313,287,63,13,15,45,156,5,46,0,0
2900,1270,130,1316,290,63,13,15,46,160,6,46,0,0
2901,1272,129,1320,290,63,13,15,48,161,7,46,0,0
2902,1276,131,1324,290,63,13,15,48,159,8,46,0,0
2903,1280,132,1330,295,63,13,15,50,163,9,46,0,0
2904,1286,133,1335,296,63,13,15,49,163,10,46,0,0
2905,1289,135,1339,296,63,13,15,50,161,11,46,0,0
2906,1290,139,1341,301,63,13,15,51,162,12,46,0,0
2907,1292,142,1344,306,63,13,15,52,164,13,46,0,0
2908,1294,147,1348,316,63,13,15,54,169,14,46,0,0
2909,1299,153,1352,318,63,13,15,53,165,15,46,0,0
2910,1304,154,1358,318,63,13,15,54,164,16,46,0,0
2911,1306,153,1364,325,63,13,15,58,172,17,46,0,0
2912,1304,151,1364,330,63,13,15,60,179,18,46,0,0
2913,1301,150,1363,334,63,13,15,62,184,19,46,0,0
2914,1301,150,1366,342,63,13,15,65,192,20,46,0,0
2915,1304,150,1370,345,63,13,15,66,195,21,46,0,0
2916,1304,150,1374,352,63,13,15,70,202,22,46,0,0
2917,1303,155,1374,362,63,13,15,71,207,23,46,0,0
2918,1297,159,1369,366,63,13,15,72,207,24,46,0,0
2919,1293,160,1365,367,63,13,15,72,207,25,46,0,0
2920,1291,163,1364,373,63,13,15,73,210,26,46,0,0
2921,1293,165,1367,376,63,13,15,74,211,27,46,0,0
2922,1294,166,1371,383,63,13,15,77,217,28,46,0,0
2923,1291,171,1370,393,63,13,15,79,222,29,46,0,0
2924,1284,173,1365,400,63,13,15,81,227,30,46,0,0
2925,1277,173,1360,406,63,13,15,83,233,31,46,0,0
2926,1276,178,1360,414,63,13,15,84,236,32,46,0,0
2927,1277,180,1363,424,63,13,15,86,244,33,46,0,0
2928,1278,181,1365,427,63,13,15,87,246,34,46,0,0
2929,1274,185,1364,439,63,13,15,90,254,35,46,0,0
2930,1269,187,1361,448,63,13,15,92,261,36,46,0,0
2931,1266,187,1359,452,63,13,15,93,265,37,46,0,0
2932,1265,189,1362,465,63,13,15,97,276,38,46,0,0
2933,1271,190,1370,472,63,13,15,99,282,39,46,0,0
2934,1281,191,1379,474,63,13,15,98,283,40,46,0,0
2935,1289,197,1388,486,63,13,15,99,289,41,46,0,0
2936,1296,201,1398,498,63,13,15,102,297,42,46,0,0
2937,1305,204,1406,503,63,13,15,101,299,43,46,0,0
2938,1316,206,1420,512,63,13,15,104,306,44,46,0,0
2939,1325,208,1428,508,63,13,15,103,300,45,46,0,0
2940,1329,210,1433,514,63,13,15,104,304,46,46,1,0
2895,3,862,184,1076,64,13,15,181,214,0,0,0,0
2896,89,803,317,1074,65,13,15,228,271,0,0,0,0
2897,238,769,468,1073,66,13,15,230,304,0,0,0,0
2898,361,711,615,1071,67,13,15,254,360,0,0,0,0
2899,449,652,853,1074,68,13,15,404,422,0,13,0,0
2900,509,612,942,1067,68,13,15,433,455,1,13,0,0
2901,536,560,1015,1068,68,13,15,479,508,2,13,0,0
2902,587,523,1096,1072,68,13,15,509,549,3,13,0,0
2903,656,498,1177,1072,68,13,15,521,574,4,13,0,0
2904,733,464,1269,1071,68,13,15,536,607,5,13,0,0
2905,796,444,1331,1068,68,13,15,535,624,6,13,0,0
2906,851,423,1374,1056,68,13,15,523,633,7,13,0,0
2907,917,393,1397,997,68,13,15,480,604,8,13,0,0
2908,975,384,1424,968,68,13,15,449,584,9,13,0,0
2909,1039,367,1455,928,68,13,15,416,561,10,13,0,0
2910,1119,361,1501,898,68,13,15,382,537,11,13,0,0
2911,1163,345,1532,885,68,13,15,369,540,12,13,0,0
2912,1213,324,1584,869,68,13,15,371,545,13,13,0,0
2912,1327,385,1440,820,69,13,15,113,435,0,0,0,0
3020,1316,444,1420,603,70,13,15,104,159,0,0,0,0
3021,1277,368,1428,848,71,13,15,151,480,0,20,0,1
3022,1276,373,1426,848,71,13,15,150,475,1,20,0,0
3023,1248,369,1398,842,71,13,15,150,473,2,20,0,0
3024,1205,387,1367,890,71,13,15,162,503,3,20,0,0
3025,1166,398,1332,908,71,13,15,166,510,4,20,0,0
3026,1130,412,1306,945,71,13,15,176,533,5,20,0,0
3027,1108,433,1300,1007,71,13,15,192,574,6,20,0,0
3028,1090,455,1284,1030,71,13,15,194,575,7,20,0,0
3029,1057,471,1257,1065,71,13,15,200,594,8,20,0,0
3030,1037,489,1237,1078,71,13,15,200,589,9,20,0,0
3031,988,520,1185,1080,71,13,15,197,560,10,20,0,0
3032,948,540,1146,1080,71,13,15,198,540,11,20,0,0
3033,920,582,1111,1080,71,13,15,191,498,12,20,0,0
3034,901,593,1092,1078,71,13,15,191,485,13,20,0,0
3035,868,644,1047,1080,71,13,15,179,436,14,20,0,0
3036,791,708,959,1073,71,13,15,168,365,15,20,0,0
3037,691,737,870,1072,71,13,15,179,335,16,20,0,0
3038,659,779,834,1073,71,13,15,175,294,17,20,0,0
3039,602,850,755,1076,71,13,15,153,226,18,20,0,0
3040,522,908,652,1078,71,13,15,130,170,19,20,0,0
3041,432,977,524,1080,71,13,15,92,103,20,20,1,0
3023,1392,302,1436,493,72,13,15,44,191,0,0,0,0
3024,1340,308,1403,502,73,13,15,63,194,0,0,0,0
3024,1320,322,1429,851,74,13,15,109,529,0,3,0,0
3025,1327,306,1408,696,74,13,15,81,390,1,3,0,0
3026,1306,306,1377,641,74,13,15,71,335,2,3,0,0
3027,1298,304,1359,596,74,13,15,61,292,3,3,0,0
3025,1299,297,1355,472,75,13,15,56,175,0,0,0,0
3027,1166,316,1359,735,76,13,15,193,419,0,18,0,0
3028,1137,309,1378,837,76,13,15,241,528,1,18,0,0
3029,1118,317,1364,864,76,13,15,246,547,2,18,0,0
3030,1099,334,1312,812,76,13,15,213,478,3,18,0,0
3031,1065,334,1235,708,76,13,15,170,374,4,18,0,0
3032,985,344,1180,770,76,13,15,195,426,5,18,0,0
3033,941,359,1155,822,76,13,15,214,463,6,18,0,0
3034,893,360,1108,829,76,13,15,215,469,7,18,0,0
3035,878,384,1126,938,76,13,15,248,554,8,18,0,0
3036,843,398,1102,987,76,13,15,259,589,9,18,0,0
3037,793,429,1060,1041,76,13,15,267,612,10,18,0,0
3038,754,476,1009,1057,76,13,15,255,581,11,18,0,0
3039,716,519,962,1070,76,13,15,246,551,12,18,0,0
3040,679,542,921,1075,76,13,15,242,533,13,18,0,0
3041,637,563,876,1080,76,13,15,239,517,14,18,0,0
3042,583,612,804,1077,76,13,15,221,465,15,18,0,0
3043,521,665,730,1080,76,13,15,209,415,16,18,0,0
3044,467,732,659,1080,76,13,15,192,348,17,18,0,0
3045,426,764,608,1080,76,13,15,182,316,18,18,0,0
3031,1048,327,1147,526,77,13,15,99,199,0,0,0,0
3033,944,351,1091,583,78,13,15,147,232,0,1,0,0
3034,935,357,1061,557,78,13,15,126,200,1,1,0,0
3035,921,374,986,669,79,13,15,65,295,0,0,0,0
3036,866,378,949,714,80,13,15,83,336,0,1,0,0
3037,828,387,897,657,80,13,15,69,270,1,1,0,0
3038,716,410,919,653,81,13,15,203,243,0,14,0,0
3039,684,421,897,678,81,13,15,213,257,1,14,0,0
3040,696,433,892,668,81,13,15,196,235,2,14,0,0
3041,646,462,858,721,81,13,15,212,259,3,14,0,0
3042,588,484,830,784,81,13,15,242,300,4,14,0,0
3043,532,504,808,851,81,13,15,276,347,5,14,0,0
3044,483,538,799,940,81,13,15,316,402,6,14,0,0
3045,410,567,753,1014,81,13,15,343,447,7,14,0,0
3046,350,595,706,1071,81,13,15,356,476,8,14,0,0
3047,312,635,649,1080,81,13,15,337,445,9,14,0,0
3048,231,669,544,1080,81,13,15,313,411,10,14,0,0
3049,170,700,460,1080,81,13,15,290,380,11,14,0,0
3050,106,753,361,1080,81,13,15,255,327,12,14,0,0
3051,62,799,287,1080,81,13,15,225,281,13,14,0,0
3052,15,829,238,1080,81,13,15,223,251,14,14,0,0
3168,1316,170,1457,801,85,13,15,141,631,0,14,0,0
3169,1287,281,1405,801,85,13,15,118,520,1,14,0,0
3170,1220,320,1338,826,85,13,15,118,506,2,14,0,0
3171,1182,325,1309,849,85,13,15,127,524,3,14,0,0
3172,1142,338,1291,936,85,13,15,149,598,4,14,0,0
3173,1096,355,1254,974,85,13,15,158,619,5,14,0,0
3174,1035,372,1206,1018,85,13,15,171,646,6,14,0,0
3175,994,406,1173,1065,85,13,15,179,659,7,14,0,0
3176,964,431,1151,1080,85,13,15,187,649,8,14,0,0
3177,960,480,1149,1080,85,13,15,189,600,9,14,0,0
3178,985,528,1183,1080,85,13,15,198,552,10,14,0,0
3179,1004,583,1218,1080,85,13,15,214,497,11,14,0,0
3180,976,669,1179,1080,85,13,15,203,411,12,14,0,0
3181,1001,744,1199,1080,85,13,15,198,336,13,14,0,0
3182,998,790,1178,1080,85,13,15,180,290,14,14,0,0
3252,0,738,264,1075,87,13,15,264,337,0,18,0,0
3253,60,686,363,1073,87,13,15,303,387,1,18,0,0
3254,150,649,481,1074,87,13,15,331,425,2,18,0,0
3255,252,591,618,1067,87,13,15,366,476,3,18,0,0
3256,360,543,758,1067,87,13,15,398,524,4,18,0,0
3257,464,509,884,1072,87,13,15,420,563,5,18,0,0
3258,547,466,986,1073,87,13,15,439,607,6,18,0,0
3259,627,432,1074,1072,87,13,15,447,640,7,18,0,0
3260,698,408,1145,1074,87,13,15,447,666,8,18,0,0
3261,778,376,1189,1012,87,13,15,411,636,9,18,0,0
3262,848,356,1234,974,87,13,15,386,618,10,18,0,0
3263,918,338,1269,917,87,13,15,351,579,11,18,0,0
3264,991,320,1315,878,87,13,15,324,558,12,18,0,0
3265,1040,316,1346,863,87,13,15,306,547,13,18,0,0
3266,1115,303,1395,822,87,13,15,280,519,14,18,0,0
3267,1170,303,1429,795,87,13,15,259,492,15,18,0,0
3268,1216,300,1460,770,87,13,15,244,470,16,18,0,0
3269,1282,298,1501,742,87,13,15,219,444,17,18,0,0
3270,1345,281,1561,719,87,13,15,216,438,18,18,0,0
3436,1335,218,1439,495,88,13,15,104,277,0,38,0,1
3437,1324,216,1429,496,88,13,15,105,280,1,38,0,0
3438,1307,208,1411,488,88,13,15,104,280,2,38,0,0
3439,1278,204,1378,475,88,13,15,100,271,3,38,0,0
3440,1256,203,1353,464,88,13,15,97,261,4,38,0,0
3441,1241,195,1337,455,88,13,15,96,260,5,38,0,0
3442,1234,189,1325,440,88,13,15,91,251,6,38,0,0
3443,1225,187,1314,435,88,13,15,89,248,7,38,0,0
3444,1218,183,1302,419,88,13,15,84,236,8,38,0,0
3445,1216,182,1296,408,88,13,15,80,226,9,38,0,0
3446,1213,177,1292,400,88,13,15,79,223,10,38,0,0
3447,1214,174,1290,391,88,13,15,76,217,11,38,0,0
3448,1212,172,1285,383,88,13,15,73,211,12,38,0,0
3449,1211,169,1281,372,88,13,15,70,203,13,38,0,0
3450,1208,168,1281,380,88,13,15,73,212,14,38,0,0
3451,1210,162,1279,364,88,13,15,69,202,15,38,0,0
3452,1210,162,1276,353,88,13,15,66,191,16,38,0,0
3453,1207,152,1273,345,88,13,15,66,193,17,38,0,0
3454,1207,151,1271,337,88,13,15,64,186,18,38,0,0
3455,1207,146,1272,337,88,13,15,65,191,19,38,0,0
3456,1210,145,1272,327,88,13,15,62,182,20,38,0,0
3457,1212,146,1270,317,88,13,15,58,171,21,38,0,0
3458,1212,143,1268,313,88,13,15,56,170,22,38,0,0
3459,1213,144,1267,309,88,13,15,54,165,23,38,0,0
3460,1214,142,1268,305,88,13,15,54,163,24,38,0,0
3461,1216,138,1270,301,88,13,15,54,163,25,38,0,0
3462,1217,140,1268,297,88,13,15,51,157,26,38,0,0
3463,1217,138,1267,291,88,13,15,50,153,27,38,0,0
3464,1219,140,1268,289,88,13,15,49,149,28,38,0,0
3465,1220,137,1267,283,88,13,15,47,146,29,38,0,0
3466,1220,138,1265,276,88,13,15,45,138,30,38,0,0
3467,1216,133,1262,273,88,13,15,46,140,31,38,0,0
3468,1211,131,1255,268,88,13,15,44,137,32,38,0,0
3469,1206,132,1249,263,88,13,15,43,131,33,38,0,0
3470,1200,129,1244,267,88,13,15,44,138,34,38,0,0
3471,1194,125,1237,261,88,13,15,43,136,35,38,0,0
3472,1181,121,1225,259,88,13,15,44,138,36,38,0,0
3473,1172,121,1213,255,88,13,15,41,134,37,38,0,0
3474,1167,120,1208,251,88,13,15,41,131,38,38,1,0
3502,1387,830,1611,1072,89,13,15,224,242,0,0,0,0
3503,1233,770,1469,1072,90,13,15,236,302,0,0,0,0
3504,1036,747,1310,1072,91,13,15,274,325,0,0,0,0
3505,828,673,1195,1069,92,13,15,367,396,0,13,0,0
3506,746,626,1157,1069,92,13,15,411,443,1,13,0,0
3507,713,566,1175,1068,92,13,15,462,502,2,13,0,0
3508,702,506,1216,1073,92,13,15,514,567,3,13,0,0
3509,702,463,1243,1070,92,13,15,541,607,4,13,0,0
3510,718,409,1290,1069,92,13,15,572,660,5,13,0,0
3511,742,374,1325,1066,92,13,15,583,692,6,13,0,0
3512,825,347,1358,999,92,13,15,533,652,7,13,0,0
3513,898,326,1397,961,92,13,15,499,635,8,13,0,0
3514,967,313,1434,928,92,13,15,467,615,9,13,0,0
3515,1056,295,1470,864,92,13,15,414,569,10,13,0,0
3516,1106,291,1491,837,92,13,15,385,546,11,13,0,0
3517,1183,287,1521,790,92,13,15,338,503,12,13,0,0
3518,1216,262,1553,765,92,13,15,337,503,13,13,0,0
3518,1376,421,1422,612,93,13,15,46,191,0,0,0,0
3599,1340,216,1441,498,94,13,15,101,282,0,55,0,1
3600,1332,214,1433,498,94,13,15,101,284,1,55,0,0
3601,1300,206,1401,491,94,13,15,101,285,2,55,0,0
3602,1268,210,1370,495,94,13,15,102,285,3,55,0,0
3603,1237,201,1339,487,94,13,15,102,286,4,55,0,0
3604,1211,199,1311,479,94,13,15,100,280,5,55,0,0
3605,1189,200,1285,473,94,13,15,96,273,6,55,0,0
3606,1167,196,1259,460,94,13,15,92,264,7,55,0,0
3607,1135,193,1229,459,94,13,15,94,266,8,55,0,0
3608,1119,193,1210,452,94,13,15,91,259,9,55,0,0
3609,1105,188,1191,436,94,13,15,86,248,10,55,0,0
3610,1093,187,1177,431,94,13,15,84,244,11,55,0,0
3611,1084,185,1166,425,94,13,15,82,240,12,55,0,0
3612,1080,180,1159,415,94,13,15,79,235,13,55,0,0
3613,1074,177,1153,412,94,13,15,79,235,14,55,0,0
3614,1069,176,1145,403,94,13,15,76,227,15,55,0,0
3615,1065,171,1140,395,94,13,15,75,224,16,55,0,0
3616,1063,170,1136,391,94,13,15,73,221,17,55,0,0
3617,1063,169,1135,386,94,13,15,72,217,18,55,0,0
3618,1066,164,1136,379,94,13,15,70,215,19,55,0,0
3619,1071,165,1139,374,94,13,15,68,209,20,55,0,0
3620,1076,164,1142,369,94,13,15,66,205,21,55,0,0
3621,1082,160,1146,357,94,13,15,64,197,22,55,0,0
3622,1089,158,1153,356,94,13,15,64,198,23,55,0,0
3623,1100,156,1164,355,94,13,15,64,199,24,55,0,0
3624,1110,153,1173,348,94,13,15,63,195,25,55,0,0
3625,1116,154,1176,343,94,13,15,60,189,26,55,0,0
3626,1123,153,1182,339,94,13,15,59,186,27,55,0,0
3627,1132,151,1190,336,94,13,15,58,185,28,55,0,0
3628,1139,149,1197,334,94,13,15,58,185,29,55,0,0
3629,1147,147,1205,333,94,13,15,58,186,30,55,0,0
3630,1154,148,1209,322,94,13,15,55,174,31,55,0,0
3631,1159,146,1214,321,94,13,15,55,175,32,55,0,0
3632,1161,146,1215,318,94,13,15,54,172,33,55,0,0
3633,1163,144,1217,319,94,13,15,54,175,34,55,0,0
3634,1166,144,1220,321,94,13,15,54,177,35,55,0,0
3635,1169,145,1222,321,94,13,15,53,176,36,55,0,0
3636,1171,144,1222,315,94,13,15,51,171,37,55,0,0
3637,1173,144,1222,306,94,13,15,49,162,38,55,0,0
3638,1175,143,1223,305,94,13,15,48,162,39,55,0,0
3639,1176,142,1224,302,94,13,15,48,160,40,55,0,0
3640,1176,140,1224,302,94,13,15,48,162,41,55,0,0
3641,1178,137,1226,299,94,13,15,48,162,42,55,0,0
3642,1179,135,1226,292,94,13,15,47,157,43,55,0,0
3643,1181,136,1227,288,94,13,15,46,152,44,55,0,0
3644,1182,135,1227,285,94,13,15,45,150,45,55,0,0
3645,1182,134,1228,284,94,13,15,46,150,46,55,0,0
3646,1184,134,1227,275,94,13,15,43,141,47,55,0,0
3647,1184,131,1228,274,94,13,15,44,143,48,55,0,0
3648,1186,131,1228,268,94,13,15,42,137,49,55,0,0
3649,1185,131,1227,270,94,13,15,42,139,50,55,0,0
3650,1182,130,1226,270,94,13,15,44,140,51,55,0,0
3651,1180,128,1222,263,94,13,15,42,135,52,55,0,0
3652,1176,128,1216,253,94,13,15,40,125,53,55,0,0
3653,1173,126,1212,249,94,13,15,39,123,54,55,0,0
3654,1170,123,1208,246,94,13,15,38,123,55,55,1,0
3603,1352,245,1423,523,95,13,15,71,278,0,54,0,1
3604,1330,239,1405,531,95,13,15,75,292,1,54,0,0
3605,1314,235,1390,522,95,13,15,76,287,2,54,0,0
3606,1310,227,1381,494,95,13,15,71,267,3,54,0,0
3607,1302,225,1371,486,95,13,15,69,261,4,54,0,0
3608,1291,221,1360,478,95,13,15,69,257,5,54,0,0
3609,1282,215,1350,466,95,13,15,68,251,6,54,0,0
3610,1278,212,1345,457,95,13,15,67,245,7,54,0,0
3611,1271,204,1341,455,95,13,15,70,251,8,54,0,0
3612,1265,201,1334,443,95,13,15,69,242,9,54,0,0
3613,1257,196,1327,441,95,13,15,70,245,10,54,0,0
3614,1249,192,1315,426,95,13,15,66,234,11,54,0,0
3615,1246,187,1312,417,95,13,15,66,230,12,54,0,0
3616,1246,189,1313,416,95,13,15,67,227,13,54,0,0
3617,1246,185,1314,412,95,13,15,68,227,14,54,0,0
3618,1246,181,1312,401,95,13,15,66,220,15,54,0,0
3619,1245,181,1310,395,95,13,15,65,214,16,54,0,0
3620,1246,177,1311,389,95,13,15,65,212,17,54,0,0
3621,1250,175,1315,386,95,13,15,65,211,18,54,0,0
3622,1255,174,1319,381,95,13,15,64,207,19,54,0,0
3623,1258,171,1320,373,95,13,15,62,202,20,54,0,0
3624,1259,170,1321,369,95,13,15,62,199,21,54,0,0
3625,1259,170,1320,365,95,13,15,61,195,22,54,0,0
3626,1259,168,1320,360,95,13,15,61,192,23,54,0,0
3627,1260,167,1321,358,95,13,15,61,191,24,54,0,0
3628,1262,164,1322,355,95,13,15,60,191,25,54,0,0
3629,1263,158,1324,351,95,13,15,61,193,26,54,0,0
3630,1262,155,1323,349,95,13,15,61,194,27,54,0,0
3631,1263,151,1321,339,95,13,15,58,188,28,54,0,0
3632,1263,150,1320,334,95,13,15,57,184,29,54,0,0
3633,1266,149,1321,329,95,13,15,55,180,30,54,0,0
3634,1269,148,1323,325,95,13,15,54,177,31,54,0,0
3635,1270,150,1321,320,95,13,15,51,170,32,54,0,0
3636,1269,148,1321,319,95,13,15,52,171,33,54,0,0
3637,1269,146,1320,312,95,13,15,51,166,34,54,0,0
3638,1271,146,1320,308,95,13,15,49,162,35,54,0,0
3639,1272,146,1319,303,95,13,15,47,157,36,54,0,0
3640,1272,144,1319,301,95,13,15,47,157,37,54,0,0
3641,1270,145,1317,300,95,13,15,47,155,38,54,0,0
3642,1269,143,1315,296,95,13,15,46,153,39,54,0,0
3643,1268,140,1314,290,95,13,15,46,150,40,54,0,0
3644,1269,139,1313,284,95,13,15,44,145,41,54,0,0
3645,1267,140,1312,287,95,13,15,45,147,42,54,0,0
3646,1267,137,1311,281,95,13,15,44,144,43,54,0,0
3647,1265,137,1307,275,95,13,15,42,138,44,54,0,0
3648,1262,136,1304,272,95,13,15,42,136,45,54,0,0
3649,1260,135,1299,263,95,13,15,39,128,46,54,0,0
3650,1254,133,1294,266,95,13,15,40,133,47,54,0,0
3651,1248,133,1288,269,95,13,15,40,136,48,54,0,0
3652,1242,132,1280,264,95,13,15,38,132,49,54,0,0
3653,1234,132,1270,258,95,13,15,36,126,50,54,0,0
3654,1222,130,1258,256,95,13,15,36,126,51,54,0,0
3655,1209,129,1246,254,95,13,15,37,125,52,54,0,0
3656,1200,128,1235,248,95,13,15,35,120,53,54,0,0
3657,1190,128,1225,247,95,13,15,35,119,54,54,1,0
3908,1190,121,1225,256,96,13,15,35,135,0,43,0,1
3909,1203,125,1238,261,96,13,15,35,136,1,43,0,0
3910,1216,124,1254,267,96,13,15,38,143,2,43,0,0
3911,1230,127,1267,265,96,13,15,37,138,3,43,0,0
3912,1239,129,1278,274,96,13,15,39,145,4,43,0,0
3913,1249,132,1288,272,96,13,15,39,140,5,43,0,0
3914,1257,131,1298,278,96,13,15,41,147,6,43,0,0
3915,1265,131,1308,283,96,13,15,43,152,7,43,0,0
3916,1270,132,1312,279,96,13,15,42,147,8,43,0,0
3917,1273,133,1317,286,96,13,15,44,153,9,43,0,0
3918,1275,134,1321,290,96,13,15,46,156,10,43,0,0
3919,1277,131,1324,292,96,13,15,47,161,11,43,0,0
3920,1280,136,1327,296,96,13,15,47,160,12,43,0,0
3921,1281,139,1328,297,96,13,15,47,158,13,43,0,0
3922,1278,143,1327,306,96,13,15,49,163,14,43,0,0
3923,1275,144,1326,312,96,13,15,51,168,15,43,0,0
3924,1274,146,1326,316,96,13,15,52,170,16,43,0,0
3925,1274,150,1325,317,96,13,15,51,167,17,43,0,0
3926,1270,146,1324,323,96,13,15,54,177,18,43,0,0
3927,1262,147,1320,334,96,13,15,58,187,19,43,0,0
3928,1256,147,1316,339,96,13,15,60,192,20,43,0,0
3929,1252,146,1314,347,96,13,15,62,201,21,43,0,0
3930,1249,146,1313,350,96,13,15,64,204,22,43,0,0
3931,1245,151,1309,355,96,13,15,64,204,23,43,0,0
3932,1237,152,1305,369,96,13,15,68,217,24,43,0,0
3933,1229,155,1299,378,96,13,15,70,223,25,43,0,0
3934,1226,160,1296,381,96,13,15,70,221,26,43,0,0
3935,1225,165,1294,385,96,13,15,69,220,27,43,0,0
3936,1219,165,1295,407,96,13,15,76,242,28,43,0,0
3937,1215,171,1291,412,96,13,15,76,241,29,43,0,0
3938,1206,172,1287,425,96,13,15,81,253,30,43,0,0
3939,1206,176,1286,427,96,13,15,80,251,31,43,0,0
3940,1210,180,1290,430,96,13,15,80,250,32,43,0,0
3941,1211,182,1291,429,96,13,15,80,247,33,43,0,0
3942,1208,186,1293,444,96,13,15,85,258,34,43,0,0
3943,1210,187,1296,445,96,13,15,86,258,35,43,0,0
3944,1219,191,1311,460,96,13,15,92,269,36,43,0,0
3945,1232,192,1327,471,96,13,15,95,279,37,43,0,0
3946,1246,196,1343,481,96,13,15,97,285,38,43,0,0
3947,1261,202,1360,494,96,13,15,99,292,39,43,0,0
3948,1283,205,1383,501,96,13,15,100,296,40,43,0,0
3949,1301,212,1405,511,96,13,15,104,299,41,43,0,0
3950,1321,215,1426,519,96,13,15,105,304,42,43,0,0
3951,1328,218,1435,527,96,13,15,107,309,43,43,1,0
4017,1376,265,1434,595,97,13,15,58,330,0,44,0,1
4018,1336,259,1396,588,97,13,15,60,329,1,44,0,0
4019,1316,258,1377,579,97,13,15,61,321,2,44,0,0
4020,1298,250,1359,560,97,13,15,61,310,3,44,0,0
4021,1271,243,1334,550,97,13,15,63,307,4,44,0,0
4022,1245,235,1310,534,97,13,15,65,299,5,44,0,0
4023,1224,231,1286,510,97,13,15,62,279,6,44,0,0
4024,1207,223,1272,506,97,13,15,65,283,7,44,0,0
4025,1196,215,1260,481,97,13,15,64,266,8,44,0,0
4026,1188,205,1254,472,97,13,15,66,267,9,44,0,0
4027,1179,203,1246,463,97,13,15,67,260,10,44,0,0
4028,1176,198,1243,450,97,13,15,67,252,11,44,0,0
4029,1179,195,1246,445,97,13,15,67,250,12,44,0,0
4030,1184,192,1249,429,97,13,15,65,237,13,44,0,0
4031,1189,187,1254,418,97,13,15,65,231,14,44,0,0
4032,1193,187,1257,415,97,13,15,64,228,15,44,0,0
4033,1195,183,1259,405,97,13,15,64,222,16,44,0,0
4034,1197,180,1261,400,97,13,15,64,220,17,44,0,0
4035,1205,178,1264,379,97,13,15,59,201,18,44,0,0
4036,1210,177,1257,332,97,13,15,47,155,19,44,0,0
4037,1220,176,1256,281,97,13,15,36,105,20,44,0,0
4038,1221,174,1259,273,97,13,15,38,99,21,44,0,0
4039,1219,172,1259,271,97,13,15,40,99,22,44,0,0
4040,1217,174,1271,306,97,13,15,54,132,23,44,0,0
4041,1213,172,1278,337,97,13,15,65,165,24,44,0,0
4042,1211,172,1281,352,97,13,15,70,180,25,44,0,0
4043,1204,164,1282,371,97,13,15,78,207,26,44,0,0
4044,1207,159,1280,357,97,13,15,73,198,27,44,0,0
4045,1211,158,1283,359,97,13,15,72,201,28,44,0,0
4046,1217,157,1285,351,97,13,15,68,194,29,44,0,0
4047,1224,159,1288,346,97,13,15,64,187,30,44,0,0
4048,1225,149,1290,345,97,13,15,65,196,31,44,0,0
4049,1229,148,1289,332,97,13,15,60,184,32,44,0,0
4050,1233,146,1291,326,97,13,15,58,180,33,44,0,0
4051,1237,145,1291,317,97,13,15,54,172,34,44,0,0
4052,1240,143,1291,310,97,13,15,51,167,35,44,0,0
4053,1241,143,1292,313,97,13,15,51,170,36,44,0,0
4054,1242,143,1291,306,97,13,15,49,163,37,44,0,0
4055,1244,145,1293,308,97,13,15,49,163,38,44,0,0
4056,1247,144,1297,310,97,13,15,50,166,39,44,0,0
4057,1250,142,1299,306,97,13,15,49,164,40,44,0,0
4058,1255,154,1310,337,97,13,15,55,183,41,44,0,0
4059,1266,158,1311,313,97,13,15,45,155,42,44,0,0
4060,1274,155,1313,291,97,13,15,39,136,43,44,0,0
4061,1278,155,1313,277,97,13,15,35,122,44,44,1,0
4063,1268,148,1303,268,97,13,15,35,120,0,44,0,0
4020,1383,287,1439,521,98,13,15,56,234,0,21,0,1
4021,1369,273,1428,521,98,13,15,59,248,1,21,0,0
4022,1353,244,1419,514,98,13,15,66,270,2,21,0,0
4023,1332,225,1399,498,98,13,15,67,273,3,21,0,0
4024,1314,211,1382,487,98,13,15,68,276,4,21,0,0
4025,1299,210,1366,479,98,13,15,67,269,5,21,0,0
4026,1287,207,1354,469,98,13,15,67,262,6,21,0,0
4027,1280,205,1347,460,98,13,15,67,255,7,21,0,0
4028,1272,199,1339,453,98,13,15,67,254,8,21,0,0
4029,1266,198,1332,444,98,13,15,66,246,9,21,0,0
4030,1262,198,1327,436,98,13,15,65,238,10,21,0,0
4031,1258,192,1324,432,98,13,15,66,240,11,21,0,0
4032,1258,190,1323,426,98,13,15,65,236,12,21,0,0
4033,1262,187,1326,414,98,13,15,64,227,13,21,0,0
4034,1271,183,1329,379,98,13,15,58,196,14,21,0,0
4035,1282,185,1327,325,98,13,15,45,140,15,21,0,0
4036,1288,181,1335,330,98,13,15,47,149,16,21,0,0
4037,1277,177,1341,376,98,13,15,64,199,17,21,0,0
4038,1276,177,1345,389,98,13,15,69,212,18,21,0,0
4039,1284,178,1342,348,98,13,15,58,170,19,21,0,0
4040,1287,178,1335,314,98,13,15,48,136,20,21,0,0
4041,1293,175,1330,273,98,13,15,37,98,21,21,1,0
4032,1315,286,1428,639,99,13,15,113,353,0,53,0,1
4033,1302,274,1423,652,99,13,15,121,378,1,53,0,0
4034,1263,266,1384,643,99,13,15,121,377,2,53,0,0
4035,1225,234,1354,635,99,13,15,129,401,3,53,0,0
4036,1208,236,1325,603,99,13,15,117,367,4,53,0,0
4037,1192,232,1307,590,99,13,15,115,358,5,53,0,0
4038,1181,233,1289,571,99,13,15,108,338,6,53,0,0
4039,1167,230,1267,545,99,13,15,100,315,7,53,0,0
4040,1153,224,1251,533,99,13,15,98,309,8,53,0,0
4041,1141,213,1236,511,99,13,15,95,298,9,53,0,0
4042,1132,205,1226,499,99,13,15,94,294,10,53,0,0
4043,1127,205,1219,496,99,13,15,92,291,11,53,0,0
4044,1129,199,1216,477,99,13,15,87,278,12,53,0,0
4045,1130,197,1215,469,99,13,15,85,272,13,53,0,0
4046,1135,193,1217,459,99,13,15,82,266,14,53,0,0
4047,1134,189,1212,444,99,13,15,78,255,15,53,0,0
4048,1138,188,1214,438,99,13,15,76,250,16,53,0,0
4049,1148,186,1220,419,99,13,15,72,233,17,53,0,0
4050,1157,181,1227,411,99,13,15,70,230,18,53,0,0
4051,1163,180,1231,406,99,13,15,68,226,19,53,0,0
4052,1168,175,1233,392,99,13,15,65,217,20,53,0,0
4053,1173,174,1235,379,99,13,15,62,205,21,53,0,0
4054,1182,174,1240,365,99,13,15,58,191,22,53,0,0
4055,1189,171,1248,366,99,13,15,59,195,23,53,0,0
4056,1195,169,1254,365,99,13,15,59,196,24,53,0,0
4057,1201,166,1256,350,99,13,15,55,184,25,53,0,0
4058,1203,159,1261,352,99,13,15,58,193,26,53,0,0
4059,1207,162,1265,352,99,13,15,58,190,27,53,0,0
4060,1212,153,1270,343,99,13,15,58,190,28,53,0,0
4061,1217,150,1275,340,99,13,15,58,190,29,53,0,0
4062,1219,144,1277,337,99,13,15,58,193,30,53,0,0
4063,1218,139,1274,328,99,13,15,56,189,31,53,0,0
4064,1218,141,1274,322,99,13,15,56,181,32,53,0,0
4065,1221,144,1274,313,99,13,15,53,169,33,53,0,0
4066,1223,142,1275,308,99,13,15,52,166,34,53,0,0
4067,1223,142,1274,305,99,13,15,51,163,35,53,0,0
4068,1224,145,1271,298,99,13,15,47,153,36,53,0,0
4069,1224,144,1272,297,99,13,15,48,153,37,53,0,0
4070,1225,144,1270,288,99,13,15,45,144,38,53,0,0
4071,1226,140,1271,283,99,13,15,45,143,39,53,0,0
4072,1226,139,1270,281,99,13,15,44,142,40,53,0,0
4073,1226,138,1268,273,99,13,15,42,135,41,53,0,0
4074,1222,133,1265,270,99,13,15,43,137,42,53,0,0
4075,1220,135,1262,267,99,13,15,42,132,43,53,0,0
4076,1218,134,1259,264,99,13,15,41,130,44,53,0,0
4077,1215,133,1256,262,99,13,15,41,129,45,53,0,0
4078,1211,131,1252,258,99,13,15,41,127,46,53,0,0
4079,1206,130,1246,255,99,13,15,40,125,47,53,0,0
4080,1200,129,1240,253,99,13,15,40,124,48,53,0,0
4081,1192,127,1233,253,99,13,15,41,126,49,53,0,0
4082,1184,126,1223,250,99,13,15,39,124,50,53,0,0
4083,1177,126,1216,247,99,13,15,39,121,51,53,0,0
4084,1170,123,1207,241,99,13,15,37,118,52,53,0,0
4085,1166,122,1202,237,99,13,15,36,115,53,53,1,0
4037,1357,199,1446,551,100,13,15,89,352,0,50,0,1
4038,1329,208,1414,539,100,13,15,85,331,1,50,0,0
4039,1324,206,1409,535,100,13,15,85,329,2,50,0,0
4040,1311,202,1395,526,100,13,15,84,324,3,50,0,0
4041,1301,198,1385,523,100,13,15,84,325,4,50,0,0
4042,1294,191,1377,505,100,13,15,83,314,5,50,0,0
4043,1288,181,1372,493,100,13,15,84,312,6,50,0,0
4044,1281,182,1364,485,100,13,15,83,303,7,50,0,0
4045,1273,179,1355,472,100,13,15,82,293,8,50,0,0
4046,1265,177,1346,463,100,13,15,81,286,9,50,0,0
4047,1264,178,1346,460,100,13,15,82,282,10,50,0,0
4048,1267,173,1345,440,100,13,15,78,267,11,50,0,0
4049,1270,170,1347,430,100,13,15,77,260,12,50,0,0
4050,1273,172,1348,423,100,13,15,75,251,13,50,0,0
4051,1273,164,1350,413,100,13,15,77,249,14,50,0,0
4052,1273,161,1350,409,100,13,15,77,248,15,50,0,0
4053,1280,162,1355,399,100,13,15,75,237,16,50,0,0
4054,1288,160,1360,388,100,13,15,72,228,17,50,0,0
4055,1293,162,1363,381,100,13,15,70,219,18,50,0,0
4056,1294,154,1363,372,100,13,15,69,218,19,50,0,0
4057,1292,150,1361,367,100,13,15,69,217,20,50,0,0
4058,1292,150,1360,367,100,13,15,68,217,21,50,0,0
4059,1299,156,1367,368,100,13,15,68,212,22,50,0,0
4060,1303,153,1369,360,100,13,15,66,207,23,50,0,0
4061,1305,157,1369,354,100,13,15,64,197,24,50,0,0
4062,1307,156,1369,348,100,13,15,62,192,25,50,0,0
4063,1310,163,1368,339,100,13,15,58,176,26,50,0,0
4064,1307,155,1368,333,100,13,15,61,178,27,50,0,0
4065,1305,144,1368,328,100,13,15,63,184,28,50,0,0
4066,1303,142,1365,324,100,13,15,62,182,29,50,0,0
4067,1301,140,1360,317,100,13,15,59,177,30,50,0,0
4068,1299,139,1358,315,100,13,15,59,176,31,50,0,0
4069,1297,139,1356,316,100,13,15,59,177,32,50,0,0
4070,1300,137,1355,305,100,13,15,55,168,33,50,0,0
4071,1302,134,1358,303,100,13,15,56,169,34,50,0,0
4072,1303,134,1356,296,100,13,15,53,162,35,50,0,0
4073,1301,129,1353,286,100,13,15,52,157,36,50,0,0
4074,1298,125,1352,289,100,13,15,54,164,37,50,0,0
4075,1297,127,1350,286,100,13,15,53,159,38,50,0,0
4076,1294,125,1344,275,100,13,15,50,150,39,50,0,0
4077,1291,125,1337,259,100,13,15,46,134,40,50,0,0
4078,1283,123,1327,249,100,13,15,44,126,41,50,0,0
4079,1271,119,1322,263,100,13,15,51,144,42,50,0,0
4080,1264,119,1312,255,100,13,15,48,136,43,50,0,0
4081,1253,119,1302,255,100,13,15,49,136,44,50,0,0
4082,1247,118,1294,249,100,13,15,47,131,45,50,0,0
4083,1238,121,1282,245,100,13,15,44,124,46,50,0,0
4084,1223,120,1269,247,100,13,15,46,127,47,50,0,0
4085,1216,119,1261,244,100,13,15,45,125,48,50,0,0
4086,1195,114,1243,248,100,13,15,48,134,49,50,0,0
4087,1187,113,1234,245,100,13,15,47,132,50,50,1,0
4065,1203,138,1238,219,103,13,15,35,81,0,4,0,0
4066,1193,135,1229,218,103,13,15,36,83,1,4,0,0
4067,1182,133,1219,219,103,13,15,37,86,2,4,0,0
4068,1173,132,1212,224,103,13,15,39,92,3,4,0,0
4069,1166,131,1206,226,103,13,15,40,95,4,4,0,0
4070,1178,131,1216,218,104,13,15,38,87,0,1,0,0
4071,1173,153,1208,232,104,13,15,35,79,1,1,0,0
4429,1319,496,1415,621,105,13,15,96,125,0,0,0,0
4429,1299,457,1434,873,106,13,15,135,416,0,16,0,0
4430,1261,331,1432,861,106,13,15,171,530,1,16,0,0
4431,1179,319,1362,872,106,13,15,183,553,2,16,0,0
4432,1109,317,1293,873,106,13,15,184,556,3,16,0,0
4433,1009,317,1208,912,106,13,15,199,595,4,16,0,0
4434,927,329,1137,947,106,13,15,210,618,5,16,0,0
4435,846,338,1057,960,106,13,15,211,622,6,16,0,0
4436,757,362,977,992,106,13,15,220,630,7,16,0,0
4437,700,377,926,1022,106,13,15,226,645,8,16,0,0
4438,600,390,840,1066,106,13,15,240,676,9,16,0,0
4439,517,431,758,1079,106,13,15,241,648,10,16,0,0
4440,408,461,644,1080,106,13,15,236,619,11,16,0,0
4441,321,505,553,1080,106,13,15,232,575,12,16,0,0
4442,201,561,418,1080,106,13,15,217,519,13,16,0,0
4443,89,604,299,1080,106,13,15,210,476,14,16,0,0
4444,33,692,215,1080,106,13,15,182,388,15,16,0,0
4445,0,724,126,1080,106,13,15,126,356,16,16,0,0
4477,1371,248,1437,614,107,13,15,66,366,0,32,0,1
4478,1358,261,1422,614,107,13,15,64,353,1,32,0,0
4479,1317,269,1385,627,107,13,15,68,358,2,32,0,0
4480,1296,274,1368,640,107,13,15,72,366,3,32,0,0
4481,1268,273,1343,648,107,13,15,75,375,4,32,0,0
4482,1243,274,1322,661,107,13,15,79,387,5,32,0,0
4483,1217,281,1300,676,107,13,15,83,395,6,32,0,0
4484,1188,283,1275,686,107,13,15,87,403,7,32,0,0
4485,1155,287,1246,691,107,13,15,91,404,8,32,0,0
4486,1115,290,1215,712,107,13,15,100,422,9,32,0,0
4487,1090,299,1193,716,107,13,15,103,417,10,32,0,0
4488,1055,302,1162,730,107,13,15,107,428,11,32,0,0
4489,1019,312,1134,766,107,13,15,115,454,12,32,0,0
4490,989,319,1108,783,107,13,15,119,464,13,32,0,0
4491,962,326,1081,782,107,13,15,119,456,14,32,0,0
4492,925,338,1051,812,107,13,15,126,474,15,32,0,0
4493,891,346,1022,834,107,13,15,131,488,16,32,0,0
4494,855,347,992,850,107,13,15,137,503,17,32,0,0
4495,823,360,972,900,107,13,15,149,540,18,32,0,0
4496,789,378,944,937,107,13,15,155,559,19,32,0,0
4497,748,393,906,954,107,13,15,158,561,20,32,0,0
4498,700,408,862,984,107,13,15,162,576,21,32,0,0
4499,651,439,816,1022,107,13,15,165,583,22,32,0,0
4500,601,447,768,1041,107,13,15,167,594,23,32,0,0
4501,554,462,721,1043,107,13,15,167,581,24,32,0,0
4502,521,509,673,1017,107,13,15,152,508,25,32,0,0
4503,495,540,626,934,107,13,15,131,394,26,32,0,0
4504,439,568,590,997,107,13,15,151,429,27,32,0,0
4505,387,609,550,1050,107,13,15,163,441,28,32,0,0
4506,316,644,483,1071,107,13,15,167,427,29,32,0,0
4507,244,680,414,1080,107,13,15,170,400,30,32,0,0
4508,178,737,337,1077,107,13,15,159,340,31,32,0,0
4509,131,766,284,1080,107,13,15,153,314,32,32,1,0
4485,1342,239,1438,588,108,13,15,96,349,0,0,0,0
4485,1269,281,1432,812,109,13,15,163,531,0,19,0,1
4486,1269,299,1426,812,109,13,15,157,513,1,19,0,0
4487,1233,308,1403,859,109,13,15,170,551,2,19,0,0
4488,1198,326,1375,893,109,13,15,177,567,3,19,0,0
4489,1180,339,1358,900,109,13,15,178,561,4,19,0,0
4490,1120,345,1306,913,109,13,15,186,568,5,19,0,0
4491,1073,360,1273,961,109,13,15,200,601,6,19,0,0
4492,1047,370,1251,979,109,13,15,204,609,7,19,0,0
4493,1010,389,1233,1045,109,13,15,223,656,8,19,0,0
4494,988,417,1216,1070,109,13,15,228,653,9,19,0,0
4495,965,446,1189,1077,109,13,15,224,631,10,19,0,0
4496,927,473,1147,1080,109,13,15,220,607,11,19,0,0
4497,883,500,1098,1080,109,13,15,215,580,12,19,0,0
4498,827,534,1039,1080,109,13,15,212,546,13,19,0,0
4499,779,565,993,1080,109,13,15,214,515,14,19,0,0
4500,745,621,950,1080,109,13,15,205,459,15,19,0,0
4501,713,681,906,1078,109,13,15,193,397,16,19,0,0
4502,665,746,846,1077,109,13,15,181,331,17,19,0,0
4503,576,823,733,1074,109,13,15,157,251,18,19,0,0
4504,537,868,669,1080,109,13,15,132,212,19,19,0,0
4486,1362,244,1429,337,110,13,15,67,93,0,0,0,0
4487,1322,252,1421,434,111,13,15,99,182,0,29,0,1
4488,1280,252,1385,445,111,13,15,105,193,1,29,0,0
4489,1220,245,1342,469,111,13,15,122,224,2,29,0,0
4490,1177,243,1299,464,111,13,15,122,221,3,29,0,0
4491,1152,249,1273,470,111,13,15,121,221,4,29,0,0
4492,1117,250,1245,487,111,13,15,128,237,5,29,0,0
4493,1082,258,1212,499,111,13,15,130,241,6,29,0,0
4494,1041,268,1174,518,111,13,15,133,250,7,29,0,0
4495,990,272,1133,539,111,13,15,143,267,8,29,0,0
4496,938,273,1099,570,111,13,15,161,297,9,29,0,0
4497,898,284,1066,598,111,13,15,168,314,10,29,0,0
4498,849,287,1039,648,111,13,15,190,361,11,29,0,0
4499,803,291,1008,691,111,13,15,205,400,12,29,0,0
4500,754,306,976,749,111,13,15,222,443,13,29,0,0
4501,692,312,928,790,111,13,15,236,478,14,29,0,0
4502,636,325,890,845,111,13,15,254,520,15,29,0,0
4503,593,341,865,910,111,13,15,272,569,16,29,0,0
4504,553,354,833,955,111,13,15,280,601,17,29,0,0
4505,517,371,799,991,111,13,15,282,620,18,29,0,0
4506,478,394,762,1026,111,13,15,284,632,19,29,0,0
4507,412,401,704,1059,111,13,15,292,658,20,29,0,0
4508,352,415,647,1078,111,13,15,295,663,21,29,0,0
4509,322,439,608,1080,111,13,15,286,641,22,29,0,0
4510,281,465,559,1080,111,13,15,278,615,23,29,0,0
4511,233,499,500,1080,111,13,15,267,581,24,29,0,0
4512,147,544,401,1076,111,13,15,254,532,25,29,0,0
4513,94,578,339,1080,111,13,15,245,502,26,29,0,0
4514,43,638,265,1073,111,13,15,222,435,27,29,0,0
4515,17,709,202,1062,111,13,15,185,353,28,29,0,0
4516,0,740,147,1072,111,13,15,147,332,29,29,1,0
4488,1373,308,1432,525,112,13,15,59,217,0,0,0,0
4489,1329,310,1423,736,113,13,15,94,426,0,27,0,1
4490,1305,307,1401,740,113,13,15,96,433,1,27,0,0
4491,1272,310,1369,743,113,13,15,97,433,2,27,0,0
4492,1232,309,1331,746,113,13,15,99,437,3,27,0,0
4493,1198,314,1295,737,113,13,15,97,423,4,27,0,0
4494,1165,326,1253,697,113,13,15,88,371,5,27,0,0
4495,1136,326,1224,683,113,13,15,88,357,6,27,0,0
4496,1104,332,1212,764,113,13,15,108,432,7,27,0,0
4497,1073,348,1189,797,113,13,15,116,449,8,27,0,0
4498,1034,344,1156,799,113,13,15,122,455,9,27,0,0
4499,991,345,1121,826,113,13,15,130,481,10,27,0,0
4500,951,358,1094,877,113,13,15,143,519,11,27,0,0
4501,913,379,1060,901,113,13,15,147,522,12,27,0,0
4502,876,391,1035,951,113,13,15,159,560,13,27,0,0
4503,841,404,1004,963,113,13,15,163,559,14,27,0,0
4504,793,423,971,1016,113,13,15,178,593,15,27,0,0
4505,762,445,946,1052,113,13,15,184,607,16,27,0,0
4506,727,461,916,1072,113,13,15,189,611,17,27,0,0
4507,696,489,883,1080,113,13,15,187,591,18,27,0,0
4508,667,534,847,1077,113,13,15,180,543,19,27,0,0
4509,627,563,808,1076,113,13,15,181,513,20,27,0,0
4510,575,603,758,1080,113,13,15,183,477,21,27,0,0
4511,508,670,681,1073,113,13,15,173,403,22,27,0,0
4512,416,720,586,1073,113,13,15,170,353,23,27,0,0
4513,309,751,485,1078,113,13,15,176,327,24,27,0,0
4514,229,844,373,1077,113,13,15,144,233,25,27,0,0
4515,127,904,251,1079,113,13,15,124,175,26,27,0,0
4516,65,949,161,1080,113,13,15,96,131,27,27,1,0
4493,1318,353,1448,861,114,13,15,130,508,0,16,0,0
4494,1280,372,1414,891,114,13,15,134,519,1,16,0,0
4495,1261,386,1393,896,114,13,15,132,510,2,16,0,0
4496,1220,395,1360,921,114,13,15,140,526,3,16,0,0
4497,1181,422,1331,975,114,13,15,150,553,4,16,0,0
4498,1154,433,1313,1008,114,13,15,159,575,5,16,0,0
4499,1135,453,1305,1051,114,13,15,170,598,6,16,0,0
4500,1111,489,1284,1074,114,13,15,173,585,7,16,0,0
4501,1089,511,1265,1080,114,13,15,176,569,8,16,0,0
4502,1074,542,1247,1079,114,13,15,173,537,9,16,0,0
4503,1056,586,1223,1080,114,13,15,167,494,10,16,0,0
4504,1028,629,1191,1080,114,13,15,163,451,11,16,0,0
4505,992,669,1154,1080,114,13,15,162,411,12,16,0,0
4506,955,729,1110,1080,114,13,15,155,351,13,16,0,0
4507,922,771,1072,1080,114,13,15,150,309,14,16,0,0
4508,887,844,1018,1077,114,13,15,131,233,15,16,0,0
4509,865,886,976,1080,114,13,15,111,194,16,16,0,0
4702,1267,139,1303,268,118,13,15,36,129,0,55,0,1
4703,1268,137,1305,267,118,13,15,37,130,1,55,0,0
4704,1269,137,1308,273,118,13,15,39,136,2,55,0,0
4705,1271,135,1312,277,118,13,15,41,142,3,55,0,0
4706,1274,136,1315,278,118,13,15,41,142,4,55,0,0
4707,1274,137,1316,280,118,13,15,42,143,5,55,0,0
4708,1272,137,1315,280,118,13,15,43,143,6,55,0,0
4709,1271,138,1315,286,118,13,15,44,148,7,55,0,0
4710,1272,139,1317,290,118,13,15,45,151,8,55,0,0
4711,1273,141,1319,293,118,13,15,46,152,9,55,0,0
4712,1272,144,1319,296,118,13,15,47,152,10,55,0,0
4713,1271,145,1318,297,118,13,15,47,152,11,55,0,0
4714,1270,146,1317,300,118,13,15,47,154,12,55,0,0
4715,1268,148,1317,308,118,13,15,49,160,13,55,0,0
4716,1268,150,1317,312,118,13,15,49,162,14,55,0,0
4717,1264,149,1316,317,118,13,15,52,168,15,55,0,0
4718,1259,151,1311,320,118,13,15,52,169,16,55,0,0
4719,1255,152,1306,317,118,13,15,51,165,17,55,0,0
4720,1251,151,1303,321,118,13,15,52,170,18,55,0,0
4721,1250,156,1300,320,118,13,15,50,164,19,55,0,0
4722,1245,154,1298,328,118,13,15,53,174,20,55,0,0
4723,1241,156,1296,333,118,13,15,55,177,21,55,0,0
4724,1235,159,1290,338,118,13,15,55,179,22,55,0,0
4725,1232,160,1287,337,118,13,15,55,177,23,55,0,0
4726,1229,165,1285,345,118,13,15,56,180,24,55,0,0
4727,1228,167,1284,349,118,13,15,56,182,25,55,0,0
4728,1222,168,1281,356,118,13,15,59,188,26,55,0,0
4729,1217,170,1278,366,118,13,15,61,196,27,55,0,0
4730,1212,170,1275,370,118,13,15,63,200,28,55,0,0
4731,1211,172,1274,372,118,13,15,63,200,29,55,0,0
4732,1208,173,1272,377,118,13,15,64,204,30,55,0,0
4733,1206,175,1269,374,118,13,15,63,199,31,55,0,0
4734,1200,176,1265,382,118,13,15,65,206,32,55,0,0
4735,1195,177,1261,388,118,13,15,66,211,33,55,0,0
4736,1193,177,1261,392,118,13,15,68,215,34,55,0,0
4737,1191,180,1263,412,118,13,15,72,232,35,55,0,0
4738,1194,182,1263,397,118,13,15,69,215,36,55,0,0
4739,1191,183,1263,411,118,13,15,72,228,37,55,0,0
4740,1186,189,1260,421,118,13,15,74,232,38,55,0,0
4741,1184,192,1256,421,118,13,15,72,229,39,55,0,0
4742,1183,193,1260,431,118,13,15,77,238,40,55,0,0
4743,1183,197,1262,437,118,13,15,79,240,41,55,0,0
4744,1184,197,1264,441,118,13,15,80,244,42,55,0,0
4745,1182,201,1265,455,118,13,15,83,254,43,55,0,0
4746,1181,203,1266,463,118,13,15,85,260,44,55,0,0
4747,1183,205,1270,471,118,13,15,87,266,45,55,0,0
4748,1188,212,1279,489,118,13,15,91,277,46,55,0,0
4749,1202,215,1295,496,118,13,15,93,281,47,55,0,0
4750,1218,221,1312,503,118,13,15,94,282,48,55,0,0
4751,1235,224,1330,507,118,13,15,95,283,49,55,0,0
4752,1243,229,1337,512,118,13,15,94,283,50,55,0,0
4753,1264,239,1355,519,118,13,15,91,280,51,55,0,0
4754,1291,239,1384,533,118,13,15,93,294,52,55,0,0
4755,1327,242,1409,506,118,13,15,82,264,53,55,0,0
4756,1355,251,1433,514,118,13,15,78,263,54,55,0,0
4757,1367,255,1446,518,118,13,15,79,263,55,55,1,0
4696,1188,125,1224,247,120,13,15,36,122,0,62,0,1
4697,1191,127,1227,250,120,13,15,36,123,1,62,0,0
4698,1194,129,1232,257,120,13,15,38,128,2,62,0,0
4699,1199,130,1237,258,120,13,15,38,128,3,62,0,0
4700,1203,130,1241,258,120,13,15,38,128,4,62,0,0
4701,1206,125,1248,264,120,13,15,42,139,5,62,0,0
4702,1209,124,1251,263,120,13,15,42,139,6,62,0,0
4703,1210,125,1252,264,120,13,15,42,139,7,62,0,0
4704,1209,126,1251,264,120,13,15,42,138,8,62,0,0
4705,1208,126,1252,269,120,13,15,44,143,9,62,0,0
4706,1209,129,1254,273,120,13,15,45,144,10,62,0,0
4707,1211,131,1255,273,120,13,15,44,142,11,62,0,0
4708,1210,132,1256,279,120,13,15,46,147,12,62,0,0
4709,1208,134,1255,283,120,13,15,47,149,13,62,0,0
4710,1204,132,1252,282,120,13,15,48,150,14,62,0,0
4711,1202,132,1250,284,120,13,15,48,152,15,62,0,0
4712,1200,134,1248,288,120,13,15,48,154,16,62,0,0
4713,1199,136,1246,287,120,13,15,47,151,17,62,0,0
4714,1198,138,1245,287,120,13,15,47,149,18,62,0,0
4715,1195,140,1245,299,120,13,15,50,159,19,62,0,0
4716,1192,140,1242,300,120,13,15,50,160,20,62,0,0
4717,1189,139,1241,301,120,13,15,52,162,21,62,0,0
4718,1187,142,1241,308,120,13,15,54,166,22,62,0,0
4719,1188,145,1243,310,120,13,15,55,165,23,62,0,0
4720,1188,146,1244,311,120,13,15,56,165,24,62,0,0
4721,1184,144,1244,320,120,13,15,60,176,25,62,0,0
4722,1175,141,1239,327,120,13,15,64,186,26,62,0,0
4723,1171,143,1233,328,120,13,15,62,185,27,62,0,0
4724,1167,147,1230,335,120,13,15,63,188,28,62,0,0
4725,1166,150,1228,334,120,13,15,62,184,29,62,0,0
4726,1159,151,1221,335,120,13,15,62,184,30,62,0,0
4727,1148,151,1212,339,120,13,15,64,188,31,62,0,0
4728,1140,152,1204,341,120,13,15,64,189,32,62,0,0
4729,1136,156,1201,349,120,13,15,65,193,33,62,0,0
4730,1133,161,1198,354,120,13,15,65,193,34,62,0,0
4731,1131,161,1198,360,120,13,15,67,199,35,62,0,0
4732,1125,166,1193,371,120,13,15,68,205,36,62,0,0
4733,1116,167,1187,383,120,13,15,71,216,37,62,0,0
4734,1109,167,1180,387,120,13,15,71,220,38,62,0,0
4735,1105,170,1175,392,120,13,15,70,222,39,62,0,0
4736,1102,171,1173,397,120,13,15,71,226,40,62,0,0
4737,1099,171,1171,399,120,13,15,72,228,41,62,0,0
4738,1092,175,1168,414,120,13,15,76,239,42,62,0,0
4739,1087,179,1164,420,120,13,15,77,241,43,62,0,0
4740,1081,179,1160,426,120,13,15,79,247,44,62,0,0
4741,1077,182,1159,433,120,13,15,82,251,45,62,0,0
4742,1076,184,1159,442,120,13,15,83,258,46,62,0,0
4743,1075,188,1158,446,120,13,15,83,258,47,62,0,0
4744,1073,193,1158,456,120,13,15,85,263,48,62,0,0
4745,1068,197,1156,466,120,13,15,88,269,49,62,0,0
4746,1071,199,1161,474,120,13,15,90,275,50,62,0,0
4747,1085,204,1176,487,120,13,15,91,283,51,62,0,0
4748,1101,206,1195,495,120,13,15,94,289,52,62,0,0
4749,1111,207,1209,510,120,13,15,98,303,53,62,0,0
4750,1125,216,1225,521,120,13,15,100,305,54,62,0,0
4751,1142,220,1242,527,120,13,15,100,307,55,62,0,0
4752,1167,225,1267,538,120,13,15,100,313,56,62,0,0
4753,1188,236,1293,555,120,13,15,105,319,57,62,0,0
4754,1219,241,1323,555,120,13,15,104,314,58,62,0,0
4755,1251,244,1360,578,120,13,15,109,334,59,62,0,0
4756,1276,248,1391,593,120,13,15,115,345,60,62,0,0
4757,1314,250,1430,602,120,13,15,116,352,61,62,0,0
4758,1329,253,1447,612,120,13,15,118,359,62,62,1,0
4724,2,852,205,1074,121,13,15,203,222,0,0,0,0
4725,92,807,332,1073,122,13,15,240,266,0,0,0,0
4726,222,764,489,1072,123,13,15,267,308,0,17,0,0
4727,295,704,612,1072,123,13,15,317,368,1,17,0,0
4728,408,665,760,1070,123,13,15,352,405,2,17,0,0
4729,496,614,889,1067,123,13,15,393,453,3,17,0,0
4730,540,557,980,1072,123,13,15,440,515,4,17,0,0
4731,604,523,1065,1073,123,13,15,461,550,5,17,0,0
4732,652,486,1128,1071,123,13,15,476,585,6,17,0,0
4733,723,446,1216,1069,123,13,15,493,623,7,17,0,0
4734,794,434,1282,1069,123,13,15,488,635,8,17,0,0
4735,851,408,1314,1031,123,13,15,463,623,9,17,0,0
4736,907,384,1329,973,123,13,15,422,589,10,17,0,0
4737,960,381,1353,944,123,13,15,393,563,11,17,0,0
4738,1035,371,1388,892,123,13,15,353,521,12,17,0,0
4739,1110,354,1455,881,123,13,15,345,527,13,17,0,0
4740,1150,349,1483,874,123,13,15,333,525,14,17,0,0
4741,1211,339,1513,838,123,13,15,302,499,15,17,0,0
4742,1247,330,1524,817,123,13,15,277,487,16,17,0,0
4743,1299,310,1579,799,123,13,15,280,489,17,17,0,0
4743,1328,658,1409,813,124,13,15,81,155,0,0,0,0
4817,1175,137,1215,242,125,13,15,40,105,0,0,0,0
4818,1197,137,1237,235,126,13,15,40,98,0,21,0,1
4819,1207,142,1255,259,126,13,15,48,117,1,21,0,0
4820,1215,140,1266,267,126,13,15,51,127,2,21,0,0
4821,1227,141,1277,265,126,13,15,50,124,3,21,0,0
4822,1233,140,1288,279,126,13,15,55,139,4,21,0,0
4823,1239,144,1296,289,126,13,15,57,145,5,21,0,0
4824,1243,146,1301,299,126,13,15,58,153,6,21,0,0
4825,1241,146,1306,317,126,13,15,65,171,7,21,0,0
4826,1243,152,1308,326,126,13,15,65,174,8,21,0,0
4827,1242,154,1309,338,126,13,15,67,184,9,21,0,0
4828,1241,160,1307,343,126,13,15,66,183,10,21,0,0
4829,1238,170,1307,363,126,13,15,69,193,11,21,0,0
4830,1233,170,1307,380,126,13,15,74,210,12,21,0,0
4831,1230,180,1305,397,126,13,15,75,217,13,21,0,0
4832,1227,183,1306,416,126,13,15,79,233,14,21,0,0
4833,1229,189,1310,429,126,13,15,81,240,15,21,0,0
4834,1233,202,1316,448,126,13,15,83,246,16,21,0,0
4835,1242,204,1329,466,126,13,15,87,262,17,21,0,0
4836,1265,218,1352,480,126,13,15,87,262,18,21,0,0
4837,1294,228,1384,494,126,13,15,90,266,19,21,0,0
4838,1320,235,1412,502,126,13,15,92,267,20,21,0,0
4839,1328,240,1422,514,126,13,15,94,274,21,21,1,0
4858,1254,131,1290,266,127,13,15,36,135,0,54,0,1
4859,1259,131,1296,268,127,13,15,37,137,1,54,0,0
4860,1262,132,1300,271,127,13,15,38,139,2,54,0,0
4861,1264,133,1302,271,127,13,15,38,138,3,54,0,0
4862,1265,133,1304,272,127,13,15,39,139,4,54,0,0
4863,1265,134,1305,276,127,13,15,40,142,5,54,0,0
4864,1266,135,1308,280,127,13,15,42,145,6,54,0,0
4865,1268,137,1311,283,127,13,15,43,146,7,54,0,0
4866,1268,139,1311,287,127,13,15,43,148,8,54,0,0
4867,1267,142,1311,289,127,13,15,44,147,9,54,0,0
4868,1264,142,1310,292,127,13,15,46,150,10,54,0,0
4869,1263,141,1309,294,127,13,15,46,153,11,54,0,0
4870,1263,143,1311,299,127,13,15,48,156,12,54,0,0
4871,1265,143,1314,303,127,13,15,49,160,13,54,0,0
4872,1266,143,1316,306,127,13,15,50,163,14,54,0,0
4873,1265,144,1317,311,127,13,15,52,167,15,54,0,0
4874,1265,145,1317,313,127,13,15,52,168,16,54,0,0
4875,1265,145,1318,315,127,13,15,53,170,17,54,0,0
4876,1265,148,1319,320,127,13,15,54,172,18,54,0,0
4877,1267,148,1322,325,127,13,15,55,177,19,54,0,0
4878,1270,148,1326,328,127,13,15,56,180,20,54,0,0
4879,1269,149,1326,333,127,13,15,57,184,21,54,0,0
4880,1267,149,1326,336,127,13,15,59,187,22,54,0,0
4881,1264,150,1324,339,127,13,15,60,189,23,54,0,0
4882,1262,148,1326,350,127,13,15,64,202,24,54,0,0
4883,1262,150,1328,355,127,13,15,66,205,25,54,0,0
4884,1263,151,1329,356,127,13,15,66,205,26,54,0,0
4885,1263,151,1331,361,127,13,15,68,210,27,54,0,0
4886,1263,159,1333,374,127,13,15,70,215,28,54,0,0
4887,1261,159,1330,371,127,13,15,69,212,29,54,0,0
4888,1259,161,1329,377,127,13,15,70,216,30,54,0,0
4889,1259,168,1330,386,127,13,15,71,218,31,54,0,0
4890,1259,171,1331,388,127,13,15,72,217,32,54,0,0
4891,1259,171,1332,390,127,13,15,73,219,33,54,0,0
4892,1252,173,1328,397,127,13,15,76,224,34,54,0,0
4893,1241,175,1320,405,127,13,15,79,230,35,54,0,0
4894,1233,173,1312,406,127,13,15,79,233,36,54,0,0
4895,1227,174,1308,413,127,13,15,81,239,37,54,0,0
4896,1224,174,1309,425,127,13,15,85,251,38,54,0,0
4897,1223,173,1309,427,127,13,15,86,254,39,54,0,0
4898,1221,172,1309,432,127,13,15,88,260,40,54,0,0
4899,1217,177,1305,439,127,13,15,88,262,41,54,0,0
4900,1211,177,1301,448,127,13,15,90,271,42,54,0,0
4901,1213,178,1303,455,127,13,15,90,277,43,54,0,0
4902,1220,183,1312,465,127,13,15,92,282,44,54,0,0
4903,1228,185,1322,474,127,13,15,94,289,45,54,0,0
4904,1242,187,1337,476,127,13,15,95,289,46,54,0,0
4905,1255,194,1351,488,127,13,15,96,294,47,54,0,0
4906,1268,196,1366,497,127,13,15,98,301,48,54,0,0
4907,1292,195,1392,498,127,13,15,100,303,49,54,0,0
4908,1309,200,1411,502,127,13,15,102,302,50,54,0,0
4909,1314,207,1419,509,127,13,15,105,302,51,54,0,0
4910,1344,209,1442,502,127,13,15,98,293,52,54,0,0
4911,1359,227,1450,514,127,13,15,91,287,53,54,0,0
4912,1368,232,1460,520,127,13,15,92,288,54,54,1,0
4858,1192,120,1227,270,128,13,15,35,150,0,56,0,1
4859,1194,121,1230,271,128,13,15,36,150,1,56,0,0
4860,1193,121,1232,277,128,13,15,39,156,2,56,0,0
4861,1192,120,1232,281,128,13,15,40,161,3,56,0,0
4862,1194,124,1233,280,128,13,15,39,156,4,56,0,0
4863,1196,125,1237,282,128,13,15,41,157,5,56,0,0
4864,1197,126,1239,284,128,13,15,42,158,6,56,0,0
4865,1198,130,1240,286,128,13,15,42,156,7,56,0,0
4866,1197,131,1240,289,128,13,15,43,158,8,56,0,0
4867,1197,130,1242,291,128,13,15,45,161,9,56,0,0
4868,1196,132,1242,295,128,13,15,46,163,10,56,0,0
4869,1196,133,1243,296,128,13,15,47,163,11,56,0,0
4870,1197,134,1245,298,128,13,15,48,164,12,56,0,0
4871,1195,135,1245,302,128,13,15,50,167,13,56,0,0
4872,1193,136,1244,305,128,13,15,51,169,14,56,0,0
4873,1191,136,1243,307,128,13,15,52,171,15,56,0,0
4874,1189,137,1242,310,128,13,15,53,173,16,56,0,0
4875,1188,137,1241,311,128,13,15,53,174,17,56,0,0
4876,1188,138,1242,313,128,13,15,54,175,18,56,0,0
4877,1185,138,1241,320,128,13,15,56,182,19,56,0,0
4878,1180,137,1239,327,128,13,15,59,190,20,56,0,0
4879,1179,138,1237,330,128,13,15,58,192,21,56,0,0
4880,1175,138,1235,337,128,13,15,60,199,22,56,0,0
4881,1174,140,1234,339,128,13,15,60,199,23,56,0,0
4882,1172,140,1233,342,128,13,15,61,202,24,56,0,0
4883,1168,144,1230,349,128,13,15,62,205,25,56,0,0
4884,1161,145,1225,356,128,13,15,64,211,26,56,0,0
4885,1156,144,1221,358,128,13,15,65,214,27,56,0,0
4886,1152,147,1217,364,128,13,15,65,217,28,56,0,0
4887,1149,148,1215,369,128,13,15,66,221,29,56,0,0
4888,1146,150,1213,369,128,13,15,67,219,30,56,0,0
4889,1145,155,1211,375,128,13,15,66,220,31,56,0,0
4890,1143,156,1209,375,128,13,15,66,219,32,56,0,0
4891,1139,157,1208,383,128,13,15,69,226,33,56,0,0
4892,1137,161,1208,394,128,13,15,71,233,34,56,0,0
4893,1137,161,1209,399,128,13,15,72,238,35,56,0,0
4894,1137,164,1210,403,128,13,15,73,239,36,56,0,0
4895,1138,167,1212,411,128,13,15,74,244,37,56,0,0
4896,1135,168,1211,419,128,13,15,76,251,38,56,0,0
4897,1135,171,1210,418,128,13,15,75,247,39,56,0,0
4898,1133,173,1211,433,128,13,15,78,260,40,56,0,0
4899,1133,175,1211,438,128,13,15,78,263,41,56,0,0
4900,1132,177,1212,445,128,13,15,80,268,42,56,0,0
4901,1131,183,1213,455,128,13,15,82,272,43,56,0,0
4902,1131,184,1217,465,128,13,15,86,281,44,56,0,0
4903,1138,185,1227,476,128,13,15,89,291,45,56,0,0
4904,1146,189,1238,488,128,13,15,92,299,46,56,0,0
4905,1161,191,1256,491,128,13,15,95,300,47,56,0,0
4906,1177,193,1275,501,128,13,15,98,308,48,56,0,0
4907,1196,197,1299,515,128,13,15,103,318,49,56,0,0
4908,1214,200,1317,520,128,13,15,103,320,50,56,0,0
4909,1236,203,1338,521,128,13,15,102,318,51,56,0,0
4910,1260,209,1368,528,128,13,15,108,319,52,56,0,0
4911,1279,210,1391,532,128,13,15,112,322,53,56,0,0
4912,1314,210,1426,538,128,13,15,112,328,54,56,0,0
4913,1335,225,1440,534,128,13,15,105,309,55,56,0,0
4914,1348,228,1454,539,128,13,15,106,311,56,56,1,0
4852,2,947,80,1080,129,13,15,78,133,0,0,0,0
4857,708,813,964,1073,134,13,15,256,260,0,0,0,0
4914,5,838,211,1068,136,13,15,206,230,0,0,0,0
4915,118,814,345,1078,137,13,15,227,264,0,0,0,0
4915,1360,250,1434,623,138,13,15,74,373,0,54,0,1
4916,1336,258,1408,615,138,13,15,72,357,1,54,0,0
4917,1302,267,1374,616,138,13,15,72,349,2,54,0,0
4918,1263,261,1337,606,138,13,15,74,345,3,54,0,0
4919,1210,267,1287,608,138,13,15,77,341,4,54,0,0
4920,1175,252,1258,608,138,13,15,83,356,5,54,0,0
4921,1148,246,1232,595,138,13,15,84,349,6,54,0,0
4922,1130,240,1213,574,138,13,15,83,334,7,54,0,0
4923,1108,231,1194,563,138,13,15,86,332,8,54,0,0
4924,1098,238,1170,500,138,13,15,72,262,9,54,0,0
4925,1071,227,1147,494,138,13,15,76,267,10,54,0,0
4926,1043,221,1133,526,138,13,15,90,305,11,54,0,0
4927,1029,221,1123,539,138,13,15,94,318,12,54,0,0
4928,1018,216,1113,530,138,13,15,95,314,13,54,0,0
4929,1005,210,1101,521,138,13,15,96,311,14,54,0,0
4930,995,212,1086,502,138,13,15,91,290,15,54,0,0
4931,990,206,1080,489,138,13,15,90,283,16,54,0,0
4932,993,204,1082,480,138,13,15,89,276,17,54,0,0
4933,1004,196,1091,464,138,13,15,87,268,18,54,0,0
4934,1016,191,1102,454,138,13,15,86,263,19,54,0,0
4935,1028,188,1112,447,138,13,15,84,259,20,54,0,0
4936,1041,182,1123,432,138,13,15,82,250,21,54,0,0
4937,1055,179,1136,424,138,13,15,81,245,22,54,0,0
4938,1069,175,1146,405,138,13,15,77,230,23,54,0,0
4939,1076,175,1154,400,138,13,15,78,225,24,54,0,0
4940,1083,171,1159,389,138,13,15,76,218,25,54,0,0
4941,1092,167,1167,382,138,13,15,75,215,26,54,0,0
4942,1105,165,1175,368,138,13,15,70,203,27,54,0,0
4943,1115,163,1185,365,138,13,15,70,202,28,54,0,0
4944,1120,162,1190,362,138,13,15,70,200,29,54,0,0
4945,1126,155,1195,354,138,13,15,69,199,30,54,0,0
4946,1135,153,1203,350,138,13,15,68,197,31,54,0,0
4947,1142,150,1210,348,138,13,15,68,198,32,54,0,0
4948,1151,149,1217,339,138,13,15,66,190,33,54,0,0
4949,1157,147,1220,331,138,13,15,63,184,34,54,0,0
4950,1162,146,1222,324,138,13,15,60,178,35,54,0,0
4951,1169,148,1226,317,138,13,15,57,169,36,54,0,0
4952,1174,147,1231,312,138,13,15,57,165,37,54,0,0
4953,1178,146,1234,309,138,13,15,56,163,38,54,0,0
4954,1182,142,1237,303,138,13,15,55,161,39,54,0,0
4955,1185,140,1240,300,138,13,15,55,160,40,54,0,0
4956,1190,140,1244,297,138,13,15,54,157,41,54,0,0
4957,1193,140,1246,293,138,13,15,53,153,42,54,0,0
4958,1194,140,1246,290,138,13,15,52,150,43,54,0,0
4959,1195,138,1245,282,138,13,15,50,144,44,54,0,0
4960,1197,137,1246,280,138,13,15,49,143,45,54,0,0
4961,1199,136,1246,273,138,13,15,47,137,46,54,0,0
4962,1200,135,1246,270,138,13,15,46,135,47,54,0,0
4963,1199,135,1244,269,138,13,15,45,134,48,54,0,0
4964,1197,132,1244,267,138,13,15,47,135,49,54,0,0
4965,1197,131,1243,263,138,13,15,46,132,50,54,0,0
4966,1195,128,1241,262,138,13,15,46,134,51,54,0,0
4967,1190,127,1235,258,138,13,15,45,131,52,54,0,0
4968,1183,125,1228,256,138,13,15,45,131,53,54,0,0
4969,1176,123,1220,252,138,13,15,44,129,54,54,1,0
4916,245,749,515,1065,139,13,15,270,316,0,14,0,0
4917,320,703,633,1071,139,13,15,313,368,1,14,0,0
4918,435,678,766,1069,139,13,15,331,391,2,14,0,0
4919,527,624,901,1071,139,13,15,374,447,3,14,0,0
4920,594,577,1000,1066,139,13,15,406,489,4,14,0,0
4921,622,538,1056,1068,139,13,15,434,530,5,14,0,0
4922,707,489,1160,1063,139,13,15,453,574,6,14,0,0
4923,800,461,1253,1051,139,13,15,453,590,7,14,0,0
4924,862,434,1302,1026,139,13,15,440,592,8,14,0,0
4925,954,401,1369,979,139,13,15,415,578,9,14,0,0
4926,986,357,1407,963,139,13,15,421,606,10,14,0,0
4927,1056,362,1435,925,139,13,15,379,563,11,14,0,0
4928,1160,373,1480,869,139,13,15,320,496,12,14,0,0
4929,1199,369,1499,849,139,13,15,300,480,13,14,0,0
4930,1262,346,1565,831,139,13,15,303,485,14,14,0,0
4920,1356,286,1426,595,140,13,15,70,309,0,54,0,1
4921,1327,282,1397,588,140,13,15,70,306,1,54,0,0
4922,1307,286,1378,586,140,13,15,71,300,2,54,0,0
4923,1283,275,1355,575,140,13,15,72,300,3,54,0,0
4924,1249,272,1320,557,140,13,15,71,285,4,54,0,0
4925,1227,270,1298,549,140,13,15,71,279,5,54,0,0
4926,1213,265,1266,462,140,13,15,53,197,6,54,0,0
4927,1195,256,1261,493,140,13,15,66,237,7,54,0,0
4928,1182,247,1255,504,140,13,15,73,257,8,54,0,0
4929,1173,242,1251,510,140,13,15,78,268,9,54,0,0
4930,1170,241,1246,503,140,13,15,76,262,10,54,0,0
4931,1166,236,1240,485,140,13,15,74,249,11,54,0,0
4932,1164,236,1239,483,140,13,15,75,247,12,54,0,0
4933,1167,227,1239,460,140,13,15,72,233,13,54,0,0
4934,1170,222,1239,444,140,13,15,69,222,14,54,0,0
4935,1169,209,1241,435,140,13,15,72,226,15,54,0,0
4936,1168,206,1241,427,140,13,15,73,221,16,54,0,0
4937,1180,205,1250,414,140,13,15,70,209,17,54,0,0
4938,1189,200,1259,407,140,13,15,70,207,18,54,0,0
4939,1193,197,1262,402,140,13,15,69,205,19,54,0,0
4940,1198,194,1265,391,140,13,15,67,197,20,54,0,0
4941,1200,195,1272,410,140,13,15,72,215,21,54,0,0
4942,1210,193,1278,393,140,13,15,68,200,22,54,0,0
4943,1218,189,1284,384,140,13,15,66,195,23,54,0,0
4944,1220,186,1285,378,140,13,15,65,192,24,54,0,0
4945,1224,182,1286,367,140,13,15,62,185,25,54,0,0
4946,1231,180,1291,356,140,13,15,60,176,26,54,0,0
4947,1236,177,1294,349,140,13,15,58,172,27,54,0,0
4948,1242,178,1297,339,140,13,15,55,161,28,54,0,0
4949,1247,178,1300,332,140,13,15,53,154,29,54,0,0
4950,1251,177,1304,326,140,13,15,53,149,30,54,0,0
4951,1253,171,1306,320,140,13,15,53,149,31,54,0,0
4952,1255,169,1306,315,140,13,15,51,146,32,54,0,0
4953,1255,167,1305,308,140,13,15,50,141,33,54,0,0
4954,1256,163,1305,304,140,13,15,49,141,34,54,0,0
4955,1258,159,1307,298,140,13,15,49,139,35,54,0,0
4956,1259,155,1308,297,140,13,15,49,142,36,54,0,0
4957,1261,155,1308,289,140,13,15,47,134,37,54,0,0
4958,1262,152,1309,285,140,13,15,47,133,38,54,0,0
4959,1263,154,1308,281,140,13,15,45,127,39,54,0,0
4960,1265,152,1309,275,140,13,15,44,123,40,54,0,0
4961,1264,150,1309,273,140,13,15,45,123,41,54,0,0
4962,1263,146,1307,268,140,13,15,44,122,42,54,0,0
4963,1261,144,1305,268,140,13,15,44,124,43,54,0,0
4964,1261,144,1304,264,140,13,15,43,120,44,54,0,0
4965,1261,142,1303,262,140,13,15,42,120,45,54,0,0
4966,1257,141,1299,260,140,13,15,42,119,46,54,0,0
4967,1251,141,1292,256,140,13,15,41,115,47,54,0,0
4968,1245,142,1285,254,140,13,15,40,112,48,54,0,0
4969,1235,141,1275,252,140,13,15,40,111,49,54,0,0
4970,1227,140,1266,248,140,13,15,39,108,50,54,0,0
4971,1215,139,1253,245,140,13,15,38,106,51,54,0,0
4972,1200,139,1239,245,140,13,15,39,106,52,54,0,0
4973,1188,146,1224,244,140,13,15,36,98,53,54,0,0
4974,1174,139,1209,236,140,13,15,35,97,54,54,1,0
5062,3,815,137,1075,149,13,15,134,260,0,16,0,0
5063,37,746,209,1077,149,13,15,172,331,1,16,0,0
5064,107,679,315,1076,149,13,15,208,397,2,16,0,0
5065,200,603,450,1077,149,13,15,250,474,3,16,0,0
5066,309,556,585,1077,149,13,15,276,521,4,16,0,0
5067,411,498,715,1074,149,13,15,304,576,5,16,0,0
5068,516,454,842,1073,149,13,15,326,619,6,16,0,0
5069,613,425,949,1070,149,13,15,336,645,7,16,0,0
5070,696,387,1034,1049,149,13,15,338,662,8,16,0,0
5071,782,373,1115,1023,149,13,15,333,650,9,16,0,0
5072,856,352,1174,986,149,13,15,318,634,10,16,0,0
5073,954,330,1267,962,149,13,15,313,632,11,16,0,0
5074,1039,326,1342,940,149,13,15,303,614,12,16,0,0
5075,1131,306,1412,890,149,13,15,281,584,13,16,0,0
5076,1179,303,1448,865,149,13,15,269,562,14,16,0,0
5077,1219,243,1492,835,149,13,15,273,592,15,16,0,0
5078,1289,210,1568,817,149,13,15,279,607,16,16,0,0
5230,851,363,1104,997,151,13,15,253,634,0,10,0,0
5231,877,352,1135,999,151,13,15,258,647,1,10,0,0
5232,917,333,1151,921,151,13,15,234,588,2,10,0,0
5233,959,316,1185,886,151,13,15,226,570,3,10,0,0
5234,991,307,1210,860,151,13,15,219,553,4,10,0,0
5235,1035,294,1238,808,151,13,15,203,514,5,10,0,0
5236,1079,297,1271,775,151,13,15,192,478,6,10,0,0
5237,1107,291,1301,766,151,13,15,194,475,7,10,0,0
5238,1183,291,1373,760,151,13,15,190,469,8,10,0,0
5239,1227,294,1416,756,151,13,15,189,462,9,10,0,0
5240,1270,290,1452,734,151,13,15,182,444,10,10,0,0
5245,1338,190,1444,640,152,13,15,106,450,0,32,0,1
5246,1323,258,1413,639,152,13,15,90,381,1,32,0,0
5247,1314,269,1401,632,152,13,15,87,363,2,32,0,0
5248,1273,273,1362,633,152,13,15,89,360,3,32,0,0
5249,1228,277,1324,644,152,13,15,96,367,4,32,0,0
5250,1196,271,1297,644,152,13,15,101,373,5,32,0,0
5251,1154,269,1262,655,152,13,15,108,386,6,32,0,0
5252,1109,278,1222,668,152,13,15,113,390,7,32,0,0
5253,1076,278,1193,673,152,13,15,117,395,8,32,0,0
5254,1038,279,1158,676,152,13,15,120,397,9,32,0,0
5255,985,286,1115,690,152,13,15,130,404,10,32,0,0
5256,944,285,1082,703,152,13,15,138,418,11,32,0,0
5257,896,286,1039,711,152,13,15,143,425,12,32,0,0
5258,854,299,1001,731,152,13,15,147,432,13,32,0,0
5259,819,307,974,753,152,13,15,155,446,14,32,0,0
5260,776,309,935,758,152,13,15,159,449,15,32,0,0
5261,720,325,885,774,152,13,15,165,449,16,32,0,0
5262,684,335,856,792,152,13,15,172,457,17,32,0,0
5263,630,343,806,810,152,13,15,176,467,18,32,0,0
5264,589,357,778,853,152,13,15,189,496,19,32,0,0
5265,559,369,762,897,152,13,15,203,528,20,32,0,0
5266,516,384,718,904,152,13,15,202,520,21,32,0,0
5267,466,406,676,947,152,13,15,210,541,22,32,0,0
5268,412,426,635,1002,152,13,15,223,576,23,32,0,0
5269,369,441,596,1021,152,13,15,227,580,24,32,0,0
5270,317,465,554,1061,152,13,15,237,596,25,32,0,0
5271,278,501,515,1076,152,13,15,237,575,26,32,0,0
5272,221,520,461,1080,152,13,15,240,560,27,32,0,0
5273,165,558,400,1080,152,13,15,235,522,28,32,0,0
5274,115,599,348,1080,152,13,15,233,481,29,32,0,0
5275,49,627,275,1080,152,13,15,226,453,30,32,0,0
5276,38,701,238,1078,152,13,15,200,377,31,32,0,0
5277,0,729,189,1080,152,13,15,189,351,32,32,1,0
5349,1419,846,1606,1066,153,13,15,187,220,0,18,0,0
5350,1318,796,1552,1072,153,13,15,234,276,1,18,0,0
5351,1220,744,1502,1078,153,13,15,282,334,2,18,0,0
5352,1107,683,1432,1073,153,13,15,325,390,3,18,0,0
5353,980,610,1360,1072,153,13,15,380,462,4,18,0,0
5354,878,561,1293,1074,153,13,15,415,513,5,18,0,0
5355,798,522,1235,1073,153,13,15,437,551,6,18,0,0
5356,749,477,1208,1065,153,13,15,459,588,7,18,0,0
5357,730,441,1205,1067,153,13,15,475,626,8,18,0,0
5358,732,406,1220,1070,153,13,15,488,664,9,18,0,0
5359,750,368,1245,1065,153,13,15,495,697,10,18,0,0
5360,784,349,1274,1060,153,13,15,490,711,11,18,0,0
5361,827,331,1289,1024,153,13,15,462,693,12,18,0,0
5362,894,323,1299,954,153,13,15,405,631,13,18,0,0
5363,965,329,1334,919,153,13,15,369,590,14,18,0,0
5364,1036,318,1378,879,153,13,15,342,561,15,18,0,0
5365,1122,314,1434,843,153,13,15,312,529,16,18,0,0
5366,1168,307,1464,826,153,13,15,296,519,17,18,0,0
5367,1170,284,1469,808,153,13,15,299,524,18,18,0,0
5450,1355,202,1439,542,154,13,15,84,340,0,149,0,1
5451,1330,209,1414,545,154,13,15,84,336,1,149,0,0
5452,1314,200,1399,539,154,13,15,85,339,2,149,0,0
5453,1292,195,1376,525,154,13,15,84,330,3,149,0,0
5454,1272,195,1353,509,154,13,15,81,314,4,149,0,0
5455,1253,185,1334,494,154,13,15,81,309,5,149,0,0
5456,1233,182,1317,497,154,13,15,84,315,6,149,0,0
5457,1217,180,1299,481,154,13,15,82,301,7,149,0,0
5458,1213,179,1293,464,154,13,15,80,285,8,149,0,0
5459,1210,179,1292,460,154,13,15,82,281,9,149,0,0
5460,1208,176,1288,446,154,13,15,80,270,10,149,0,0
5461,1209,175,1288,434,154,13,15,79,259,11,149,0,0
5462,1210,171,1286,422,154,13,15,76,251,12,149,0,0
5463,1211,166,1287,410,154,13,15,76,244,13,149,0,0
5464,1216,165,1293,405,154,13,15,77,240,14,149,0,0
5465,1223,157,1303,402,154,13,15,80,245,15,149,0,0
5466,1231,152,1309,391,154,13,15,78,239,16,149,0,0
5467,1236,155,1310,380,154,13,15,74,225,17,149,0,0
5468,1239,150,1314,382,154,13,15,75,232,18,149,0,0
5469,1243,151,1317,379,154,13,15,74,228,19,149,0,0
5470,1250,150,1324,374,154,13,15,74,224,20,149,0,0
5471,1258,146,1330,363,154,13,15,72,217,21,149,0,0
5472,1262,146,1333,362,154,13,15,71,216,22,149,0,0
5473,1264,144,1332,353,154,13,15,68,209,23,149,0,0
5474,1268,144,1333,342,154,13,15,65,198,24,149,0,0
5475,1272,147,1336,339,154,13,15,64,192,25,149,0,0
5476,1277,145,1339,331,154,13,15,62,186,26,149,0,0
5477,1281,144,1342,326,154,13,15,61,182,27,149,0,0
5478,1283,140,1344,323,154,13,15,61,183,28,149,0,0
5479,1286,140,1345,318,154,13,15,59,178,29,149,0,0
5480,1290,141,1348,314,154,13,15,58,173,30,149,0,0
5481,1292,134,1350,306,154,13,15,58,172,31,149,0,0
5482,1293,134,1350,300,154,13,15,57,166,32,149,0,0
5483,1291,131,1348,297,154,13,15,57,166,33,149,0,0
5484,1288,130,1344,292,154,13,15,56,162,34,149,0,0
5485,1289,130,1343,289,154,13,15,54,159,35,149,0,0
5486,1289,127,1343,285,154,13,15,54,158,36,149,0,0
5487,1287,127,1339,278,154,13,15,52,151,37,149,0,0
5488,1282,127,1334,275,154,13,15,52,148,38,149,0,0
5489,1276,123,1328,272,154,13,15,52,149,39,149,0,0
5490,1271,124,1322,271,154,13,15,51,147,40,149,0,0
5491,1267,125,1318,268,154,13,15,51,143,41,149,0,0
5492,1265,124,1313,260,154,13,15,48,136,42,149,0,0
5493,1260,123,1306,254,154,13,15,46,131,43,149,0,0
5494,1253,122,1300,252,154,13,15,47,130,44,149,0,0
5495,1248,121,1296,253,154,13,15,48,132,45,149,0,0
5496,1246,121,1294,251,154,13,15,48,130,46,149,0,0
5497,1245,120,1293,251,154,13,15,48,131,47,149,0,0
5498,1245,118,1290,243,154,13,15,45,125,48,149,0,0
5499,1241,117,1288,246,154,13,15,47,129,49,149,0,0
5500,1237,118,1284,246,154,13,15,47,128,50,149,0,0
5501,1235,117,1281,242,154,13,15,46,125,51,149,0,0
5502,1234,119,1281,243,154,13,15,47,124,52,149,0,0
5503,1236,118,1284,246,154,13,15,48,128,53,149,0,0
5504,1237,117,1286,247,154,13,15,49,130,54,149,0,0
5505,1237,116,1285,246,154,13,15,48,130,55,149,0,0
5506,1237,113,1285,245,154,13,15,48,132,56,149,0,0
5507,1236,112,1284,246,154,13,15,48,134,57,149,0,0
5508,1235,113,1283,247,154,13,15,48,134,58,149,0,0
5509,1231,116,1279,247,154,13,15,48,131,59,149,0,0
5510,1227,117,1275,248,154,13,15,48,131,60,149,0,0
5511,1222,117,1270,249,154,13,15,48,132,61,149,0,0
5512,1216,118,1263,247,154,13,15,47,129,62,149,0,0
5513,1210,116,1256,243,154,13,15,46,127,63,149,0,0
5514,1203,116,1248,242,154,13,15,45,126,64,149,0,0
5515,1200,117,1246,243,154,13,15,46,126,65,149,0,0
5516,1199,117,1245,242,154,13,15,46,125,66,149,0,0
5517,1198,117,1245,246,154,13,15,47,129,67,149,0,0
5518,1197,117,1243,242,154,13,15,46,125,68,149,0,0
5519,1193,117,1239,244,154,13,15,46,127,69,149,0,0
5520,1188,116,1235,246,154,13,15,47,130,70,149,0,0
5521,1185,116,1230,242,154,13,15,45,126,71,149,0,0
5522,1182,117,1229,249,154,13,15,47,132,72,149,0,0
5523,1183,118,1230,249,154,13,15,47,131,73,149,0,0
5524,1184,118,1230,246,154,13,15,46,128,74,149,0,0
5525,1186,118,1230,240,154,13,15,44,122,75,149,0,0
5526,1185,119,1229,239,154,13,15,44,120,76,149,0,0
5527,1183,119,1229,245,154,13,15,46,126,77,149,0,0
5528,1181,121,1230,254,154,13,15,49,133,78,149,0,0
5529,1182,122,1232,257,154,13,15,50,135,79,149,0,0
5530,1185,122,1234,256,154,13,15,49,134,80,149,0,0
5531,1185,122,1238,266,154,13,15,53,144,81,149,0,0
5532,1186,124,1240,271,154,13,15,54,147,82,149,0,0
5533,1184,122,1240,279,154,13,15,56,157,83,149,0,0
5534,1181,122,1238,283,154,13,15,57,161,84,149,0,0
5535,1180,124,1237,289,154,13,15,57,165,85,149,0,0
5536,1181,124,1237,287,154,13,15,56,163,86,149,0,0
5537,1181,125,1238,291,154,13,15,57,166,87,149,0,0
5538,1179,127,1236,295,154,13,15,57,168,88,149,0,0
5539,1177,128,1234,295,154,13,15,57,167,89,149,0,0
5540,1177,131,1234,303,154,13,15,57,172,90,149,0,0
5541,1176,132,1234,308,154,13,15,58,176,91,149,0,0
5542,1174,133,1233,312,154,13,15,59,179,92,149,0,0
5543,1171,135,1231,315,154,13,15,60,180,93,149,0,0
5544,1167,136,1228,320,154,13,15,61,184,94,149,0,0
5545,1163,137,1226,327,154,13,15,63,190,95,149,0,0
5546,1161,138,1224,330,154,13,15,63,192,96,149,0,0
5547,1159,139,1222,334,154,13,15,63,195,97,149,0,0
5548,1156,142,1220,340,154,13,15,64,198,98,149,0,0
5549,1151,143,1217,343,154,13,15,66,200,99,149,0,0
5550,1146,144,1214,354,154,13,15,68,210,100,149,0,0
5551,1143,145,1214,362,154,13,15,71,217,101,149,0,0
5552,1141,146,1214,369,154,13,15,73,223,102,149,0,0
5553,1138,151,1213,379,154,13,15,75,228,103,149,0,0
5554,1132,152,1208,383,154,13,15,76,231,104,149,0,0
5555,1126,151,1204,389,154,13,15,78,238,105,149,0,0
5556,1121,157,1200,396,154,13,15,79,239,106,149,0,0
5557,1117,158,1197,399,154,13,15,80,241,107,149,0,0
5558,1111,162,1194,409,154,13,15,83,247,108,149,0,0
5559,1102,163,1188,418,154,13,15,86,255,109,149,0,0
5560,1095,164,1183,424,154,13,15,88,260,110,149,0,0
5561,1088,170,1179,437,154,13,15,91,267,111,149,0,0
5562,1085,177,1175,442,154,13,15,90,265,112,149,0,0
5563,1080,176,1171,446,154,13,15,91,270,113,149,0,0
5564,1076,174,1168,450,154,13,15,92,276,114,149,0,0
5565,1068,172,1160,449,154,13,15,92,277,115,149,0,0
5566,1056,170,1147,443,154,13,15,91,273,116,149,0,0
5567,1050,171,1138,434,154,13,15,88,263,117,149,0,0
5568,1048,169,1135,424,154,13,15,87,255,118,149,0,0
5569,1048,168,1132,410,154,13,15,84,242,119,149,0,0
5570,1054,166,1137,401,154,13,15,83,235,120,149,0,0
5571,1061,158,1143,393,154,13,15,82,235,121,149,0,0
5572,1069,155,1151,389,154,13,15,82,234,122,149,0,0
5573,1078,153,1155,371,154,13,15,77,218,123,149,0,0
5574,1088,150,1165,366,154,13,15,77,216,124,149,0,0
5575,1100,151,1175,361,154,13,15,75,210,125,149,0,0
5576,1113,146,1185,348,154,13,15,72,202,126,149,0,0
5577,1124,145,1194,346,154,13,15,70,201,127,149,0,0
5578,1132,140,1204,349,154,13,15,72,209,128,149,0,0
5579,1144,140,1213,339,154,13,15,69,199,129,149,0,0
5580,1155,139,1221,329,154,13,15,66,190,130,149,0,0
5581,1166,135,1230,322,154,13,15,64,187,131,149,0,0
5582,1173,133,1238,321,154,13,15,65,188,132,149,0,0
5583,1178,132,1242,318,154,13,15,64,186,133,149,0,0
5584,1184,133,1246,313,154,13,15,62,180,134,149,0,0
5585,1193,132,1253,307,154,13,15,60,175,135,149,0,0
5586,1202,133,1258,296,154,13,15,56,163,136,149,0,0
5587,1207,132,1261,289,154,13,15,54,157,137,149,0,0
5588,1208,127,1264,289,154,13,15,56,162,138,149,0,0
5589,1211,129,1266,288,154,13,15,55,159,139,149,0,0
5590,1212,126,1267,285,154,13,15,55,159,140,149,0,0
5591,1213,124,1266,279,154,13,15,53,155,141,149,0,0
5592,1212,125,1264,276,154,13,15,52,151,142,149,0,0
5593,1208,123,1259,268,154,13,15,51,145,143,149,0,0
5594,1204,123,1253,264,154,13,15,49,141,144,149,0,0
5595,1199,121,1247,257,154,13,15,48,136,145,149,0,0
5596,1191,120,1240,259,154,13,15,49,139,146,149,0,0
5597,1183,120,1230,251,154,13,15,47,131,147,149,0,0
5598,1173,119,1217,245,154,13,15,44,126,148,149,0,0
5599,1171,117,1213,240,154,13,15,42,123,149,149,1,0
5563,127,839,324,1070,156,13,15,197,231,0,0,0,0
5564,293,793,487,1071,157,13,15,194,278,0,0,0,0
5565,419,703,725,1078,158,13,15,306,375,0,15,0,0
5566,493,656,833,1074,158,13,15,340,418,1,15,0,0
5567,555,605,934,1074,158,13,15,379,469,2,15,0,0
5568,617,549,1037,1075,158,13,15,420,526,3,15,0,0
5569,669,512,1112,1077,158,13,15,443,565,4,15,0,0
5570,717,468,1184,1079,158,13,15,467,611,5,15,0,0
5571,769,433,1247,1079,158,13,15,478,646,6,15,0,0
5572,817,407,1279,1055,158,13,15,462,648,7,15,0,0
5573,885,378,1305,986,158,13,15,420,608,8,15,0,0
5574,942,371,1327,944,158,13,15,385,573,9,15,0,0
5575,1011,358,1363,900,158,13,15,352,542,10,15,0,0
5576,1067,349,1401,885,158,13,15,334,536,11,15,0,0
5577,1119,345,1430,859,158,13,15,311,514,12,15,0,0
5578,1183,334,1471,830,158,13,15,288,496,13,15,0,0
5579,1222,341,1485,804,158,13,15,263,463,14,15,0,0
5580,1271,323,1532,784,158,13,15,261,461,15,15,0,0
