frame_num,x1,y1,x2,y2,track,hour,camera,w,h,track_length,max_track_len,departure,entrance
4157,1262,178,1330,436,1,11,1,68,258,0,32,0,1
4158,1262,174,1330,431,1,11,1,68,257,1,32,0,0
4159,1279,177,1347,434,1,11,1,68,257,2,32,0,0
4160,1299,180,1369,437,1,11,1,70,257,3,32,0,0
4161,1316,178,1390,451,1,11,1,74,273,4,32,0,0
4162,1333,182,1411,464,1,11,1,78,282,5,32,0,0
4163,1345,186,1429,483,1,11,1,84,297,6,32,0,0
4164,1356,188,1443,494,1,11,1,87,306,7,32,0,0
4165,1365,194,1457,514,1,11,1,92,320,8,32,0,0
4166,1378,198,1473,525,1,11,1,95,327,9,32,0,0
4167,1383,203,1482,543,1,11,1,99,340,10,32,0,0
4168,1383,210,1487,562,1,11,1,104,352,11,32,0,0
4169,1380,212,1490,582,1,11,1,110,370,12,32,0,0
4170,1378,220,1493,608,1,11,1,115,388,13,32,0,0
4171,1372,224,1492,625,1,11,1,120,401,14,32,0,0
4172,1358,231,1487,660,1,11,1,129,429,15,32,0,0
4173,1342,238,1475,679,1,11,1,133,441,16,32,0,0
4174,1324,246,1461,699,1,11,1,137,453,17,32,0,0
4175,1303,265,1450,749,1,11,1,147,484,18,32,0,0
4176,1286,281,1436,769,1,11,1,150,488,19,32,0,0
4177,1260,303,1421,819,1,11,1,161,516,20,32,0,0
4178,1233,324,1400,858,1,11,1,167,534,21,32,0,0
4179,1201,332,1384,911,1,11,1,183,579,22,32,0,0
4180,1173,361,1373,986,1,11,1,200,625,23,32,0,0
4181,1145,379,1357,1036,1,11,1,212,657,24,32,0,0
4182,1118,398,1337,1071,1,11,1,219,673,25,32,0,0
4183,1081,424,1300,1080,1,11,1,219,656,26,32,0,0
4184,1041,450,1263,1080,1,11,1,222,630,27,32,0,0
4185,1005,505,1223,1080,1,11,1,218,575,28,32,0,0
4186,956,558,1169,1080,1,11,1,213,522,29,32,0,0
4187,906,653,1105,1080,1,11,1,199,427,30,32,0,0
4188,821,773,989,1080,1,11,1,168,307,31,32,0,0
4189,793,817,946,1080,1,11,1,153,263,32,32,1,0
4360,1623,145,1658,279,3,11,1,35,134,0,26,0,1
4361,1615,146,1650,279,3,11,1,35,133,1,26,0,0
4362,1605,146,1640,280,3,11,1,35,134,2,26,0,0
4363,1593,145,1630,287,3,11,1,37,142,3,26,0,0
4364,1582,145,1622,294,3,11,1,40,149,4,26,0,0
4365,1572,143,1614,298,3,11,1,42,155,5,26,0,0
4366,1565,144,1607,301,3,11,1,42,157,6,26,0,0
4367,1558,144,1601,301,3,11,1,43,157,7,26,0,0
4368,1549,144,1593,305,3,11,1,44,161,8,26,0,0
4369,1540,147,1586,312,3,11,1,46,165,9,26,0,0
4370,1536,148,1582,312,3,11,1,46,164,10,26,0,0
4371,1529,148,1576,314,3,11,1,47,166,11,26,0,0
4372,1521,150,1570,320,3,11,1,49,170,12,26,0,0
4373,1507,148,1559,325,3,11,1,52,177,13,26,0,0
4374,1494,148,1546,328,3,11,1,52,180,14,26,0,0
4375,1479,150,1531,331,3,11,1,52,181,15,26,0,0
4376,1463,150,1516,333,3,11,1,53,183,16,26,0,0
4377,1447,152,1502,334,3,11,1,55,182,17,26,0,0
4378,1430,155,1485,337,3,11,1,55,182,18,26,0,0
4379,1409,152,1464,339,3,11,1,55,187,19,26,0,0
4380,1392,155,1450,340,3,11,1,58,185,20,26,0,0
4381,1368,152,1426,338,3,11,1,58,186,21,26,0,0
4382,1343,153,1402,337,3,11,1,59,184,22,26,0,0
4383,1327,153,1389,340,3,11,1,62,187,23,26,0,0
4384,1298,153,1358,339,3,11,1,60,186,24,26,0,0
4385,1277,155,1337,338,3,11,1,60,183,25,26,0,0
4386,1260,155,1321,339,3,11,1,61,184,26,26,1,0
130,1867,931,1920,1073,1,11,10,53,142,0,0,0,0
131,1791,854,1920,1075,2,11,10,129,221,0,1,0,0
132,1727,820,1877,1075,2,11,10,150,255,1,1,0,0
133,1601,797,1788,1072,3,11,10,187,275,0,0,0,0
134,1419,771,1663,1072,4,11,10,244,301,0,130,0,1
135,1301,725,1581,1072,4,11,10,280,347,1,130,0,0
136,1179,706,1476,1074,4,11,10,297,368,2,130,0,0
137,1040,668,1365,1074,4,11,10,325,406,3,130,0,0
138,864,624,1223,1071,4,11,10,359,447,4,130,0,0
139,728,593,1110,1069,4,11,10,382,476,5,130,0,0
140,638,555,1048,1074,4,11,10,410,519,6,130,0,0
141,551,514,985,1075,4,11,10,434,561,7,130,0,0
142,482,497,913,1072,4,11,10,431,575,8,130,0,0
143,402,468,843,1077,4,11,10,441,609,9,130,0,0
144,343,448,783,1075,4,11,10,440,627,10,130,0,0
145,305,429,740,1075,4,11,10,435,646,11,130,0,0
146,291,404,690,1019,4,11,10,399,615,12,130,0,0
147,279,396,646,987,4,11,10,367,591,13,130,0,0
148,265,386,597,940,4,11,10,332,554,14,130,0,0
149,249,367,562,910,4,11,10,313,543,15,130,0,0
150,243,367,527,880,4,11,10,284,513,16,130,0,0
151,234,350,493,831,4,11,10,259,481,17,130,0,0
152,228,341,473,811,4,11,10,245,470,18,130,0,0
153,220,339,446,789,4,11,10,226,450,19,130,0,0
154,210,324,421,758,4,11,10,211,434,20,130,0,0
155,207,320,408,746,4,11,10,201,426,21,130,0,0
156,208,312,398,725,4,11,10,190,413,22,130,0,0
157,205,302,382,695,4,11,10,177,393,23,130,0,0
158,198,300,367,686,4,11,10,169,386,24,130,0,0
159,191,293,348,661,4,11,10,157,368,25,130,0,0
160,188,287,337,647,4,11,10,149,360,26,130,0,0
161,185,286,326,635,4,11,10,141,349,27,130,0,0
162,183,282,313,613,4,11,10,130,331,28,130,0,0
163,179,280,301,596,4,11,10,122,316,29,130,0,0
164,172,282,287,586,4,11,10,115,304,30,130,0,0
165,166,271,280,575,4,11,10,114,304,31,130,0,0
166,166,266,276,569,4,11,10,110,303,32,130,0,0
167,167,266,271,555,4,11,10,104,289,33,130,0,0
168,164,262,263,540,4,11,10,99,278,34,130,0,0
169,164,265,260,537,4,11,10,96,272,35,130,0,0
170,164,261,256,524,4,11,10,92,263,36,130,0,0
171,168,257,260,521,4,11,10,92,264,37,130,0,0
172,172,257,260,510,4,11,10,88,253,38,130,0,0
173,169,252,255,500,4,11,10,86,248,39,130,0,0
174,163,250,246,490,4,11,10,83,240,40,130,0,0
175,159,249,240,480,4,11,10,81,231,41,130,0,0
176,158,243,237,468,4,11,10,79,225,42,130,0,0
177,158,242,234,462,4,11,10,76,220,43,130,0,0
178,154,238,228,451,4,11,10,74,213,44,130,0,0
179,147,236,221,451,4,11,10,74,215,45,130,0,0
180,142,237,214,446,4,11,10,72,209,46,130,0,0
181,137,235,208,445,4,11,10,71,210,47,130,0,0
182,136,235,205,440,4,11,10,69,205,48,130,0,0
183,136,233,204,441,4,11,10,68,208,49,130,0,0
184,135,230,201,435,4,11,10,66,205,50,130,0,0
185,134,232,198,429,4,11,10,64,197,51,130,0,0
186,132,230,195,424,4,11,10,63,194,52,130,0,0
187,131,227,192,417,4,11,10,61,190,53,130,0,0
188,133,225,190,409,4,11,10,57,184,54,130,0,0
189,131,223,188,403,4,11,10,57,180,55,130,0,0
190,131,224,186,399,4,11,10,55,175,56,130,0,0
191,129,227,183,396,4,11,10,54,169,57,130,0,0
192,127,223,181,393,4,11,10,54,170,58,130,0,0
193,127,221,180,391,4,11,10,53,170,59,130,0,0
194,127,221,179,384,4,11,10,52,163,60,130,0,0
195,126,216,178,384,4,11,10,52,168,61,130,0,0
196,126,219,177,381,4,11,10,51,162,62,130,0,0
197,123,216,173,376,4,11,10,50,160,63,130,0,0
198,122,212,171,372,4,11,10,49,160,64,130,0,0
199,122,213,169,372,4,11,10,47,159,65,130,0,0
200,122,213,168,368,4,11,10,46,155,66,130,0,0
201,121,213,166,363,4,11,10,45,150,67,130,0,0
202,121,214,164,359,4,11,10,43,145,68,130,0,0
203,121,208,164,353,4,11,10,43,145,69,130,0,0
204,123,209,164,350,4,11,10,41,141,70,130,0,0
205,124,208,165,345,4,11,10,41,137,71,130,0,0
206,125,208,165,343,4,11,10,40,135,72,130,0,0
207,124,211,163,341,4,11,10,39,130,73,130,0,0
208,123,208,162,338,4,11,10,39,130,74,130,0,0
209,122,205,161,340,4,11,10,39,135,75,130,0,0
210,124,208,162,338,4,11,10,38,130,76,130,0,0
211,123,208,160,332,4,11,10,37,124,77,130,0,0
212,121,208,158,330,4,11,10,37,122,78,130,0,0
213,120,209,157,330,4,11,10,37,121,79,130,0,0
214,119,208,156,329,4,11,10,37,121,80,130,0,0
215,120,208,156,328,4,11,10,36,120,81,130,0,0
216,124,211,159,328,4,11,10,35,117,82,130,0,0
217,128,215,163,329,4,11,10,35,114,83,130,0,0
218,132,218,168,330,4,11,10,36,112,84,130,0,0
219,139,221,176,330,4,11,10,37,109,85,130,0,0
220,144,226,181,330,4,11,10,37,104,86,130,0,0
221,147,233,183,331,4,11,10,36,98,87,130,0,0
222,149,241,185,332,4,11,10,36,91,88,130,0,0
223,150,244,185,332,4,11,10,35,88,89,130,0,0
224,150,247,186,333,4,11,10,36,86,90,130,0,0
225,149,246,187,333,4,11,10,38,87,91,130,0,0
226,149,247,188,333,4,11,10,39,86,92,130,0,0
227,149,249,188,332,4,11,10,39,83,93,130,0,0
228,147,247,188,333,4,11,10,41,86,94,130,0,0
229,147,247,189,332,4,11,10,42,85,95,130,0,0
230,147,247,189,332,4,11,10,42,85,96,130,0,0
231,145,245,190,333,4,11,10,45,88,97,130,0,0
232,144,242,190,333,4,11,10,46,91,98,130,0,0
233,143,239,191,333,4,11,10,48,94,99,130,0,0
234,144,233,195,333,4,11,10,51,100,100,130,0,0
235,141,226,196,333,4,11,10,55,107,101,130,0,0
236,140,222,194,331,4,11,10,54,109,102,130,0,0
237,140,217,196,330,4,11,10,56,113,103,130,0,0
238,145,215,201,330,4,11,10,56,115,104,130,0,0
239,150,213,205,329,4,11,10,55,116,105,130,0,0
240,155,210,210,329,4,11,10,55,119,106,130,0,0
241,159,208,213,329,4,11,10,54,121,107,130,0,0
242,163,207,216,327,4,11,10,53,120,108,130,0,0
243,169,206,219,325,4,11,10,50,119,109,130,0,0
244,173,208,224,325,4,11,10,51,117,110,130,0,0
245,176,208,227,325,4,11,10,51,117,111,130,0,0
246,187,210,234,323,4,11,10,47,113,112,130,0,0
247,191,209,237,323,4,11,10,46,114,113,130,0,0
248,194,212,238,326,4,11,10,44,114,114,130,0,0
249,197,214,240,328,4,11,10,43,114,115,130,0,0
250,198,214,240,328,4,11,10,42,114,116,130,0,0
251,199,214,240,328,4,11,10,41,114,117,130,0,0
252,199,214,239,329,4,11,10,40,115,118,130,0,0
253,199,214,238,328,4,11,10,39,114,119,130,0,0
254,198,216,237,328,4,11,10,39,112,120,130,0,0
255,191,216,231,329,4,11,10,40,113,121,130,0,0
256,188,220,228,329,4,11,10,40,109,122,130,0,0
257,185,229,223,329,4,11,10,38,100,123,130,0,0
258,182,240,218,327,4,11,10,36,87,124,130,0,0
259,181,248,216,328,4,11,10,35,80,125,130,0,0
260,180,254,215,328,4,11,10,35,74,126,130,0,0
261,179,256,215,328,4,11,10,36,72,127,130,0,0
262,179,257,216,329,4,11,10,37,72,128,130,0,0
263,178,256,217,329,4,11,10,39,73,129,130,0,0
264,178,259,216,329,4,11,10,38,70,130,130,1,0
266,179,255,219,329,4,11,10,40,74,0,130,0,0
267,179,256,219,329,4,11,10,40,73,1,130,0,0
269,188,259,228,329,4,11,10,40,70,0,130,0,1
270,185,256,225,329,4,11,10,40,73,1,130,0,0
271,182,252,224,329,4,11,10,42,77,2,130,0,0
272,175,232,228,331,4,11,10,53,99,3,130,0,0
273,172,221,228,331,4,11,10,56,110,4,130,0,0
274,168,215,224,328,4,11,10,56,113,5,130,0,0
275,162,211,219,328,4,11,10,57,117,6,130,0,0
276,156,207,213,326,4,11,10,57,119,7,130,0,0
277,153,208,206,322,4,11,10,53,114,8,130,0,0
278,150,206,200,318,4,11,10,50,112,9,130,0,0
279,146,203,196,315,4,11,10,50,112,10,130,0,0
280,145,202,193,313,4,11,10,48,111,11,130,0,0
281,144,200,191,311,4,11,10,47,111,12,130,0,0
282,144,201,190,310,4,11,10,46,109,13,130,0,0
283,144,198,190,309,4,11,10,46,111,14,130,0,0
284,145,197,189,306,4,11,10,44,109,15,130,0,0
285,145,196,187,303,4,11,10,42,107,16,130,0,0
286,144,194,186,300,4,11,10,42,106,17,130,0,0
287,145,194,185,299,4,11,10,40,105,18,130,0,0
288,145,193,185,297,4,11,10,40,104,19,130,0,0
289,144,191,184,296,4,11,10,40,105,20,130,0,0
290,144,194,182,294,4,11,10,38,100,21,130,0,0
291,142,193,179,292,4,11,10,37,99,22,130,0,0
292,141,193,177,290,4,11,10,36,97,23,130,0,0
293,140,193,176,290,4,11,10,36,97,24,130,0,0
294,139,191,174,288,4,11,10,35,97,25,130,0,0
295,138,189,173,286,4,11,10,35,97,26,130,0,0
296,136,186,171,284,4,11,10,35,98,27,130,0,0
297,135,183,170,283,4,11,10,35,100,28,130,0,0
3607,104,165,139,239,5,11,10,35,74,0,85,0,0
3608,105,165,140,240,5,11,10,35,75,1,85,0,0
3609,105,165,141,240,5,11,10,36,75,2,85,0,0
3610,105,165,141,240,5,11,10,36,75,3,85,0,0
3611,105,166,141,243,5,11,10,36,77,4,85,0,0
3612,106,166,142,243,5,11,10,36,77,5,85,0,0
3613,106,167,142,244,5,11,10,36,77,6,85,0,0
3614,107,167,143,245,5,11,10,36,78,7,85,0,0
3615,107,168,143,246,5,11,10,36,78,8,85,0,0
3616,106,169,141,246,5,11,10,35,77,9,85,0,0
3617,105,170,140,248,5,11,10,35,78,10,85,0,0
3626,102,175,137,256,5,11,10,35,81,0,85,0,0
3635,109,183,144,273,5,11,10,35,90,0,85,0,0
3637,110,185,145,276,5,11,10,35,91,0,85,0,0
3639,111,184,146,278,5,11,10,35,94,0,85,0,0
3640,112,183,147,279,5,11,10,35,96,1,85,0,0
3641,112,183,148,280,5,11,10,36,97,2,85,0,0
3642,112,182,148,281,5,11,10,36,99,3,85,0,0
3643,112,182,148,285,5,11,10,36,103,4,85,0,0
3644,112,184,148,286,5,11,10,36,102,5,85,0,0
3645,112,184,149,288,5,11,10,37,104,6,85,0,0
3646,113,187,148,289,5,11,10,35,102,7,85,0,0
3647,112,186,149,292,5,11,10,37,106,8,85,0,0
3648,114,189,150,295,5,11,10,36,106,9,85,0,0
3649,115,190,151,297,5,11,10,36,107,10,85,0,0
3650,116,189,152,300,5,11,10,36,111,11,85,0,0
3651,118,192,153,300,5,11,10,35,108,12,85,0,0
3652,119,193,154,301,5,11,10,35,108,13,85,0,0
3656,127,199,162,308,5,11,10,35,109,0,85,0,1
3657,129,198,164,310,5,11,10,35,112,1,85,0,0
3658,131,199,167,313,5,11,10,36,114,2,85,0,0
3659,134,203,169,316,5,11,10,35,113,3,85,0,0
3660,138,202,174,317,5,11,10,36,115,4,85,0,0
3661,141,205,177,321,5,11,10,36,116,5,85,0,0
3662,143,206,179,323,5,11,10,36,117,6,85,0,0
3663,145,207,182,325,5,11,10,37,118,7,85,0,0
3664,147,210,184,327,5,11,10,37,117,8,85,0,0
3665,149,211,186,328,5,11,10,37,117,9,85,0,0
3666,151,210,190,332,5,11,10,39,122,10,85,0,0
3667,152,211,192,335,5,11,10,40,124,11,85,0,0
3668,154,210,194,334,5,11,10,40,124,12,85,0,0
3669,155,210,196,339,5,11,10,41,129,13,85,0,0
3670,158,210,201,343,5,11,10,43,133,14,85,0,0
3671,161,210,204,344,5,11,10,43,134,15,85,0,0
3672,164,211,206,344,5,11,10,42,133,16,85,0,0
3673,166,210,210,348,5,11,10,44,138,17,85,0,0
3674,167,211,211,351,5,11,10,44,140,18,85,0,0
3675,170,212,215,355,5,11,10,45,143,19,85,0,0
3676,171,212,217,359,5,11,10,46,147,20,85,0,0
3677,172,214,219,363,5,11,10,47,149,21,85,0,0
3678,172,212,219,364,5,11,10,47,152,22,85,0,0
3679,171,213,219,366,5,11,10,48,153,23,85,0,0
3680,170,215,219,371,5,11,10,49,156,24,85,0,0
3681,170,216,219,370,5,11,10,49,154,25,85,0,0
3682,168,215,219,378,5,11,10,51,163,26,85,0,0
3683,166,216,218,384,5,11,10,52,168,27,85,0,0
3684,165,216,217,385,5,11,10,52,169,28,85,0,0
3685,163,220,216,390,5,11,10,53,170,29,85,0,0
3686,164,224,217,392,5,11,10,53,168,30,85,0,0
3687,163,223,218,399,5,11,10,55,176,31,85,0,0
3688,164,228,219,402,5,11,10,55,174,32,85,0,0
3689,163,229,218,405,5,11,10,55,176,33,85,0,0
3690,162,230,218,406,5,11,10,56,176,34,85,0,0
3691,161,232,219,417,5,11,10,58,185,35,85,0,0
3692,159,231,220,423,5,11,10,61,192,36,85,0,0
3693,158,233,220,429,5,11,10,62,196,37,85,0,0
3694,157,235,219,432,5,11,10,62,197,38,85,0,0
3695,155,235,220,440,5,11,10,65,205,39,85,0,0
3696,154,239,221,447,5,11,10,67,208,40,85,0,0
3697,154,239,221,446,5,11,10,67,207,41,85,0,0
3698,154,240,224,456,5,11,10,70,216,42,85,0,0
3699,154,244,225,459,5,11,10,71,215,43,85,0,0
3700,155,244,226,462,5,11,10,71,218,44,85,0,0
3701,155,250,226,467,5,11,10,71,217,45,85,0,0
3702,157,252,230,476,5,11,10,73,224,46,85,0,0
3703,160,252,234,484,5,11,10,74,232,47,85,0,0
3704,162,256,237,493,5,11,10,75,237,48,85,0,0
3705,164,255,242,500,5,11,10,78,245,49,85,0,0
3706,167,257,246,510,5,11,10,79,253,50,85,0,0
3707,171,263,250,515,5,11,10,79,252,51,85,0,0
3708,174,261,257,522,5,11,10,83,261,52,85,0,0
3709,174,264,260,534,5,11,10,86,270,53,85,0,0
3710,173,265,262,543,5,11,10,89,278,54,85,0,0
3711,173,266,265,557,5,11,10,92,291,55,85,0,0
3712,174,270,271,577,5,11,10,97,307,56,85,0,0
3713,175,270,277,591,5,11,10,102,321,57,85,0,0
3714,174,275,280,607,5,11,10,106,332,58,85,0,0
3715,172,286,278,619,5,11,10,106,333,59,85,0,0
3716,171,289,280,627,5,11,10,109,338,60,85,0,0
3717,171,295,284,650,5,11,10,113,355,61,85,0,0
3718,175,300,293,666,5,11,10,118,366,62,85,0,0
3719,181,303,302,680,5,11,10,121,377,63,85,0,0
3720,188,313,312,700,5,11,10,124,387,64,85,0,0
3721,196,316,324,714,5,11,10,128,398,65,85,0,0
3722,207,322,341,734,5,11,10,134,412,66,85,0,0
3723,222,330,361,758,5,11,10,139,428,67,85,0,0
3724,236,333,379,772,5,11,10,143,439,68,85,0,0
3725,248,346,400,815,5,11,10,152,469,69,85,0,0
3726,262,355,420,840,5,11,10,158,485,70,85,0,0
3727,274,365,437,861,5,11,10,163,496,71,85,0,0
3728,287,384,457,899,5,11,10,170,515,72,85,0,0
3729,307,396,483,922,5,11,10,176,526,73,85,0,0
3730,322,411,514,980,5,11,10,192,569,74,85,0,0
3731,337,429,542,1031,5,11,10,205,602,75,85,0,0
3732,348,435,561,1053,5,11,10,213,618,76,85,0,0
3733,361,459,577,1074,5,11,10,216,615,77,85,0,0
3734,394,483,610,1080,5,11,10,216,597,78,85,0,0
3735,427,500,647,1080,5,11,10,220,580,79,85,0,0
3736,473,541,690,1080,5,11,10,217,539,80,85,0,0
3737,521,576,736,1080,5,11,10,215,504,81,85,0,0
3738,568,621,773,1080,5,11,10,205,459,82,85,0,0
3739,674,690,863,1080,5,11,10,189,390,83,85,0,0
3740,793,731,972,1077,5,11,10,179,346,84,85,0,0
3741,846,760,1015,1080,5,11,10,169,320,85,85,1,0
4620,251,214,290,337,11,11,10,39,123,0,17,0,0
4621,241,214,280,336,11,11,10,39,122,1,17,0,0
4622,227,214,266,336,11,11,10,39,122,2,17,0,0
4623,216,219,254,336,11,11,10,38,117,3,17,0,0
4624,200,215,239,334,11,11,10,39,119,4,17,0,0
4625,188,213,227,331,11,11,10,39,118,5,17,0,0
4626,177,209,217,332,11,11,10,40,123,6,17,0,0
4627,168,206,210,330,11,11,10,42,124,7,17,0,0
4628,164,207,203,327,11,11,10,39,120,8,17,0,0
4629,157,206,197,325,11,11,10,40,119,9,17,0,0
4630,153,205,190,320,11,11,10,37,115,10,17,0,0
4631,148,203,185,317,11,11,10,37,114,11,17,0,0
4632,144,202,181,315,11,11,10,37,113,12,17,0,0
4633,142,200,178,313,11,11,10,36,113,13,17,0,0
4634,138,201,174,311,11,11,10,36,110,14,17,0,0
4635,136,201,171,309,11,11,10,35,108,15,17,0,0
4636,133,196,168,307,11,11,10,35,111,16,17,0,0
4637,131,194,166,305,11,11,10,35,111,17,17,0,0
4772,139,225,174,336,13,11,10,35,111,0,42,0,1
4773,142,226,177,339,13,11,10,35,113,1,42,0,0
4774,142,227,178,343,13,11,10,36,116,2,42,0,0
4775,141,230,178,345,13,11,10,37,115,3,42,0,0
4776,138,229,177,353,13,11,10,39,124,4,42,0,0
4777,138,230,177,351,13,11,10,39,121,5,42,0,0
4778,138,231,179,356,13,11,10,41,125,6,42,0,0
4779,138,232,179,359,13,11,10,41,127,7,42,0,0
4780,137,233,177,358,13,11,10,40,125,8,42,0,0
4781,134,233,177,364,13,11,10,43,131,9,42,0,0
4782,134,234,178,367,13,11,10,44,133,10,42,0,0
4783,135,234,179,368,13,11,10,44,134,11,42,0,0
4784,135,236,179,371,13,11,10,44,135,12,42,0,0
4785,133,235,178,372,13,11,10,45,137,13,42,0,0
4786,130,236,179,384,13,11,10,49,148,14,42,0,0
4787,130,237,180,387,13,11,10,50,150,15,42,0,0
4788,131,239,180,389,13,11,10,49,150,16,42,0,0
4789,130,241,179,392,13,11,10,49,151,17,42,0,0
4790,126,241,177,397,13,11,10,51,156,18,42,0,0
4791,121,242,176,409,13,11,10,55,167,19,42,0,0
4792,121,242,176,410,13,11,10,55,168,20,42,0,0
4793,123,242,179,415,13,11,10,56,173,21,42,0,0
4794,122,243,179,422,13,11,10,57,179,22,42,0,0
4795,120,246,176,424,13,11,10,56,178,23,42,0,0
4796,119,253,176,430,13,11,10,57,177,24,42,0,0
4797,119,254,179,436,13,11,10,60,182,25,42,0,0
4798,122,255,182,442,13,11,10,60,187,26,42,0,0
4799,123,257,183,447,13,11,10,60,190,27,42,0,0
4800,119,258,182,452,13,11,10,63,194,28,42,0,0
4801,115,261,181,465,13,11,10,66,204,29,42,0,0
4802,117,263,181,462,13,11,10,64,199,30,42,0,0
4803,118,265,183,467,13,11,10,65,202,31,42,0,0
4804,115,266,181,477,13,11,10,66,211,32,42,0,0
4805,107,268,175,484,13,11,10,68,216,33,42,0,0
4806,97,272,166,485,13,11,10,69,213,34,42,0,0
4807,91,274,163,493,13,11,10,72,219,35,42,0,0
4808,86,277,161,509,13,11,10,75,232,36,42,0,0
4809,79,283,153,515,13,11,10,74,232,37,42,0,0
4810,62,283,136,515,13,11,10,74,232,38,42,0,0
4811,48,283,125,527,13,11,10,77,244,39,42,0,0
4812,35,286,114,539,13,11,10,79,253,40,42,0,0
4813,26,293,102,543,13,11,10,76,250,41,42,0,0
4814,19,295,96,550,13,11,10,77,255,42,42,1,0
133,1800,737,1918,1074,2,11,11,118,337,0,0,0,0
3745,1759,391,1919,1070,3,11,11,160,679,0,5,0,0
3746,1703,312,1882,1067,3,11,11,179,755,1,5,0,0
3747,1668,351,1843,1066,3,11,11,175,715,2,5,0,0
3748,1584,428,1750,1063,3,11,11,166,635,3,5,0,0
3749,1480,516,1641,1066,3,11,11,161,550,4,5,0,0
3750,1425,561,1572,1066,3,11,11,147,505,5,5,0,0
4134,580,366,817,1042,3,11,12,237,676,0,85,0,1
4135,573,340,784,939,3,11,12,211,599,1,85,0,0
4136,561,316,765,898,3,11,12,204,582,2,85,0,0
4137,539,306,742,882,3,11,12,203,576,3,85,0,0
4138,519,284,709,821,3,11,12,190,537,4,85,0,0
4139,497,277,683,804,3,11,12,186,527,5,85,0,0
4140,495,263,668,752,3,11,12,173,489,6,85,0,0
4141,489,246,656,719,3,11,12,167,473,7,85,0,0
4142,481,249,640,698,3,11,12,159,449,8,85,0,0
4143,468,238,621,664,3,11,12,153,426,9,85,0,0
4144,447,228,597,647,3,11,12,150,419,10,85,0,0
4145,437,227,582,636,3,11,12,145,409,11,85,0,0
4146,433,217,568,598,3,11,12,135,381,12,85,0,0
4147,432,215,561,577,3,11,12,129,362,13,85,0,0
4148,426,211,554,569,3,11,12,128,358,14,85,0,0
4149,419,203,540,542,3,11,12,121,339,15,85,0,0
4150,410,198,530,536,3,11,12,120,338,16,85,0,0
4151,410,191,525,516,3,11,12,115,325,17,85,0,0
4152,412,187,521,495,3,11,12,109,308,18,85,0,0
4153,408,190,513,485,3,11,12,105,295,19,85,0,0
4154,401,183,503,471,3,11,12,102,288,20,85,0,0
4155,392,180,492,464,3,11,12,100,284,21,85,0,0
4156,390,182,486,456,3,11,12,96,274,22,85,0,0
4157,387,175,479,442,3,11,12,92,267,23,85,0,0
4158,377,172,469,436,3,11,12,92,264,24,85,0,0
4159,354,147,454,426,3,11,12,100,279,25,85,0,0
4160,352,143,451,415,3,11,12,99,272,26,85,0,0
4161,351,145,449,414,3,11,12,98,269,27,85,0,0
4162,360,155,450,401,3,11,12,90,246,28,85,0,0
4163,361,157,448,398,3,11,12,87,241,29,85,0,0
4164,360,156,445,392,3,11,12,85,236,30,85,0,0
4165,360,153,441,380,3,11,12,81,227,31,85,0,0
4166,360,152,438,374,3,11,12,78,222,32,85,0,0
4167,362,152,438,369,3,11,12,76,217,33,85,0,0
4168,365,149,439,362,3,11,12,74,213,34,85,0,0
4169,367,151,438,359,3,11,12,71,208,35,85,0,0
4170,365,149,435,349,3,11,12,70,200,36,85,0,0
4171,367,147,433,341,3,11,12,66,194,37,85,0,0
4172,368,148,432,338,3,11,12,64,190,38,85,0,0
4173,369,144,433,332,3,11,12,64,188,39,85,0,0
4174,372,145,434,331,3,11,12,62,186,40,85,0,0
4175,366,141,428,325,3,11,12,62,184,41,85,0,0
4176,363,140,423,321,3,11,12,60,181,42,85,0,0
4177,362,141,420,319,3,11,12,58,178,43,85,0,0
4178,362,141,418,315,3,11,12,56,174,44,85,0,0
4179,361,141,416,313,3,11,12,55,172,45,85,0,0
4180,358,140,412,308,3,11,12,54,168,46,85,0,0
4181,355,136,409,302,3,11,12,54,166,47,85,0,0
4182,352,132,406,298,3,11,12,54,166,48,85,0,0
4183,353,131,405,295,3,11,12,52,164,49,85,0,0
4184,352,128,404,291,3,11,12,52,163,50,85,0,0
4185,351,129,401,286,3,11,12,50,157,51,85,0,0
4186,349,130,398,283,3,11,12,49,153,52,85,0,0
4187,346,129,394,279,3,11,12,48,150,53,85,0,0
4188,346,130,392,275,3,11,12,46,145,54,85,0,0
4189,344,128,390,272,3,11,12,46,144,55,85,0,0
4190,342,129,386,271,3,11,12,44,142,56,85,0,0
4191,336,128,382,270,3,11,12,46,142,57,85,0,0
4192,332,124,380,269,3,11,12,48,145,58,85,0,0
4193,332,125,378,266,3,11,12,46,141,59,85,0,0
4194,332,118,379,263,3,11,12,47,145,60,85,0,0
4195,333,121,378,261,3,11,12,45,140,61,85,0,0
4196,331,123,375,260,3,11,12,44,137,62,85,0,0
4197,330,122,374,255,3,11,12,44,133,63,85,0,0
4198,329,122,372,254,3,11,12,43,132,64,85,0,0
4199,330,123,372,250,3,11,12,42,127,65,85,0,0
4200,330,122,371,247,3,11,12,41,125,66,85,0,0
4201,329,121,371,248,3,11,12,42,127,67,85,0,0
4202,329,121,370,244,3,11,12,41,123,68,85,0,0
4203,329,120,369,240,3,11,12,40,120,69,85,0,0
4204,329,120,369,239,3,11,12,40,119,70,85,0,0
4205,331,120,370,237,3,11,12,39,117,71,85,0,0
4206,332,119,371,234,3,11,12,39,115,72,85,0,0
4207,331,119,370,233,3,11,12,39,114,73,85,0,0
4208,331,117,370,230,3,11,12,39,113,74,85,0,0
4209,332,115,370,226,3,11,12,38,111,75,85,0,0
4210,332,116,369,224,3,11,12,37,108,76,85,0,0
4211,334,117,371,225,3,11,12,37,108,77,85,0,0
4212,334,118,370,223,3,11,12,36,105,78,85,0,0
4213,332,118,369,223,3,11,12,37,105,79,85,0,0
4214,332,117,368,220,3,11,12,36,103,80,85,0,0
4215,331,116,367,217,3,11,12,36,101,81,85,0,0
4216,331,115,367,217,3,11,12,36,102,82,85,0,0
4217,330,117,366,220,3,11,12,36,103,83,85,0,0
4218,329,115,365,216,3,11,12,36,101,84,85,0,0
4219,330,114,365,213,3,11,12,35,99,85,85,1,0
4221,329,113,365,209,3,11,12,36,96,0,85,0,0
4222,329,112,365,210,3,11,12,36,98,1,85,0,0
4223,327,113,362,212,3,11,12,35,99,2,85,0,0
4224,326,113,361,211,3,11,12,35,98,3,85,0,0
4153,494,275,531,386,4,11,12,37,111,0,0,0,0
4403,537,129,586,267,1,11,13,49,138,0,11,0,0
4404,523,131,568,258,1,11,13,45,127,1,11,0,0
4405,500,128,546,256,1,11,13,46,128,2,11,0,0
4406,476,126,523,258,1,11,13,47,132,3,11,0,0
4407,458,127,505,256,1,11,13,47,129,4,11,0,0
4408,436,127,485,256,1,11,13,49,129,5,11,0,0
4409,419,131,467,257,1,11,13,48,126,6,11,0,0
4410,393,125,444,256,1,11,13,51,131,7,11,0,0
4411,374,126,424,256,1,11,13,50,130,8,11,0,0
4412,354,129,404,258,1,11,13,50,129,9,11,0,0
4413,338,128,388,258,1,11,13,50,130,10,11,0,0
4414,320,128,370,258,1,11,13,50,130,11,11,0,0
4042,1579,153,1614,272,4,11,14,35,119,0,80,0,0
4043,1580,153,1615,274,4,11,14,35,121,1,80,0,0
4045,1581,155,1616,275,4,11,14,35,120,0,80,0,0
4048,1583,161,1618,281,4,11,14,35,120,0,80,0,1
4049,1583,162,1618,282,4,11,14,35,120,1,80,0,0
4050,1583,162,1618,282,4,11,14,35,120,2,80,0,0
4051,1582,160,1618,285,4,11,14,36,125,3,80,0,0
4052,1582,162,1618,289,4,11,14,36,127,4,80,0,0
4053,1581,164,1618,289,4,11,14,37,125,5,80,0,0
4054,1580,164,1618,293,4,11,14,38,129,6,80,0,0
4055,1580,166,1617,293,4,11,14,37,127,7,80,0,0
4056,1580,167,1618,296,4,11,14,38,129,8,80,0,0
4057,1580,167,1619,299,4,11,14,39,132,9,80,0,0
4058,1581,166,1621,301,4,11,14,40,135,10,80,0,0
4059,1582,167,1623,308,4,11,14,41,141,11,80,0,0
4060,1582,165,1624,309,4,11,14,42,144,12,80,0,0
4061,1583,163,1627,312,4,11,14,44,149,13,80,0,0
4062,1584,170,1626,318,4,11,14,42,148,14,80,0,0
4063,1584,172,1626,317,4,11,14,42,145,15,80,0,0
4064,1583,175,1625,319,4,11,14,42,144,16,80,0,0
4065,1582,178,1623,321,4,11,14,41,143,17,80,0,0
4066,1579,177,1621,321,4,11,14,42,144,18,80,0,0
4067,1576,174,1621,327,4,11,14,45,153,19,80,0,0
4068,1573,177,1618,330,4,11,14,45,153,20,80,0,0
4069,1571,177,1617,331,4,11,14,46,154,21,80,0,0
4070,1568,179,1615,334,4,11,14,47,155,22,80,0,0
4071,1565,181,1612,336,4,11,14,47,155,23,80,0,0
4072,1561,181,1609,344,4,11,14,48,163,24,80,0,0
4073,1558,184,1606,347,4,11,14,48,163,25,80,0,0
4074,1553,182,1604,350,4,11,14,51,168,26,80,0,0
4075,1550,183,1601,355,4,11,14,51,172,27,80,0,0
4076,1545,182,1598,359,4,11,14,53,177,28,80,0,0
4077,1542,181,1596,362,4,11,14,54,181,29,80,0,0
4078,1540,187,1594,368,4,11,14,54,181,30,80,0,0
4079,1540,186,1594,368,4,11,14,54,182,31,80,0,0
4080,1538,190,1594,377,4,11,14,56,187,32,80,0,0
4081,1536,194,1593,385,4,11,14,57,191,33,80,0,0
4082,1533,194,1592,388,4,11,14,59,194,34,80,0,0
4083,1531,197,1590,392,4,11,14,59,195,35,80,0,0
4084,1530,200,1590,398,4,11,14,60,198,36,80,0,0
4085,1527,200,1588,401,4,11,14,61,201,37,80,0,0
4086,1523,204,1586,408,4,11,14,63,204,38,80,0,0
4087,1514,202,1581,416,4,11,14,67,214,39,80,0,0
4088,1509,203,1578,427,4,11,14,69,224,40,80,0,0
4089,1506,211,1577,436,4,11,14,71,225,41,80,0,0
4090,1503,213,1574,439,4,11,14,71,226,42,80,0,0
4091,1499,213,1573,445,4,11,14,74,232,43,80,0,0
4092,1492,209,1569,450,4,11,14,77,241,44,80,0,0
4093,1488,207,1567,458,4,11,14,79,251,45,80,0,0
4094,1483,211,1565,471,4,11,14,82,260,46,80,0,0
4095,1475,213,1560,481,4,11,14,85,268,47,80,0,0
4096,1469,214,1556,488,4,11,14,87,274,48,80,0,0
4097,1463,224,1550,496,4,11,14,87,272,49,80,0,0
4098,1454,225,1543,503,4,11,14,89,278,50,80,0,0
4099,1447,227,1540,516,4,11,14,93,289,51,80,0,0
4100,1441,232,1537,532,4,11,14,96,300,52,80,0,0
4101,1433,230,1532,537,4,11,14,99,307,53,80,0,0
4102,1425,235,1529,558,4,11,14,104,323,54,80,0,0
4103,1411,239,1520,575,4,11,14,109,336,55,80,0,0
4104,1400,238,1513,590,4,11,14,113,352,56,80,0,0
4105,1393,251,1509,610,4,11,14,116,359,57,80,0,0
4106,1384,257,1502,618,4,11,14,118,361,58,80,0,0
4107,1368,260,1492,641,4,11,14,124,381,59,80,0,0
4108,1359,266,1486,658,4,11,14,127,392,60,80,0,0
4109,1346,269,1476,670,4,11,14,130,401,61,80,0,0
4110,1334,282,1472,710,4,11,14,138,428,62,80,0,0
4111,1322,286,1466,733,4,11,14,144,447,63,80,0,0
4112,1308,297,1457,753,4,11,14,149,456,64,80,0,0
4113,1291,312,1447,787,4,11,14,156,475,65,80,0,0
4114,1276,318,1435,800,4,11,14,159,482,66,80,0,0
4115,1256,329,1426,840,4,11,14,170,511,67,80,0,0
4116,1242,341,1424,890,4,11,14,182,549,68,80,0,0
4117,1220,353,1409,917,4,11,14,189,564,69,80,0,0
4118,1186,380,1390,986,4,11,14,204,606,70,80,0,0
4119,1157,398,1365,1015,4,11,14,208,617,71,80,0,0
4120,1124,409,1343,1059,4,11,14,219,650,72,80,0,0
4121,1093,442,1309,1079,4,11,14,216,637,73,80,0,0
4122,1055,472,1270,1080,4,11,14,215,608,74,80,0,0
4123,1013,508,1224,1080,4,11,14,211,572,75,80,0,0
4124,955,555,1159,1080,4,11,14,204,525,76,80,0,0
4125,883,592,1085,1080,4,11,14,202,488,77,80,0,0
4126,803,668,991,1080,4,11,14,188,412,78,80,0,0
4127,726,758,894,1080,4,11,14,168,322,79,80,0,0
4128,687,796,842,1080,4,11,14,155,284,80,80,1,0
4157,1359,229,1440,520,1,11,15,81,291,0,39,0,1
4158,1347,194,1436,514,1,11,15,89,320,1,39,0,0
4159,1333,182,1424,507,1,11,15,91,325,2,39,0,0
4160,1298,185,1386,494,1,11,15,88,309,3,39,0,0
4161,1273,180,1362,490,1,11,15,89,310,4,39,0,0
4162,1249,176,1335,473,1,11,15,86,297,5,39,0,0
4163,1225,175,1307,454,1,11,15,82,279,6,39,0,0
4164,1205,165,1289,448,1,11,15,84,283,7,39,0,0
4165,1188,166,1270,439,1,11,15,82,273,8,39,0,0
4166,1174,155,1256,430,1,11,15,82,275,9,39,0,0
4167,1168,154,1247,419,1,11,15,79,265,10,39,0,0
4168,1165,156,1243,413,1,11,15,78,257,11,39,0,0
4169,1164,149,1241,402,1,11,15,77,253,12,39,0,0
4170,1163,149,1238,393,1,11,15,75,244,13,39,0,0
4171,1166,144,1236,377,1,11,15,70,233,14,39,0,0
4172,1168,138,1240,373,1,11,15,72,235,15,39,0,0
4173,1174,139,1245,372,1,11,15,71,233,16,39,0,0
4174,1182,136,1251,359,1,11,15,69,223,17,39,0,0
4175,1190,138,1255,351,1,11,15,65,213,18,39,0,0
4176,1196,138,1257,339,1,11,15,61,201,19,39,0,0
4177,1201,138,1259,329,1,11,15,58,191,20,39,0,0
4178,1206,141,1262,324,1,11,15,56,183,21,39,0,0
4179,1211,139,1267,320,1,11,15,56,181,22,39,0,0
4180,1214,138,1269,315,1,11,15,55,177,23,39,0,0
4181,1215,134,1269,306,1,11,15,54,172,24,39,0,0
4182,1214,128,1268,299,1,11,15,54,171,25,39,0,0
4183,1215,129,1269,298,1,11,15,54,169,26,39,0,0
4184,1216,124,1270,292,1,11,15,54,168,27,39,0,0
4185,1217,124,1268,282,1,11,15,51,158,28,39,0,0
4186,1215,122,1267,283,1,11,15,52,161,29,39,0,0
4187,1215,118,1267,281,1,11,15,52,163,30,39,0,0
4188,1214,118,1266,279,1,11,15,52,161,31,39,0,0
4189,1213,114,1264,275,1,11,15,51,161,32,39,0,0
4190,1211,116,1260,270,1,11,15,49,154,33,39,0,0
4191,1204,115,1252,267,1,11,15,48,152,34,39,0,0
4192,1195,114,1243,262,1,11,15,48,148,35,39,0,0
4193,1185,114,1233,263,1,11,15,48,149,36,39,0,0
4194,1176,114,1222,259,1,11,15,46,145,37,39,0,0
4195,1170,113,1214,252,1,11,15,44,139,38,39,0,0
4196,1166,112,1209,248,1,11,15,43,136,39,39,1,0
4365,1,703,177,1075,2,11,15,176,372,0,17,0,0
4366,73,670,265,1072,2,11,15,192,402,1,17,0,0
4367,159,613,380,1074,2,11,15,221,461,2,17,0,0
4368,256,554,508,1073,2,11,15,252,519,3,17,0,0
4369,396,519,670,1071,2,11,15,274,552,4,17,0,0
4370,462,466,759,1065,2,11,15,297,599,5,17,0,0
4371,539,435,849,1066,2,11,15,310,631,6,17,0,0
4372,619,406,939,1063,2,11,15,320,657,7,17,0,0
4373,702,378,1031,1067,2,11,15,329,689,8,17,0,0
4374,782,363,1117,1068,2,11,15,335,705,9,17,0,0
4375,876,342,1191,1020,2,11,15,315,678,10,17,0,0
4376,950,324,1245,973,2,11,15,295,649,11,17,0,0
4377,1006,321,1289,945,2,11,15,283,624,12,17,0,0
4378,1105,310,1363,894,2,11,15,258,584,13,17,0,0
4379,1167,307,1421,892,2,11,15,254,585,14,17,0,0
4380,1247,303,1465,817,2,11,15,218,514,15,17,0,0
4381,1286,324,1486,814,2,11,15,200,490,16,17,0,0
4382,1356,309,1555,794,2,11,15,199,485,17,17,0,0
4382,1321,645,1404,819,3,11,15,83,174,0,0,0,0
4406,732,686,1114,1076,3,11,2,382,390,0,8,0,0
4407,628,604,1083,1070,3,11,2,455,466,1,8,0,0
4408,548,561,1041,1072,3,11,2,493,511,2,8,0,0
4409,472,509,1006,1071,3,11,2,534,562,3,8,0,0
4410,406,459,976,1075,3,11,2,570,616,4,8,0,0
4411,357,426,941,1076,3,11,2,584,650,5,8,0,0
4412,322,394,902,1064,3,11,2,580,670,6,8,0,0
4413,305,370,870,1051,3,11,2,565,681,7,8,0,0
4414,252,334,845,1049,3,11,2,593,715,8,8,0,0
4414,481,360,678,959,4,11,2,197,599,0,63,0,1
4415,472,343,660,914,4,11,2,188,571,1,63,0,0
4416,459,331,641,884,4,11,2,182,553,2,63,0,0
4417,442,307,615,835,4,11,2,173,528,3,63,0,0
4418,433,303,597,803,4,11,2,164,500,4,63,0,0
4419,430,289,585,766,4,11,2,155,477,5,63,0,0
4420,428,276,572,721,4,11,2,144,445,6,63,0,0
4421,419,272,558,700,4,11,2,139,428,7,63,0,0
4422,408,260,539,664,4,11,2,131,404,8,63,0,0
4423,399,254,527,651,4,11,2,128,397,9,63,0,0
4424,391,249,517,638,4,11,2,126,389,10,63,0,0
4425,388,236,506,603,4,11,2,118,367,11,63,0,0
4426,383,232,496,582,4,11,2,113,350,12,63,0,0
4427,377,230,483,562,4,11,2,106,332,13,63,0,0
4428,371,226,475,550,4,11,2,104,324,14,63,0,0
4429,370,226,468,535,4,11,2,98,309,15,63,0,0
4430,370,214,465,513,4,11,2,95,299,16,63,0,0
4431,363,209,457,506,4,11,2,94,297,17,63,0,0
4432,356,205,448,497,4,11,2,92,292,18,63,0,0
4433,353,203,441,481,4,11,2,88,278,19,63,0,0
4434,352,206,436,472,4,11,2,84,266,20,63,0,0
4435,352,204,432,458,4,11,2,80,254,21,63,0,0
4436,350,199,429,451,4,11,2,79,252,22,63,0,0
4437,347,196,423,440,4,11,2,76,244,23,63,0,0
4438,344,196,416,426,4,11,2,72,230,24,63,0,0
4439,342,197,412,424,4,11,2,70,227,25,63,0,0
4440,342,194,410,412,4,11,2,68,218,26,63,0,0
4441,341,191,407,404,4,11,2,66,213,27,63,0,0
4442,339,190,404,399,4,11,2,65,209,28,63,0,0
4443,335,179,401,391,4,11,2,66,212,29,63,0,0
4444,333,175,398,388,4,11,2,65,213,30,63,0,0
4445,334,176,395,379,4,11,2,61,203,31,63,0,0
4446,334,176,392,370,4,11,2,58,194,32,63,0,0
4447,333,179,389,365,4,11,2,56,186,33,63,0,0
4448,330,176,385,361,4,11,2,55,185,34,63,0,0
4449,331,178,384,357,4,11,2,53,179,35,63,0,0
4450,332,178,383,351,4,11,2,51,173,36,63,0,0
4451,333,176,382,343,4,11,2,49,167,37,63,0,0
4452,332,177,380,342,4,11,2,48,165,38,63,0,0
4453,331,176,378,335,4,11,2,47,159,39,63,0,0
4454,331,175,376,329,4,11,2,45,154,40,63,0,0
4455,333,176,376,326,4,11,2,43,150,41,63,0,0
4456,334,170,379,322,4,11,2,45,152,42,63,0,0
4457,335,169,379,322,4,11,2,44,153,43,63,0,0
4458,335,169,378,317,4,11,2,43,148,44,63,0,0
4459,335,162,379,312,4,11,2,44,150,45,63,0,0
4460,336,160,380,309,4,11,2,44,149,46,63,0,0
4461,338,155,383,304,4,11,2,45,149,47,63,0,0
4462,339,153,383,302,4,11,2,44,149,48,63,0,0
4463,337,151,382,300,4,11,2,45,149,49,63,0,0
4464,335,147,381,298,4,11,2,46,151,50,63,0,0
4465,334,146,379,294,4,11,2,45,148,51,63,0,0
4466,336,149,379,290,4,11,2,43,141,52,63,0,0
4467,337,147,381,286,4,11,2,44,139,53,63,0,0
4468,332,148,375,287,4,11,2,43,139,54,63,0,0
4469,329,146,371,283,4,11,2,42,137,55,63,0,0
4470,326,145,367,281,4,11,2,41,136,56,63,0,0
4471,324,148,364,278,4,11,2,40,130,57,63,0,0
4472,324,148,362,275,4,11,2,38,127,58,63,0,0
4473,323,151,359,273,4,11,2,36,122,59,63,0,0
4474,320,147,357,272,4,11,2,37,125,60,63,0,0
4475,319,143,356,269,4,11,2,37,126,61,63,0,0
4476,317,140,354,268,4,11,2,37,128,62,63,0,0
4477,316,145,351,267,4,11,2,35,122,63,63,1,0
4129,327,142,362,273,1,11,3,35,131,0,1,0,0
4130,309,141,344,273,1,11,3,35,132,1,1,0,0
12,1159,268,1268,399,1,11,4,109,131,0,4,0,0
13,1155,268,1265,399,1,11,4,110,131,1,4,0,0
14,1153,269,1262,400,1,11,4,109,131,2,4,0,0
15,1151,268,1265,404,1,11,4,114,136,3,4,0,0
16,1150,268,1265,406,1,11,4,115,138,4,4,0,0
46,1161,267,1269,405,2,11,4,108,138,0,5,0,0
47,1159,267,1268,405,2,11,4,109,138,1,5,0,0
48,1160,267,1269,406,2,11,4,109,139,2,5,0,0
49,1161,267,1269,405,2,11,4,108,138,3,5,0,0
50,1157,264,1269,407,2,11,4,112,143,4,5,0,0
51,1157,264,1269,407,2,11,4,112,143,5,5,0,0
81,1150,265,1268,407,3,11,4,118,142,0,5,0,0
82,1154,268,1264,401,3,11,4,110,133,1,5,0,0
83,1150,265,1267,406,3,11,4,117,141,2,5,0,0
84,1151,266,1264,402,3,11,4,113,136,3,5,0,0
85,1148,265,1266,406,3,11,4,118,141,4,5,0,0
86,1148,264,1266,407,3,11,4,118,143,5,5,0,0
91,1158,266,1267,398,3,11,4,109,132,0,5,0,0
92,1159,266,1267,397,3,11,4,108,131,1,5,0,0
93,1159,266,1266,397,3,11,4,107,131,2,5,0,0
94,1159,266,1266,397,3,11,4,107,131,3,5,0,0
95,1158,270,1263,397,3,11,4,105,127,4,5,0,0
96,1158,270,1263,397,3,11,4,105,127,5,5,0,0
233,1155,271,1264,399,4,11,4,109,128,0,1,0,0
234,1155,271,1264,399,4,11,4,109,128,1,1,0,0
236,1165,271,1267,399,5,11,4,102,128,0,0,0,0
241,1159,277,1264,400,6,11,4,105,123,0,5,0,0
242,1159,277,1263,399,6,11,4,104,122,1,5,0,0
243,1160,278,1263,398,6,11,4,103,120,2,5,0,0
244,1160,276,1263,398,6,11,4,103,122,3,5,0,0
245,1160,276,1262,397,6,11,4,102,121,4,5,0,0
246,1160,276,1262,396,6,11,4,102,120,5,5,0,0
379,1153,267,1267,403,7,11,4,114,136,0,0,0,0
421,1146,267,1267,411,8,11,4,121,144,0,5,0,0
422,1150,267,1266,404,8,11,4,116,137,1,5,0,0
423,1151,267,1265,403,8,11,4,114,136,2,5,0,0
424,1148,267,1265,406,8,11,4,117,139,3,5,0,0
425,1146,266,1266,408,8,11,4,120,142,4,5,0,0
426,1145,266,1266,409,8,11,4,121,143,5,5,0,0
446,1157,272,1263,400,8,11,4,106,128,0,5,0,0
447,1158,273,1263,399,8,11,4,105,126,1,5,0,0
448,1157,272,1262,400,8,11,4,105,128,2,5,0,0
449,1158,272,1263,400,8,11,4,105,128,3,5,0,0
450,1158,272,1263,400,8,11,4,105,128,4,5,0,0
451,1159,272,1263,399,8,11,4,104,127,5,5,0,0
454,1156,267,1261,396,8,11,4,105,129,0,5,0,0
455,1156,267,1261,395,8,11,4,105,128,1,5,0,0
456,1156,266,1261,395,8,11,4,105,129,2,5,0,0
651,1161,271,1272,405,9,11,4,111,134,0,5,0,0
652,1160,272,1269,404,9,11,4,109,132,1,5,0,0
653,1160,271,1271,405,9,11,4,111,134,2,5,0,0
654,1159,271,1269,404,9,11,4,110,133,3,5,0,0
655,1159,271,1268,403,9,11,4,109,132,4,5,0,0
656,1159,271,1268,403,9,11,4,109,132,5,5,0,0
702,1152,267,1259,401,11,11,4,107,134,0,0,0,0
704,1154,270,1262,400,12,11,4,108,130,0,0,0,0
796,1147,263,1265,403,14,11,4,118,140,0,10,0,0
797,1149,263,1265,400,14,11,4,116,137,1,10,0,0
798,1150,265,1265,401,14,11,4,115,136,2,10,0,0
799,1150,266,1262,398,14,11,4,112,132,3,10,0,0
800,1149,263,1264,400,14,11,4,115,137,4,10,0,0
801,1145,263,1264,402,14,11,4,119,139,5,10,0,0
802,1145,261,1263,400,14,11,4,118,139,6,10,0,0
803,1144,264,1264,404,14,11,4,120,140,7,10,0,0
804,1144,265,1263,402,14,11,4,119,137,8,10,0,0
805,1145,265,1265,404,14,11,4,120,139,9,10,0,0
806,1145,266,1265,404,14,11,4,120,138,10,10,0,0
862,1159,263,1272,397,15,11,4,113,134,0,0,0,0
866,1146,267,1267,397,16,11,4,121,130,0,7,0,0
867,1145,268,1270,403,16,11,4,125,135,1,7,0,0
868,1143,266,1266,399,16,11,4,123,133,2,7,0,0
869,1140,266,1267,402,16,11,4,127,136,3,7,0,0
870,1143,266,1266,398,16,11,4,123,132,4,7,0,0
871,1142,265,1265,397,16,11,4,123,132,5,7,0,0
872,1144,265,1270,401,16,11,4,126,136,6,7,0,0
873,1144,265,1271,402,16,11,4,127,137,7,7,0,0
891,1145,263,1277,409,16,11,4,132,146,0,7,0,0
892,1147,263,1275,410,16,11,4,128,147,1,7,0,0
893,1147,264,1273,409,16,11,4,126,145,2,7,0,0
894,1147,264,1271,409,16,11,4,124,145,3,7,0,0
895,1145,262,1272,413,16,11,4,127,151,4,7,0,0
896,1144,262,1273,414,16,11,4,129,152,5,7,0,0
1101,1153,266,1264,396,17,11,4,111,130,0,5,0,0
1102,1152,266,1263,396,17,11,4,111,130,1,5,0,0
1103,1152,266,1263,396,17,11,4,111,130,2,5,0,0
1104,1151,265,1263,396,17,11,4,112,131,3,5,0,0
1105,1152,266,1263,396,17,11,4,111,130,4,5,0,0
1106,1152,266,1263,396,17,11,4,111,130,5,5,0,0
1156,1153,269,1265,398,18,11,4,112,129,0,5,0,0
1157,1152,266,1267,399,18,11,4,115,133,1,5,0,0
1158,1151,268,1264,398,18,11,4,113,130,2,5,0,0
1159,1150,268,1263,398,18,11,4,113,130,3,5,0,0
1160,1150,268,1263,398,18,11,4,113,130,4,5,0,0
1161,1150,269,1262,397,18,11,4,112,128,5,5,0,0
1201,1148,267,1264,408,20,11,4,116,141,0,1,0,0
1202,1150,268,1263,405,20,11,4,113,137,1,1,0,0
1204,1149,267,1264,407,21,11,4,115,140,0,0,0,0
1211,1143,269,1271,402,22,11,4,128,133,0,5,0,0
1212,1143,269,1270,401,22,11,4,127,132,1,5,0,0
1213,1138,267,1274,408,22,11,4,136,141,2,5,0,0
1214,1140,267,1272,404,22,11,4,132,137,3,5,0,0
1215,1142,267,1270,402,22,11,4,128,135,4,5,0,0
1216,1141,267,1270,401,22,11,4,129,134,5,5,0,0
1286,1152,265,1266,405,23,11,4,114,140,0,10,0,0
1287,1149,264,1263,404,23,11,4,114,140,1,10,0,0
1288,1149,263,1263,403,23,11,4,114,140,2,10,0,0
1289,1148,263,1263,404,23,11,4,115,141,3,10,0,0
1290,1148,263,1263,404,23,11,4,115,141,4,10,0,0
1291,1147,263,1263,405,23,11,4,116,142,5,10,0,0
1292,1154,258,1270,401,23,11,4,116,143,6,10,0,0
1293,1155,257,1271,401,23,11,4,116,144,7,10,0,0
1316,1152,262,1266,401,23,11,4,114,139,0,10,0,0
1317,1152,262,1266,401,23,11,4,114,139,1,10,0,0
1318,1152,262,1266,401,23,11,4,114,139,2,10,0,0
1319,1152,262,1266,401,23,11,4,114,139,3,10,0,0
1320,1152,263,1266,401,23,11,4,114,138,4,10,0,0
1346,1151,264,1267,402,23,11,4,116,138,0,10,0,0
1347,1150,264,1267,403,23,11,4,117,139,1,10,0,0
1348,1150,264,1267,402,23,11,4,117,138,2,10,0,0
1349,1149,265,1266,402,23,11,4,117,137,3,10,0,0
1350,1150,264,1268,402,23,11,4,118,138,4,10,0,0
1351,1156,263,1270,399,23,11,4,114,136,5,10,0,0
1352,1158,262,1270,396,23,11,4,112,134,6,10,0,0
1353,1161,263,1270,396,23,11,4,109,133,7,10,0,0
1354,1162,264,1270,395,23,11,4,108,131,8,10,0,0
1355,1162,264,1268,394,23,11,4,106,130,9,10,0,0
1356,1163,264,1268,393,23,11,4,105,129,10,10,0,0
1366,1153,265,1265,401,23,11,4,112,136,0,10,0,0
1367,1152,265,1264,402,23,11,4,112,137,1,10,0,0
1368,1150,264,1264,402,23,11,4,114,138,2,10,0,0
1369,1152,266,1265,403,23,11,4,113,137,3,10,0,0
1370,1151,264,1264,402,23,11,4,113,138,4,10,0,0
1371,1150,264,1264,403,23,11,4,114,139,5,10,0,0
1376,1159,264,1269,398,23,11,4,110,134,0,10,0,0
1377,1160,265,1268,397,23,11,4,108,132,1,10,0,0
1378,1157,264,1268,399,23,11,4,111,135,2,10,0,0
1379,1157,266,1267,398,23,11,4,110,132,3,10,0,0
1380,1158,265,1269,399,23,11,4,111,134,4,10,0,0
1381,1158,264,1269,399,23,11,4,111,135,5,10,0,0
1405,1148,264,1262,399,23,11,4,114,135,0,10,0,0
1406,1148,263,1262,400,23,11,4,114,137,1,10,0,0
1416,1160,263,1267,398,23,11,4,107,135,0,10,0,0
1417,1163,264,1266,397,23,11,4,103,133,1,10,0,0
1418,1162,264,1265,398,23,11,4,103,134,2,10,0,0
1419,1165,266,1264,397,23,11,4,99,131,3,10,0,0
1420,1165,267,1264,397,23,11,4,99,130,4,10,0,0
1456,1172,270,1265,396,24,11,4,93,126,0,6,0,0
1457,1172,270,1263,394,24,11,4,91,124,1,6,0,0
1458,1171,270,1263,393,24,11,4,92,123,2,6,0,0
1459,1171,270,1263,394,24,11,4,92,124,3,6,0,0
1460,1169,270,1264,399,24,11,4,95,129,4,6,0,0
1461,1168,270,1265,400,24,11,4,97,130,5,6,0,0
1467,1175,270,1266,394,24,11,4,91,124,0,6,0,0
1468,1175,271,1266,394,24,11,4,91,123,1,6,0,0
1470,1175,270,1267,395,24,11,4,92,125,0,6,0,0
1471,1162,268,1261,400,24,11,4,99,132,1,6,0,0
1472,1158,268,1259,402,24,11,4,101,134,2,6,0,0
1473,1156,267,1259,403,24,11,4,103,136,3,6,0,0
1474,1154,267,1259,403,24,11,4,105,136,4,6,0,0
1475,1153,268,1259,403,24,11,4,106,135,5,6,0,0
1476,1152,268,1258,404,24,11,4,106,136,6,6,0,0
1491,1157,271,1260,402,24,11,4,103,131,0,6,0,0
1492,1157,272,1260,401,24,11,4,103,129,1,6,0,0
1493,1154,270,1261,404,24,11,4,107,134,2,6,0,0
1494,1153,270,1261,405,24,11,4,108,135,3,6,0,0
1495,1154,272,1261,404,24,11,4,107,132,4,6,0,0
1496,1154,272,1261,404,24,11,4,107,132,5,6,0,0
1502,1153,266,1263,400,24,11,4,110,134,0,6,0,0
1503,1153,266,1263,400,24,11,4,110,134,1,6,0,0
1504,1152,266,1262,399,24,11,4,110,133,2,6,0,0
1505,1153,266,1263,398,24,11,4,110,132,3,6,0,0
1506,1154,266,1263,398,24,11,4,109,132,4,6,0,0
1536,1140,264,1266,414,25,11,4,126,150,0,5,0,0
1537,1139,264,1265,414,25,11,4,126,150,1,5,0,0
1538,1139,264,1265,414,25,11,4,126,150,2,5,0,0
1539,1139,264,1265,414,25,11,4,126,150,3,5,0,0
1540,1141,266,1264,411,25,11,4,123,145,4,5,0,0
1541,1141,266,1263,411,25,11,4,122,145,5,5,0,0
1555,1149,267,1263,402,25,11,4,114,135,0,5,0,0
1556,1149,267,1263,402,25,11,4,114,135,1,5,0,0
1572,1153,266,1265,401,25,11,4,112,135,0,5,0,0
1573,1153,265,1266,401,25,11,4,113,136,1,5,0,0
1601,1158,266,1266,398,25,11,4,108,132,0,5,0,0
1602,1159,267,1265,397,25,11,4,106,130,1,5,0,0
1603,1159,267,1265,397,25,11,4,106,130,2,5,0,0
1721,1173,276,1260,392,26,11,4,87,116,0,5,0,0
1722,1172,276,1260,392,26,11,4,88,116,1,5,0,0
1723,1171,276,1258,393,26,11,4,87,117,2,5,0,0
1724,1171,276,1259,393,26,11,4,88,117,3,5,0,0
1725,1171,276,1259,393,26,11,4,88,117,4,5,0,0
1726,1171,276,1259,393,26,11,4,88,117,5,5,0,0
1756,1155,272,1262,404,27,11,4,107,132,0,5,0,0
1757,1155,272,1262,403,27,11,4,107,131,1,5,0,0
1758,1156,275,1260,403,27,11,4,104,128,2,5,0,0
1759,1155,273,1261,403,27,11,4,106,130,3,5,0,0
1760,1155,276,1259,403,27,11,4,104,127,4,5,0,0
1761,1155,276,1259,403,27,11,4,104,127,5,5,0,0
1776,1157,271,1265,401,27,11,4,108,130,0,5,0,0
1777,1157,270,1265,400,27,11,4,108,130,1,5,0,0
1778,1157,270,1266,400,27,11,4,109,130,2,5,0,0
1779,1158,269,1267,400,27,11,4,109,131,3,5,0,0
1796,1153,267,1265,400,27,11,4,112,133,0,5,0,0
1797,1152,267,1265,400,27,11,4,113,133,1,5,0,0
1798,1151,267,1266,402,27,11,4,115,135,2,5,0,0
1799,1151,267,1267,403,27,11,4,116,136,3,5,0,0
1800,1149,266,1267,404,27,11,4,118,138,4,5,0,0
1801,1149,266,1267,404,27,11,4,118,138,5,5,0,0
1836,1151,272,1264,402,28,11,4,113,130,0,5,0,0
1837,1152,272,1263,401,28,11,4,111,129,1,5,0,0
1838,1150,272,1263,401,28,11,4,113,129,2,5,0,0
1839,1148,269,1264,402,28,11,4,116,133,3,5,0,0
1840,1153,272,1263,400,28,11,4,110,128,4,5,0,0
1841,1153,272,1264,399,28,11,4,111,127,5,5,0,0
1846,1159,265,1270,396,28,11,4,111,131,0,5,0,0
1847,1158,266,1268,396,28,11,4,110,130,1,5,0,0
1848,1159,265,1269,396,28,11,4,110,131,2,5,0,0
1881,1143,264,1267,410,29,11,4,124,146,0,5,0,0
1882,1143,264,1265,409,29,11,4,122,145,1,5,0,0
1883,1140,263,1267,412,29,11,4,127,149,2,5,0,0
1884,1141,263,1267,412,29,11,4,126,149,3,5,0,0
1885,1140,263,1267,413,29,11,4,127,150,4,5,0,0
1886,1139,263,1267,414,29,11,4,128,151,5,5,0,0
1931,1161,264,1267,396,30,11,4,106,132,0,5,0,0
1932,1159,264,1266,396,30,11,4,107,132,1,5,0,0
1933,1157,265,1263,397,30,11,4,106,132,2,5,0,0
1934,1159,266,1262,395,30,11,4,103,129,3,5,0,0
1935,1159,267,1262,395,30,11,4,103,128,4,5,0,0
1936,1159,267,1262,394,30,11,4,103,127,5,5,0,0
1946,1151,264,1264,403,30,11,4,113,139,0,5,0,0
1947,1150,264,1264,404,30,11,4,114,140,1,5,0,0
1948,1150,265,1263,404,30,11,4,113,139,2,5,0,0
1949,1150,265,1263,404,30,11,4,113,139,3,5,0,0
1950,1150,266,1262,402,30,11,4,112,136,4,5,0,0
1951,1150,266,1262,403,30,11,4,112,137,5,5,0,0
2112,1151,270,1269,405,31,11,4,118,135,0,0,0,0
2121,1149,273,1265,398,32,11,4,116,125,0,0,0,0
2123,1148,272,1266,398,33,11,4,118,126,0,3,0,0
2124,1146,272,1265,398,33,11,4,119,126,1,3,0,0
2125,1147,273,1264,398,33,11,4,117,125,2,3,0,0
2126,1148,274,1264,398,33,11,4,116,124,3,3,0,0
2196,1152,269,1265,405,34,11,4,113,136,0,5,0,0
2197,1153,269,1264,404,34,11,4,111,135,1,5,0,0
2198,1146,268,1266,413,34,11,4,120,145,2,5,0,0
2199,1149,268,1265,408,34,11,4,116,140,3,5,0,0
2200,1150,268,1264,406,34,11,4,114,138,4,5,0,0
2201,1150,268,1264,405,34,11,4,114,137,5,5,0,0
2243,1168,266,1261,396,35,11,4,93,130,0,5,0,0
2244,1168,266,1260,396,35,11,4,92,130,1,5,0,0
2245,1169,267,1260,395,35,11,4,91,128,2,5,0,0
2246,1169,267,1260,394,35,11,4,91,127,3,5,0,0
2271,1160,264,1260,401,35,11,4,100,137,0,5,0,0
2272,1160,263,1260,402,35,11,4,100,139,1,5,0,0
2276,1164,266,1259,398,35,11,4,95,132,0,5,0,0
2277,1163,267,1259,399,35,11,4,96,132,1,5,0,0
2278,1162,267,1259,399,35,11,4,97,132,2,5,0,0
2279,1162,268,1259,399,35,11,4,97,131,3,5,0,0
2280,1161,269,1258,399,35,11,4,97,130,4,5,0,0
2281,1161,269,1258,400,35,11,4,97,131,5,5,0,0
2286,1164,267,1260,396,35,11,4,96,129,0,5,0,0
2287,1165,267,1260,395,35,11,4,95,128,1,5,0,0
2288,1165,267,1260,395,35,11,4,95,128,2,5,0,0
2290,1164,268,1259,396,35,11,4,95,128,0,5,0,0
2291,1164,268,1259,396,35,11,4,95,128,1,5,0,0
2391,1142,267,1259,407,37,11,4,117,140,0,5,0,0
2392,1142,267,1258,406,37,11,4,116,139,1,5,0,0
2393,1142,267,1258,405,37,11,4,116,138,2,5,0,0
2394,1143,264,1261,406,37,11,4,118,142,3,5,0,0
2395,1143,264,1262,406,37,11,4,119,142,4,5,0,0
2396,1143,264,1263,407,37,11,4,120,143,5,5,0,0
2441,1154,267,1266,406,38,11,4,112,139,0,5,0,0
2442,1157,269,1264,402,38,11,4,107,133,1,5,0,0
2443,1158,270,1264,401,38,11,4,106,131,2,5,0,0
2444,1152,267,1265,407,38,11,4,113,140,3,5,0,0
2445,1155,267,1265,404,38,11,4,110,137,4,5,0,0
2446,1155,267,1265,404,38,11,4,110,137,5,5,0,0
2516,1150,266,1265,404,39,11,4,115,138,0,5,0,0
2517,1150,266,1264,403,39,11,4,114,137,1,5,0,0
2518,1151,267,1263,402,39,11,4,112,135,2,5,0,0
2519,1152,267,1263,401,39,11,4,111,134,3,5,0,0
2520,1151,267,1263,401,39,11,4,112,134,4,5,0,0
2521,1151,267,1263,401,39,11,4,112,134,5,5,0,0
2657,1162,269,1263,402,40,11,4,101,133,0,0,0,0
2746,1153,263,1266,399,41,11,4,113,136,0,5,0,0
2747,1152,263,1265,399,41,11,4,113,136,1,5,0,0
2748,1153,264,1265,399,41,11,4,112,135,2,5,0,0
2749,1152,264,1265,399,41,11,4,113,135,3,5,0,0
2750,1153,265,1265,399,41,11,4,112,134,4,5,0,0
2751,1154,266,1265,400,41,11,4,111,134,5,5,0,0
4201,1174,269,1267,394,52,11,4,93,125,0,3,0,0
4202,1170,269,1265,396,52,11,4,95,127,1,3,0,0
4203,1170,269,1265,396,52,11,4,95,127,2,3,0,0
4204,1170,269,1265,396,52,11,4,95,127,3,3,0,0
4347,1587,163,1622,282,56,11,4,35,119,0,64,0,1
4348,1586,163,1622,285,56,11,4,36,122,1,64,0,0
4349,1585,162,1621,286,56,11,4,36,124,2,64,0,0
4350,1584,165,1620,290,56,11,4,36,125,3,64,0,0
4351,1584,165,1621,294,56,11,4,37,129,4,64,0,0
4352,1583,166,1620,294,56,11,4,37,128,5,64,0,0
4353,1582,168,1621,299,56,11,4,39,131,6,64,0,0
4354,1582,169,1620,299,56,11,4,38,130,7,64,0,0
4355,1582,171,1621,304,56,11,4,39,133,8,64,0,0
4356,1580,175,1619,307,56,11,4,39,132,9,64,0,0
4357,1579,176,1619,309,56,11,4,40,133,10,64,0,0
4358,1578,175,1620,316,56,11,4,42,141,11,64,0,0
4359,1578,176,1620,317,56,11,4,42,141,12,64,0,0
4360,1577,175,1622,324,56,11,4,45,149,13,64,0,0
4361,1576,181,1621,331,56,11,4,45,150,14,64,0,0
4362,1574,181,1620,332,56,11,4,46,151,15,64,0,0
4363,1572,183,1619,337,56,11,4,47,154,16,64,0,0
4364,1569,183,1617,340,56,11,4,48,157,17,64,0,0
4365,1567,184,1617,345,56,11,4,50,161,18,64,0,0
4366,1565,185,1616,353,56,11,4,51,168,19,64,0,0
4367,1562,186,1615,357,56,11,4,53,171,20,64,0,0
4368,1558,187,1612,362,56,11,4,54,175,21,64,0,0
4369,1557,190,1612,368,56,11,4,55,178,22,64,0,0
4370,1556,188,1612,370,56,11,4,56,182,23,64,0,0
4371,1553,188,1612,379,56,11,4,59,191,24,64,0,0
4372,1550,192,1610,387,56,11,4,60,195,25,64,0,0
4373,1547,195,1608,393,56,11,4,61,198,26,64,0,0
4374,1541,186,1607,401,56,11,4,66,215,27,64,0,0
4375,1540,186,1607,405,56,11,4,67,219,28,64,0,0
4376,1536,185,1608,417,56,11,4,72,232,29,64,0,0
4377,1535,192,1607,424,56,11,4,72,232,30,64,0,0
4378,1533,197,1606,432,56,11,4,73,235,31,64,0,0
4379,1528,195,1606,445,56,11,4,78,250,32,64,0,0
4380,1527,197,1607,451,56,11,4,80,254,33,64,0,0
4381,1525,195,1610,465,56,11,4,85,270,34,64,0,0
4382,1522,198,1610,477,56,11,4,88,279,35,64,0,0
4383,1522,199,1611,483,56,11,4,89,284,36,64,0,0
4384,1519,205,1611,501,56,11,4,92,296,37,64,0,0
4385,1519,210,1612,506,56,11,4,93,296,38,64,0,0
4386,1514,210,1611,522,56,11,4,97,312,39,64,0,0
4387,1505,216,1606,542,56,11,4,101,326,40,64,0,0
4388,1494,217,1599,554,56,11,4,105,337,41,64,0,0
4389,1488,223,1598,578,56,11,4,110,355,42,64,0,0
4390,1480,225,1595,595,56,11,4,115,370,43,64,0,0
4391,1470,229,1589,610,56,11,4,119,381,44,64,0,0
4392,1458,240,1580,631,56,11,4,122,391,45,64,0,0
4393,1443,243,1569,645,56,11,4,126,402,46,64,0,0
4394,1426,255,1562,688,56,11,4,136,433,47,64,0,0
4395,1414,266,1559,717,56,11,4,145,451,48,64,0,0
4396,1401,267,1548,727,56,11,4,147,460,49,64,0,0
4397,1381,277,1538,767,56,11,4,157,490,50,64,0,0
4398,1362,284,1525,795,56,11,4,163,511,51,64,0,0
4399,1340,299,1513,841,56,11,4,173,542,52,64,0,0
4400,1317,320,1500,890,56,11,4,183,570,53,64,0,0
4401,1300,339,1485,914,56,11,4,185,575,54,64,0,0
4402,1268,364,1469,981,56,11,4,201,617,55,64,0,0
4403,1239,392,1449,1033,56,11,4,210,641,56,64,0,0
4404,1211,409,1426,1064,56,11,4,215,655,57,64,0,0
4405,1186,447,1401,1080,56,11,4,215,633,58,64,0,0
4406,1152,480,1363,1080,56,11,4,211,600,59,64,0,0
4407,1118,531,1321,1080,56,11,4,203,549,60,64,0,0
4408,1056,594,1252,1080,56,11,4,196,486,61,64,0,0
4409,978,653,1169,1080,56,11,4,191,427,62,64,0,0
4410,893,767,1058,1076,56,11,4,165,309,63,64,0,0
4411,859,809,1010,1080,56,11,4,151,271,64,64,1,0
4301,1152,259,1271,408,57,11,4,119,149,0,5,0,0
4302,1146,256,1269,409,57,11,4,123,153,1,5,0,0
4303,1147,256,1269,409,57,11,4,122,153,2,5,0,0
4304,1149,258,1269,408,57,11,4,120,150,3,5,0,0
4305,1149,257,1270,408,57,11,4,121,151,4,5,0,0
4306,1149,257,1270,407,57,11,4,121,150,5,5,0,0
4309,1157,259,1271,402,57,11,4,114,143,0,5,0,0
4310,1159,260,1271,401,57,11,4,112,141,1,5,0,0
4311,1160,260,1271,400,57,11,4,111,140,2,5,0,0
4341,1167,263,1265,397,58,11,4,98,134,0,5,0,0
4342,1166,263,1264,397,58,11,4,98,134,1,5,0,0
4343,1166,263,1265,398,58,11,4,99,135,2,5,0,0
4344,1165,262,1264,398,58,11,4,99,136,3,5,0,0
4345,1165,262,1264,398,58,11,4,99,136,4,5,0,0
4346,1165,262,1264,398,58,11,4,99,136,5,5,0,0
4397,1142,268,1267,412,59,11,4,125,144,0,0,0,0
4399,1146,272,1273,412,60,11,4,127,140,0,1,0,0
4400,1145,268,1274,410,60,11,4,129,142,1,1,0,0
4466,1168,270,1267,395,62,11,4,99,125,0,5,0,0
4467,1167,270,1266,395,62,11,4,99,125,1,5,0,0
4468,1166,270,1266,396,62,11,4,100,126,2,5,0,0
4469,1167,270,1266,396,62,11,4,99,126,3,5,0,0
4470,1166,268,1267,396,62,11,4,101,128,4,5,0,0
4471,1165,268,1267,397,62,11,4,102,129,5,5,0,0
4676,1171,270,1268,397,63,11,4,97,127,0,5,0,0
4677,1168,269,1271,403,63,11,4,103,134,1,5,0,0
4678,1168,268,1271,404,63,11,4,103,136,2,5,0,0
4679,1167,268,1271,404,63,11,4,104,136,3,5,0,0
4680,1166,270,1266,402,63,11,4,100,132,4,5,0,0
4681,1165,271,1265,402,63,11,4,100,131,5,5,0,0
4978,1173,269,1267,397,64,11,4,94,128,0,0,0,0
5032,1165,265,1269,401,65,11,4,104,136,0,3,0,0
5033,1167,263,1271,399,65,11,4,104,136,1,3,0,0
5034,1167,263,1270,398,65,11,4,103,135,2,3,0,0
5035,1167,263,1270,397,65,11,4,103,134,3,3,0,0
5106,1163,260,1267,399,66,11,4,104,139,0,4,0,0
5107,1164,260,1266,397,66,11,4,102,137,1,4,0,0
5108,1162,260,1267,400,66,11,4,105,140,2,4,0,0
5109,1158,259,1264,401,66,11,4,106,142,3,4,0,0
5110,1156,258,1264,401,66,11,4,108,143,4,4,0,0
5112,1173,268,1266,392,66,11,4,93,124,0,4,0,0
5113,1174,265,1270,393,66,11,4,96,128,1,4,0,0
5114,1175,265,1270,391,66,11,4,95,126,2,4,0,0
5115,1177,265,1271,390,66,11,4,94,125,3,4,0,0
5156,1163,268,1263,401,67,11,4,100,133,0,10,0,0
5157,1162,268,1262,401,67,11,4,100,133,1,10,0,0
5158,1157,260,1264,403,67,11,4,107,143,2,10,0,0
5159,1159,263,1263,401,67,11,4,104,138,3,10,0,0
5160,1159,265,1263,402,67,11,4,104,137,4,10,0,0
5161,1159,264,1263,402,67,11,4,104,138,5,10,0,0
5162,1166,265,1267,400,67,11,4,101,135,6,10,0,0
5163,1166,265,1268,402,67,11,4,102,137,7,10,0,0
5164,1166,268,1265,400,67,11,4,99,132,8,10,0,0
5165,1166,269,1264,400,67,11,4,98,131,9,10,0,0
5166,1166,269,1264,400,67,11,4,98,131,10,10,0,0
5221,1167,268,1271,398,68,11,4,104,130,0,8,0,0
5222,1171,268,1271,393,68,11,4,100,125,1,8,0,0
5223,1169,269,1270,396,68,11,4,101,127,2,8,0,0
5224,1169,269,1271,396,68,11,4,102,127,3,8,0,0
5225,1170,269,1270,395,68,11,4,100,126,4,8,0,0
5226,1166,267,1270,397,68,11,4,104,130,5,8,0,0
5227,1164,266,1269,399,68,11,4,105,133,6,8,0,0
5228,1165,266,1269,398,68,11,4,104,132,7,8,0,0
5229,1165,266,1269,398,68,11,4,104,132,8,8,0,0
5590,1171,271,1266,401,69,11,4,95,130,0,0,0,0
5596,1144,267,1268,407,70,11,4,124,140,0,0,0,0
5598,1144,267,1269,407,71,11,4,125,140,0,0,0,0
5611,1168,270,1261,404,72,11,4,93,134,0,5,0,0
5612,1164,270,1259,406,72,11,4,95,136,1,5,0,0
5613,1163,270,1258,407,72,11,4,95,137,2,5,0,0
5614,1162,269,1258,407,72,11,4,96,138,3,5,0,0
5615,1159,270,1257,409,72,11,4,98,139,4,5,0,0
5616,1158,270,1257,410,72,11,4,99,140,5,5,0,0
5636,1179,274,1263,393,72,11,4,84,119,0,5,0,0
5637,1180,275,1264,392,72,11,4,84,117,1,5,0,0
5638,1181,275,1264,391,72,11,4,83,116,2,5,0,0
5651,1181,272,1265,389,72,11,4,84,117,0,5,0,0
5652,1182,271,1266,389,72,11,4,84,118,1,5,0,0
5653,1181,271,1265,390,72,11,4,84,119,2,5,0,0
5654,1181,271,1265,390,72,11,4,84,119,3,5,0,0
5655,1180,271,1265,390,72,11,4,85,119,4,5,0,0
5656,1180,271,1266,390,72,11,4,86,119,5,5,0,0
5661,1173,271,1263,395,72,11,4,90,124,0,5,0,0
5662,1168,270,1262,397,72,11,4,94,127,1,5,0,0
5663,1166,270,1262,397,72,11,4,96,127,2,5,0,0
5664,1167,271,1263,397,72,11,4,96,126,3,5,0,0
5665,1167,271,1263,397,72,11,4,96,126,4,5,0,0
5671,1163,268,1265,402,72,11,4,102,134,0,5,0,0
5672,1163,268,1264,402,72,11,4,101,134,1,5,0,0
5673,1163,268,1265,402,72,11,4,102,134,2,5,0,0
5674,1163,268,1265,403,72,11,4,102,135,3,5,0,0
5675,1163,270,1264,402,72,11,4,101,132,4,5,0,0
5676,1162,270,1263,402,72,11,4,101,132,5,5,0,0
5817,1172,272,1264,399,73,11,4,92,127,0,4,0,0
5818,1170,271,1264,399,73,11,4,94,128,1,4,0,0
5819,1170,270,1264,399,73,11,4,94,129,2,4,0,0
5820,1170,270,1263,398,73,11,4,93,128,3,4,0,0
5821,1170,270,1263,397,73,11,4,93,127,4,4,0,0
5864,1174,271,1268,394,74,11,4,94,123,0,0,0,0
5871,1153,269,1272,402,75,11,4,119,133,0,5,0,0
5872,1151,269,1270,402,75,11,4,119,133,1,5,0,0
5873,1150,269,1270,403,75,11,4,120,134,2,5,0,0
5874,1151,269,1270,402,75,11,4,119,133,3,5,0,0
5875,1143,269,1269,409,75,11,4,126,140,4,5,0,0
5876,1141,269,1268,411,75,11,4,127,142,5,5,0,0
5879,1144,265,1273,409,75,11,4,129,144,0,5,0,0
5880,1143,264,1273,410,75,11,4,130,146,1,5,0,0
5891,1140,269,1270,415,75,11,4,130,146,0,5,0,0
5892,1141,270,1267,410,75,11,4,126,140,1,5,0,0
5893,1140,270,1267,410,75,11,4,127,140,2,5,0,0
5894,1141,269,1269,410,75,11,4,128,141,3,5,0,0
5895,1139,269,1269,413,75,11,4,130,144,4,5,0,0
5896,1139,269,1269,413,75,11,4,130,144,5,5,0,0
5906,1145,268,1276,414,75,11,4,131,146,0,5,0,0
5907,1148,267,1272,407,75,11,4,124,140,1,5,0,0
5908,1149,268,1270,404,75,11,4,121,136,2,5,0,0
5909,1148,268,1269,404,75,11,4,121,136,3,5,0,0
5910,1144,267,1270,409,75,11,4,126,142,4,5,0,0
5911,1143,267,1270,409,75,11,4,127,142,5,5,0,0
5951,1153,271,1262,405,76,11,4,109,134,0,0,0,0
5953,1157,270,1262,403,77,11,4,105,133,0,5,0,0
5954,1148,268,1261,411,77,11,4,113,143,1,5,0,0
5955,1148,267,1262,412,77,11,4,114,145,2,5,0,0
5956,1146,267,1262,413,77,11,4,116,146,3,5,0,0
5966,1160,273,1260,398,77,11,4,100,125,0,5,0,0
5967,1161,274,1261,397,77,11,4,100,123,1,5,0,0
5968,1159,273,1263,398,77,11,4,104,125,2,5,0,0
5969,1158,271,1265,399,77,11,4,107,128,3,5,0,0
5970,1158,271,1266,398,77,11,4,108,127,4,5,0,0
5971,1159,271,1266,398,77,11,4,107,127,5,5,0,0
5987,1149,268,1268,407,77,11,4,119,139,0,5,0,0
5988,1149,267,1268,408,77,11,4,119,141,1,5,0,0
194,2,896,92,1080,1,11,5,90,184,0,0,0,0
194,3,690,98,819,2,11,5,95,129,0,0,0,0
195,9,549,242,1067,3,11,5,233,518,0,87,0,1
196,0,433,279,1074,3,11,5,279,641,1,87,0,0
197,94,396,402,1074,3,11,5,308,678,2,87,0,0
198,219,382,535,1073,3,11,5,316,691,3,87,0,0
199,305,351,631,1069,3,11,5,326,718,4,87,0,0
200,453,349,785,1073,3,11,5,332,724,5,87,0,0
201,534,351,868,1074,3,11,5,334,723,6,87,0,0
202,663,341,994,1072,3,11,5,331,731,7,87,0,0
203,746,340,1076,1064,3,11,5,330,724,8,87,0,0
204,862,333,1178,1028,3,11,5,316,695,9,87,0,0
205,972,328,1275,998,3,11,5,303,670,10,87,0,0
206,1047,353,1337,975,3,11,5,290,622,11,87,0,0
207,1145,349,1426,948,3,11,5,281,599,12,87,0,0
208,1220,341,1500,934,3,11,5,280,593,13,87,0,0
209,1264,345,1539,920,3,11,5,275,575,14,87,0,0
210,1290,342,1560,897,3,11,5,270,555,15,87,0,0
211,1301,343,1574,891,3,11,5,273,548,16,87,0,0
212,1311,353,1591,908,3,11,5,280,555,17,87,0,0
213,1323,368,1614,942,3,11,5,291,574,18,87,0,0
214,1338,407,1619,958,3,11,5,281,551,19,87,0,0
215,1355,446,1624,966,3,11,5,269,520,20,87,0,0
216,1364,480,1624,971,3,11,5,260,491,21,87,0,0
217,1370,514,1618,972,3,11,5,248,458,22,87,0,0
218,1371,558,1607,984,3,11,5,236,426,23,87,0,0
219,1364,589,1591,988,3,11,5,227,399,24,87,0,0
220,1357,602,1587,998,3,11,5,230,396,25,87,0,0
221,1354,605,1586,997,3,11,5,232,392,26,87,0,0
222,1351,602,1589,996,3,11,5,238,394,27,87,0,0
223,1347,597,1591,997,3,11,5,244,400,28,87,0,0
224,1343,589,1591,993,3,11,5,248,404,29,87,0,0
225,1341,585,1595,996,3,11,5,254,411,30,87,0,0
226,1341,581,1596,997,3,11,5,255,416,31,87,0,0
227,1343,579,1597,992,3,11,5,254,413,32,87,0,0
228,1338,573,1602,1002,3,11,5,264,429,33,87,0,0
229,1341,564,1612,1002,3,11,5,271,438,34,87,0,0
230,1350,549,1630,997,3,11,5,280,448,35,87,0,0
231,1357,526,1656,995,3,11,5,299,469,36,87,0,0
232,1373,495,1688,988,3,11,5,315,493,37,87,0,0
233,1383,478,1715,999,3,11,5,332,521,38,87,0,0
234,1388,469,1733,1008,3,11,5,345,539,39,87,0,0
235,1409,460,1765,1015,3,11,5,356,555,40,87,0,0
236,1441,448,1804,1016,3,11,5,363,568,41,87,0,0
237,1453,433,1827,1018,3,11,5,374,585,42,87,0,0
238,1482,420,1859,1016,3,11,5,377,596,43,87,0,0
239,1507,416,1897,1044,3,11,5,390,628,44,87,0,0
240,1528,419,1920,1058,3,11,5,392,639,45,87,0,0
241,1544,433,1920,1063,3,11,5,376,630,46,87,0,0
242,1552,438,1920,1070,3,11,5,368,632,47,87,0,0
243,1588,441,1920,1073,3,11,5,332,632,48,87,0,0
244,1614,451,1920,1073,3,11,5,306,622,49,87,0,0
245,1628,465,1920,1071,3,11,5,292,606,50,87,0,0
246,1634,474,1920,1072,3,11,5,286,598,51,87,0,0
247,1633,478,1920,1070,3,11,5,287,592,52,87,0,0
248,1631,477,1920,1071,3,11,5,289,594,53,87,0,0
249,1627,478,1920,1073,3,11,5,293,595,54,87,0,0
250,1609,480,1918,1072,3,11,5,309,592,55,87,0,0
251,1562,482,1873,1067,3,11,5,311,585,56,87,0,0
252,1517,509,1822,1071,3,11,5,305,562,57,87,0,0
253,1489,561,1773,1071,3,11,5,284,510,58,87,0,0
254,1473,623,1732,1074,3,11,5,259,451,59,87,0,0
255,1459,665,1705,1074,3,11,5,246,409,60,87,0,0
256,1460,691,1701,1077,3,11,5,241,386,61,87,0,0
257,1459,701,1703,1079,3,11,5,244,378,62,87,0,0
258,1459,703,1709,1079,3,11,5,250,376,63,87,0,0
259,1463,704,1719,1077,3,11,5,256,373,64,87,0,0
260,1464,710,1723,1074,3,11,5,259,364,65,87,0,0
261,1460,717,1721,1073,3,11,5,261,356,66,87,0,0
262,1461,716,1731,1074,3,11,5,270,358,67,87,0,0
263,1485,716,1755,1074,3,11,5,270,358,68,87,0,0
264,1499,725,1764,1069,3,11,5,265,344,69,87,0,0
265,1497,736,1755,1062,3,11,5,258,326,70,87,0,0
266,1488,749,1748,1069,3,11,5,260,320,71,87,0,0
267,1479,735,1762,1075,3,11,5,283,340,72,87,0,0
268,1469,686,1795,1073,3,11,5,326,387,73,87,0,0
269,1458,607,1849,1072,3,11,5,391,465,74,87,0,0
270,1462,535,1905,1074,3,11,5,443,539,75,87,0,0
271,1464,471,1920,1067,3,11,5,456,596,76,87,0,0
272,1489,429,1920,1005,3,11,5,431,576,77,87,0,0
273,1512,407,1920,958,3,11,5,408,551,78,87,0,0
274,1556,394,1920,911,3,11,5,364,517,79,87,0,0
275,1598,376,1920,888,3,11,5,322,512,80,87,0,0
276,1637,366,1920,854,3,11,5,283,488,81,87,0,0
277,1662,344,1920,815,3,11,5,258,471,82,87,0,0
278,1677,344,1920,795,3,11,5,243,451,83,87,0,0
279,1719,373,1920,770,3,11,5,201,397,84,87,0,0
280,1754,372,1920,765,3,11,5,166,393,85,87,0,0
281,1777,386,1920,756,3,11,5,143,370,86,87,0,0
282,1793,380,1920,741,3,11,5,127,361,87,87,1,0
3644,1876,434,1918,625,4,11,5,42,191,0,26,0,1
3645,1860,341,1920,625,4,11,5,60,284,1,26,0,0
3646,1845,328,1912,632,4,11,5,67,304,2,26,0,0
3647,1832,311,1908,649,4,11,5,76,338,3,26,0,0
3648,1825,293,1912,677,4,11,5,87,384,4,26,0,0
3649,1809,288,1904,701,4,11,5,95,413,5,26,0,0
3650,1802,288,1901,706,4,11,5,99,418,6,26,0,0
3651,1774,291,1881,715,4,11,5,107,424,7,26,0,0
3652,1756,293,1875,744,4,11,5,119,451,8,26,0,0
3653,1744,288,1872,758,4,11,5,128,470,9,26,0,0
3654,1722,295,1862,795,4,11,5,140,500,10,26,0,0
3655,1704,308,1852,817,4,11,5,148,509,11,26,0,0
3656,1659,307,1821,830,4,11,5,162,523,12,26,0,0
3657,1618,315,1795,859,4,11,5,177,544,13,26,0,0
3658,1590,316,1778,873,4,11,5,188,557,14,26,0,0
3659,1545,330,1752,929,4,11,5,207,599,15,26,0,0
3660,1492,351,1714,968,4,11,5,222,617,16,26,0,0
3661,1455,353,1684,971,4,11,5,229,618,17,26,0,0
3662,1371,365,1619,1002,4,11,5,248,637,18,26,0,0
3663,1310,369,1574,1029,4,11,5,264,660,19,26,0,0
3664,1260,376,1533,1056,4,11,5,273,680,20,26,0,0
3665,1185,403,1454,1062,4,11,5,269,659,21,26,0,0
3666,1096,405,1371,1070,4,11,5,275,665,22,26,0,0
3667,992,426,1263,1071,4,11,5,271,645,23,26,0,0
3668,868,442,1137,1075,4,11,5,269,633,24,26,0,0
3669,738,455,1005,1076,4,11,5,267,621,25,26,0,0
3670,675,462,946,1080,4,11,5,271,618,26,26,1,0
3670,513,521,813,1074,5,11,5,300,553,0,0,0,0
3671,327,501,647,1064,6,11,5,320,563,0,4,0,0
3672,195,535,498,1066,6,11,5,303,531,1,4,0,0
3673,60,564,349,1069,6,11,5,289,505,2,4,0,0
3674,0,623,236,1076,6,11,5,236,453,3,4,0,0
3675,0,655,141,1080,6,11,5,141,425,4,4,0,0
4615,1794,843,1920,1073,7,11,5,126,230,0,0,0,0
4623,1334,408,1920,1026,8,11,5,586,618,0,13,0,0
4624,1378,390,1920,1004,8,11,5,542,614,1,13,0,0
4625,1423,367,1920,972,8,11,5,497,605,2,13,0,0
4626,1487,351,1920,902,8,11,5,433,551,3,13,0,0
4627,1520,344,1920,874,8,11,5,400,530,4,13,0,0
4628,1577,340,1920,822,8,11,5,343,482,5,13,0,0
4629,1615,329,1920,807,8,11,5,305,478,6,13,0,0
4630,1643,320,1920,794,8,11,5,277,474,7,13,0,0
4631,1684,318,1920,754,8,11,5,236,436,8,13,0,0
4632,1709,343,1920,733,8,11,5,211,390,9,13,0,0
4633,1739,350,1920,705,8,11,5,181,355,10,13,0,0
4634,1770,347,1920,688,8,11,5,150,341,11,13,0,0
4635,1789,348,1920,678,8,11,5,131,330,12,13,0,0
4636,1806,341,1920,658,8,11,5,114,317,13,13,0,0
4629,1865,336,1918,412,9,11,5,53,76,0,0,0,0
4636,1862,345,1920,650,10,11,5,58,305,0,2,0,0
4637,1862,356,1916,638,10,11,5,54,282,1,2,0,0
4638,1878,436,1913,614,10,11,5,35,178,2,2,0,0
4745,1864,490,1917,639,11,11,5,53,149,0,32,0,1
4746,1847,425,1920,645,11,11,5,73,220,1,32,0,0
4747,1836,380,1920,663,11,11,5,84,283,2,32,0,0
4748,1823,359,1920,676,11,11,5,97,317,3,32,0,0
4749,1813,349,1920,680,11,11,5,107,331,4,32,0,0
4750,1786,337,1912,696,11,11,5,126,359,5,32,0,0
4751,1772,330,1906,706,11,11,5,134,376,6,32,0,0
4752,1757,329,1903,733,11,11,5,146,404,7,32,0,0
4753,1736,332,1891,753,11,11,5,155,421,8,32,0,0
4754,1716,330,1876,760,11,11,5,160,430,9,32,0,0
4755,1667,334,1836,774,11,11,5,169,440,10,32,0,0
4756,1632,326,1811,782,11,11,5,179,456,11,32,0,0
4757,1587,338,1777,810,11,11,5,190,472,12,32,0,0
4758,1548,352,1745,831,11,11,5,197,479,13,32,0,0
4759,1495,356,1702,845,11,11,5,207,489,14,32,0,0
4760,1430,367,1651,870,11,11,5,221,503,15,32,0,0
4761,1395,364,1624,880,11,11,5,229,516,16,32,0,0
4762,1324,381,1576,941,11,11,5,252,560,17,32,0,0
4763,1274,399,1536,976,11,11,5,262,577,18,32,0,0
4764,1182,401,1462,1002,11,11,5,280,601,19,32,0,0
4765,1105,415,1392,1024,11,11,5,287,609,20,32,0,0
4766,1038,426,1334,1059,11,11,5,296,633,21,32,0,0
4767,931,449,1226,1070,11,11,5,295,621,22,32,0,0
4768,841,461,1130,1078,11,11,5,289,617,23,32,0,0
4769,726,480,1013,1080,11,11,5,287,600,24,32,0,0
4770,596,481,889,1080,11,11,5,293,599,25,32,0,0
4771,454,491,747,1080,11,11,5,293,589,26,32,0,0
4772,342,510,640,1080,11,11,5,298,570,27,32,0,0
4773,185,524,478,1079,11,11,5,293,555,28,32,0,0
4774,76,540,371,1079,11,11,5,295,539,29,32,0,0
4775,0,570,261,1080,11,11,5,261,510,30,32,0,0
4776,0,621,193,1077,11,11,5,193,456,31,32,0,0
4777,0,637,106,1080,11,11,5,106,443,32,32,1,0
4777,1,953,123,1079,12,11,5,122,126,0,0,0,0
128,287,106,326,239,1,11,6,39,133,0,69,0,1
129,296,110,334,241,1,11,6,38,131,1,69,0,0
130,304,104,345,243,1,11,6,41,139,2,69,0,0
131,314,102,358,249,1,11,6,44,147,3,69,0,0
132,323,103,366,249,1,11,6,43,146,4,69,0,0
133,331,107,373,249,1,11,6,42,142,5,69,0,0
134,336,104,381,253,1,11,6,45,149,6,69,0,0
135,344,107,389,256,1,11,6,45,149,7,69,0,0
136,352,103,401,262,1,11,6,49,159,8,69,0,0
137,359,104,409,265,1,11,6,50,161,9,69,0,0
138,364,105,415,266,1,11,6,51,161,10,69,0,0
139,369,107,420,270,1,11,6,51,163,11,69,0,0
140,375,108,427,274,1,11,6,52,166,12,69,0,0
141,382,108,435,275,1,11,6,53,167,13,69,0,0
142,388,112,441,278,1,11,6,53,166,14,69,0,0
143,390,113,445,287,1,11,6,55,174,15,69,0,0
144,392,113,448,289,1,11,6,56,176,16,69,0,0
145,395,115,453,294,1,11,6,58,179,17,69,0,0
146,401,115,460,299,1,11,6,59,184,18,69,0,0
147,405,114,467,307,1,11,6,62,193,19,69,0,0
148,408,116,471,311,1,11,6,63,195,20,69,0,0
149,413,116,476,314,1,11,6,63,198,21,69,0,0
150,416,116,482,320,1,11,6,66,204,22,69,0,0
151,421,121,488,328,1,11,6,67,207,23,69,0,0
152,427,120,497,334,1,11,6,70,214,24,69,0,0
153,432,123,501,335,1,11,6,69,212,25,69,0,0
154,433,126,506,347,1,11,6,73,221,26,69,0,0
155,436,125,510,350,1,11,6,74,225,27,69,0,0
156,441,132,516,360,1,11,6,75,228,28,69,0,0
157,447,133,524,367,1,11,6,77,234,29,69,0,0
158,453,135,532,372,1,11,6,79,237,30,69,0,0
159,456,138,538,388,1,11,6,82,250,31,69,0,0
160,462,138,545,393,1,11,6,83,255,32,69,0,0
161,470,144,552,399,1,11,6,82,255,33,69,0,0
162,478,148,562,407,1,11,6,84,259,34,69,0,0
163,487,148,572,410,1,11,6,85,262,35,69,0,0
164,493,153,577,414,1,11,6,84,261,36,69,0,0
165,499,155,585,423,1,11,6,86,268,37,69,0,0
166,503,156,594,440,1,11,6,91,284,38,69,0,0
167,507,163,600,452,1,11,6,93,289,39,69,0,0
168,514,165,609,461,1,11,6,95,296,40,69,0,0
169,518,166,619,479,1,11,6,101,313,41,69,0,0
170,522,172,629,504,1,11,6,107,332,42,69,0,0
171,527,173,636,510,1,11,6,109,337,43,69,0,0
172,532,178,646,530,1,11,6,114,352,44,69,0,0
173,543,185,662,549,1,11,6,119,364,45,69,0,0
174,558,188,680,561,1,11,6,122,373,46,69,0,0
175,573,197,701,588,1,11,6,128,391,47,69,0,0
176,591,202,722,599,1,11,6,131,397,48,69,0,0
177,605,209,740,618,1,11,6,135,409,49,69,0,0
178,625,224,764,642,1,11,6,139,418,50,69,0,0
179,651,230,794,657,1,11,6,143,427,51,69,0,0
180,677,246,831,703,1,11,6,154,457,52,69,0,0
181,697,258,858,731,1,11,6,161,473,53,69,0,0
182,710,260,878,754,1,11,6,168,494,54,69,0,0
183,728,281,900,784,1,11,6,172,503,55,69,0,0
184,760,294,937,809,1,11,6,177,515,56,69,0,0
185,798,303,998,882,1,11,6,200,579,57,69,0,0
186,836,329,1046,932,1,11,6,210,603,58,69,0,0
187,869,343,1082,953,1,11,6,213,610,59,69,0,0
188,899,374,1122,1008,1,11,6,223,634,60,69,0,0
189,937,404,1170,1052,1,11,6,233,648,61,69,0,0
190,1021,426,1259,1074,1,11,6,238,648,62,69,0,0
191,1100,463,1340,1078,1,11,6,240,615,63,69,0,0
192,1166,500,1401,1079,1,11,6,235,579,64,69,0,0
193,1236,543,1464,1080,1,11,6,228,537,65,69,0,0
194,1343,612,1554,1080,1,11,6,211,468,66,69,0,0
195,1464,658,1668,1080,1,11,6,204,422,67,69,0,0
196,1591,729,1775,1080,1,11,6,184,351,68,69,0,0
197,1663,764,1836,1080,1,11,6,173,316,69,69,1,0
3677,1404,812,1630,1073,4,11,6,226,261,0,0,0,0
3678,1181,695,1527,1069,5,11,6,346,374,0,70,0,1
3679,1053,630,1461,1072,5,11,6,408,442,1,70,0,0
3680,939,577,1393,1071,5,11,6,454,494,2,70,0,0
3681,837,515,1343,1069,5,11,6,506,554,3,70,0,0
3682,768,470,1303,1067,5,11,6,535,597,4,70,0,0
3683,692,427,1253,1068,5,11,6,561,641,5,70,0,0
3684,636,387,1213,1067,5,11,6,577,680,6,70,0,0
3685,586,365,1169,1075,5,11,6,583,710,7,70,0,0
3686,575,335,1117,1018,5,11,6,542,683,8,70,0,0
3687,576,309,1071,958,5,11,6,495,649,9,70,0,0
3688,567,296,1023,921,5,11,6,456,625,10,70,0,0
3689,569,273,970,846,5,11,6,401,573,11,70,0,0
3690,561,262,938,825,5,11,6,377,563,12,70,0,0
3691,557,252,904,788,5,11,6,347,536,13,70,0,0
3692,568,243,869,728,5,11,6,301,485,14,70,0,0
3693,573,252,848,712,5,11,6,275,460,15,70,0,0
3694,563,228,820,674,5,11,6,257,446,16,70,0,0
3695,558,215,798,647,5,11,6,240,432,17,70,0,0
3696,547,207,777,634,5,11,6,230,427,18,70,0,0
3697,545,197,755,599,5,11,6,210,402,19,70,0,0
3698,543,194,740,584,5,11,6,197,390,20,70,0,0
3699,533,190,711,554,5,11,6,178,364,21,70,0,0
3700,525,180,690,527,5,11,6,165,347,22,70,0,0
3701,512,179,673,526,5,11,6,161,347,23,70,0,0
3702,504,173,657,510,5,11,6,153,337,24,70,0,0
3703,501,167,644,489,5,11,6,143,322,25,70,0,0
3704,496,165,632,479,5,11,6,136,314,26,70,0,0
3705,492,159,617,454,5,11,6,125,295,27,70,0,0
3706,487,158,607,445,5,11,6,120,287,28,70,0,0
3707,481,156,598,439,5,11,6,117,283,29,70,0,0
3708,480,148,593,424,5,11,6,113,276,30,70,0,0
3709,479,148,588,419,5,11,6,109,271,31,70,0,0
3710,477,144,581,404,5,11,6,104,260,32,70,0,0
3711,476,142,576,392,5,11,6,100,250,33,70,0,0
3712,474,142,572,386,5,11,6,98,244,34,70,0,0
3713,474,136,568,373,5,11,6,94,237,35,70,0,0
3714,473,135,564,369,5,11,6,91,234,36,70,0,0
3715,469,132,559,363,5,11,6,90,231,37,70,0,0
3716,467,128,552,351,5,11,6,85,223,38,70,0,0
3717,461,132,544,347,5,11,6,83,215,39,70,0,0
3718,453,128,534,341,5,11,6,81,213,40,70,0,0
3719,447,123,528,336,5,11,6,81,213,41,70,0,0
3720,442,126,520,334,5,11,6,78,208,42,70,0,0
3721,435,122,512,332,5,11,6,77,210,43,70,0,0
3722,427,121,503,328,5,11,6,76,207,44,70,0,0
3723,420,119,497,328,5,11,6,77,209,45,70,0,0
3724,417,115,492,316,5,11,6,75,201,46,70,0,0
3725,416,116,488,312,5,11,6,72,196,47,70,0,0
3726,413,115,482,303,5,11,6,69,188,48,70,0,0
3727,410,113,479,302,5,11,6,69,189,49,70,0,0
3728,408,113,477,300,5,11,6,69,187,50,70,0,0
3729,412,112,476,286,5,11,6,64,174,51,70,0,0
3730,414,111,477,280,5,11,6,63,169,52,70,0,0
3731,412,112,473,276,5,11,6,61,164,53,70,0,0
3732,410,110,470,270,5,11,6,60,160,54,70,0,0
3733,409,109,468,268,5,11,6,59,159,55,70,0,0
3734,407,109,466,265,5,11,6,59,156,56,70,0,0
3735,406,107,463,261,5,11,6,57,154,57,70,0,0
3736,403,108,457,255,5,11,6,54,147,58,70,0,0
3737,397,107,450,252,5,11,6,53,145,59,70,0,0
3738,391,104,444,251,5,11,6,53,147,60,70,0,0
3739,383,103,436,249,5,11,6,53,146,61,70,0,0
3740,373,100,425,245,5,11,6,52,145,62,70,0,0
3741,362,102,413,244,5,11,6,51,142,63,70,0,0
3742,351,103,400,238,5,11,6,49,135,64,70,0,0
3743,338,100,386,235,5,11,6,48,135,65,70,0,0
3744,324,102,374,239,5,11,6,50,137,66,70,0,0
3745,308,99,356,234,5,11,6,48,135,67,70,0,0
3746,297,100,343,233,5,11,6,46,133,68,70,0,0
3747,286,100,331,232,5,11,6,45,132,69,70,0,0
3748,276,99,321,229,5,11,6,45,130,70,70,1,0
4778,1561,821,1780,1076,8,11,6,219,255,0,0,0,0
4779,1379,750,1677,1071,9,11,6,298,321,0,50,0,1
4780,1283,687,1638,1071,9,11,6,355,384,1,50,0,0
4781,1185,636,1586,1073,9,11,6,401,437,2,50,0,0
4782,1071,581,1513,1067,9,11,6,442,486,3,50,0,0
4783,962,537,1439,1070,9,11,6,477,533,4,50,0,0
4784,890,495,1394,1074,9,11,6,504,579,5,50,0,0
4785,842,458,1360,1072,9,11,6,518,614,6,50,0,0
4786,801,423,1321,1063,9,11,6,520,640,7,50,0,0
4787,781,391,1255,995,9,11,6,474,604,8,50,0,0
4788,758,371,1201,956,9,11,6,443,585,9,50,0,0
4789,748,347,1147,897,9,11,6,399,550,10,50,0,0
4790,730,327,1100,860,9,11,6,370,533,11,50,0,0
4791,715,316,1056,825,9,11,6,341,509,12,50,0,0
4792,709,297,1019,777,9,11,6,310,480,13,50,0,0
4793,692,286,983,754,9,11,6,291,468,14,50,0,0
4794,686,278,945,709,9,11,6,259,431,15,50,0,0
4795,668,266,910,686,9,11,6,242,420,16,50,0,0
4796,655,260,883,669,9,11,6,228,409,17,50,0,0
4797,648,249,857,634,9,11,6,209,385,18,50,0,0
4798,638,238,839,621,9,11,6,201,383,19,50,0,0
4799,635,233,819,593,9,11,6,184,360,20,50,0,0
4800,625,225,798,571,9,11,6,173,346,21,50,0,0
4801,622,224,783,558,9,11,6,161,334,22,50,0,0
4802,628,215,780,537,9,11,6,152,322,23,50,0,0
4803,632,210,779,528,9,11,6,147,318,24,50,0,0
4804,632,198,774,508,9,11,6,142,310,25,50,0,0
4805,633,192,767,490,9,11,6,134,298,26,50,0,0
4806,641,195,765,476,9,11,6,124,281,27,50,0,0
4807,656,192,775,464,9,11,6,119,272,28,50,0,0
4808,670,188,787,461,9,11,6,117,273,29,50,0,0
4809,678,185,791,447,9,11,6,113,262,30,50,0,0
4810,679,178,788,436,9,11,6,109,258,31,50,0,0
4811,684,177,788,426,9,11,6,104,249,32,50,0,0
4812,694,174,794,416,9,11,6,100,242,33,50,0,0
4813,702,174,800,414,9,11,6,98,240,34,50,0,0
4814,708,171,802,401,9,11,6,94,230,35,50,0,0
4815,709,168,800,395,9,11,6,91,227,36,50,0,0
4816,711,167,800,391,9,11,6,89,224,37,50,0,0
4817,718,163,803,380,9,11,6,85,217,38,50,0,0
4818,721,160,805,374,9,11,6,84,214,39,50,0,0
4819,723,159,804,368,9,11,6,81,209,40,50,0,0
4820,721,153,802,361,9,11,6,81,208,41,50,0,0
4821,720,154,797,356,9,11,6,77,202,42,50,0,0
4822,721,149,795,343,9,11,6,74,194,43,50,0,0
4823,718,146,792,338,9,11,6,74,192,44,50,0,0
4824,712,147,784,335,9,11,6,72,188,45,50,0,0
4825,704,138,776,327,9,11,6,72,189,46,50,0,0
4826,695,137,764,322,9,11,6,69,185,47,50,0,0
4827,690,137,755,315,9,11,6,65,178,48,50,0,0
4828,689,139,750,307,9,11,6,61,168,49,50,0,0
4829,687,137,745,300,9,11,6,58,163,50,50,1,0
199,1722,708,1916,1074,1,11,7,194,366,0,0,0,0
200,1505,711,1792,1077,2,11,7,287,366,0,0,0,0
201,1290,649,1631,1069,3,11,7,341,420,0,0,0,0
202,1002,613,1448,1075,4,11,7,446,462,0,93,0,1
203,819,581,1297,1076,4,11,7,478,495,1,93,0,0
204,730,527,1253,1076,4,11,7,523,549,2,93,0,0
205,616,506,1146,1071,4,11,7,530,565,3,93,0,0
206,493,498,1019,1069,4,11,7,526,571,4,93,0,0
207,359,464,903,1070,4,11,7,544,606,5,93,0,0
208,272,450,812,1067,4,11,7,540,617,6,93,0,0
209,205,434,741,1067,4,11,7,536,633,7,93,0,0
210,165,413,700,1062,4,11,7,535,649,8,93,0,0
211,137,411,663,1063,4,11,7,526,652,9,93,0,0
212,106,406,620,1060,4,11,7,514,654,10,93,0,0
213,97,401,600,1060,4,11,7,503,659,11,93,0,0
214,114,393,602,1051,4,11,7,488,658,12,93,0,0
215,162,390,637,1045,4,11,7,475,655,13,93,0,0
216,207,392,662,1038,4,11,7,455,646,14,93,0,0
217,249,406,669,1018,4,11,7,420,612,15,93,0,0
218,281,428,668,1009,4,11,7,387,581,16,93,0,0
219,308,456,667,1006,4,11,7,359,550,17,93,0,0
220,342,498,668,1000,4,11,7,326,502,18,93,0,0
221,373,539,674,1004,4,11,7,301,465,19,93,0,0
222,394,570,674,1000,4,11,7,280,430,20,93,0,0
223,403,577,677,996,4,11,7,274,419,21,93,0,0
224,403,574,681,997,4,11,7,278,423,22,93,0,0
225,404,575,684,999,4,11,7,280,424,23,93,0,0
226,401,573,686,1001,4,11,7,285,428,24,93,0,0
227,399,569,693,1007,4,11,7,294,438,25,93,0,0
228,400,569,696,1009,4,11,7,296,440,26,93,0,0
229,397,566,697,1009,4,11,7,300,443,27,93,0,0
230,390,558,695,1008,4,11,7,305,450,28,93,0,0
231,383,538,699,1007,4,11,7,316,469,29,93,0,0
232,366,505,698,1008,4,11,7,332,503,30,93,0,0
233,348,467,696,1006,4,11,7,348,539,31,93,0,0
234,340,415,703,992,4,11,7,363,577,32,93,0,0
235,339,380,705,980,4,11,7,366,600,33,93,0,0
236,345,358,708,973,4,11,7,363,615,34,93,0,0
237,358,337,708,951,4,11,7,350,614,35,93,0,0
238,371,319,703,920,4,11,7,332,601,36,93,0,0
239,376,303,703,910,4,11,7,327,607,37,93,0,0
240,376,289,686,877,4,11,7,310,588,38,93,0,0
241,391,280,692,858,4,11,7,301,578,39,93,0,0
242,399,275,695,846,4,11,7,296,571,40,93,0,0
243,420,270,709,837,4,11,7,289,567,41,93,0,0
244,441,273,723,838,4,11,7,282,565,42,93,0,0
245,476,270,752,823,4,11,7,276,553,43,93,0,0
246,501,280,768,812,4,11,7,267,532,44,93,0,0
247,516,293,776,808,4,11,7,260,515,45,93,0,0
248,534,303,786,804,4,11,7,252,501,46,93,0,0
249,544,305,792,804,4,11,7,248,499,47,93,0,0
250,548,302,793,799,4,11,7,245,497,48,93,0,0
251,554,307,798,808,4,11,7,244,501,49,93,0,0
252,549,322,791,818,4,11,7,242,496,50,93,0,0
253,548,336,801,843,4,11,7,253,507,51,93,0,0
254,543,362,809,879,4,11,7,266,517,52,93,0,0
255,544,416,799,893,4,11,7,255,477,53,93,0,0
256,548,473,792,909,4,11,7,244,436,54,93,0,0
257,563,518,794,913,4,11,7,231,395,55,93,0,0
258,567,543,800,926,4,11,7,233,383,56,93,0,0
259,563,552,800,928,4,11,7,237,376,57,93,0,0
260,558,552,803,931,4,11,7,245,379,58,93,0,0
261,551,549,804,932,4,11,7,253,383,59,93,0,0
262,554,552,807,923,4,11,7,253,371,60,93,0,0
263,552,557,807,921,4,11,7,255,364,61,93,0,0
264,546,560,807,924,4,11,7,261,364,62,93,0,0
265,546,554,806,908,4,11,7,260,354,63,93,0,0
266,540,543,809,904,4,11,7,269,361,64,93,0,0
267,541,537,821,909,4,11,7,280,372,65,93,0,0
268,550,536,828,905,4,11,7,278,369,66,93,0,0
269,542,524,830,908,4,11,7,288,384,67,93,0,0
270,527,487,839,906,4,11,7,312,419,68,93,0,0
271,491,432,837,904,4,11,7,346,472,69,93,0,0
272,442,369,815,888,4,11,7,373,519,70,93,0,0
273,405,344,782,872,4,11,7,377,528,71,93,0,0
274,328,318,704,859,4,11,7,376,541,72,93,0,0
275,271,314,633,846,4,11,7,362,532,73,93,0,0
276,217,311,557,827,4,11,7,340,516,74,93,0,0
277,174,295,496,799,4,11,7,322,504,75,93,0,0
278,147,298,451,783,4,11,7,304,485,76,93,0,0
279,106,293,389,758,4,11,7,283,465,77,93,0,0
280,75,293,345,750,4,11,7,270,457,78,93,0,0
281,55,285,308,729,4,11,7,253,444,79,93,0,0
282,53,279,284,694,4,11,7,231,415,80,93,0,0
283,50,281,265,674,4,11,7,215,393,81,93,0,0
284,35,282,236,655,4,11,7,201,373,82,93,0,0
285,10,278,201,642,4,11,7,191,364,83,93,0,0
286,0,277,183,638,4,11,7,183,361,84,93,0,0
287,0,274,162,617,4,11,7,162,343,85,93,0,0
288,0,276,153,602,4,11,7,153,326,86,93,0,0
289,0,279,138,592,4,11,7,138,313,87,93,0,0
290,0,267,121,585,4,11,7,121,318,88,93,0,0
291,0,267,108,586,4,11,7,108,319,89,93,0,0
292,0,281,87,569,4,11,7,87,288,90,93,0,0
293,0,286,76,555,4,11,7,76,269,91,93,0,0
294,0,298,70,547,4,11,7,70,249,92,93,0,0
295,0,300,56,536,4,11,7,56,236,93,93,1,0
3647,2,389,38,633,5,11,7,36,244,0,30,0,1
3648,3,359,45,645,5,11,7,42,286,1,30,0,0
3649,11,356,58,669,5,11,7,47,313,2,30,0,0
3650,13,346,64,677,5,11,7,51,331,3,30,0,0
3651,32,344,87,683,5,11,7,55,339,4,30,0,0
3652,41,330,107,702,5,11,7,66,372,5,30,0,0
3653,41,313,116,712,5,11,7,75,399,6,30,0,0
3654,54,304,141,734,5,11,7,87,430,7,30,0,0
3655,74,305,171,753,5,11,7,97,448,8,30,0,0
3656,93,304,201,761,5,11,7,108,457,9,30,0,0
3657,128,308,249,776,5,11,7,121,468,10,30,0,0
3658,150,307,283,791,5,11,7,133,484,11,30,0,0
3659,175,307,325,826,5,11,7,150,519,12,30,0,0
3660,209,319,373,854,5,11,7,164,535,13,30,0,0
3661,233,317,406,867,5,11,7,173,550,14,30,0,0
3662,293,328,482,882,5,11,7,189,554,15,30,0,0
3663,341,337,545,909,5,11,7,204,572,16,30,0,0
3664,365,338,585,949,5,11,7,220,611,17,30,0,0
3665,431,351,673,999,5,11,7,242,648,18,30,0,0
3666,479,358,733,1029,5,11,7,254,671,19,30,0,0
3667,581,363,855,1051,5,11,7,274,688,20,30,0,0
3668,663,385,946,1072,5,11,7,283,687,21,30,0,0
3669,737,381,1021,1080,5,11,7,284,699,22,30,0,0
3670,852,409,1126,1080,5,11,7,274,671,23,30,0,0
3671,958,437,1225,1080,5,11,7,267,643,24,30,0,0
3672,1091,446,1354,1078,5,11,7,263,632,25,30,0,0
3673,1226,471,1483,1073,5,11,7,257,602,26,30,0,0
3674,1387,478,1646,1074,5,11,7,259,596,27,30,0,0
3675,1517,512,1771,1066,5,11,7,254,554,28,30,0,0
3676,1633,563,1876,1077,5,11,7,243,514,29,30,0,0
3677,1726,579,1920,1080,5,11,7,194,501,30,30,1,0
4555,1612,79,1647,197,6,11,7,35,118,0,86,0,1
4556,1608,79,1644,198,6,11,7,36,119,1,86,0,0
4557,1605,79,1642,200,6,11,7,37,121,2,86,0,0
4558,1602,74,1641,202,6,11,7,39,128,3,86,0,0
4559,1599,74,1639,206,6,11,7,40,132,4,86,0,0
4560,1596,70,1639,210,6,11,7,43,140,5,86,0,0
4561,1594,75,1637,211,6,11,7,43,136,6,86,0,0
4562,1592,80,1634,213,6,11,7,42,133,7,86,0,0
4563,1589,83,1631,214,6,11,7,42,131,8,86,0,0
4564,1588,85,1630,220,6,11,7,42,135,9,86,0,0
4565,1587,82,1632,223,6,11,7,45,141,10,86,0,0
4566,1587,88,1630,224,6,11,7,43,136,11,86,0,0
4567,1587,100,1628,227,6,11,7,41,127,12,86,0,0
4568,1583,101,1625,227,6,11,7,42,126,13,86,0,0
4569,1582,102,1625,233,6,11,7,43,131,14,86,0,0
4570,1579,100,1625,238,6,11,7,46,138,15,86,0,0
4571,1576,96,1625,241,6,11,7,49,145,16,86,0,0
4572,1573,98,1622,245,6,11,7,49,147,17,86,0,0
4573,1570,98,1620,247,6,11,7,50,149,18,86,0,0
4574,1566,95,1620,254,6,11,7,54,159,19,86,0,0
4575,1563,92,1620,259,6,11,7,57,167,20,86,0,0
4576,1561,88,1619,261,6,11,7,58,173,21,86,0,0
4577,1560,95,1617,266,6,11,7,57,171,22,86,0,0
4578,1560,95,1617,269,6,11,7,57,174,23,86,0,0
4579,1557,93,1617,275,6,11,7,60,182,24,86,0,0
4580,1556,95,1618,282,6,11,7,62,187,25,86,0,0
4581,1555,95,1617,284,6,11,7,62,189,26,86,0,0
4582,1555,96,1617,286,6,11,7,62,190,27,86,0,0
4583,1551,98,1616,294,6,11,7,65,196,28,86,0,0
4584,1551,102,1616,300,6,11,7,65,198,29,86,0,0
4585,1552,104,1618,307,6,11,7,66,203,30,86,0,0
4586,1550,104,1617,310,6,11,7,67,206,31,86,0,0
4587,1548,108,1616,317,6,11,7,68,209,32,86,0,0
4588,1545,109,1614,323,6,11,7,69,214,33,86,0,0
4589,1544,113,1611,324,6,11,7,67,211,34,86,0,0
4590,1542,110,1615,335,6,11,7,73,225,35,86,0,0
4591,1540,111,1616,347,6,11,7,76,236,36,86,0,0
4592,1538,113,1614,351,6,11,7,76,238,37,86,0,0
4593,1534,118,1611,361,6,11,7,77,243,38,86,0,0
4594,1528,116,1608,366,6,11,7,80,250,39,86,0,0
4595,1524,115,1608,378,6,11,7,84,263,40,86,0,0
4596,1521,121,1607,388,6,11,7,86,267,41,86,0,0
4597,1515,122,1602,393,6,11,7,87,271,42,86,0,0
4598,1506,125,1596,407,6,11,7,90,282,43,86,0,0
4599,1499,129,1590,416,6,11,7,91,287,44,86,0,0
4600,1495,131,1589,428,6,11,7,94,297,45,86,0,0
4601,1490,136,1589,446,6,11,7,99,310,46,86,0,0
4602,1482,137,1584,455,6,11,7,102,318,47,86,0,0
4603,1470,143,1575,471,6,11,7,105,328,48,86,0,0
4604,1460,150,1568,485,6,11,7,108,335,49,86,0,0
4605,1450,146,1564,494,6,11,7,114,348,50,86,0,0
4606,1441,159,1561,522,6,11,7,120,363,51,86,0,0
4607,1434,167,1557,539,6,11,7,123,372,52,86,0,0
4608,1425,170,1552,551,6,11,7,127,381,53,86,0,0
4609,1410,177,1543,575,6,11,7,133,398,54,86,0,0
4610,1395,180,1532,588,6,11,7,137,408,55,86,0,0
4611,1379,187,1526,630,6,11,7,147,443,56,86,0,0
4612,1362,200,1516,664,6,11,7,154,464,57,86,0,0
4613,1340,207,1497,677,6,11,7,157,470,58,86,0,0
4614,1303,217,1472,719,6,11,7,169,502,59,86,0,0
4615,1274,225,1447,740,6,11,7,173,515,60,86,0,0
4616,1240,235,1425,790,6,11,7,185,555,61,86,0,0
4617,1199,254,1395,833,6,11,7,196,579,62,86,0,0
4618,1135,255,1338,859,6,11,7,203,604,63,86,0,0
4619,1049,267,1265,883,6,11,7,216,616,64,86,0,0
4620,974,275,1197,896,6,11,7,223,621,65,86,0,0
4621,870,276,1102,915,6,11,7,232,639,66,86,0,0
4622,784,291,1025,919,6,11,7,241,628,67,86,0,0
4623,676,292,921,920,6,11,7,245,628,68,86,0,0
4624,579,298,825,919,6,11,7,246,621,69,86,0,0
4625,501,301,750,909,6,11,7,249,608,70,86,0,0
4626,416,300,651,885,6,11,7,235,585,71,86,0,0
4627,357,305,585,859,6,11,7,228,554,72,86,0,0
4628,298,308,521,840,6,11,7,223,532,73,86,0,0
4629,222,309,435,821,6,11,7,213,512,74,86,0,0
4630,177,316,385,809,6,11,7,208,493,75,86,0,0
4631,125,311,322,787,6,11,7,197,476,76,86,0,0
4632,99,304,286,754,6,11,7,187,450,77,86,0,0
4633,76,299,260,739,6,11,7,184,440,78,86,0,0
4634,37,306,209,722,6,11,7,172,416,79,86,0,0
4635,15,306,184,714,6,11,7,169,408,80,86,0,0
4636,0,301,147,693,6,11,7,147,392,81,86,0,0
4637,0,300,130,668,6,11,7,130,368,82,86,0,0
4638,0,335,112,652,6,11,7,112,317,83,86,0,0
4639,0,344,84,643,6,11,7,84,299,84,86,0,0
4640,0,358,70,640,6,11,7,70,282,85,86,0,0
4641,0,366,38,628,6,11,7,38,262,86,86,1,0
4747,3,377,39,612,8,11,7,36,235,0,30,0,1
4748,4,351,48,637,8,11,7,44,286,1,30,0,0
4749,7,341,55,652,8,11,7,48,311,2,30,0,0
4750,24,317,80,667,8,11,7,56,350,3,30,0,0
4751,30,311,92,678,8,11,7,62,367,4,30,0,0
4752,29,318,95,689,8,11,7,66,371,5,30,0,0
4753,38,325,111,717,8,11,7,73,392,6,30,0,0
4754,42,327,122,727,8,11,7,80,400,7,30,0,0
4755,65,335,155,738,8,11,7,90,403,8,30,0,0
4756,79,337,180,753,8,11,7,101,416,9,30,0,0
4757,91,338,203,781,8,11,7,112,443,10,30,0,0
4758,109,345,234,822,8,11,7,125,477,11,30,0,0
4759,121,347,252,823,8,11,7,131,476,12,30,0,0
4760,155,370,298,851,8,11,7,143,481,13,30,0,0
4761,179,383,335,880,8,11,7,156,497,14,30,0,0
4762,207,400,382,934,8,11,7,175,534,15,30,0,0
4763,239,415,424,965,8,11,7,185,550,16,30,0,0
4764,277,424,473,988,8,11,7,196,564,17,30,0,0
4765,342,436,559,1020,8,11,7,217,584,18,30,0,0
4766,388,452,614,1042,8,11,7,226,590,19,30,0,0
4767,456,466,693,1069,8,11,7,237,603,20,30,0,0
4768,516,487,753,1080,8,11,7,237,593,21,30,0,0
4769,615,508,853,1080,8,11,7,238,572,22,30,0,0
4770,721,529,957,1080,8,11,7,236,551,23,30,0,0
4771,838,547,1072,1079,8,11,7,234,532,24,30,0,0
4772,959,605,1183,1074,8,11,7,224,469,25,30,0,0
4773,1098,639,1321,1076,8,11,7,223,437,26,30,0,0
4774,1257,677,1479,1080,8,11,7,222,403,27,30,0,0
4775,1432,715,1649,1079,8,11,7,217,364,28,30,0,0
4776,1586,753,1795,1073,8,11,7,209,320,29,30,0,0
4777,1699,780,1895,1079,8,11,7,196,299,30,30,1,0
50,496,91,532,212,2,11,9,36,121,0,84,0,1
51,497,92,533,211,2,11,9,36,119,1,84,0,0
52,497,91,533,212,2,11,9,36,121,2,84,0,0
53,494,89,533,215,2,11,9,39,126,3,84,0,0
54,496,91,537,219,2,11,9,41,128,4,84,0,0
55,500,92,541,220,2,11,9,41,128,5,84,0,0
56,503,94,544,221,2,11,9,41,127,6,84,0,0
57,505,96,546,222,2,11,9,41,126,7,84,0,0
58,504,94,547,226,2,11,9,43,132,8,84,0,0
59,506,96,550,230,2,11,9,44,134,9,84,0,0
60,509,97,552,230,2,11,9,43,133,10,84,0,0
61,510,97,554,230,2,11,9,44,133,11,84,0,0
62,509,95,554,233,2,11,9,45,138,12,84,0,0
63,510,96,554,233,2,11,9,44,137,13,84,0,0
64,510,98,555,237,2,11,9,45,139,14,84,0,0
65,513,101,559,242,2,11,9,46,141,15,84,0,0
66,516,101,562,244,2,11,9,46,143,16,84,0,0
67,518,104,564,246,2,11,9,46,142,17,84,0,0
68,519,106,566,247,2,11,9,47,141,18,84,0,0
69,519,101,567,249,2,11,9,48,148,19,84,0,0
70,520,104,569,253,2,11,9,49,149,20,84,0,0
71,521,107,569,252,2,11,9,48,145,21,84,0,0
72,520,106,569,254,2,11,9,49,148,22,84,0,0
73,518,108,568,258,2,11,9,50,150,23,84,0,0
74,519,108,569,261,2,11,9,50,153,24,84,0,0
75,520,110,572,266,2,11,9,52,156,25,84,0,0
76,522,112,574,270,2,11,9,52,158,26,84,0,0
77,521,114,573,272,2,11,9,52,158,27,84,0,0
78,520,115,573,276,2,11,9,53,161,28,84,0,0
79,519,116,572,279,2,11,9,53,163,29,84,0,0
80,519,115,574,285,2,11,9,55,170,30,84,0,0
81,517,117,574,293,2,11,9,57,176,31,84,0,0
82,517,117,574,296,2,11,9,57,179,32,84,0,0
83,516,118,574,301,2,11,9,58,183,33,84,0,0
84,515,121,572,304,2,11,9,57,183,34,84,0,0
85,515,121,573,307,2,11,9,58,186,35,84,0,0
86,516,123,575,311,2,11,9,59,188,36,84,0,0
87,518,124,577,315,2,11,9,59,191,37,84,0,0
88,517,125,577,320,2,11,9,60,195,38,84,0,0
89,518,132,577,327,2,11,9,59,195,39,84,0,0
90,516,131,578,334,2,11,9,62,203,40,84,0,0
91,516,131,579,340,2,11,9,63,209,41,84,0,0
92,518,135,582,346,2,11,9,64,211,42,84,0,0
93,519,137,585,350,2,11,9,66,213,43,84,0,0
94,519,137,587,358,2,11,9,68,221,44,84,0,0
95,519,141,588,364,2,11,9,69,223,45,84,0,0
96,518,137,591,371,2,11,9,73,234,46,84,0,0
97,519,143,593,382,2,11,9,74,239,47,84,0,0
98,524,145,599,387,2,11,9,75,242,48,84,0,0
99,526,146,603,396,2,11,9,77,250,49,84,0,0
100,529,153,606,404,2,11,9,77,251,50,84,0,0
101,530,152,611,413,2,11,9,81,261,51,84,0,0
102,535,154,619,423,2,11,9,84,269,52,84,0,0
103,536,157,622,433,2,11,9,86,276,53,84,0,0
104,539,155,628,440,2,11,9,89,285,54,84,0,0
105,542,157,633,450,2,11,9,91,293,55,84,0,0
106,543,157,639,464,2,11,9,96,307,56,84,0,0
107,550,159,649,476,2,11,9,99,317,57,84,0,0
108,557,169,660,496,2,11,9,103,327,58,84,0,0
109,567,172,671,504,2,11,9,104,332,59,84,0,0
110,573,175,681,517,2,11,9,108,342,60,84,0,0
111,577,182,690,539,2,11,9,113,357,61,84,0,0
112,581,184,698,549,2,11,9,117,365,62,84,0,0
113,582,196,705,578,2,11,9,123,382,63,84,0,0
114,589,204,715,595,2,11,9,126,391,64,84,0,0
115,598,209,729,612,2,11,9,131,403,65,84,0,0
116,599,219,737,646,2,11,9,138,427,66,84,0,0
117,602,226,745,664,2,11,9,143,438,67,84,0,0
118,606,233,757,695,2,11,9,151,462,68,84,0,0
119,611,252,768,729,2,11,9,157,477,69,84,0,0
120,618,260,778,742,2,11,9,160,482,70,84,0,0
121,611,268,780,782,2,11,9,169,514,71,84,0,0
122,596,284,774,820,2,11,9,178,536,72,84,0,0
123,586,290,776,852,2,11,9,190,562,73,84,0,0
124,573,312,782,914,2,11,9,209,602,74,84,0,0
125,546,321,766,947,2,11,9,220,626,75,84,0,0
126,503,331,733,992,2,11,9,230,661,76,84,0,0
127,460,349,703,1037,2,11,9,243,688,77,84,0,0
128,399,362,646,1054,2,11,9,247,692,78,84,0,0
129,333,385,585,1076,2,11,9,252,691,79,84,0,0
130,268,417,522,1080,2,11,9,254,663,80,84,0,0
131,162,427,416,1080,2,11,9,254,653,81,84,0,0
132,84,461,341,1080,2,11,9,257,619,82,84,0,0
133,10,536,231,1080,2,11,9,221,544,83,84,0,0
134,0,557,193,1080,2,11,9,193,523,84,84,1,0
134,0,803,109,1080,3,11,9,109,277,0,0,0,0
2421,1602,790,1638,878,12,11,9,36,88,0,0,0,0
2425,1584,779,1628,860,13,11,9,44,81,0,4,0,0
2426,1577,770,1630,868,13,11,9,53,98,1,4,0,0
2427,1574,767,1629,870,13,11,9,55,103,2,4,0,0
2428,1571,770,1623,865,13,11,9,52,95,3,4,0,0
2429,1569,769,1621,865,13,11,9,52,96,4,4,0,0
2434,1603,814,1643,884,14,11,9,40,70,0,18,0,0
2435,1603,810,1644,883,14,11,9,41,73,1,18,0,0
2436,1604,807,1646,883,14,11,9,42,76,2,18,0,0
2437,1604,804,1647,884,14,11,9,43,80,3,18,0,0
2438,1602,798,1648,886,14,11,9,46,88,4,18,0,0
2439,1601,794,1648,885,14,11,9,47,91,5,18,0,0
2440,1599,789,1647,886,14,11,9,48,97,6,18,0,0
2441,1598,785,1648,886,14,11,9,50,101,7,18,0,0
2442,1598,782,1645,878,14,11,9,47,96,8,18,0,0
2443,1597,778,1643,873,14,11,9,46,95,9,18,0,0
2444,1597,776,1641,868,14,11,9,44,92,10,18,0,0
2445,1597,776,1638,861,14,11,9,41,85,11,18,0,0
2446,1599,774,1636,851,14,11,9,37,77,12,18,0,0
2447,1596,770,1635,849,14,11,9,39,79,13,18,0,0
2448,1595,770,1632,844,14,11,9,37,74,14,18,0,0
2449,1593,768,1630,842,14,11,9,37,74,15,18,0,0
2450,1592,765,1628,836,14,11,9,36,71,16,18,0,0
2451,1590,763,1626,834,14,11,9,36,71,17,18,0,0
2452,1589,760,1625,831,14,11,9,36,71,18,18,0,0
2488,1575,759,1635,839,15,11,9,60,80,0,6,0,0
2489,1573,758,1631,836,15,11,9,58,78,1,6,0,0
2490,1565,758,1631,847,15,11,9,66,89,2,6,0,0
2491,1566,763,1625,844,15,11,9,59,81,3,6,0,0
2492,1560,750,1626,842,15,11,9,66,92,4,6,0,0
2493,1559,744,1628,842,15,11,9,69,98,5,6,0,0
2494,1556,741,1628,842,15,11,9,72,101,6,6,0,0
2632,1587,800,1625,872,18,11,9,38,72,0,33,0,0
2633,1587,800,1625,872,18,11,9,38,72,1,33,0,0
2634,1587,798,1624,870,18,11,9,37,72,2,33,0,0
2637,1582,794,1619,864,18,11,9,37,70,0,33,0,0
2640,1580,788,1619,862,18,11,9,39,74,0,33,0,1
2641,1581,787,1621,863,18,11,9,40,76,1,33,0,0
2642,1582,786,1622,863,18,11,9,40,77,2,33,0,0
2643,1582,785,1623,862,18,11,9,41,77,3,33,0,0
2644,1583,784,1623,859,18,11,9,40,75,4,33,0,0
2645,1583,783,1623,858,18,11,9,40,75,5,33,0,0
2646,1579,774,1626,862,18,11,9,47,88,6,33,0,0
2647,1581,774,1629,864,18,11,9,48,90,7,33,0,0
2648,1582,774,1632,865,18,11,9,50,91,8,33,0,0
2649,1585,773,1630,856,18,11,9,45,83,9,33,0,0
2650,1579,769,1631,859,18,11,9,52,90,10,33,0,0
2651,1576,764,1631,859,18,11,9,55,95,11,33,0,0
2652,1578,765,1633,859,18,11,9,55,94,12,33,0,0
2653,1575,761,1632,857,18,11,9,57,96,13,33,0,0
2654,1574,758,1633,857,18,11,9,59,99,14,33,0,0
2655,1573,756,1632,857,18,11,9,59,101,15,33,0,0
2656,1573,754,1633,857,18,11,9,60,103,16,33,0,0
2657,1572,756,1630,857,18,11,9,58,101,17,33,0,0
2658,1569,753,1628,856,18,11,9,59,103,18,33,0,0
2659,1569,756,1626,858,18,11,9,57,102,19,33,0,0
2660,1568,753,1627,859,18,11,9,59,106,20,33,0,0
2661,1570,757,1626,859,18,11,9,56,102,21,33,0,0
2662,1572,759,1625,855,18,11,9,53,96,22,33,0,0
2663,1572,759,1623,853,18,11,9,51,94,23,33,0,0
2664,1572,760,1622,852,18,11,9,50,92,24,33,0,0
2665,1573,762,1623,852,18,11,9,50,90,25,33,0,0
2666,1574,764,1622,851,18,11,9,48,87,26,33,0,0
2667,1574,765,1621,851,18,11,9,47,86,27,33,0,0
2668,1574,765,1622,853,18,11,9,48,88,28,33,0,0
2669,1574,766,1621,852,18,11,9,47,86,29,33,0,0
2670,1574,766,1622,853,18,11,9,48,87,30,33,0,0
2671,1573,765,1623,855,18,11,9,50,90,31,33,0,0
2672,1570,763,1622,856,18,11,9,52,93,32,33,0,0
2673,1570,762,1622,856,18,11,9,52,94,33,33,1,0
3741,5,719,152,1080,27,11,9,147,361,0,94,0,1
3742,38,595,233,1070,27,11,9,195,475,1,94,0,0
3743,118,533,344,1076,27,11,9,226,543,2,94,0,0
3744,192,489,437,1072,27,11,9,245,583,3,94,0,0
3745,266,454,528,1069,27,11,9,262,615,4,94,0,0
3746,320,408,601,1067,27,11,9,281,659,5,94,0,0
3747,372,386,660,1064,27,11,9,288,678,6,94,0,0
3748,403,351,702,1060,27,11,9,299,709,7,94,0,0
3749,432,325,723,1020,27,11,9,291,695,8,94,0,0
3750,456,314,738,999,27,11,9,282,685,9,94,0,0
3751,479,289,738,919,27,11,9,259,630,10,94,0,0
3752,490,273,738,883,27,11,9,248,610,11,94,0,0
3753,496,267,731,851,27,11,9,235,584,12,94,0,0
3754,497,250,712,790,27,11,9,215,540,13,94,0,0
3755,494,244,702,769,27,11,9,208,525,14,94,0,0
3756,498,232,695,732,27,11,9,197,500,15,94,0,0
3757,504,217,689,692,27,11,9,185,475,16,94,0,0
3758,504,212,682,675,27,11,9,178,463,17,94,0,0
3759,505,207,667,631,27,11,9,162,424,18,94,0,0
3760,502,203,658,614,27,11,9,156,411,19,94,0,0
3761,501,199,654,607,27,11,9,153,408,20,94,0,0
3762,505,189,646,569,27,11,9,141,380,21,94,0,0
3763,503,188,638,554,27,11,9,135,366,22,94,0,0
3764,499,181,629,538,27,11,9,130,357,23,94,0,0
3765,495,174,621,521,27,11,9,126,347,24,94,0,0
3766,486,173,609,512,27,11,9,123,339,25,94,0,0
3767,482,167,601,495,27,11,9,119,328,26,94,0,0
3768,487,166,598,480,27,11,9,111,314,27,94,0,0
3769,486,163,593,467,27,11,9,107,304,28,94,0,0
3770,482,161,584,449,27,11,9,102,288,29,94,0,0
3771,476,158,576,444,27,11,9,100,286,30,94,0,0
3772,474,156,570,430,27,11,9,96,274,31,94,0,0
3773,472,148,567,422,27,11,9,95,274,32,94,0,0
3774,473,149,566,416,27,11,9,93,267,33,94,0,0
3775,467,149,557,407,27,11,9,90,258,34,94,0,0
3776,464,145,549,394,27,11,9,85,249,35,94,0,0
3777,457,148,541,392,27,11,9,84,244,36,94,0,0
3778,458,145,537,378,27,11,9,79,233,37,94,0,0
3779,457,143,535,372,27,11,9,78,229,38,94,0,0
3780,453,141,530,368,27,11,9,77,227,39,94,0,0
3781,451,138,524,356,27,11,9,73,218,40,94,0,0
3782,449,138,520,350,27,11,9,71,212,41,94,0,0
3783,450,136,518,340,27,11,9,68,204,42,94,0,0
3784,449,134,517,334,27,11,9,68,200,43,94,0,0
3785,448,134,514,332,27,11,9,66,198,44,94,0,0
3786,443,128,509,326,27,11,9,66,198,45,94,0,0
3787,441,122,507,322,27,11,9,66,200,46,94,0,0
3788,442,123,505,316,27,11,9,63,193,47,94,0,0
3789,442,118,504,309,27,11,9,62,191,48,94,0,0
3790,441,118,502,306,27,11,9,61,188,49,94,0,0
3791,439,120,497,302,27,11,9,58,182,50,94,0,0
3792,439,116,497,298,27,11,9,58,182,51,94,0,0
3793,439,114,496,296,27,11,9,57,182,52,94,0,0
3794,441,113,497,291,27,11,9,56,178,53,94,0,0
3795,438,94,498,287,27,11,9,60,193,54,94,0,0
3796,440,94,498,282,27,11,9,58,188,55,94,0,0
3797,441,94,498,277,27,11,9,57,183,56,94,0,0
3798,444,89,500,274,27,11,9,56,185,57,94,0,0
3799,451,103,502,269,27,11,9,51,166,58,94,0,0
3800,457,106,506,267,27,11,9,49,161,59,94,0,0
3801,460,105,509,266,27,11,9,49,161,60,94,0,0
3802,461,100,509,262,27,11,9,48,162,61,94,0,0
3803,461,99,508,257,27,11,9,47,158,62,94,0,0
3804,462,104,505,253,27,11,9,43,149,63,94,0,0
3805,461,105,504,251,27,11,9,43,146,64,94,0,0
3806,460,107,502,249,27,11,9,42,142,65,94,0,0
3807,458,100,500,248,27,11,9,42,148,66,94,0,0
3808,455,95,498,244,27,11,9,43,149,67,94,0,0
3809,454,94,497,243,27,11,9,43,149,68,94,0,0
3810,456,101,494,236,27,11,9,38,135,69,94,0,0
3811,455,101,493,234,27,11,9,38,133,70,94,0,0
3812,452,92,492,233,27,11,9,40,141,71,94,0,0
3813,446,80,489,230,27,11,9,43,150,72,94,0,0
3814,446,80,487,228,27,11,9,41,148,73,94,0,0
3815,442,75,485,228,27,11,9,43,153,74,94,0,0
3816,442,76,484,225,27,11,9,42,149,75,94,0,0
3817,441,78,482,224,27,11,9,41,146,76,94,0,0
3818,439,80,480,224,27,11,9,41,144,77,94,0,0
3819,438,80,477,222,27,11,9,39,142,78,94,0,0
3820,437,79,477,223,27,11,9,40,144,79,94,0,0
3821,436,80,475,219,27,11,9,39,139,80,94,0,0
3822,436,79,474,217,27,11,9,38,138,81,94,0,0
3823,436,80,474,217,27,11,9,38,137,82,94,0,0
3824,437,81,474,215,27,11,9,37,134,83,94,0,0
3825,438,80,475,213,27,11,9,37,133,84,94,0,0
3826,438,79,475,210,27,11,9,37,131,85,94,0,0
3827,440,77,477,206,27,11,9,37,129,86,94,0,0
3828,441,79,477,206,27,11,9,36,127,87,94,0,0
3829,441,79,477,203,27,11,9,36,124,88,94,0,0
3830,441,76,478,203,27,11,9,37,127,89,94,0,0
3831,440,74,477,201,27,11,9,37,127,90,94,0,0
3832,441,76,477,197,27,11,9,36,121,91,94,0,0
3833,441,76,477,195,27,11,9,36,119,92,94,0,0
3834,443,78,478,193,27,11,9,35,115,93,94,0,0
3835,443,78,478,191,27,11,9,35,113,94,94,1,0
3837,441,77,476,189,27,11,9,35,112,0,94,0,0
3842,442,76,477,183,27,11,9,35,107,0,94,0,0
3804,435,77,478,253,28,11,9,43,176,0,0,0,0
4011,488,78,523,159,32,11,9,35,81,0,1,0,0
4012,483,78,519,162,32,11,9,36,84,1,1,0,0
1826,382,504,933,1065,2,13,1,551,561,0,37,0,1
1827,404,473,970,1063,2,13,1,566,590,1,37,0,0
1828,426,439,998,1063,2,13,1,572,624,2,37,0,0
1829,489,421,1031,1035,2,13,1,542,614,3,37,0,0
1830,557,408,1061,1005,2,13,1,504,597,4,37,0,0
1831,615,382,1079,956,2,13,1,464,574,5,37,0,0
1832,667,365,1110,932,2,13,1,443,567,6,37,0,0
1833,711,354,1132,917,2,13,1,421,563,7,37,0,0
1834,765,339,1139,863,2,13,1,374,524,8,37,0,0
1835,834,334,1169,821,2,13,1,335,487,9,37,0,0
1836,882,325,1196,797,2,13,1,314,472,10,37,0,0
1837,917,306,1210,761,2,13,1,293,455,11,37,0,0
1838,953,296,1233,741,2,13,1,280,445,12,37,0,0
1839,986,288,1256,727,2,13,1,270,439,13,37,0,0
1840,1012,275,1258,691,2,13,1,246,416,14,37,0,0
1841,1033,270,1265,671,2,13,1,232,401,15,37,0,0
1842,1061,269,1277,657,2,13,1,216,388,16,37,0,0
1843,1083,254,1288,631,2,13,1,205,377,17,37,0,0
1844,1105,247,1305,619,2,13,1,200,372,18,37,0,0
1845,1122,244,1316,613,2,13,1,194,369,19,37,0,0
1846,1135,234,1315,587,2,13,1,180,353,20,37,0,0
1847,1146,228,1319,579,2,13,1,173,351,21,37,0,0
1848,1165,227,1328,567,2,13,1,163,340,22,37,0,0
1849,1181,222,1333,544,2,13,1,152,322,23,37,0,0
1850,1197,216,1346,533,2,13,1,149,317,24,37,0,0
1851,1212,217,1355,528,2,13,1,143,311,25,37,0,0
1852,1223,210,1359,513,2,13,1,136,303,26,37,0,0
1853,1231,205,1361,498,2,13,1,130,293,27,37,0,0
1854,1245,206,1369,491,2,13,1,124,285,28,37,0,0
1855,1258,204,1374,470,2,13,1,116,266,29,37,0,0
1856,1270,199,1382,458,2,13,1,112,259,30,37,0,0
1857,1273,200,1382,453,2,13,1,109,253,31,37,0,0
1858,1266,193,1370,440,2,13,1,104,247,32,37,0,0
1859,1260,191,1362,436,2,13,1,102,245,33,37,0,0
1860,1256,189,1356,434,2,13,1,100,245,34,37,0,0
1861,1252,185,1347,427,2,13,1,95,242,35,37,0,0
1862,1249,184,1339,422,2,13,1,90,238,36,37,0,0
1863,1252,180,1340,412,2,13,1,88,232,37,37,1,0
3629,1599,191,1636,262,3,13,1,37,71,0,0,0,0
3637,1497,162,1533,298,4,13,1,36,136,0,17,0,0
3638,1487,162,1524,300,4,13,1,37,138,1,17,0,0
3639,1480,166,1516,300,4,13,1,36,134,2,17,0,0
3640,1471,167,1508,306,4,13,1,37,139,3,17,0,0
3641,1461,170,1502,319,4,13,1,41,149,4,17,0,0
3642,1454,171,1495,317,4,13,1,41,146,5,17,0,0
3643,1447,172,1489,317,4,13,1,42,145,6,17,0,0
3644,1440,173,1482,315,4,13,1,42,142,7,17,0,0
3645,1426,173,1470,325,4,13,1,44,152,8,17,0,0
3646,1412,176,1458,330,4,13,1,46,154,9,17,0,0
3647,1394,176,1442,336,4,13,1,48,160,10,17,0,0
3648,1374,175,1423,339,4,13,1,49,164,11,17,0,0
3649,1354,178,1406,340,4,13,1,52,162,12,17,0,0
3650,1331,180,1379,332,4,13,1,48,152,13,17,0,0
3651,1306,180,1357,335,4,13,1,51,155,14,17,0,0
3652,1281,183,1328,330,4,13,1,47,147,15,17,0,0
3653,1261,185,1310,339,4,13,1,49,154,16,17,0,0
3654,1245,186,1294,341,4,13,1,49,155,17,17,0,0
4014,867,410,1523,1074,6,13,1,656,664,0,2,0,0
4015,897,386,1544,1073,6,13,1,647,687,1,2,0,0
4016,928,344,1616,1073,6,13,1,688,729,2,2,0,0
4016,1139,382,1359,1063,7,13,1,220,681,0,36,0,1
4017,1164,357,1376,1015,7,13,1,212,658,1,36,0,0
4018,1179,346,1388,992,7,13,1,209,646,2,36,0,0
4019,1195,335,1393,945,7,13,1,198,610,3,36,0,0
4020,1211,317,1396,882,7,13,1,185,565,4,36,0,0
4021,1223,309,1402,861,7,13,1,179,552,5,36,0,0
4022,1235,300,1412,846,7,13,1,177,546,6,36,0,0
4023,1250,282,1415,793,7,13,1,165,511,7,36,0,0
4024,1254,276,1415,776,7,13,1,161,500,8,36,0,0
4025,1256,263,1411,745,7,13,1,155,482,9,36,0,0
4026,1259,251,1409,714,7,13,1,150,463,10,36,0,0
4027,1271,248,1417,701,7,13,1,146,453,11,36,0,0
4028,1285,242,1425,680,7,13,1,140,438,12,36,0,0
4029,1300,232,1434,654,7,13,1,134,422,13,36,0,0
4030,1309,230,1441,647,7,13,1,132,417,14,36,0,0
4031,1318,227,1443,626,7,13,1,125,399,15,36,0,0
4032,1324,221,1442,601,7,13,1,118,380,16,36,0,0
4033,1330,219,1445,591,7,13,1,115,372,17,36,0,0
4034,1339,215,1451,581,7,13,1,112,366,18,36,0,0
4035,1347,206,1454,558,7,13,1,107,352,19,36,0,0
4036,1350,203,1455,551,7,13,1,105,348,20,36,0,0
4037,1351,199,1453,537,7,13,1,102,338,21,36,0,0
4038,1351,194,1451,527,7,13,1,100,333,22,36,0,0
4039,1352,192,1450,520,7,13,1,98,328,23,36,0,0
4040,1356,192,1450,504,7,13,1,94,312,24,36,0,0
4041,1359,187,1453,496,7,13,1,94,309,25,36,0,0
4042,1355,186,1447,487,7,13,1,92,301,26,36,0,0
4043,1344,188,1432,475,7,13,1,88,287,27,36,0,0
4044,1335,186,1419,464,7,13,1,84,278,28,36,0,0
4045,1328,185,1411,458,7,13,1,83,273,29,36,0,0
4046,1320,180,1401,441,7,13,1,81,261,30,36,0,0
4047,1310,177,1390,433,7,13,1,80,256,31,36,0,0
4048,1294,176,1376,434,7,13,1,82,258,32,36,0,0
4049,1279,175,1362,430,7,13,1,83,255,33,36,0,0
4050,1259,171,1342,428,7,13,1,83,257,34,36,0,0
4051,1250,170,1329,426,7,13,1,79,256,35,36,0,0
4052,1242,167,1320,418,7,13,1,78,251,36,36,1,0
4119,1262,197,1297,387,8,13,1,35,190,0,82,0,1
4120,1268,189,1307,400,8,13,1,39,211,1,82,0,0
4121,1276,190,1316,399,8,13,1,40,209,2,82,0,0
4122,1290,190,1330,400,8,13,1,40,210,3,82,0,0
4123,1307,193,1349,405,8,13,1,42,212,4,82,0,0
4124,1319,194,1363,408,8,13,1,44,214,5,82,0,0
4125,1328,195,1374,413,8,13,1,46,218,6,82,0,0
4126,1334,196,1383,421,8,13,1,49,225,7,82,0,0
4127,1335,199,1388,431,8,13,1,53,232,8,82,0,0
4128,1339,200,1395,440,8,13,1,56,240,9,82,0,0
4129,1347,205,1405,448,8,13,1,58,243,10,82,0,0
4130,1354,206,1416,455,8,13,1,62,249,11,82,0,0
4131,1361,207,1427,463,8,13,1,66,256,12,82,0,0
4132,1355,208,1422,468,8,13,1,67,260,13,82,0,0
4133,1356,210,1422,468,8,13,1,66,258,14,82,0,0
4134,1361,210,1427,466,8,13,1,66,256,15,82,0,0
4135,1361,204,1429,468,8,13,1,68,264,16,82,0,0
4136,1371,207,1437,462,8,13,1,66,255,17,82,0,0
4137,1385,208,1453,461,8,13,1,68,253,18,82,0,0
4138,1398,209,1466,457,8,13,1,68,248,19,82,0,0
4139,1414,205,1483,453,8,13,1,69,248,20,82,0,0
4140,1424,205,1490,443,8,13,1,66,238,21,82,0,0
4141,1425,203,1491,439,8,13,1,66,236,22,82,0,0
4142,1424,201,1489,433,8,13,1,65,232,23,82,0,0
4143,1426,199,1489,426,8,13,1,63,227,24,82,0,0
4144,1432,197,1495,422,8,13,1,63,225,25,82,0,0
4145,1438,194,1500,413,8,13,1,62,219,26,82,0,0
4146,1443,191,1504,410,8,13,1,61,219,27,82,0,0
4147,1448,189,1511,411,8,13,1,63,222,28,82,0,0
4148,1456,190,1517,400,8,13,1,61,210,29,82,0,0
4149,1466,189,1528,402,8,13,1,62,213,30,82,0,0
4150,1479,186,1540,396,8,13,1,61,210,31,82,0,0
4151,1486,186,1546,393,8,13,1,60,207,32,82,0,0
4152,1487,184,1546,385,8,13,1,59,201,33,82,0,0
4153,1487,181,1545,377,8,13,1,58,196,34,82,0,0
4154,1488,181,1544,373,8,13,1,56,192,35,82,0,0
4155,1492,180,1548,369,8,13,1,56,189,36,82,0,0
4156,1496,178,1550,363,8,13,1,54,185,37,82,0,0
4157,1493,177,1547,361,8,13,1,54,184,38,82,0,0
4158,1489,174,1542,352,8,13,1,53,178,39,82,0,0
4159,1487,173,1540,350,8,13,1,53,177,40,82,0,0
4160,1489,174,1541,350,8,13,1,52,176,41,82,0,0
4161,1491,176,1541,340,8,13,1,50,164,42,82,0,0
4162,1489,171,1539,339,8,13,1,50,168,43,82,0,0
4163,1486,171,1534,332,8,13,1,48,161,44,82,0,0
4164,1484,170,1532,331,8,13,1,48,161,45,82,0,0
4165,1483,168,1531,331,8,13,1,48,163,46,82,0,0
4166,1484,167,1531,324,8,13,1,47,157,47,82,0,0
4167,1483,167,1529,320,8,13,1,46,153,48,82,0,0
4168,1478,166,1523,315,8,13,1,45,149,49,82,0,0
4169,1475,166,1519,311,8,13,1,44,145,50,82,0,0
4170,1475,167,1518,311,8,13,1,43,144,51,82,0,0
4171,1478,163,1520,305,8,13,1,42,142,52,82,0,0
4172,1480,160,1523,304,8,13,1,43,144,53,82,0,0
4173,1480,159,1523,301,8,13,1,43,142,54,82,0,0
4174,1481,157,1523,296,8,13,1,42,139,55,82,0,0
4175,1484,157,1525,293,8,13,1,41,136,56,82,0,0
4176,1490,155,1531,290,8,13,1,41,135,57,82,0,0
4177,1498,154,1539,290,8,13,1,41,136,58,82,0,0
4178,1504,154,1544,287,8,13,1,40,133,59,82,0,0
4179,1510,153,1550,287,8,13,1,40,134,60,82,0,0
4180,1517,152,1556,283,8,13,1,39,131,61,82,0,0
4181,1525,151,1565,281,8,13,1,40,130,62,82,0,0
4182,1534,150,1573,282,8,13,1,39,132,63,82,0,0
4183,1540,150,1579,285,8,13,1,39,135,64,82,0,0
4184,1544,149,1584,283,8,13,1,40,134,65,82,0,0
4187,1542,154,1578,280,8,13,1,36,126,0,82,0,1
4188,1540,154,1576,281,8,13,1,36,127,1,82,0,0
4189,1539,154,1575,277,8,13,1,36,123,2,82,0,0
4190,1539,159,1574,280,8,13,1,35,121,3,82,0,0
4191,1541,156,1578,283,8,13,1,37,127,4,82,0,0
4192,1544,156,1582,284,8,13,1,38,128,5,82,0,0
4193,1547,157,1585,286,8,13,1,38,129,6,82,0,0
4194,1545,157,1584,288,8,13,1,39,131,7,82,0,0
4195,1539,161,1577,288,8,13,1,38,127,8,82,0,0
4196,1534,165,1573,298,8,13,1,39,133,9,82,0,0
4197,1530,163,1571,301,8,13,1,41,138,10,82,0,0
4198,1528,160,1571,302,8,13,1,43,142,11,82,0,0
4199,1526,160,1568,304,8,13,1,42,144,12,82,0,0
4200,1521,160,1564,307,8,13,1,43,147,13,82,0,0
4201,1513,158,1558,313,8,13,1,45,155,14,82,0,0
4202,1508,160,1554,319,8,13,1,46,159,15,82,0,0
4203,1506,161,1553,319,8,13,1,47,158,16,82,0,0
4204,1506,163,1552,321,8,13,1,46,158,17,82,0,0
4205,1502,167,1547,323,8,13,1,45,156,18,82,0,0
4206,1495,169,1541,327,8,13,1,46,158,19,82,0,0
4207,1488,170,1536,333,8,13,1,48,163,20,82,0,0
4208,1487,171,1536,336,8,13,1,49,165,21,82,0,0
4209,1489,172,1538,338,8,13,1,49,166,22,82,0,0
4210,1489,173,1538,343,8,13,1,49,170,23,82,0,0
4211,1484,174,1536,348,8,13,1,52,174,24,82,0,0
4212,1481,173,1532,346,8,13,1,51,173,25,82,0,0
4213,1480,174,1533,353,8,13,1,53,179,26,82,0,0
4214,1482,175,1535,354,8,13,1,53,179,27,82,0,0
4215,1479,176,1536,364,8,13,1,57,188,28,82,0,0
4216,1475,177,1533,369,8,13,1,58,192,29,82,0,0
4217,1473,177,1530,371,8,13,1,57,194,30,82,0,0
4218,1470,181,1528,379,8,13,1,58,198,31,82,0,0
4219,1469,182,1526,379,8,13,1,57,197,32,82,0,0
4220,1465,184,1525,389,8,13,1,60,205,33,82,0,0
4221,1459,188,1520,396,8,13,1,61,208,34,82,0,0
4222,1449,188,1511,400,8,13,1,62,212,35,82,0,0
4223,1441,192,1505,410,8,13,1,64,218,36,82,0,0
4224,1439,194,1505,414,8,13,1,66,220,37,82,0,0
4225,1438,196,1506,425,8,13,1,68,229,38,82,0,0
4226,1433,199,1502,434,8,13,1,69,235,39,82,0,0
4227,1423,198,1493,435,8,13,1,70,237,40,82,0,0
4228,1411,201,1482,442,8,13,1,71,241,41,82,0,0
4229,1405,205,1479,452,8,13,1,74,247,42,82,0,0
4230,1402,209,1477,459,8,13,1,75,250,43,82,0,0
4231,1394,216,1470,470,8,13,1,76,254,44,82,0,0
4232,1382,219,1459,475,8,13,1,77,256,45,82,0,0
4233,1369,219,1450,491,8,13,1,81,272,46,82,0,0
4234,1359,225,1442,508,8,13,1,83,283,47,82,0,0
4235,1349,226,1433,512,8,13,1,84,286,48,82,0,0
4236,1332,231,1419,524,8,13,1,87,293,49,82,0,0
4237,1315,234,1404,533,8,13,1,89,299,50,82,0,0
4238,1291,238,1384,544,8,13,1,93,306,51,82,0,0
4239,1265,245,1364,562,8,13,1,99,317,52,82,0,0
4240,1252,243,1353,566,8,13,1,101,323,53,82,0,0
4241,1238,248,1342,582,8,13,1,104,334,54,82,0,0
4242,1222,258,1326,592,8,13,1,104,334,55,82,0,0
4243,1193,260,1302,604,8,13,1,109,344,56,82,0,0
4244,1164,269,1281,634,8,13,1,117,365,57,82,0,0
4245,1151,274,1270,648,8,13,1,119,374,58,82,0,0
4246,1140,283,1260,658,8,13,1,120,375,59,82,0,0
4247,1121,295,1242,669,8,13,1,121,374,60,82,0,0
4248,1091,298,1215,687,8,13,1,124,389,61,82,0,0
4249,1046,306,1182,724,8,13,1,136,418,62,82,0,0
4250,1021,319,1162,745,8,13,1,141,426,63,82,0,0
4251,1012,329,1153,757,8,13,1,141,428,64,82,0,0
4252,988,345,1136,795,8,13,1,148,450,65,82,0,0
4253,958,356,1110,817,8,13,1,152,461,66,82,0,0
4254,903,370,1068,868,8,13,1,165,498,67,82,0,0
4255,865,387,1040,908,8,13,1,175,521,68,82,0,0
4256,860,399,1032,917,8,13,1,172,518,69,82,0,0
4257,838,422,1017,961,8,13,1,179,539,70,82,0,0
4258,812,441,996,993,8,13,1,184,552,71,82,0,0
4259,743,462,939,1037,8,13,1,196,575,72,82,0,0
4260,695,488,899,1067,8,13,1,204,579,73,82,0,0
4261,685,508,886,1078,8,13,1,201,570,74,82,0,0
4262,680,538,875,1080,8,13,1,195,542,75,82,0,0
4263,654,572,842,1080,8,13,1,188,508,76,82,0,0
4264,594,599,781,1080,8,13,1,187,481,77,82,0,0
4265,542,649,728,1080,8,13,1,186,431,78,82,0,0
4266,552,700,725,1080,8,13,1,173,380,79,82,0,0
4267,544,757,704,1078,8,13,1,160,321,80,82,0,0
4268,515,838,648,1074,8,13,1,133,236,81,82,0,0
4269,497,878,611,1080,8,13,1,114,202,82,82,1,0
963,1826,916,1920,1077,1,13,10,94,161,0,0,0,0
964,1700,854,1850,1075,2,13,10,150,221,0,0,0,0
965,1545,789,1763,1077,3,13,10,218,288,0,9,0,0
966,1436,763,1675,1078,3,13,10,239,315,1,9,0,0
967,1341,736,1601,1078,3,13,10,260,342,2,9,0,0
968,1246,698,1529,1073,3,13,10,283,375,3,9,0,0
969,1145,664,1452,1073,3,13,10,307,409,4,9,0,0
970,1066,638,1386,1074,3,13,10,320,436,5,9,0,0
971,997,609,1334,1077,3,13,10,337,468,6,9,0,0
972,963,598,1302,1078,3,13,10,339,480,7,9,0,0
973,958,592,1296,1079,3,13,10,338,487,8,9,0,0
974,894,570,1248,1079,3,13,10,354,509,9,9,0,0
974,1112,606,1371,1080,4,13,10,259,474,0,7,0,0
975,1171,632,1415,1076,4,13,10,244,444,1,7,0,0
976,1247,682,1467,1077,4,13,10,220,395,2,7,0,0
977,1318,732,1515,1071,4,13,10,197,339,3,7,0,0
978,1456,779,1637,1077,4,13,10,181,298,4,7,0,0
979,1566,812,1736,1077,4,13,10,170,265,5,7,0,0
980,1682,841,1842,1076,4,13,10,160,235,6,7,0,0
981,1786,875,1920,1076,4,13,10,134,201,7,7,0,0
1297,169,210,205,320,6,13,10,36,110,0,10,0,0
1298,173,210,210,324,6,13,10,37,114,1,10,0,0
1299,179,212,215,321,6,13,10,36,109,2,10,0,0
1300,185,213,221,325,6,13,10,36,112,3,10,0,0
1301,193,216,230,328,6,13,10,37,112,4,10,0,0
1302,205,216,243,330,6,13,10,38,114,5,10,0,0
1303,217,220,254,333,6,13,10,37,113,6,10,0,0
1304,225,219,264,334,6,13,10,39,115,7,10,0,0
1305,239,215,279,333,6,13,10,40,118,8,10,0,0
1306,249,219,288,335,6,13,10,39,116,9,10,0,0
1307,255,219,295,337,6,13,10,40,118,10,10,0,0
3421,574,261,633,489,7,13,10,59,228,0,39,0,1
3422,554,261,616,498,7,13,10,62,237,1,39,0,0
3423,522,258,584,496,7,13,10,62,238,2,39,0,0
3424,492,261,554,490,7,13,10,62,229,3,39,0,0
3425,466,259,529,489,7,13,10,63,230,4,39,0,0
3426,428,254,494,490,7,13,10,66,236,5,39,0,0
3427,407,253,472,484,7,13,10,65,231,6,39,0,0
3428,380,247,448,486,7,13,10,68,239,7,39,0,0
3429,356,248,424,484,7,13,10,68,236,8,39,0,0
3430,332,244,399,477,7,13,10,67,233,9,39,0,0
3431,308,242,377,476,7,13,10,69,234,10,39,0,0
3432,285,242,356,476,7,13,10,71,234,11,39,0,0
3433,264,238,336,471,7,13,10,72,233,12,39,0,0
3434,251,236,321,459,7,13,10,70,223,13,39,0,0
3435,238,233,308,456,7,13,10,70,223,14,39,0,0
3436,227,229,298,455,7,13,10,71,226,15,39,0,0
3437,215,227,286,448,7,13,10,71,221,16,39,0,0
3438,208,226,278,441,7,13,10,70,215,17,39,0,0
3439,205,230,270,430,7,13,10,65,200,18,39,0,0
3440,202,220,270,427,7,13,10,68,207,19,39,0,0
3441,199,222,264,420,7,13,10,65,198,20,39,0,0
3442,196,225,259,417,7,13,10,63,192,21,39,0,0
3443,192,222,257,416,7,13,10,65,194,22,39,0,0
3444,190,222,252,412,7,13,10,62,190,23,39,0,0
3445,191,223,251,408,7,13,10,60,185,24,39,0,0
3446,191,219,251,406,7,13,10,60,187,25,39,0,0
3447,192,217,252,399,7,13,10,60,182,26,39,0,0
3448,194,215,253,395,7,13,10,59,180,27,39,0,0
3449,199,215,257,390,7,13,10,58,175,28,39,0,0
3450,201,214,258,388,7,13,10,57,174,29,39,0,0
3451,205,220,258,383,7,13,10,53,163,30,39,0,0
3452,208,220,260,377,7,13,10,52,157,31,39,0,0
3453,212,217,263,374,7,13,10,51,157,32,39,0,0
3454,214,216,264,370,7,13,10,50,154,33,39,0,0
3455,215,214,264,364,7,13,10,49,150,34,39,0,0
3456,218,216,266,364,7,13,10,48,148,35,39,0,0
3457,223,216,270,362,7,13,10,47,146,36,39,0,0
3458,229,216,275,358,7,13,10,46,142,37,39,0,0
3459,237,217,278,344,7,13,10,41,127,38,39,0,0
3460,239,216,279,339,7,13,10,40,123,39,39,1,0
3433,248,227,295,429,8,13,10,47,202,0,0,0,0
3441,242,223,286,407,9,13,10,44,184,0,1,0,0
3442,242,234,283,405,9,13,10,41,171,1,1,0,0
4927,253,218,292,340,10,13,10,39,122,0,0,0,0
4931,227,225,262,333,11,13,10,35,108,0,2,0,0
4932,224,220,260,333,11,13,10,36,113,1,2,0,0
4935,204,219,239,328,11,13,10,35,109,0,2,0,0
4936,198,216,233,327,11,13,10,35,111,1,2,0,0
4937,195,214,230,326,11,13,10,35,112,2,2,0,0
5058,199,213,234,324,13,13,10,35,111,0,8,0,0
5059,203,212,240,326,13,13,10,37,114,1,8,0,0
5060,209,214,247,331,13,13,10,38,117,2,8,0,0
5061,215,215,254,333,13,13,10,39,118,3,8,0,0
5062,224,212,263,332,13,13,10,39,120,4,8,0,0
5063,231,207,272,330,13,13,10,41,123,5,8,0,0
5064,235,207,276,332,13,13,10,41,125,6,8,0,0
5065,247,205,290,335,13,13,10,43,130,7,8,0,0
5066,252,205,295,337,13,13,10,43,132,8,8,0,0
5346,111,208,152,305,14,13,10,41,97,0,63,0,1
5347,110,207,158,320,14,13,10,48,113,1,63,0,0
5348,109,209,158,324,14,13,10,49,115,2,63,0,0
5349,108,213,155,328,14,13,10,47,115,3,63,0,0
5350,108,218,154,331,14,13,10,46,113,4,63,0,0
5351,107,219,156,341,14,13,10,49,122,5,63,0,0
5352,109,216,155,333,14,13,10,46,117,6,63,0,0
5353,111,223,154,333,14,13,10,43,110,7,63,0,0
5354,109,222,152,335,14,13,10,43,113,8,63,0,0
5355,107,220,151,337,14,13,10,44,117,9,63,0,0
5356,107,222,150,340,14,13,10,43,118,10,63,0,0
5357,108,221,151,340,14,13,10,43,119,11,63,0,0
5358,109,218,154,345,14,13,10,45,127,12,63,0,0
5359,112,226,155,349,14,13,10,43,123,13,63,0,0
5360,111,227,154,349,14,13,10,43,122,14,63,0,0
5361,109,221,154,352,14,13,10,45,131,15,63,0,0
5362,111,224,156,357,14,13,10,45,133,16,63,0,0
5363,115,225,159,359,14,13,10,44,134,17,63,0,0
5364,118,224,163,361,14,13,10,45,137,18,63,0,0
5365,120,228,164,364,14,13,10,44,136,19,63,0,0
5366,120,230,164,366,14,13,10,44,136,20,63,0,0
5367,119,228,164,369,14,13,10,45,141,21,63,0,0
5368,120,230,165,373,14,13,10,45,143,22,63,0,0
5369,121,232,165,372,14,13,10,44,140,23,63,0,0
5370,121,231,166,374,14,13,10,45,143,24,63,0,0
5371,120,234,166,382,14,13,10,46,148,25,63,0,0
5372,119,237,166,386,14,13,10,47,149,26,63,0,0
5373,119,237,166,387,14,13,10,47,150,27,63,0,0
5374,118,240,165,390,14,13,10,47,150,28,63,0,0
5375,116,237,166,399,14,13,10,50,162,29,63,0,0
5376,117,236,167,399,14,13,10,50,163,30,63,0,0
5377,118,239,169,404,14,13,10,51,165,31,63,0,0
5378,118,242,170,409,14,13,10,52,167,32,63,0,0
5379,118,239,172,413,14,13,10,54,174,33,63,0,0
5380,119,240,175,422,14,13,10,56,182,34,63,0,0
5381,123,240,180,426,14,13,10,57,186,35,63,0,0
5382,130,238,189,430,14,13,10,59,192,36,63,0,0
5383,139,247,197,433,14,13,10,58,186,37,63,0,0
5384,147,247,207,443,14,13,10,60,196,38,63,0,0
5385,154,243,216,446,14,13,10,62,203,39,63,0,0
5386,164,251,225,449,14,13,10,61,198,40,63,0,0
5387,174,250,237,452,14,13,10,63,202,41,63,0,0
5388,187,249,251,455,14,13,10,64,206,42,63,0,0
5389,198,254,263,461,14,13,10,65,207,43,63,0,0
5390,211,255,278,468,14,13,10,67,213,44,63,0,0
5391,221,243,294,478,14,13,10,73,235,45,63,0,0
5392,236,256,309,483,14,13,10,73,227,46,63,0,0
5393,258,259,328,482,14,13,10,70,223,47,63,0,0
5394,278,261,350,486,14,13,10,72,225,48,63,0,0
5395,297,266,370,490,14,13,10,73,224,49,63,0,0
5396,318,266,391,492,14,13,10,73,226,50,63,0,0
5397,340,264,415,495,14,13,10,75,231,51,63,0,0
5398,359,269,439,504,14,13,10,80,235,52,63,0,0
5399,381,273,462,503,14,13,10,81,230,53,63,0,0
5400,407,273,488,509,14,13,10,81,236,54,63,0,0
5401,432,280,513,511,14,13,10,81,231,55,63,0,0
5402,455,276,538,510,14,13,10,83,234,56,63,0,0
5403,479,273,564,513,14,13,10,85,240,57,63,0,0
5404,498,277,583,516,14,13,10,85,239,58,63,0,0
5405,509,281,597,520,14,13,10,88,239,59,63,0,0
5406,533,281,623,523,14,13,10,90,242,60,63,0,0
5407,556,283,644,528,14,13,10,88,245,61,63,0,0
5408,570,306,647,527,14,13,10,77,221,62,63,0,0
5409,588,310,665,530,14,13,10,77,220,63,63,1,0
5364,157,227,192,362,15,13,10,35,135,0,40,0,1
5365,159,228,194,363,15,13,10,35,135,1,40,0,0
5366,161,228,197,368,15,13,10,36,140,2,40,0,0
5367,161,229,197,367,15,13,10,36,138,3,40,0,0
5368,161,230,199,373,15,13,10,38,143,4,40,0,0
5369,163,233,202,378,15,13,10,39,145,5,40,0,0
5370,166,232,205,379,15,13,10,39,147,6,40,0,0
5371,168,232,209,384,15,13,10,41,152,7,40,0,0
5372,169,233,210,384,15,13,10,41,151,8,40,0,0
5373,170,235,212,388,15,13,10,42,153,9,40,0,0
5374,172,238,214,394,15,13,10,42,156,10,40,0,0
5375,177,239,219,395,15,13,10,42,156,11,40,0,0
5376,180,240,223,398,15,13,10,43,158,12,40,0,0
5377,183,239,229,408,15,13,10,46,169,13,40,0,0
5378,185,240,232,412,15,13,10,47,172,14,40,0,0
5379,188,240,237,417,15,13,10,49,177,15,40,0,0
5380,192,241,242,424,15,13,10,50,183,16,40,0,0
5381,197,238,248,425,15,13,10,51,187,17,40,0,0
5382,203,241,255,427,15,13,10,52,186,18,40,0,0
5383,211,243,262,424,15,13,10,51,181,19,40,0,0
5384,217,242,268,427,15,13,10,51,185,20,40,0,0
5385,225,244,280,438,15,13,10,55,194,21,40,0,0
5386,232,248,288,446,15,13,10,56,198,22,40,0,0
5387,243,249,299,450,15,13,10,56,201,23,40,0,0
5388,251,257,308,457,15,13,10,57,200,24,40,0,0
5389,269,262,320,442,15,13,10,51,180,25,40,0,0
5390,286,260,342,456,15,13,10,56,196,26,40,0,0
5391,301,259,362,472,15,13,10,61,213,27,40,0,0
5392,317,264,376,472,15,13,10,59,208,28,40,0,0
5393,334,265,394,473,15,13,10,60,208,29,40,0,0
5394,348,267,411,485,15,13,10,63,218,30,40,0,0
5395,373,269,436,487,15,13,10,63,218,31,40,0,0
5396,397,271,464,492,15,13,10,67,221,32,40,0,0
5397,420,274,487,496,15,13,10,67,222,33,40,0,0
5398,444,275,511,497,15,13,10,67,222,34,40,0,0
5399,467,281,536,503,15,13,10,69,222,35,40,0,0
5400,486,273,558,504,15,13,10,72,231,36,40,0,0
5401,516,272,587,504,15,13,10,71,232,37,40,0,0
5402,553,284,615,481,15,13,10,62,197,38,40,0,0
5403,584,299,634,462,15,13,10,50,163,39,40,0,0
5404,605,303,654,461,15,13,10,49,158,40,40,1,0
5653,178,210,213,316,20,13,10,35,106,0,11,0,0
5654,181,210,218,320,20,13,10,37,110,1,11,0,0
5655,183,212,220,321,20,13,10,37,109,2,11,0,0
5656,186,213,222,323,20,13,10,36,110,3,11,0,0
5657,189,212,227,327,20,13,10,38,115,4,11,0,0
5658,196,212,235,331,20,13,10,39,119,5,11,0,0
5659,206,214,246,333,20,13,10,40,119,6,11,0,0
5660,215,218,254,335,20,13,10,39,117,7,11,0,0
5661,221,219,260,335,20,13,10,39,116,8,11,0,0
5662,230,219,267,330,20,13,10,37,111,9,11,0,0
5663,238,218,277,334,20,13,10,39,116,10,11,0,0
5664,242,218,282,335,20,13,10,40,117,11,11,0,0
932,1412,0,1464,99,1,13,11,52,99,0,1,0,0
933,1406,0,1459,99,1,13,11,53,99,1,1,0,0
935,1407,0,1463,119,2,13,11,56,119,0,27,0,1
936,1401,0,1466,137,2,13,11,65,137,1,27,0,0
937,1393,0,1463,149,2,13,11,70,149,2,27,0,0
938,1392,0,1468,159,2,13,11,76,159,3,27,0,0
939,1385,0,1475,189,2,13,11,90,189,4,27,0,0
940,1382,0,1475,193,2,13,11,93,193,5,27,0,0
941,1367,0,1470,213,2,13,11,103,213,6,27,0,0
942,1350,1,1460,230,2,13,11,110,229,7,27,0,0
943,1337,2,1460,259,2,13,11,123,257,8,27,0,0
944,1329,3,1465,285,2,13,11,136,282,9,27,0,0
945,1310,1,1454,303,2,13,11,144,302,10,27,0,0
946,1281,3,1438,337,2,13,11,157,334,11,27,0,0
947,1261,1,1425,354,2,13,11,164,353,12,27,0,0
948,1242,2,1426,397,2,13,11,184,395,13,27,0,0
949,1225,5,1419,425,2,13,11,194,420,14,27,0,0
950,1203,15,1409,470,2,13,11,206,455,15,27,0,0
951,1182,25,1397,513,2,13,11,215,488,16,27,0,0
952,1169,41,1406,573,2,13,11,237,532,17,27,0,0
953,1155,64,1414,637,2,13,11,259,573,18,27,0,0
954,1135,84,1404,690,2,13,11,269,606,19,27,0,0
955,1109,119,1392,773,2,13,11,283,654,20,27,0,0
956,1096,148,1389,823,2,13,11,293,675,21,27,0,0
957,1076,211,1410,965,2,13,11,334,754,22,27,0,0
958,1073,256,1420,1029,2,13,11,347,773,23,27,0,0
959,1070,316,1411,1066,2,13,11,341,750,24,27,0,0
960,1087,383,1416,1080,2,13,11,329,697,25,27,0,0
961,1162,449,1471,1080,2,13,11,309,631,26,27,0,0
962,1160,474,1474,1080,2,13,11,314,606,27,27,1,0
962,1313,536,1732,1079,3,13,11,419,543,0,1,0,0
963,1466,562,1858,1068,3,13,11,392,506,1,1,0,0
2343,53,637,331,1071,1,13,12,278,434,0,0,0,0
2344,234,607,639,1062,2,13,12,405,455,0,13,0,0
2345,359,580,798,1075,2,13,12,439,495,1,13,0,0
2346,427,555,886,1078,2,13,12,459,523,2,13,0,0
2347,538,546,1002,1078,2,13,12,464,532,3,13,0,0
2348,683,527,1155,1076,2,13,12,472,549,4,13,0,0
2349,838,517,1314,1078,2,13,12,476,561,5,13,0,0
2350,958,502,1433,1075,2,13,12,475,573,6,13,0,0
2351,1030,485,1504,1075,2,13,12,474,590,7,13,0,0
2352,1083,485,1545,1076,2,13,12,462,591,8,13,0,0
2353,1124,476,1584,1078,2,13,12,460,602,9,13,0,0
2354,1138,460,1597,1076,2,13,12,459,616,10,13,0,0
2355,1121,457,1568,1075,2,13,12,447,618,11,13,0,0
2356,1089,456,1519,1073,2,13,12,430,617,12,13,0,0
2357,1141,446,1577,1073,2,13,12,436,627,13,13,0,0
2357,1051,465,1280,1076,3,13,12,229,611,0,9,0,0
2358,979,478,1204,1075,3,13,12,225,597,1,9,0,0
2359,904,474,1133,1078,3,13,12,229,604,2,9,0,0
2360,769,492,995,1079,3,13,12,226,587,3,9,0,0
2361,642,506,870,1080,3,13,12,228,574,4,9,0,0
2362,553,525,776,1080,3,13,12,223,555,5,9,0,0
2363,412,555,626,1078,3,13,12,214,523,6,9,0,0
2364,276,565,491,1079,3,13,12,215,514,7,9,0,0
2365,121,604,327,1074,3,13,12,206,470,8,9,0,0
2366,7,623,205,1074,3,13,12,198,451,9,9,0,0
3392,2,619,157,999,4,13,12,155,380,0,61,0,1
3393,37,585,232,1062,4,13,12,195,477,1,61,0,0
3394,100,550,310,1063,4,13,12,210,513,2,61,0,0
3395,151,505,386,1077,4,13,12,235,572,3,61,0,0
3396,211,467,452,1057,4,13,12,241,590,4,61,0,0
3397,267,436,511,1036,4,13,12,244,600,5,61,0,0
3398,312,412,535,964,4,13,12,223,552,6,61,0,0
3399,334,382,553,929,4,13,12,219,547,7,61,0,0
3400,347,364,551,881,4,13,12,204,517,8,61,0,0
3401,365,341,554,825,4,13,12,189,484,9,61,0,0
3402,375,331,554,796,4,13,12,179,465,10,61,0,0
3403,378,311,541,741,4,13,12,163,430,11,61,0,0
3404,370,299,526,716,4,13,12,156,417,12,61,0,0
3405,366,290,508,674,4,13,12,142,384,13,61,0,0
3406,372,281,507,651,4,13,12,135,370,14,61,0,0
3407,374,275,509,640,4,13,12,135,365,15,61,0,0
3408,369,264,493,602,4,13,12,124,338,16,61,0,0
3409,363,259,481,585,4,13,12,118,326,17,61,0,0
3410,354,252,466,571,4,13,12,112,319,18,61,0,0
3411,348,244,455,553,4,13,12,107,309,19,61,0,0
3412,343,241,446,543,4,13,12,103,302,20,61,0,0
3413,342,239,435,517,4,13,12,93,278,21,61,0,0
3414,337,233,428,510,4,13,12,91,277,22,61,0,0
3415,327,231,413,497,4,13,12,86,266,23,61,0,0
3416,316,223,400,488,4,13,12,84,265,24,61,0,0
3417,308,221,389,483,4,13,12,81,262,25,61,0,0
3418,304,217,378,459,4,13,12,74,242,26,61,0,0
3419,297,213,370,453,4,13,12,73,240,27,61,0,0
3420,293,211,361,438,4,13,12,68,227,28,61,0,0
3421,288,208,355,434,4,13,12,67,226,29,61,0,0
3422,288,207,353,430,4,13,12,65,223,30,61,0,0
3423,291,204,351,409,4,13,12,60,205,31,61,0,0
3424,291,201,350,402,4,13,12,59,201,32,61,0,0
3425,290,200,346,394,4,13,12,56,194,33,61,0,0
3426,287,192,344,391,4,13,12,57,199,34,61,0,0
3427,287,192,342,388,4,13,12,55,196,35,61,0,0
3428,288,186,341,374,4,13,12,53,188,36,61,0,0
3429,289,183,339,360,4,13,12,50,177,37,61,0,0
3430,287,186,336,357,4,13,12,49,171,38,61,0,0
3431,284,179,337,361,4,13,12,53,182,39,61,0,0
3432,288,177,341,359,4,13,12,53,182,40,61,0,0
3433,288,175,339,344,4,13,12,51,169,41,61,0,0
3434,284,174,335,344,4,13,12,51,170,42,61,0,0
3435,284,174,333,339,4,13,12,49,165,43,61,0,0
3436,286,171,334,333,4,13,12,48,162,44,61,0,0
3437,290,172,337,325,4,13,12,47,153,45,61,0,0
3438,294,171,340,320,4,13,12,46,149,46,61,0,0
3439,296,169,341,315,4,13,12,45,146,47,61,0,0
3440,298,170,342,315,4,13,12,44,145,48,61,0,0
3441,300,168,343,309,4,13,12,43,141,49,61,0,0
3442,303,166,346,306,4,13,12,43,140,50,61,0,0
3443,308,162,350,301,4,13,12,42,139,51,61,0,0
3444,310,156,353,298,4,13,12,43,142,52,61,0,0
3445,312,156,354,296,4,13,12,42,140,53,61,0,0
3446,312,149,356,293,4,13,12,44,144,54,61,0,0
3447,313,148,355,289,4,13,12,42,141,55,61,0,0
3448,313,145,354,285,4,13,12,41,140,56,61,0,0
3449,313,145,353,281,4,13,12,40,136,57,61,0,0
3450,309,149,348,282,4,13,12,39,133,58,61,0,0
3451,305,151,342,277,4,13,12,37,126,59,61,0,0
3452,301,150,338,273,4,13,12,37,123,60,61,0,0
3453,298,151,334,272,4,13,12,36,121,61,61,1,0
3455,288,149,323,271,4,13,12,35,122,0,61,0,0
3456,284,148,319,269,4,13,12,35,121,1,61,0,0
3931,1853,440,1920,732,5,13,12,67,292,0,22,0,1
3932,1842,411,1918,739,5,13,12,76,328,1,22,0,0
3933,1831,404,1910,743,5,13,12,79,339,2,22,0,0
3934,1806,415,1886,748,5,13,12,80,333,3,22,0,0
3935,1788,398,1877,759,5,13,12,89,361,4,22,0,0
3936,1770,409,1866,784,5,13,12,96,375,5,22,0,0
3937,1741,402,1847,800,5,13,12,106,398,6,22,0,0
3938,1705,404,1820,807,5,13,12,115,403,7,22,0,0
3939,1665,415,1788,826,5,13,12,123,411,8,22,0,0
3940,1637,412,1772,846,5,13,12,135,434,9,22,0,0
3941,1595,422,1744,876,5,13,12,149,454,10,22,0,0
3942,1558,421,1721,905,5,13,12,163,484,11,22,0,0
3943,1499,433,1677,933,5,13,12,178,500,12,22,0,0
3944,1449,437,1641,962,5,13,12,192,525,13,22,0,0
3945,1382,437,1603,1023,5,13,12,221,586,14,22,0,0
3946,1318,446,1555,1055,5,13,12,237,609,15,22,0,0
3947,1259,456,1505,1074,5,13,12,246,618,16,22,0,0
3948,1181,483,1428,1080,5,13,12,247,597,17,22,0,0
3949,1101,484,1353,1080,5,13,12,252,596,18,22,0,0
3950,969,501,1225,1080,5,13,12,256,579,19,22,0,0
3951,849,515,1111,1080,5,13,12,262,565,20,22,0,0
3952,743,543,994,1080,5,13,12,251,537,21,22,0,0
3953,681,552,934,1080,5,13,12,253,528,22,22,1,0
3953,548,583,789,1080,6,13,12,241,497,0,0,0,0
3954,359,589,612,1077,7,13,12,253,488,0,0,0,0
3955,152,647,420,1078,8,13,12,268,431,0,0,0,0
3956,0,668,231,1080,9,13,12,231,412,0,0,0,0
5995,332,119,367,213,11,13,12,35,94,0,0,0,0
6000,348,121,383,216,11,13,12,35,95,0,0,0,0
1166,738,535,1260,1062,2,13,13,522,527,0,5,0,0
1167,653,491,1207,1066,2,13,13,554,575,1,5,0,0
1168,585,444,1162,1066,2,13,13,577,622,2,5,0,0
1169,539,396,1126,1055,2,13,13,587,659,3,5,0,0
1170,529,371,1078,1012,2,13,13,549,641,4,5,0,0
1171,469,322,1056,1007,2,13,13,587,685,5,5,0,0
1171,659,359,839,903,3,13,13,180,544,0,14,0,0
1172,624,352,798,878,3,13,13,174,526,1,14,0,0
1173,597,328,760,820,3,13,13,163,492,2,14,0,0
1174,579,313,739,795,3,13,13,160,482,3,14,0,0
1175,558,293,711,747,3,13,13,153,454,4,14,0,0
1176,528,271,675,710,3,13,13,147,439,5,14,0,0
1177,498,270,636,681,3,13,13,138,411,6,14,0,0
1178,468,257,600,652,3,13,13,132,395,7,14,0,0
1179,444,254,573,639,3,13,13,129,385,8,14,0,0
1180,417,245,538,606,3,13,13,121,361,9,14,0,0
1181,385,238,502,586,3,13,13,117,348,10,14,0,0
1182,358,237,474,580,3,13,13,116,343,11,14,0,0
1183,320,226,432,557,3,13,13,112,331,12,14,0,0
1184,303,226,411,547,3,13,13,108,321,13,14,0,0
1185,276,219,379,526,3,13,13,103,307,14,14,0,0
1540,346,134,386,254,4,13,13,40,120,0,12,0,0
1541,359,134,402,265,4,13,13,43,131,1,12,0,0
1542,377,137,419,264,4,13,13,42,127,2,12,0,0
1543,395,146,435,263,4,13,13,40,117,3,12,0,0
1544,414,142,454,261,4,13,13,40,119,4,12,0,0
1545,431,145,472,263,4,13,13,41,118,5,12,0,0
1546,444,147,485,263,4,13,13,41,116,6,12,0,0
1547,465,144,506,261,4,13,13,41,117,7,12,0,0
1548,483,145,523,259,4,13,13,40,114,8,12,0,0
1549,498,145,539,255,4,13,13,41,110,9,12,0,0
1550,521,144,560,253,4,13,13,39,109,10,12,0,0
1551,538,149,580,266,4,13,13,42,117,11,12,0,0
1552,555,150,597,267,4,13,13,42,117,12,12,0,0
2315,305,215,364,548,5,13,13,59,333,0,24,0,1
2316,317,219,374,542,5,13,13,57,323,1,24,0,0
2317,336,231,396,559,5,13,13,60,328,2,24,0,0
2318,363,232,428,576,5,13,13,65,344,3,24,0,0
2319,405,235,474,590,5,13,13,69,355,4,24,0,0
2320,433,248,507,613,5,13,13,74,365,5,24,0,0
2321,458,254,535,623,5,13,13,77,369,6,24,0,0
2322,467,269,556,662,5,13,13,89,393,7,24,0,0
2323,492,273,589,679,5,13,13,97,406,8,24,0,0
2324,534,286,638,712,5,13,13,104,426,9,24,0,0
2325,566,299,676,740,5,13,13,110,441,10,24,0,0
2326,586,310,703,762,5,13,13,117,452,11,24,0,0
2327,589,329,721,817,5,13,13,132,488,12,24,0,0
2328,614,341,756,844,5,13,13,142,503,13,24,0,0
2329,652,368,806,908,5,13,13,154,540,14,24,0,0
2330,691,387,852,941,5,13,13,161,554,15,24,0,0
2331,719,412,897,1013,5,13,13,178,601,16,24,0,0
2332,757,443,942,1055,5,13,13,185,612,17,24,0,0
2333,800,469,988,1074,5,13,13,188,605,18,24,0,0
2334,852,519,1037,1080,5,13,13,185,561,19,24,0,0
2335,937,560,1119,1080,5,13,13,182,520,20,24,0,0
2336,1015,626,1190,1080,5,13,13,175,454,21,24,0,0
2337,1119,705,1283,1079,5,13,13,164,374,22,24,0,0
2338,1239,781,1392,1075,5,13,13,153,294,23,24,0,0
2339,1305,820,1447,1080,5,13,13,142,260,24,24,1,0
2368,1362,823,1557,1071,6,13,13,195,248,0,0,0,0
2369,1210,745,1426,1071,7,13,13,216,326,0,0,0,0
2370,1046,688,1285,1079,8,13,13,239,391,0,65,0,1
2371,917,612,1197,1071,8,13,13,280,459,1,65,0,0
2372,821,573,1124,1070,8,13,13,303,497,2,65,0,0
2373,717,543,1021,1044,8,13,13,304,501,3,65,0,0
2374,604,482,949,1059,8,13,13,345,577,4,65,0,0
2375,510,455,869,1065,8,13,13,359,610,5,65,0,0
2376,434,410,809,1063,8,13,13,375,653,6,65,0,0
2377,368,389,744,1062,8,13,13,376,673,7,65,0,0
2378,302,368,676,1047,8,13,13,374,679,8,65,0,0
2379,253,353,623,1031,8,13,13,370,678,9,65,0,0
2380,241,333,596,990,8,13,13,355,657,10,65,0,0
2381,249,335,576,951,8,13,13,327,616,11,65,0,0
2382,288,338,590,928,8,13,13,302,590,12,65,0,0
2383,293,337,577,914,8,13,13,284,577,13,65,0,0
2384,293,327,561,882,8,13,13,268,555,14,65,0,0
2385,297,319,556,859,8,13,13,259,540,15,65,0,0
2386,293,323,540,851,8,13,13,247,528,16,65,0,0
2387,291,310,532,838,8,13,13,241,528,17,65,0,0
2388,302,303,526,801,8,13,13,224,498,18,65,0,0
2389,305,292,524,790,8,13,13,219,498,19,65,0,0
2390,305,283,518,782,8,13,13,213,499,20,65,0,0
2391,311,276,508,746,8,13,13,197,470,21,65,0,0
2392,315,269,503,723,8,13,13,188,454,22,65,0,0
2393,325,266,503,708,8,13,13,178,442,23,65,0,0
2394,343,262,510,680,8,13,13,167,418,24,65,0,0
2395,356,257,516,662,8,13,13,160,405,25,65,0,0
2396,356,255,513,658,8,13,13,157,403,26,65,0,0
2397,355,242,507,635,8,13,13,152,393,27,65,0,0
2398,356,237,500,615,8,13,13,144,378,28,65,0,0
2399,357,236,495,605,8,13,13,138,369,29,65,0,0
2400,361,231,496,596,8,13,13,135,365,30,65,0,0
2401,364,226,494,580,8,13,13,130,354,31,65,0,0
2402,364,224,491,569,8,13,13,127,345,32,65,0,0
2403,359,224,481,560,8,13,13,122,336,33,65,0,0
2404,352,219,468,544,8,13,13,116,325,34,65,0,0
2405,346,213,460,535,8,13,13,114,322,35,65,0,0
2406,340,211,451,528,8,13,13,111,317,36,65,0,0
2407,339,210,446,521,8,13,13,107,311,37,65,0,0
2408,338,208,443,521,8,13,13,105,313,38,65,0,0
2409,332,206,438,524,8,13,13,106,318,39,65,0,0
2410,324,208,434,529,8,13,13,110,321,40,65,0,0
2411,337,212,447,531,8,13,13,110,319,41,65,0,0
2412,354,214,465,534,8,13,13,111,320,42,65,0,0
2413,365,214,477,538,8,13,13,112,324,43,65,0,0
2414,371,217,484,541,8,13,13,113,324,44,65,0,0
2415,374,222,489,550,8,13,13,115,328,45,65,0,0
2416,377,224,499,570,8,13,13,122,346,46,65,0,0
2417,394,227,515,577,8,13,13,121,350,47,65,0,0
2418,409,235,530,591,8,13,13,121,356,48,65,0,0
2419,424,242,547,604,8,13,13,123,362,49,65,0,0
2420,436,245,560,611,8,13,13,124,366,50,65,0,0
2421,443,252,570,624,8,13,13,127,372,51,65,0,0
2422,451,258,578,625,8,13,13,127,367,52,65,0,0
2423,461,256,592,636,8,13,13,131,380,53,65,0,0
2424,474,259,612,661,8,13,13,138,402,54,65,0,0
2425,489,271,628,678,8,13,13,139,407,55,65,0,0
2426,498,276,643,700,8,13,13,145,424,56,65,0,0
2427,498,281,648,716,8,13,13,150,435,57,65,0,0
2428,490,292,644,735,8,13,13,154,443,58,65,0,0
2429,471,293,629,747,8,13,13,158,454,59,65,0,0
2430,442,299,603,757,8,13,13,161,458,60,65,0,0
2431,397,302,564,762,8,13,13,167,460,61,65,0,0
2432,343,304,514,765,8,13,13,171,461,62,65,0,0
2433,295,305,460,762,8,13,13,165,457,63,65,0,0
2434,283,356,428,767,8,13,13,145,411,64,65,0,0
2435,271,364,416,775,8,13,13,145,411,65,65,1,0
3372,290,320,424,729,9,13,13,134,409,0,15,0,0
3373,316,334,456,760,9,13,13,140,426,1,15,0,0
3374,359,338,503,774,9,13,13,144,436,2,15,0,0
3375,392,353,543,810,9,13,13,151,457,3,15,0,0
3376,437,357,592,829,9,13,13,155,472,4,15,0,0
3377,489,374,659,876,9,13,13,170,502,5,15,0,0
3378,548,393,721,896,9,13,13,173,503,6,15,0,0
3379,601,411,782,932,9,13,13,181,521,7,15,0,0
3380,638,445,823,976,9,13,13,185,531,8,15,0,0
3381,708,474,884,978,9,13,13,176,504,9,15,0,0
3382,772,516,968,1052,9,13,13,196,536,10,15,0,0
3383,846,551,1043,1075,9,13,13,197,524,11,15,0,0
3384,927,593,1120,1080,9,13,13,193,487,12,15,0,0
3385,1037,644,1219,1080,9,13,13,182,436,13,15,0,0
3386,1132,689,1308,1080,9,13,13,176,391,14,15,0,0
3387,1200,718,1372,1080,9,13,13,172,362,15,15,0,0
3716,366,125,412,253,10,13,13,46,128,0,1,0,0
3717,376,125,422,253,10,13,13,46,128,1,1,0,0
3718,407,124,442,252,11,13,13,35,128,0,1,0,0
3719,417,115,455,255,11,13,13,38,140,1,1,0,0
3722,465,126,504,258,12,13,13,39,132,0,1,0,0
3723,474,126,513,253,12,13,13,39,127,1,1,0,0
3724,498,121,536,248,13,13,13,38,127,0,0,0,0
3958,1329,814,1548,1056,14,13,13,219,242,0,0,0,0
3959,1102,738,1371,1070,15,13,13,269,332,0,0,0,0
3960,958,633,1253,1070,16,13,13,295,437,0,24,0,1
3961,846,582,1176,1070,16,13,13,330,488,1,24,0,0
3962,735,535,1095,1067,16,13,13,360,532,2,24,0,0
3963,666,499,1047,1065,16,13,13,381,566,3,24,0,0
3964,585,452,991,1067,16,13,13,406,615,4,24,0,0
3965,539,408,953,1049,16,13,13,414,641,5,24,0,0
3966,506,379,909,1018,16,13,13,403,639,6,24,0,0
3967,481,343,853,943,16,13,13,372,600,7,24,0,0
3968,452,327,800,903,16,13,13,348,576,8,24,0,0
3969,437,305,749,837,16,13,13,312,532,9,24,0,0
3970,424,289,719,802,16,13,13,295,513,10,24,0,0
3971,416,282,692,772,16,13,13,276,490,11,24,0,0
3972,409,268,660,725,16,13,13,251,457,12,24,0,0
3973,393,266,625,696,16,13,13,232,430,13,24,0,0
3974,383,253,596,656,16,13,13,213,403,14,24,0,0
3975,368,244,571,638,16,13,13,203,394,15,24,0,0
3976,359,240,543,601,16,13,13,184,361,16,24,0,0
3977,346,231,519,580,16,13,13,173,349,17,24,0,0
3978,329,229,495,570,16,13,13,166,341,18,24,0,0
3979,312,218,472,551,16,13,13,160,333,19,24,0,0
3980,297,211,450,541,16,13,13,153,330,20,24,0,0
3981,289,206,431,519,16,13,13,142,313,21,24,0,0
3982,282,204,416,509,16,13,13,134,305,22,24,0,0
3983,275,206,400,506,16,13,13,125,300,23,24,0,0
3984,258,198,378,487,16,13,13,120,289,24,24,1,0
4031,317,219,360,392,17,13,13,43,173,0,112,0,1
4032,328,173,382,391,17,13,13,54,218,1,112,0,0
4033,343,165,400,390,17,13,13,57,225,2,112,0,0
4034,375,162,431,381,17,13,13,56,219,3,112,0,0
4035,404,164,459,375,17,13,13,55,211,4,112,0,0
4036,422,162,478,372,17,13,13,56,210,5,112,0,0
4037,446,166,499,363,17,13,13,53,197,6,112,0,0
4038,463,159,519,364,17,13,13,56,205,7,112,0,0
4039,478,156,534,359,17,13,13,56,203,8,112,0,0
4040,490,156,545,353,17,13,13,55,197,9,112,0,0
4041,501,152,555,347,17,13,13,54,195,10,112,0,0
4042,508,153,563,343,17,13,13,55,190,11,112,0,0
4043,512,154,565,337,17,13,13,53,183,12,112,0,0
4044,514,152,566,328,17,13,13,52,176,13,112,0,0
4045,516,152,566,324,17,13,13,50,172,14,112,0,0
4046,518,148,569,319,17,13,13,51,171,15,112,0,0
4047,516,149,566,314,17,13,13,50,165,16,112,0,0
4048,514,148,562,305,17,13,13,48,157,17,112,0,0
4049,510,148,557,300,17,13,13,47,152,18,112,0,0
4050,508,146,554,295,17,13,13,46,149,19,112,0,0
4051,506,142,554,291,17,13,13,48,149,20,112,0,0
4052,503,140,552,289,17,13,13,49,149,21,112,0,0
4053,500,138,549,286,17,13,13,49,148,22,112,0,0
4054,501,137,548,278,17,13,13,47,141,23,112,0,0
4055,502,141,548,277,17,13,13,46,136,24,112,0,0
4056,504,140,550,277,17,13,13,46,137,25,112,0,0
4057,511,138,558,276,17,13,13,47,138,26,112,0,0
4058,514,137,562,274,17,13,13,48,137,27,112,0,0
4059,513,138,561,273,17,13,13,48,135,28,112,0,0
4060,514,140,562,272,17,13,13,48,132,29,112,0,0
4061,515,137,565,273,17,13,13,50,136,30,112,0,0
4062,514,137,565,273,17,13,13,51,136,31,112,0,0
4063,514,136,567,272,17,13,13,53,136,32,112,0,0
4064,514,135,569,273,17,13,13,55,138,33,112,0,0
4065,514,136,569,273,17,13,13,55,137,34,112,0,0
4066,514,138,570,273,17,13,13,56,135,35,112,0,0
4067,514,139,570,273,17,13,13,56,134,36,112,0,0
4068,513,139,571,273,17,13,13,58,134,37,112,0,0
4069,513,139,571,273,17,13,13,58,134,38,112,0,0
4070,512,139,571,273,17,13,13,59,134,39,112,0,0
4071,512,136,573,274,17,13,13,61,138,40,112,0,0
4072,512,136,574,274,17,13,13,62,138,41,112,0,0
4073,511,135,574,274,17,13,13,63,139,42,112,0,0
4074,511,135,574,274,17,13,13,63,139,43,112,0,0
4075,511,136,574,274,17,13,13,63,138,44,112,0,0
4076,512,136,576,274,17,13,13,64,138,45,112,0,0
4077,512,136,576,274,17,13,13,64,138,46,112,0,0
4078,512,136,577,274,17,13,13,65,138,47,112,0,0
4079,511,136,577,274,17,13,13,66,138,48,112,0,0
4080,511,136,577,274,17,13,13,66,138,49,112,0,0
4081,510,138,575,274,17,13,13,65,136,50,112,0,0
4082,509,138,575,274,17,13,13,66,136,51,112,0,0
4083,509,138,574,273,17,13,13,65,135,52,112,0,0
4084,509,139,574,273,17,13,13,65,134,53,112,0,0
4085,509,139,574,273,17,13,13,65,134,54,112,0,0
4086,509,138,574,273,17,13,13,65,135,55,112,0,0
4087,509,138,574,273,17,13,13,65,135,56,112,0,0
4088,509,138,575,273,17,13,13,66,135,57,112,0,0
4089,507,140,571,273,17,13,13,64,133,58,112,0,0
4090,508,140,572,273,17,13,13,64,133,59,112,0,0
4091,506,139,568,272,17,13,13,62,133,60,112,0,0
4092,502,141,561,272,17,13,13,59,131,61,112,0,0
4093,500,138,559,272,17,13,13,59,134,62,112,0,0
4094,501,138,560,273,17,13,13,59,135,63,112,0,0
4095,503,137,560,272,17,13,13,57,135,64,112,0,0
4096,503,137,560,273,17,13,13,57,136,65,112,0,0
4097,505,136,562,274,17,13,13,57,138,66,112,0,0
4098,506,137,562,274,17,13,13,56,137,67,112,0,0
4099,507,137,562,274,17,13,13,55,137,68,112,0,0
4100,506,139,560,274,17,13,13,54,135,69,112,0,0
4101,506,141,559,274,17,13,13,53,133,70,112,0,0
4102,506,144,557,273,17,13,13,51,129,71,112,0,0
4103,506,145,556,273,17,13,13,50,128,72,112,0,0
4104,507,144,557,273,17,13,13,50,129,73,112,0,0
4105,507,144,558,273,17,13,13,51,129,74,112,0,0
4106,508,146,557,272,17,13,13,49,126,75,112,0,0
4107,508,147,557,274,17,13,13,49,127,76,112,0,0
4108,509,147,557,274,17,13,13,48,127,77,112,0,0
4109,508,147,556,274,17,13,13,48,127,78,112,0,0
4110,509,147,556,272,17,13,13,47,125,79,112,0,0
4111,509,146,556,272,17,13,13,47,126,80,112,0,0
4112,507,148,554,273,17,13,13,47,125,81,112,0,0
4113,507,151,553,273,17,13,13,46,122,82,112,0,0
4114,508,149,554,275,17,13,13,46,126,83,112,0,0
4115,507,146,554,276,17,13,13,47,130,84,112,0,0
4116,508,146,554,273,17,13,13,46,127,85,112,0,0
4117,509,154,552,274,17,13,13,43,120,86,112,0,0
4118,511,156,554,274,17,13,13,43,118,87,112,0,0
4119,514,159,557,280,17,13,13,43,121,88,112,0,0
4120,518,155,565,286,17,13,13,47,131,89,112,0,0
4121,518,148,568,289,17,13,13,50,141,90,112,0,0
4122,517,150,568,293,17,13,13,51,143,91,112,0,0
4123,516,151,569,298,17,13,13,53,147,92,112,0,0
4124,514,151,568,303,17,13,13,54,152,93,112,0,0
4125,508,153,564,309,17,13,13,56,156,94,112,0,0
4126,504,151,560,313,17,13,13,56,162,95,112,0,0
4127,501,152,561,323,17,13,13,60,171,96,112,0,0
4128,499,151,560,327,17,13,13,61,176,97,112,0,0
4129,491,151,555,333,17,13,13,64,182,98,112,0,0
4130,487,153,550,337,17,13,13,63,184,99,112,0,0
4131,481,153,548,347,17,13,13,67,194,100,112,0,0
4132,475,157,542,354,17,13,13,67,197,101,112,0,0
4133,469,160,534,353,17,13,13,65,193,102,112,0,0
4134,456,159,524,363,17,13,13,68,204,103,112,0,0
4135,447,161,515,366,17,13,13,68,205,104,112,0,0
4136,437,164,504,371,17,13,13,67,207,105,112,0,0
4137,423,167,491,379,17,13,13,68,212,106,112,0,0
4138,407,167,476,385,17,13,13,69,218,107,112,0,0
4139,384,172,455,395,17,13,13,71,223,108,112,0,0
4140,364,171,437,402,17,13,13,73,231,109,112,0,0
4141,342,170,415,405,17,13,13,73,235,110,112,0,0
4142,322,177,393,408,17,13,13,71,231,111,112,0,0
4143,310,179,383,413,17,13,13,73,234,112,112,1,0
4056,538,148,576,273,19,13,13,38,125,0,0,0,0
4097,543,165,579,275,20,13,13,36,110,0,4,0,0
4098,543,165,578,275,20,13,13,35,110,1,4,0,0
4099,542,164,578,274,20,13,13,36,110,2,4,0,0
4100,541,163,577,273,20,13,13,36,110,3,4,0,0
4105,537,153,577,273,20,13,13,40,120,0,4,0,0
4106,537,151,577,273,20,13,13,40,122,1,4,0,0
4107,539,157,578,273,20,13,13,39,116,2,4,0,0
4108,540,159,578,275,20,13,13,38,116,3,4,0,0
4109,540,159,578,275,20,13,13,38,116,4,4,0,0
4592,508,184,544,259,22,13,13,36,75,0,16,0,0
4593,499,179,535,254,22,13,13,36,75,1,16,0,0
4594,486,175,526,258,22,13,13,40,83,2,16,0,0
4595,468,157,516,259,22,13,13,48,102,3,16,0,0
4596,458,159,505,260,22,13,13,47,101,4,16,0,0
4597,445,153,494,259,22,13,13,49,106,5,16,0,0
4598,433,154,482,261,22,13,13,49,107,6,16,0,0
4599,424,163,468,258,22,13,13,44,95,7,16,0,0
4600,412,168,454,259,22,13,13,42,91,8,16,0,0
4601,399,162,443,259,22,13,13,44,97,9,16,0,0
4602,389,165,431,259,22,13,13,42,94,10,16,0,0
4603,377,163,418,256,22,13,13,41,93,11,16,0,0
4604,366,158,409,256,22,13,13,43,98,12,16,0,0
4605,354,150,398,256,22,13,13,44,106,13,16,0,0
4606,346,164,385,255,22,13,13,39,91,14,16,0,0
4607,337,159,377,253,22,13,13,40,94,15,16,0,0
4608,326,158,366,253,22,13,13,40,95,16,16,0,0
5281,359,126,394,259,23,13,13,35,133,0,24,0,1
5282,368,127,404,261,23,13,13,36,134,1,24,0,0
5283,384,130,420,262,23,13,13,36,132,2,24,0,0
5284,397,126,435,263,23,13,13,38,137,3,24,0,0
5285,411,128,450,264,23,13,13,39,136,4,24,0,0
5286,420,133,460,266,23,13,13,40,133,5,24,0,0
5287,436,128,478,268,23,13,13,42,140,6,24,0,0
5288,451,131,493,270,23,13,13,42,139,7,24,0,0
5289,464,130,510,273,23,13,13,46,143,8,24,0,0
5290,475,130,521,272,23,13,13,46,142,9,24,0,0
5291,492,130,538,267,23,13,13,46,137,10,24,0,0
5292,497,131,545,270,23,13,13,48,139,11,24,0,0
5293,502,135,549,272,23,13,13,47,137,12,24,0,0
5294,513,137,558,269,23,13,13,45,132,13,24,0,0
5295,525,136,571,273,23,13,13,46,137,14,24,0,0
5296,531,136,578,274,23,13,13,47,138,15,24,0,0
5297,536,133,586,278,23,13,13,50,145,16,24,0,0
5298,537,133,587,278,23,13,13,50,145,17,24,0,0
5299,541,134,590,277,23,13,13,49,143,18,24,0,0
5300,547,134,597,278,23,13,13,50,144,19,24,0,0
5301,550,135,601,280,23,13,13,51,145,20,24,0,0
5302,553,135,605,283,23,13,13,52,148,21,24,0,0
5303,562,137,613,281,23,13,13,51,144,22,24,0,0
5304,567,137,617,285,23,13,13,50,148,23,24,0,0
5305,574,138,625,286,23,13,13,51,148,24,24,1,0
5775,351,131,386,261,25,13,13,35,130,0,96,0,1
5776,343,127,380,263,25,13,13,37,136,1,96,0,0
5777,347,133,382,263,25,13,13,35,130,2,96,0,0
5778,352,133,388,264,25,13,13,36,131,3,96,0,0
5779,359,134,396,265,25,13,13,37,131,4,96,0,0
5780,372,133,410,266,25,13,13,38,133,5,96,0,0
5781,381,131,420,267,25,13,13,39,136,6,96,0,0
5782,391,134,430,266,25,13,13,39,132,7,96,0,0
5783,400,132,440,267,25,13,13,40,135,8,96,0,0
5784,408,131,448,267,25,13,13,40,136,9,96,0,0
5785,418,137,457,267,25,13,13,39,130,10,96,0,0
5786,427,135,467,267,25,13,13,40,132,11,96,0,0
5787,435,131,478,270,25,13,13,43,139,12,96,0,0
5788,445,136,486,270,25,13,13,41,134,13,96,0,0
5789,452,141,492,268,25,13,13,40,127,14,96,0,0
5790,458,139,499,265,25,13,13,41,126,15,96,0,0
5791,469,136,511,265,25,13,13,42,129,16,96,0,0
5792,479,136,522,265,25,13,13,43,129,17,96,0,0
5793,486,135,529,266,25,13,13,43,131,18,96,0,0
5794,493,134,536,266,25,13,13,43,132,19,96,0,0
5795,499,138,541,266,25,13,13,42,128,20,96,0,0
5796,508,138,552,269,25,13,13,44,131,21,96,0,0
5797,516,136,561,270,25,13,13,45,134,22,96,0,0
5798,519,134,565,271,25,13,13,46,137,23,96,0,0
5799,518,134,565,272,25,13,13,47,138,24,96,0,0
5800,518,133,566,272,25,13,13,48,139,25,96,0,0
5801,518,134,567,273,25,13,13,49,139,26,96,0,0
5802,518,135,568,274,25,13,13,50,139,27,96,0,0
5803,517,135,568,274,25,13,13,51,139,28,96,0,0
5804,517,135,568,274,25,13,13,51,139,29,96,0,0
5805,517,135,569,274,25,13,13,52,139,30,96,0,0
5806,517,135,570,274,25,13,13,53,139,31,96,0,0
5807,518,135,571,274,25,13,13,53,139,32,96,0,0
5808,517,135,571,274,25,13,13,54,139,33,96,0,0
5809,517,136,571,275,25,13,13,54,139,34,96,0,0
5810,516,136,571,275,25,13,13,55,139,35,96,0,0
5811,515,136,569,273,25,13,13,54,137,36,96,0,0
5812,513,136,568,273,25,13,13,55,137,37,96,0,0
5813,512,136,566,273,25,13,13,54,137,38,96,0,0
5814,512,136,566,273,25,13,13,54,137,39,96,0,0
5815,512,137,566,273,25,13,13,54,136,40,96,0,0
5816,510,138,564,273,25,13,13,54,135,41,96,0,0
5817,510,137,563,272,25,13,13,53,135,42,96,0,0
5818,510,137,564,272,25,13,13,54,135,43,96,0,0
5819,510,138,563,272,25,13,13,53,134,44,96,0,0
5820,512,138,565,270,25,13,13,53,132,45,96,0,0
5821,511,136,566,272,25,13,13,55,136,46,96,0,0
5822,511,135,567,272,25,13,13,56,137,47,96,0,0
5823,512,135,567,272,25,13,13,55,137,48,96,0,0
5824,512,134,568,272,25,13,13,56,138,49,96,0,0
5825,512,135,567,272,25,13,13,55,137,50,96,0,0
5826,511,137,565,271,25,13,13,54,134,51,96,0,0
5827,512,140,565,271,25,13,13,53,131,52,96,0,0
5828,514,139,567,267,25,13,13,53,128,53,96,0,0
5829,512,139,565,267,25,13,13,53,128,54,96,0,0
5830,511,137,565,268,25,13,13,54,131,55,96,0,0
5831,512,137,567,271,25,13,13,55,134,56,96,0,0
5832,512,137,568,272,25,13,13,56,135,57,96,0,0
5833,512,138,568,271,25,13,13,56,133,58,96,0,0
5834,511,139,568,271,25,13,13,57,132,59,96,0,0
5835,511,137,569,272,25,13,13,58,135,60,96,0,0
5836,512,137,571,273,25,13,13,59,136,61,96,0,0
5837,513,137,571,273,25,13,13,58,136,62,96,0,0
5838,512,137,570,273,25,13,13,58,136,63,96,0,0
5839,509,137,567,271,25,13,13,58,134,64,96,0,0
5840,508,137,566,270,25,13,13,58,133,65,96,0,0
5841,512,136,571,271,25,13,13,59,135,66,96,0,0
5842,510,135,569,272,25,13,13,59,137,67,96,0,0
5843,511,135,570,272,25,13,13,59,137,68,96,0,0
5844,509,135,568,272,25,13,13,59,137,69,96,0,0
5845,510,136,568,273,25,13,13,58,137,70,96,0,0
5846,509,136,566,271,25,13,13,57,135,71,96,0,0
5847,509,136,565,271,25,13,13,56,135,72,96,0,0
5848,511,135,567,272,25,13,13,56,137,73,96,0,0
5849,509,136,565,272,25,13,13,56,136,74,96,0,0
5850,510,137,565,272,25,13,13,55,135,75,96,0,0
5851,511,137,565,272,25,13,13,54,135,76,96,0,0
5852,512,137,566,271,25,13,13,54,134,77,96,0,0
5853,513,136,567,272,25,13,13,54,136,78,96,0,0
5854,512,134,566,272,25,13,13,54,138,79,96,0,0
5855,511,135,564,271,25,13,13,53,136,80,96,0,0
5856,511,132,565,272,25,13,13,54,140,81,96,0,0
5857,514,132,568,273,25,13,13,54,141,82,96,0,0
5858,515,133,569,273,25,13,13,54,140,83,96,0,0
5859,511,133,566,274,25,13,13,55,141,84,96,0,0
5860,507,138,559,273,25,13,13,52,135,85,96,0,0
5861,505,139,556,271,25,13,13,51,132,86,96,0,0
5862,502,142,550,269,25,13,13,48,127,87,96,0,0
5863,501,141,549,267,25,13,13,48,126,88,96,0,0
5864,501,140,550,267,25,13,13,49,127,89,96,0,0
5865,502,139,551,266,25,13,13,49,127,90,96,0,0
5866,506,137,556,266,25,13,13,50,129,91,96,0,0
5867,512,137,561,263,25,13,13,49,126,92,96,0,0
5868,521,135,572,267,25,13,13,51,132,93,96,0,0
5869,528,137,578,266,25,13,13,50,129,94,96,0,0
5870,534,149,580,268,25,13,13,46,119,95,96,0,0
5871,537,150,582,268,25,13,13,45,118,96,96,1,0
5776,363,128,406,266,26,13,13,43,138,0,25,0,1
5777,378,133,416,255,26,13,13,38,122,1,25,0,0
5778,375,138,411,257,26,13,13,36,119,2,25,0,0
5779,375,141,411,257,26,13,13,36,116,3,25,0,0
5780,416,135,455,263,26,13,13,39,128,4,25,0,0
5781,430,134,471,265,26,13,13,41,131,5,25,0,0
5782,441,138,480,265,26,13,13,39,127,6,25,0,0
5783,451,139,492,270,26,13,13,41,131,7,25,0,0
5784,463,137,504,267,26,13,13,41,130,8,25,0,0
5785,474,136,516,269,26,13,13,42,133,9,25,0,0
5786,481,137,524,272,26,13,13,43,135,10,25,0,0
5787,489,136,533,273,26,13,13,44,137,11,25,0,0
5788,497,136,542,274,26,13,13,45,138,12,25,0,0
5789,504,138,549,273,26,13,13,45,135,13,25,0,0
5790,510,138,555,273,26,13,13,45,135,14,25,0,0
5791,524,137,569,273,26,13,13,45,136,15,25,0,0
5792,535,138,580,274,26,13,13,45,136,16,25,0,0
5793,539,139,583,275,26,13,13,44,136,17,25,0,0
5794,539,138,583,277,26,13,13,44,139,18,25,0,0
5795,539,140,583,278,26,13,13,44,138,19,25,0,0
5796,542,144,583,277,26,13,13,41,133,20,25,0,0
5797,543,147,583,274,26,13,13,40,127,21,25,0,0
5798,546,152,583,272,26,13,13,37,120,22,25,0,0
5799,545,155,581,275,26,13,13,36,120,23,25,0,0
5800,546,154,581,272,26,13,13,35,118,24,25,0,0
5801,550,155,585,272,26,13,13,35,117,25,25,1,0
5812,545,154,582,274,26,13,13,37,120,0,25,0,0
5813,543,153,580,275,26,13,13,37,122,1,25,0,0
5814,543,152,579,275,26,13,13,36,123,2,25,0,0
5815,543,152,580,275,26,13,13,37,123,3,25,0,0
5816,542,153,579,277,26,13,13,37,124,4,25,0,0
5817,543,152,579,275,26,13,13,36,123,5,25,0,0
5818,543,151,580,276,26,13,13,37,125,6,25,0,0
5819,542,152,579,277,26,13,13,37,125,7,25,0,0
5820,543,158,578,275,26,13,13,35,117,8,25,0,0
5844,542,150,578,274,26,13,13,36,124,0,25,0,0
5845,542,149,578,274,26,13,13,36,125,1,25,0,0
5846,541,152,577,274,26,13,13,36,122,2,25,0,0
5849,542,155,578,275,26,13,13,36,120,0,25,0,0
5850,542,155,578,275,26,13,13,36,120,1,25,0,0
5851,543,154,578,274,26,13,13,35,120,2,25,0,0
5855,543,152,578,274,26,13,13,35,122,0,25,0,0
5856,541,144,578,272,26,13,13,37,128,1,25,0,0
5857,541,143,579,272,26,13,13,38,129,2,25,0,0
5859,542,154,577,274,26,13,13,35,120,0,25,0,0
5860,539,149,575,274,26,13,13,36,125,1,25,0,0
5861,538,147,574,274,26,13,13,36,127,2,25,0,0
5862,532,143,567,266,26,13,13,35,123,3,25,0,0
5863,531,141,566,266,26,13,13,35,125,4,25,0,0
5792,519,138,554,271,28,13,13,35,133,0,3,0,0
5793,521,138,557,271,28,13,13,36,133,1,3,0,0
5794,520,136,555,270,28,13,13,35,134,2,3,0,0
5795,520,135,555,270,28,13,13,35,135,3,3,0,0
5913,339,130,374,259,29,13,13,35,129,0,21,0,1
5914,348,130,383,259,29,13,13,35,129,1,21,0,0
5915,357,133,392,263,29,13,13,35,130,2,21,0,0
5916,370,137,405,264,29,13,13,35,127,3,21,0,0
5917,386,136,423,268,29,13,13,37,132,4,21,0,0
5918,397,137,435,271,29,13,13,38,134,5,21,0,0
5919,409,136,448,273,29,13,13,39,137,6,21,0,0
5920,421,135,460,273,29,13,13,39,138,7,21,0,0
5921,430,137,471,276,29,13,13,41,139,8,21,0,0
5922,443,137,485,278,29,13,13,42,141,9,21,0,0
5923,459,138,502,280,29,13,13,43,142,10,21,0,0
5924,471,140,514,280,29,13,13,43,140,11,21,0,0
5925,482,137,527,282,29,13,13,45,145,12,21,0,0
5926,496,137,541,282,29,13,13,45,145,13,21,0,0
5927,505,139,552,285,29,13,13,47,146,14,21,0,0
5928,521,140,572,289,29,13,13,51,149,15,21,0,0
5929,535,139,586,289,29,13,13,51,150,16,21,0,0
5930,548,140,599,286,29,13,13,51,146,17,21,0,0
5931,554,139,606,286,29,13,13,52,147,18,21,0,0
5932,563,143,614,290,29,13,13,51,147,19,21,0,0
5933,569,145,619,289,29,13,13,50,144,20,21,0,0
5934,580,146,630,290,29,13,13,50,144,21,21,1,0
1106,1596,182,1631,294,4,13,14,35,112,0,51,0,1
1107,1596,183,1631,294,4,13,14,35,111,1,51,0,0
1108,1594,182,1630,301,4,13,14,36,119,2,51,0,0
1109,1592,182,1630,305,4,13,14,38,123,3,51,0,0
1110,1590,180,1631,310,4,13,14,41,130,4,51,0,0
1111,1590,182,1632,314,4,13,14,42,132,5,51,0,0
1112,1590,184,1632,317,4,13,14,42,133,6,51,0,0
1113,1590,185,1632,322,4,13,14,42,137,7,51,0,0
1114,1588,186,1631,324,4,13,14,43,138,8,51,0,0
1115,1587,185,1632,328,4,13,14,45,143,9,51,0,0
1116,1587,186,1632,329,4,13,14,45,143,10,51,0,0
1117,1584,186,1632,336,4,13,14,48,150,11,51,0,0
1118,1582,186,1631,342,4,13,14,49,156,12,51,0,0
1119,1579,185,1632,349,4,13,14,53,164,13,51,0,0
1120,1578,193,1632,357,4,13,14,54,164,14,51,0,0
1121,1575,194,1629,359,4,13,14,54,165,15,51,0,0
1122,1572,199,1626,365,4,13,14,54,166,16,51,0,0
1123,1567,200,1623,369,4,13,14,56,169,17,51,0,0
1124,1566,203,1624,377,4,13,14,58,174,18,51,0,0
1125,1564,205,1623,379,4,13,14,59,174,19,51,0,0
1126,1560,207,1621,385,4,13,14,61,178,20,51,0,0
1127,1556,210,1619,395,4,13,14,63,185,21,51,0,0
1128,1553,209,1620,406,4,13,14,67,197,22,51,0,0
1129,1549,209,1620,418,4,13,14,71,209,23,51,0,0
1130,1546,207,1620,423,4,13,14,74,216,24,51,0,0
1131,1543,217,1616,434,4,13,14,73,217,25,51,0,0
1132,1538,219,1613,440,4,13,14,75,221,26,51,0,0
1133,1534,224,1614,454,4,13,14,80,230,27,51,0,0
1134,1531,225,1614,461,4,13,14,83,236,28,51,0,0
1135,1527,226,1612,469,4,13,14,85,243,29,51,0,0
1136,1521,232,1609,483,4,13,14,88,251,30,51,0,0
1137,1516,233,1608,496,4,13,14,92,263,31,51,0,0
1138,1516,242,1611,506,4,13,14,95,264,32,51,0,0
1139,1513,244,1613,521,4,13,14,100,277,33,51,0,0
1140,1511,250,1615,544,4,13,14,104,294,34,51,0,0
1141,1506,251,1615,560,4,13,14,109,309,35,51,0,0
1142,1504,257,1621,585,4,13,14,117,328,36,51,0,0
1143,1504,268,1626,609,4,13,14,122,341,37,51,0,0
1144,1500,271,1626,622,4,13,14,126,351,38,51,0,0
1145,1495,283,1622,639,4,13,14,127,356,39,51,0,0
1146,1481,286,1617,668,4,13,14,136,382,40,51,0,0
1147,1476,302,1622,707,4,13,14,146,405,41,51,0,0
1148,1470,312,1622,730,4,13,14,152,418,42,51,0,0
1149,1465,323,1621,752,4,13,14,156,429,43,51,0,0
1150,1451,336,1618,798,4,13,14,167,462,44,51,0,0
1151,1441,348,1620,836,4,13,14,179,488,45,51,0,0
1152,1435,365,1632,899,4,13,14,197,534,46,51,0,0
1153,1435,379,1642,937,4,13,14,207,558,47,51,0,0
1154,1436,410,1658,1009,4,13,14,222,599,48,51,0,0
1155,1443,431,1676,1049,4,13,14,233,618,49,51,0,0
1156,1480,465,1715,1061,4,13,14,235,596,50,51,0,0
1157,1479,478,1721,1080,4,13,14,242,602,51,51,1,0
1157,1595,512,1881,1012,5,13,14,286,500,0,1,0,0
1158,1629,537,1915,1037,5,13,14,286,500,1,1,0,0
2340,1763,686,1914,1000,6,13,14,151,314,0,0,0,0
2341,1615,653,1802,1071,7,13,14,187,418,0,0,0,0
2342,1362,650,1736,1070,8,13,14,374,420,0,16,0,0
2343,1225,636,1606,1066,8,13,14,381,430,1,16,0,0
2344,1071,619,1467,1072,8,13,14,396,453,2,16,0,0
2345,962,615,1358,1071,8,13,14,396,456,3,16,0,0
2346,786,582,1209,1077,8,13,14,423,495,4,16,0,0
2347,666,583,1084,1080,8,13,14,418,497,5,16,0,0
2348,545,579,955,1078,8,13,14,410,499,6,16,0,0
2349,452,551,873,1077,8,13,14,421,526,7,16,0,0
2350,395,542,812,1078,8,13,14,417,536,8,16,0,0
2351,355,536,763,1077,8,13,14,408,541,9,16,0,0
2352,343,532,744,1074,8,13,14,401,542,10,16,0,0
2353,349,535,738,1073,8,13,14,389,538,11,16,0,0
2354,383,555,751,1077,8,13,14,368,522,12,16,0,0
2355,435,579,780,1077,8,13,14,345,498,13,16,0,0
2356,473,618,793,1075,8,13,14,320,457,14,16,0,0
2357,543,640,856,1075,8,13,14,313,435,15,16,0,0
2358,516,645,825,1075,8,13,14,309,430,16,16,0,0
2358,739,663,1016,1078,9,13,14,277,415,0,0,0,0
2359,896,675,1160,1078,10,13,14,264,403,0,1,0,0
2360,1028,669,1295,1076,10,13,14,267,407,1,1,0,0
2361,1261,698,1543,1076,11,13,14,282,378,0,4,0,0
2362,1355,691,1641,1072,11,13,14,286,381,1,4,0,0
2363,1504,699,1787,1072,11,13,14,283,373,2,4,0,0
2364,1635,755,1882,1078,11,13,14,247,323,3,4,0,0
2365,1730,777,1920,1079,11,13,14,190,302,4,4,0,0
3929,2,550,72,760,12,13,14,70,210,0,0,0,0
3931,1,496,83,804,13,13,14,82,308,0,20,0,1
3932,9,514,94,833,13,13,14,85,319,1,20,0,0
3933,12,507,100,835,13,13,14,88,328,2,20,0,0
3934,41,554,123,846,13,13,14,82,292,3,20,0,0
3935,40,511,142,866,13,13,14,102,355,4,20,0,0
3936,43,488,161,888,13,13,14,118,400,5,20,0,0
3937,54,485,188,929,13,13,14,134,444,6,20,0,0
3938,83,488,228,948,13,13,14,145,460,7,20,0,0
3939,125,501,280,970,13,13,14,155,469,8,20,0,0
3940,149,496,320,992,13,13,14,171,496,9,20,0,0
3941,188,501,379,1033,13,13,14,191,532,10,20,0,0
3942,227,504,430,1059,13,13,14,203,555,11,20,0,0
3943,306,518,523,1076,13,13,14,217,558,12,20,0,0
3944,370,520,594,1080,13,13,14,224,560,13,20,0,0
3945,426,524,654,1080,13,13,14,228,556,14,20,0,0
3946,506,548,731,1080,13,13,14,225,532,15,20,0,0
3947,610,552,839,1080,13,13,14,229,528,16,20,0,0
3948,728,566,952,1080,13,13,14,224,514,17,20,0,0
3949,858,564,1080,1080,13,13,14,222,516,18,20,0,0
3950,988,581,1207,1080,13,13,14,219,499,19,20,0,0
3951,1056,585,1277,1080,13,13,14,221,495,20,20,1,0
3951,1197,600,1442,1076,14,13,14,245,476,0,0,0,0
3952,1379,608,1614,1068,15,13,14,235,460,0,0,0,0
3953,1546,651,1792,1079,16,13,14,246,428,0,0,0,0
1815,1218,120,1254,267,1,13,15,36,147,0,47,0,1
1816,1233,124,1270,270,1,13,15,37,146,1,47,0,0
1817,1243,126,1281,273,1,13,15,38,147,2,47,0,0
1818,1252,126,1292,276,1,13,15,40,150,3,47,0,0
1819,1263,129,1302,274,1,13,15,39,145,4,47,0,0
1820,1272,126,1315,283,1,13,15,43,157,5,47,0,0
1821,1282,128,1326,284,1,13,15,44,156,6,47,0,0
1822,1295,133,1340,287,1,13,15,45,154,7,47,0,0
1823,1303,135,1350,292,1,13,15,47,157,8,47,0,0
1824,1314,135,1364,294,1,13,15,50,159,9,47,0,0
1825,1318,135,1371,298,1,13,15,53,163,10,47,0,0
1826,1324,139,1380,304,1,13,15,56,165,11,47,0,0
1827,1328,139,1384,304,1,13,15,56,165,12,47,0,0
1828,1330,138,1389,311,1,13,15,59,173,13,47,0,0
1829,1331,141,1390,317,1,13,15,59,176,14,47,0,0
1830,1331,142,1389,315,1,13,15,58,173,15,47,0,0
1831,1328,142,1390,322,1,13,15,62,180,16,47,0,0
1832,1327,144,1390,329,1,13,15,63,185,17,47,0,0
1833,1325,145,1389,333,1,13,15,64,188,18,47,0,0
1834,1324,149,1388,337,1,13,15,64,188,19,47,0,0
1835,1321,151,1387,340,1,13,15,66,189,20,47,0,0
1836,1318,149,1386,343,1,13,15,68,194,21,47,0,0
1837,1312,147,1383,345,1,13,15,71,198,22,47,0,0
1838,1307,152,1378,351,1,13,15,71,199,23,47,0,0
1839,1307,155,1379,355,1,13,15,72,200,24,47,0,0
1840,1310,156,1383,360,1,13,15,73,204,25,47,0,0
1841,1309,159,1385,369,1,13,15,76,210,26,47,0,0
1842,1308,161,1387,373,1,13,15,79,212,27,47,0,0
1843,1301,160,1383,377,1,13,15,82,217,28,47,0,0
1844,1295,164,1379,386,1,13,15,84,222,29,47,0,0
1845,1296,166,1384,398,1,13,15,88,232,30,47,0,0
1846,1299,165,1388,403,1,13,15,89,238,31,47,0,0
1847,1299,172,1390,414,1,13,15,91,242,32,47,0,0
1848,1297,175,1390,419,1,13,15,93,244,33,47,0,0
1849,1291,175,1387,425,1,13,15,96,250,34,47,0,0
1850,1286,180,1382,432,1,13,15,96,252,35,47,0,0
1851,1288,182,1387,444,1,13,15,99,262,36,47,0,0
1852,1290,183,1389,447,1,13,15,99,264,37,47,0,0
1853,1287,185,1390,460,1,13,15,103,275,38,47,0,0
1854,1283,186,1391,474,1,13,15,108,288,39,47,0,0
1855,1280,188,1390,479,1,13,15,110,291,40,47,0,0
1856,1283,195,1391,484,1,13,15,108,289,41,47,0,0
1857,1293,200,1402,495,1,13,15,109,295,42,47,0,0
1858,1314,203,1423,500,1,13,15,109,297,43,47,0,0
1859,1321,207,1436,522,1,13,15,115,315,44,47,0,0
1860,1338,207,1448,521,1,13,15,110,314,45,47,0,0
1861,1356,252,1450,534,1,13,15,94,282,46,47,0,0
1862,1360,259,1455,542,1,13,15,95,283,47,47,1,0
3636,313,870,509,1069,4,13,15,196,199,0,0,0,0
3637,462,823,701,1076,5,13,15,239,253,0,0,0,0
3638,595,735,852,1073,6,13,15,257,338,0,13,0,0
3639,660,677,961,1075,6,13,15,301,398,1,13,0,0
3640,728,644,1050,1073,6,13,15,322,429,2,13,0,0
3641,793,581,1156,1071,6,13,15,363,490,3,13,0,0
3642,845,534,1237,1069,6,13,15,392,535,4,13,0,0
3643,881,494,1296,1072,6,13,15,415,578,5,13,0,0
3644,927,462,1334,1045,6,13,15,407,583,6,13,0,0
3645,965,439,1361,1024,6,13,15,396,585,7,13,0,0
3646,1045,415,1399,953,6,13,15,354,538,8,13,0,0
3647,1100,396,1437,923,6,13,15,337,527,9,13,0,0
3648,1161,379,1473,883,6,13,15,312,504,10,13,0,0
3649,1216,365,1502,845,6,13,15,286,480,11,13,0,0
3650,1222,258,1543,820,6,13,15,321,562,12,13,0,0
3651,1264,220,1594,799,6,13,15,330,579,13,13,0,0
3998,1176,112,1212,250,7,13,15,36,138,0,55,0,1
3999,1184,112,1219,244,7,13,15,35,132,1,55,0,0
4000,1191,115,1227,251,7,13,15,36,136,2,55,0,0
4001,1198,115,1233,243,7,13,15,35,128,3,55,0,0
4002,1204,116,1241,251,7,13,15,37,135,4,55,0,0
4003,1211,117,1250,257,7,13,15,39,140,5,55,0,0
4004,1218,116,1258,255,7,13,15,40,139,6,55,0,0
4005,1221,115,1265,266,7,13,15,44,151,7,55,0,0
4006,1225,117,1270,267,7,13,15,45,150,8,55,0,0
4007,1225,117,1272,272,7,13,15,47,155,9,55,0,0
4008,1225,116,1275,280,7,13,15,50,164,10,55,0,0
4009,1226,117,1277,283,7,13,15,51,166,11,55,0,0
4010,1226,117,1279,285,7,13,15,53,168,12,55,0,0
4011,1227,119,1280,286,7,13,15,53,167,13,55,0,0
4012,1223,119,1277,290,7,13,15,54,171,14,55,0,0
4013,1219,121,1272,287,7,13,15,53,166,15,55,0,0
4014,1216,123,1269,291,7,13,15,53,168,16,55,0,0
4015,1212,122,1269,299,7,13,15,57,177,17,55,0,0
4016,1209,124,1267,305,7,13,15,58,181,18,55,0,0
4017,1208,128,1266,310,7,13,15,58,182,19,55,0,0
4018,1206,129,1266,315,7,13,15,60,186,20,55,0,0
4019,1204,128,1265,319,7,13,15,61,191,21,55,0,0
4020,1203,132,1264,325,7,13,15,61,193,22,55,0,0
4021,1203,133,1265,327,7,13,15,62,194,23,55,0,0
4022,1202,130,1266,327,7,13,15,64,197,24,55,0,0
4023,1201,133,1265,332,7,13,15,64,199,25,55,0,0
4024,1201,135,1265,336,7,13,15,64,201,26,55,0,0
4025,1202,135,1268,340,7,13,15,66,205,27,55,0,0
4026,1203,137,1271,344,7,13,15,68,207,28,55,0,0
4027,1204,138,1274,353,7,13,15,70,215,29,55,0,0
4028,1207,139,1277,355,7,13,15,70,216,30,55,0,0
4029,1205,139,1276,365,7,13,15,71,226,31,55,0,0
4030,1200,139,1273,372,7,13,15,73,233,32,55,0,0
4031,1198,142,1270,374,7,13,15,72,232,33,55,0,0
4032,1197,141,1269,377,7,13,15,72,236,34,55,0,0
4033,1198,142,1269,376,7,13,15,71,234,35,55,0,0
4034,1197,143,1270,388,7,13,15,73,245,36,55,0,0
4035,1195,145,1269,399,7,13,15,74,254,37,55,0,0
4036,1192,146,1268,404,7,13,15,76,258,38,55,0,0
4037,1191,146,1267,407,7,13,15,76,261,39,55,0,0
4038,1192,149,1269,412,7,13,15,77,263,40,55,0,0
4039,1195,151,1270,411,7,13,15,75,260,41,55,0,0
4040,1196,154,1274,423,7,13,15,78,269,42,55,0,0
4041,1196,159,1276,433,7,13,15,80,274,43,55,0,0
4042,1199,161,1279,434,7,13,15,80,273,44,55,0,0
4043,1204,168,1285,446,7,13,15,81,278,45,55,0,0
4044,1213,172,1297,457,7,13,15,84,285,46,55,0,0
4045,1224,171,1309,460,7,13,15,85,289,47,55,0,0
4046,1237,173,1325,472,7,13,15,88,299,48,55,0,0
4047,1248,175,1339,482,7,13,15,91,307,49,55,0,0
4048,1264,175,1356,483,7,13,15,92,308,50,55,0,0
4049,1280,182,1375,494,7,13,15,95,312,51,55,0,0
4050,1295,187,1395,506,7,13,15,100,319,52,55,0,0
4051,1326,188,1425,507,7,13,15,99,319,53,55,0,0
4052,1349,192,1444,507,7,13,15,95,315,54,55,0,0
4053,1359,194,1456,513,7,13,15,97,319,55,55,1,0
4123,1365,238,1437,553,8,13,15,72,315,0,54,0,1
4124,1340,232,1412,546,8,13,15,72,314,1,54,0,0
4125,1316,233,1388,537,8,13,15,72,304,2,54,0,0
4126,1298,227,1369,527,8,13,15,71,300,3,54,0,0
4127,1284,222,1356,518,8,13,15,72,296,4,54,0,0
4128,1272,218,1345,515,8,13,15,73,297,5,54,0,0
4129,1263,208,1335,496,8,13,15,72,288,6,54,0,0
4130,1247,205,1319,490,8,13,15,72,285,7,54,0,0
4131,1236,201,1305,472,8,13,15,69,271,8,54,0,0
4132,1229,199,1297,465,8,13,15,68,266,9,54,0,0
4133,1228,195,1296,462,8,13,15,68,267,10,54,0,0
4134,1227,196,1293,458,8,13,15,66,262,11,54,0,0
4135,1225,192,1292,459,8,13,15,67,267,12,54,0,0
4136,1223,193,1291,463,8,13,15,68,270,13,54,0,0
4137,1215,196,1282,467,8,13,15,67,271,14,54,0,0
4138,1203,200,1271,467,8,13,15,68,267,15,54,0,0
4139,1181,202,1253,474,8,13,15,72,272,16,54,0,0
4140,1165,203,1238,471,8,13,15,73,268,17,54,0,0
4141,1154,205,1231,484,8,13,15,77,279,18,54,0,0
4142,1151,205,1232,498,8,13,15,81,293,19,54,0,0
4143,1150,205,1233,505,8,13,15,83,300,20,54,0,0
4144,1146,209,1232,513,8,13,15,86,304,21,54,0,0
4145,1140,215,1228,524,8,13,15,88,309,22,54,0,0
4146,1132,219,1220,527,8,13,15,88,308,23,54,0,0
4147,1121,224,1213,546,8,13,15,92,322,24,54,0,0
4148,1112,227,1207,561,8,13,15,95,334,25,54,0,0
4149,1099,232,1194,565,8,13,15,95,333,26,54,0,0
4150,1071,236,1173,577,8,13,15,102,341,27,54,0,0
4151,1048,236,1152,582,8,13,15,104,346,28,54,0,0
4152,1027,244,1134,599,8,13,15,107,355,29,54,0,0
4153,1018,252,1130,622,8,13,15,112,370,30,54,0,0
4154,1013,256,1129,630,8,13,15,116,374,31,54,0,0
4155,1005,267,1124,650,8,13,15,119,383,32,54,0,0
4156,993,275,1115,667,8,13,15,122,392,33,54,0,0
4157,973,279,1101,684,8,13,15,128,405,34,54,0,0
4158,959,289,1097,720,8,13,15,138,431,35,54,0,0
4159,959,295,1101,738,8,13,15,142,443,36,54,0,0
4160,957,306,1103,761,8,13,15,146,455,37,54,0,0
4161,950,321,1101,793,8,13,15,151,472,38,54,0,0
4162,929,329,1085,811,8,13,15,156,482,39,54,0,0
4163,910,346,1078,866,8,13,15,168,520,40,54,0,0
4164,903,359,1080,904,8,13,15,177,545,41,54,0,0
4165,906,380,1087,934,8,13,15,181,554,42,54,0,0
4166,898,400,1089,986,8,13,15,191,586,43,54,0,0
4167,866,418,1064,1014,8,13,15,198,596,44,54,0,0
4168,839,444,1048,1059,8,13,15,209,615,45,54,0,0
4169,845,473,1053,1072,8,13,15,208,599,46,54,0,0
4170,854,498,1062,1080,8,13,15,208,582,47,54,0,0
4171,857,542,1053,1076,8,13,15,196,534,48,54,0,0
4172,824,580,1014,1080,8,13,15,190,500,49,54,0,0
4173,771,621,961,1080,8,13,15,190,459,50,54,0,0
4174,741,680,923,1080,8,13,15,182,400,51,54,0,0
4175,718,739,888,1080,8,13,15,170,341,52,54,0,0
4176,661,811,807,1078,8,13,15,146,267,53,54,0,0
4177,641,850,771,1080,8,13,15,130,230,54,54,1,0
4193,0,975,81,1073,11,13,15,81,98,0,1,0,0
4194,1,922,131,1078,11,13,15,130,156,1,1,0,0
4203,528,489,1097,1072,12,13,15,569,583,0,79,0,1
4204,565,460,1139,1073,12,13,15,574,613,1,79,0,0
4205,603,429,1159,1053,12,13,15,556,624,2,79,0,0
4206,659,409,1185,1027,12,13,15,526,618,3,79,0,0
4207,717,390,1196,982,12,13,15,479,592,4,79,0,0
4208,769,373,1225,962,12,13,15,456,589,5,79,0,0
4209,801,356,1225,931,12,13,15,424,575,6,79,0,0
4210,830,341,1204,873,12,13,15,374,532,7,79,0,0
4211,850,330,1192,845,12,13,15,342,515,8,79,0,0
4212,882,316,1196,812,12,13,15,314,496,9,79,0,0
4213,919,304,1206,776,12,13,15,287,472,10,79,0,0
4214,935,299,1201,756,12,13,15,266,457,11,79,0,0
4215,947,284,1191,722,12,13,15,244,438,12,79,0,0
4216,959,276,1186,701,12,13,15,227,425,13,79,0,0
4217,979,270,1188,679,12,13,15,209,409,14,79,0,0
4218,1008,260,1203,653,12,13,15,195,393,15,79,0,0
4219,1025,256,1211,642,12,13,15,186,386,16,79,0,0
4220,1038,247,1212,620,12,13,15,174,373,17,79,0,0
4221,1045,238,1209,600,12,13,15,164,362,18,79,0,0
4222,1055,234,1210,589,12,13,15,155,355,19,79,0,0
4223,1079,229,1223,564,12,13,15,144,335,20,79,0,0
4224,1094,227,1232,555,12,13,15,138,328,21,79,0,0
4225,1103,224,1233,541,12,13,15,130,317,22,79,0,0
4226,1108,218,1231,523,12,13,15,123,305,23,79,0,0
4227,1116,216,1233,515,12,13,15,117,299,24,79,0,0
4228,1131,209,1242,498,12,13,15,111,289,25,79,0,0
4229,1146,206,1253,490,12,13,15,107,284,26,79,0,0
4230,1154,204,1258,482,12,13,15,104,278,27,79,0,0
4231,1158,200,1257,469,12,13,15,99,269,28,79,0,0
4232,1165,196,1259,458,12,13,15,94,262,29,79,0,0
4233,1179,194,1269,448,12,13,15,90,254,30,79,0,0
4234,1194,192,1282,442,12,13,15,88,250,31,79,0,0
4235,1206,193,1293,442,12,13,15,87,249,32,79,0,0
4236,1211,190,1294,429,12,13,15,83,239,33,79,0,0
4237,1218,187,1299,424,12,13,15,81,237,34,79,0,0
4238,1229,186,1308,417,12,13,15,79,231,35,79,0,0
4239,1243,181,1321,411,12,13,15,78,230,36,79,0,0
4240,1252,181,1328,407,12,13,15,76,226,37,79,0,0
4241,1257,178,1330,399,12,13,15,73,221,38,79,0,0
4242,1261,175,1331,388,12,13,15,70,213,39,79,0,0
4243,1269,176,1337,381,12,13,15,68,205,40,79,0,0
4244,1281,174,1347,379,12,13,15,66,205,41,79,0,0
4245,1287,174,1353,378,12,13,15,66,204,42,79,0,0
4246,1290,171,1353,369,12,13,15,63,198,43,79,0,0
4247,1292,165,1354,364,12,13,15,62,199,44,79,0,0
4248,1295,165,1355,355,12,13,15,60,190,45,79,0,0
4249,1303,162,1361,348,12,13,15,58,186,46,79,0,0
4250,1308,162,1365,343,12,13,15,57,181,47,79,0,0
4251,1310,164,1364,336,12,13,15,54,172,48,79,0,0
4252,1310,162,1364,333,12,13,15,54,171,49,79,0,0
4253,1310,158,1364,332,12,13,15,54,174,50,79,0,0
4254,1314,154,1367,326,12,13,15,53,172,51,79,0,0
4255,1317,151,1370,322,12,13,15,53,171,52,79,0,0
4256,1314,151,1366,319,12,13,15,52,168,53,79,0,0
4257,1312,154,1361,314,12,13,15,49,160,54,79,0,0
4258,1310,153,1359,312,12,13,15,49,159,55,79,0,0
4259,1310,153,1358,309,12,13,15,48,156,56,79,0,0
4260,1310,150,1358,307,12,13,15,48,157,57,79,0,0
4261,1309,150,1356,301,12,13,15,47,151,58,79,0,0
4262,1305,149,1351,297,12,13,15,46,148,59,79,0,0
4263,1300,146,1346,297,12,13,15,46,151,60,79,0,0
4264,1296,143,1342,295,12,13,15,46,152,61,79,0,0
4265,1293,142,1338,289,12,13,15,45,147,62,79,0,0
4266,1288,142,1331,281,12,13,15,43,139,63,79,0,0
4267,1280,139,1325,285,12,13,15,45,146,64,79,0,0
4268,1271,136,1317,285,12,13,15,46,149,65,79,0,0
4269,1266,136,1310,276,12,13,15,44,140,66,79,0,0
4270,1262,137,1304,270,12,13,15,42,133,67,79,0,0
4271,1256,134,1297,265,12,13,15,41,131,68,79,0,0
4272,1246,134,1289,269,12,13,15,43,135,69,79,0,0
4273,1238,132,1280,264,12,13,15,42,132,70,79,0,0
4274,1229,130,1271,263,12,13,15,42,133,71,79,0,0
4275,1221,130,1263,262,12,13,15,42,132,72,79,0,0
4276,1213,130,1254,257,12,13,15,41,127,73,79,0,0
4277,1204,129,1244,254,12,13,15,40,125,74,79,0,0
4278,1192,124,1233,251,12,13,15,41,127,75,79,0,0
4279,1181,122,1222,251,12,13,15,41,129,76,79,0,0
4280,1173,122,1213,249,12,13,15,40,127,77,79,0,0
4281,1167,120,1205,245,12,13,15,38,125,78,79,0,0
4282,1159,118,1197,242,12,13,15,38,124,79,79,1,0
164,812,387,870,467,1,13,2,58,80,0,0,0,0
486,811,397,869,469,2,13,2,58,72,0,0,0,0
1454,269,121,306,247,3,13,2,37,126,0,75,0,0
1455,270,127,305,247,3,13,2,35,120,1,75,0,0
1471,272,146,308,276,3,13,2,36,130,0,75,0,0
1476,274,158,310,287,3,13,2,36,129,0,75,0,1
1477,274,161,309,288,3,13,2,35,127,1,75,0,0
1478,276,164,311,287,3,13,2,35,123,2,75,0,0
1479,278,159,315,290,3,13,2,37,131,3,75,0,0
1480,279,162,317,294,3,13,2,38,132,4,75,0,0
1481,279,164,317,296,3,13,2,38,132,5,75,0,0
1482,278,170,316,299,3,13,2,38,129,6,75,0,0
1483,281,167,319,301,3,13,2,38,134,7,75,0,0
1484,283,158,325,303,3,13,2,42,145,8,75,0,0
1485,286,162,328,306,3,13,2,42,144,9,75,0,0
1486,286,165,328,307,3,13,2,42,142,10,75,0,0
1487,282,166,325,310,3,13,2,43,144,11,75,0,0
1488,278,169,323,316,3,13,2,45,147,12,75,0,0
1489,276,170,323,321,3,13,2,47,151,13,75,0,0
1490,276,170,324,321,3,13,2,48,151,14,75,0,0
1491,274,172,324,326,3,13,2,50,154,15,75,0,0
1492,271,173,322,332,3,13,2,51,159,16,75,0,0
1493,267,175,318,333,3,13,2,51,158,17,75,0,0
1494,265,178,318,338,3,13,2,53,160,18,75,0,0
1495,264,182,317,341,3,13,2,53,159,19,75,0,0
1496,264,180,320,346,3,13,2,56,166,20,75,0,0
1497,265,181,323,353,3,13,2,58,172,21,75,0,0
1498,262,182,322,360,3,13,2,60,178,22,75,0,0
1499,259,180,321,364,3,13,2,62,184,23,75,0,0
1500,258,183,320,367,3,13,2,62,184,24,75,0,0
1501,259,184,321,371,3,13,2,62,187,25,75,0,0
1502,261,186,325,377,3,13,2,64,191,26,75,0,0
1503,262,192,327,383,3,13,2,65,191,27,75,0,0
1504,259,192,326,391,3,13,2,67,199,28,75,0,0
1505,258,193,325,396,3,13,2,67,203,29,75,0,0
1506,258,199,325,400,3,13,2,67,201,30,75,0,0
1507,262,201,329,406,3,13,2,67,205,31,75,0,0
1508,264,199,335,411,3,13,2,71,212,32,75,0,0
1509,266,203,337,416,3,13,2,71,213,33,75,0,0
1510,262,204,336,426,3,13,2,74,222,34,75,0,0
1511,259,204,334,430,3,13,2,75,226,35,75,0,0
1512,258,209,334,439,3,13,2,76,230,36,75,0,0
1513,261,211,338,447,3,13,2,77,236,37,75,0,0
1514,262,211,342,456,3,13,2,80,245,38,75,0,0
1515,261,217,342,464,3,13,2,81,247,39,75,0,0
1516,258,221,339,472,3,13,2,81,251,40,75,0,0
1517,257,222,341,482,3,13,2,84,260,41,75,0,0
1518,257,227,343,497,3,13,2,86,270,42,75,0,0
1519,259,229,347,505,3,13,2,88,276,43,75,0,0
1520,262,229,353,515,3,13,2,91,286,44,75,0,0
1521,262,234,357,533,3,13,2,95,299,45,75,0,0
1522,262,236,360,545,3,13,2,98,309,46,75,0,0
1523,264,237,367,557,3,13,2,103,320,47,75,0,0
1524,268,242,375,577,3,13,2,107,335,48,75,0,0
1525,273,242,383,586,3,13,2,110,344,49,75,0,0
1526,277,248,392,602,3,13,2,115,354,50,75,0,0
1527,279,259,398,623,3,13,2,119,364,51,75,0,0
1528,274,260,398,637,3,13,2,124,377,52,75,0,0
1529,275,268,403,656,3,13,2,128,388,53,75,0,0
1530,278,281,409,678,3,13,2,131,397,54,75,0,0
1531,279,283,418,696,3,13,2,139,413,55,75,0,0
1532,282,287,431,725,3,13,2,149,438,56,75,0,0
1533,287,299,442,758,3,13,2,155,459,57,75,0,0
1534,282,304,442,775,3,13,2,160,471,58,75,0,0
1535,283,318,451,803,3,13,2,168,485,59,75,0,0
1536,280,333,458,845,3,13,2,178,512,60,75,0,0
1537,287,342,470,856,3,13,2,183,514,61,75,0,0
1538,289,356,491,918,3,13,2,202,562,62,75,0,0
1539,285,375,499,965,3,13,2,214,590,63,75,0,0
1540,283,390,501,985,3,13,2,218,595,64,75,0,0
1541,293,415,528,1050,3,13,2,235,635,65,75,0,0
1542,300,439,537,1074,3,13,2,237,635,66,75,0,0
1543,324,454,567,1080,3,13,2,243,626,67,75,0,0
1544,344,491,585,1080,3,13,2,241,589,68,75,0,0
1545,348,526,587,1080,3,13,2,239,554,69,75,0,0
1546,344,572,577,1080,3,13,2,233,508,70,75,0,0
1547,363,639,581,1080,3,13,2,218,441,71,75,0,0
1548,429,707,630,1073,3,13,2,201,366,72,75,0,0
1549,513,784,696,1071,3,13,2,183,287,73,75,0,0
1550,562,921,676,1080,3,13,2,114,159,74,75,0,0
1551,603,981,681,1080,3,13,2,78,99,75,75,1,0
3261,1564,471,1692,835,5,13,2,128,364,0,3,0,0
3262,1567,469,1688,809,5,13,2,121,340,1,3,0,0
3263,1567,468,1687,807,5,13,2,120,339,2,3,0,0
3264,1567,467,1686,802,5,13,2,119,335,3,3,0,0
3638,305,130,340,269,6,13,2,35,139,0,83,0,0
3639,306,133,341,270,6,13,2,35,137,1,83,0,0
3644,311,136,348,281,6,13,2,37,145,0,83,0,1
3645,311,132,349,283,6,13,2,38,151,1,83,0,0
3646,311,141,347,282,6,13,2,36,141,2,83,0,0
3647,310,146,346,285,6,13,2,36,139,3,83,0,0
3648,309,144,346,285,6,13,2,37,141,4,83,0,0
3649,309,145,346,285,6,13,2,37,140,5,83,0,0
3650,307,142,347,293,6,13,2,40,151,6,83,0,0
3651,303,138,345,297,6,13,2,42,159,7,83,0,0
3652,300,139,342,298,6,13,2,42,159,8,83,0,0
3653,297,136,341,303,6,13,2,44,167,9,83,0,0
3654,296,132,342,305,6,13,2,46,173,10,83,0,0
3655,295,130,343,307,6,13,2,48,177,11,83,0,0
3656,299,140,344,308,6,13,2,45,168,12,83,0,0
3657,297,144,343,312,6,13,2,46,168,13,83,0,0
3658,295,136,345,319,6,13,2,50,183,14,83,0,0
3659,297,134,349,324,6,13,2,52,190,15,83,0,0
3660,301,136,352,323,6,13,2,51,187,16,83,0,0
3661,305,147,354,329,6,13,2,49,182,17,83,0,0
3662,308,155,354,330,6,13,2,46,175,18,83,0,0
3663,308,155,355,331,6,13,2,47,176,19,83,0,0
3664,308,157,356,337,6,13,2,48,180,20,83,0,0
3665,311,162,359,339,6,13,2,48,177,21,83,0,0
3666,314,165,363,344,6,13,2,49,179,22,83,0,0
3667,315,165,365,348,6,13,2,50,183,23,83,0,0
3668,316,165,366,351,6,13,2,50,186,24,83,0,0
3669,316,168,368,357,6,13,2,52,189,25,83,0,0
3670,317,173,369,362,6,13,2,52,189,26,83,0,0
3671,317,173,370,363,6,13,2,53,190,27,83,0,0
3672,317,175,373,369,6,13,2,56,194,28,83,0,0
3673,316,176,373,374,6,13,2,57,198,29,83,0,0
3674,314,176,373,378,6,13,2,59,202,30,83,0,0
3675,311,175,373,386,6,13,2,62,211,31,83,0,0
3676,311,175,375,393,6,13,2,64,218,32,83,0,0
3677,313,175,378,396,6,13,2,65,221,33,83,0,0
3678,313,174,378,400,6,13,2,65,226,34,83,0,0
3679,313,180,378,404,6,13,2,65,224,35,83,0,0
3680,311,181,377,407,6,13,2,66,226,36,83,0,0
3681,312,186,379,419,6,13,2,67,233,37,83,0,0
3682,315,192,381,424,6,13,2,66,232,38,83,0,0
3683,318,190,386,427,6,13,2,68,237,39,83,0,0
3684,320,190,391,435,6,13,2,71,245,40,83,0,0
3685,322,193,394,441,6,13,2,72,248,41,83,0,0
3686,322,195,396,449,6,13,2,74,254,42,83,0,0
3687,323,197,399,458,6,13,2,76,261,43,83,0,0
3688,327,202,404,464,6,13,2,77,262,44,83,0,0
3689,332,200,411,468,6,13,2,79,268,45,83,0,0
3690,332,204,414,480,6,13,2,82,276,46,83,0,0
3691,333,204,419,492,6,13,2,86,288,47,83,0,0
3692,334,203,423,497,6,13,2,89,294,48,83,0,0
3693,332,208,425,515,6,13,2,93,307,49,83,0,0
3694,335,210,431,525,6,13,2,96,315,50,83,0,0
3695,337,212,436,535,6,13,2,99,323,51,83,0,0
3696,336,221,437,549,6,13,2,101,328,52,83,0,0
3697,334,226,436,555,6,13,2,102,329,53,83,0,0
3698,333,229,439,568,6,13,2,106,339,54,83,0,0
3699,333,231,443,584,6,13,2,110,353,55,83,0,0
3700,337,231,453,597,6,13,2,116,366,56,83,0,0
3701,339,236,461,621,6,13,2,122,385,57,83,0,0
3702,339,246,465,645,6,13,2,126,399,58,83,0,0
3703,340,249,471,655,6,13,2,131,406,59,83,0,0
3704,344,256,478,672,6,13,2,134,416,60,83,0,0
3705,354,267,492,695,6,13,2,138,428,61,83,0,0
3706,369,267,513,709,6,13,2,144,442,62,83,0,0
3707,382,276,536,741,6,13,2,154,465,63,83,0,0
3708,394,285,555,768,6,13,2,161,483,64,83,0,0
3709,404,291,568,779,6,13,2,164,488,65,83,0,0
3710,415,302,586,810,6,13,2,171,508,66,83,0,0
3711,433,320,609,841,6,13,2,176,521,67,83,0,0
3712,448,321,640,881,6,13,2,192,560,68,83,0,0
3713,461,332,669,937,6,13,2,208,605,69,83,0,0
3714,477,349,689,958,6,13,2,212,609,70,83,0,0
3715,492,364,711,983,6,13,2,219,619,71,83,0,0
3716,517,390,743,1027,6,13,2,226,637,72,83,0,0
3717,548,401,782,1050,6,13,2,234,649,73,83,0,0
3718,589,426,829,1069,6,13,2,240,643,74,83,0,0
3719,631,456,872,1071,6,13,2,241,615,75,83,0,0
3720,658,484,897,1073,6,13,2,239,589,76,83,0,0
3721,684,518,917,1075,6,13,2,233,557,77,83,0,0
3722,743,562,970,1080,6,13,2,227,518,78,83,0,0
3723,821,594,1051,1080,6,13,2,230,486,79,83,0,0
3724,918,651,1146,1079,6,13,2,228,428,80,83,0,0
3725,1008,735,1213,1075,6,13,2,205,340,81,83,0,0
3726,1150,814,1336,1072,6,13,2,186,258,82,83,0,0
3727,1225,857,1385,1080,6,13,2,160,223,83,83,1,0
3971,1577,477,1697,813,8,13,2,120,336,0,3,0,0
3972,1575,473,1698,818,8,13,2,123,345,1,3,0,0
3973,1576,475,1698,816,8,13,2,122,341,2,3,0,0
3974,1577,475,1698,815,8,13,2,121,340,3,3,0,0
4601,554,600,799,1076,10,13,2,245,476,0,83,0,1
4602,538,585,791,1076,10,13,2,253,491,1,83,0,0
4603,509,558,773,1075,10,13,2,264,517,2,83,0,0
4604,477,527,756,1077,10,13,2,279,550,3,83,0,0
4605,467,510,748,1071,10,13,2,281,561,4,83,0,0
4606,467,489,751,1066,10,13,2,284,577,5,83,0,0
4607,468,459,746,1035,10,13,2,278,576,6,83,0,0
4608,464,452,730,1016,10,13,2,266,564,7,83,0,0
4609,445,432,699,983,10,13,2,254,551,8,83,0,0
4610,419,412,669,968,10,13,2,250,556,9,83,0,0
4611,407,399,649,956,10,13,2,242,557,10,83,0,0
4612,407,385,629,910,10,13,2,222,525,11,83,0,0
4613,406,378,612,878,10,13,2,206,500,12,83,0,0
4614,395,372,594,865,10,13,2,199,493,13,83,0,0
4615,377,358,566,839,10,13,2,189,481,14,83,0,0
4616,370,349,554,821,10,13,2,184,472,15,83,0,0
4617,367,339,547,808,10,13,2,180,469,16,83,0,0
4618,374,326,543,773,10,13,2,169,447,17,83,0,0
4619,376,323,538,753,10,13,2,162,430,18,83,0,0
4620,367,314,524,737,10,13,2,157,423,19,83,0,0
4621,368,307,523,724,10,13,2,155,417,20,83,0,0
4622,376,299,527,712,10,13,2,151,413,21,83,0,0
4623,392,290,537,695,10,13,2,145,405,22,83,0,0
4624,407,291,545,690,10,13,2,138,399,23,83,0,0
4625,422,290,553,682,10,13,2,131,392,24,83,0,0
4626,435,289,557,664,10,13,2,122,375,25,83,0,0
4627,454,290,570,648,10,13,2,116,358,26,83,0,0
4628,467,284,580,637,10,13,2,113,353,27,83,0,0
4629,477,276,587,622,10,13,2,110,346,28,83,0,0
4630,488,270,599,619,10,13,2,111,349,29,83,0,0
4631,489,268,597,610,10,13,2,108,342,30,83,0,0
4632,485,265,591,597,10,13,2,106,332,31,83,0,0
4633,484,262,587,589,10,13,2,103,327,32,83,0,0
4634,485,258,583,575,10,13,2,98,317,33,83,0,0
4635,482,255,578,565,10,13,2,96,310,34,83,0,0
4636,476,253,572,557,10,13,2,96,304,35,83,0,0
4637,458,246,553,547,10,13,2,95,301,36,83,0,0
4638,436,244,528,539,10,13,2,92,295,37,83,0,0
4639,427,245,515,529,10,13,2,88,284,38,83,0,0
4640,418,243,501,510,10,13,2,83,267,39,83,0,0
4641,404,244,486,506,10,13,2,82,262,40,83,0,0
4642,390,237,474,501,10,13,2,84,264,41,83,0,0
4643,378,232,461,493,10,13,2,83,261,42,83,0,0
4644,369,226,454,492,10,13,2,85,266,43,83,0,0
4645,365,225,446,479,10,13,2,81,254,44,83,0,0
4646,358,223,436,471,10,13,2,78,248,45,83,0,0
4647,349,224,427,468,10,13,2,78,244,46,83,0,0
4648,339,224,414,463,10,13,2,75,239,47,83,0,0
4649,334,221,407,458,10,13,2,73,237,48,83,0,0
4650,329,220,402,456,10,13,2,73,236,49,83,0,0
4651,327,219,396,443,10,13,2,69,224,50,83,0,0
4652,323,217,390,438,10,13,2,67,221,51,83,0,0
4653,316,217,381,434,10,13,2,65,217,52,83,0,0
4654,310,217,372,427,10,13,2,62,210,53,83,0,0
4655,307,211,369,426,10,13,2,62,215,54,83,0,0
4656,307,209,365,412,10,13,2,58,203,55,83,0,0
4657,305,206,362,408,10,13,2,57,202,56,83,0,0
4658,302,206,357,402,10,13,2,55,196,57,83,0,0
4659,296,204,350,398,10,13,2,54,194,58,83,0,0
4660,293,203,346,397,10,13,2,53,194,59,83,0,0
4661,292,203,345,395,10,13,2,53,192,60,83,0,0
4662,294,200,345,388,10,13,2,51,188,61,83,0,0
4663,294,199,344,382,10,13,2,50,183,62,83,0,0
4664,291,197,341,381,10,13,2,50,184,63,83,0,0
4665,289,197,339,377,10,13,2,50,180,64,83,0,0
4666,291,197,339,372,10,13,2,48,175,65,83,0,0
4667,296,196,342,365,10,13,2,46,169,66,83,0,0
4668,297,191,343,362,10,13,2,46,171,67,83,0,0
4669,298,192,343,359,10,13,2,45,167,68,83,0,0
4670,297,187,342,357,10,13,2,45,170,69,83,0,0
4671,295,183,340,353,10,13,2,45,170,70,83,0,0
4672,297,185,341,352,10,13,2,44,167,71,83,0,0
4673,300,185,342,346,10,13,2,42,161,72,83,0,0
4674,301,184,343,342,10,13,2,42,158,73,83,0,0
4675,300,183,342,342,10,13,2,42,159,74,83,0,0
4676,301,182,342,340,10,13,2,41,158,75,83,0,0
4677,303,182,343,335,10,13,2,40,153,76,83,0,0
4678,308,182,347,331,10,13,2,39,149,77,83,0,0
4679,312,180,351,331,10,13,2,39,151,78,83,0,0
4680,314,180,353,329,10,13,2,39,149,79,83,0,0
4681,315,180,352,324,10,13,2,37,144,80,83,0,0
4682,317,183,353,320,10,13,2,36,137,81,83,0,0
4683,320,180,356,318,10,13,2,36,138,82,83,0,0
4684,325,182,360,315,10,13,2,35,133,83,83,1,0
4686,327,181,362,315,10,13,2,35,134,0,83,0,0
4687,325,175,360,310,10,13,2,35,135,1,83,0,0
5168,323,123,358,206,16,13,2,35,83,0,85,0,0
5169,323,123,358,207,16,13,2,35,84,1,85,0,0
5170,322,122,358,208,16,13,2,36,86,2,85,0,0
5171,321,124,356,207,16,13,2,35,83,3,85,0,0
5172,320,124,355,207,16,13,2,35,83,4,85,0,0
5173,320,124,355,209,16,13,2,35,85,5,85,0,0
5174,319,125,355,210,16,13,2,36,85,6,85,0,0
5175,318,123,353,210,16,13,2,35,87,7,85,0,0
5176,314,121,349,213,16,13,2,35,92,8,85,0,0
5207,314,131,351,254,16,13,2,37,123,0,85,0,1
5208,314,134,350,254,16,13,2,36,120,1,85,0,0
5209,312,135,348,255,16,13,2,36,120,2,85,0,0
5210,312,135,349,260,16,13,2,37,125,3,85,0,0
5211,312,140,348,262,16,13,2,36,122,4,85,0,0
5212,312,139,348,262,16,13,2,36,123,5,85,0,0
5213,312,138,349,263,16,13,2,37,125,6,85,0,0
5214,313,140,349,266,16,13,2,36,126,7,85,0,0
5215,313,141,349,267,16,13,2,36,126,8,85,0,0
5216,314,146,350,271,16,13,2,36,125,9,85,0,0
5217,316,149,352,273,16,13,2,36,124,10,85,0,0
5218,317,151,352,275,16,13,2,35,124,11,85,0,0
5219,316,154,351,277,16,13,2,35,123,12,85,0,0
5220,314,146,352,279,16,13,2,38,133,13,85,0,0
5221,314,148,352,283,16,13,2,38,135,14,85,0,0
5222,314,149,353,287,16,13,2,39,138,15,85,0,0
5223,314,152,352,287,16,13,2,38,135,16,85,0,0
5224,312,161,348,289,16,13,2,36,128,17,85,0,0
5225,309,164,346,294,16,13,2,37,130,18,85,0,0
5226,304,158,343,296,16,13,2,39,138,19,85,0,0
5227,301,159,341,300,16,13,2,40,141,20,85,0,0
5228,299,165,340,303,16,13,2,41,138,21,85,0,0
5229,298,164,340,305,16,13,2,42,141,22,85,0,0
5230,297,164,340,309,16,13,2,43,145,23,85,0,0
5231,296,165,341,314,16,13,2,45,149,24,85,0,0
5232,293,165,338,314,16,13,2,45,149,25,85,0,0
5233,292,164,340,320,16,13,2,48,156,26,85,0,0
5234,293,165,342,324,16,13,2,49,159,27,85,0,0
5235,297,164,347,326,16,13,2,50,162,28,85,0,0
5236,302,170,351,330,16,13,2,49,160,29,85,0,0
5237,303,175,353,335,16,13,2,50,160,30,85,0,0
5238,304,171,355,336,16,13,2,51,165,31,85,0,0
5239,304,174,357,345,16,13,2,53,171,32,85,0,0
5240,306,175,361,353,16,13,2,55,178,33,85,0,0
5241,310,178,365,356,16,13,2,55,178,34,85,0,0
5242,311,185,365,360,16,13,2,54,175,35,85,0,0
5243,310,181,367,366,16,13,2,57,185,36,85,0,0
5244,310,179,369,369,16,13,2,59,190,37,85,0,0
5245,313,180,374,378,16,13,2,61,198,38,85,0,0
5246,317,182,380,382,16,13,2,63,200,39,85,0,0
5247,320,181,386,385,16,13,2,66,204,40,85,0,0
5248,323,187,389,393,16,13,2,66,206,41,85,0,0
5249,322,192,389,401,16,13,2,67,209,42,85,0,0
5250,321,186,391,404,16,13,2,70,218,43,85,0,0
5251,323,192,396,412,16,13,2,73,220,44,85,0,0
5252,321,194,397,421,16,13,2,76,227,45,85,0,0
5253,323,195,401,430,16,13,2,78,235,46,85,0,0
5254,328,200,408,439,16,13,2,80,239,47,85,0,0
5255,327,200,409,444,16,13,2,82,244,48,85,0,0
5256,328,201,413,454,16,13,2,85,253,49,85,0,0
5257,335,207,423,466,16,13,2,88,259,50,85,0,0
5258,343,203,436,476,16,13,2,93,273,51,85,0,0
5259,354,207,448,483,16,13,2,94,276,52,85,0,0
5260,362,212,459,490,16,13,2,97,278,53,85,0,0
5261,368,213,470,502,16,13,2,102,289,54,85,0,0
5262,377,215,483,516,16,13,2,106,301,55,85,0,0
5263,387,220,495,526,16,13,2,108,306,56,85,0,0
5264,396,222,506,532,16,13,2,110,310,57,85,0,0
5265,400,229,517,560,16,13,2,117,331,58,85,0,0
5266,402,236,524,582,16,13,2,122,346,59,85,0,0
5267,407,239,531,590,16,13,2,124,351,60,85,0,0
5268,412,247,538,606,16,13,2,126,359,61,85,0,0
5269,421,253,548,617,16,13,2,127,364,62,85,0,0
5270,429,259,561,636,16,13,2,132,377,63,85,0,0
5271,434,268,574,666,16,13,2,140,398,64,85,0,0
5272,433,281,580,700,16,13,2,147,419,65,85,0,0
5273,433,286,582,712,16,13,2,149,426,66,85,0,0
5274,429,291,584,734,16,13,2,155,443,67,85,0,0
5275,429,306,592,767,16,13,2,163,461,68,85,0,0
5276,436,312,606,790,16,13,2,170,478,69,85,0,0
5277,437,326,623,848,16,13,2,186,522,70,85,0,0
5278,440,342,636,893,16,13,2,196,551,71,85,0,0
5279,429,347,633,919,16,13,2,204,572,72,85,0,0
5280,403,361,627,991,16,13,2,224,630,73,85,0,0
5281,397,382,630,1039,16,13,2,233,657,74,85,0,0
5282,403,399,638,1050,16,13,2,235,651,75,85,0,0
5283,399,421,637,1071,16,13,2,238,650,76,85,0,0
5284,376,448,611,1080,16,13,2,235,632,77,85,0,0
5285,333,466,570,1080,16,13,2,237,614,78,85,0,0
5286,292,492,528,1080,16,13,2,236,588,79,85,0,0
5287,257,534,486,1073,16,13,2,229,539,80,85,0,0
5288,228,576,452,1077,16,13,2,224,501,81,85,0,0
5289,178,615,397,1079,16,13,2,219,464,82,85,0,0
5290,120,672,323,1078,16,13,2,203,406,83,85,0,0
5291,61,740,242,1080,16,13,2,181,340,84,85,0,0
5292,35,774,204,1080,16,13,2,169,306,85,85,1,0
5714,347,167,382,300,17,13,2,35,133,0,82,0,1
5715,348,166,384,303,17,13,2,36,137,1,82,0,0
5716,350,169,387,306,17,13,2,37,137,2,82,0,0
5717,350,168,388,308,17,13,2,38,140,3,82,0,0
5718,351,165,390,313,17,13,2,39,148,4,82,0,0
5719,352,165,393,317,17,13,2,41,152,5,82,0,0
5720,352,165,394,318,17,13,2,42,153,6,82,0,0
5721,353,167,396,323,17,13,2,43,156,7,82,0,0
5722,354,167,397,326,17,13,2,43,159,8,82,0,0
5723,352,162,398,329,17,13,2,46,167,9,82,0,0
5724,353,166,400,334,17,13,2,47,168,10,82,0,0
5725,356,170,401,334,17,13,2,45,164,11,82,0,0
5726,357,173,403,337,17,13,2,46,164,12,82,0,0
5727,358,176,404,341,17,13,2,46,165,13,82,0,0
5728,359,179,405,344,17,13,2,46,165,14,82,0,0
5729,359,181,406,351,17,13,2,47,170,15,82,0,0
5730,359,181,409,358,17,13,2,50,177,16,82,0,0
5731,359,178,411,362,17,13,2,52,184,17,82,0,0
5732,360,179,413,367,17,13,2,53,188,18,82,0,0
5733,361,184,414,369,17,13,2,53,185,19,82,0,0
5734,361,187,415,372,17,13,2,54,185,20,82,0,0
5735,362,188,417,380,17,13,2,55,192,21,82,0,0
5736,365,193,420,385,17,13,2,55,192,22,82,0,0
5737,368,193,425,390,17,13,2,57,197,23,82,0,0
5738,370,197,428,398,17,13,2,58,201,24,82,0,0
5739,371,201,430,402,17,13,2,59,201,25,82,0,0
5740,372,202,432,406,17,13,2,60,204,26,82,0,0
5741,376,202,438,414,17,13,2,62,212,27,82,0,0
5742,379,200,443,418,17,13,2,64,218,28,82,0,0
5743,381,201,448,424,17,13,2,67,223,29,82,0,0
5744,382,206,449,430,17,13,2,67,224,30,82,0,0
5745,380,208,449,437,17,13,2,69,229,31,82,0,0
5746,382,209,453,442,17,13,2,71,233,32,82,0,0
5747,386,213,459,452,17,13,2,73,239,33,82,0,0
5748,390,214,464,456,17,13,2,74,242,34,82,0,0
5749,391,220,467,467,17,13,2,76,247,35,82,0,0
5750,391,222,469,473,17,13,2,78,251,36,82,0,0
5751,392,223,472,479,17,13,2,80,256,37,82,0,0
5752,395,228,476,490,17,13,2,81,262,38,82,0,0
5753,397,230,482,506,17,13,2,85,276,39,82,0,0
5754,400,230,487,513,17,13,2,87,283,40,82,0,0
5755,402,236,493,531,17,13,2,91,295,41,82,0,0
5756,401,240,497,549,17,13,2,96,309,42,82,0,0
5757,404,242,499,549,17,13,2,95,307,43,82,0,0
5758,404,247,504,569,17,13,2,100,322,44,82,0,0
5759,407,254,511,587,17,13,2,104,333,45,82,0,0
5760,409,261,516,607,17,13,2,107,346,46,82,0,0
5761,411,273,521,624,17,13,2,110,351,47,82,0,0
5762,411,277,524,637,17,13,2,113,360,48,82,0,0
5763,412,278,531,656,17,13,2,119,378,49,82,0,0
5764,416,287,539,679,17,13,2,123,392,50,82,0,0
5765,421,290,546,692,17,13,2,125,402,51,82,0,0
5766,419,295,554,731,17,13,2,135,436,52,82,0,0
5767,420,306,558,755,17,13,2,138,449,53,82,0,0
5768,422,311,564,769,17,13,2,142,458,54,82,0,0
5769,421,324,567,793,17,13,2,146,469,55,82,0,0
5770,424,333,578,831,17,13,2,154,498,56,82,0,0
5771,429,342,586,851,17,13,2,157,509,57,82,0,0
5772,424,369,590,905,17,13,2,166,536,58,82,0,0
5773,421,386,591,932,17,13,2,170,546,59,82,0,0
5774,420,398,597,959,17,13,2,177,561,60,82,0,0
5775,411,412,606,1033,17,13,2,195,621,61,82,0,0
5776,410,435,606,1061,17,13,2,196,626,62,82,0,0
5777,405,451,604,1079,17,13,2,199,628,63,82,0,0
5778,390,481,587,1080,17,13,2,197,599,64,82,0,0
5779,337,492,541,1080,17,13,2,204,588,65,82,0,0
5780,306,512,514,1080,17,13,2,208,568,66,82,0,0
5781,267,521,484,1080,17,13,2,217,559,67,82,0,0
5782,225,531,447,1080,17,13,2,222,549,68,82,0,0
5783,185,534,416,1076,17,13,2,231,542,69,82,0,0
5784,166,559,385,1040,17,13,2,219,481,70,82,0,0
5785,125,568,355,1057,17,13,2,230,489,71,82,0,0
5786,112,590,341,1064,17,13,2,229,474,72,82,0,0
5787,121,616,351,1072,17,13,2,230,456,73,82,0,0
5788,147,638,376,1076,17,13,2,229,438,74,82,0,0
5789,190,654,419,1075,17,13,2,229,421,75,82,0,0
5790,222,674,449,1070,17,13,2,227,396,76,82,0,0
5791,263,720,480,1078,17,13,2,217,358,77,82,0,0
5792,287,767,489,1076,17,13,2,202,309,78,82,0,0
5793,298,828,482,1077,17,13,2,184,249,79,82,0,0
5794,265,872,427,1080,17,13,2,162,208,80,82,0,0
5795,259,921,389,1080,17,13,2,130,159,81,82,0,0
5796,286,958,395,1080,17,13,2,109,122,82,82,1,0
5697,297,154,333,264,18,13,2,36,110,0,85,0,1
5698,296,153,333,266,18,13,2,37,113,1,85,0,0
5699,294,153,333,270,18,13,2,39,117,2,85,0,0
5700,294,153,334,272,18,13,2,40,119,3,85,0,0
5701,296,154,336,272,18,13,2,40,118,4,85,0,0
5702,295,153,336,274,18,13,2,41,121,5,85,0,0
5703,294,153,336,276,18,13,2,42,123,6,85,0,0
5704,292,153,335,280,18,13,2,43,127,7,85,0,0
5705,290,154,333,282,18,13,2,43,128,8,85,0,0
5706,290,155,334,284,18,13,2,44,129,9,85,0,0
5707,291,156,334,283,18,13,2,43,127,10,85,0,0
5708,291,155,337,290,18,13,2,46,135,11,85,0,0
5709,290,160,336,295,18,13,2,46,135,12,85,0,0
5710,292,157,338,297,18,13,2,46,140,13,85,0,0
5711,292,159,338,297,18,13,2,46,138,14,85,0,0
5712,294,163,339,299,18,13,2,45,136,15,85,0,0
5713,298,164,343,300,18,13,2,45,136,16,85,0,0
5714,300,167,345,300,18,13,2,45,133,17,85,0,0
5715,299,170,345,304,18,13,2,46,134,18,85,0,0
5716,298,168,345,307,18,13,2,47,139,19,85,0,0
5717,299,171,346,311,18,13,2,47,140,20,85,0,0
5718,299,172,346,314,18,13,2,47,142,21,85,0,0
5719,299,171,347,315,18,13,2,48,144,22,85,0,0
5720,298,169,348,320,18,13,2,50,151,23,85,0,0
5721,297,170,347,324,18,13,2,50,154,24,85,0,0
5722,295,167,347,327,18,13,2,52,160,25,85,0,0
5723,294,167,347,333,18,13,2,53,166,26,85,0,0
5724,294,171,346,335,18,13,2,52,164,27,85,0,0
5725,293,166,346,335,18,13,2,53,169,28,85,0,0
5726,292,176,344,342,18,13,2,52,166,29,85,0,0
5727,289,169,344,349,18,13,2,55,180,30,85,0,0
5728,287,172,343,352,18,13,2,56,180,31,85,0,0
5729,285,172,342,355,18,13,2,57,183,32,85,0,0
5730,287,175,344,361,18,13,2,57,186,33,85,0,0
5731,289,176,345,362,18,13,2,56,186,34,85,0,0
5732,289,177,347,368,18,13,2,58,191,35,85,0,0
5733,291,185,348,372,18,13,2,57,187,36,85,0,0
5734,289,184,347,374,18,13,2,58,190,37,85,0,0
5735,289,188,348,381,18,13,2,59,193,38,85,0,0
5736,292,197,350,386,18,13,2,58,189,39,85,0,0
5737,295,200,354,392,18,13,2,59,192,40,85,0,0
5738,297,200,358,398,18,13,2,61,198,41,85,0,0
5739,297,203,359,404,18,13,2,62,201,42,85,0,0
5740,295,203,360,408,18,13,2,65,205,43,85,0,0
5741,294,201,362,415,18,13,2,68,214,44,85,0,0
5742,295,200,365,422,18,13,2,70,222,45,85,0,0
5743,297,202,368,426,18,13,2,71,224,46,85,0,0
5744,295,202,369,431,18,13,2,74,229,47,85,0,0
5745,297,208,373,442,18,13,2,76,234,48,85,0,0
5746,296,210,375,452,18,13,2,79,242,49,85,0,0
5747,294,210,376,458,18,13,2,82,248,50,85,0,0
5748,296,216,378,463,18,13,2,82,247,51,85,0,0
5749,301,220,384,471,18,13,2,83,251,52,85,0,0
5750,303,220,389,483,18,13,2,86,263,53,85,0,0
5751,303,225,392,497,18,13,2,89,272,54,85,0,0
5752,299,228,392,508,18,13,2,93,280,55,85,0,0
5753,293,228,391,522,18,13,2,98,294,56,85,0,0
5754,292,233,392,528,18,13,2,100,295,57,85,0,0
5755,294,238,396,541,18,13,2,102,303,58,85,0,0
5756,294,240,400,556,18,13,2,106,316,59,85,0,0
5757,291,246,403,574,18,13,2,112,328,60,85,0,0
5758,287,250,403,591,18,13,2,116,341,61,85,0,0
5759,283,251,401,598,18,13,2,118,347,62,85,0,0
5760,282,261,402,611,18,13,2,120,350,63,85,0,0
5761,285,270,404,618,18,13,2,119,348,64,85,0,0
5762,287,274,410,636,18,13,2,123,362,65,85,0,0
5763,286,284,416,667,18,13,2,130,383,66,85,0,0
5764,279,292,417,694,18,13,2,138,402,67,85,0,0
5765,275,292,419,712,18,13,2,144,420,68,85,0,0
5766,276,299,425,729,18,13,2,149,430,69,85,0,0
5767,276,307,431,758,18,13,2,155,451,70,85,0,0
5768,286,315,441,768,18,13,2,155,453,71,85,0,0
5769,282,320,448,809,18,13,2,166,489,72,85,0,0
5770,284,340,453,838,18,13,2,169,498,73,85,0,0
5771,281,343,455,859,18,13,2,174,516,74,85,0,0
5772,280,352,453,864,18,13,2,173,512,75,85,0,0
5773,274,367,459,915,18,13,2,185,548,76,85,0,0
5774,267,380,456,938,18,13,2,189,558,77,85,0,0
5775,263,390,453,956,18,13,2,190,566,78,85,0,0
5776,252,400,456,1011,18,13,2,204,611,79,85,0,0
5777,239,420,443,1036,18,13,2,204,616,80,85,0,0
5778,223,436,425,1046,18,13,2,202,610,81,85,0,0
5779,192,452,362,965,18,13,2,170,513,82,85,0,0
5780,166,474,320,945,18,13,2,154,471,83,85,0,0
5781,166,492,316,943,18,13,2,150,451,84,85,0,0
5782,158,504,307,951,18,13,2,149,447,85,85,1,0
5824,315,127,351,248,19,13,2,36,121,0,98,0,1
5825,318,129,355,249,19,13,2,37,120,1,98,0,0
5826,320,132,356,252,19,13,2,36,120,2,98,0,0
5827,320,138,355,252,19,13,2,35,114,3,98,0,0
5828,321,137,357,252,19,13,2,36,115,4,98,0,0
5829,322,137,358,254,19,13,2,36,117,5,98,0,0
5830,324,135,361,254,19,13,2,37,119,6,98,0,0
5831,326,130,364,254,19,13,2,38,124,7,98,0,0
5832,326,133,365,258,19,13,2,39,125,8,98,0,0
5833,327,138,365,258,19,13,2,38,120,9,98,0,0
5834,327,138,365,259,19,13,2,38,121,10,98,0,0
5835,326,132,367,263,19,13,2,41,131,11,98,0,0
5836,329,139,368,264,19,13,2,39,125,12,98,0,0
5837,331,145,369,265,19,13,2,38,120,13,98,0,0
5838,331,142,370,269,19,13,2,39,127,14,98,0,0
5839,331,142,371,269,19,13,2,40,127,15,98,0,0
5840,332,144,372,270,19,13,2,40,126,16,98,0,0
5841,333,145,374,274,19,13,2,41,129,17,98,0,0
5842,336,145,378,276,19,13,2,42,131,18,98,0,0
5843,336,145,378,278,19,13,2,42,133,19,98,0,0
5844,335,141,380,282,19,13,2,45,141,20,98,0,0
5845,334,141,378,278,19,13,2,44,137,21,98,0,0
5846,337,143,381,282,19,13,2,44,139,22,98,0,0
5847,340,143,384,285,19,13,2,44,142,23,98,0,0
5848,340,145,385,287,19,13,2,45,142,24,98,0,0
5849,341,145,387,289,19,13,2,46,144,25,98,0,0
5850,341,147,387,292,19,13,2,46,145,26,98,0,0
5851,339,144,385,290,19,13,2,46,146,27,98,0,0
5852,339,147,385,294,19,13,2,46,147,28,98,0,0
5853,342,153,386,296,19,13,2,44,143,29,98,0,0
5854,343,149,389,298,19,13,2,46,149,30,98,0,0
5855,344,153,390,302,19,13,2,46,149,31,98,0,0
5856,347,163,391,307,19,13,2,44,144,32,98,0,0
5857,347,164,391,308,19,13,2,44,144,33,98,0,0
5858,345,161,393,316,19,13,2,48,155,34,98,0,0
5859,346,160,396,321,19,13,2,50,161,35,98,0,0
5860,348,158,398,323,19,13,2,50,165,36,98,0,0
5861,349,161,400,327,19,13,2,51,166,37,98,0,0
5862,350,161,402,331,19,13,2,52,170,38,98,0,0
5863,352,162,403,328,19,13,2,51,166,39,98,0,0
5864,357,166,409,334,19,13,2,52,168,40,98,0,0
5865,363,169,414,337,19,13,2,51,168,41,98,0,0
5866,370,170,422,338,19,13,2,52,168,42,98,0,0
5867,375,173,430,345,19,13,2,55,172,43,98,0,0
5868,378,174,433,350,19,13,2,55,176,44,98,0,0
5869,379,172,435,350,19,13,2,56,178,45,98,0,0
5870,381,173,439,358,19,13,2,58,185,46,98,0,0
5871,385,175,444,362,19,13,2,59,187,47,98,0,0
5872,389,176,449,362,19,13,2,60,186,48,98,0,0
5873,391,179,452,373,19,13,2,61,194,49,98,0,0
5874,391,182,452,377,19,13,2,61,195,50,98,0,0
5875,394,184,456,381,19,13,2,62,197,51,98,0,0
5876,397,184,461,388,19,13,2,64,204,52,98,0,0
5877,400,180,467,389,19,13,2,67,209,53,98,0,0
5878,403,179,471,393,19,13,2,68,214,54,98,0,0
5879,403,186,472,398,19,13,2,69,212,55,98,0,0
5880,404,188,471,395,19,13,2,67,207,56,98,0,0
5881,405,191,475,406,19,13,2,70,215,57,98,0,0
5882,409,194,481,417,19,13,2,72,223,58,98,0,0
5883,417,198,490,422,19,13,2,73,224,59,98,0,0
5884,424,198,498,427,19,13,2,74,229,60,98,0,0
5885,425,199,500,432,19,13,2,75,233,61,98,0,0
5886,425,200,504,440,19,13,2,79,240,62,98,0,0
5887,424,200,508,458,19,13,2,84,258,63,98,0,0
5888,431,203,515,461,19,13,2,84,258,64,98,0,0
5889,439,207,523,466,19,13,2,84,259,65,98,0,0
5890,443,212,528,473,19,13,2,85,261,66,98,0,0
5891,444,217,531,482,19,13,2,87,265,67,98,0,0
5892,443,218,534,493,19,13,2,91,275,68,98,0,0
5893,442,225,536,514,19,13,2,94,289,69,98,0,0
5894,443,229,539,521,19,13,2,96,292,70,98,0,0
5895,443,230,541,529,19,13,2,98,299,71,98,0,0
5896,440,238,542,548,19,13,2,102,310,72,98,0,0
5897,437,240,545,570,19,13,2,108,330,73,98,0,0
5898,435,241,547,580,19,13,2,112,339,74,98,0,0
5899,435,251,549,598,19,13,2,114,347,75,98,0,0
5900,438,255,555,607,19,13,2,117,352,76,98,0,0
5901,442,262,561,618,19,13,2,119,356,77,98,0,0
5902,439,275,564,651,19,13,2,125,376,78,98,0,0
5903,437,280,566,669,19,13,2,129,389,79,98,0,0
5904,434,285,568,686,19,13,2,134,401,80,98,0,0
5905,434,292,576,717,19,13,2,142,425,81,98,0,0
5906,440,297,586,733,19,13,2,146,436,82,98,0,0
5907,442,313,597,770,19,13,2,155,457,83,98,0,0
5908,436,328,599,810,19,13,2,163,482,84,98,0,0
5909,426,331,595,827,19,13,2,169,496,85,98,0,0
5910,411,342,591,864,19,13,2,180,522,86,98,0,0
5911,404,353,594,905,19,13,2,190,552,87,98,0,0
5912,399,360,595,921,19,13,2,196,561,88,98,0,0
5913,388,381,598,979,19,13,2,210,598,89,98,0,0
5914,365,398,586,1024,19,13,2,221,626,90,98,0,0
5915,316,411,541,1047,19,13,2,225,636,91,98,0,0
5916,264,433,494,1072,19,13,2,230,639,92,98,0,0
5917,231,458,458,1075,19,13,2,227,617,93,98,0,0
5918,192,480,415,1080,19,13,2,223,600,94,98,0,0
5919,158,521,372,1080,19,13,2,214,559,95,98,0,0
5920,81,559,285,1080,19,13,2,204,521,96,98,0,0
5921,48,594,247,1080,19,13,2,199,486,97,98,0,0
5922,24,614,221,1080,19,13,2,197,466,98,98,1,0
5786,0,806,179,1080,20,13,2,179,274,0,1,0,0
5787,11,853,160,1080,20,13,2,149,227,1,1,0,0
1156,463,154,507,276,1,13,3,44,122,0,35,0,1
1157,450,150,497,279,1,13,3,47,129,1,35,0,0
1158,433,152,482,285,1,13,3,49,133,2,35,0,0
1159,423,152,472,285,1,13,3,49,133,3,35,0,0
1160,412,153,462,288,1,13,3,50,135,4,35,0,0
1161,400,153,451,293,1,13,3,51,140,5,35,0,0
1162,390,156,444,302,1,13,3,54,146,6,35,0,0
1163,386,159,440,305,1,13,3,54,146,7,35,0,0
1164,385,159,440,307,1,13,3,55,148,8,35,0,0
1165,384,164,439,311,1,13,3,55,147,9,35,0,0
1166,383,163,439,315,1,13,3,56,152,10,35,0,0
1167,385,166,443,323,1,13,3,58,157,11,35,0,0
1168,387,166,446,327,1,13,3,59,161,12,35,0,0
1169,389,169,451,336,1,13,3,62,167,13,35,0,0
1170,391,170,455,344,1,13,3,64,174,14,35,0,0
1171,397,172,460,343,1,13,3,63,171,15,35,0,0
1172,405,174,469,350,1,13,3,64,176,16,35,0,0
1173,412,175,477,354,1,13,3,65,179,17,35,0,0
1174,417,176,484,361,1,13,3,67,185,18,35,0,0
1175,420,177,490,369,1,13,3,70,192,19,35,0,0
1176,434,179,503,371,1,13,3,69,192,20,35,0,0
1177,443,181,515,378,1,13,3,72,197,21,35,0,0
1178,457,181,531,384,1,13,3,74,203,22,35,0,0
1179,470,187,544,391,1,13,3,74,204,23,35,0,0
1180,490,188,565,396,1,13,3,75,208,24,35,0,0
1181,509,188,588,406,1,13,3,79,218,25,35,0,0
1182,529,191,611,411,1,13,3,82,220,26,35,0,0
1183,560,193,642,416,1,13,3,82,223,27,35,0,0
1184,585,196,669,422,1,13,3,84,226,28,35,0,0
1185,621,197,704,425,1,13,3,83,228,29,35,0,0
1186,656,207,741,429,1,13,3,85,222,30,35,0,0
1187,695,203,783,431,1,13,3,88,228,31,35,0,0
1188,734,208,823,436,1,13,3,89,228,32,35,0,0
1189,765,214,856,441,1,13,3,91,227,33,35,0,0
1190,800,227,883,444,1,13,3,83,217,34,35,0,0
1191,823,230,906,449,1,13,3,83,219,35,35,1,0
2309,803,204,871,430,2,13,3,68,226,0,126,0,1
2310,782,198,854,437,2,13,3,72,239,1,126,0,0
2311,769,203,839,433,2,13,3,70,230,2,126,0,0
2312,730,203,801,429,2,13,3,71,226,3,126,0,0
2313,700,200,770,423,2,13,3,70,223,4,126,0,0
2314,659,198,730,422,2,13,3,71,224,5,126,0,0
2315,624,201,695,420,2,13,3,71,219,6,126,0,0
2316,596,194,668,418,2,13,3,72,224,7,126,0,0
2317,564,197,635,410,2,13,3,71,213,8,126,0,0
2318,539,191,609,402,2,13,3,70,211,9,126,0,0
2319,507,188,578,399,2,13,3,71,211,10,126,0,0
2320,488,184,559,396,2,13,3,71,212,11,126,0,0
2321,472,180,543,389,2,13,3,71,209,12,126,0,0
2322,459,179,528,382,2,13,3,69,203,13,126,0,0
2323,446,176,514,373,2,13,3,68,197,14,126,0,0
2324,430,178,497,369,2,13,3,67,191,15,126,0,0
2325,420,176,485,365,2,13,3,65,189,16,126,0,0
2326,414,175,480,364,2,13,3,66,189,17,126,0,0
2327,411,174,475,358,2,13,3,64,184,18,126,0,0
2328,404,170,466,349,2,13,3,62,179,19,126,0,0
2329,396,171,456,344,2,13,3,60,173,20,126,0,0
2330,392,169,450,338,2,13,3,58,169,21,126,0,0
2331,389,166,446,333,2,13,3,57,167,22,126,0,0
2332,389,164,446,330,2,13,3,57,166,23,126,0,0
2333,385,163,440,323,2,13,3,55,160,24,126,0,0
2334,381,165,434,318,2,13,3,53,153,25,126,0,0
2335,378,161,430,313,2,13,3,52,152,26,126,0,0
2336,377,158,429,310,2,13,3,52,152,27,126,0,0
2337,377,156,429,305,2,13,3,52,149,28,126,0,0
2338,372,155,423,301,2,13,3,51,146,29,126,0,0
2339,368,156,418,301,2,13,3,50,145,30,126,0,0
2340,364,153,413,296,2,13,3,49,143,31,126,0,0
2341,362,152,410,294,2,13,3,48,142,32,126,0,0
2342,363,151,409,285,2,13,3,46,134,33,126,0,0
2343,360,151,405,280,2,13,3,45,129,34,126,0,0
2344,358,155,400,279,2,13,3,42,124,35,126,0,0
2345,356,150,398,275,2,13,3,42,125,36,126,0,0
2346,355,150,397,274,2,13,3,42,124,37,126,0,0
2347,355,150,396,270,2,13,3,41,120,38,126,0,0
2348,355,151,395,268,2,13,3,40,117,39,126,0,0
2349,353,150,393,267,2,13,3,40,117,40,126,0,0
2350,352,149,392,265,2,13,3,40,116,41,126,0,0
2351,352,149,391,262,2,13,3,39,113,42,126,0,0
2352,352,148,391,261,2,13,3,39,113,43,126,0,0
2353,351,149,390,262,2,13,3,39,113,44,126,0,0
2354,352,148,390,262,2,13,3,38,114,45,126,0,0
2355,352,148,391,263,2,13,3,39,115,46,126,0,0
2356,348,148,385,257,2,13,3,37,109,47,126,0,0
2357,343,150,381,263,2,13,3,38,113,48,126,0,0
2358,340,152,378,268,2,13,3,38,116,49,126,0,0
2359,336,152,376,271,2,13,3,40,119,50,126,0,0
2360,336,153,377,273,2,13,3,41,120,51,126,0,0
2361,339,152,381,275,2,13,3,42,123,52,126,0,0
2362,342,150,386,277,2,13,3,44,127,53,126,0,0
2363,345,151,389,279,2,13,3,44,128,54,126,0,0
2364,350,153,394,282,2,13,3,44,129,55,126,0,0
2365,355,153,401,287,2,13,3,46,134,56,126,0,0
2366,361,152,409,292,2,13,3,48,140,57,126,0,0
2367,365,153,414,299,2,13,3,49,146,58,126,0,0
2368,370,153,420,302,2,13,3,50,149,59,126,0,0
2369,378,154,428,304,2,13,3,50,150,60,126,0,0
2370,385,158,435,310,2,13,3,50,152,61,126,0,0
2371,393,157,445,311,2,13,3,52,154,62,126,0,0
2372,399,158,452,316,2,13,3,53,158,63,126,0,0
2373,408,160,460,317,2,13,3,52,157,64,126,0,0
2374,421,163,473,319,2,13,3,52,156,65,126,0,0
2375,433,167,485,323,2,13,3,52,156,66,126,0,0
2376,445,167,497,325,2,13,3,52,158,67,126,0,0
2377,456,170,508,329,2,13,3,52,159,68,126,0,0
2378,465,172,519,333,2,13,3,54,161,69,126,0,0
2379,481,173,540,336,2,13,3,59,163,70,126,0,0
2380,486,171,548,334,2,13,3,62,163,71,126,0,0
2381,481,172,542,336,2,13,3,61,164,72,126,0,0
2382,481,172,541,336,2,13,3,60,164,73,126,0,0
2383,485,171,546,340,2,13,3,61,169,74,126,0,0
2384,489,170,553,346,2,13,3,64,176,75,126,0,0
2385,491,170,558,352,2,13,3,67,182,76,126,0,0
2386,497,171,563,353,2,13,3,66,182,77,126,0,0
2387,500,172,567,355,2,13,3,67,183,78,126,0,0
2388,502,173,568,356,2,13,3,66,183,79,126,0,0
2389,505,174,572,360,2,13,3,67,186,80,126,0,0
2390,507,175,576,365,2,13,3,69,190,81,126,0,0
2391,509,175,578,366,2,13,3,69,191,82,126,0,0
2392,510,177,581,373,2,13,3,71,196,83,126,0,0
2393,509,177,581,378,2,13,3,72,201,84,126,0,0
2394,507,177,580,380,2,13,3,73,203,85,126,0,0
2395,507,178,581,385,2,13,3,74,207,86,126,0,0
2396,511,180,584,388,2,13,3,73,208,87,126,0,0
2397,513,180,587,391,2,13,3,74,211,88,126,0,0
2398,516,181,591,395,2,13,3,75,214,89,126,0,0
2399,520,184,594,398,2,13,3,74,214,90,126,0,0
2400,523,187,597,401,2,13,3,74,214,91,126,0,0
2401,528,187,601,403,2,13,3,73,216,92,126,0,0
2402,532,190,605,407,2,13,3,73,217,93,126,0,0
2403,538,192,611,411,2,13,3,73,219,94,126,0,0
2404,545,193,620,416,2,13,3,75,223,95,126,0,0
2405,553,194,629,422,2,13,3,76,228,96,126,0,0
2406,561,198,636,423,2,13,3,75,225,97,126,0,0
2407,567,196,643,427,2,13,3,76,231,98,126,0,0
2408,571,196,647,428,2,13,3,76,232,99,126,0,0
2409,574,199,653,428,2,13,3,79,229,100,126,0,0
2410,571,200,651,431,2,13,3,80,231,101,126,0,0
2411,562,197,643,431,2,13,3,81,234,102,126,0,0
2412,551,195,632,427,2,13,3,81,232,103,126,0,0
2413,543,194,621,417,2,13,3,78,223,104,126,0,0
2414,537,193,614,418,2,13,3,77,225,105,126,0,0
2415,531,193,605,412,2,13,3,74,219,106,126,0,0
2416,520,190,593,406,2,13,3,73,216,107,126,0,0
2417,510,189,582,401,2,13,3,72,212,108,126,0,0
2418,500,188,570,395,2,13,3,70,207,109,126,0,0
2419,490,185,561,395,2,13,3,71,210,110,126,0,0
2420,480,182,549,390,2,13,3,69,208,111,126,0,0
2421,474,185,541,385,2,13,3,67,200,112,126,0,0
2422,469,181,537,385,2,13,3,68,204,113,126,0,0
2423,463,178,531,382,2,13,3,68,204,114,126,0,0
2424,456,178,521,373,2,13,3,65,195,115,126,0,0
2425,448,179,513,372,2,13,3,65,193,116,126,0,0
2426,445,178,510,368,2,13,3,65,190,117,126,0,0
2427,446,178,511,365,2,13,3,65,187,118,126,0,0
2428,449,178,514,364,2,13,3,65,186,119,126,0,0
2429,457,179,522,360,2,13,3,65,181,120,126,0,0
2430,468,180,531,357,2,13,3,63,177,121,126,0,0
2431,479,182,547,362,2,13,3,68,180,122,126,0,0
2432,503,180,571,356,2,13,3,68,176,123,126,0,0
2433,521,184,585,353,2,13,3,64,169,124,126,0,0
2434,539,183,605,356,2,13,3,66,173,125,126,0,0
2435,546,183,611,354,2,13,3,65,171,126,126,1,0
2433,569,177,607,352,3,13,3,38,175,0,0,0,0
3373,529,188,579,344,5,13,3,50,156,0,22,0,1
3374,504,182,556,344,5,13,3,52,162,1,22,0,0
3375,492,184,544,347,5,13,3,52,163,2,22,0,0
3376,475,185,527,345,5,13,3,52,160,3,22,0,0
3377,456,185,509,347,5,13,3,53,162,4,22,0,0
3378,439,184,491,343,5,13,3,52,159,5,22,0,0
3379,425,181,477,341,5,13,3,52,160,6,22,0,0
3380,414,182,464,332,5,13,3,50,150,7,22,0,0
3381,402,179,451,330,5,13,3,49,151,8,22,0,0
3382,389,179,439,327,5,13,3,50,148,9,22,0,0
3383,382,178,429,320,5,13,3,47,142,10,22,0,0
3384,371,178,416,311,5,13,3,45,133,11,22,0,0
3385,360,178,406,314,5,13,3,46,136,12,22,0,0
3386,350,176,396,313,5,13,3,46,137,13,22,0,0
3387,345,177,388,307,5,13,3,43,130,14,22,0,0
3388,339,176,383,307,5,13,3,44,131,15,22,0,0
3389,335,173,378,301,5,13,3,43,128,16,22,0,0
3390,328,171,370,298,5,13,3,42,127,17,22,0,0
3391,321,170,361,292,5,13,3,40,122,18,22,0,0
3392,315,169,354,288,5,13,3,39,119,19,22,0,0
3393,308,167,345,280,5,13,3,37,113,20,22,0,0
3394,298,166,336,278,5,13,3,38,112,21,22,0,0
3395,286,165,321,272,5,13,3,35,107,22,22,1,0
3936,335,139,370,243,7,13,3,35,104,0,53,0,1
3937,334,139,369,245,7,13,3,35,106,1,53,0,0
3938,332,140,368,248,7,13,3,36,108,2,53,0,0
3939,332,140,368,249,7,13,3,36,109,3,53,0,0
3940,333,142,369,251,7,13,3,36,109,4,53,0,0
3941,335,145,371,252,7,13,3,36,107,5,53,0,0
3942,337,146,374,256,7,13,3,37,110,6,53,0,0
3943,340,146,379,260,7,13,3,39,114,7,53,0,0
3944,343,145,383,260,7,13,3,40,115,8,53,0,0
3945,345,147,384,261,7,13,3,39,114,9,53,0,0
3946,348,146,387,261,7,13,3,39,115,10,53,0,0
3947,351,146,391,265,7,13,3,40,119,11,53,0,0
3948,352,146,392,267,7,13,3,40,121,12,53,0,0
3949,355,146,396,268,7,13,3,41,122,13,53,0,0
3950,358,153,398,270,7,13,3,40,117,14,53,0,0
3951,360,150,402,273,7,13,3,42,123,15,53,0,0
3952,363,153,406,278,7,13,3,43,125,16,53,0,0
3953,365,152,408,280,7,13,3,43,128,17,53,0,0
3954,366,151,411,283,7,13,3,45,132,18,53,0,0
3955,369,151,416,287,7,13,3,47,136,19,53,0,0
3956,372,151,422,295,7,13,3,50,144,20,53,0,0
3957,373,152,424,301,7,13,3,51,149,21,53,0,0
3958,376,152,428,302,7,13,3,52,150,22,53,0,0
3959,379,154,433,307,7,13,3,54,153,23,53,0,0
3960,383,153,439,309,7,13,3,56,156,24,53,0,0
3961,388,157,446,317,7,13,3,58,160,25,53,0,0
3962,391,158,450,319,7,13,3,59,161,26,53,0,0
3963,396,159,457,323,7,13,3,61,164,27,53,0,0
3964,401,163,463,328,7,13,3,62,165,28,53,0,0
3965,408,165,471,333,7,13,3,63,168,29,53,0,0
3966,415,170,478,338,7,13,3,63,168,30,53,0,0
3967,420,170,485,339,7,13,3,65,169,31,53,0,0
3968,428,171,494,344,7,13,3,66,173,32,53,0,0
3969,432,171,502,353,7,13,3,70,182,33,53,0,0
3970,438,172,511,361,7,13,3,73,189,34,53,0,0
3971,444,175,519,367,7,13,3,75,192,35,53,0,0
3972,451,175,528,370,7,13,3,77,195,36,53,0,0
3973,463,178,539,375,7,13,3,76,197,37,53,0,0
3974,473,178,552,383,7,13,3,79,205,38,53,0,0
3975,485,179,566,388,7,13,3,81,209,39,53,0,0
3976,498,185,580,398,7,13,3,82,213,40,53,0,0
3977,512,185,595,402,7,13,3,83,217,41,53,0,0
3978,530,190,614,409,7,13,3,84,219,42,53,0,0
3979,546,192,630,412,7,13,3,84,220,43,53,0,0
3980,565,195,650,418,7,13,3,85,223,44,53,0,0
3981,585,196,673,427,7,13,3,88,231,45,53,0,0
3982,606,196,693,431,7,13,3,87,235,46,53,0,0
3983,623,202,714,438,7,13,3,91,236,47,53,0,0
3984,654,206,745,442,7,13,3,91,236,48,53,0,0
3985,681,206,776,451,7,13,3,95,245,49,53,0,0
3986,712,214,807,456,7,13,3,95,242,50,53,0,0
3987,752,214,845,457,7,13,3,93,243,51,53,0,0
3988,772,220,865,459,7,13,3,93,239,52,53,0,0
3989,792,223,885,464,7,13,3,93,241,53,53,1,0
4030,784,274,871,555,8,13,3,87,281,0,24,0,1
4031,768,253,862,557,8,13,3,94,304,1,24,0,0
4032,754,245,855,572,8,13,3,101,327,2,24,0,0
4033,722,251,828,592,8,13,3,106,341,3,24,0,0
4034,695,252,804,600,8,13,3,109,348,4,24,0,0
4035,653,256,766,615,8,13,3,113,359,5,24,0,0
4036,624,263,741,632,8,13,3,117,369,6,24,0,0
4037,600,267,725,663,8,13,3,125,396,7,24,0,0
4038,577,279,709,696,8,13,3,132,417,8,24,0,0
4039,556,283,692,707,8,13,3,136,424,9,24,0,0
4040,535,296,677,738,8,13,3,142,442,10,24,0,0
4041,512,305,661,767,8,13,3,149,462,11,24,0,0
4042,501,318,660,807,8,13,3,159,489,12,24,0,0
4043,498,335,669,853,8,13,3,171,518,13,24,0,0
4044,496,348,681,907,8,13,3,185,559,14,24,0,0
4045,485,373,685,971,8,13,3,200,598,15,24,0,0
4046,486,391,696,1006,8,13,3,210,615,16,24,0,0
4047,515,426,735,1054,8,13,3,220,628,17,24,0,0
4048,542,452,768,1075,8,13,3,226,623,18,24,0,0
4049,581,494,805,1080,8,13,3,224,586,19,24,0,0
4050,618,543,837,1080,8,13,3,219,537,20,24,0,0
4051,690,598,908,1080,8,13,3,218,482,21,24,0,0
4052,763,678,967,1080,8,13,3,204,402,22,24,0,0
4053,859,743,1053,1080,8,13,3,194,337,23,24,0,0
4054,892,778,1076,1080,8,13,3,184,302,24,24,1,0
4054,998,878,1190,1075,9,13,3,192,197,0,0,0,0
4125,543,423,763,1066,12,13,3,220,643,0,21,0,1
4126,543,390,748,992,12,13,3,205,602,1,21,0,0
4127,536,375,738,966,12,13,3,202,591,2,21,0,0
4128,537,345,725,892,12,13,3,188,547,3,21,0,0
4129,540,332,717,850,12,13,3,177,518,4,21,0,0
4130,552,316,716,797,12,13,3,164,481,5,21,0,0
4131,558,301,715,760,12,13,3,157,459,6,21,0,0
4132,565,292,719,742,12,13,3,154,450,7,21,0,0
4133,571,281,714,698,12,13,3,143,417,8,21,0,0
4134,580,277,717,676,12,13,3,137,399,9,21,0,0
4135,594,265,724,646,12,13,3,130,381,10,21,0,0
4136,607,258,734,631,12,13,3,127,373,11,21,0,0
4137,619,256,742,613,12,13,3,123,357,12,21,0,0
4138,634,246,751,586,12,13,3,117,340,13,21,0,0
4139,646,246,758,574,12,13,3,112,328,14,21,0,0
4140,668,241,775,554,12,13,3,107,313,15,21,0,0
4141,697,240,801,542,12,13,3,104,302,16,21,0,0
4142,721,240,821,531,12,13,3,100,291,17,21,0,0
4143,748,228,848,522,12,13,3,100,294,18,21,0,0
4144,764,229,861,514,12,13,3,97,285,19,21,0,0
4145,783,233,873,500,12,13,3,90,267,20,21,0,0
4146,800,229,886,483,12,13,3,86,254,21,21,1,0
5919,1825,965,1920,1078,14,13,3,95,113,0,3,0,0
5920,1761,919,1892,1073,14,13,3,131,154,1,3,0,0
5921,1708,930,1833,1074,14,13,3,125,144,2,3,0,0
5922,1681,926,1808,1073,14,13,3,127,147,3,3,0,0
1552,1240,383,1875,1042,29,13,4,635,659,0,1,0,0
1553,1241,339,1915,1039,29,13,4,674,700,1,1,0,0
1553,1447,371,1671,945,31,13,4,224,574,0,72,0,1
1554,1458,371,1675,928,31,13,4,217,557,1,72,0,0
1555,1481,355,1684,877,31,13,4,203,522,2,72,0,0
1556,1497,339,1689,833,31,13,4,192,494,3,72,0,0
1557,1503,333,1690,815,31,13,4,187,482,4,72,0,0
1558,1510,317,1687,777,31,13,4,177,460,5,72,0,0
1559,1510,300,1679,741,31,13,4,169,441,6,72,0,0
1560,1515,295,1680,727,31,13,4,165,432,7,72,0,0
1561,1525,282,1681,692,31,13,4,156,410,8,72,0,0
1562,1538,274,1688,671,31,13,4,150,397,9,72,0,0
1563,1543,270,1691,665,31,13,4,148,395,10,72,0,0
1564,1545,263,1683,634,31,13,4,138,371,11,72,0,0
1565,1549,257,1681,613,31,13,4,132,356,12,72,0,0
1566,1555,253,1684,604,31,13,4,129,351,13,72,0,0
1567,1566,248,1687,580,31,13,4,121,332,14,72,0,0
1568,1569,238,1687,567,31,13,4,118,329,15,72,0,0
1569,1574,237,1690,564,31,13,4,116,327,16,72,0,0
1570,1580,237,1686,539,31,13,4,106,302,17,72,0,0
1571,1584,233,1686,524,31,13,4,102,291,18,72,0,0
1572,1589,236,1687,518,31,13,4,98,282,19,72,0,0
1573,1597,235,1687,500,31,13,4,90,265,20,72,0,0
1574,1599,226,1687,487,31,13,4,88,261,21,72,0,0
1575,1602,223,1688,484,31,13,4,86,261,22,72,0,0
1576,1605,219,1688,472,31,13,4,83,253,23,72,0,0
1577,1607,213,1689,466,31,13,4,82,253,24,72,0,0
1578,1609,213,1688,459,31,13,4,79,246,25,72,0,0
1579,1613,208,1689,448,31,13,4,76,240,26,72,0,0
1580,1617,206,1688,435,31,13,4,71,229,27,72,0,0
1581,1619,210,1686,424,31,13,4,67,214,28,72,0,0
1582,1617,200,1685,419,31,13,4,68,219,29,72,0,0
1583,1617,201,1683,415,31,13,4,66,214,30,72,0,0
1584,1616,200,1683,413,31,13,4,67,213,31,72,0,0
1585,1618,195,1684,406,31,13,4,66,211,32,72,0,0
1586,1620,194,1684,399,31,13,4,64,205,33,72,0,0
1587,1622,195,1685,397,31,13,4,63,202,34,72,0,0
1588,1620,191,1682,389,31,13,4,62,198,35,72,0,0
1589,1618,186,1681,386,31,13,4,63,200,36,72,0,0
1590,1619,185,1680,378,31,13,4,61,193,37,72,0,0
1591,1621,181,1681,371,31,13,4,60,190,38,72,0,0
1592,1623,181,1682,366,31,13,4,59,185,39,72,0,0
1593,1622,181,1680,362,31,13,4,58,181,40,72,0,0
1594,1620,177,1679,357,31,13,4,59,180,41,72,0,0
1595,1618,176,1677,355,31,13,4,59,179,42,72,0,0
1596,1619,176,1677,353,31,13,4,58,177,43,72,0,0
1597,1620,173,1678,348,31,13,4,58,175,44,72,0,0
1598,1622,173,1678,343,31,13,4,56,170,45,72,0,0
1599,1623,176,1677,338,31,13,4,54,162,46,72,0,0
1600,1622,175,1675,331,31,13,4,53,156,47,72,0,0
1601,1618,173,1673,329,31,13,4,55,156,48,72,0,0
1602,1617,172,1672,328,31,13,4,55,156,49,72,0,0
1603,1616,169,1671,325,31,13,4,55,156,50,72,0,0
1604,1616,168,1669,318,31,13,4,53,150,51,72,0,0
1605,1614,168,1666,314,31,13,4,52,146,52,72,0,0
1606,1608,162,1662,312,31,13,4,54,150,53,72,0,0
1607,1607,164,1659,308,31,13,4,52,144,54,72,0,0
1608,1608,163,1661,308,31,13,4,53,145,55,72,0,0
1609,1611,163,1662,304,31,13,4,51,141,56,72,0,0
1610,1613,162,1664,303,31,13,4,51,141,57,72,0,0
1611,1615,161,1665,302,31,13,4,50,141,58,72,0,0
1612,1614,155,1666,300,31,13,4,52,145,59,72,0,0
1613,1616,156,1667,299,31,13,4,51,143,60,72,0,0
1614,1619,156,1668,298,31,13,4,49,142,61,72,0,0
1615,1623,156,1671,297,31,13,4,48,141,62,72,0,0
1616,1627,161,1673,296,31,13,4,46,135,63,72,0,0
1617,1630,162,1673,294,31,13,4,43,132,64,72,0,0
1618,1630,160,1672,291,31,13,4,42,131,65,72,0,0
1619,1631,160,1672,291,31,13,4,41,131,66,72,0,0
1620,1631,155,1672,288,31,13,4,41,133,67,72,0,0
1621,1633,150,1673,283,31,13,4,40,133,68,72,0,0
1622,1634,148,1673,281,31,13,4,39,133,69,72,0,0
1623,1635,150,1672,278,31,13,4,37,128,70,72,0,0
1624,1635,152,1671,278,31,13,4,36,126,71,72,0,0
1625,1636,151,1671,275,31,13,4,35,124,72,72,1,0
1703,529,136,620,340,33,13,4,91,204,0,0,0,0
2266,912,470,1003,571,42,13,4,91,101,0,0,0,0
2445,522,77,559,168,47,13,4,37,91,0,0,0,0
3723,870,434,1486,1070,57,13,4,616,636,0,4,0,0
3724,920,412,1525,1065,57,13,4,605,653,1,4,0,0
3725,950,382,1544,1055,57,13,4,594,673,2,4,0,0
3726,973,363,1547,1042,57,13,4,574,679,3,4,0,0
3727,1009,324,1613,1039,57,13,4,604,715,4,4,0,0
3727,1165,350,1381,948,58,13,4,216,598,0,78,0,1
3728,1183,336,1397,931,58,13,4,214,595,1,78,0,0
3729,1212,333,1417,906,58,13,4,205,573,2,78,0,0
3730,1236,318,1428,852,58,13,4,192,534,3,78,0,0
3731,1250,300,1442,837,58,13,4,192,537,4,78,0,0
3732,1260,289,1449,817,58,13,4,189,528,5,78,0,0
3733,1282,281,1456,767,58,13,4,174,486,6,78,0,0
3734,1303,272,1471,745,58,13,4,168,473,7,78,0,0
3735,1330,269,1487,713,58,13,4,157,444,8,78,0,0
3736,1351,262,1503,690,58,13,4,152,428,9,78,0,0
3737,1366,259,1517,686,58,13,4,151,427,10,78,0,0
3738,1380,251,1526,666,58,13,4,146,415,11,78,0,0
3739,1395,241,1535,640,58,13,4,140,399,12,78,0,0
3740,1407,237,1540,615,58,13,4,133,378,13,78,0,0
3741,1429,234,1554,594,58,13,4,125,360,14,78,0,0
3742,1439,225,1563,583,58,13,4,124,358,15,78,0,0
3743,1441,220,1567,581,58,13,4,126,361,16,78,0,0
3744,1448,214,1568,558,58,13,4,120,344,17,78,0,0
3745,1459,206,1576,547,58,13,4,117,341,18,78,0,0
3746,1470,206,1584,541,58,13,4,114,335,19,78,0,0
3747,1476,203,1587,528,58,13,4,111,325,20,78,0,0
3748,1486,201,1593,516,58,13,4,107,315,21,78,0,0
3749,1494,200,1599,511,58,13,4,105,311,22,78,0,0
3750,1502,202,1600,493,58,13,4,98,291,23,78,0,0
3751,1507,197,1602,481,58,13,4,95,284,24,78,0,0
3752,1516,200,1607,477,58,13,4,91,277,25,78,0,0
3753,1522,196,1611,466,58,13,4,89,270,26,78,0,0
3754,1526,192,1613,460,58,13,4,87,268,27,78,0,0
3755,1528,188,1613,451,58,13,4,85,263,28,78,0,0
3756,1529,185,1612,440,58,13,4,83,255,29,78,0,0
3757,1532,186,1613,435,58,13,4,81,249,30,78,0,0
3758,1534,187,1612,429,58,13,4,78,242,31,78,0,0
3759,1537,183,1613,422,58,13,4,76,239,32,78,0,0
3760,1540,183,1615,421,58,13,4,75,238,33,78,0,0
3761,1543,181,1615,410,58,13,4,72,229,34,78,0,0
3762,1547,172,1619,403,58,13,4,72,231,35,78,0,0
3763,1554,173,1624,401,58,13,4,70,228,36,78,0,0
3764,1560,172,1628,394,58,13,4,68,222,37,78,0,0
3765,1566,169,1632,391,58,13,4,66,222,38,78,0,0
3766,1574,175,1636,381,58,13,4,62,206,39,78,0,0
3767,1577,172,1638,374,58,13,4,61,202,40,78,0,0
3768,1581,173,1640,371,58,13,4,59,198,41,78,0,0
3769,1584,170,1643,369,58,13,4,59,199,42,78,0,0
3770,1588,171,1645,363,58,13,4,57,192,43,78,0,0
3771,1592,166,1650,362,58,13,4,58,196,44,78,0,0
3772,1595,165,1651,356,58,13,4,56,191,45,78,0,0
3773,1595,166,1651,351,58,13,4,56,185,46,78,0,0
3774,1595,167,1650,349,58,13,4,55,182,47,78,0,0
3775,1596,166,1650,348,58,13,4,54,182,48,78,0,0
3776,1597,161,1651,342,58,13,4,54,181,49,78,0,0
3777,1597,160,1651,339,58,13,4,54,179,50,78,0,0
3778,1598,161,1650,335,58,13,4,52,174,51,78,0,0
3779,1596,157,1649,331,58,13,4,53,174,52,78,0,0
3780,1597,158,1648,328,58,13,4,51,170,53,78,0,0
3781,1597,157,1647,325,58,13,4,50,168,54,78,0,0
3782,1597,158,1646,320,58,13,4,49,162,55,78,0,0
3783,1596,158,1645,320,58,13,4,49,162,56,78,0,0
3784,1594,157,1642,315,58,13,4,48,158,57,78,0,0
3785,1593,155,1641,312,58,13,4,48,157,58,78,0,0
3786,1592,156,1638,308,58,13,4,46,152,59,78,0,0
3787,1591,153,1636,302,58,13,4,45,149,60,78,0,0
3788,1592,152,1637,300,58,13,4,45,148,61,78,0,0
3789,1591,154,1634,297,58,13,4,43,143,62,78,0,0
3790,1592,152,1634,293,58,13,4,42,141,63,78,0,0
3791,1591,154,1632,291,58,13,4,41,137,64,78,0,0
3792,1591,155,1632,291,58,13,4,41,136,65,78,0,0
3793,1593,153,1633,288,58,13,4,40,135,66,78,0,0
3794,1594,151,1633,285,58,13,4,39,134,67,78,0,0
3795,1594,152,1632,281,58,13,4,38,129,68,78,0,0
3796,1594,150,1633,279,58,13,4,39,129,69,78,0,0
3797,1596,149,1634,276,58,13,4,38,127,70,78,0,0
3798,1597,148,1634,273,58,13,4,37,125,71,78,0,0
3799,1597,146,1635,274,58,13,4,38,128,72,78,0,0
3800,1597,146,1635,273,58,13,4,38,127,73,78,0,0
3801,1597,147,1634,269,58,13,4,37,122,74,78,0,0
3802,1597,145,1633,266,58,13,4,36,121,75,78,0,0
3803,1596,144,1633,269,58,13,4,37,125,76,78,0,0
3804,1597,144,1633,267,58,13,4,36,123,77,78,0,0
3805,1597,143,1632,265,58,13,4,35,122,78,78,1,0
3804,1627,138,1664,274,63,13,4,37,136,0,0,0,0
4058,1785,524,1919,1069,78,13,4,134,545,0,57,0,1
4059,1772,501,1914,1078,78,13,4,142,577,1,57,0,0
4060,1761,496,1906,1080,78,13,4,145,584,2,57,0,0
4061,1754,491,1899,1073,78,13,4,145,582,3,57,0,0
4062,1749,489,1896,1072,78,13,4,147,583,4,57,0,0
4063,1747,489,1895,1070,78,13,4,148,581,5,57,0,0
4064,1746,490,1897,1070,78,13,4,151,580,6,57,0,0
4065,1744,490,1897,1071,78,13,4,153,581,7,57,0,0
4066,1743,489,1898,1074,78,13,4,155,585,8,57,0,0
4067,1741,490,1899,1076,78,13,4,158,586,9,57,0,0
4068,1740,490,1901,1077,78,13,4,161,587,10,57,0,0
4069,1739,489,1902,1075,78,13,4,163,586,11,57,0,0
4070,1739,490,1903,1077,78,13,4,164,587,12,57,0,0
4071,1736,491,1901,1074,78,13,4,165,583,13,57,0,0
4072,1734,491,1901,1069,78,13,4,167,578,14,57,0,0
4073,1732,491,1901,1068,78,13,4,169,577,15,57,0,0
4074,1733,491,1903,1069,78,13,4,170,578,16,57,0,0
4075,1733,492,1905,1068,78,13,4,172,576,17,57,0,0
4076,1735,494,1908,1070,78,13,4,173,576,18,57,0,0
4077,1735,494,1909,1070,78,13,4,174,576,19,57,0,0
4078,1735,494,1910,1070,78,13,4,175,576,20,57,0,0
4079,1735,494,1910,1070,78,13,4,175,576,21,57,0,0
4080,1735,494,1911,1071,78,13,4,176,577,22,57,0,0
4081,1733,494,1910,1069,78,13,4,177,575,23,57,0,0
4082,1733,494,1910,1067,78,13,4,177,573,24,57,0,0
4083,1732,494,1910,1067,78,13,4,178,573,25,57,0,0
4084,1732,493,1911,1066,78,13,4,179,573,26,57,0,0
4085,1732,493,1912,1067,78,13,4,180,574,27,57,0,0
4086,1727,491,1910,1072,78,13,4,183,581,28,57,0,0
4087,1726,491,1910,1074,78,13,4,184,583,29,57,0,0
4088,1727,491,1911,1075,78,13,4,184,584,30,57,0,0
4089,1729,493,1913,1075,78,13,4,184,582,31,57,0,0
4090,1731,495,1915,1078,78,13,4,184,583,32,57,0,0
4091,1732,498,1916,1079,78,13,4,184,581,33,57,0,0
4092,1732,501,1915,1079,78,13,4,183,578,34,57,0,0
4093,1730,502,1914,1079,78,13,4,184,577,35,57,0,0
4094,1729,501,1913,1079,78,13,4,184,578,36,57,0,0
4095,1725,500,1911,1080,78,13,4,186,580,37,57,0,0
4096,1719,496,1907,1076,78,13,4,188,580,38,57,0,0
4097,1717,492,1907,1074,78,13,4,190,582,39,57,0,0
4098,1715,490,1907,1075,78,13,4,192,585,40,57,0,0
4099,1713,487,1907,1075,78,13,4,194,588,41,57,0,0
4100,1713,488,1908,1075,78,13,4,195,587,42,57,0,0
4101,1708,488,1905,1075,78,13,4,197,587,43,57,0,0
4102,1712,488,1909,1075,78,13,4,197,587,44,57,0,0
4103,1713,488,1911,1076,78,13,4,198,588,45,57,0,0
4104,1713,487,1912,1077,78,13,4,199,590,46,57,0,0
4105,1714,487,1913,1077,78,13,4,199,590,47,57,0,0
4106,1714,486,1913,1075,78,13,4,199,589,48,57,0,0
4107,1714,486,1914,1074,78,13,4,200,588,49,57,0,0
4108,1715,487,1914,1074,78,13,4,199,587,50,57,0,0
4109,1714,486,1914,1072,78,13,4,200,586,51,57,0,0
4110,1711,488,1913,1076,78,13,4,202,588,52,57,0,0
4111,1711,489,1913,1078,78,13,4,202,589,53,57,0,0
4112,1713,491,1914,1079,78,13,4,201,588,54,57,0,0
4113,1722,498,1920,1079,78,13,4,198,581,55,57,0,0
4114,1733,516,1920,1080,78,13,4,187,564,56,57,0,0
4115,1735,519,1920,1080,78,13,4,185,561,57,57,1,0
4521,1598,169,1634,301,93,13,4,36,132,0,83,0,1
4522,1601,168,1637,300,93,13,4,36,132,1,83,0,0
4523,1601,167,1638,302,93,13,4,37,135,2,83,0,0
4524,1602,168,1641,310,93,13,4,39,142,3,83,0,0
4525,1605,170,1644,313,93,13,4,39,143,4,83,0,0
4526,1608,170,1647,311,93,13,4,39,141,5,83,0,0
4527,1608,172,1649,320,93,13,4,41,148,6,83,0,0
4528,1608,174,1649,321,93,13,4,41,147,7,83,0,0
4529,1606,175,1650,327,93,13,4,44,152,8,83,0,0
4530,1608,177,1652,332,93,13,4,44,155,9,83,0,0
4531,1611,179,1656,332,93,13,4,45,153,10,83,0,0
4532,1612,180,1658,337,93,13,4,46,157,11,83,0,0
4533,1612,179,1658,341,93,13,4,46,162,12,83,0,0
4534,1607,180,1654,341,93,13,4,47,161,13,83,0,0
4535,1605,182,1653,348,93,13,4,48,166,14,83,0,0
4536,1604,183,1654,352,93,13,4,50,169,15,83,0,0
4537,1604,184,1654,355,93,13,4,50,171,16,83,0,0
4538,1601,186,1651,360,93,13,4,50,174,17,83,0,0
4539,1597,189,1646,359,93,13,4,49,170,18,83,0,0
4540,1590,189,1640,363,93,13,4,50,174,19,83,0,0
4541,1587,191,1638,366,93,13,4,51,175,20,83,0,0
4542,1585,190,1637,368,93,13,4,52,178,21,83,0,0
4543,1583,197,1634,374,93,13,4,51,177,22,83,0,0
4544,1576,198,1628,380,93,13,4,52,182,23,83,0,0
4545,1570,198,1622,379,93,13,4,52,181,24,83,0,0
4546,1566,199,1621,390,93,13,4,55,191,25,83,0,0
4547,1567,201,1623,395,93,13,4,56,194,26,83,0,0
4548,1568,201,1625,399,93,13,4,57,198,27,83,0,0
4549,1568,202,1626,407,93,13,4,58,205,28,83,0,0
4550,1566,202,1625,409,93,13,4,59,207,29,83,0,0
4551,1562,203,1623,417,93,13,4,61,214,30,83,0,0
4552,1564,208,1626,424,93,13,4,62,216,31,83,0,0
4553,1570,210,1632,426,93,13,4,62,216,32,83,0,0
4554,1574,213,1637,436,93,13,4,63,223,33,83,0,0
4555,1574,216,1637,440,93,13,4,63,224,34,83,0,0
4556,1570,219,1635,447,93,13,4,65,228,35,83,0,0
4557,1568,223,1635,454,93,13,4,67,231,36,83,0,0
4558,1570,225,1639,461,93,13,4,69,236,37,83,0,0
4559,1569,226,1639,467,93,13,4,70,241,38,83,0,0
4560,1566,230,1638,476,93,13,4,72,246,39,83,0,0
4561,1560,232,1631,478,93,13,4,71,246,40,83,0,0
4562,1552,230,1627,492,93,13,4,75,262,41,83,0,0
4563,1550,232,1627,504,93,13,4,77,272,42,83,0,0
4564,1548,232,1626,504,93,13,4,78,272,43,83,0,0
4565,1542,236,1623,520,93,13,4,81,284,44,83,0,0
4566,1535,243,1615,524,93,13,4,80,281,45,83,0,0
4567,1521,243,1605,535,93,13,4,84,292,46,83,0,0
4568,1512,247,1600,549,93,13,4,88,302,47,83,0,0
4569,1509,249,1598,555,93,13,4,89,306,48,83,0,0
4570,1504,252,1598,570,93,13,4,94,318,49,83,0,0
4571,1496,259,1592,584,93,13,4,96,325,50,83,0,0
4572,1486,263,1582,591,93,13,4,96,328,51,83,0,0
4573,1468,270,1570,614,93,13,4,102,344,52,83,0,0
4574,1465,277,1572,634,93,13,4,107,357,53,83,0,0
4575,1464,280,1572,641,93,13,4,108,361,54,83,0,0
4576,1458,285,1570,661,93,13,4,112,376,55,83,0,0
4577,1453,295,1565,671,93,13,4,112,376,56,83,0,0
4578,1439,301,1555,684,93,13,4,116,383,57,83,0,0
4579,1426,311,1551,716,93,13,4,125,405,58,83,0,0
4580,1428,317,1557,732,93,13,4,129,415,59,83,0,0
4581,1432,326,1565,754,93,13,4,133,428,60,83,0,0
4582,1425,333,1562,776,93,13,4,137,443,61,83,0,0
4583,1411,341,1551,792,93,13,4,140,451,62,83,0,0
4584,1392,350,1543,829,93,13,4,151,479,63,83,0,0
4585,1393,365,1547,859,93,13,4,154,494,64,83,0,0
4586,1390,374,1545,872,93,13,4,155,498,65,83,0,0
4587,1363,390,1529,913,93,13,4,166,523,66,83,0,0
4588,1344,409,1512,938,93,13,4,168,529,67,83,0,0
4589,1325,421,1501,971,93,13,4,176,550,68,83,0,0
4590,1311,442,1497,1024,93,13,4,186,582,69,83,0,0
4591,1302,452,1493,1046,93,13,4,191,594,70,83,0,0
4592,1290,474,1482,1069,93,13,4,192,595,71,83,0,0
4593,1267,498,1458,1080,93,13,4,191,582,72,83,0,0
4594,1242,516,1431,1080,93,13,4,189,564,73,83,0,0
4595,1226,551,1411,1080,93,13,4,185,529,74,83,0,0
4596,1221,580,1403,1077,93,13,4,182,497,75,83,0,0
4597,1212,607,1394,1076,93,13,4,182,469,76,83,0,0
4598,1179,649,1355,1075,93,13,4,176,426,77,83,0,0
4599,1123,689,1296,1073,93,13,4,173,384,78,83,0,0
4600,1072,734,1244,1078,93,13,4,172,344,79,83,0,0
4601,1028,794,1187,1077,93,13,4,159,283,80,83,0,0
4602,983,850,1129,1078,93,13,4,146,228,81,83,0,0
4603,905,918,1021,1076,93,13,4,116,158,82,83,0,0
4604,873,962,959,1080,93,13,4,86,118,83,83,1,0
5290,1464,560,1920,1072,109,13,4,456,512,0,1,0,0
5291,1491,526,1920,1072,109,13,4,429,546,1,1,0,0
5291,1711,554,1920,1080,110,13,4,209,526,0,4,0,0
5292,1721,545,1920,1080,110,13,4,199,535,1,4,0,0
5293,1725,523,1920,1069,110,13,4,195,546,2,4,0,0
5294,1738,529,1920,1059,110,13,4,182,530,3,4,0,0
5295,1743,525,1920,1052,110,13,4,177,527,4,4,0,0
5501,919,478,996,565,113,13,4,77,87,0,5,0,0
5502,924,480,998,564,113,13,4,74,84,1,5,0,0
5503,923,480,998,564,113,13,4,75,84,2,5,0,0
5504,922,478,997,563,113,13,4,75,85,3,5,0,0
5505,921,478,996,562,113,13,4,75,84,4,5,0,0
5506,921,477,996,561,113,13,4,75,84,5,5,0,0
5502,957,417,1023,514,114,13,4,66,97,0,1,0,0
5503,957,417,1026,520,114,13,4,69,103,1,1,0,0
5646,520,82,562,162,118,13,4,42,80,0,5,0,0
5647,520,82,562,162,118,13,4,42,80,1,5,0,0
5648,519,82,561,162,118,13,4,42,80,2,5,0,0
5649,518,82,561,163,118,13,4,43,81,3,5,0,0
5650,518,82,561,164,118,13,4,43,82,4,5,0,0
5651,518,82,561,164,118,13,4,43,82,5,5,0,0
5723,929,413,1033,551,119,13,4,104,138,0,0,0,0
5725,929,415,1037,551,120,13,4,108,136,0,0,0,0
5785,1785,603,1915,1030,122,13,4,130,427,0,4,0,0
5786,1785,603,1905,996,122,13,4,120,393,1,4,0,0
5787,1782,569,1916,1010,122,13,4,134,441,2,4,0,0
5788,1798,553,1920,992,122,13,4,122,439,3,4,0,0
5789,1802,538,1920,987,122,13,4,118,449,4,4,0,0
5785,1594,639,1887,1049,123,13,4,293,410,0,163,0,1
5786,1537,689,1808,1068,123,13,4,271,379,1,163,0,0
5787,1463,652,1766,1073,123,13,4,303,421,2,163,0,0
5788,1427,620,1754,1073,123,13,4,327,453,3,163,0,0
5789,1404,591,1751,1071,123,13,4,347,480,4,163,0,0
5790,1392,569,1752,1070,123,13,4,360,501,5,163,0,0
5791,1388,540,1761,1065,123,13,4,373,525,6,163,0,0
5792,1385,517,1766,1058,123,13,4,381,541,7,163,0,0
5793,1378,506,1766,1065,123,13,4,388,559,8,163,0,0
5794,1376,497,1766,1070,123,13,4,390,573,9,163,0,0
5795,1381,482,1772,1071,123,13,4,391,589,10,163,0,0
5796,1378,472,1765,1076,123,13,4,387,604,11,163,0,0
5797,1388,457,1772,1073,123,13,4,384,616,12,163,0,0
5798,1409,443,1791,1069,123,13,4,382,626,13,163,0,0
5799,1424,434,1802,1067,123,13,4,378,633,14,163,0,0
5800,1429,436,1797,1068,123,13,4,368,632,15,163,0,0
5801,1437,445,1790,1068,123,13,4,353,623,16,163,0,0
5802,1440,450,1781,1069,123,13,4,341,619,17,163,0,0
5803,1445,458,1772,1069,123,13,4,327,611,18,163,0,0
5804,1448,452,1771,1068,123,13,4,323,616,19,163,0,0
5805,1452,456,1766,1068,123,13,4,314,612,20,163,0,0
5806,1460,443,1775,1069,123,13,4,315,626,21,163,0,0
5807,1465,439,1778,1071,123,13,4,313,632,22,163,0,0
5808,1468,436,1779,1070,123,13,4,311,634,23,163,0,0
5809,1469,433,1777,1071,123,13,4,308,638,24,163,0,0
5810,1470,430,1775,1070,123,13,4,305,640,25,163,0,0
5811,1469,435,1768,1070,123,13,4,299,635,26,163,0,0
5812,1470,436,1767,1074,123,13,4,297,638,27,163,0,0
5813,1471,436,1765,1071,123,13,4,294,635,28,163,0,0
5814,1473,436,1764,1069,123,13,4,291,633,29,163,0,0
5815,1471,436,1760,1069,123,13,4,289,633,30,163,0,0
5816,1477,436,1763,1066,123,13,4,286,630,31,163,0,0
5817,1478,435,1764,1066,123,13,4,286,631,32,163,0,0
5818,1477,432,1764,1065,123,13,4,287,633,33,163,0,0
5819,1477,432,1764,1065,123,13,4,287,633,34,163,0,0
5820,1480,433,1765,1066,123,13,4,285,633,35,163,0,0
5821,1478,439,1760,1069,123,13,4,282,630,36,163,0,0
5822,1479,433,1762,1069,123,13,4,283,636,37,163,0,0
5823,1481,429,1766,1071,123,13,4,285,642,38,163,0,0
5824,1480,429,1765,1072,123,13,4,285,643,39,163,0,0
5825,1484,429,1766,1070,123,13,4,282,641,40,163,0,0
5826,1484,426,1769,1072,123,13,4,285,646,41,163,0,0
5827,1480,423,1768,1074,123,13,4,288,651,42,163,0,0
5828,1479,424,1766,1072,123,13,4,287,648,43,163,0,0
5829,1483,427,1767,1070,123,13,4,284,643,44,163,0,0
5830,1487,434,1767,1065,123,13,4,280,631,45,163,0,0
5831,1486,440,1763,1064,123,13,4,277,624,46,163,0,0
5832,1485,445,1759,1066,123,13,4,274,621,47,163,0,0
5833,1485,445,1760,1066,123,13,4,275,621,48,163,0,0
5834,1481,448,1755,1069,123,13,4,274,621,49,163,0,0
5835,1483,447,1758,1069,123,13,4,275,622,50,163,0,0
5836,1484,441,1760,1065,123,13,4,276,624,51,163,0,0
5837,1483,441,1760,1065,123,13,4,277,624,52,163,0,0
5838,1483,441,1759,1064,123,13,4,276,623,53,163,0,0
5839,1482,442,1757,1065,123,13,4,275,623,54,163,0,0
5840,1480,436,1759,1067,123,13,4,279,631,55,163,0,0
5841,1479,438,1759,1072,123,13,4,280,634,56,163,0,0
5842,1483,438,1764,1075,123,13,4,281,637,57,163,0,0
5843,1475,443,1753,1067,123,13,4,278,624,58,163,0,0
5844,1445,445,1733,1066,123,13,4,288,621,59,163,0,0
5845,1417,448,1710,1066,123,13,4,293,618,60,163,0,0
5846,1365,445,1654,1068,123,13,4,289,623,61,163,0,0
5847,1339,440,1623,1068,123,13,4,284,628,62,163,0,0
5848,1324,440,1602,1072,123,13,4,278,632,63,163,0,0
5849,1323,439,1594,1072,123,13,4,271,633,64,163,0,0
5850,1324,438,1589,1072,123,13,4,265,634,65,163,0,0
5851,1331,438,1589,1071,123,13,4,258,633,66,163,0,0
5852,1341,443,1593,1070,123,13,4,252,627,67,163,0,0
5853,1355,449,1602,1070,123,13,4,247,621,68,163,0,0
5854,1369,463,1608,1064,123,13,4,239,601,69,163,0,0
5855,1385,460,1627,1066,123,13,4,242,606,70,163,0,0
5856,1402,457,1649,1073,123,13,4,247,616,71,163,0,0
5857,1408,449,1658,1073,123,13,4,250,624,72,163,0,0
5858,1410,450,1658,1070,123,13,4,248,620,73,163,0,0
5859,1406,450,1655,1072,123,13,4,249,622,74,163,0,0
5860,1398,446,1645,1072,123,13,4,247,626,75,163,0,0
5861,1390,437,1639,1071,123,13,4,249,634,76,163,0,0
5862,1383,427,1639,1069,123,13,4,256,642,77,163,0,0
5863,1325,434,1581,1067,123,13,4,256,633,78,163,0,0
5864,1281,438,1538,1068,123,13,4,257,630,79,163,0,0
5865,1232,447,1483,1072,123,13,4,251,625,80,163,0,0
5866,1191,438,1443,1077,123,13,4,252,639,81,163,0,0
5867,1159,428,1413,1079,123,13,4,254,651,82,163,0,0
5868,1140,420,1380,1042,123,13,4,240,622,83,163,0,0
5869,1131,408,1359,1005,123,13,4,228,597,84,163,0,0
5870,1134,402,1357,992,123,13,4,223,590,85,163,0,0
5871,1144,385,1356,955,123,13,4,212,570,86,163,0,0
5872,1163,365,1360,903,123,13,4,197,538,87,163,0,0
5873,1177,354,1367,880,123,13,4,190,526,88,163,0,0
5874,1188,351,1366,854,123,13,4,178,503,89,163,0,0
5875,1194,329,1365,814,123,13,4,171,485,90,163,0,0
5876,1207,315,1375,795,123,13,4,168,480,91,163,0,0
5877,1232,305,1387,750,123,13,4,155,445,92,163,0,0
5878,1250,288,1402,732,123,13,4,152,444,93,163,0,0
5879,1260,283,1408,718,123,13,4,148,435,94,163,0,0
5880,1270,278,1409,690,123,13,4,139,412,95,163,0,0
5881,1281,268,1414,661,123,13,4,133,393,96,163,0,0
5882,1287,263,1421,659,123,13,4,134,396,97,163,0,0
5883,1303,259,1429,634,123,13,4,126,375,98,163,0,0
5884,1325,249,1447,611,123,13,4,122,362,99,163,0,0
5885,1338,249,1456,601,123,13,4,118,352,100,163,0,0
5886,1346,243,1463,595,123,13,4,117,352,101,163,0,0
5887,1358,236,1471,575,123,13,4,113,339,102,163,0,0
5888,1369,237,1480,568,123,13,4,111,331,103,163,0,0
5889,1382,240,1487,553,123,13,4,105,313,104,163,0,0
5890,1397,233,1498,536,123,13,4,101,303,105,163,0,0
5891,1406,231,1505,529,123,13,4,99,298,106,163,0,0
5892,1409,231,1508,526,123,13,4,99,295,107,163,0,0
5893,1410,223,1504,506,123,13,4,94,283,108,163,0,0
5894,1413,221,1504,496,123,13,4,91,275,109,163,0,0
5895,1427,220,1515,489,123,13,4,88,269,110,163,0,0
5896,1439,212,1524,473,123,13,4,85,261,111,163,0,0
5897,1451,202,1538,469,123,13,4,87,267,112,163,0,0
5898,1459,207,1542,458,123,13,4,83,251,113,163,0,0
5899,1465,203,1545,448,123,13,4,80,245,114,163,0,0
5900,1469,201,1548,443,123,13,4,79,242,115,163,0,0
5901,1470,203,1548,441,123,13,4,78,238,116,163,0,0
5902,1479,197,1555,431,123,13,4,76,234,117,163,0,0
5903,1487,194,1562,426,123,13,4,75,232,118,163,0,0
5904,1493,198,1565,422,123,13,4,72,224,119,163,0,0
5905,1493,196,1562,414,123,13,4,69,218,120,163,0,0
5906,1492,185,1563,409,123,13,4,71,224,121,163,0,0
5907,1495,181,1566,403,123,13,4,71,222,122,163,0,0
5908,1500,180,1570,394,123,13,4,70,214,123,163,0,0
5909,1502,177,1571,390,123,13,4,69,213,124,163,0,0
5910,1502,181,1568,385,123,13,4,66,204,125,163,0,0
5911,1500,172,1566,381,123,13,4,66,209,126,163,0,0
5912,1499,167,1566,377,123,13,4,67,210,127,163,0,0
5913,1503,174,1567,371,123,13,4,64,197,128,163,0,0
5914,1505,175,1567,368,123,13,4,62,193,129,163,0,0
5915,1508,171,1569,362,123,13,4,61,191,130,163,0,0
5916,1511,173,1570,359,123,13,4,59,186,131,163,0,0
5917,1516,172,1573,356,123,13,4,57,184,132,163,0,0
5918,1519,174,1574,351,123,13,4,55,177,133,163,0,0
5919,1521,176,1575,347,123,13,4,54,171,134,163,0,0
5920,1526,179,1577,342,123,13,4,51,163,135,163,0,0
5921,1532,179,1581,333,123,13,4,49,154,136,163,0,0
5922,1535,180,1584,332,123,13,4,49,152,137,163,0,0
5923,1536,180,1585,332,123,13,4,49,152,138,163,0,0
5924,1538,174,1587,327,123,13,4,49,153,139,163,0,0
5925,1537,175,1586,324,123,13,4,49,149,140,163,0,0
5926,1539,173,1587,322,123,13,4,48,149,141,163,0,0
5927,1542,168,1590,318,123,13,4,48,150,142,163,0,0
5928,1544,166,1592,316,123,13,4,48,150,143,163,0,0
5929,1544,161,1592,309,123,13,4,48,148,144,163,0,0
5930,1543,155,1592,305,123,13,4,49,150,145,163,0,0
5931,1542,163,1588,303,123,13,4,46,140,146,163,0,0
5932,1542,166,1587,303,123,13,4,45,137,147,163,0,0
5933,1544,156,1591,300,123,13,4,47,144,148,163,0,0
5934,1547,148,1597,298,123,13,4,50,150,149,163,0,0
5935,1547,146,1599,297,123,13,4,52,151,150,163,0,0
5936,1546,147,1596,294,123,13,4,50,147,151,163,0,0
5937,1547,152,1595,293,123,13,4,48,141,152,163,0,0
5938,1552,164,1595,289,123,13,4,43,125,153,163,0,0
5939,1557,165,1598,288,123,13,4,41,123,154,163,0,0
5940,1562,168,1600,283,123,13,4,38,115,155,163,0,0
5941,1563,166,1602,282,123,13,4,39,116,156,163,0,0
5942,1565,159,1605,281,123,13,4,40,122,157,163,0,0
5943,1566,161,1604,280,123,13,4,38,119,158,163,0,0
5944,1570,169,1605,279,123,13,4,35,110,159,163,0,0
5945,1570,158,1607,275,123,13,4,37,117,160,163,0,0
5946,1572,159,1608,270,123,13,4,36,111,161,163,0,0
5947,1573,158,1608,269,123,13,4,35,111,162,163,0,0
5948,1574,155,1609,266,123,13,4,35,111,163,163,1,0
5825,1775,679,1915,1080,127,13,4,140,401,0,0,0,0
5838,1673,514,1896,1077,129,13,4,223,563,0,86,0,0
5839,1674,521,1892,1073,129,13,4,218,552,1,86,0,0
5840,1686,524,1902,1071,129,13,4,216,547,2,86,0,0
5841,1715,535,1920,1070,129,13,4,205,535,3,86,0,0
5842,1728,540,1920,1069,129,13,4,192,529,4,86,0,0
5861,1733,533,1920,1075,129,13,4,187,542,0,86,0,1
5862,1724,529,1920,1060,129,13,4,196,531,1,86,0,0
5863,1708,523,1907,1050,129,13,4,199,527,2,86,0,0
5864,1677,518,1884,1059,129,13,4,207,541,3,86,0,0
5865,1608,509,1825,1063,129,13,4,217,554,4,86,0,0
5866,1558,492,1777,1059,129,13,4,219,567,5,86,0,0
5867,1505,469,1733,1067,129,13,4,228,598,6,86,0,0
5868,1440,464,1672,1058,129,13,4,232,594,7,86,0,0
5869,1408,445,1645,1055,129,13,4,237,610,8,86,0,0
5870,1391,421,1621,1020,129,13,4,230,599,9,86,0,0
5871,1372,405,1603,1010,129,13,4,231,605,10,86,0,0
5872,1369,390,1593,980,129,13,4,224,590,11,86,0,0
5873,1369,367,1582,930,129,13,4,213,563,12,86,0,0
5874,1382,356,1586,912,129,13,4,204,556,13,86,0,0
5875,1389,346,1581,881,129,13,4,192,535,14,86,0,0
5876,1392,330,1569,831,129,13,4,177,501,15,86,0,0
5877,1399,323,1567,803,129,13,4,168,480,16,86,0,0
5878,1412,311,1573,776,129,13,4,161,465,17,86,0,0
5879,1435,306,1585,744,129,13,4,150,438,18,86,0,0
5880,1448,298,1595,734,129,13,4,147,436,19,86,0,0
5881,1457,286,1601,716,129,13,4,144,430,20,86,0,0
5882,1461,279,1596,685,129,13,4,135,406,21,86,0,0
5883,1464,274,1597,673,129,13,4,133,399,22,86,0,0
5884,1477,266,1603,646,129,13,4,126,380,23,86,0,0
5885,1481,260,1602,627,129,13,4,121,367,24,86,0,0
5886,1486,260,1602,615,129,13,4,116,355,25,86,0,0
5887,1489,254,1599,593,129,13,4,110,339,26,86,0,0
5888,1491,251,1598,583,129,13,4,107,332,27,86,0,0
5889,1500,250,1601,569,129,13,4,101,319,28,86,0,0
5890,1506,244,1604,554,129,13,4,98,310,29,86,0,0
5891,1513,239,1609,542,129,13,4,96,303,30,86,0,0
5892,1518,235,1611,533,129,13,4,93,298,31,86,0,0
5893,1520,228,1610,518,129,13,4,90,290,32,86,0,0
5894,1524,225,1613,510,129,13,4,89,285,33,86,0,0
5895,1530,224,1617,502,129,13,4,87,278,34,86,0,0
5896,1540,219,1624,485,129,13,4,84,266,35,86,0,0
5897,1550,219,1633,483,129,13,4,83,264,36,86,0,0
5898,1551,216,1633,471,129,13,4,82,255,37,86,0,0
5899,1546,208,1628,461,129,13,4,82,253,38,86,0,0
5900,1553,210,1635,454,129,13,4,82,244,39,86,0,0
5901,1559,209,1641,449,129,13,4,82,240,40,86,0,0
5902,1559,206,1638,444,129,13,4,79,238,41,86,0,0
5903,1558,205,1635,438,129,13,4,77,233,42,86,0,0
5904,1562,211,1633,428,129,13,4,71,217,43,86,0,0
5905,1567,212,1634,417,129,13,4,67,205,44,86,0,0
5906,1570,209,1638,417,129,13,4,68,208,45,86,0,0
5907,1578,201,1647,410,129,13,4,69,209,46,86,0,0
5908,1581,199,1649,406,129,13,4,68,207,47,86,0,0
5909,1584,199,1651,399,129,13,4,67,200,48,86,0,0
5910,1583,199,1647,393,129,13,4,64,194,49,86,0,0
5911,1584,195,1648,389,129,13,4,64,194,50,86,0,0
5912,1587,191,1650,386,129,13,4,63,195,51,86,0,0
5913,1591,195,1650,378,129,13,4,59,183,52,86,0,0
5914,1593,190,1650,369,129,13,4,57,179,53,86,0,0
5915,1593,189,1649,366,129,13,4,56,177,54,86,0,0
5916,1594,180,1651,362,129,13,4,57,182,55,86,0,0
5917,1596,176,1653,360,129,13,4,57,184,56,86,0,0
5918,1596,175,1651,356,129,13,4,55,181,57,86,0,0
5919,1596,175,1651,355,129,13,4,55,180,58,86,0,0
5920,1598,176,1651,350,129,13,4,53,174,59,86,0,0
5921,1600,178,1649,342,129,13,4,49,164,60,86,0,0
5922,1601,179,1649,338,129,13,4,48,159,61,86,0,0
5923,1600,181,1647,337,129,13,4,47,156,62,86,0,0
5924,1603,182,1648,331,129,13,4,45,149,63,86,0,0
5925,1603,183,1647,328,129,13,4,44,145,64,86,0,0
5926,1604,174,1649,323,129,13,4,45,149,65,86,0,0
5927,1603,172,1649,320,129,13,4,46,148,66,86,0,0
5928,1603,172,1648,319,129,13,4,45,147,67,86,0,0
5929,1603,171,1647,316,129,13,4,44,145,68,86,0,0
5930,1603,170,1647,312,129,13,4,44,142,69,86,0,0
5931,1603,166,1647,308,129,13,4,44,142,70,86,0,0
5932,1602,162,1647,306,129,13,4,45,144,71,86,0,0
5933,1599,164,1642,303,129,13,4,43,139,72,86,0,0
5934,1599,162,1641,299,129,13,4,42,137,73,86,0,0
5935,1601,161,1643,298,129,13,4,42,137,74,86,0,0
5936,1603,161,1644,295,129,13,4,41,134,75,86,0,0
5937,1605,159,1647,295,129,13,4,42,136,76,86,0,0
5938,1604,158,1646,294,129,13,4,42,136,77,86,0,0
5939,1604,159,1646,293,129,13,4,42,134,78,86,0,0
5940,1603,159,1644,290,129,13,4,41,131,79,86,0,0
5941,1605,161,1643,286,129,13,4,38,125,80,86,0,0
5942,1608,162,1644,281,129,13,4,36,119,81,86,0,0
5943,1609,162,1645,279,129,13,4,36,117,82,86,0,0
5944,1611,161,1646,276,129,13,4,35,115,83,86,0,0
5945,1613,158,1648,275,129,13,4,35,117,84,86,0,0
5946,1614,157,1649,273,129,13,4,35,116,85,86,0,0
5947,1616,156,1651,272,129,13,4,35,116,86,86,1,0
5860,1809,554,1919,892,130,13,4,110,338,0,0,0,0
5960,522,82,559,165,131,13,4,37,83,0,0,0,0
1288,1842,455,1920,746,1,13,5,78,291,0,19,0,1
1289,1844,471,1920,757,1,13,5,76,286,1,19,0,0
1290,1831,429,1920,785,1,13,5,89,356,2,19,0,0
1291,1808,418,1915,818,1,13,5,107,400,3,19,0,0
1292,1791,388,1911,832,1,13,5,120,444,4,19,0,0
1293,1753,371,1886,839,1,13,5,133,468,5,19,0,0
1294,1723,373,1865,851,1,13,5,142,478,6,19,0,0
1295,1704,372,1857,861,1,13,5,153,489,7,19,0,0
1296,1679,380,1853,919,1,13,5,174,539,8,19,0,0
1297,1657,401,1844,960,1,13,5,187,559,9,19,0,0
1298,1633,412,1833,980,1,13,5,200,568,10,19,0,0
1299,1579,429,1804,1032,1,13,5,225,603,11,19,0,0
1300,1552,454,1791,1066,1,13,5,239,612,12,19,0,0
1301,1534,479,1779,1078,1,13,5,245,599,13,19,0,0
1302,1534,539,1771,1080,1,13,5,237,541,14,19,0,0
1303,1558,582,1795,1080,1,13,5,237,498,15,19,0,0
1304,1579,644,1808,1080,1,13,5,229,436,16,19,0,0
1305,1600,731,1808,1080,1,13,5,208,349,17,19,0,0
1306,1642,811,1823,1080,1,13,5,181,269,18,19,0,0
1307,1650,847,1816,1080,1,13,5,166,233,19,19,0,0
4936,1397,529,1920,1074,3,13,5,523,545,0,4,0,0
4937,1417,502,1920,1078,3,13,5,503,576,1,4,0,0
4938,1460,494,1920,1073,3,13,5,460,579,2,4,0,0
4939,1491,479,1920,1066,3,13,5,429,587,3,4,0,0
4940,1491,446,1920,1066,3,13,5,429,620,4,4,0,0
4940,1711,479,1914,973,4,13,5,203,494,0,6,0,0
4941,1721,508,1909,964,4,13,5,188,456,1,6,0,0
4942,1728,482,1920,956,4,13,5,192,474,2,6,0,0
4943,1777,528,1920,929,4,13,5,143,401,3,6,0,0
4944,1806,593,1920,922,4,13,5,114,329,4,6,0,0
4945,1824,579,1920,872,4,13,5,96,293,5,6,0,0
4946,1845,595,1920,850,4,13,5,75,255,6,6,0,0
5048,1849,557,1920,855,5,13,5,71,298,0,16,0,0
5049,1842,564,1917,878,5,13,5,75,314,1,16,0,0
5050,1815,489,1917,915,5,13,5,102,426,2,16,0,0
5051,1796,460,1912,939,5,13,5,116,479,3,16,0,0
5052,1777,464,1896,946,5,13,5,119,482,4,16,0,0
5053,1744,474,1877,987,5,13,5,133,513,5,16,0,0
5054,1715,456,1869,1028,5,13,5,154,572,6,16,0,0
5055,1699,445,1869,1050,5,13,5,170,605,7,16,0,0
5056,1679,458,1861,1075,5,13,5,182,617,8,16,0,0
5057,1659,480,1850,1080,5,13,5,191,600,9,16,0,0
5058,1642,508,1839,1080,5,13,5,197,572,10,16,0,0
5059,1623,543,1824,1080,5,13,5,201,537,11,16,0,0
5060,1586,602,1790,1080,5,13,5,204,478,12,16,0,0
5061,1577,641,1787,1078,5,13,5,210,437,13,16,0,0
5062,1606,708,1804,1077,5,13,5,198,369,14,16,0,0
5063,1661,811,1825,1080,5,13,5,164,269,15,16,0,0
5064,1667,843,1817,1080,5,13,5,150,237,16,16,0,0
5333,1877,359,1918,593,6,13,5,41,234,0,35,0,1
5334,1863,340,1910,607,6,13,5,47,267,1,35,0,0
5335,1850,333,1901,617,6,13,5,51,284,2,35,0,0
5336,1841,302,1899,619,6,13,5,58,317,3,35,0,0
5337,1830,291,1898,649,6,13,5,68,358,4,35,0,0
5338,1817,295,1895,687,6,13,5,78,392,5,35,0,0
5339,1808,297,1890,691,6,13,5,82,394,6,35,0,0
5340,1777,296,1867,699,6,13,5,90,403,7,35,0,0
5341,1797,328,1892,743,6,13,5,95,415,8,35,0,0
5342,1750,309,1850,722,6,13,5,100,413,9,35,0,0
5343,1706,299,1821,748,6,13,5,115,449,10,35,0,0
5344,1668,301,1796,775,6,13,5,128,474,11,35,0,0
5345,1636,296,1773,783,6,13,5,137,487,12,35,0,0
5346,1586,309,1730,780,6,13,5,144,471,13,35,0,0
5347,1544,308,1703,804,6,13,5,159,496,14,35,0,0
5348,1523,312,1707,863,6,13,5,184,551,15,35,0,0
5349,1455,307,1662,900,6,13,5,207,593,16,35,0,0
5350,1394,314,1607,917,6,13,5,213,603,17,35,0,0
5351,1354,328,1587,971,6,13,5,233,643,18,35,0,0
5352,1274,338,1534,1023,6,13,5,260,685,19,35,0,0
5353,1240,354,1501,1034,6,13,5,261,680,20,35,0,0
5354,1136,347,1418,1062,6,13,5,282,715,21,35,0,0
5355,1038,346,1326,1065,6,13,5,288,719,22,35,0,0
5356,995,369,1275,1078,6,13,5,280,709,23,35,0,0
5357,883,392,1165,1080,6,13,5,282,688,24,35,0,0
5358,770,411,1047,1079,6,13,5,277,668,25,35,0,0
5359,679,444,949,1079,6,13,5,270,635,26,35,0,0
5360,553,470,812,1080,6,13,5,259,610,27,35,0,0
5361,407,496,657,1080,6,13,5,250,584,28,35,0,0
5362,281,523,530,1079,6,13,5,249,556,29,35,0,0
5363,227,436,509,1072,6,13,5,282,636,30,35,0,0
5364,141,430,433,1074,6,13,5,292,644,31,35,0,0
5365,80,451,378,1080,6,13,5,298,629,32,35,0,0
5366,0,505,252,1080,6,13,5,252,575,33,35,0,0
5367,0,600,192,1080,6,13,5,192,480,34,35,0,0
5368,0,618,116,1080,6,13,5,116,462,35,35,1,0
5340,1827,381,1920,755,7,13,5,93,374,0,0,0,0
5341,1681,306,1884,695,8,13,5,203,389,0,1,0,0
5342,1729,348,1920,772,8,13,5,191,424,1,1,0,0
5351,1363,319,1527,663,9,13,5,164,344,0,1,0,0
5352,1332,323,1479,630,9,13,5,147,307,1,1,0,0
5356,883,358,1142,948,10,13,5,259,590,0,1,0,0
5357,958,358,1107,694,10,13,5,149,336,1,1,0,0
5358,822,367,1069,751,11,13,5,247,384,0,0,0,0
5360,579,352,785,752,12,13,5,206,400,0,1,0,0
5361,472,371,798,1008,12,13,5,326,637,1,1,0,0
5363,38,589,372,1077,13,13,5,334,488,0,0,0,0
5364,1,580,111,860,14,13,5,110,280,0,1,0,0
5365,0,639,158,1048,14,13,5,158,409,1,1,0,0
5642,1852,660,1920,785,15,13,5,68,125,0,21,0,1
5643,1813,551,1920,795,15,13,5,107,244,1,21,0,0
5644,1788,472,1920,816,15,13,5,132,344,2,21,0,0
5645,1766,439,1920,845,15,13,5,154,406,3,21,0,0
5646,1759,441,1920,855,15,13,5,161,414,4,21,0,0
5647,1739,434,1920,866,15,13,5,181,432,5,21,0,0
5648,1706,419,1920,891,15,13,5,214,472,6,21,0,0
5649,1688,396,1920,901,15,13,5,232,505,7,21,0,0
5650,1669,393,1920,934,15,13,5,251,541,8,21,0,0
5651,1644,403,1920,989,15,13,5,276,586,9,21,0,0
5652,1631,410,1920,1020,15,13,5,289,610,10,21,0,0
5653,1590,429,1896,1045,15,13,5,306,616,11,21,0,0
5654,1554,449,1864,1059,15,13,5,310,610,12,21,0,0
5655,1533,466,1843,1068,15,13,5,310,602,13,21,0,0
5656,1515,490,1822,1074,15,13,5,307,584,14,21,0,0
5657,1508,535,1804,1079,15,13,5,296,544,15,21,0,0
5658,1517,576,1804,1079,15,13,5,287,503,16,21,0,0
5659,1529,621,1803,1080,15,13,5,274,459,17,21,0,0
5660,1529,685,1781,1080,15,13,5,252,395,18,21,0,0
5661,1539,740,1774,1080,15,13,5,235,340,19,21,0,0
5662,1590,831,1784,1080,15,13,5,194,249,20,21,0,0
5663,1599,863,1774,1080,15,13,5,175,217,21,21,1,0
5816,922,288,982,371,17,13,5,60,83,0,6,0,0
5817,922,288,982,371,17,13,5,60,83,1,6,0,0
5818,922,288,982,371,17,13,5,60,83,2,6,0,0
5819,922,288,982,371,17,13,5,60,83,3,6,0,0
5820,922,288,982,371,17,13,5,60,83,4,6,0,0
5821,924,290,982,369,17,13,5,58,79,5,6,0,0
5822,925,290,982,369,17,13,5,57,79,6,6,0,0
5941,933,288,979,368,18,13,5,46,80,0,5,0,0
5942,932,288,979,368,18,13,5,47,80,1,5,0,0
5943,932,288,979,368,18,13,5,47,80,2,5,0,0
5944,932,288,979,368,18,13,5,47,80,3,5,0,0
5945,932,288,979,368,18,13,5,47,80,4,5,0,0
5946,932,288,979,368,18,13,5,47,80,5,5,0,0
5961,927,288,976,368,18,13,5,49,80,0,5,0,0
5962,926,288,976,369,18,13,5,50,81,1,5,0,0
5963,925,288,977,369,18,13,5,52,81,2,5,0,0
5964,925,288,977,369,18,13,5,52,81,3,5,0,0
5965,924,288,977,369,18,13,5,53,81,4,5,0,0
5966,924,288,977,369,18,13,5,53,81,5,5,0,0
5971,922,289,976,369,18,13,5,54,80,0,5,0,0
5972,923,290,976,369,18,13,5,53,79,1,5,0,0
5973,923,289,977,369,18,13,5,54,80,2,5,0,0
5974,923,289,977,369,18,13,5,54,80,3,5,0,0
5975,923,289,977,369,18,13,5,54,80,4,5,0,0
5976,923,290,977,368,18,13,5,54,78,5,5,0,0
957,467,98,505,220,1,13,6,38,122,0,1,0,0
958,448,104,484,218,1,13,6,36,114,1,1,0,0
959,423,102,461,222,2,13,6,38,120,0,0,0,0
960,387,105,443,224,3,13,6,56,119,0,25,0,1
961,369,100,427,224,3,13,6,58,124,1,25,0,0
962,350,103,406,224,3,13,6,56,121,2,25,0,0
963,332,106,388,227,3,13,6,56,121,3,25,0,0
964,320,107,376,230,3,13,6,56,123,4,25,0,0
965,309,107,366,234,3,13,6,57,127,5,25,0,0
966,301,108,358,236,3,13,6,57,128,6,25,0,0
967,295,110,351,238,3,13,6,56,128,7,25,0,0
968,291,112,347,240,3,13,6,56,128,8,25,0,0
969,289,112,345,244,3,13,6,56,132,9,25,0,0
970,289,112,346,248,3,13,6,57,136,10,25,0,0
971,292,114,348,251,3,13,6,56,137,11,25,0,0
972,293,114,350,256,3,13,6,57,142,12,25,0,0
973,293,115,351,261,3,13,6,58,146,13,25,0,0
974,291,116,349,264,3,13,6,58,148,14,25,0,0
975,290,115,348,265,3,13,6,58,150,15,25,0,0
976,288,117,345,265,3,13,6,57,148,16,25,0,0
977,288,119,342,262,3,13,6,54,143,17,25,0,0
978,286,117,341,268,3,13,6,55,151,18,25,0,0
979,287,116,341,263,3,13,6,54,147,19,25,0,0
980,289,115,341,260,3,13,6,52,145,20,25,0,0
981,295,117,346,256,3,13,6,51,139,21,25,0,0
982,299,113,351,250,3,13,6,52,137,22,25,0,0
983,292,112,342,246,3,13,6,50,134,23,25,0,0
984,283,112,332,243,3,13,6,49,131,24,25,0,0
985,281,111,329,242,3,13,6,48,131,25,25,1,0
3430,241,172,368,520,11,13,6,127,348,0,27,0,1
3431,238,171,371,537,11,13,6,133,366,1,27,0,0
3432,257,175,394,550,11,13,6,137,375,2,27,0,0
3433,287,175,426,555,11,13,6,139,380,3,27,0,0
3434,320,182,461,567,11,13,6,141,385,4,27,0,0
3435,354,185,498,577,11,13,6,144,392,5,27,0,0
3436,379,195,531,606,11,13,6,152,411,6,27,0,0
3437,400,200,555,616,11,13,6,155,416,7,27,0,0
3438,421,202,582,631,11,13,6,161,429,8,27,0,0
3439,444,205,615,655,11,13,6,171,450,9,27,0,0
3440,467,212,645,678,11,13,6,178,466,10,27,0,0
3441,483,219,673,713,11,13,6,190,494,11,27,0,0
3442,498,229,701,752,11,13,6,203,523,12,27,0,0
3443,514,231,724,772,11,13,6,210,541,13,27,0,0
3444,528,239,753,817,11,13,6,225,578,14,27,0,0
3445,548,255,786,862,11,13,6,238,607,15,27,0,0
3446,565,267,804,882,11,13,6,239,615,16,27,0,0
3447,573,288,830,956,11,13,6,257,668,17,27,0,0
3448,583,312,851,1010,11,13,6,268,698,18,27,0,0
3449,595,324,870,1038,11,13,6,275,714,19,27,0,0
3450,596,352,871,1065,11,13,6,275,713,20,27,0,0
3451,618,384,889,1073,11,13,6,271,689,21,27,0,0
3452,654,417,926,1077,11,13,6,272,660,22,27,0,0
3453,689,468,962,1080,11,13,6,273,612,23,27,0,0
3454,699,515,968,1080,11,13,6,269,565,24,27,0,0
3455,709,587,965,1080,11,13,6,256,493,25,27,0,0
3456,786,694,1012,1080,11,13,6,226,386,26,27,0,0
3457,819,734,1030,1080,11,13,6,211,346,27,27,1,0
5368,1510,848,1702,1074,22,13,6,192,226,0,1,0,0
5369,1550,766,1811,1073,22,13,6,261,307,1,1,0,0
5368,1721,816,1911,1067,23,13,6,190,251,0,0,0,0
5369,1367,759,1632,1071,24,13,6,265,312,0,33,0,1
5370,1406,715,1711,1074,24,13,6,305,359,1,33,0,0
5371,1336,651,1690,1071,24,13,6,354,420,2,33,0,0
5372,1244,583,1650,1072,24,13,6,406,489,3,33,0,0
5373,1151,546,1583,1073,24,13,6,432,527,4,33,0,0
5374,1052,494,1514,1069,24,13,6,462,575,5,33,0,0
5375,963,452,1449,1073,24,13,6,486,621,6,33,0,0
5376,900,427,1389,1070,24,13,6,489,643,7,33,0,0
5377,870,396,1331,1026,24,13,6,461,630,8,33,0,0
5378,836,367,1275,989,24,13,6,439,622,9,33,0,0
5379,794,351,1215,966,24,13,6,421,615,10,33,0,0
5380,777,328,1151,898,24,13,6,374,570,11,33,0,0
5381,744,308,1091,854,24,13,6,347,546,12,33,0,0
5382,715,301,1039,830,24,13,6,324,529,13,33,0,0
5383,698,285,991,782,24,13,6,293,497,14,33,0,0
5384,662,272,936,751,24,13,6,274,479,15,33,0,0
5385,633,270,892,738,24,13,6,259,468,16,33,0,0
5386,609,265,833,682,24,13,6,224,417,17,33,0,0
5387,561,248,783,671,24,13,6,222,423,18,33,0,0
5388,536,243,747,656,24,13,6,211,413,19,33,0,0
5389,513,228,709,623,24,13,6,196,395,20,33,0,0
5390,486,220,674,611,24,13,6,188,391,21,33,0,0
5391,461,216,644,607,24,13,6,183,391,22,33,0,0
5392,442,210,611,578,24,13,6,169,368,23,33,0,0
5393,415,201,575,558,24,13,6,160,357,24,33,0,0
5394,395,205,547,549,24,13,6,152,344,25,33,0,0
5395,364,194,510,531,24,13,6,146,337,26,33,0,0
5396,329,190,470,522,24,13,6,141,332,27,33,0,0
5397,305,190,442,520,24,13,6,137,330,28,33,0,0
5398,277,184,408,507,24,13,6,131,323,29,33,0,0
5399,248,182,378,507,24,13,6,130,325,30,33,0,0
5400,233,184,363,509,24,13,6,130,325,31,33,0,0
5401,212,178,334,497,24,13,6,122,319,32,33,0,0
5402,184,172,304,485,24,13,6,120,313,33,33,1,0
5370,1241,703,1489,1067,25,13,6,248,364,0,29,0,1
5371,1113,644,1402,1070,25,13,6,289,426,1,29,0,0
5372,976,593,1304,1075,25,13,6,328,482,2,29,0,0
5373,871,544,1233,1075,25,13,6,362,531,3,29,0,0
5374,787,491,1179,1075,25,13,6,392,584,4,29,0,0
5375,722,452,1129,1071,25,13,6,407,619,5,29,0,0
5376,661,425,1071,1062,25,13,6,410,637,6,29,0,0
5377,624,394,1016,1024,25,13,6,392,630,7,29,0,0
5378,585,368,971,1006,25,13,6,386,638,8,29,0,0
5379,564,346,934,978,25,13,6,370,632,9,29,0,0
5380,549,322,884,914,25,13,6,335,592,10,29,0,0
5381,532,312,839,876,25,13,6,307,564,11,29,0,0
5382,513,299,801,846,25,13,6,288,547,12,29,0,0
5383,492,279,753,793,25,13,6,261,514,13,29,0,0
5384,473,272,720,772,25,13,6,247,500,14,29,0,0
5385,460,260,686,732,25,13,6,226,472,15,29,0,0
5386,448,251,658,704,25,13,6,210,453,16,29,0,0
5387,431,250,621,674,25,13,6,190,424,17,29,0,0
5388,411,239,588,650,25,13,6,177,411,18,29,0,0
5389,389,232,561,640,25,13,6,172,408,19,29,0,0
5390,369,229,535,636,25,13,6,166,407,20,29,0,0
5391,349,221,499,598,25,13,6,150,377,21,29,0,0
5392,317,215,462,586,25,13,6,145,371,22,29,0,0
5393,306,215,443,566,25,13,6,137,351,23,29,0,0
5394,278,211,406,552,25,13,6,128,341,24,29,0,0
5395,257,204,385,551,25,13,6,128,347,25,29,0,0
5396,233,196,356,540,25,13,6,123,344,26,29,0,0
5397,214,195,326,523,25,13,6,112,328,27,29,0,0
5398,211,222,309,515,25,13,6,98,293,28,29,0,0
5399,187,219,282,500,25,13,6,95,281,29,29,1,0
1277,0,303,40,522,1,13,7,40,219,0,102,0,1
1278,5,303,48,537,1,13,7,43,234,1,102,0,0
1279,8,297,54,544,1,13,7,46,247,2,102,0,0
1280,11,295,59,547,1,13,7,48,252,3,102,0,0
1281,20,269,76,557,1,13,7,56,288,4,102,0,0
1282,26,266,86,556,1,13,7,60,290,5,102,0,0
1283,26,261,91,565,1,13,7,65,304,6,102,0,0
1284,35,262,104,576,1,13,7,69,314,7,102,0,0
1285,44,265,121,591,1,13,7,77,326,8,102,0,0
1286,53,266,134,590,1,13,7,81,324,9,102,0,0
1287,73,264,165,601,1,13,7,92,337,10,102,0,0
1288,87,269,182,605,1,13,7,95,336,11,102,0,0
1289,98,271,201,623,1,13,7,103,352,12,102,0,0
1290,114,275,227,642,1,13,7,113,367,13,102,0,0
1291,117,277,238,665,1,13,7,121,388,14,102,0,0
1292,128,283,257,680,1,13,7,129,397,15,102,0,0
1293,148,289,286,694,1,13,7,138,405,16,102,0,0
1294,167,290,312,710,1,13,7,145,420,17,102,0,0
1295,183,287,342,736,1,13,7,159,449,18,102,0,0
1296,205,289,381,780,1,13,7,176,491,19,102,0,0
1297,222,296,404,799,1,13,7,182,503,20,102,0,0
1298,270,304,460,807,1,13,7,190,503,21,102,0,0
1299,322,306,521,818,1,13,7,199,512,22,102,0,0
1300,358,308,560,829,1,13,7,202,521,23,102,0,0
1301,423,305,641,858,1,13,7,218,553,24,102,0,0
1302,484,315,708,876,1,13,7,224,561,25,102,0,0
1303,543,302,770,887,1,13,7,227,585,26,102,0,0
1304,639,304,871,884,1,13,7,232,580,27,102,0,0
1305,701,297,932,873,1,13,7,231,576,28,102,0,0
1306,796,293,1020,864,1,13,7,224,571,29,102,0,0
1307,876,291,1101,850,1,13,7,225,559,30,102,0,0
1308,954,285,1179,844,1,13,7,225,559,31,102,0,0
1309,1043,268,1274,847,1,13,7,231,579,32,102,0,0
1310,1104,268,1340,842,1,13,7,236,574,33,102,0,0
1311,1178,254,1399,804,1,13,7,221,550,34,102,0,0
1312,1245,252,1455,773,1,13,7,210,521,35,102,0,0
1313,1277,257,1482,757,1,13,7,205,500,36,102,0,0
1314,1344,246,1540,726,1,13,7,196,480,37,102,0,0
1315,1388,240,1586,719,1,13,7,198,479,38,102,0,0
1316,1413,234,1608,701,1,13,7,195,467,39,102,0,0
1317,1440,217,1624,667,1,13,7,184,450,40,102,0,0
1318,1464,213,1640,647,1,13,7,176,434,41,102,0,0
1319,1487,211,1655,627,1,13,7,168,416,42,102,0,0
1320,1521,200,1681,599,1,13,7,160,399,43,102,0,0
1321,1534,199,1692,592,1,13,7,158,393,44,102,0,0
1322,1539,192,1692,573,1,13,7,153,381,45,102,0,0
1323,1546,180,1689,542,1,13,7,143,362,46,102,0,0
1324,1556,179,1691,526,1,13,7,135,347,47,102,0,0
1325,1570,178,1699,513,1,13,7,129,335,48,102,0,0
1326,1579,176,1705,501,1,13,7,126,325,49,102,0,0
1327,1582,177,1704,494,1,13,7,122,317,50,102,0,0
1328,1580,172,1695,471,1,13,7,115,299,51,102,0,0
1329,1585,167,1695,457,1,13,7,110,290,52,102,0,0
1330,1589,168,1694,449,1,13,7,105,281,53,102,0,0
1331,1594,160,1697,436,1,13,7,103,276,54,102,0,0
1332,1598,154,1701,424,1,13,7,103,270,55,102,0,0
1333,1602,154,1700,408,1,13,7,98,254,56,102,0,0
1334,1600,150,1696,399,1,13,7,96,249,57,102,0,0
1335,1600,144,1693,392,1,13,7,93,248,58,102,0,0
1336,1604,145,1695,386,1,13,7,91,241,59,102,0,0
1337,1612,137,1701,373,1,13,7,89,236,60,102,0,0
1338,1616,136,1704,368,1,13,7,88,232,61,102,0,0
1339,1619,135,1705,363,1,13,7,86,228,62,102,0,0
1340,1618,133,1700,350,1,13,7,82,217,63,102,0,0
1341,1617,132,1696,342,1,13,7,79,210,64,102,0,0
1342,1621,130,1699,339,1,13,7,78,209,65,102,0,0
1343,1624,125,1702,333,1,13,7,78,208,66,102,0,0
1344,1626,125,1703,329,1,13,7,77,204,67,102,0,0
1345,1627,126,1700,322,1,13,7,73,196,68,102,0,0
1346,1627,119,1699,313,1,13,7,72,194,69,102,0,0
1347,1629,118,1699,307,1,13,7,70,189,70,102,0,0
1348,1632,116,1701,305,1,13,7,69,189,71,102,0,0
1349,1635,114,1704,302,1,13,7,69,188,72,102,0,0
1350,1638,112,1705,298,1,13,7,67,186,73,102,0,0
1351,1639,114,1703,293,1,13,7,64,179,74,102,0,0
1352,1638,114,1701,289,1,13,7,63,175,75,102,0,0
1353,1639,115,1701,288,1,13,7,62,173,76,102,0,0
1354,1644,113,1703,280,1,13,7,59,167,77,102,0,0
1355,1647,112,1705,275,1,13,7,58,163,78,102,0,0
1356,1646,113,1702,272,1,13,7,56,159,79,102,0,0
1357,1644,110,1699,265,1,13,7,55,155,80,102,0,0
1358,1641,105,1696,260,1,13,7,55,155,81,102,0,0
1359,1643,107,1697,258,1,13,7,54,151,82,102,0,0
1360,1646,108,1700,257,1,13,7,54,149,83,102,0,0
1361,1649,104,1702,254,1,13,7,53,150,84,102,0,0
1362,1649,105,1701,250,1,13,7,52,145,85,102,0,0
1363,1648,102,1700,248,1,13,7,52,146,86,102,0,0
1364,1650,103,1700,242,1,13,7,50,139,87,102,0,0
1365,1653,102,1703,242,1,13,7,50,140,88,102,0,0
1366,1656,99,1706,240,1,13,7,50,141,89,102,0,0
1367,1659,99,1708,238,1,13,7,49,139,90,102,0,0
1368,1661,98,1709,236,1,13,7,48,138,91,102,0,0
1369,1663,100,1710,235,1,13,7,47,135,92,102,0,0
1370,1666,101,1711,235,1,13,7,45,134,93,102,0,0
1371,1669,99,1712,230,1,13,7,43,131,94,102,0,0
1372,1670,94,1712,226,1,13,7,42,132,95,102,0,0
1373,1671,91,1713,225,1,13,7,42,134,96,102,0,0
1374,1672,93,1712,224,1,13,7,40,131,97,102,0,0
1375,1671,93,1710,221,1,13,7,39,128,98,102,0,0
1376,1671,91,1709,218,1,13,7,38,127,99,102,0,0
1377,1673,90,1709,214,1,13,7,36,124,100,102,0,0
1378,1674,89,1710,211,1,13,7,36,122,101,102,0,0
1379,1674,87,1709,211,1,13,7,35,124,102,102,1,0
1381,1673,86,1708,207,1,13,7,35,121,0,102,0,0
1382,1674,84,1709,206,1,13,7,35,122,1,102,0,0
1284,10,280,50,476,2,13,7,40,196,0,0,0,0
3458,1734,651,1920,1080,3,13,7,186,429,0,85,0,1
3459,1676,476,1920,1061,3,13,7,244,585,1,85,0,0
3460,1641,379,1920,1040,3,13,7,279,661,2,85,0,0
3461,1553,346,1846,1017,3,13,7,293,671,3,85,0,0
3462,1510,306,1821,1015,3,13,7,311,709,4,85,0,0
3463,1479,285,1791,1002,3,13,7,312,717,5,85,0,0
3464,1429,267,1734,976,3,13,7,305,709,6,85,0,0
3465,1404,248,1686,909,3,13,7,282,661,7,85,0,0
3466,1379,235,1652,876,3,13,7,273,641,8,85,0,0
3467,1371,227,1620,818,3,13,7,249,591,9,85,0,0
3468,1368,216,1603,779,3,13,7,235,563,10,85,0,0
3469,1368,212,1589,749,3,13,7,221,537,11,85,0,0
3470,1376,187,1590,711,3,13,7,214,524,12,85,0,0
3471,1381,156,1598,693,3,13,7,217,537,13,85,0,0
3472,1392,172,1595,678,3,13,7,203,506,14,85,0,0
3473,1403,165,1588,632,3,13,7,185,467,15,85,0,0
3474,1412,165,1584,601,3,13,7,172,436,16,85,0,0
3475,1423,163,1586,580,3,13,7,163,417,17,85,0,0
3476,1431,159,1587,558,3,13,7,156,399,18,85,0,0
3477,1442,152,1594,545,3,13,7,152,393,19,85,0,0
3478,1444,150,1594,537,3,13,7,150,387,20,85,0,0
3479,1455,145,1594,510,3,13,7,139,365,21,85,0,0
3480,1467,143,1598,493,3,13,7,131,350,22,85,0,0
3481,1476,139,1603,482,3,13,7,127,343,23,85,0,0
3482,1485,134,1608,471,3,13,7,123,337,24,85,0,0
3483,1494,134,1613,462,3,13,7,119,328,25,85,0,0
3484,1499,135,1611,443,3,13,7,112,308,26,85,0,0
3485,1507,129,1616,434,3,13,7,109,305,27,85,0,0
3486,1513,128,1619,430,3,13,7,106,302,28,85,0,0
3487,1523,128,1624,415,3,13,7,101,287,29,85,0,0
3488,1532,126,1629,405,3,13,7,97,279,30,85,0,0
3489,1537,126,1632,402,3,13,7,95,276,31,85,0,0
3490,1539,123,1630,389,3,13,7,91,266,32,85,0,0
3491,1542,117,1631,381,3,13,7,89,264,33,85,0,0
3492,1546,114,1634,377,3,13,7,88,263,34,85,0,0
3493,1552,111,1638,371,3,13,7,86,260,35,85,0,0
3494,1552,110,1637,367,3,13,7,85,257,36,85,0,0
3495,1552,106,1635,358,3,13,7,83,252,37,85,0,0
3496,1550,102,1632,350,3,13,7,82,248,38,85,0,0
3497,1554,106,1633,343,3,13,7,79,237,39,85,0,0
3498,1557,107,1633,340,3,13,7,76,233,40,85,0,0
3499,1559,105,1634,331,3,13,7,75,226,41,85,0,0
3500,1558,104,1633,330,3,13,7,75,226,42,85,0,0
3501,1556,100,1629,322,3,13,7,73,222,43,85,0,0
3502,1556,96,1628,314,3,13,7,72,218,44,85,0,0
3503,1559,96,1629,310,3,13,7,70,214,45,85,0,0
3504,1562,94,1631,305,3,13,7,69,211,46,85,0,0
3505,1565,93,1633,302,3,13,7,68,209,47,85,0,0
3506,1565,93,1633,301,3,13,7,68,208,48,85,0,0
3507,1565,92,1632,295,3,13,7,67,203,49,85,0,0
3508,1566,90,1632,293,3,13,7,66,203,50,85,0,0
3509,1571,89,1636,292,3,13,7,65,203,51,85,0,0
3510,1575,90,1636,283,3,13,7,61,193,52,85,0,0
3511,1577,94,1636,278,3,13,7,59,184,53,85,0,0
3512,1579,100,1635,278,3,13,7,56,178,54,85,0,0
3513,1582,100,1635,272,3,13,7,53,172,55,85,0,0
3514,1586,101,1637,268,3,13,7,51,167,56,85,0,0
3515,1589,97,1641,266,3,13,7,52,169,57,85,0,0
3516,1591,93,1642,259,3,13,7,51,166,58,85,0,0
3517,1593,92,1643,257,3,13,7,50,165,59,85,0,0
3518,1593,91,1643,253,3,13,7,50,162,60,85,0,0
3519,1594,89,1643,250,3,13,7,49,161,61,85,0,0
3520,1597,89,1644,247,3,13,7,47,158,62,85,0,0
3521,1599,88,1646,243,3,13,7,47,155,63,85,0,0
3522,1601,86,1648,241,3,13,7,47,155,64,85,0,0
3523,1602,86,1648,240,3,13,7,46,154,65,85,0,0
3524,1602,84,1648,236,3,13,7,46,152,66,85,0,0
3525,1604,83,1649,234,3,13,7,45,151,67,85,0,0
3526,1608,90,1650,231,3,13,7,42,141,68,85,0,0
3527,1612,93,1652,229,3,13,7,40,136,69,85,0,0
3528,1615,91,1654,226,3,13,7,39,135,70,85,0,0
3529,1617,94,1655,224,3,13,7,38,130,71,85,0,0
3530,1619,92,1657,222,3,13,7,38,130,72,85,0,0
3531,1622,96,1658,221,3,13,7,36,125,73,85,0,0
3532,1625,95,1661,218,3,13,7,36,123,74,85,0,0
3533,1627,91,1663,215,3,13,7,36,124,75,85,0,0
3534,1628,90,1665,216,3,13,7,37,126,76,85,0,0
3535,1629,92,1664,211,3,13,7,35,119,77,85,0,0
3536,1632,89,1667,209,3,13,7,35,120,78,85,0,0
3537,1636,85,1671,206,3,13,7,35,121,79,85,0,0
3538,1637,79,1674,204,3,13,7,37,125,80,85,0,0
3539,1639,76,1676,202,3,13,7,37,126,81,85,0,0
3540,1641,76,1677,203,3,13,7,36,127,82,85,0,0
3541,1642,74,1679,202,3,13,7,37,128,83,85,0,0
3542,1644,74,1680,201,3,13,7,36,127,84,85,0,0
3543,1647,75,1682,199,3,13,7,35,124,85,85,1,0
4857,1633,104,1668,235,6,13,7,35,131,0,109,0,1
4858,1632,105,1667,237,6,13,7,35,132,1,109,0,0
4859,1632,104,1668,238,6,13,7,36,134,2,109,0,0
4860,1633,107,1668,240,6,13,7,35,133,3,109,0,0
4861,1632,105,1668,244,6,13,7,36,139,4,109,0,0
4862,1630,107,1666,245,6,13,7,36,138,5,109,0,0
4863,1629,108,1665,247,6,13,7,36,139,6,109,0,0
4864,1629,111,1665,250,6,13,7,36,139,7,109,0,0
4865,1630,111,1668,252,6,13,7,38,141,8,109,0,0
4866,1629,106,1669,257,6,13,7,40,151,9,109,0,0
4867,1627,111,1666,258,6,13,7,39,147,10,109,0,0
4868,1623,115,1662,260,6,13,7,39,145,11,109,0,0
4869,1622,118,1661,263,6,13,7,39,145,12,109,0,0
4870,1623,117,1663,267,6,13,7,40,150,13,109,0,0
4871,1624,116,1666,270,6,13,7,42,154,14,109,0,0
4872,1624,118,1666,273,6,13,7,42,155,15,109,0,0
4873,1623,119,1665,275,6,13,7,42,156,16,109,0,0
4874,1621,118,1666,279,6,13,7,45,161,17,109,0,0
4875,1622,122,1667,285,6,13,7,45,163,18,109,0,0
4876,1625,119,1672,288,6,13,7,47,169,19,109,0,0
4877,1628,120,1676,293,6,13,7,48,173,20,109,0,0
4878,1629,122,1678,301,6,13,7,49,179,21,109,0,0
4879,1628,123,1677,303,6,13,7,49,180,22,109,0,0
4880,1626,122,1677,308,6,13,7,51,186,23,109,0,0
4881,1628,124,1680,312,6,13,7,52,188,24,109,0,0
4882,1631,127,1682,311,6,13,7,51,184,25,109,0,0
4883,1631,131,1683,319,6,13,7,52,188,26,109,0,0
4884,1630,134,1683,325,6,13,7,53,191,27,109,0,0
4885,1626,134,1680,326,6,13,7,54,192,28,109,0,0
4886,1624,133,1680,331,6,13,7,56,198,29,109,0,0
4887,1624,134,1682,335,6,13,7,58,201,30,109,0,0
4888,1625,135,1684,339,6,13,7,59,204,31,109,0,0
4889,1625,138,1684,345,6,13,7,59,207,32,109,0,0
4890,1622,139,1682,349,6,13,7,60,210,33,109,0,0
4891,1622,144,1682,355,6,13,7,60,211,34,109,0,0
4892,1626,146,1688,363,6,13,7,62,217,35,109,0,0
4893,1629,147,1693,368,6,13,7,64,221,36,109,0,0
4894,1631,150,1696,377,6,13,7,65,227,37,109,0,0
4895,1630,153,1697,385,6,13,7,67,232,38,109,0,0
4896,1629,155,1697,388,6,13,7,68,233,39,109,0,0
4897,1627,159,1696,397,6,13,7,69,238,40,109,0,0
4898,1629,162,1699,403,6,13,7,70,241,41,109,0,0
4899,1624,162,1697,410,6,13,7,73,248,42,109,0,0
4900,1619,165,1695,422,6,13,7,76,257,43,109,0,0
4901,1611,167,1688,426,6,13,7,77,259,44,109,0,0
4902,1606,170,1686,437,6,13,7,80,267,45,109,0,0
4903,1603,172,1686,448,6,13,7,83,276,46,109,0,0
4904,1605,176,1690,455,6,13,7,85,279,47,109,0,0
4905,1606,181,1693,463,6,13,7,87,282,48,109,0,0
4906,1602,188,1689,470,6,13,7,87,282,49,109,0,0
4907,1593,187,1686,485,6,13,7,93,298,50,109,0,0
4908,1588,189,1687,504,6,13,7,99,315,51,109,0,0
4909,1588,191,1691,515,6,13,7,103,324,52,109,0,0
4910,1587,193,1692,523,6,13,7,105,330,53,109,0,0
4911,1586,201,1692,532,6,13,7,106,331,54,109,0,0
4912,1577,203,1686,543,6,13,7,109,340,55,109,0,0
4913,1567,211,1682,568,6,13,7,115,357,56,109,0,0
4914,1565,217,1683,588,6,13,7,118,371,57,109,0,0
4915,1564,220,1685,601,6,13,7,121,381,58,109,0,0
4916,1556,228,1680,613,6,13,7,124,385,59,109,0,0
4917,1542,235,1669,629,6,13,7,127,394,60,109,0,0
4918,1522,236,1658,651,6,13,7,136,415,61,109,0,0
4919,1507,244,1650,683,6,13,7,143,439,62,109,0,0
4920,1500,250,1646,696,6,13,7,146,446,63,109,0,0
4921,1478,260,1628,711,6,13,7,150,451,64,109,0,0
4922,1447,266,1605,731,6,13,7,158,465,65,109,0,0
4923,1425,270,1587,745,6,13,7,162,475,66,109,0,0
4924,1391,284,1564,789,6,13,7,173,505,67,109,0,0
4925,1364,297,1543,818,6,13,7,179,521,68,109,0,0
4926,1333,296,1514,827,6,13,7,181,531,69,109,0,0
4927,1281,311,1468,845,6,13,7,187,534,70,109,0,0
4928,1243,314,1428,848,6,13,7,185,534,71,109,0,0
4929,1188,319,1382,882,6,13,7,194,563,72,109,0,0
4930,1123,331,1322,900,6,13,7,199,569,73,109,0,0
4931,1067,327,1264,902,6,13,7,197,575,74,109,0,0
4932,992,328,1192,900,6,13,7,200,572,75,109,0,0
4933,933,325,1138,898,6,13,7,205,573,76,109,0,0
4934,836,322,1040,890,6,13,7,204,568,77,109,0,0
4935,772,324,977,868,6,13,7,205,544,78,109,0,0
4936,722,327,925,859,6,13,7,203,532,79,109,0,0
4937,642,325,842,855,6,13,7,200,530,80,109,0,0
4938,596,325,796,846,6,13,7,200,521,81,109,0,0
4939,547,317,740,818,6,13,7,193,501,82,109,0,0
4940,502,310,690,799,6,13,7,188,489,83,109,0,0
4941,465,314,650,787,6,13,7,185,473,84,109,0,0
4942,410,313,590,770,6,13,7,180,457,85,109,0,0
4943,363,310,544,768,6,13,7,181,458,86,109,0,0
4944,334,299,515,752,6,13,7,181,453,87,109,0,0
4945,311,294,482,721,6,13,7,171,427,88,109,0,0
4946,290,289,460,706,6,13,7,170,417,89,109,0,0
4947,256,290,419,687,6,13,7,163,397,90,109,0,0
4948,215,286,375,677,6,13,7,160,391,91,109,0,0
4949,194,297,350,669,6,13,7,156,372,92,109,0,0
4950,166,290,318,654,6,13,7,152,364,93,109,0,0
4951,147,290,296,644,6,13,7,149,354,94,109,0,0
4952,123,291,271,639,6,13,7,148,348,95,109,0,0
4953,89,290,233,632,6,13,7,144,342,96,109,0,0
4954,68,292,209,628,6,13,7,141,336,97,109,0,0
4955,50,289,184,612,6,13,7,134,323,98,109,0,0
4956,40,286,168,600,6,13,7,128,314,99,109,0,0
4957,34,289,157,588,6,13,7,123,299,100,109,0,0
4958,15,284,136,578,6,13,7,121,294,101,109,0,0
4959,0,284,114,572,6,13,7,114,288,102,109,0,0
4960,0,284,108,569,6,13,7,108,285,103,109,0,0
4961,0,285,97,556,6,13,7,97,271,104,109,0,0
4962,0,292,91,551,6,13,7,91,259,105,109,0,0
4963,0,295,82,548,6,13,7,82,253,106,109,0,0
4964,0,309,65,547,6,13,7,65,238,107,109,0,0
4965,0,342,51,544,6,13,7,51,202,108,109,0,0
4966,0,349,35,537,6,13,7,35,188,109,109,1,0
5035,8,277,46,507,7,13,7,38,230,0,106,0,1
5036,11,257,54,517,7,13,7,43,260,1,106,0,0
5037,16,251,63,523,7,13,7,47,272,2,106,0,0
5038,23,254,73,531,7,13,7,50,277,3,106,0,0
5039,27,251,83,537,7,13,7,56,286,4,106,0,0
5040,46,261,107,546,7,13,7,61,285,5,106,0,0
5041,55,256,122,549,7,13,7,67,293,6,106,0,0
5042,67,254,142,562,7,13,7,75,308,7,106,0,0
5043,86,254,168,572,7,13,7,82,318,8,106,0,0
5044,101,256,188,578,7,13,7,87,322,9,106,0,0
5045,119,245,216,590,7,13,7,97,345,10,106,0,0
5046,144,246,252,607,7,13,7,108,361,11,106,0,0
5047,162,246,278,616,7,13,7,116,370,12,106,0,0
5048,178,245,305,642,7,13,7,127,397,13,106,0,0
5049,198,252,330,644,7,13,7,132,392,14,106,0,0
5050,211,254,352,670,7,13,7,141,416,15,106,0,0
5051,231,250,380,681,7,13,7,149,431,16,106,0,0
5052,265,260,424,702,7,13,7,159,442,17,106,0,0
5053,295,262,461,714,7,13,7,166,452,18,106,0,0
5054,325,261,502,735,7,13,7,177,474,19,106,0,0
5055,364,270,555,766,7,13,7,191,496,20,106,0,0
5056,403,273,601,781,7,13,7,198,508,21,106,0,0
5057,441,260,647,793,7,13,7,206,533,22,106,0,0
5058,515,268,732,812,7,13,7,217,544,23,106,0,0
5059,568,269,794,826,7,13,7,226,557,24,106,0,0
5060,623,268,851,835,7,13,7,228,567,25,106,0,0
5061,700,271,938,847,7,13,7,238,576,26,106,0,0
5062,759,279,1010,868,7,13,7,251,589,27,106,0,0
5063,852,275,1098,864,7,13,7,246,589,28,106,0,0
5064,933,226,1206,879,7,13,7,273,653,29,106,0,0
5065,1001,245,1271,884,7,13,7,270,639,30,106,0,0
5066,1094,237,1351,863,7,13,7,257,626,31,106,0,0
5067,1179,235,1431,838,7,13,7,252,603,32,106,0,0
5068,1223,255,1464,822,7,13,7,241,567,33,106,0,0
5069,1320,259,1548,801,7,13,7,228,542,34,106,0,0
5070,1382,246,1611,789,7,13,7,229,543,35,106,0,0
5071,1416,233,1641,772,7,13,7,225,539,36,106,0,0
5072,1434,214,1650,745,7,13,7,216,531,37,106,0,0
5073,1457,217,1655,716,7,13,7,198,499,38,106,0,0
5074,1482,217,1664,683,7,13,7,182,466,39,106,0,0
5075,1496,207,1670,652,7,13,7,174,445,40,106,0,0
5076,1493,205,1665,643,7,13,7,172,438,41,106,0,0
5077,1498,200,1667,634,7,13,7,169,434,42,106,0,0
5078,1510,181,1664,583,7,13,7,154,402,43,106,0,0
5079,1509,173,1657,565,7,13,7,148,392,44,106,0,0
5080,1513,174,1651,545,7,13,7,138,371,45,106,0,0
5081,1516,161,1647,511,7,13,7,131,350,46,106,0,0
5082,1516,150,1645,495,7,13,7,129,345,47,106,0,0
5083,1512,142,1639,485,7,13,7,127,343,48,106,0,0
5084,1510,141,1628,463,7,13,7,118,322,49,106,0,0
5085,1512,137,1626,452,7,13,7,114,315,50,106,0,0
5086,1515,140,1623,439,7,13,7,108,299,51,106,0,0
5087,1519,138,1622,424,7,13,7,103,286,52,106,0,0
5088,1520,131,1622,417,7,13,7,102,286,53,106,0,0
5089,1517,128,1618,412,7,13,7,101,284,54,106,0,0
5090,1516,121,1613,397,7,13,7,97,276,55,106,0,0
5091,1518,120,1611,388,7,13,7,93,268,56,106,0,0
5092,1521,120,1610,378,7,13,7,89,258,57,106,0,0
5093,1525,114,1611,365,7,13,7,86,251,58,106,0,0
5094,1526,112,1611,361,7,13,7,85,249,59,106,0,0
5095,1528,110,1610,351,7,13,7,82,241,60,106,0,0
5096,1528,98,1609,339,7,13,7,81,241,61,106,0,0
5097,1531,106,1607,336,7,13,7,76,230,62,106,0,0
5098,1537,107,1610,327,7,13,7,73,220,63,106,0,0
5099,1541,103,1613,318,7,13,7,72,215,64,106,0,0
5100,1545,104,1615,317,7,13,7,70,213,65,106,0,0
5101,1544,101,1612,310,7,13,7,68,209,66,106,0,0
5102,1544,97,1611,304,7,13,7,67,207,67,106,0,0
5103,1549,100,1613,297,7,13,7,64,197,68,106,0,0
5104,1551,96,1615,292,7,13,7,64,196,69,106,0,0
5105,1551,86,1615,288,7,13,7,64,202,70,106,0,0
5106,1552,88,1614,284,7,13,7,62,196,71,106,0,0
5107,1549,91,1608,276,7,13,7,59,185,72,106,0,0
5108,1547,99,1603,269,7,13,7,56,170,73,106,0,0
5109,1549,99,1604,267,7,13,7,55,168,74,106,0,0
5110,1551,95,1606,260,7,13,7,55,165,75,106,0,0
5111,1553,90,1610,259,7,13,7,57,169,76,106,0,0
5112,1553,91,1609,257,7,13,7,56,166,77,106,0,0
5113,1554,90,1609,248,7,13,7,55,158,78,106,0,0
5114,1554,88,1609,247,7,13,7,55,159,79,106,0,0
5115,1558,89,1612,246,7,13,7,54,157,80,106,0,0
5116,1561,88,1615,244,7,13,7,54,156,81,106,0,0
5117,1564,87,1617,240,7,13,7,53,153,82,106,0,0
5118,1566,87,1617,237,7,13,7,51,150,83,106,0,0
5119,1567,86,1617,232,7,13,7,50,146,84,106,0,0
5120,1568,85,1618,229,7,13,7,50,144,85,106,0,0
5121,1569,86,1620,229,7,13,7,51,143,86,106,0,0
5122,1573,83,1624,225,7,13,7,51,142,87,106,0,0
5123,1574,83,1625,224,7,13,7,51,141,88,106,0,0
5124,1576,83,1626,222,7,13,7,50,139,89,106,0,0
5125,1576,82,1625,215,7,13,7,49,133,90,106,0,0
5126,1575,82,1625,213,7,13,7,50,131,91,106,0,0
5127,1577,83,1627,213,7,13,7,50,130,92,106,0,0
5128,1578,82,1627,209,7,13,7,49,127,93,106,0,0
5129,1578,81,1626,207,7,13,7,48,126,94,106,0,0
5130,1577,80,1624,204,7,13,7,47,124,95,106,0,0
5131,1577,78,1624,202,7,13,7,47,124,96,106,0,0
5132,1577,79,1624,201,7,13,7,47,122,97,106,0,0
5133,1580,82,1625,199,7,13,7,45,117,98,106,0,0
5134,1586,79,1631,195,7,13,7,45,116,99,106,0,0
5135,1589,78,1632,193,7,13,7,43,115,100,106,0,0
5136,1592,81,1633,193,7,13,7,41,112,101,106,0,0
5137,1596,75,1639,193,7,13,7,43,118,102,106,0,0
5138,1599,76,1640,190,7,13,7,41,114,103,106,0,0
5139,1603,75,1645,190,7,13,7,42,115,104,106,0,0
5140,1607,70,1649,188,7,13,7,42,118,105,106,0,0
5141,1612,74,1653,189,7,13,7,41,115,106,106,1,0
5333,20,335,57,576,9,13,7,37,241,0,33,0,1
5334,22,294,69,588,9,13,7,47,294,1,33,0,0
5335,24,285,76,599,9,13,7,52,314,2,33,0,0
5336,26,285,84,607,9,13,7,58,322,3,33,0,0
5337,37,285,101,618,9,13,7,64,333,4,33,0,0
5338,44,286,117,638,9,13,7,73,352,5,33,0,0
5339,54,285,134,647,9,13,7,80,362,6,33,0,0
5340,62,286,150,663,9,13,7,88,377,7,33,0,0
5341,73,290,169,678,9,13,7,96,388,8,33,0,0
5342,89,291,192,687,9,13,7,103,396,9,33,0,0
5343,113,303,225,705,9,13,7,112,402,10,33,0,0
5344,129,313,247,719,9,13,7,118,406,11,33,0,0
5345,139,309,272,759,9,13,7,133,450,12,33,0,0
5346,157,318,302,792,9,13,7,145,474,13,33,0,0
5347,165,328,318,810,9,13,7,153,482,14,33,0,0
5348,201,342,361,826,9,13,7,160,484,15,33,0,0
5349,226,349,397,848,9,13,7,171,499,16,33,0,0
5350,244,347,430,883,9,13,7,186,536,17,33,0,0
5351,279,368,480,931,9,13,7,201,563,18,33,0,0
5352,312,378,523,968,9,13,7,211,590,19,33,0,0
5353,370,384,597,990,9,13,7,227,606,20,33,0,0
5354,427,400,669,1024,9,13,7,242,624,21,33,0,0
5355,469,402,720,1049,9,13,7,251,647,22,33,0,0
5356,535,415,794,1068,9,13,7,259,653,23,33,0,0
5357,618,432,879,1074,9,13,7,261,642,24,33,0,0
5358,698,451,957,1080,9,13,7,259,629,25,33,0,0
5359,800,477,1055,1080,9,13,7,255,603,26,33,0,0
5360,915,503,1158,1080,9,13,7,243,577,27,33,0,0
5361,1038,517,1283,1080,9,13,7,245,563,28,33,0,0
5362,1177,544,1417,1077,9,13,7,240,533,29,33,0,0
5363,1329,583,1560,1078,9,13,7,231,495,30,33,0,0
5364,1496,624,1701,1048,9,13,7,205,424,31,33,0,0
5365,1528,710,1717,1072,9,13,7,189,362,32,33,0,0
5366,1614,740,1791,1080,9,13,7,177,340,33,33,1,0
5339,22,357,58,677,10,13,7,36,320,0,25,0,1
5340,27,358,66,690,10,13,7,39,332,1,25,0,0
5341,26,346,69,695,10,13,7,43,349,2,25,0,0
5342,26,334,77,727,10,13,7,51,393,3,25,0,0
5343,30,345,83,735,10,13,7,53,390,4,25,0,0
5344,36,351,95,754,10,13,7,59,403,5,25,0,0
5345,49,349,121,791,10,13,7,72,442,6,25,0,0
5346,67,357,153,819,10,13,7,86,462,7,25,0,0
5347,74,361,168,825,10,13,7,94,464,8,25,0,0
5348,81,371,189,873,10,13,7,108,502,9,25,0,0
5349,98,389,218,902,10,13,7,120,513,10,25,0,0
5350,113,393,245,922,10,13,7,132,529,11,25,0,0
5351,152,404,301,942,10,13,7,149,538,12,25,0,0
5352,165,408,319,962,10,13,7,154,554,13,25,0,0
5353,220,427,387,986,10,13,7,167,559,14,25,0,0
5354,231,444,418,1040,10,13,7,187,596,15,25,0,0
5355,274,479,467,1064,10,13,7,193,585,16,25,0,0
5356,320,489,526,1075,10,13,7,206,586,17,25,0,0
5357,381,501,600,1080,10,13,7,219,579,18,25,0,0
5358,455,530,678,1080,10,13,7,223,550,19,25,0,0
5359,542,552,770,1080,10,13,7,228,528,20,25,0,0
5360,654,597,884,1080,10,13,7,230,483,21,25,0,0
5361,768,648,991,1080,10,13,7,223,432,22,25,0,0
5362,886,665,1115,1080,10,13,7,229,415,23,25,0,0
5363,1028,704,1251,1080,10,13,7,223,376,24,25,0,0
5364,1108,727,1323,1080,10,13,7,215,353,25,25,1,0
5364,1249,745,1541,1080,11,13,7,292,335,0,0,0,0
5625,10,282,45,491,12,13,7,35,209,0,113,0,1
5626,12,277,48,495,12,13,7,36,218,1,113,0,0
5627,13,263,53,497,12,13,7,40,234,2,113,0,0
5628,14,257,56,500,12,13,7,42,243,3,113,0,0
5629,24,258,72,509,12,13,7,48,251,4,113,0,0
5630,30,257,82,512,12,13,7,52,255,5,113,0,0
5631,30,256,87,518,12,13,7,57,262,6,113,0,0
5632,35,257,98,531,12,13,7,63,274,7,113,0,0
5633,39,261,106,536,12,13,7,67,275,8,113,0,0
5634,46,260,118,535,12,13,7,72,275,9,113,0,0
5635,61,262,142,546,12,13,7,81,284,10,113,0,0
5636,72,258,159,551,12,13,7,87,293,11,113,0,0
5637,74,255,167,560,12,13,7,93,305,12,113,0,0
5638,83,256,187,583,12,13,7,104,327,13,113,0,0
5639,89,259,197,592,12,13,7,108,333,14,113,0,0
5640,100,264,210,595,12,13,7,110,331,15,113,0,0
5641,114,266,232,606,12,13,7,118,340,16,113,0,0
5642,128,261,253,614,12,13,7,125,353,17,113,0,0
5643,134,260,264,622,12,13,7,130,362,18,113,0,0
5644,140,260,277,636,12,13,7,137,376,19,113,0,0
5645,151,264,295,655,12,13,7,144,391,20,113,0,0
5646,165,266,314,666,12,13,7,149,400,21,113,0,0
5647,192,270,354,687,12,13,7,162,417,22,113,0,0
5648,214,272,381,699,12,13,7,167,427,23,113,0,0
5649,227,270,402,718,12,13,7,175,448,24,113,0,0
5650,251,275,434,736,12,13,7,183,461,25,113,0,0
5651,273,281,461,760,12,13,7,188,479,26,113,0,0
5652,305,289,497,774,12,13,7,192,485,27,113,0,0
5653,359,297,561,790,12,13,7,202,493,28,113,0,0
5654,399,294,606,797,12,13,7,207,503,29,113,0,0
5655,433,296,653,829,12,13,7,220,533,30,113,0,0
5656,480,304,713,865,12,13,7,233,561,31,113,0,0
5657,524,304,758,875,12,13,7,234,571,32,113,0,0
5658,596,302,834,882,12,13,7,238,580,33,113,0,0
5659,654,303,897,881,12,13,7,243,578,34,113,0,0
5660,720,293,957,872,12,13,7,237,579,35,113,0,0
5661,804,296,1043,878,12,13,7,239,582,36,113,0,0
5662,863,299,1105,874,12,13,7,242,575,37,113,0,0
5663,930,299,1167,878,12,13,7,237,579,38,113,0,0
5664,1007,289,1248,886,12,13,7,241,597,39,113,0,0
5665,1059,285,1307,887,12,13,7,248,602,40,113,0,0
5666,1135,265,1377,874,12,13,7,242,609,41,113,0,0
5667,1212,270,1436,839,12,13,7,224,569,42,113,0,0
5668,1265,266,1490,821,12,13,7,225,555,43,113,0,0
5669,1321,251,1538,793,12,13,7,217,542,44,113,0,0
5670,1377,250,1585,767,12,13,7,208,517,45,113,0,0
5671,1407,239,1622,771,12,13,7,215,532,46,113,0,0
5672,1445,240,1637,724,12,13,7,192,484,47,113,0,0
5673,1468,240,1650,706,12,13,7,182,466,48,113,0,0
5674,1488,233,1666,693,12,13,7,178,460,49,113,0,0
5675,1513,223,1687,671,12,13,7,174,448,50,113,0,0
5676,1528,217,1701,661,12,13,7,173,444,51,113,0,0
5677,1539,211,1706,645,12,13,7,167,434,52,113,0,0
5678,1547,200,1702,607,12,13,7,155,407,53,113,0,0
5679,1553,194,1696,575,12,13,7,143,381,54,113,0,0
5680,1559,189,1696,554,12,13,7,137,365,55,113,0,0
5681,1564,184,1697,537,12,13,7,133,353,56,113,0,0
5682,1565,178,1698,536,12,13,7,133,358,57,113,0,0
5683,1564,174,1692,519,12,13,7,128,345,58,113,0,0
5684,1565,170,1686,499,12,13,7,121,329,59,113,0,0
5685,1568,169,1681,478,12,13,7,113,309,60,113,0,0
5686,1571,165,1681,467,12,13,7,110,302,61,113,0,0
5687,1577,161,1684,456,12,13,7,107,295,62,113,0,0
5688,1580,160,1685,451,12,13,7,105,291,63,113,0,0
5689,1578,156,1679,436,12,13,7,101,280,64,113,0,0
5690,1577,148,1674,418,12,13,7,97,270,65,113,0,0
5691,1580,147,1675,413,12,13,7,95,266,66,113,0,0
5692,1584,143,1677,402,12,13,7,93,259,67,113,0,0
5693,1588,138,1679,394,12,13,7,91,256,68,113,0,0
5694,1590,137,1679,388,12,13,7,89,251,69,113,0,0
5695,1588,134,1674,374,12,13,7,86,240,70,113,0,0
5696,1589,135,1672,365,12,13,7,83,230,71,113,0,0
5697,1591,136,1672,362,12,13,7,81,226,72,113,0,0
5698,1595,134,1672,349,12,13,7,77,215,73,113,0,0
5699,1598,130,1676,348,12,13,7,78,218,74,113,0,0
5700,1598,131,1676,348,12,13,7,78,217,75,113,0,0
5701,1601,127,1677,339,12,13,7,76,212,76,113,0,0
5702,1605,121,1681,335,12,13,7,76,214,77,113,0,0
5703,1610,122,1682,328,12,13,7,72,206,78,113,0,0
5704,1614,119,1684,320,12,13,7,70,201,79,113,0,0
5705,1618,116,1687,315,12,13,7,69,199,80,113,0,0
5706,1619,115,1688,314,12,13,7,69,199,81,113,0,0
5707,1620,117,1685,307,12,13,7,65,190,82,113,0,0
5708,1619,115,1684,304,12,13,7,65,189,83,113,0,0
5709,1619,115,1683,302,12,13,7,64,187,84,113,0,0
5710,1621,114,1683,294,12,13,7,62,180,85,113,0,0
5711,1622,112,1683,290,12,13,7,61,178,86,113,0,0
5712,1621,112,1681,290,12,13,7,60,178,87,113,0,0
5713,1619,112,1676,280,12,13,7,57,168,88,113,0,0
5714,1617,109,1674,279,12,13,7,57,170,89,113,0,0
5715,1617,109,1673,274,12,13,7,56,165,90,113,0,0
5716,1618,110,1671,267,12,13,7,53,157,91,113,0,0
5717,1619,111,1671,262,12,13,7,52,151,92,113,0,0
5718,1617,111,1669,262,12,13,7,52,151,93,113,0,0
5719,1618,110,1667,255,12,13,7,49,145,94,113,0,0
5720,1618,114,1666,254,12,13,7,48,140,95,113,0,0
5721,1619,116,1664,252,12,13,7,45,136,96,113,0,0
5722,1619,113,1664,247,12,13,7,45,134,97,113,0,0
5723,1618,110,1663,245,12,13,7,45,135,98,113,0,0
5724,1617,110,1661,242,12,13,7,44,132,99,113,0,0
5725,1616,109,1659,237,12,13,7,43,128,100,113,0,0
5726,1615,108,1658,240,12,13,7,43,132,101,113,0,0
5727,1615,105,1658,238,12,13,7,43,133,102,113,0,0
5728,1615,107,1655,231,12,13,7,40,124,103,113,0,0
5729,1616,106,1656,227,12,13,7,40,121,104,113,0,0
5730,1616,106,1655,224,12,13,7,39,118,105,113,0,0
5731,1616,99,1656,221,12,13,7,40,122,106,113,0,0
5732,1616,97,1656,221,12,13,7,40,124,107,113,0,0
5733,1616,99,1655,218,12,13,7,39,119,108,113,0,0
5734,1617,98,1655,215,12,13,7,38,117,109,113,0,0
5735,1618,100,1654,214,12,13,7,36,114,110,113,0,0
5736,1618,100,1653,210,12,13,7,35,110,111,113,0,0
5737,1618,101,1653,208,12,13,7,35,107,112,113,0,0
5738,1617,98,1652,207,12,13,7,35,109,113,113,1,0
387,418,575,602,986,1,13,8,184,411,0,8,0,0
388,418,525,647,1038,1,13,8,229,513,1,8,0,0
389,432,540,664,1059,1,13,8,232,519,2,8,0,0
390,435,570,659,1069,1,13,8,224,499,3,8,0,0
391,445,613,656,1075,1,13,8,211,462,4,8,0,0
392,462,666,660,1079,1,13,8,198,413,5,8,0,0
393,477,707,666,1073,1,13,8,189,366,6,8,0,0
394,463,774,633,1077,1,13,8,170,303,7,8,0,0
395,472,811,625,1080,1,13,8,153,269,8,8,0,0
959,1113,776,1408,1079,1,13,9,295,303,0,0,0,0
960,896,694,1262,1080,2,13,9,366,386,0,10,0,0
961,740,608,1183,1078,2,13,9,443,470,1,10,0,0
962,619,562,1103,1079,2,13,9,484,517,2,10,0,0
963,505,517,1019,1076,2,13,9,514,559,3,10,0,0
964,402,478,942,1078,2,13,9,540,600,4,10,0,0
965,312,472,848,1079,2,13,9,536,607,5,10,0,0
966,181,455,715,1077,2,13,9,534,622,6,10,0,0
967,85,459,588,1058,2,13,9,503,599,7,10,0,0
968,0,458,437,1006,2,13,9,437,548,8,10,0,0
969,0,471,348,1045,2,13,9,348,574,9,10,0,0
970,0,455,262,1042,2,13,9,262,587,10,10,0,0
970,3,606,157,1080,3,13,9,154,474,0,0,0,0
981,2,494,132,1040,4,13,9,130,546,0,1,0,0
982,53,454,187,1012,4,13,9,134,558,1,1,0,0
983,87,434,441,1072,5,13,9,354,638,0,59,0,1
984,130,400,504,1078,5,13,9,374,678,1,59,0,0
985,218,394,586,1059,5,13,9,368,665,2,59,0,0
986,311,374,660,1013,5,13,9,349,639,3,59,0,0
987,379,345,721,978,5,13,9,342,633,4,59,0,0
988,423,327,754,947,5,13,9,331,620,5,59,0,0
989,469,305,762,864,5,13,9,293,559,6,59,0,0
990,498,298,766,821,5,13,9,268,523,7,59,0,0
991,528,273,770,753,5,13,9,242,480,8,59,0,0
992,535,263,765,728,5,13,9,230,465,9,59,0,0
993,543,243,753,678,5,13,9,210,435,10,59,0,0
994,545,233,743,648,5,13,9,198,415,11,59,0,0
995,554,230,735,614,5,13,9,181,384,12,59,0,0
996,560,218,731,584,5,13,9,171,366,13,59,0,0
997,556,212,719,569,5,13,9,163,357,14,59,0,0
998,551,206,700,534,5,13,9,149,328,15,59,0,0
999,543,205,685,523,5,13,9,142,318,16,59,0,0
1000,543,189,677,493,5,13,9,134,304,17,59,0,0
1001,540,185,667,477,5,13,9,127,292,18,59,0,0
1002,543,192,660,461,5,13,9,117,269,19,59,0,0
1003,545,189,654,448,5,13,9,109,259,20,59,0,0
1004,542,178,650,441,5,13,9,108,263,21,59,0,0
1005,541,160,645,417,5,13,9,104,257,22,59,0,0
1006,537,156,638,409,5,13,9,101,253,23,59,0,0
1007,533,151,629,394,5,13,9,96,243,24,59,0,0
1008,532,151,623,388,5,13,9,91,237,25,59,0,0
1009,531,158,613,377,5,13,9,82,219,26,59,0,0
1010,523,149,604,366,5,13,9,81,217,27,59,0,0
1011,517,146,597,362,5,13,9,80,216,28,59,0,0
1012,514,139,591,350,5,13,9,77,211,29,59,0,0
1013,512,143,585,345,5,13,9,73,202,30,59,0,0
1014,513,140,583,334,5,13,9,70,194,31,59,0,0
1015,511,144,577,328,5,13,9,66,184,32,59,0,0
1016,508,149,568,318,5,13,9,60,169,33,59,0,0
1017,506,150,565,314,5,13,9,59,164,34,59,0,0
1018,506,144,563,304,5,13,9,57,160,35,59,0,0
1019,506,146,559,299,5,13,9,53,153,36,59,0,0
1020,505,142,558,294,5,13,9,53,152,37,59,0,0
1021,503,138,556,289,5,13,9,53,151,38,59,0,0
1022,505,141,553,283,5,13,9,48,142,39,59,0,0
1023,502,126,553,276,5,13,9,51,150,40,59,0,0
1024,502,129,550,272,5,13,9,48,143,41,59,0,0
1025,500,126,547,267,5,13,9,47,141,42,59,0,0
1026,499,118,547,263,5,13,9,48,145,43,59,0,0
1027,497,108,545,257,5,13,9,48,149,44,59,0,0
1028,498,110,544,254,5,13,9,46,144,45,59,0,0
1029,498,118,540,252,5,13,9,42,134,46,59,0,0
1030,497,112,541,249,5,13,9,44,137,47,59,0,0
1031,497,111,541,249,5,13,9,44,138,48,59,0,0
1032,497,108,541,244,5,13,9,44,136,49,59,0,0
1033,497,112,538,242,5,13,9,41,130,50,59,0,0
1034,496,109,536,238,5,13,9,40,129,51,59,0,0
1035,495,105,534,233,5,13,9,39,128,52,59,0,0
1036,495,105,532,229,5,13,9,37,124,53,59,0,0
1037,493,102,530,227,5,13,9,37,125,54,59,0,0
1038,492,104,529,227,5,13,9,37,123,55,59,0,0
1039,491,102,527,224,5,13,9,36,122,56,59,0,0
1040,490,98,527,223,5,13,9,37,125,57,59,0,0
1041,492,100,527,219,5,13,9,35,119,58,59,0,0
1042,491,100,526,218,5,13,9,35,118,59,59,1,0
780,1577,153,1612,297,1,15,1,35,144,0,28,0,1
781,1576,153,1612,298,1,15,1,36,145,1,28,0,0
782,1575,159,1610,300,1,15,1,35,141,2,28,0,0
783,1568,157,1605,304,1,15,1,37,147,3,28,0,0
784,1564,157,1602,309,1,15,1,38,152,4,28,0,0
785,1566,155,1606,312,1,15,1,40,157,5,28,0,0
786,1569,159,1609,315,1,15,1,40,156,6,28,0,0
787,1570,160,1611,320,1,15,1,41,160,7,28,0,0
788,1567,161,1609,323,1,15,1,42,162,8,28,0,0
789,1563,161,1606,327,1,15,1,43,166,9,28,0,0
790,1561,164,1606,331,1,15,1,45,167,10,28,0,0
791,1559,163,1604,332,1,15,1,45,169,11,28,0,0
792,1552,166,1598,335,1,15,1,46,169,12,28,0,0
793,1539,165,1585,334,1,15,1,46,169,13,28,0,0
794,1522,167,1568,339,1,15,1,46,172,14,28,0,0
795,1505,171,1552,342,1,15,1,47,171,15,28,0,0
796,1486,168,1534,347,1,15,1,48,179,16,28,0,0
797,1466,171,1517,348,1,15,1,51,177,17,28,0,0
798,1445,170,1497,348,1,15,1,52,178,18,28,0,0
799,1427,170,1478,345,1,15,1,51,175,19,28,0,0
800,1405,169,1459,347,1,15,1,54,178,20,28,0,0
801,1378,169,1431,343,1,15,1,53,174,21,28,0,0
802,1358,169,1410,337,1,15,1,52,168,22,28,0,0
803,1338,169,1387,330,1,15,1,49,161,23,28,0,0
804,1313,166,1363,329,1,15,1,50,163,24,28,0,0
805,1293,170,1345,331,1,15,1,52,161,25,28,0,0
806,1268,170,1318,328,1,15,1,50,158,26,28,0,0
807,1251,170,1300,332,1,15,1,49,162,27,28,0,0
808,1233,170,1282,332,1,15,1,49,162,28,28,1,0
917,1259,182,1304,358,2,15,1,45,176,0,26,0,1
918,1262,176,1308,358,2,15,1,46,182,1,26,0,0
919,1282,173,1329,355,2,15,1,47,182,2,26,0,0
920,1305,175,1353,358,2,15,1,48,183,3,26,0,0
921,1322,175,1370,360,2,15,1,48,185,4,26,0,0
922,1339,174,1390,363,2,15,1,51,189,5,26,0,0
923,1358,174,1409,364,2,15,1,51,190,6,26,0,0
924,1380,174,1432,365,2,15,1,52,191,7,26,0,0
925,1400,172,1456,368,2,15,1,56,196,8,26,0,0
926,1423,173,1478,370,2,15,1,55,197,9,26,0,0
927,1437,173,1491,366,2,15,1,54,193,10,26,0,0
928,1446,171,1499,362,2,15,1,53,191,11,26,0,0
929,1460,172,1511,358,2,15,1,51,186,12,26,0,0
930,1475,173,1527,358,2,15,1,52,185,13,26,0,0
931,1485,169,1538,357,2,15,1,53,188,14,26,0,0
932,1497,169,1547,349,2,15,1,50,180,15,26,0,0
933,1503,171,1552,344,2,15,1,49,173,16,26,0,0
934,1508,168,1557,340,2,15,1,49,172,17,26,0,0
935,1516,165,1565,336,2,15,1,49,171,18,26,0,0
936,1524,164,1572,332,2,15,1,48,168,19,26,0,0
937,1532,162,1578,328,2,15,1,46,166,20,26,0,0
938,1536,162,1582,329,2,15,1,46,167,21,26,0,0
939,1539,161,1583,323,2,15,1,44,162,22,26,0,0
940,1542,160,1585,318,2,15,1,43,158,23,26,0,0
941,1546,155,1588,314,2,15,1,42,159,24,26,0,0
942,1548,146,1592,313,2,15,1,44,167,25,26,0,0
943,1556,144,1599,310,2,15,1,43,166,26,26,1,0
945,1553,146,1593,301,2,15,1,40,155,0,26,0,0
946,1559,145,1598,298,2,15,1,39,153,1,26,0,0
947,1564,151,1600,290,2,15,1,36,139,2,26,0,0
948,1566,147,1604,297,2,15,1,38,150,3,26,0,0
949,1569,148,1605,292,2,15,1,36,144,4,26,0,0
950,1574,146,1609,287,2,15,1,35,141,5,26,0,0
3298,1262,202,1322,436,3,15,1,60,234,0,32,0,1
3299,1267,207,1326,436,3,15,1,59,229,1,32,0,0
3300,1276,212,1334,435,3,15,1,58,223,2,32,0,0
3301,1287,215,1348,449,3,15,1,61,234,3,32,0,0
3302,1300,223,1363,456,3,15,1,63,233,4,32,0,0
3303,1311,228,1378,471,3,15,1,67,243,5,32,0,0
3304,1327,231,1399,483,3,15,1,72,252,6,32,0,0
3305,1337,237,1413,501,3,15,1,76,264,7,32,0,0
3306,1345,242,1426,517,3,15,1,81,275,8,32,0,0
3307,1350,245,1438,535,3,15,1,88,290,9,32,0,0
3308,1354,250,1447,552,3,15,1,93,302,10,32,0,0
3309,1360,253,1456,560,3,15,1,96,307,11,32,0,0
3310,1361,265,1461,586,3,15,1,100,321,12,32,0,0
3311,1361,271,1464,596,3,15,1,103,325,13,32,0,0
3312,1357,282,1467,625,3,15,1,110,343,14,32,0,0
3313,1359,291,1477,654,3,15,1,118,363,15,32,0,0
3314,1356,298,1479,670,3,15,1,123,372,16,32,0,0
3315,1347,318,1478,714,3,15,1,131,396,17,32,0,0
3316,1341,328,1477,731,3,15,1,136,403,18,32,0,0
3317,1336,348,1483,778,3,15,1,147,430,19,32,0,0
3318,1339,357,1496,810,3,15,1,157,453,20,32,0,0
3319,1328,370,1499,857,3,15,1,171,487,21,32,0,0
3320,1317,386,1501,906,3,15,1,184,520,22,32,0,0
3321,1311,407,1507,948,3,15,1,196,541,23,32,0,0
3322,1298,445,1508,1016,3,15,1,210,571,24,32,0,0
3323,1289,479,1506,1057,3,15,1,217,578,25,32,0,0
3324,1268,523,1484,1077,3,15,1,216,554,26,32,0,0
3325,1241,564,1454,1080,3,15,1,213,516,27,32,0,0
3326,1201,616,1412,1080,3,15,1,211,464,28,32,0,0
3327,1169,689,1365,1080,3,15,1,196,391,29,32,0,0
3328,1123,760,1308,1080,3,15,1,185,320,30,32,0,0
3329,1052,867,1198,1080,3,15,1,146,213,31,32,0,0
3330,1033,914,1159,1080,3,15,1,126,166,32,32,1,0
3689,818,370,1465,1040,5,15,1,647,670,0,1,0,0
3690,834,326,1522,1038,5,15,1,688,712,1,1,0,0
3690,1060,362,1280,945,6,15,1,220,583,0,55,0,1
3691,1066,351,1287,938,6,15,1,221,587,1,55,0,0
3692,1084,349,1296,915,6,15,1,212,566,2,55,0,0
3693,1120,323,1316,844,6,15,1,196,521,3,55,0,0
3694,1147,308,1336,815,6,15,1,189,507,4,55,0,0
3695,1167,295,1351,794,6,15,1,184,499,5,55,0,0
3696,1190,278,1362,746,6,15,1,172,468,6,55,0,0
3697,1209,270,1376,728,6,15,1,167,458,7,55,0,0
3698,1226,260,1389,705,6,15,1,163,445,8,55,0,0
3699,1244,248,1396,667,6,15,1,152,419,9,55,0,0
3700,1257,241,1405,652,6,15,1,148,411,10,55,0,0
3701,1276,234,1416,627,6,15,1,140,393,11,55,0,0
3702,1297,228,1430,604,6,15,1,133,376,12,55,0,0
3703,1310,228,1438,595,6,15,1,128,367,13,55,0,0
3704,1326,221,1446,568,6,15,1,120,347,14,55,0,0
3705,1338,215,1454,553,6,15,1,116,338,15,55,0,0
3706,1350,214,1464,548,6,15,1,114,334,16,55,0,0
3707,1366,206,1475,530,6,15,1,109,324,17,55,0,0
3708,1377,204,1483,521,6,15,1,106,317,18,55,0,0
3709,1384,204,1486,511,6,15,1,102,307,19,55,0,0
3710,1389,198,1488,496,6,15,1,99,298,20,55,0,0
3711,1395,195,1487,475,6,15,1,92,280,21,55,0,0
3712,1400,196,1490,472,6,15,1,90,276,22,55,0,0
3713,1404,193,1492,460,6,15,1,88,267,23,55,0,0
3714,1406,189,1494,454,6,15,1,88,265,24,55,0,0
3715,1406,184,1492,443,6,15,1,86,259,25,55,0,0
3716,1405,180,1487,428,6,15,1,82,248,26,55,0,0
3717,1407,183,1486,419,6,15,1,79,236,27,55,0,0
3718,1409,178,1488,414,6,15,1,79,236,28,55,0,0
3719,1412,174,1489,406,6,15,1,77,232,29,55,0,0
3720,1413,173,1489,403,6,15,1,76,230,30,55,0,0
3721,1413,170,1488,397,6,15,1,75,227,31,55,0,0
3722,1414,165,1487,384,6,15,1,73,219,32,55,0,0
3723,1417,165,1489,382,6,15,1,72,217,33,55,0,0
3724,1422,166,1491,374,6,15,1,69,208,34,55,0,0
3725,1426,163,1493,369,6,15,1,67,206,35,55,0,0
3726,1426,163,1492,368,6,15,1,66,205,36,55,0,0
3727,1429,159,1492,356,6,15,1,63,197,37,55,0,0
3728,1434,159,1496,352,6,15,1,62,193,38,55,0,0
3729,1437,157,1499,349,6,15,1,62,192,39,55,0,0
3730,1441,152,1501,340,6,15,1,60,188,40,55,0,0
3731,1443,150,1503,338,6,15,1,60,188,41,55,0,0
3732,1444,149,1503,336,6,15,1,59,187,42,55,0,0
3733,1444,147,1503,331,6,15,1,59,184,43,55,0,0
3734,1445,147,1502,329,6,15,1,57,182,44,55,0,0
3735,1448,149,1504,327,6,15,1,56,178,45,55,0,0
3736,1452,148,1505,316,6,15,1,53,168,46,55,0,0
3737,1452,147,1504,314,6,15,1,52,167,47,55,0,0
3738,1450,144,1501,306,6,15,1,51,162,48,55,0,0
3739,1447,142,1498,302,6,15,1,51,160,49,55,0,0
3740,1445,142,1496,304,6,15,1,51,162,50,55,0,0
3741,1440,142,1492,302,6,15,1,52,160,51,55,0,0
3742,1435,140,1485,296,6,15,1,50,156,52,55,0,0
3743,1429,141,1478,292,6,15,1,49,151,53,55,0,0
3744,1421,140,1469,290,6,15,1,48,150,54,55,0,0
3745,1419,139,1466,286,6,15,1,47,147,55,55,1,0
4798,1262,177,1318,431,7,15,1,56,254,0,30,0,1
4799,1270,178,1328,439,7,15,1,58,261,1,30,0,0
4800,1278,182,1337,441,7,15,1,59,259,2,30,0,0
4801,1304,187,1365,450,7,15,1,61,263,3,30,0,0
4802,1322,194,1385,461,7,15,1,63,267,4,30,0,0
4803,1333,193,1401,472,7,15,1,68,279,5,30,0,0
4804,1342,203,1415,497,7,15,1,73,294,6,30,0,0
4805,1353,205,1429,505,7,15,1,76,300,7,30,0,0
4806,1357,208,1441,530,7,15,1,84,322,8,30,0,0
4807,1361,212,1449,546,7,15,1,88,334,9,30,0,0
4808,1364,218,1455,560,7,15,1,91,342,10,30,0,0
4809,1360,228,1458,589,7,15,1,98,361,11,30,0,0
4810,1355,233,1456,600,7,15,1,101,367,12,30,0,0
4811,1348,243,1455,627,7,15,1,107,384,13,30,0,0
4812,1340,251,1454,656,7,15,1,114,405,14,30,0,0
4813,1331,255,1452,674,7,15,1,121,419,15,30,0,0
4814,1318,264,1450,720,7,15,1,132,456,16,30,0,0
4815,1300,264,1439,739,7,15,1,139,475,17,30,0,0
4816,1283,279,1439,801,7,15,1,156,522,18,30,0,0
4817,1263,289,1431,841,7,15,1,168,552,19,30,0,0
4818,1240,302,1418,881,7,15,1,178,579,20,30,0,0
4819,1215,329,1404,941,7,15,1,189,612,21,30,0,0
4820,1185,339,1387,996,7,15,1,202,657,22,30,0,0
4821,1157,370,1373,1054,7,15,1,216,684,23,30,0,0
4822,1125,398,1347,1078,7,15,1,222,680,24,30,0,0
4823,1100,430,1322,1080,7,15,1,222,650,25,30,0,0
4824,1066,477,1282,1080,7,15,1,216,603,26,30,0,0
4825,1015,517,1230,1080,7,15,1,215,563,27,30,0,0
4826,973,599,1180,1080,7,15,1,207,481,28,30,0,0
4827,905,701,1096,1080,7,15,1,191,379,29,30,0,0
4828,883,737,1066,1080,7,15,1,183,343,30,30,1,0
4828,754,842,974,1069,8,15,1,220,227,0,0,0,0
4866,1280,159,1317,350,9,15,1,37,191,0,35,0,1
4867,1299,158,1337,354,9,15,1,38,196,1,35,0,0
4868,1319,159,1359,356,9,15,1,40,197,2,35,0,0
4869,1347,158,1389,357,9,15,1,42,199,3,35,0,0
4870,1367,156,1411,354,9,15,1,44,198,4,35,0,0
4871,1376,157,1416,331,9,15,1,40,174,5,35,0,0
4872,1387,163,1427,336,9,15,1,40,173,6,35,0,0
4873,1404,161,1444,332,9,15,1,40,171,7,35,0,0
4874,1420,157,1461,327,9,15,1,41,170,8,35,0,0
4875,1432,156,1474,326,9,15,1,42,170,9,35,0,0
4876,1442,152,1487,326,9,15,1,45,174,10,35,0,0
4877,1451,149,1497,324,9,15,1,46,175,11,35,0,0
4878,1461,149,1507,321,9,15,1,46,172,12,35,0,0
4879,1469,148,1516,319,9,15,1,47,171,13,35,0,0
4880,1475,149,1520,311,9,15,1,45,162,14,35,0,0
4881,1476,150,1520,307,9,15,1,44,157,15,35,0,0
4882,1478,149,1523,305,9,15,1,45,156,16,35,0,0
4883,1480,148,1525,303,9,15,1,45,155,17,35,0,0
4884,1484,147,1529,299,9,15,1,45,152,18,35,0,0
4885,1489,144,1535,299,9,15,1,46,155,19,35,0,0
4886,1494,145,1539,297,9,15,1,45,152,20,35,0,0
4887,1499,144,1543,293,9,15,1,44,149,21,35,0,0
4888,1504,146,1547,288,9,15,1,43,142,22,35,0,0
4889,1511,146,1553,287,9,15,1,42,141,23,35,0,0
4890,1518,144,1560,282,9,15,1,42,138,24,35,0,0
4891,1524,141,1566,280,9,15,1,42,139,25,35,0,0
4892,1530,143,1571,276,9,15,1,41,133,26,35,0,0
4893,1536,140,1577,276,9,15,1,41,136,27,35,0,0
4894,1543,139,1584,273,9,15,1,41,134,28,35,0,0
4895,1550,140,1590,270,9,15,1,40,130,29,35,0,0
4896,1561,138,1603,274,9,15,1,42,136,30,35,0,0
4897,1571,140,1612,274,9,15,1,41,134,31,35,0,0
4898,1582,140,1622,272,9,15,1,40,132,32,35,0,0
4899,1599,141,1636,265,9,15,1,37,124,33,35,0,0
4900,1611,145,1648,266,9,15,1,37,121,34,35,0,0
4901,1621,146,1657,264,9,15,1,36,118,35,35,1,0
4871,1386,162,1450,351,10,15,1,64,189,0,27,0,1
4872,1409,172,1471,354,10,15,1,62,182,1,27,0,0
4873,1429,173,1489,353,10,15,1,60,180,2,27,0,0
4874,1454,175,1514,351,10,15,1,60,176,3,27,0,0
4875,1469,177,1527,348,10,15,1,58,171,4,27,0,0
4876,1485,176,1541,343,10,15,1,56,167,5,27,0,0
4877,1498,174,1556,342,10,15,1,58,168,6,27,0,0
4878,1509,173,1565,337,10,15,1,56,164,7,27,0,0
4879,1522,172,1577,334,10,15,1,55,162,8,27,0,0
4880,1531,174,1586,329,10,15,1,55,155,9,27,0,0
4881,1534,174,1588,329,10,15,1,54,155,10,27,0,0
4882,1535,170,1588,323,10,15,1,53,153,11,27,0,0
4883,1539,170,1590,318,10,15,1,51,148,12,27,0,0
4884,1541,167,1592,319,10,15,1,51,152,13,27,0,0
4885,1541,162,1595,318,10,15,1,54,156,14,27,0,0
4886,1542,160,1596,317,10,15,1,54,157,15,27,0,0
4887,1547,159,1597,307,10,15,1,50,148,16,27,0,0
4888,1547,158,1597,308,10,15,1,50,150,17,27,0,0
4889,1551,159,1598,302,10,15,1,47,143,18,27,0,0
4890,1555,156,1603,299,10,15,1,48,143,19,27,0,0
4891,1561,155,1608,295,10,15,1,47,140,20,27,0,0
4892,1569,155,1615,292,10,15,1,46,137,21,27,0,0
4893,1578,154,1623,291,10,15,1,45,137,22,27,0,0
4894,1587,155,1630,285,10,15,1,43,130,23,27,0,0
4895,1597,154,1639,284,10,15,1,42,130,24,27,0,0
4896,1609,153,1651,284,10,15,1,42,131,25,27,0,0
4897,1622,157,1661,280,10,15,1,39,123,26,27,0,0
4898,1630,156,1668,277,10,15,1,38,121,27,27,1,0
5457,1263,193,1318,425,11,15,1,55,232,0,38,0,1
5458,1273,193,1329,428,11,15,1,56,235,1,38,0,0
5459,1282,195,1338,425,11,15,1,56,230,2,38,0,0
5460,1295,195,1352,427,11,15,1,57,232,3,38,0,0
5461,1308,198,1372,444,11,15,1,64,246,4,38,0,0
5462,1335,200,1401,452,11,15,1,66,252,5,38,0,0
5463,1359,203,1430,467,11,15,1,71,264,6,38,0,0
5464,1379,210,1451,478,11,15,1,72,268,7,38,0,0
5465,1398,212,1473,485,11,15,1,75,273,8,38,0,0
5466,1412,219,1488,495,11,15,1,76,276,9,38,0,0
5467,1425,220,1503,502,11,15,1,78,282,10,38,0,0
5468,1437,226,1520,521,11,15,1,83,295,11,38,0,0
5469,1453,232,1539,534,11,15,1,86,302,12,38,0,0
5470,1465,239,1554,549,11,15,1,89,310,13,38,0,0
5471,1472,245,1567,573,11,15,1,95,328,14,38,0,0
5472,1477,251,1573,579,11,15,1,96,328,15,38,0,0
5473,1483,259,1584,600,11,15,1,101,341,16,38,0,0
5474,1487,267,1592,619,11,15,1,105,352,17,38,0,0
5475,1486,273,1600,643,11,15,1,114,370,18,38,0,0
5476,1481,281,1600,666,11,15,1,119,385,19,38,0,0
5477,1474,291,1598,686,11,15,1,124,395,20,38,0,0
5478,1473,300,1603,713,11,15,1,130,413,21,38,0,0
5479,1470,309,1607,738,11,15,1,137,429,22,38,0,0
5480,1465,318,1612,774,11,15,1,147,456,23,38,0,0
5481,1457,332,1610,805,11,15,1,153,473,24,38,0,0
5482,1444,342,1603,827,11,15,1,159,485,25,38,0,0
5483,1433,358,1607,890,11,15,1,174,532,26,38,0,0
5484,1424,375,1602,917,11,15,1,178,542,27,38,0,0
5485,1412,392,1598,959,11,15,1,186,567,28,38,0,0
5486,1387,412,1587,1019,11,15,1,200,607,29,38,0,0
5487,1357,436,1563,1052,11,15,1,206,616,30,38,0,0
5488,1331,465,1541,1077,11,15,1,210,612,31,38,0,0
5489,1310,498,1519,1080,11,15,1,209,582,32,38,0,0
5490,1302,540,1505,1080,11,15,1,203,540,33,38,0,0
5491,1272,595,1469,1080,11,15,1,197,485,34,38,0,0
5492,1229,651,1424,1079,11,15,1,195,428,35,38,0,0
5493,1210,726,1395,1080,11,15,1,185,354,36,38,0,0
5494,1210,822,1368,1080,11,15,1,158,258,37,38,0,0
5495,1235,969,1321,1080,11,15,1,86,111,38,38,1,0
2509,565,302,633,561,1,15,10,68,259,0,92,0,1
2510,554,308,625,575,1,15,10,71,267,1,92,0,0
2511,555,302,629,580,1,15,10,74,278,2,92,0,0
2512,551,304,630,604,1,15,10,79,300,3,92,0,0
2513,543,301,626,615,1,15,10,83,314,4,92,0,0
2514,522,301,609,624,1,15,10,87,323,5,92,0,0
2515,507,309,597,637,1,15,10,90,328,6,92,0,0
2516,482,315,577,647,1,15,10,95,332,7,92,0,0
2517,462,322,567,669,1,15,10,105,347,8,92,0,0
2518,453,328,566,687,1,15,10,113,359,9,92,0,0
2519,449,326,571,699,1,15,10,122,373,10,92,0,0
2520,445,338,578,732,1,15,10,133,394,11,92,0,0
2521,444,346,585,749,1,15,10,141,403,12,92,0,0
2522,444,349,596,773,1,15,10,152,424,13,92,0,0
2523,454,362,614,800,1,15,10,160,438,14,92,0,0
2524,470,367,638,818,1,15,10,168,451,15,92,0,0
2525,483,382,666,863,1,15,10,183,481,16,92,0,0
2526,492,396,684,891,1,15,10,192,495,17,92,0,0
2527,511,405,705,905,1,15,10,194,500,18,92,0,0
2528,552,425,755,942,1,15,10,203,517,19,92,0,0
2529,586,440,789,964,1,15,10,203,524,20,92,0,0
2530,631,448,837,992,1,15,10,206,544,21,92,0,0
2531,674,468,876,1009,1,15,10,202,541,22,92,0,0
2532,705,483,905,1021,1,15,10,200,538,23,92,0,0
2533,731,496,932,1024,1,15,10,201,528,24,92,0,0
2534,753,499,963,1030,1,15,10,210,531,25,92,0,0
2535,762,509,978,1033,1,15,10,216,524,26,92,0,0
2536,764,515,986,1033,1,15,10,222,518,27,92,0,0
2537,762,517,991,1032,1,15,10,229,515,28,92,0,0
2538,760,517,997,1032,1,15,10,237,515,29,92,0,0
2539,759,516,1003,1032,1,15,10,244,516,30,92,0,0
2540,760,514,1007,1031,1,15,10,247,517,31,92,0,0
2541,755,514,1006,1033,1,15,10,251,519,32,92,0,0
2542,752,522,1008,1047,1,15,10,256,525,33,92,0,0
2543,760,539,1015,1051,1,15,10,255,512,34,92,0,0
2544,772,550,1028,1053,1,15,10,256,503,35,92,0,0
2545,777,554,1038,1053,1,15,10,261,499,36,92,0,0
2546,776,553,1043,1053,1,15,10,267,500,37,92,0,0
2547,759,547,1033,1052,1,15,10,274,505,38,92,0,0
2548,726,527,1012,1052,1,15,10,286,525,39,92,0,0
2549,690,499,984,1049,1,15,10,294,550,40,92,0,0
2550,661,467,949,1021,1,15,10,288,554,41,92,0,0
2551,628,444,905,993,1,15,10,277,549,42,92,0,0
2552,602,437,870,987,1,15,10,268,550,43,92,0,0
2553,589,429,843,970,1,15,10,254,541,44,92,0,0
2554,574,406,807,919,1,15,10,233,513,45,92,0,0
2555,541,396,763,894,1,15,10,222,498,46,92,0,0
2556,524,390,732,861,1,15,10,208,471,47,92,0,0
2557,489,371,686,828,1,15,10,197,457,48,92,0,0
2558,459,361,650,816,1,15,10,191,455,49,92,0,0
2559,433,354,610,788,1,15,10,177,434,50,92,0,0
2560,400,342,568,761,1,15,10,168,419,51,92,0,0
2561,369,340,531,747,1,15,10,162,407,52,92,0,0
2562,348,333,497,717,1,15,10,149,384,53,92,0,0
2563,324,322,468,705,1,15,10,144,383,54,92,0,0
2564,307,316,445,696,1,15,10,138,380,55,92,0,0
2565,296,312,423,674,1,15,10,127,362,56,92,0,0
2566,274,306,399,662,1,15,10,125,356,57,92,0,0
2567,264,305,386,648,1,15,10,122,343,58,92,0,0
2568,247,295,363,626,1,15,10,116,331,59,92,0,0
2569,229,291,343,619,1,15,10,114,328,60,92,0,0
2570,218,292,326,609,1,15,10,108,317,61,92,0,0
2571,209,285,311,589,1,15,10,102,304,62,92,0,0
2572,196,279,295,576,1,15,10,99,297,63,92,0,0
2573,188,279,281,561,1,15,10,93,282,64,92,0,0
2574,177,272,269,552,1,15,10,92,280,65,92,0,0
2575,168,273,257,546,1,15,10,89,273,66,92,0,0
2576,165,268,250,530,1,15,10,85,262,67,92,0,0
2577,157,264,242,525,1,15,10,85,261,68,92,0,0
2578,149,266,232,526,1,15,10,83,260,69,92,0,0
2579,142,262,221,507,1,15,10,79,245,70,92,0,0
2580,138,261,213,497,1,15,10,75,236,71,92,0,0
2581,137,260,210,491,1,15,10,73,231,72,92,0,0
2582,133,255,205,487,1,15,10,72,232,73,92,0,0
2583,129,254,199,481,1,15,10,70,227,74,92,0,0
2584,127,252,195,474,1,15,10,68,222,75,92,0,0
2585,125,249,193,468,1,15,10,68,219,76,92,0,0
2586,125,248,191,463,1,15,10,66,215,77,92,0,0
2587,124,241,190,459,1,15,10,66,218,78,92,0,0
2588,123,242,186,455,1,15,10,63,213,79,92,0,0
2589,120,240,182,451,1,15,10,62,211,80,92,0,0
2590,118,237,177,439,1,15,10,59,202,81,92,0,0
2591,117,239,174,434,1,15,10,57,195,82,92,0,0
2592,118,238,172,425,1,15,10,54,187,83,92,0,0
2593,116,235,170,423,1,15,10,54,188,84,92,0,0
2594,111,233,164,421,1,15,10,53,188,85,92,0,0
2595,107,220,159,406,1,15,10,52,186,86,92,0,0
2596,105,217,154,395,1,15,10,49,178,87,92,0,0
2597,104,216,152,392,1,15,10,48,176,88,92,0,0
2598,102,223,148,393,1,15,10,46,170,89,92,0,0
2599,99,221,144,387,1,15,10,45,166,90,92,0,0
2600,99,229,142,384,1,15,10,43,155,91,92,0,0
2601,97,228,138,378,1,15,10,41,150,92,92,1,0
2603,93,224,135,374,1,15,10,42,150,0,92,0,0
2604,91,228,131,373,1,15,10,40,145,1,92,0,0
2605,85,226,125,369,1,15,10,40,143,2,92,0,0
2606,79,224,119,364,1,15,10,40,140,3,92,0,0
2607,74,222,112,356,1,15,10,38,134,4,92,0,0
2608,66,221,104,356,1,15,10,38,135,5,92,0,0
2609,57,220,96,357,1,15,10,39,137,6,92,0,0
2610,52,219,91,354,1,15,10,39,135,7,92,0,0
2771,34,279,88,530,2,15,10,54,251,0,23,0,1
2772,65,278,121,534,2,15,10,56,256,1,23,0,0
2773,85,281,143,539,2,15,10,58,258,2,23,0,0
2774,108,275,166,528,2,15,10,58,253,3,23,0,0
2775,137,269,196,524,2,15,10,59,255,4,23,0,0
2776,160,271,221,524,2,15,10,61,253,5,23,0,0
2777,191,267,253,523,2,15,10,62,256,6,23,0,0
2778,222,263,285,518,2,15,10,63,255,7,23,0,0
2779,248,271,313,520,2,15,10,65,249,8,23,0,0
2780,274,270,338,509,2,15,10,64,239,9,23,0,0
2781,302,268,366,506,2,15,10,64,238,10,23,0,0
2782,324,271,392,507,2,15,10,68,236,11,23,0,0
2783,348,267,417,502,2,15,10,69,235,12,23,0,0
2784,382,266,450,502,2,15,10,68,236,13,23,0,0
2785,402,268,474,501,2,15,10,72,233,14,23,0,0
2786,430,268,501,495,2,15,10,71,227,15,23,0,0
2787,456,263,528,493,2,15,10,72,230,16,23,0,0
2788,473,263,550,495,2,15,10,77,232,17,23,0,0
2789,499,271,572,489,2,15,10,73,218,18,23,0,0
2790,529,268,603,488,2,15,10,74,220,19,23,0,0
2791,547,272,622,490,2,15,10,75,218,20,23,0,0
2792,572,273,642,479,2,15,10,70,206,21,23,0,0
2793,592,275,656,474,2,15,10,64,199,22,23,0,0
2794,616,276,679,471,2,15,10,63,195,23,23,1,0
2836,597,280,637,442,3,15,10,40,162,0,25,0,1
2837,580,285,632,497,3,15,10,52,212,1,25,0,0
2838,569,283,627,514,3,15,10,58,231,2,25,0,0
2839,554,278,616,521,3,15,10,62,243,3,25,0,0
2840,521,270,589,525,3,15,10,68,255,4,25,0,0
2841,501,280,568,524,3,15,10,67,244,5,25,0,0
2842,484,278,554,524,3,15,10,70,246,6,25,0,0
2843,463,283,534,530,3,15,10,71,247,7,25,0,0
2844,435,284,510,535,3,15,10,75,251,8,25,0,0
2845,412,282,489,537,3,15,10,77,255,9,25,0,0
2846,376,279,458,543,3,15,10,82,264,10,25,0,0
2847,351,281,436,545,3,15,10,85,264,11,25,0,0
2848,331,282,416,547,3,15,10,85,265,12,25,0,0
2849,302,282,390,555,3,15,10,88,273,13,25,0,0
2850,273,285,364,562,3,15,10,91,277,14,25,0,0
2851,249,281,342,563,3,15,10,93,282,15,25,0,0
2852,218,277,312,568,3,15,10,94,291,16,25,0,0
2853,192,284,288,571,3,15,10,96,287,17,25,0,0
2854,165,288,258,563,3,15,10,93,275,18,25,0,0
2855,134,287,225,564,3,15,10,91,277,19,25,0,0
2856,103,295,197,574,3,15,10,94,279,20,25,0,0
2857,75,297,170,582,3,15,10,95,285,21,25,0,0
2858,40,292,134,580,3,15,10,94,288,22,25,0,0
2859,23,297,117,588,3,15,10,94,291,23,25,0,0
2860,25,391,92,589,3,15,10,67,198,24,25,0,0
2861,2,401,67,593,3,15,10,65,192,25,25,1,0
3328,59,221,104,363,4,15,10,45,142,0,38,0,1
3329,68,223,113,366,4,15,10,45,143,1,38,0,0
3330,75,223,119,362,4,15,10,44,139,2,38,0,0
3331,84,224,129,368,4,15,10,45,144,3,38,0,0
3332,93,227,138,369,4,15,10,45,142,4,38,0,0
3333,104,229,149,370,4,15,10,45,141,5,38,0,0
3334,110,231,155,374,4,15,10,45,143,6,38,0,0
3335,112,227,159,375,4,15,10,47,148,7,38,0,0
3336,115,225,165,385,4,15,10,50,160,8,38,0,0
3337,122,228,171,388,4,15,10,49,160,9,38,0,0
3338,129,227,180,391,4,15,10,51,164,10,38,0,0
3339,134,228,186,395,4,15,10,52,167,11,38,0,0
3340,139,230,190,396,4,15,10,51,166,12,38,0,0
3341,145,230,198,405,4,15,10,53,175,13,38,0,0
3342,151,231,204,408,4,15,10,53,177,14,38,0,0
3343,158,230,213,412,4,15,10,55,182,15,38,0,0
3344,165,229,222,417,4,15,10,57,188,16,38,0,0
3345,170,233,226,420,4,15,10,56,187,17,38,0,0
3346,179,234,237,424,4,15,10,58,190,18,38,0,0
3347,188,236,248,435,4,15,10,60,199,19,38,0,0
3348,196,238,256,438,4,15,10,60,200,20,38,0,0
3349,211,239,272,439,4,15,10,61,200,21,38,0,0
3350,217,238,282,448,4,15,10,65,210,22,38,0,0
3351,234,245,297,451,4,15,10,63,206,23,38,0,0
3352,246,239,312,455,4,15,10,66,216,24,38,0,0
3353,266,246,333,462,4,15,10,67,216,25,38,0,0
3354,283,248,350,464,4,15,10,67,216,26,38,0,0
3355,299,250,366,467,4,15,10,67,217,27,38,0,0
3356,315,256,383,473,4,15,10,68,217,28,38,0,0
3357,339,255,408,479,4,15,10,69,224,29,38,0,0
3358,359,257,432,483,4,15,10,73,226,30,38,0,0
3359,377,258,453,486,4,15,10,76,228,31,38,0,0
3360,409,261,484,492,4,15,10,75,231,32,38,0,0
3361,432,265,511,497,4,15,10,79,232,33,38,0,0
3362,465,269,542,501,4,15,10,77,232,34,38,0,0
3363,492,274,570,503,4,15,10,78,229,35,38,0,0
3364,512,271,598,509,4,15,10,86,238,36,38,0,0
3365,549,273,633,512,4,15,10,84,239,37,38,0,0
3366,570,275,655,517,4,15,10,85,242,38,38,1,0
5207,251,213,288,337,5,15,10,37,124,0,16,0,0
5208,249,219,284,334,5,15,10,35,115,1,16,0,0
5209,230,215,266,334,5,15,10,36,119,2,16,0,0
5210,219,211,256,331,5,15,10,37,120,3,16,0,0
5211,209,213,246,332,5,15,10,37,119,4,16,0,0
5212,192,211,230,332,5,15,10,38,121,5,16,0,0
5213,180,205,219,330,5,15,10,39,125,6,16,0,0
5214,169,206,208,328,5,15,10,39,122,7,16,0,0
5215,163,203,202,326,5,15,10,39,123,8,16,0,0
5216,159,201,197,322,5,15,10,38,121,9,16,0,0
5217,154,201,191,316,5,15,10,37,115,10,16,0,0
5218,151,199,187,312,5,15,10,36,113,11,16,0,0
5219,147,200,183,310,5,15,10,36,110,12,16,0,0
5220,144,198,180,309,5,15,10,36,111,13,16,0,0
5221,142,195,178,307,5,15,10,36,112,14,16,0,0
5222,141,196,176,304,5,15,10,35,108,15,16,0,0
5223,140,195,175,302,5,15,10,35,107,16,16,0,0
368,1,843,144,1077,1,15,12,143,234,0,1,0,0
369,53,839,200,1077,1,15,12,147,238,1,1,0,0
370,132,813,371,1070,2,15,12,239,257,0,110,0,1
371,211,798,463,1069,2,15,12,252,271,1,110,0,0
372,285,798,536,1069,2,15,12,251,271,2,110,0,0
373,354,786,614,1069,2,15,12,260,283,3,110,0,0
374,438,772,714,1071,2,15,12,276,299,4,110,0,0
375,466,754,757,1070,2,15,12,291,316,5,110,0,0
376,467,744,773,1074,2,15,12,306,330,6,110,0,0
377,432,735,745,1069,2,15,12,313,334,7,110,0,0
378,369,720,701,1072,2,15,12,332,352,8,110,0,0
379,331,712,670,1073,2,15,12,339,361,9,110,0,0
380,307,708,650,1072,2,15,12,343,364,10,110,0,0
381,322,706,668,1074,2,15,12,346,368,11,110,0,0
382,396,700,743,1073,2,15,12,347,373,12,110,0,0
383,460,701,798,1077,2,15,12,338,376,13,110,0,0
384,552,705,881,1075,2,15,12,329,370,14,110,0,0
385,662,723,972,1072,2,15,12,310,349,15,110,0,0
386,771,739,1070,1072,2,15,12,299,333,16,110,0,0
387,883,736,1189,1071,2,15,12,306,335,17,110,0,0
388,958,729,1274,1072,2,15,12,316,343,18,110,0,0
389,1002,707,1339,1073,2,15,12,337,366,19,110,0,0
390,1033,695,1378,1072,2,15,12,345,377,20,110,0,0
391,1054,689,1405,1075,2,15,12,351,386,21,110,0,0
392,1066,689,1416,1075,2,15,12,350,386,22,110,0,0
393,1078,691,1421,1073,2,15,12,343,382,23,110,0,0
394,1086,692,1428,1073,2,15,12,342,381,24,110,0,0
395,1084,690,1432,1075,2,15,12,348,385,25,110,0,0
396,1073,689,1424,1076,2,15,12,351,387,26,110,0,0
397,1056,684,1414,1077,2,15,12,358,393,27,110,0,0
398,1022,669,1389,1074,2,15,12,367,405,28,110,0,0
399,981,649,1363,1074,2,15,12,382,425,29,110,0,0
400,943,627,1335,1072,2,15,12,392,445,30,110,0,0
401,916,612,1312,1073,2,15,12,396,461,31,110,0,0
402,890,580,1296,1071,2,15,12,406,491,32,110,0,0
403,854,542,1269,1068,2,15,12,415,526,33,110,0,0
404,801,506,1223,1064,2,15,12,422,558,34,110,0,0
405,740,476,1163,1064,2,15,12,423,588,35,110,0,0
406,682,440,1112,1070,2,15,12,430,630,36,110,0,0
407,646,432,1052,1060,2,15,12,406,628,37,110,0,0
408,621,403,988,1002,2,15,12,367,599,38,110,0,0
409,584,388,928,971,2,15,12,344,583,39,110,0,0
410,561,382,870,922,2,15,12,309,540,40,110,0,0
411,537,359,841,900,2,15,12,304,541,41,110,0,0
412,512,348,797,876,2,15,12,285,528,42,110,0,0
413,494,330,751,823,2,15,12,257,493,43,110,0,0
414,470,320,709,793,2,15,12,239,473,44,110,0,0
415,452,313,672,761,2,15,12,220,448,45,110,0,0
416,428,302,639,743,2,15,12,211,441,46,110,0,0
417,410,293,615,736,2,15,12,205,443,47,110,0,0
418,416,292,601,701,2,15,12,185,409,48,110,0,0
419,405,276,582,678,2,15,12,177,402,49,110,0,0
420,393,268,561,660,2,15,12,168,392,50,110,0,0
421,387,263,545,640,2,15,12,158,377,51,110,0,0
422,387,258,538,626,2,15,12,151,368,52,110,0,0
423,399,250,539,595,2,15,12,140,345,53,110,0,0
424,402,241,538,584,2,15,12,136,343,54,110,0,0
425,402,237,532,568,2,15,12,130,331,55,110,0,0
426,399,230,523,551,2,15,12,124,321,56,110,0,0
427,401,228,517,532,2,15,12,116,304,57,110,0,0
428,415,225,522,509,2,15,12,107,284,58,110,0,0
429,418,215,523,499,2,15,12,105,284,59,110,0,0
430,417,212,519,490,2,15,12,102,278,60,110,0,0
431,413,214,510,480,2,15,12,97,266,61,110,0,0
432,410,208,503,473,2,15,12,93,265,62,110,0,0
433,412,207,500,462,2,15,12,88,255,63,110,0,0
434,411,204,498,457,2,15,12,87,253,64,110,0,0
435,407,205,490,449,2,15,12,83,244,65,110,0,0
436,398,202,477,438,2,15,12,79,236,66,110,0,0
437,395,201,472,432,2,15,12,77,231,67,110,0,0
438,393,200,469,428,2,15,12,76,228,68,110,0,0
439,393,199,465,415,2,15,12,72,216,69,110,0,0
440,389,198,458,406,2,15,12,69,208,70,110,0,0
441,381,195,451,407,2,15,12,70,212,71,110,0,0
442,375,194,443,402,2,15,12,68,208,72,110,0,0
443,371,189,439,400,2,15,12,68,211,73,110,0,0
444,369,183,436,391,2,15,12,67,208,74,110,0,0
445,366,177,434,387,2,15,12,68,210,75,110,0,0
446,358,166,428,385,2,15,12,70,219,76,110,0,0
447,354,165,422,382,2,15,12,68,217,77,110,0,0
448,353,167,418,376,2,15,12,65,209,78,110,0,0
449,357,170,419,372,2,15,12,62,202,79,110,0,0
450,363,170,423,368,2,15,12,60,198,80,110,0,0
451,365,170,424,367,2,15,12,59,197,81,110,0,0
452,367,171,425,367,2,15,12,58,196,82,110,0,0
453,368,170,424,363,2,15,12,56,193,83,110,0,0
454,371,169,425,356,2,15,12,54,187,84,110,0,0
455,376,170,429,355,2,15,12,53,185,85,110,0,0
456,380,168,432,355,2,15,12,52,187,86,110,0,0
457,381,167,432,353,2,15,12,51,186,87,110,0,0
458,381,168,431,350,2,15,12,50,182,88,110,0,0
459,381,163,431,344,2,15,12,50,181,89,110,0,0
460,384,163,433,342,2,15,12,49,179,90,110,0,0
461,387,166,436,345,2,15,12,49,179,91,110,0,0
462,389,157,440,341,2,15,12,51,184,92,110,0,0
463,389,155,440,339,2,15,12,51,184,93,110,0,0
464,387,155,438,337,2,15,12,51,182,94,110,0,0
465,385,153,436,334,2,15,12,51,181,95,110,0,0
466,384,154,434,331,2,15,12,50,177,96,110,0,0
467,384,154,432,325,2,15,12,48,171,97,110,0,0
468,384,153,430,317,2,15,12,46,164,98,110,0,0
469,382,154,426,312,2,15,12,44,158,99,110,0,0
470,376,153,421,312,2,15,12,45,159,100,110,0,0
471,373,154,417,312,2,15,12,44,158,101,110,0,0
472,371,154,414,311,2,15,12,43,157,102,110,0,0
473,368,149,413,310,2,15,12,45,161,103,110,0,0
474,364,151,406,302,2,15,12,42,151,104,110,0,0
475,361,148,402,297,2,15,12,41,149,105,110,0,0
476,357,149,398,295,2,15,12,41,146,106,110,0,0
477,359,153,398,294,2,15,12,39,141,107,110,0,0
478,358,149,397,291,2,15,12,39,142,108,110,0,0
479,357,150,395,285,2,15,12,38,135,109,110,0,0
480,355,157,390,282,2,15,12,35,125,110,110,1,0
484,349,143,384,273,2,15,12,35,130,0,110,0,0
1196,337,123,372,212,4,15,12,35,89,0,93,0,0
1202,337,125,372,219,4,15,12,35,94,0,93,0,0
1203,339,124,375,219,4,15,12,36,95,1,93,0,0
1204,339,124,376,221,4,15,12,37,97,2,93,0,0
1206,343,124,379,219,4,15,12,36,95,0,93,0,0
1207,342,126,379,222,4,15,12,37,96,1,93,0,0
1208,344,128,380,222,4,15,12,36,94,2,93,0,0
1209,346,131,382,223,4,15,12,36,92,3,93,0,0
1211,345,135,380,224,4,15,12,35,89,0,93,0,1
1212,343,133,380,229,4,15,12,37,96,1,93,0,0
1213,343,133,382,234,4,15,12,39,101,2,93,0,0
1214,343,128,384,236,4,15,12,41,108,3,93,0,0
1215,344,135,383,238,4,15,12,39,103,4,93,0,0
1216,343,135,382,238,4,15,12,39,103,5,93,0,0
1217,341,137,380,241,4,15,12,39,104,6,93,0,0
1218,339,136,379,242,4,15,12,40,106,7,93,0,0
1219,338,135,379,245,4,15,12,41,110,8,93,0,0
1220,336,142,376,249,4,15,12,40,107,9,93,0,0
1221,334,145,372,249,4,15,12,38,104,10,93,0,0
1222,332,143,371,250,4,15,12,39,107,11,93,0,0
1223,332,143,370,250,4,15,12,38,107,12,93,0,0
1224,333,144,371,251,4,15,12,38,107,13,93,0,0
1225,332,143,371,254,4,15,12,39,111,14,93,0,0
1226,331,143,370,256,4,15,12,39,113,15,93,0,0
1227,330,142,370,257,4,15,12,40,115,16,93,0,0
1228,333,148,371,260,4,15,12,38,112,17,93,0,0
1229,334,143,376,265,4,15,12,42,122,18,93,0,0
1230,338,145,379,267,4,15,12,41,122,19,93,0,0
1231,340,145,381,268,4,15,12,41,123,20,93,0,0
1232,342,143,383,270,4,15,12,41,127,21,93,0,0
1233,344,147,385,273,4,15,12,41,126,22,93,0,0
1234,348,147,389,273,4,15,12,41,126,23,93,0,0
1235,350,150,390,275,4,15,12,40,125,24,93,0,0
1236,352,155,391,278,4,15,12,39,123,25,93,0,0
1237,351,154,390,282,4,15,12,39,128,26,93,0,0
1238,349,150,392,288,4,15,12,43,138,27,93,0,0
1239,352,151,394,290,4,15,12,42,139,28,93,0,0
1240,352,150,395,293,4,15,12,43,143,29,93,0,0
1241,351,155,394,298,4,15,12,43,143,30,93,0,0
1242,350,157,392,301,4,15,12,42,144,31,93,0,0
1243,348,158,391,304,4,15,12,43,146,32,93,0,0
1244,348,159,391,305,4,15,12,43,146,33,93,0,0
1245,346,159,390,308,4,15,12,44,149,34,93,0,0
1246,344,165,386,310,4,15,12,42,145,35,93,0,0
1247,338,172,380,312,4,15,12,42,140,36,93,0,0
1248,333,171,378,321,4,15,12,45,150,37,93,0,0
1249,331,172,375,324,4,15,12,44,152,38,93,0,0
1250,329,170,374,328,4,15,12,45,158,39,93,0,0
1251,326,173,372,332,4,15,12,46,159,40,93,0,0
1252,323,172,370,335,4,15,12,47,163,41,93,0,0
1253,321,173,368,339,4,15,12,47,166,42,93,0,0
1254,322,176,370,345,4,15,12,48,169,43,93,0,0
1255,325,178,373,349,4,15,12,48,171,44,93,0,0
1256,326,176,376,358,4,15,12,50,182,45,93,0,0
1257,327,179,378,361,4,15,12,51,182,46,93,0,0
1258,329,180,380,363,4,15,12,51,183,47,93,0,0
1259,334,179,387,368,4,15,12,53,189,48,93,0,0
1260,341,178,396,373,4,15,12,55,195,49,93,0,0
1261,348,177,404,380,4,15,12,56,203,50,93,0,0
1262,353,177,410,383,4,15,12,57,206,51,93,0,0
1263,357,175,415,386,4,15,12,58,211,52,93,0,0
1264,366,180,426,393,4,15,12,60,213,53,93,0,0
1265,375,187,434,397,4,15,12,59,210,54,93,0,0
1266,382,192,443,405,4,15,12,61,213,55,93,0,0
1267,385,200,448,415,4,15,12,63,215,56,93,0,0
1268,388,200,451,416,4,15,12,63,216,57,93,0,0
1269,392,201,458,426,4,15,12,66,225,58,93,0,0
1270,398,204,466,431,4,15,12,68,227,59,93,0,0
1271,402,203,471,439,4,15,12,69,236,60,93,0,0
1272,403,207,474,449,4,15,12,71,242,61,93,0,0
1273,402,209,475,456,4,15,12,73,247,62,93,0,0
1274,403,211,477,464,4,15,12,74,253,63,93,0,0
1275,408,222,483,476,4,15,12,75,254,64,93,0,0
1276,414,222,492,482,4,15,12,78,260,65,93,0,0
1277,418,225,498,498,4,15,12,80,273,66,93,0,0
1278,420,228,503,509,4,15,12,83,281,67,93,0,0
1279,422,227,508,519,4,15,12,86,292,68,93,0,0
1280,429,237,517,533,4,15,12,88,296,69,93,0,0
1281,438,240,528,541,4,15,12,90,301,70,93,0,0
1282,444,244,538,563,4,15,12,94,319,71,93,0,0
1283,446,252,543,582,4,15,12,97,330,72,93,0,0
1284,447,255,545,587,4,15,12,98,332,73,93,0,0
1285,455,267,556,607,4,15,12,101,340,74,93,0,0
1286,461,268,566,618,4,15,12,105,350,75,93,0,0
1287,464,273,575,642,4,15,12,111,369,76,93,0,0
1288,461,282,577,671,4,15,12,116,389,77,93,0,0
1289,456,286,574,685,4,15,12,118,399,78,93,0,0
1290,453,291,578,714,4,15,12,125,423,79,93,0,0
1291,456,307,584,737,4,15,12,128,430,80,93,0,0
1292,459,312,590,753,4,15,12,131,441,81,93,0,0
1293,453,326,592,792,4,15,12,139,466,82,93,0,0
1294,445,335,588,814,4,15,12,143,479,83,93,0,0
1295,435,350,587,857,4,15,12,152,507,84,93,0,0
1296,436,369,595,892,4,15,12,159,523,85,93,0,0
1297,433,379,595,910,4,15,12,162,531,86,93,0,0
1298,418,400,592,970,4,15,12,174,570,87,93,0,0
1299,394,419,576,1003,4,15,12,182,584,88,93,0,0
1300,354,432,546,1050,4,15,12,192,618,89,93,0,0
1301,320,467,511,1074,4,15,12,191,607,90,93,0,0
1302,287,487,481,1079,4,15,12,194,592,91,93,0,0
1303,241,516,443,1080,4,15,12,202,564,92,93,0,0
1304,228,530,433,1080,4,15,12,205,550,93,93,1,0
1304,76,557,310,1065,5,15,12,234,508,0,1,0,0
1305,15,569,247,1072,5,15,12,232,503,1,1,0,0
276,341,144,377,266,1,15,13,36,122,0,88,0,1
277,345,134,383,262,1,15,13,38,128,1,88,0,0
278,353,135,392,267,1,15,13,39,132,2,88,0,0
279,359,137,398,268,1,15,13,39,131,3,88,0,0
280,362,138,401,270,1,15,13,39,132,4,88,0,0
281,366,148,403,272,1,15,13,37,124,5,88,0,0
282,371,148,409,274,1,15,13,38,126,6,88,0,0
283,377,147,416,277,1,15,13,39,130,7,88,0,0
284,382,145,423,281,1,15,13,41,136,8,88,0,0
285,384,143,426,281,1,15,13,42,138,9,88,0,0
286,388,140,432,284,1,15,13,44,144,10,88,0,0
287,392,145,436,286,1,15,13,44,141,11,88,0,0
288,400,147,444,288,1,15,13,44,141,12,88,0,0
289,408,144,454,292,1,15,13,46,148,13,88,0,0
290,413,148,460,295,1,15,13,47,147,14,88,0,0
291,418,150,465,298,1,15,13,47,148,15,88,0,0
292,422,155,469,300,1,15,13,47,145,16,88,0,0
293,427,154,476,303,1,15,13,49,149,17,88,0,0
294,434,154,484,306,1,15,13,50,152,18,88,0,0
295,439,157,487,307,1,15,13,48,150,19,88,0,0
296,441,156,490,310,1,15,13,49,154,20,88,0,0
297,443,154,494,314,1,15,13,51,160,21,88,0,0
298,446,155,499,320,1,15,13,53,165,22,88,0,0
299,451,155,505,322,1,15,13,54,167,23,88,0,0
300,454,156,509,326,1,15,13,55,170,24,88,0,0
301,453,156,509,329,1,15,13,56,173,25,88,0,0
302,451,157,509,334,1,15,13,58,177,26,88,0,0
303,451,163,509,340,1,15,13,58,177,27,88,0,0
304,451,163,510,344,1,15,13,59,181,28,88,0,0
305,449,165,509,349,1,15,13,60,184,29,88,0,0
306,442,162,506,359,1,15,13,64,197,30,88,0,0
307,438,161,501,359,1,15,13,63,198,31,88,0,0
308,434,164,498,365,1,15,13,64,201,32,88,0,0
309,436,171,499,369,1,15,13,63,198,33,88,0,0
310,437,173,499,369,1,15,13,62,196,34,88,0,0
311,436,176,499,377,1,15,13,63,201,35,88,0,0
312,434,177,498,380,1,15,13,64,203,36,88,0,0
313,435,180,498,382,1,15,13,63,202,37,88,0,0
314,438,184,503,392,1,15,13,65,208,38,88,0,0
315,445,185,511,397,1,15,13,66,212,39,88,0,0
316,451,187,518,405,1,15,13,67,218,40,88,0,0
317,454,191,522,416,1,15,13,68,225,41,88,0,0
318,458,193,526,416,1,15,13,68,223,42,88,0,0
319,461,195,532,432,1,15,13,71,237,43,88,0,0
320,469,199,540,434,1,15,13,71,235,44,88,0,0
321,477,205,550,443,1,15,13,73,238,45,88,0,0
322,478,212,551,449,1,15,13,73,237,46,88,0,0
323,476,210,551,457,1,15,13,75,247,47,88,0,0
324,474,212,552,473,1,15,13,78,261,48,88,0,0
325,476,211,556,476,1,15,13,80,265,49,88,0,0
326,478,212,559,483,1,15,13,81,271,50,88,0,0
327,474,221,556,494,1,15,13,82,273,51,88,0,0
328,466,226,549,503,1,15,13,83,277,52,88,0,0
329,460,227,546,516,1,15,13,86,289,53,88,0,0
330,458,234,546,531,1,15,13,88,297,54,88,0,0
331,460,238,550,538,1,15,13,90,300,55,88,0,0
332,461,245,554,554,1,15,13,93,309,56,88,0,0
333,456,252,552,573,1,15,13,96,321,57,88,0,0
334,452,252,550,581,1,15,13,98,329,58,88,0,0
335,449,257,553,607,1,15,13,104,350,59,88,0,0
336,456,261,562,620,1,15,13,106,359,60,88,0,0
337,465,263,574,630,1,15,13,109,367,61,88,0,0
338,468,272,580,648,1,15,13,112,376,62,88,0,0
339,467,278,582,664,1,15,13,115,386,63,88,0,0
340,468,284,587,686,1,15,13,119,402,64,88,0,0
341,477,294,602,715,1,15,13,125,421,65,88,0,0
342,490,302,617,728,1,15,13,127,426,66,88,0,0
343,496,313,630,759,1,15,13,134,446,67,88,0,0
344,498,326,634,777,1,15,13,136,451,68,88,0,0
345,493,332,633,795,1,15,13,140,463,69,88,0,0
346,490,344,640,842,1,15,13,150,498,70,88,0,0
347,506,354,661,865,1,15,13,155,511,71,88,0,0
348,521,368,685,907,1,15,13,164,539,72,88,0,0
349,522,390,695,959,1,15,13,173,569,73,88,0,0
350,526,402,701,982,1,15,13,175,580,74,88,0,0
351,535,427,724,1041,1,15,13,189,614,75,88,0,0
352,561,449,754,1069,1,15,13,193,620,76,88,0,0
353,593,467,787,1080,1,15,13,194,613,77,88,0,0
354,626,495,816,1080,1,15,13,190,585,78,88,0,0
355,648,526,832,1080,1,15,13,184,554,79,88,0,0
356,676,558,857,1080,1,15,13,181,522,80,88,0,0
357,725,600,900,1079,1,15,13,175,479,81,88,0,0
358,791,639,964,1080,1,15,13,173,441,82,88,0,0
359,862,684,1030,1077,1,15,13,168,393,83,88,0,0
360,919,738,1077,1075,1,15,13,158,337,84,88,0,0
361,991,800,1132,1070,1,15,13,141,270,85,88,0,0
362,1107,874,1224,1074,1,15,13,117,200,86,88,0,0
363,1233,956,1323,1079,1,15,13,90,123,87,88,0,0
364,1319,1010,1373,1080,1,15,13,54,70,88,88,1,0
1307,1576,878,1731,1066,5,15,13,155,188,0,0,0,0
1313,822,591,1301,1072,6,15,13,479,481,0,68,0,1
1314,723,546,1230,1071,6,15,13,507,525,1,68,0,0
1315,618,520,1129,1063,6,15,13,511,543,2,68,0,0
1316,538,498,1051,1063,6,15,13,513,565,3,68,0,0
1317,444,464,969,1068,6,15,13,525,604,4,68,0,0
1318,380,445,893,1060,6,15,13,513,615,5,68,0,0
1319,318,417,802,1025,6,15,13,484,608,6,68,0,0
1320,261,408,706,987,6,15,13,445,579,7,68,0,0
1321,220,405,634,965,6,15,13,414,560,8,68,0,0
1322,187,391,591,957,6,15,13,404,566,9,68,0,0
1323,186,384,574,945,6,15,13,388,561,10,68,0,0
1324,200,381,575,939,6,15,13,375,558,11,68,0,0
1325,250,373,609,932,6,15,13,359,559,12,68,0,0
1326,266,381,617,929,6,15,13,351,548,13,68,0,0
1327,323,388,655,924,6,15,13,332,536,14,68,0,0
1328,363,386,680,921,6,15,13,317,535,15,68,0,0
1329,404,385,709,924,6,15,13,305,539,16,68,0,0
1330,444,380,737,922,6,15,13,293,542,17,68,0,0
1331,476,381,756,918,6,15,13,280,537,18,68,0,0
1332,505,380,769,908,6,15,13,264,528,19,68,0,0
1333,529,377,782,902,6,15,13,253,525,20,68,0,0
1334,541,377,786,902,6,15,13,245,525,21,68,0,0
1335,554,380,789,901,6,15,13,235,521,22,68,0,0
1336,554,380,784,905,6,15,13,230,525,23,68,0,0
1337,556,381,780,907,6,15,13,224,526,24,68,0,0
1338,560,381,778,907,6,15,13,218,526,25,68,0,0
1339,560,382,774,908,6,15,13,214,526,26,68,0,0
1340,562,381,772,907,6,15,13,210,526,27,68,0,0
1341,562,381,767,907,6,15,13,205,526,28,68,0,0
1342,560,380,763,909,6,15,13,203,529,29,68,0,0
1343,560,380,760,908,6,15,13,200,528,30,68,0,0
1344,562,377,757,904,6,15,13,195,527,31,68,0,0
1345,562,374,756,907,6,15,13,194,533,32,68,0,0
1346,563,375,754,908,6,15,13,191,533,33,68,0,0
1347,565,377,753,907,6,15,13,188,530,34,68,0,0
1348,569,382,753,906,6,15,13,184,524,35,68,0,0
1349,568,378,751,908,6,15,13,183,530,36,68,0,0
1350,573,381,753,906,6,15,13,180,525,37,68,0,0
1351,569,376,751,908,6,15,13,182,532,38,68,0,0
1352,571,377,750,909,6,15,13,179,532,39,68,0,0
1353,568,380,742,898,6,15,13,174,518,40,68,0,0
1354,547,385,717,884,6,15,13,170,499,41,68,0,0
1355,500,384,683,895,6,15,13,183,511,42,68,0,0
1356,434,386,639,905,6,15,13,205,519,43,68,0,0
1357,381,379,609,915,6,15,13,228,536,44,68,0,0
1358,355,372,603,924,6,15,13,248,552,45,68,0,0
1359,340,373,599,923,6,15,13,259,550,46,68,0,0
1360,342,374,607,923,6,15,13,265,549,47,68,0,0
1361,390,373,643,907,6,15,13,253,534,48,68,0,0
1362,434,366,678,896,6,15,13,244,530,49,68,0,0
1363,462,369,700,905,6,15,13,238,536,50,68,0,0
1364,483,365,719,914,6,15,13,236,549,51,68,0,0
1365,500,369,731,923,6,15,13,231,554,52,68,0,0
1366,521,382,739,918,6,15,13,218,536,53,68,0,0
1367,537,390,746,917,6,15,13,209,527,54,68,0,0
1368,548,396,750,917,6,15,13,202,521,55,68,0,0
1369,531,404,733,930,6,15,13,202,526,56,68,0,0
1370,513,410,719,941,6,15,13,206,531,57,68,0,0
1371,490,417,694,952,6,15,13,204,535,58,68,0,0
1372,472,415,684,987,6,15,13,212,572,59,68,0,0
1373,464,420,676,999,6,15,13,212,579,60,68,0,0
1374,462,427,671,1008,6,15,13,209,581,61,68,0,0
1375,455,432,662,1013,6,15,13,207,581,62,68,0,0
1376,429,441,640,1023,6,15,13,211,582,63,68,0,0
1377,401,446,616,1027,6,15,13,215,581,64,68,0,0
1378,341,448,552,1035,6,15,13,211,587,65,68,0,0
1379,294,458,503,1042,6,15,13,209,584,66,68,0,0
1380,252,455,456,1030,6,15,13,204,575,67,68,0,0
1381,231,459,436,1035,6,15,13,205,576,68,68,1,0
3380,827,233,942,527,7,15,13,115,294,0,51,0,1
3381,821,226,932,510,7,15,13,111,284,1,51,0,0
3382,796,221,906,506,7,15,13,110,285,2,51,0,0
3383,757,219,867,502,7,15,13,110,283,3,51,0,0
3384,735,208,843,488,7,15,13,108,280,4,51,0,0
3385,715,204,822,481,7,15,13,107,277,5,51,0,0
3386,689,204,794,475,7,15,13,105,271,6,51,0,0
3387,671,200,769,455,7,15,13,98,255,7,51,0,0
3388,648,194,746,450,7,15,13,98,256,8,51,0,0
3389,632,192,727,442,7,15,13,95,250,9,51,0,0
3390,616,185,708,430,7,15,13,92,245,10,51,0,0
3391,595,179,689,428,7,15,13,94,249,11,51,0,0
3392,585,177,677,419,7,15,13,92,242,12,51,0,0
3393,581,172,669,407,7,15,13,88,235,13,51,0,0
3394,572,170,658,401,7,15,13,86,231,14,51,0,0
3395,562,166,644,390,7,15,13,82,224,15,51,0,0
3396,555,166,634,385,7,15,13,79,219,16,51,0,0
3397,547,168,623,375,7,15,13,76,207,17,51,0,0
3398,540,166,613,369,7,15,13,73,203,18,51,0,0
3399,532,159,605,362,7,15,13,73,203,19,51,0,0
3400,521,155,594,358,7,15,13,73,203,20,51,0,0
3401,513,152,585,356,7,15,13,72,204,21,51,0,0
3402,506,151,576,352,7,15,13,70,201,22,51,0,0
3403,502,152,569,344,7,15,13,67,192,23,51,0,0
3404,496,150,562,339,7,15,13,66,189,24,51,0,0
3405,487,150,552,334,7,15,13,65,184,25,51,0,0
3406,480,146,542,326,7,15,13,62,180,26,51,0,0
3407,473,143,535,321,7,15,13,62,178,27,51,0,0
3408,468,143,527,317,7,15,13,59,174,28,51,0,0
3409,463,142,521,314,7,15,13,58,172,29,51,0,0
3410,461,142,517,307,7,15,13,56,165,30,51,0,0
3411,458,142,513,304,7,15,13,55,162,31,51,0,0
3412,454,137,509,300,7,15,13,55,163,32,51,0,0
3413,451,132,506,297,7,15,13,55,165,33,51,0,0
3414,448,130,503,296,7,15,13,55,166,34,51,0,0
3415,448,130,501,288,7,15,13,53,158,35,51,0,0
3416,449,130,501,284,7,15,13,52,154,36,51,0,0
3417,447,128,499,284,7,15,13,52,156,37,51,0,0
3418,447,122,499,279,7,15,13,52,157,38,51,0,0
3419,448,122,498,275,7,15,13,50,153,39,51,0,0
3420,450,124,501,275,7,15,13,51,151,40,51,0,0
3421,456,125,506,274,7,15,13,50,149,41,51,0,0
3422,461,128,510,273,7,15,13,49,145,42,51,0,0
3423,468,128,514,267,7,15,13,46,139,43,51,0,0
3424,476,127,522,264,7,15,13,46,137,44,51,0,0
3425,482,127,529,263,7,15,13,47,136,45,51,0,0
3426,494,126,539,258,7,15,13,45,132,46,51,0,0
3427,507,131,551,257,7,15,13,44,126,47,51,0,0
3428,521,131,564,254,7,15,13,43,123,48,51,0,0
3429,536,127,581,259,7,15,13,45,132,49,51,0,0
3430,547,130,592,265,7,15,13,45,135,50,51,0,0
3431,555,130,599,264,7,15,13,44,134,51,51,1,0
3536,509,147,546,253,8,15,13,37,106,0,113,0,1
3537,499,144,539,258,8,15,13,40,114,1,113,0,0
3538,487,147,526,258,8,15,13,39,111,2,113,0,0
3539,472,145,514,262,8,15,13,42,117,3,113,0,0
3540,466,145,507,260,8,15,13,41,115,4,113,0,0
3541,462,144,503,261,8,15,13,41,117,5,113,0,0
3542,461,143,504,262,8,15,13,43,119,6,113,0,0
3543,462,142,505,262,8,15,13,43,120,7,113,0,0
3544,460,141,504,263,8,15,13,44,122,8,113,0,0
3545,457,139,501,264,8,15,13,44,125,9,113,0,0
3546,454,140,498,265,8,15,13,44,125,10,113,0,0
3547,452,142,492,262,8,15,13,40,120,11,113,0,0
3548,449,146,488,262,8,15,13,39,116,12,113,0,0
3549,444,149,484,265,8,15,13,40,116,13,113,0,0
3550,440,149,480,265,8,15,13,40,116,14,113,0,0
3551,436,150,477,266,8,15,13,41,116,15,113,0,0
3552,429,150,472,269,8,15,13,43,119,16,113,0,0
3553,424,150,468,268,8,15,13,44,118,17,113,0,0
3554,422,151,467,272,8,15,13,45,121,18,113,0,0
3555,419,151,467,277,8,15,13,48,126,19,113,0,0
3556,418,151,467,278,8,15,13,49,127,20,113,0,0
3557,416,151,469,285,8,15,13,53,134,21,113,0,0
3558,418,152,472,287,8,15,13,54,135,22,113,0,0
3559,417,152,472,289,8,15,13,55,137,23,113,0,0
3560,416,154,473,296,8,15,13,57,142,24,113,0,0
3561,414,156,472,300,8,15,13,58,144,25,113,0,0
3562,411,158,469,306,8,15,13,58,148,26,113,0,0
3563,408,161,466,309,8,15,13,58,148,27,113,0,0
3564,406,165,463,315,8,15,13,57,150,28,113,0,0
3565,402,170,459,321,8,15,13,57,151,29,113,0,0
3566,401,171,460,326,8,15,13,59,155,30,113,0,0
3567,399,172,460,333,8,15,13,61,161,31,113,0,0
3568,396,171,459,337,8,15,13,63,166,32,113,0,0
3569,393,174,458,346,8,15,13,65,172,33,113,0,0
3570,395,175,463,353,8,15,13,68,178,34,113,0,0
3571,397,178,465,355,8,15,13,68,177,35,113,0,0
3572,401,183,472,368,8,15,13,71,185,36,113,0,0
3573,402,183,474,372,8,15,13,72,189,37,113,0,0
3574,403,188,479,390,8,15,13,76,202,38,113,0,0
3575,413,187,491,395,8,15,13,78,208,39,113,0,0
3576,419,195,497,405,8,15,13,78,210,40,113,0,0
3577,424,196,503,410,8,15,13,79,214,41,113,0,0
3578,421,197,505,423,8,15,13,84,226,42,113,0,0
3579,426,201,512,436,8,15,13,86,235,43,113,0,0
3580,436,206,522,441,8,15,13,86,235,44,113,0,0
3581,446,217,532,453,8,15,13,86,236,45,113,0,0
3582,448,213,539,462,8,15,13,91,249,46,113,0,0
3583,445,224,540,486,8,15,13,95,262,47,113,0,0
3584,446,227,545,502,8,15,13,99,275,48,113,0,0
3585,450,234,555,518,8,15,13,105,284,49,113,0,0
3586,444,243,553,535,8,15,13,109,292,50,113,0,0
3587,433,245,544,546,8,15,13,111,301,51,113,0,0
3588,421,256,537,574,8,15,13,116,318,52,113,0,0
3589,420,260,540,590,8,15,13,120,330,53,113,0,0
3590,406,273,528,610,8,15,13,122,337,54,113,0,0
3591,394,280,525,643,8,15,13,131,363,55,113,0,0
3592,382,289,518,673,8,15,13,136,384,56,113,0,0
3593,377,303,518,703,8,15,13,141,400,57,113,0,0
3594,373,311,520,726,8,15,13,147,415,58,113,0,0
3595,357,322,505,745,8,15,13,148,423,59,113,0,0
3596,340,335,490,769,8,15,13,150,434,60,113,0,0
3597,324,339,487,815,8,15,13,163,476,61,113,0,0
3598,311,350,479,837,8,15,13,168,487,62,113,0,0
3599,306,359,479,855,8,15,13,173,496,63,113,0,0
3600,339,365,512,856,8,15,13,173,491,64,113,0,0
3601,379,371,547,851,8,15,13,168,480,65,113,0,0
3602,402,375,563,842,8,15,13,161,467,66,113,0,0
3603,423,375,582,845,8,15,13,159,470,67,113,0,0
3604,437,372,594,847,8,15,13,157,475,68,113,0,0
3605,444,371,597,843,8,15,13,153,472,69,113,0,0
3606,446,380,596,846,8,15,13,150,466,70,113,0,0
3607,449,383,596,845,8,15,13,147,462,71,113,0,0
3608,454,379,597,832,8,15,13,143,453,72,113,0,0
3609,464,370,612,839,8,15,13,148,469,73,113,0,0
3610,470,366,619,835,8,15,13,149,469,74,113,0,0
3611,472,363,621,837,8,15,13,149,474,75,113,0,0
3612,472,362,617,830,8,15,13,145,468,76,113,0,0
3613,469,361,614,838,8,15,13,145,477,77,113,0,0
3614,468,364,611,840,8,15,13,143,476,78,113,0,0
3615,467,365,607,841,8,15,13,140,476,79,113,0,0
3616,465,365,603,839,8,15,13,138,474,80,113,0,0
3617,465,363,603,842,8,15,13,138,479,81,113,0,0
3618,464,364,601,841,8,15,13,137,477,82,113,0,0
3619,466,363,601,842,8,15,13,135,479,83,113,0,0
3620,468,362,602,841,8,15,13,134,479,84,113,0,0
3621,470,366,601,841,8,15,13,131,475,85,113,0,0
3622,470,373,596,833,8,15,13,126,460,86,113,0,0
3623,466,369,591,834,8,15,13,125,465,87,113,0,0
3624,459,364,584,830,8,15,13,125,466,88,113,0,0
3625,450,358,576,831,8,15,13,126,473,89,113,0,0
3626,442,356,566,823,8,15,13,124,467,90,113,0,0
3627,435,356,555,809,8,15,13,120,453,91,113,0,0
3628,412,351,535,799,8,15,13,123,448,92,113,0,0
3629,410,352,534,798,8,15,13,124,446,93,113,0,0
3630,405,348,531,797,8,15,13,126,449,94,113,0,0
3631,391,349,519,797,8,15,13,128,448,95,113,0,0
3632,374,346,502,791,8,15,13,128,445,96,113,0,0
3633,355,342,483,789,8,15,13,128,447,97,113,0,0
3634,341,333,468,784,8,15,13,127,451,98,113,0,0
3635,334,327,458,780,8,15,13,124,453,99,113,0,0
3636,327,324,447,762,8,15,13,120,438,100,113,0,0
3637,325,323,442,749,8,15,13,117,426,101,113,0,0
3638,324,321,438,741,8,15,13,114,420,102,113,0,0
3639,321,318,434,739,8,15,13,113,421,103,113,0,0
3640,320,318,433,740,8,15,13,113,422,104,113,0,0
3641,320,318,431,741,8,15,13,111,423,105,113,0,0
3642,320,318,430,742,8,15,13,110,424,106,113,0,0
3643,320,320,430,742,8,15,13,110,422,107,113,0,0
3644,320,320,429,742,8,15,13,109,422,108,113,0,0
3645,318,317,428,743,8,15,13,110,426,109,113,0,0
3646,312,320,420,739,8,15,13,108,419,110,113,0,0
3647,304,325,410,730,8,15,13,106,405,111,113,0,0
3648,298,327,403,725,8,15,13,105,398,112,113,0,0
3649,293,327,398,722,8,15,13,105,395,113,113,1,0
5021,544,122,582,272,10,15,13,38,150,0,0,0,0
5022,522,126,557,255,11,15,13,35,129,0,0,0,0
5023,480,135,543,261,12,15,13,63,126,0,8,0,0
5024,460,126,525,257,12,15,13,65,131,1,8,0,0
5025,439,126,504,259,12,15,13,65,133,2,8,0,0
5026,416,128,481,260,12,15,13,65,132,3,8,0,0
5027,392,122,458,261,12,15,13,66,139,4,8,0,0
5028,367,122,434,260,12,15,13,67,138,5,8,0,0
5029,346,124,410,259,12,15,13,64,135,6,8,0,0
5030,327,121,391,261,12,15,13,64,140,7,8,0,0
5031,307,120,372,262,12,15,13,65,142,8,8,0,0
5756,546,136,590,277,13,15,13,44,141,0,1,0,0
5757,539,136,581,271,13,15,13,42,135,1,1,0,0
5759,498,135,541,246,15,15,13,43,111,0,10,0,0
5760,480,135,526,254,15,15,13,46,119,1,10,0,0
5761,462,134,510,259,15,15,13,48,125,2,10,0,0
5762,444,135,493,262,15,15,13,49,127,3,10,0,0
5763,428,137,474,259,15,15,13,46,122,4,10,0,0
5764,407,137,455,262,15,15,13,48,125,5,10,0,0
5765,391,133,439,261,15,15,13,48,128,6,10,0,0
5766,375,131,423,260,15,15,13,48,129,7,10,0,0
5767,356,131,405,259,15,15,13,49,128,8,10,0,0
5768,341,128,388,255,15,15,13,47,127,9,10,0,0
5769,325,127,372,255,15,15,13,47,128,10,10,0,0
370,1739,636,1920,1005,1,15,14,181,369,0,41,0,1
371,1693,635,1879,1011,1,15,14,186,376,1,41,0,0
372,1625,628,1824,1027,1,15,14,199,399,2,41,0,0
373,1534,608,1743,1025,1,15,14,209,417,3,41,0,0
374,1459,602,1685,1055,1,15,14,226,453,4,41,0,0
375,1396,584,1636,1062,1,15,14,240,478,5,41,0,0
376,1354,576,1600,1068,1,15,14,246,492,6,41,0,0
377,1329,576,1574,1066,1,15,14,245,490,7,41,0,0
378,1301,574,1552,1072,1,15,14,251,498,8,41,0,0
379,1309,581,1559,1070,1,15,14,250,489,9,41,0,0
380,1334,589,1583,1069,1,15,14,249,480,10,41,0,0
381,1364,606,1609,1072,1,15,14,245,466,11,41,0,0
382,1385,615,1629,1071,1,15,14,244,456,12,41,0,0
383,1381,620,1627,1070,1,15,14,246,450,13,41,0,0
384,1346,615,1598,1067,1,15,14,252,452,14,41,0,0
385,1278,602,1536,1069,1,15,14,258,467,15,41,0,0
386,1227,584,1495,1068,1,15,14,268,484,16,41,0,0
387,1176,576,1446,1072,1,15,14,270,496,17,41,0,0
388,1134,570,1404,1074,1,15,14,270,504,18,41,0,0
389,1084,556,1357,1079,1,15,14,273,523,19,41,0,0
390,1036,548,1309,1078,1,15,14,273,530,20,41,0,0
391,983,543,1254,1077,1,15,14,271,534,21,41,0,0
392,943,538,1209,1079,1,15,14,266,541,22,41,0,0
393,929,526,1190,1080,1,15,14,261,554,23,41,0,0
394,923,524,1177,1077,1,15,14,254,553,24,41,0,0
395,915,522,1164,1076,1,15,14,249,554,25,41,0,0
396,922,517,1166,1076,1,15,14,244,559,26,41,0,0
397,926,519,1164,1077,1,15,14,238,558,27,41,0,0
398,923,512,1160,1076,1,15,14,237,564,28,41,0,0
399,912,509,1149,1075,1,15,14,237,566,29,41,0,0
400,915,520,1145,1072,1,15,14,230,552,30,41,0,0
401,908,529,1133,1075,1,15,14,225,546,31,41,0,0
402,894,544,1115,1077,1,15,14,221,533,32,41,0,0
403,880,570,1092,1073,1,15,14,212,503,33,41,0,0
404,817,592,1026,1071,1,15,14,209,479,34,41,0,0
405,740,611,950,1069,1,15,14,210,458,35,41,0,0
406,680,654,885,1073,1,15,14,205,419,36,41,0,0
407,625,699,828,1076,1,15,14,203,377,37,41,0,0
408,570,744,765,1077,1,15,14,195,333,38,41,0,0
409,502,817,673,1077,1,15,14,171,260,39,41,0,0
410,415,883,562,1073,1,15,14,147,190,40,41,0,0
411,371,920,489,1072,1,15,14,118,152,41,41,1,0
784,138,669,414,1064,1,15,15,276,395,0,21,0,1
785,204,612,515,1057,1,15,15,311,445,1,21,0,0
786,275,579,612,1060,1,15,15,337,481,2,21,0,0
787,304,530,676,1066,1,15,15,372,536,3,21,0,0
788,349,500,740,1068,1,15,15,391,568,4,21,0,0
789,389,472,791,1068,1,15,15,402,596,5,21,0,0
790,438,441,824,1028,1,15,15,386,587,6,21,0,0
791,492,416,872,1008,1,15,15,380,592,7,21,0,0
792,551,391,906,960,1,15,15,355,569,8,21,0,0
793,614,374,931,895,1,15,15,317,521,9,21,0,0
794,660,356,971,876,1,15,15,311,520,10,21,0,0
795,726,345,1015,849,1,15,15,289,504,11,21,0,0
796,797,338,1085,847,1,15,15,288,509,12,21,0,0
797,862,331,1139,829,1,15,15,277,498,13,21,0,0
798,937,330,1190,800,1,15,15,253,470,14,21,0,0
799,993,328,1242,794,1,15,15,249,466,15,21,0,0
800,1057,326,1294,787,1,15,15,237,461,16,21,0,0
801,1124,327,1357,785,1,15,15,233,458,17,21,0,0
802,1174,328,1408,789,1,15,15,234,461,18,21,0,0
803,1244,328,1469,792,1,15,15,225,464,19,21,0,0
804,1291,404,1467,775,1,15,15,176,371,20,21,0,0
805,1346,405,1516,764,1,15,15,170,359,21,21,1,0
923,1326,279,1431,682,2,15,15,105,403,0,27,0,1
924,1291,279,1396,678,2,15,15,105,399,1,27,0,0
925,1263,283,1366,674,2,15,15,103,391,2,27,0,0
926,1209,281,1315,675,2,15,15,106,394,3,27,0,0
927,1168,284,1277,676,2,15,15,109,392,4,27,0,0
928,1125,287,1236,679,2,15,15,111,392,5,27,0,0
929,1096,296,1216,713,2,15,15,120,417,6,27,0,0
930,1071,301,1197,732,2,15,15,126,431,7,27,0,0
931,1025,306,1156,743,2,15,15,131,437,8,27,0,0
932,982,314,1122,767,2,15,15,140,453,9,27,0,0
933,945,319,1086,777,2,15,15,141,458,10,27,0,0
934,909,337,1063,828,2,15,15,154,491,11,27,0,0
935,878,345,1041,862,2,15,15,163,517,12,27,0,0
936,832,353,1000,880,2,15,15,168,527,13,27,0,0
937,789,376,963,912,2,15,15,174,536,14,27,0,0
938,736,388,918,939,2,15,15,182,551,15,27,0,0
939,678,410,872,1005,2,15,15,194,595,16,27,0,0
940,629,436,832,1056,2,15,15,203,620,17,27,0,0
941,585,458,793,1080,2,15,15,208,622,18,27,0,0
942,547,489,757,1080,2,15,15,210,591,19,27,0,0
943,480,516,688,1080,2,15,15,208,564,20,27,0,0
944,408,548,612,1080,2,15,15,204,532,21,27,0,0
945,358,595,549,1080,2,15,15,191,485,22,27,0,0
946,301,638,484,1079,2,15,15,183,441,23,27,0,0
947,213,698,382,1080,2,15,15,169,382,24,27,0,0
948,117,745,273,1080,2,15,15,156,335,25,27,0,0
949,38,801,176,1080,2,15,15,138,279,26,27,0,0
950,0,837,102,1080,2,15,15,102,243,27,27,1,0
3301,1349,227,1429,496,5,15,15,80,269,0,37,0,1
3302,1326,225,1406,493,5,15,15,80,268,1,37,0,0
3303,1304,222,1380,474,5,15,15,76,252,2,37,0,0
3304,1283,216,1357,461,5,15,15,74,245,3,37,0,0
3305,1259,210,1338,464,5,15,15,79,254,4,37,0,0
3306,1239,203,1314,444,5,15,15,75,241,5,37,0,0
3307,1226,201,1299,436,5,15,15,73,235,6,37,0,0
3308,1214,195,1288,430,5,15,15,74,235,7,37,0,0
3309,1203,194,1277,424,5,15,15,74,230,8,37,0,0
3310,1200,191,1271,413,5,15,15,71,222,9,37,0,0
3311,1191,181,1262,400,5,15,15,71,219,10,37,0,0
3312,1187,177,1257,395,5,15,15,70,218,11,37,0,0
3313,1185,173,1254,393,5,15,15,69,220,12,37,0,0
3314,1184,172,1254,391,5,15,15,70,219,13,37,0,0
3315,1180,172,1247,382,5,15,15,67,210,14,37,0,0
3316,1179,171,1241,361,5,15,15,62,190,15,37,0,0
3317,1179,169,1240,356,5,15,15,61,187,16,37,0,0
3318,1178,162,1240,352,5,15,15,62,190,17,37,0,0
3319,1178,162,1239,346,5,15,15,61,184,18,37,0,0
3320,1172,152,1233,335,5,15,15,61,183,19,37,0,0
3321,1172,149,1231,325,5,15,15,59,176,20,37,0,0
3322,1172,145,1230,319,5,15,15,58,174,21,37,0,0
3323,1171,142,1229,313,5,15,15,58,171,22,37,0,0
3324,1171,142,1228,309,5,15,15,57,167,23,37,0,0
3325,1172,139,1228,306,5,15,15,56,167,24,37,0,0
3326,1176,141,1230,298,5,15,15,54,157,25,37,0,0
3327,1181,141,1234,297,5,15,15,53,156,26,37,0,0
3328,1185,140,1236,290,5,15,15,51,150,27,37,0,0
3329,1191,140,1239,285,5,15,15,48,145,28,37,0,0
3330,1192,136,1242,285,5,15,15,50,149,29,37,0,0
3331,1198,136,1246,282,5,15,15,48,146,30,37,0,0
3332,1201,133,1249,279,5,15,15,48,146,31,37,0,0
3333,1204,133,1248,268,5,15,15,44,135,32,37,0,0
3334,1202,133,1245,261,5,15,15,43,128,33,37,0,0
3335,1198,132,1242,264,5,15,15,44,132,34,37,0,0
3336,1194,133,1238,265,5,15,15,44,132,35,37,0,0
3337,1187,131,1230,259,5,15,15,43,128,36,37,0,0
3338,1186,130,1228,255,5,15,15,42,125,37,37,1,0
3676,1179,115,1214,261,7,15,15,35,146,0,70,0,1
3677,1190,117,1228,270,7,15,15,38,153,1,70,0,0
3678,1202,118,1240,271,7,15,15,38,153,2,70,0,0
3679,1212,120,1250,270,7,15,15,38,150,3,70,0,0
3680,1222,123,1261,273,7,15,15,39,150,4,70,0,0
3681,1230,122,1268,268,7,15,15,38,146,5,70,0,0
3682,1236,125,1275,268,7,15,15,39,143,6,70,0,0
3683,1242,124,1284,278,7,15,15,42,154,7,70,0,0
3684,1248,126,1290,279,7,15,15,42,153,8,70,0,0
3685,1250,129,1294,283,7,15,15,44,154,9,70,0,0
3686,1251,130,1296,285,7,15,15,45,155,10,70,0,0
3687,1251,130,1296,287,7,15,15,45,157,11,70,0,0
3688,1250,132,1297,290,7,15,15,47,158,12,70,0,0
3689,1252,133,1300,293,7,15,15,48,160,13,70,0,0
3690,1249,136,1299,296,7,15,15,50,160,14,70,0,0
3691,1247,141,1298,302,7,15,15,51,161,15,70,0,0
3692,1243,140,1297,305,7,15,15,54,165,16,70,0,0
3693,1240,136,1298,313,7,15,15,58,177,17,70,0,0
3694,1240,137,1299,320,7,15,15,59,183,18,70,0,0
3695,1240,136,1300,322,7,15,15,60,186,19,70,0,0
3696,1239,136,1303,333,7,15,15,64,197,20,70,0,0
3697,1235,137,1301,342,7,15,15,66,205,21,70,0,0
3698,1232,134,1300,347,7,15,15,68,213,22,70,0,0
3699,1230,135,1298,353,7,15,15,68,218,23,70,0,0
3700,1230,138,1298,358,7,15,15,68,220,24,70,0,0
3701,1227,139,1296,363,7,15,15,69,224,25,70,0,0
3702,1224,141,1293,366,7,15,15,69,225,26,70,0,0
3703,1219,146,1289,373,7,15,15,70,227,27,70,0,0
3704,1215,146,1286,377,7,15,15,71,231,28,70,0,0
3705,1210,153,1281,385,7,15,15,71,232,29,70,0,0
3706,1203,154,1277,396,7,15,15,74,242,30,70,0,0
3707,1198,156,1273,403,7,15,15,75,247,31,70,0,0
3708,1191,164,1267,412,7,15,15,76,248,32,70,0,0
3709,1182,167,1257,415,7,15,15,75,248,33,70,0,0
3710,1177,171,1254,425,7,15,15,77,254,34,70,0,0
3711,1174,176,1250,427,7,15,15,76,251,35,70,0,0
3712,1169,178,1246,429,7,15,15,77,251,36,70,0,0
3713,1164,180,1247,447,7,15,15,83,267,37,70,0,0
3714,1159,183,1244,458,7,15,15,85,275,38,70,0,0
3715,1156,184,1242,461,7,15,15,86,277,39,70,0,0
3716,1153,189,1244,481,7,15,15,91,292,40,70,0,0
3717,1151,192,1247,496,7,15,15,96,304,41,70,0,0
3718,1153,193,1252,504,7,15,15,99,311,42,70,0,0
3719,1149,196,1254,525,7,15,15,105,329,43,70,0,0
3720,1147,199,1254,533,7,15,15,107,334,44,70,0,0
3721,1142,201,1251,547,7,15,15,109,346,45,70,0,0
3722,1138,208,1254,576,7,15,15,116,368,46,70,0,0
3723,1138,213,1258,593,7,15,15,120,380,47,70,0,0
3724,1135,218,1260,612,7,15,15,125,394,48,70,0,0
3725,1130,225,1261,635,7,15,15,131,410,49,70,0,0
3726,1122,231,1257,653,7,15,15,135,422,50,70,0,0
3727,1113,240,1255,686,7,15,15,142,446,51,70,0,0
3728,1110,251,1260,720,7,15,15,150,469,52,70,0,0
3729,1101,257,1253,733,7,15,15,152,476,53,70,0,0
3730,1089,266,1249,765,7,15,15,160,499,54,70,0,0
3731,1075,282,1240,795,7,15,15,165,513,55,70,0,0
3732,1058,290,1228,818,7,15,15,170,528,56,70,0,0
3733,1034,306,1224,887,7,15,15,190,581,57,70,0,0
3734,1021,321,1222,930,7,15,15,201,609,58,70,0,0
3735,1018,335,1222,951,7,15,15,204,616,59,70,0,0
3736,1006,366,1224,1016,7,15,15,218,650,60,70,0,0
3737,984,388,1210,1061,7,15,15,226,673,61,70,0,0
3738,956,408,1188,1076,7,15,15,232,668,62,70,0,0
3739,947,450,1177,1079,7,15,15,230,629,63,70,0,0
3740,954,482,1186,1078,7,15,15,232,596,64,70,0,0
3741,967,520,1207,1080,7,15,15,240,560,65,70,0,0
3742,987,575,1230,1080,7,15,15,243,505,66,70,0,0
3743,1014,624,1256,1079,7,15,15,242,455,67,70,0,0
3744,1054,681,1277,1077,7,15,15,223,396,68,70,0,0
3745,1159,743,1360,1077,7,15,15,201,334,69,70,0,0
3746,1187,779,1374,1080,7,15,15,187,301,70,70,1,0
4800,1369,195,1439,493,9,15,15,70,298,0,36,0,1
4801,1347,196,1417,493,9,15,15,70,297,1,36,0,0
4802,1327,189,1398,487,9,15,15,71,298,2,36,0,0
4803,1284,188,1358,488,9,15,15,74,300,3,36,0,0
4804,1259,183,1335,486,9,15,15,76,303,4,36,0,0
4805,1243,179,1317,466,9,15,15,74,287,5,36,0,0
4806,1228,179,1300,453,9,15,15,72,274,6,36,0,0
4807,1214,173,1285,438,9,15,15,71,265,7,36,0,0
4808,1200,171,1271,432,9,15,15,71,261,8,36,0,0
4809,1193,166,1262,416,9,15,15,69,250,9,36,0,0
4810,1189,158,1258,407,9,15,15,69,249,10,36,0,0
4811,1188,157,1256,399,9,15,15,68,242,11,36,0,0
4812,1188,151,1256,390,9,15,15,68,239,12,36,0,0
4813,1188,147,1254,376,9,15,15,66,229,13,36,0,0
4814,1188,146,1255,378,9,15,15,67,232,14,36,0,0
4815,1190,144,1254,362,9,15,15,64,218,15,36,0,0
4816,1194,143,1256,356,9,15,15,62,213,16,36,0,0
4817,1196,140,1256,344,9,15,15,60,204,17,36,0,0
4818,1198,139,1256,337,9,15,15,58,198,18,36,0,0
4819,1200,138,1256,329,9,15,15,56,191,19,36,0,0
4820,1201,136,1255,318,9,15,15,54,182,20,36,0,0
4821,1204,137,1257,313,9,15,15,53,176,21,36,0,0
4822,1205,130,1259,308,9,15,15,54,178,22,36,0,0
4823,1206,130,1259,302,9,15,15,53,172,23,36,0,0
4824,1205,125,1259,299,9,15,15,54,174,24,36,0,0
4825,1207,124,1259,294,9,15,15,52,170,25,36,0,0
4826,1207,121,1260,292,9,15,15,53,171,26,36,0,0
4827,1208,120,1260,288,9,15,15,52,168,27,36,0,0
4828,1209,120,1260,281,9,15,15,51,161,28,36,0,0
4829,1209,120,1258,274,9,15,15,49,154,29,36,0,0
4830,1208,118,1256,270,9,15,15,48,152,30,36,0,0
4831,1206,118,1254,268,9,15,15,48,150,31,36,0,0
4832,1202,116,1251,266,9,15,15,49,150,32,36,0,0
4833,1196,116,1244,263,9,15,15,48,147,33,36,0,0
4834,1186,114,1235,263,9,15,15,49,149,34,36,0,0
4835,1176,113,1224,259,9,15,15,48,146,35,36,0,0
4836,1173,112,1219,255,9,15,15,46,143,36,36,1,0
4871,1261,319,1427,740,10,15,15,166,421,0,17,0,0
4872,1246,322,1414,748,10,15,15,168,426,1,17,0,0
4873,1184,322,1376,807,10,15,15,192,485,2,17,0,0
4874,1171,339,1377,856,10,15,15,206,517,3,17,0,0
4875,1152,338,1371,886,10,15,15,219,548,4,17,0,0
4876,1109,345,1355,966,10,15,15,246,621,5,17,0,0
4877,1074,364,1326,1003,10,15,15,252,639,6,17,0,0
4878,1040,376,1293,1016,10,15,15,253,640,7,17,0,0
4879,976,394,1242,1061,10,15,15,266,667,8,17,0,0
4880,934,415,1201,1079,10,15,15,267,664,9,17,0,0
4881,884,436,1148,1080,10,15,15,264,644,10,17,0,0
4882,856,469,1108,1080,10,15,15,252,611,11,17,0,0
4883,828,508,1070,1080,10,15,15,242,572,12,17,0,0
4884,810,547,1046,1078,10,15,15,236,531,13,17,0,0
4885,766,598,992,1078,10,15,15,226,480,14,17,0,0
4886,675,642,899,1078,10,15,15,224,436,15,17,0,0
4887,571,634,817,1076,10,15,15,246,442,16,17,0,0
4888,524,655,765,1080,10,15,15,241,425,17,17,0,0
4872,1347,334,1428,765,11,15,15,81,431,0,1,0,0
4873,1323,336,1405,765,11,15,15,82,429,1,1,0,0
4875,1099,330,1218,761,12,15,15,119,431,0,0,0,0
4876,962,341,1180,790,13,15,15,218,449,0,17,0,0
4877,914,351,1139,815,13,15,15,225,464,1,17,0,0
4878,893,353,1116,817,13,15,15,223,464,2,17,0,0
4879,829,368,1062,857,13,15,15,233,489,3,17,0,0
4880,785,382,1020,880,13,15,15,235,498,4,17,0,0
4881,704,402,952,933,13,15,15,248,531,5,17,0,0
4882,620,425,891,1000,13,15,15,271,575,6,17,0,0
4883,589,445,861,1026,13,15,15,272,581,7,17,0,0
4884,567,466,840,1061,13,15,15,273,595,8,17,0,0
4885,526,505,786,1080,13,15,15,260,575,9,17,0,0
4886,488,537,680,962,13,15,15,192,425,10,17,0,0
4887,390,579,590,1003,13,15,15,200,424,11,17,0,0
4888,346,625,539,1009,13,15,15,193,384,12,17,0,0
4889,294,663,493,1046,13,15,15,199,383,13,17,0,0
4890,235,721,429,1073,13,15,15,194,352,14,17,0,0
4891,127,771,305,1080,13,15,15,178,309,15,17,0,0
4892,43,822,200,1080,13,15,15,157,258,16,17,0,0
4893,0,861,124,1080,13,15,15,124,219,17,17,0,0
5460,1314,210,1437,505,17,15,15,123,295,0,44,0,1
5461,1305,210,1429,508,17,15,15,124,298,1,44,0,0
5462,1284,203,1408,502,17,15,15,124,299,2,44,0,0
5463,1271,203,1393,496,17,15,15,122,293,3,44,0,0
5464,1236,196,1356,489,17,15,15,120,293,4,44,0,0
5465,1199,197,1316,479,17,15,15,117,282,5,44,0,0
5466,1173,192,1289,479,17,15,15,116,287,6,44,0,0
5467,1154,187,1263,459,17,15,15,109,272,7,44,0,0
5468,1141,182,1247,452,17,15,15,106,270,8,44,0,0
5469,1130,174,1233,441,17,15,15,103,267,9,44,0,0
5470,1118,172,1217,434,17,15,15,99,262,10,44,0,0
5471,1108,172,1202,424,17,15,15,94,252,11,44,0,0
5472,1102,166,1192,410,17,15,15,90,244,12,44,0,0
5473,1098,163,1185,401,17,15,15,87,238,13,44,0,0
5474,1098,160,1182,393,17,15,15,84,233,14,44,0,0
5475,1098,161,1179,388,17,15,15,81,227,15,44,0,0
5476,1098,159,1177,383,17,15,15,79,224,16,44,0,0
5477,1100,156,1177,373,17,15,15,77,217,17,44,0,0
5478,1104,150,1181,371,17,15,15,77,221,18,44,0,0
5479,1113,149,1188,358,17,15,15,75,209,19,44,0,0
5480,1116,149,1187,351,17,15,15,71,202,20,44,0,0
5481,1118,148,1187,340,17,15,15,69,192,21,44,0,0
5482,1119,146,1186,335,17,15,15,67,189,22,44,0,0
5483,1124,143,1190,332,17,15,15,66,189,23,44,0,0
5484,1133,143,1197,325,17,15,15,64,182,24,44,0,0
5485,1135,145,1198,323,17,15,15,63,178,25,44,0,0
5486,1139,142,1200,313,17,15,15,61,171,26,44,0,0
5487,1141,138,1202,312,17,15,15,61,174,27,44,0,0
5488,1145,139,1205,308,17,15,15,60,169,28,44,0,0
5489,1156,138,1214,302,17,15,15,58,164,29,44,0,0
5490,1160,136,1218,302,17,15,15,58,166,30,44,0,0
5491,1166,136,1222,296,17,15,15,56,160,31,44,0,0
5492,1167,135,1224,295,17,15,15,57,160,32,44,0,0
5493,1170,136,1225,292,17,15,15,55,156,33,44,0,0
5494,1174,133,1230,289,17,15,15,56,156,34,44,0,0
5495,1174,132,1230,289,17,15,15,56,157,35,44,0,0
5496,1176,130,1231,286,17,15,15,55,156,36,44,0,0
5497,1175,129,1229,284,17,15,15,54,155,37,44,0,0
5498,1177,128,1230,279,17,15,15,53,151,38,44,0,0
5499,1181,127,1232,275,17,15,15,51,148,39,44,0,0
5500,1179,126,1232,278,17,15,15,53,152,40,44,0,0
5501,1179,126,1231,278,17,15,15,52,152,41,44,0,0
5502,1177,127,1227,272,17,15,15,50,145,42,44,0,0
5503,1175,125,1225,267,17,15,15,50,142,43,44,0,0
5504,1176,124,1225,263,17,15,15,49,139,44,44,1,0
155,323,139,358,230,2,15,2,35,91,0,78,0,0
156,325,136,360,231,2,15,2,35,95,1,78,0,0
157,325,136,360,232,2,15,2,35,96,2,78,0,0
159,327,137,362,234,2,15,2,35,97,0,78,0,0
160,328,137,363,235,2,15,2,35,98,1,78,0,0
161,328,133,364,236,2,15,2,36,103,2,78,0,0
162,330,138,365,236,2,15,2,35,98,3,78,0,0
166,331,141,366,240,2,15,2,35,99,0,78,0,0
172,345,146,380,245,2,15,2,35,99,0,78,0,0
173,343,145,379,246,2,15,2,36,101,1,78,0,0
174,341,145,377,247,2,15,2,36,102,2,78,0,0
175,341,148,376,248,2,15,2,35,100,3,78,0,0
176,345,150,381,250,2,15,2,36,100,4,78,0,0
177,346,148,382,251,2,15,2,36,103,5,78,0,0
178,346,148,384,253,2,15,2,38,105,6,78,0,0
179,347,150,384,254,2,15,2,37,104,7,78,0,0
180,347,154,383,256,2,15,2,36,102,8,78,0,0
181,349,152,386,258,2,15,2,37,106,9,78,0,0
182,349,149,387,258,2,15,2,38,109,10,78,0,0
183,353,153,389,258,2,15,2,36,105,11,78,0,0
186,355,161,391,262,2,15,2,36,101,0,78,0,0
187,357,166,392,265,2,15,2,35,99,1,78,0,0
188,356,160,394,268,2,15,2,38,108,2,78,0,0
189,355,157,394,271,2,15,2,39,114,3,78,0,0
190,355,158,394,272,2,15,2,39,114,4,78,0,0
191,355,156,395,274,2,15,2,40,118,5,78,0,0
192,357,167,394,274,2,15,2,37,107,6,78,0,0
193,355,162,394,276,2,15,2,39,114,7,78,0,0
194,355,160,396,277,2,15,2,41,117,8,78,0,0
195,356,160,397,279,2,15,2,41,119,9,78,0,0
196,356,169,394,280,2,15,2,38,111,10,78,0,0
197,359,179,396,285,2,15,2,37,106,11,78,0,0
198,359,174,398,288,2,15,2,39,114,12,78,0,0
199,360,175,399,290,2,15,2,39,115,13,78,0,0
208,378,207,413,308,2,15,2,35,101,0,78,0,1
209,378,195,418,309,2,15,2,40,114,1,78,0,0
210,379,189,421,312,2,15,2,42,123,2,78,0,0
211,379,195,420,314,2,15,2,41,119,3,78,0,0
212,377,195,419,315,2,15,2,42,120,4,78,0,0
213,377,195,418,315,2,15,2,41,120,5,78,0,0
214,376,186,421,319,2,15,2,45,133,6,78,0,0
215,375,180,422,323,2,15,2,47,143,7,78,0,0
216,376,191,421,327,2,15,2,45,136,8,78,0,0
217,374,185,422,330,2,15,2,48,145,9,78,0,0
218,372,179,422,337,2,15,2,50,158,10,78,0,0
219,372,180,422,336,2,15,2,50,156,11,78,0,0
220,374,177,424,339,2,15,2,50,162,12,78,0,0
221,374,176,425,341,2,15,2,51,165,13,78,0,0
222,374,176,426,347,2,15,2,52,171,14,78,0,0
223,371,176,424,352,2,15,2,53,176,15,78,0,0
224,371,178,424,356,2,15,2,53,178,16,78,0,0
225,375,182,428,359,2,15,2,53,177,17,78,0,0
226,378,182,432,360,2,15,2,54,178,18,78,0,0
227,380,188,433,365,2,15,2,53,177,19,78,0,0
228,380,190,433,368,2,15,2,53,178,20,78,0,0
229,380,196,433,372,2,15,2,53,176,21,78,0,0
230,382,197,436,378,2,15,2,54,181,22,78,0,0
231,385,198,440,381,2,15,2,55,183,23,78,0,0
232,388,199,443,384,2,15,2,55,185,24,78,0,0
233,390,201,444,385,2,15,2,54,184,25,78,0,0
234,390,201,446,389,2,15,2,56,188,26,78,0,0
235,391,201,449,396,2,15,2,58,195,27,78,0,0
236,397,201,456,400,2,15,2,59,199,28,78,0,0
237,401,201,461,404,2,15,2,60,203,29,78,0,0
238,406,202,468,410,2,15,2,62,208,30,78,0,0
239,408,203,469,411,2,15,2,61,208,31,78,0,0
240,408,205,472,418,2,15,2,64,213,32,78,0,0
241,413,210,477,424,2,15,2,64,214,33,78,0,0
242,419,210,485,432,2,15,2,66,222,34,78,0,0
243,425,212,491,437,2,15,2,66,225,35,78,0,0
244,426,213,492,438,2,15,2,66,225,36,78,0,0
245,427,214,494,444,2,15,2,67,230,37,78,0,0
246,432,217,502,455,2,15,2,70,238,38,78,0,0
247,436,220,508,462,2,15,2,72,242,39,78,0,0
248,443,221,515,466,2,15,2,72,245,40,78,0,0
249,448,227,521,471,2,15,2,73,244,41,78,0,0
250,451,231,525,477,2,15,2,74,246,42,78,0,0
251,455,230,533,489,2,15,2,78,259,43,78,0,0
252,461,234,542,498,2,15,2,81,264,44,78,0,0
253,471,233,554,509,2,15,2,83,276,45,78,0,0
254,479,237,563,520,2,15,2,84,283,46,78,0,0
255,485,241,569,527,2,15,2,84,286,47,78,0,0
256,487,243,572,537,2,15,2,85,294,48,78,0,0
257,492,250,583,559,2,15,2,91,309,49,78,0,0
258,503,252,595,568,2,15,2,92,316,50,78,0,0
259,512,257,603,571,2,15,2,91,314,51,78,0,0
260,518,264,610,584,2,15,2,92,320,52,78,0,0
261,516,268,610,596,2,15,2,94,328,53,78,0,0
262,515,275,610,611,2,15,2,95,336,54,78,0,0
263,521,285,617,625,2,15,2,96,340,55,78,0,0
264,525,288,624,637,2,15,2,99,349,56,78,0,0
265,525,293,631,663,2,15,2,106,370,57,78,0,0
266,520,300,629,682,2,15,2,109,382,58,78,0,0
267,512,305,623,695,2,15,2,111,390,59,78,0,0
268,508,318,625,729,2,15,2,117,411,60,78,0,0
269,511,331,630,746,2,15,2,119,415,61,78,0,0
270,511,339,636,772,2,15,2,125,433,62,78,0,0
271,499,346,632,808,2,15,2,133,462,63,78,0,0
272,488,349,625,827,2,15,2,137,478,64,78,0,0
273,478,363,621,860,2,15,2,143,497,65,78,0,0
274,477,382,624,893,2,15,2,147,511,66,78,0,0
275,472,389,622,907,2,15,2,150,518,67,78,0,0
276,454,408,613,954,2,15,2,159,546,68,78,0,0
277,424,419,593,983,2,15,2,169,564,69,78,0,0
278,368,430,548,1028,2,15,2,180,598,70,78,0,0
279,324,452,512,1065,2,15,2,188,613,71,78,0,0
280,275,469,468,1080,2,15,2,193,611,72,78,0,0
281,229,485,428,1080,2,15,2,199,595,73,78,0,0
282,169,504,376,1080,2,15,2,207,576,74,78,0,0
283,82,516,291,1080,2,15,2,209,564,75,78,0,0
284,42,538,249,1080,2,15,2,207,542,76,78,0,0
285,6,626,177,1080,2,15,2,171,454,77,78,0,0
286,0,647,145,1080,2,15,2,145,433,78,78,1,0
3424,4,794,159,1072,3,15,2,155,278,0,1,0,0
3425,20,761,195,1074,3,15,2,175,313,1,1,0,0
3426,155,772,346,1076,4,15,2,191,304,0,0,0,0
3427,297,764,515,1068,5,15,2,218,304,0,0,0,0
3428,481,815,696,1065,6,15,2,215,250,0,0,0,0
3557,0,726,337,1074,11,15,2,337,348,0,0,0,0
5035,330,367,550,975,14,15,2,220,608,0,52,0,1
5036,314,340,524,920,14,15,2,210,580,1,52,0,0
5037,303,330,507,895,14,15,2,204,565,2,52,0,0
5038,302,312,484,820,14,15,2,182,508,3,52,0,0
5039,298,301,475,794,14,15,2,177,493,4,52,0,0
5040,304,284,468,742,14,15,2,164,458,5,52,0,0
5041,298,271,453,706,14,15,2,155,435,6,52,0,0
5042,293,263,443,683,14,15,2,150,420,7,52,0,0
5043,295,245,436,645,14,15,2,141,400,8,52,0,0
5044,298,242,431,623,14,15,2,133,381,9,52,0,0
5045,299,231,424,592,14,15,2,125,361,10,52,0,0
5046,296,227,415,573,14,15,2,119,346,11,52,0,0
5047,293,223,409,567,14,15,2,116,344,12,52,0,0
5048,297,214,404,534,14,15,2,107,320,13,52,0,0
5049,301,212,403,520,14,15,2,102,308,14,52,0,0
5050,306,210,400,496,14,15,2,94,286,15,52,0,0
5051,307,206,398,481,14,15,2,91,275,16,52,0,0
5052,308,203,395,469,14,15,2,87,266,17,52,0,0
5053,305,201,389,459,14,15,2,84,258,18,52,0,0
5054,306,202,387,454,14,15,2,81,252,19,52,0,0
5055,308,198,383,433,14,15,2,75,235,20,52,0,0
5056,307,193,382,428,14,15,2,75,235,21,52,0,0
5057,305,191,379,421,14,15,2,74,230,22,52,0,0
5058,304,183,376,409,14,15,2,72,226,23,52,0,0
5059,305,185,374,403,14,15,2,69,218,24,52,0,0
5060,306,179,372,392,14,15,2,66,213,25,52,0,0
5061,307,179,371,388,14,15,2,64,209,26,52,0,0
5062,307,179,369,378,14,15,2,62,199,27,52,0,0
5063,307,174,367,370,14,15,2,60,196,28,52,0,0
5064,308,178,365,366,14,15,2,57,188,29,52,0,0
5065,309,174,365,360,14,15,2,56,186,30,52,0,0
5066,310,174,365,357,14,15,2,55,183,31,52,0,0
5067,309,172,363,351,14,15,2,54,179,32,52,0,0
5068,310,170,362,343,14,15,2,52,173,33,52,0,0
5069,312,170,361,336,14,15,2,49,166,34,52,0,0
5070,312,165,361,330,14,15,2,49,165,35,52,0,0
5071,312,163,360,329,14,15,2,48,166,36,52,0,0
5072,311,158,359,324,14,15,2,48,166,37,52,0,0
5073,310,156,357,319,14,15,2,47,163,38,52,0,0
5074,312,160,355,311,14,15,2,43,151,39,52,0,0
5075,311,160,353,306,14,15,2,42,146,40,52,0,0
5076,310,164,350,304,14,15,2,40,140,41,52,0,0
5077,306,158,347,300,14,15,2,41,142,42,52,0,0
5078,306,157,345,295,14,15,2,39,138,43,52,0,0
5079,305,157,344,292,14,15,2,39,135,44,52,0,0
5080,305,154,344,288,14,15,2,39,134,45,52,0,0
5081,303,149,343,289,14,15,2,40,140,46,52,0,0
5082,302,147,342,287,14,15,2,40,140,47,52,0,0
5083,302,144,340,279,14,15,2,38,135,48,52,0,0
5084,302,148,339,278,14,15,2,37,130,49,52,0,0
5085,302,148,338,276,14,15,2,36,128,50,52,0,0
5086,302,149,337,275,14,15,2,35,126,51,52,0,0
5087,300,144,335,271,14,15,2,35,127,52,52,1,0
5089,299,138,335,265,14,15,2,36,127,0,52,0,0
5092,297,134,332,259,14,15,2,35,125,0,52,0,0
5093,297,129,332,258,14,15,2,35,129,1,52,0,0
5094,297,127,332,254,14,15,2,35,127,2,52,0,0
5095,297,124,332,253,14,15,2,35,129,3,52,0,0
5770,433,486,656,1080,16,15,2,223,594,0,74,0,1
5771,418,466,643,1066,16,15,2,225,600,1,74,0,0
5772,401,443,622,1032,16,15,2,221,589,2,74,0,0
5773,376,415,599,1016,16,15,2,223,601,3,74,0,0
5774,370,405,582,979,16,15,2,212,574,4,74,0,0
5775,366,377,562,911,16,15,2,196,534,5,74,0,0
5776,359,358,548,879,16,15,2,189,521,6,74,0,0
5777,347,346,523,832,16,15,2,176,486,7,74,0,0
5778,350,340,519,804,16,15,2,169,464,8,74,0,0
5779,342,326,511,787,16,15,2,169,461,9,74,0,0
5780,333,313,491,744,16,15,2,158,431,10,74,0,0
5781,319,303,472,725,16,15,2,153,422,11,74,0,0
5782,308,293,452,696,16,15,2,144,403,12,74,0,0
5783,306,288,443,675,16,15,2,137,387,13,74,0,0
5784,304,282,438,663,16,15,2,134,381,14,74,0,0
5785,311,275,436,629,16,15,2,125,354,15,74,0,0
5786,306,269,427,617,16,15,2,121,348,16,74,0,0
5787,301,259,415,591,16,15,2,114,332,17,74,0,0
5788,298,253,410,579,16,15,2,112,326,18,74,0,0
5789,299,251,406,567,16,15,2,107,316,19,74,0,0
5790,305,243,407,541,16,15,2,102,298,20,74,0,0
5791,304,242,404,540,16,15,2,100,298,21,74,0,0
5792,301,237,397,525,16,15,2,96,288,22,74,0,0
5793,299,233,392,513,16,15,2,93,280,23,74,0,0
5794,300,231,391,505,16,15,2,91,274,24,74,0,0
5795,304,225,391,490,16,15,2,87,265,25,74,0,0
5796,303,221,388,481,16,15,2,85,260,26,74,0,0
5797,302,220,383,471,16,15,2,81,251,27,74,0,0
5798,299,218,377,460,16,15,2,78,242,28,74,0,0
5799,297,217,374,455,16,15,2,77,238,29,74,0,0
5800,300,214,374,440,16,15,2,74,226,30,74,0,0
5801,297,213,370,435,16,15,2,73,222,31,74,0,0
5802,293,208,365,430,16,15,2,72,222,32,74,0,0
5803,288,202,359,422,16,15,2,71,220,33,74,0,0
5804,284,205,353,419,16,15,2,69,214,34,74,0,0
5805,285,201,353,407,16,15,2,68,206,35,74,0,0
5806,282,201,348,403,16,15,2,66,202,36,74,0,0
5807,276,199,342,401,16,15,2,66,202,37,74,0,0
5808,271,198,334,393,16,15,2,63,195,38,74,0,0
5809,268,200,329,390,16,15,2,61,190,39,74,0,0
5810,267,196,326,380,16,15,2,59,184,40,74,0,0
5811,265,195,324,378,16,15,2,59,183,41,74,0,0
5812,263,196,319,373,16,15,2,56,177,42,74,0,0
5813,261,194,316,368,16,15,2,55,174,43,74,0,0
5814,261,194,315,363,16,15,2,54,169,44,74,0,0
5815,263,184,318,358,16,15,2,55,174,45,74,0,0
5816,265,182,320,357,16,15,2,55,175,46,74,0,0
5817,264,183,318,353,16,15,2,54,170,47,74,0,0
5818,265,182,317,348,16,15,2,52,166,48,74,0,0
5819,265,182,315,345,16,15,2,50,163,49,74,0,0
5820,268,180,317,336,16,15,2,49,156,50,74,0,0
5821,270,180,318,332,16,15,2,48,152,51,74,0,0
5822,269,181,315,329,16,15,2,46,148,52,74,0,0
5823,269,178,315,323,16,15,2,46,145,53,74,0,0
5824,268,175,315,323,16,15,2,47,148,54,74,0,0
5825,272,173,317,317,16,15,2,45,144,55,74,0,0
5826,275,169,320,313,16,15,2,45,144,56,74,0,0
5827,276,167,321,312,16,15,2,45,145,57,74,0,0
5828,277,167,321,308,16,15,2,44,141,58,74,0,0
5829,276,166,319,306,16,15,2,43,140,59,74,0,0
5830,278,163,321,303,16,15,2,43,140,60,74,0,0
5831,280,160,323,301,16,15,2,43,141,61,74,0,0
5832,279,160,320,299,16,15,2,41,139,62,74,0,0
5833,277,160,318,297,16,15,2,41,137,63,74,0,0
5834,276,160,316,296,16,15,2,40,136,64,74,0,0
5835,277,161,317,295,16,15,2,40,134,65,74,0,0
5836,278,162,316,289,16,15,2,38,127,66,74,0,0
5837,276,162,314,288,16,15,2,38,126,67,74,0,0
5838,274,162,312,287,16,15,2,38,125,68,74,0,0
5839,274,161,309,281,16,15,2,35,120,69,74,0,0
5840,273,159,309,281,16,15,2,36,122,70,74,0,0
5841,273,156,308,280,16,15,2,35,124,71,74,0,0
5842,272,155,307,280,16,15,2,35,125,72,74,0,0
5843,271,151,308,285,16,15,2,37,134,73,74,0,0
5844,271,150,306,279,16,15,2,35,129,74,74,1,0
284,1660,779,1902,1072,1,15,3,242,293,0,118,0,1
285,1574,766,1826,1072,1,15,3,252,306,1,118,0,0
286,1478,732,1759,1073,1,15,3,281,341,2,118,0,0
287,1378,692,1691,1073,1,15,3,313,381,3,118,0,0
288,1276,662,1607,1069,1,15,3,331,407,4,118,0,0
289,1179,626,1530,1064,1,15,3,351,438,5,118,0,0
290,1094,594,1462,1063,1,15,3,368,469,6,118,0,0
291,1019,577,1391,1064,1,15,3,372,487,7,118,0,0
292,938,546,1328,1072,1,15,3,390,526,8,118,0,0
293,848,520,1247,1071,1,15,3,399,551,9,118,0,0
294,793,498,1192,1067,1,15,3,399,569,10,118,0,0
295,754,478,1139,1051,1,15,3,385,573,11,118,0,0
296,713,460,1090,1043,1,15,3,377,583,12,118,0,0
297,687,439,1044,1012,1,15,3,357,573,13,118,0,0
298,666,416,995,963,1,15,3,329,547,14,118,0,0
299,643,411,949,933,1,15,3,306,522,15,118,0,0
300,623,393,905,892,1,15,3,282,499,16,118,0,0
301,610,383,875,867,1,15,3,265,484,17,118,0,0
302,603,366,856,844,1,15,3,253,478,18,118,0,0
303,603,352,834,801,1,15,3,231,449,19,118,0,0
304,596,343,817,784,1,15,3,221,441,20,118,0,0
305,590,334,793,751,1,15,3,203,417,21,118,0,0
306,588,326,778,726,1,15,3,190,400,22,118,0,0
307,591,323,771,713,1,15,3,180,390,23,118,0,0
308,597,307,767,684,1,15,3,170,377,24,118,0,0
309,600,297,763,667,1,15,3,163,370,25,118,0,0
310,594,288,751,655,1,15,3,157,367,26,118,0,0
311,587,280,734,633,1,15,3,147,353,27,118,0,0
312,583,277,722,621,1,15,3,139,344,28,118,0,0
313,580,273,710,605,1,15,3,130,332,29,118,0,0
314,574,267,698,589,1,15,3,124,322,30,118,0,0
315,559,259,680,580,1,15,3,121,321,31,118,0,0
316,548,256,659,557,1,15,3,111,301,32,118,0,0
317,535,250,643,549,1,15,3,108,299,33,118,0,0
318,529,248,632,540,1,15,3,103,292,34,118,0,0
319,525,244,623,523,1,15,3,98,279,35,118,0,0
320,514,241,609,516,1,15,3,95,275,36,118,0,0
321,504,235,596,502,1,15,3,92,267,37,118,0,0
322,493,231,583,494,1,15,3,90,263,38,118,0,0
323,491,231,577,487,1,15,3,86,256,39,118,0,0
324,491,229,573,474,1,15,3,82,245,40,118,0,0
325,490,226,570,470,1,15,3,80,244,41,118,0,0
326,488,224,566,465,1,15,3,78,241,42,118,0,0
327,485,218,562,454,1,15,3,77,236,43,118,0,0
328,485,215,559,447,1,15,3,74,232,44,118,0,0
329,490,209,564,441,1,15,3,74,232,45,118,0,0
330,493,205,565,436,1,15,3,72,231,46,118,0,0
331,493,204,563,431,1,15,3,70,227,47,118,0,0
332,490,202,558,422,1,15,3,68,220,48,118,0,0
333,490,200,554,409,1,15,3,64,209,49,118,0,0
334,490,200,552,404,1,15,3,62,204,50,118,0,0
335,492,198,553,399,1,15,3,61,201,51,118,0,0
336,491,197,550,395,1,15,3,59,198,52,118,0,0
337,484,197,544,395,1,15,3,60,198,53,118,0,0
338,480,190,538,389,1,15,3,58,199,54,118,0,0
339,478,188,532,373,1,15,3,54,185,55,118,0,0
340,477,187,533,379,1,15,3,56,192,56,118,0,0
341,475,184,529,372,1,15,3,54,188,57,118,0,0
342,470,184,524,370,1,15,3,54,186,58,118,0,0
343,464,182,517,365,1,15,3,53,183,59,118,0,0
344,460,180,512,360,1,15,3,52,180,60,118,0,0
345,460,180,511,359,1,15,3,51,179,61,118,0,0
346,460,178,510,352,1,15,3,50,174,62,118,0,0
347,460,178,508,345,1,15,3,48,167,63,118,0,0
348,456,176,504,342,1,15,3,48,166,64,118,0,0
349,453,174,500,341,1,15,3,47,167,65,118,0,0
350,451,173,498,341,1,15,3,47,168,66,118,0,0
351,452,172,498,333,1,15,3,46,161,67,118,0,0
352,450,172,494,326,1,15,3,44,154,68,118,0,0
353,444,171,489,326,1,15,3,45,155,69,118,0,0
354,437,166,482,322,1,15,3,45,156,70,118,0,0
355,432,165,477,320,1,15,3,45,155,71,118,0,0
356,431,165,475,317,1,15,3,44,152,72,118,0,0
357,430,165,472,309,1,15,3,42,144,73,118,0,0
358,426,166,468,311,1,15,3,42,145,74,118,0,0
359,421,166,464,310,1,15,3,43,144,75,118,0,0
360,416,163,460,310,1,15,3,44,147,76,118,0,0
361,414,162,457,311,1,15,3,43,149,77,118,0,0
362,411,160,455,306,1,15,3,44,146,78,118,0,0
363,407,159,449,299,1,15,3,42,140,79,118,0,0
364,402,158,444,298,1,15,3,42,140,80,118,0,0
365,398,157,441,299,1,15,3,43,142,81,118,0,0
366,396,156,439,298,1,15,3,43,142,82,118,0,0
367,396,155,440,299,1,15,3,44,144,83,118,0,0
368,397,155,439,294,1,15,3,42,139,84,118,0,0
369,396,154,440,296,1,15,3,44,142,85,118,0,0
370,395,154,436,291,1,15,3,41,137,86,118,0,0
371,394,153,434,285,1,15,3,40,132,87,118,0,0
372,395,152,435,284,1,15,3,40,132,88,118,0,0
373,397,153,436,282,1,15,3,39,129,89,118,0,0
374,396,152,436,281,1,15,3,40,129,90,118,0,0
375,394,152,434,279,1,15,3,40,127,91,118,0,0
376,393,152,433,279,1,15,3,40,127,92,118,0,0
377,387,152,427,280,1,15,3,40,128,93,118,0,0
378,383,152,423,281,1,15,3,40,129,94,118,0,0
379,380,152,420,280,1,15,3,40,128,95,118,0,0
380,379,151,418,279,1,15,3,39,128,96,118,0,0
381,379,152,418,280,1,15,3,39,128,97,118,0,0
382,380,152,419,283,1,15,3,39,131,98,118,0,0
383,383,152,420,278,1,15,3,37,126,99,118,0,0
384,386,152,423,276,1,15,3,37,124,100,118,0,0
385,390,153,428,275,1,15,3,38,122,101,118,0,0
386,396,152,435,277,1,15,3,39,125,102,118,0,0
387,400,151,438,273,1,15,3,38,122,103,118,0,0
388,401,151,439,272,1,15,3,38,121,104,118,0,0
389,400,151,437,270,1,15,3,37,119,105,118,0,0
390,397,151,435,270,1,15,3,38,119,106,118,0,0
391,397,150,435,270,1,15,3,38,120,107,118,0,0
392,398,150,436,269,1,15,3,38,119,108,118,0,0
393,399,149,438,269,1,15,3,39,120,109,118,0,0
394,400,149,438,270,1,15,3,38,121,110,118,0,0
395,399,149,438,270,1,15,3,39,121,111,118,0,0
396,400,149,439,270,1,15,3,39,121,112,118,0,0
397,401,149,439,270,1,15,3,38,121,113,118,0,0
398,399,151,437,271,1,15,3,38,120,114,118,0,0
399,395,152,434,272,1,15,3,39,120,115,118,0,0
400,388,150,426,272,1,15,3,38,122,116,118,0,0
401,380,151,417,269,1,15,3,37,118,117,118,0,0
402,371,150,407,267,1,15,3,36,117,118,118,1,0
404,347,155,382,268,1,15,3,35,113,0,118,0,0
405,331,151,368,269,1,15,3,37,118,1,118,0,0
406,317,153,354,270,1,15,3,37,117,2,118,0,0
407,304,157,340,271,1,15,3,36,114,3,118,0,0
408,289,154,324,271,1,15,3,35,117,4,118,0,0
409,280,154,316,271,1,15,3,36,117,5,118,0,0
399,414,161,449,262,3,15,3,35,101,0,0,0,0
1307,341,161,376,291,4,15,3,35,130,0,75,0,1
1308,348,164,385,299,4,15,3,37,135,1,75,0,0
1309,352,164,389,300,4,15,3,37,136,2,75,0,0
1310,355,163,392,299,4,15,3,37,136,3,75,0,0
1311,359,167,396,302,4,15,3,37,135,4,75,0,0
1312,364,167,403,307,4,15,3,39,140,5,75,0,0
1313,371,167,410,308,4,15,3,39,141,6,75,0,0
1314,376,172,416,314,4,15,3,40,142,7,75,0,0
1315,383,171,423,315,4,15,3,40,144,8,75,0,0
1316,391,171,434,317,4,15,3,43,146,9,75,0,0
1317,406,172,452,323,4,15,3,46,151,10,75,0,0
1318,424,171,470,321,4,15,3,46,150,11,75,0,0
1319,437,172,485,325,4,15,3,48,153,12,75,0,0
1320,456,173,506,330,4,15,3,50,157,13,75,0,0
1321,470,174,522,335,4,15,3,52,161,14,75,0,0
1322,483,174,535,332,4,15,3,52,158,15,75,0,0
1323,491,172,543,334,4,15,3,52,162,16,75,0,0
1324,494,173,544,334,4,15,3,50,161,17,75,0,0
1325,492,174,542,334,4,15,3,50,160,18,75,0,0
1326,487,176,537,336,4,15,3,50,160,19,75,0,0
1327,482,178,533,336,4,15,3,51,158,20,75,0,0
1328,469,177,521,335,4,15,3,52,158,21,75,0,0
1329,464,176,516,335,4,15,3,52,159,22,75,0,0
1330,457,176,508,334,4,15,3,51,158,23,75,0,0
1331,445,175,497,335,4,15,3,52,160,24,75,0,0
1332,436,175,489,338,4,15,3,53,163,25,75,0,0
1333,431,174,484,339,4,15,3,53,165,26,75,0,0
1334,429,174,482,340,4,15,3,53,166,27,75,0,0
1335,427,174,480,341,4,15,3,53,167,28,75,0,0
1336,427,174,479,341,4,15,3,52,167,29,75,0,0
1337,426,174,478,342,4,15,3,52,168,30,75,0,0
1338,426,174,478,342,4,15,3,52,168,31,75,0,0
1339,426,174,477,342,4,15,3,51,168,32,75,0,0
1340,426,174,477,341,4,15,3,51,167,33,75,0,0
1341,427,174,478,341,4,15,3,51,167,34,75,0,0
1342,428,174,478,341,4,15,3,50,167,35,75,0,0
1343,429,175,478,340,4,15,3,49,165,36,75,0,0
1344,429,175,478,340,4,15,3,49,165,37,75,0,0
1345,429,175,478,340,4,15,3,49,165,38,75,0,0
1346,430,175,478,339,4,15,3,48,164,39,75,0,0
1347,430,175,478,339,4,15,3,48,164,40,75,0,0
1348,431,176,478,339,4,15,3,47,163,41,75,0,0
1349,431,176,478,339,4,15,3,47,163,42,75,0,0
1350,431,176,478,339,4,15,3,47,163,43,75,0,0
1351,430,176,478,339,4,15,3,48,163,44,75,0,0
1352,430,176,478,339,4,15,3,48,163,45,75,0,0
1353,430,175,478,339,4,15,3,48,164,46,75,0,0
1354,431,175,478,338,4,15,3,47,163,47,75,0,0
1355,434,175,483,339,4,15,3,49,164,48,75,0,0
1356,440,178,493,343,4,15,3,53,165,49,75,0,0
1357,456,179,514,343,4,15,3,58,164,50,75,0,0
1358,463,179,523,341,4,15,3,60,162,51,75,0,0
1359,465,179,528,339,4,15,3,63,160,52,75,0,0
1360,466,178,532,338,4,15,3,66,160,53,75,0,0
1361,466,176,536,340,4,15,3,70,164,54,75,0,0
1362,457,178,526,340,4,15,3,69,162,55,75,0,0
1363,450,177,517,341,4,15,3,67,164,56,75,0,0
1364,444,177,510,339,4,15,3,66,162,57,75,0,0
1365,439,177,503,337,4,15,3,64,160,58,75,0,0
1366,434,177,497,338,4,15,3,63,161,59,75,0,0
1367,430,176,493,341,4,15,3,63,165,60,75,0,0
1368,428,175,489,337,4,15,3,61,162,61,75,0,0
1369,428,174,487,335,4,15,3,59,161,62,75,0,0
1370,430,175,488,334,4,15,3,58,159,63,75,0,0
1371,435,176,493,338,4,15,3,58,162,64,75,0,0
1372,445,176,502,336,4,15,3,57,160,65,75,0,0
1373,452,175,507,333,4,15,3,55,158,66,75,0,0
1374,455,175,508,331,4,15,3,53,156,67,75,0,0
1375,456,174,508,328,4,15,3,52,154,68,75,0,0
1376,458,174,510,328,4,15,3,52,154,69,75,0,0
1377,461,173,514,327,4,15,3,53,154,70,75,0,0
1378,465,174,520,331,4,15,3,55,157,71,75,0,0
1379,484,171,536,326,4,15,3,52,155,72,75,0,0
1380,496,171,549,325,4,15,3,53,154,73,75,0,0
1381,515,170,562,314,4,15,3,47,144,74,75,0,0
1382,521,170,567,312,4,15,3,46,142,75,75,1,0
3384,246,206,290,457,5,15,3,44,251,0,36,0,1
3385,251,199,298,469,5,15,3,47,270,1,36,0,0
3386,265,197,315,474,5,15,3,50,277,2,36,0,0
3387,275,207,328,483,5,15,3,53,276,3,36,0,0
3388,287,212,343,492,5,15,3,56,280,4,36,0,0
3389,299,213,357,497,5,15,3,58,284,5,36,0,0
3390,309,221,371,517,5,15,3,62,296,6,36,0,0
3391,321,219,386,524,5,15,3,65,305,7,36,0,0
3392,335,223,404,533,5,15,3,69,310,8,36,0,0
3393,343,232,418,556,5,15,3,75,324,9,36,0,0
3394,347,236,425,564,5,15,3,78,328,10,36,0,0
3395,352,240,436,587,5,15,3,84,347,11,36,0,0
3396,363,246,451,609,5,15,3,88,363,12,36,0,0
3397,378,243,471,619,5,15,3,93,376,13,36,0,0
3398,385,251,486,643,5,15,3,101,392,14,36,0,0
3399,399,259,505,663,5,15,3,106,404,15,36,0,0
3400,413,266,523,677,5,15,3,110,411,16,36,0,0
3401,432,272,549,711,5,15,3,117,439,17,36,0,0
3402,452,278,573,728,5,15,3,121,450,18,36,0,0
3403,481,287,604,732,5,15,3,123,445,19,36,0,0
3404,489,300,629,787,5,15,3,140,487,20,36,0,0
3405,512,307,659,812,5,15,3,147,505,21,36,0,0
3406,539,324,694,850,5,15,3,155,526,22,36,0,0
3407,569,339,733,892,5,15,3,164,553,23,36,0,0
3408,609,352,778,913,5,15,3,169,561,24,36,0,0
3409,648,371,837,985,5,15,3,189,614,25,36,0,0
3410,683,393,882,1031,5,15,3,199,638,26,36,0,0
3411,711,413,912,1057,5,15,3,201,644,27,36,0,0
3412,756,448,953,1074,5,15,3,197,626,28,36,0,0
3413,811,471,1010,1079,5,15,3,199,608,29,36,0,0
3414,879,502,1079,1080,5,15,3,200,578,30,36,0,0
3415,943,553,1146,1080,5,15,3,203,527,31,36,0,0
3416,1010,601,1205,1080,5,15,3,195,479,32,36,0,0
3417,1096,650,1285,1080,5,15,3,189,430,33,36,0,0
3418,1217,725,1391,1078,5,15,3,174,353,34,36,0,0
3419,1351,795,1509,1070,5,15,3,158,275,35,36,0,0
3420,1429,835,1568,1078,5,15,3,139,243,36,36,1,0
3555,1670,928,1813,1077,7,15,3,143,149,0,0,0,0
3556,1541,881,1711,1075,8,15,3,170,194,0,0,0,0
3557,1413,795,1623,1070,9,15,3,210,275,0,0,0,0
3558,1207,721,1533,1072,10,15,3,326,351,0,93,0,1
3559,1089,681,1453,1073,10,15,3,364,392,1,93,0,0
3560,1035,619,1448,1069,10,15,3,413,450,2,93,0,0
3561,935,580,1378,1070,10,15,3,443,490,3,93,0,0
3562,865,533,1333,1062,10,15,3,468,529,4,93,0,0
3563,775,499,1262,1065,10,15,3,487,566,5,93,0,0
3564,721,463,1204,1040,10,15,3,483,577,6,93,0,0
3565,734,432,1165,965,10,15,3,431,533,7,93,0,0
3566,722,416,1122,930,10,15,3,400,514,8,93,0,0
3567,705,385,1060,859,10,15,3,355,474,9,93,0,0
3568,674,372,1005,829,10,15,3,331,457,10,93,0,0
3569,662,351,966,785,10,15,3,304,434,11,93,0,0
3570,672,336,943,740,10,15,3,271,404,12,93,0,0
3571,665,324,910,705,10,15,3,245,381,13,93,0,0
3572,638,305,866,674,10,15,3,228,369,14,93,0,0
3573,606,295,824,657,10,15,3,218,362,15,93,0,0
3574,605,283,800,619,10,15,3,195,336,16,93,0,0
3575,590,277,772,601,10,15,3,182,324,17,93,0,0
3576,574,267,739,575,10,15,3,165,308,18,93,0,0
3577,552,259,708,558,10,15,3,156,299,19,93,0,0
3578,531,253,681,544,10,15,3,150,291,20,93,0,0
3579,533,246,673,527,10,15,3,140,281,21,93,0,0
3580,524,246,654,514,10,15,3,130,268,22,93,0,0
3581,514,237,636,498,10,15,3,122,261,23,93,0,0
3582,490,238,610,494,10,15,3,120,256,24,93,0,0
3583,481,230,595,476,10,15,3,114,246,25,93,0,0
3584,487,226,594,463,10,15,3,107,237,26,93,0,0
3585,486,224,588,456,10,15,3,102,232,27,93,0,0
3586,478,214,577,442,10,15,3,99,228,28,93,0,0
3587,478,213,572,432,10,15,3,94,219,29,93,0,0
3588,482,205,571,416,10,15,3,89,211,30,93,0,0
3589,488,205,575,415,10,15,3,87,210,31,93,0,0
3590,491,202,573,402,10,15,3,82,200,32,93,0,0
3591,490,199,569,395,10,15,3,79,196,33,93,0,0
3592,493,198,570,390,10,15,3,77,192,34,93,0,0
3593,497,191,570,378,10,15,3,73,187,35,93,0,0
3594,499,193,570,376,10,15,3,71,183,36,93,0,0
3595,496,188,566,368,10,15,3,70,180,37,93,0,0
3596,496,186,564,361,10,15,3,68,175,38,93,0,0
3597,501,182,568,358,10,15,3,67,176,39,93,0,0
3598,504,180,569,352,10,15,3,65,172,40,93,0,0
3599,503,177,567,349,10,15,3,64,172,41,93,0,0
3600,500,176,563,345,10,15,3,63,169,42,93,0,0
3601,496,177,558,344,10,15,3,62,167,43,93,0,0
3602,486,178,547,346,10,15,3,61,168,44,93,0,0
3603,478,178,539,346,10,15,3,61,168,45,93,0,0
3604,474,182,532,344,10,15,3,58,162,46,93,0,0
3605,471,182,528,344,10,15,3,57,162,47,93,0,0
3606,470,183,526,345,10,15,3,56,162,48,93,0,0
3607,469,182,525,345,10,15,3,56,163,49,93,0,0
3608,468,181,525,348,10,15,3,57,167,50,93,0,0
3609,468,181,524,346,10,15,3,56,165,51,93,0,0
3610,467,180,523,348,10,15,3,56,168,52,93,0,0
3611,467,179,522,348,10,15,3,55,169,53,93,0,0
3612,466,179,521,349,10,15,3,55,170,54,93,0,0
3613,466,178,521,349,10,15,3,55,171,55,93,0,0
3614,467,178,521,349,10,15,3,54,171,56,93,0,0
3615,467,178,521,349,10,15,3,54,171,57,93,0,0
3616,467,178,520,349,10,15,3,53,171,58,93,0,0
3617,468,179,520,349,10,15,3,52,170,59,93,0,0
3618,469,179,520,349,10,15,3,51,170,60,93,0,0
3619,469,179,520,349,10,15,3,51,170,61,93,0,0
3620,470,179,520,349,10,15,3,50,170,62,93,0,0
3621,470,179,520,350,10,15,3,50,171,63,93,0,0
3622,469,178,519,350,10,15,3,50,172,64,93,0,0
3623,470,181,518,348,10,15,3,48,167,65,93,0,0
3624,471,181,518,345,10,15,3,47,164,66,93,0,0
3625,473,181,520,344,10,15,3,47,163,67,93,0,0
3626,475,181,523,344,10,15,3,48,163,68,93,0,0
3627,478,181,526,345,10,15,3,48,164,69,93,0,0
3628,482,181,530,348,10,15,3,48,167,70,93,0,0
3629,487,182,535,348,10,15,3,48,166,71,93,0,0
3630,488,182,538,347,10,15,3,50,165,72,93,0,0
3631,488,182,538,349,10,15,3,50,167,73,93,0,0
3632,491,182,543,351,10,15,3,52,169,74,93,0,0
3633,498,182,550,350,10,15,3,52,168,75,93,0,0
3634,506,183,558,353,10,15,3,52,170,76,93,0,0
3635,512,183,565,357,10,15,3,53,174,77,93,0,0
3636,518,186,569,354,10,15,3,51,168,78,93,0,0
3637,523,185,575,357,10,15,3,52,172,79,93,0,0
3638,527,185,579,362,10,15,3,52,177,80,93,0,0
3639,530,184,582,363,10,15,3,52,179,81,93,0,0
3640,533,185,584,363,10,15,3,51,178,82,93,0,0
3641,535,185,585,362,10,15,3,50,177,83,93,0,0
3642,535,185,585,363,10,15,3,50,178,84,93,0,0
3643,536,185,585,362,10,15,3,49,177,85,93,0,0
3644,536,186,584,362,10,15,3,48,176,86,93,0,0
3645,536,187,583,361,10,15,3,47,174,87,93,0,0
3646,537,187,583,362,10,15,3,46,175,88,93,0,0
3647,540,190,585,358,10,15,3,45,168,89,93,0,0
3648,544,189,592,360,10,15,3,48,171,90,93,0,0
3649,549,190,600,365,10,15,3,51,175,91,93,0,0
3650,554,192,608,368,10,15,3,54,176,92,93,0,0
3651,557,192,611,369,10,15,3,54,177,93,93,1,0
3423,1716,569,1915,1080,46,15,4,199,511,0,74,0,1
3424,1640,564,1839,1073,46,15,4,199,509,1,74,0,0
3425,1536,538,1743,1064,46,15,4,207,526,2,74,0,0
3426,1412,501,1637,1063,46,15,4,225,562,3,74,0,0
3427,1314,478,1556,1065,46,15,4,242,587,4,74,0,0
3428,1259,451,1515,1068,46,15,4,256,617,5,74,0,0
3429,1216,426,1482,1069,46,15,4,266,643,6,74,0,0
3430,1186,407,1455,1066,46,15,4,269,659,7,74,0,0
3431,1160,385,1413,1008,46,15,4,253,623,8,74,0,0
3432,1142,372,1390,979,46,15,4,248,607,9,74,0,0
3433,1149,359,1387,946,46,15,4,238,587,10,74,0,0
3434,1162,336,1382,883,46,15,4,220,547,11,74,0,0
3435,1168,314,1382,859,46,15,4,214,545,12,74,0,0
3436,1170,293,1378,826,46,15,4,208,533,13,74,0,0
3437,1188,272,1380,770,46,15,4,192,498,14,74,0,0
3438,1209,268,1390,746,46,15,4,181,478,15,74,0,0
3439,1233,264,1396,701,46,15,4,163,437,16,74,0,0
3440,1245,253,1401,678,46,15,4,156,425,17,74,0,0
3441,1253,251,1406,674,46,15,4,153,423,18,74,0,0
3442,1266,244,1408,640,46,15,4,142,396,19,74,0,0
3443,1285,239,1417,616,46,15,4,132,377,20,74,0,0
3444,1308,242,1430,593,46,15,4,122,351,21,74,0,0
3445,1328,230,1446,575,46,15,4,118,345,22,74,0,0
3446,1337,226,1452,564,46,15,4,115,338,23,74,0,0
3447,1345,224,1456,555,46,15,4,111,331,24,74,0,0
3448,1360,222,1464,534,46,15,4,104,312,25,74,0,0
3449,1374,217,1474,524,46,15,4,100,307,26,74,0,0
3450,1389,210,1485,507,46,15,4,96,297,27,74,0,0
3451,1393,208,1488,498,46,15,4,95,290,28,74,0,0
3452,1395,209,1488,496,46,15,4,93,287,29,74,0,0
3453,1404,203,1492,475,46,15,4,88,272,30,74,0,0
3454,1412,193,1499,464,46,15,4,87,271,31,74,0,0
3455,1421,193,1504,456,46,15,4,83,263,32,74,0,0
3456,1430,189,1509,443,46,15,4,79,254,33,74,0,0
3457,1431,185,1510,437,46,15,4,79,252,34,74,0,0
3458,1433,183,1511,432,46,15,4,78,249,35,74,0,0
3459,1442,185,1514,417,46,15,4,72,232,36,74,0,0
3460,1448,186,1519,415,46,15,4,71,229,37,74,0,0
3461,1455,176,1526,408,46,15,4,71,232,38,74,0,0
3462,1460,168,1531,400,46,15,4,71,232,39,74,0,0
3463,1461,168,1530,398,46,15,4,69,230,40,74,0,0
3464,1463,164,1529,388,46,15,4,66,224,41,74,0,0
3465,1466,169,1529,380,46,15,4,63,211,42,74,0,0
3466,1468,166,1530,375,46,15,4,62,209,43,74,0,0
3467,1472,160,1533,369,46,15,4,61,209,44,74,0,0
3468,1476,160,1537,365,46,15,4,61,205,45,74,0,0
3469,1477,155,1539,361,46,15,4,62,206,46,74,0,0
3470,1478,156,1538,354,46,15,4,60,198,47,74,0,0
3471,1483,156,1542,349,46,15,4,59,193,48,74,0,0
3472,1490,154,1549,345,46,15,4,59,191,49,74,0,0
3473,1496,153,1552,337,46,15,4,56,184,50,74,0,0
3474,1499,156,1555,336,46,15,4,56,180,51,74,0,0
3475,1501,152,1556,331,46,15,4,55,179,52,74,0,0
3476,1505,151,1559,327,46,15,4,54,176,53,74,0,0
3477,1510,152,1563,325,46,15,4,53,173,54,74,0,0
3478,1514,149,1567,322,46,15,4,53,173,55,74,0,0
3479,1516,150,1568,317,46,15,4,52,167,56,74,0,0
3480,1517,151,1567,313,46,15,4,50,162,57,74,0,0
3481,1517,151,1566,306,46,15,4,49,155,58,74,0,0
3482,1518,150,1567,303,46,15,4,49,153,59,74,0,0
3483,1520,150,1569,301,46,15,4,49,151,60,74,0,0
3484,1522,149,1571,298,46,15,4,49,149,61,74,0,0
3485,1522,149,1571,296,46,15,4,49,147,62,74,0,0
3486,1524,148,1572,294,46,15,4,48,146,63,74,0,0
3487,1527,148,1574,290,46,15,4,47,142,64,74,0,0
3488,1529,147,1577,288,46,15,4,48,141,65,74,0,0
3489,1533,146,1580,286,46,15,4,47,140,66,74,0,0
3490,1535,146,1584,287,46,15,4,49,141,67,74,0,0
3491,1538,146,1586,285,46,15,4,48,139,68,74,0,0
3492,1540,145,1587,278,46,15,4,47,133,69,74,0,0
3493,1543,147,1590,279,46,15,4,47,132,70,74,0,0
3494,1552,153,1597,278,46,15,4,45,125,71,74,0,0
3495,1560,154,1602,273,46,15,4,42,119,72,74,0,0
3496,1565,154,1606,271,46,15,4,41,117,73,74,0,0
3497,1569,154,1609,268,46,15,4,40,114,74,74,1,0
3463,1613,139,1648,231,51,15,4,35,92,0,73,0,0
3469,1608,145,1643,238,51,15,4,35,93,0,73,0,0
3470,1609,142,1644,239,51,15,4,35,97,1,73,0,0
3471,1609,142,1645,242,51,15,4,36,100,2,73,0,0
3472,1609,139,1647,245,51,15,4,38,106,3,73,0,0
3473,1609,141,1647,249,51,15,4,38,108,4,73,0,0
3474,1609,141,1648,252,51,15,4,39,111,5,73,0,0
3475,1610,145,1648,253,51,15,4,38,108,6,73,0,0
3476,1612,144,1649,253,51,15,4,37,109,7,73,0,0
3477,1612,143,1650,256,51,15,4,38,113,8,73,0,0
3478,1611,144,1649,257,51,15,4,38,113,9,73,0,0
3479,1611,144,1650,259,51,15,4,39,115,10,73,0,0
3481,1611,147,1650,264,51,15,4,39,117,0,73,0,1
3482,1611,152,1649,267,51,15,4,38,115,1,73,0,0
3483,1611,155,1649,270,51,15,4,38,115,2,73,0,0
3484,1610,158,1648,274,51,15,4,38,116,3,73,0,0
3485,1611,158,1649,275,51,15,4,38,117,4,73,0,0
3486,1612,162,1651,280,51,15,4,39,118,5,73,0,0
3487,1612,165,1651,283,51,15,4,39,118,6,73,0,0
3488,1611,165,1651,286,51,15,4,40,121,7,73,0,0
3489,1612,166,1653,291,51,15,4,41,125,8,73,0,0
3490,1610,166,1653,296,51,15,4,43,130,9,73,0,0
3491,1608,169,1651,299,51,15,4,43,130,10,73,0,0
3492,1606,166,1650,300,51,15,4,44,134,11,73,0,0
3493,1605,169,1650,305,51,15,4,45,136,12,73,0,0
3494,1604,171,1648,306,51,15,4,44,135,13,73,0,0
3495,1602,171,1648,311,51,15,4,46,140,14,73,0,0
3496,1600,167,1648,314,51,15,4,48,147,15,73,0,0
3497,1597,164,1648,321,51,15,4,51,157,16,73,0,0
3498,1597,172,1646,325,51,15,4,49,153,17,73,0,0
3499,1595,176,1644,328,51,15,4,49,152,18,73,0,0
3500,1592,181,1640,332,51,15,4,48,151,19,73,0,0
3501,1587,187,1633,336,51,15,4,46,149,20,73,0,0
3502,1583,189,1631,342,51,15,4,48,153,21,73,0,0
3503,1581,192,1629,345,51,15,4,48,153,22,73,0,0
3504,1576,183,1627,350,51,15,4,51,167,23,73,0,0
3505,1570,189,1621,358,51,15,4,51,169,24,73,0,0
3506,1566,193,1618,364,51,15,4,52,171,25,73,0,0
3507,1562,186,1617,372,51,15,4,55,186,26,73,0,0
3508,1559,187,1615,377,51,15,4,56,190,27,73,0,0
3509,1552,187,1610,387,51,15,4,58,200,28,73,0,0
3510,1545,195,1603,394,51,15,4,58,199,29,73,0,0
3511,1540,198,1600,401,51,15,4,60,203,30,73,0,0
3512,1537,203,1598,408,51,15,4,61,205,31,73,0,0
3513,1533,203,1597,416,51,15,4,64,213,32,73,0,0
3514,1531,215,1594,428,51,15,4,63,213,33,73,0,0
3515,1526,211,1593,435,51,15,4,67,224,34,73,0,0
3516,1522,220,1590,447,51,15,4,68,227,35,73,0,0
3517,1520,223,1590,456,51,15,4,70,233,36,73,0,0
3518,1510,223,1586,472,51,15,4,76,249,37,73,0,0
3519,1505,229,1583,483,51,15,4,78,254,38,73,0,0
3520,1496,230,1579,499,51,15,4,83,269,39,73,0,0
3521,1491,245,1576,517,51,15,4,85,272,40,73,0,0
3522,1485,248,1572,524,51,15,4,87,276,41,73,0,0
3523,1474,256,1567,548,51,15,4,93,292,42,73,0,0
3524,1466,260,1562,561,51,15,4,96,301,43,73,0,0
3525,1452,270,1554,587,51,15,4,102,317,44,73,0,0
3526,1443,280,1550,608,51,15,4,107,328,45,73,0,0
3527,1424,289,1539,637,51,15,4,115,348,46,73,0,0
3528,1411,301,1530,662,51,15,4,119,361,47,73,0,0
3529,1394,310,1521,692,51,15,4,127,382,48,73,0,0
3530,1380,332,1514,733,51,15,4,134,401,49,73,0,0
3531,1366,343,1504,752,51,15,4,138,409,50,73,0,0
3532,1339,366,1488,799,51,15,4,149,433,51,73,0,0
3533,1313,376,1470,827,51,15,4,157,451,52,73,0,0
3534,1287,392,1461,890,51,15,4,174,498,53,73,0,0
3535,1270,422,1452,936,51,15,4,182,514,54,73,0,0
3536,1248,446,1440,978,51,15,4,192,532,55,73,0,0
3537,1216,479,1425,1041,51,15,4,209,562,56,73,0,0
3538,1186,504,1400,1074,51,15,4,214,570,57,73,0,0
3539,1175,534,1385,1080,51,15,4,210,546,58,73,0,0
3540,1190,557,1395,1080,51,15,4,205,523,59,73,0,0
3541,1212,570,1423,1080,51,15,4,211,510,60,73,0,0
3542,1218,588,1432,1080,51,15,4,214,492,61,73,0,0
3543,1196,604,1409,1080,51,15,4,213,476,62,73,0,0
3544,1196,615,1411,1080,51,15,4,215,465,63,73,0,0
3545,1218,613,1440,1080,51,15,4,222,467,64,73,0,0
3546,1239,618,1461,1075,51,15,4,222,457,65,73,0,0
3547,1259,627,1487,1076,51,15,4,228,449,66,73,0,0
3548,1256,634,1490,1073,51,15,4,234,439,67,73,0,0
3549,1243,652,1476,1072,51,15,4,233,420,68,73,0,0
3550,1246,688,1472,1075,51,15,4,226,387,69,73,0,0
3551,1298,744,1508,1075,51,15,4,210,331,70,73,0,0
3552,1406,804,1603,1079,51,15,4,197,275,71,73,0,0
3553,1508,822,1719,1080,51,15,4,211,258,72,73,0,0
3554,1554,847,1749,1080,51,15,4,195,233,73,73,1,0
4970,1617,147,1652,260,70,15,4,35,113,0,42,0,0
4971,1617,145,1654,265,70,15,4,37,120,1,42,0,0
4972,1617,146,1654,267,70,15,4,37,121,2,42,0,0
4974,1617,160,1652,272,70,15,4,35,112,0,42,0,0
4975,1617,157,1654,275,70,15,4,37,118,1,42,0,0
4976,1615,147,1655,277,70,15,4,40,130,2,42,0,0
4977,1613,142,1656,284,70,15,4,43,142,3,42,0,0
4978,1610,139,1654,287,70,15,4,44,148,4,42,0,0
4979,1609,148,1652,292,70,15,4,43,144,5,42,0,0
4980,1607,152,1650,295,70,15,4,43,143,6,42,0,0
4981,1607,161,1647,295,70,15,4,40,134,7,42,0,0
4982,1605,166,1645,300,70,15,4,40,134,8,42,0,0
4983,1604,170,1644,305,70,15,4,40,135,9,42,0,0
4984,1602,175,1642,312,70,15,4,40,137,10,42,0,0
4985,1600,176,1641,316,70,15,4,41,140,11,42,0,0
4986,1599,178,1640,319,70,15,4,41,141,12,42,0,0
4988,1594,180,1638,332,70,15,4,44,152,0,42,0,1
4989,1591,182,1637,338,70,15,4,46,156,1,42,0,0
4990,1589,180,1636,341,70,15,4,47,161,2,42,0,0
4991,1587,180,1636,351,70,15,4,49,171,3,42,0,0
4992,1586,178,1636,354,70,15,4,50,176,4,42,0,0
4993,1585,180,1636,362,70,15,4,51,182,5,42,0,0
4994,1583,182,1634,365,70,15,4,51,183,6,42,0,0
4995,1581,185,1633,371,70,15,4,52,186,7,42,0,0
4996,1578,185,1633,382,70,15,4,55,197,8,42,0,0
4997,1575,181,1633,389,70,15,4,58,208,9,42,0,0
4998,1570,176,1633,401,70,15,4,63,225,10,42,0,0
4999,1565,173,1630,408,70,15,4,65,235,11,42,0,0
5000,1561,173,1630,416,70,15,4,69,243,12,42,0,0
5001,1558,176,1628,428,70,15,4,70,252,13,42,0,0
5002,1557,174,1628,433,70,15,4,71,259,14,42,0,0
5003,1554,183,1628,448,70,15,4,74,265,15,42,0,0
5004,1552,188,1627,457,70,15,4,75,269,16,42,0,0
5005,1548,192,1626,470,70,15,4,78,278,17,42,0,0
5006,1545,202,1625,483,70,15,4,80,281,18,42,0,0
5007,1541,205,1623,490,70,15,4,82,285,19,42,0,0
5008,1536,209,1624,512,70,15,4,88,303,20,42,0,0
5009,1531,210,1622,524,70,15,4,91,314,21,42,0,0
5010,1526,217,1622,547,70,15,4,96,330,22,42,0,0
5011,1521,225,1622,570,70,15,4,101,345,23,42,0,0
5012,1515,226,1620,580,70,15,4,105,354,24,42,0,0
5013,1506,238,1617,608,70,15,4,111,370,25,42,0,0
5014,1495,242,1610,625,70,15,4,115,383,26,42,0,0
5015,1480,248,1607,665,70,15,4,127,417,27,42,0,0
5016,1470,264,1602,692,70,15,4,132,428,28,42,0,0
5017,1458,265,1595,710,70,15,4,137,445,29,42,0,0
5018,1441,279,1590,756,70,15,4,149,477,30,42,0,0
5019,1422,284,1576,782,70,15,4,154,498,31,42,0,0
5020,1399,301,1569,845,70,15,4,170,544,32,42,0,0
5021,1377,325,1555,887,70,15,4,178,562,33,42,0,0
5022,1353,340,1544,937,70,15,4,191,597,34,42,0,0
5023,1325,373,1530,1006,70,15,4,205,633,35,42,0,0
5024,1296,400,1507,1042,70,15,4,211,642,36,42,0,0
5025,1266,440,1480,1074,70,15,4,214,634,37,42,0,0
5026,1240,485,1453,1080,70,15,4,213,595,38,42,0,0
5027,1224,533,1433,1080,70,15,4,209,547,39,42,0,0
5028,1196,623,1387,1080,70,15,4,191,457,40,42,0,0
5029,1151,713,1327,1080,70,15,4,176,367,41,42,0,0
5030,1134,748,1303,1080,70,15,4,169,332,42,42,1,0
5028,1126,734,1236,1055,71,15,4,110,321,0,0,0,0
5029,1025,807,1156,1073,72,15,4,131,266,0,1,0,0
5030,1066,910,1151,1074,72,15,4,85,164,1,1,0,0
5689,1613,160,1648,272,77,15,4,35,112,0,79,0,1
5690,1613,159,1648,273,77,15,4,35,114,1,79,0,0
5691,1610,158,1647,277,77,15,4,37,119,2,79,0,0
5692,1609,158,1646,279,77,15,4,37,121,3,79,0,0
5693,1608,153,1648,284,77,15,4,40,131,4,79,0,0
5694,1608,155,1647,286,77,15,4,39,131,5,79,0,0
5695,1606,155,1647,288,77,15,4,41,133,6,79,0,0
5696,1606,159,1646,291,77,15,4,40,132,7,79,0,0
5697,1605,159,1645,293,77,15,4,40,134,8,79,0,0
5698,1606,163,1646,297,77,15,4,40,134,9,79,0,0
5699,1606,165,1648,300,77,15,4,42,135,10,79,0,0
5700,1606,164,1649,302,77,15,4,43,138,11,79,0,0
5701,1606,168,1649,304,77,15,4,43,136,12,79,0,0
5702,1605,167,1649,307,77,15,4,44,140,13,79,0,0
5703,1606,170,1651,309,77,15,4,45,139,14,79,0,0
5704,1609,170,1654,312,77,15,4,45,142,15,79,0,0
5705,1610,170,1657,318,77,15,4,47,148,16,79,0,0
5706,1610,171,1659,322,77,15,4,49,151,17,79,0,0
5707,1609,172,1659,326,77,15,4,50,154,18,79,0,0
5708,1612,176,1662,332,77,15,4,50,156,19,79,0,0
5709,1615,177,1664,333,77,15,4,49,156,20,79,0,0
5710,1615,176,1666,338,77,15,4,51,162,21,79,0,0
5711,1614,177,1666,341,77,15,4,52,164,22,79,0,0
5712,1611,178,1664,344,77,15,4,53,166,23,79,0,0
5713,1611,179,1665,351,77,15,4,54,172,24,79,0,0
5714,1611,181,1665,354,77,15,4,54,173,25,79,0,0
5715,1610,181,1665,358,77,15,4,55,177,26,79,0,0
5716,1606,182,1662,364,77,15,4,56,182,27,79,0,0
5717,1604,184,1660,366,77,15,4,56,182,28,79,0,0
5718,1604,189,1660,372,77,15,4,56,183,29,79,0,0
5719,1606,191,1661,376,77,15,4,55,185,30,79,0,0
5720,1606,195,1662,382,77,15,4,56,187,31,79,0,0
5721,1605,196,1662,388,77,15,4,57,192,32,79,0,0
5722,1602,195,1661,391,77,15,4,59,196,33,79,0,0
5723,1601,197,1660,398,77,15,4,59,201,34,79,0,0
5724,1603,202,1663,404,77,15,4,60,202,35,79,0,0
5725,1601,201,1662,409,77,15,4,61,208,36,79,0,0
5726,1600,204,1662,419,77,15,4,62,215,37,79,0,0
5727,1596,207,1659,424,77,15,4,63,217,38,79,0,0
5728,1595,209,1660,432,77,15,4,65,223,39,79,0,0
5729,1594,211,1661,441,77,15,4,67,230,40,79,0,0
5730,1595,213,1661,446,77,15,4,66,233,41,79,0,0
5731,1593,218,1660,452,77,15,4,67,234,42,79,0,0
5732,1589,222,1656,458,77,15,4,67,236,43,79,0,0
5733,1586,224,1656,468,77,15,4,70,244,44,79,0,0
5734,1583,228,1655,480,77,15,4,72,252,45,79,0,0
5735,1582,231,1655,487,77,15,4,73,256,46,79,0,0
5736,1573,232,1650,500,77,15,4,77,268,47,79,0,0
5737,1562,230,1643,510,77,15,4,81,280,48,79,0,0
5738,1553,234,1636,519,77,15,4,83,285,49,79,0,0
5739,1549,240,1633,532,77,15,4,84,292,50,79,0,0
5740,1546,245,1632,542,77,15,4,86,297,51,79,0,0
5741,1538,246,1629,559,77,15,4,91,313,52,79,0,0
5742,1528,248,1623,571,77,15,4,95,323,53,79,0,0
5743,1517,253,1615,583,77,15,4,98,330,54,79,0,0
5744,1510,259,1614,607,77,15,4,104,348,55,79,0,0
5745,1508,266,1613,614,77,15,4,105,348,56,79,0,0
5746,1502,274,1612,636,77,15,4,110,362,57,79,0,0
5747,1494,280,1608,653,77,15,4,114,373,58,79,0,0
5748,1481,284,1600,669,77,15,4,119,385,59,79,0,0
5749,1479,298,1604,704,77,15,4,125,406,60,79,0,0
5750,1478,303,1606,718,77,15,4,128,415,61,79,0,0
5751,1470,315,1604,748,77,15,4,134,433,62,79,0,0
5752,1464,327,1602,774,77,15,4,138,447,63,79,0,0
5753,1458,334,1599,792,77,15,4,141,458,64,79,0,0
5754,1448,348,1602,852,77,15,4,154,504,65,79,0,0
5755,1441,357,1599,875,77,15,4,158,518,66,79,0,0
5756,1426,374,1593,919,77,15,4,167,545,67,79,0,0
5757,1408,391,1583,958,77,15,4,175,567,68,79,0,0
5758,1395,403,1574,975,77,15,4,179,572,69,79,0,0
5759,1379,428,1572,1043,77,15,4,193,615,70,79,0,0
5760,1368,450,1564,1072,77,15,4,196,622,71,79,0,0
5761,1349,482,1544,1080,77,15,4,195,598,72,79,0,0
5762,1322,519,1512,1080,77,15,4,190,561,73,79,0,0
5763,1293,550,1482,1080,77,15,4,189,530,74,79,0,0
5764,1263,601,1446,1080,77,15,4,183,479,75,79,0,0
5765,1223,655,1398,1079,77,15,4,175,424,76,79,0,0
5766,1181,722,1347,1079,77,15,4,166,357,77,79,0,0
5767,1129,820,1269,1078,77,15,4,140,258,78,79,0,0
5768,1108,863,1231,1080,77,15,4,123,217,79,79,1,0
5781,1142,280,1266,421,79,15,4,124,141,0,5,0,0
5782,1146,281,1262,413,79,15,4,116,132,1,5,0,0
5783,1143,280,1265,419,79,15,4,122,139,2,5,0,0
5784,1142,280,1266,420,79,15,4,124,140,3,5,0,0
5785,1142,279,1266,421,79,15,4,124,142,4,5,0,0
5786,1141,279,1267,422,79,15,4,126,143,5,5,0,0
2599,0,916,100,1069,2,15,5,100,153,0,0,0,0
2600,5,640,150,1051,3,15,5,145,411,0,77,0,1
2601,26,456,241,1062,3,15,5,215,606,1,77,0,0
2602,34,366,272,1036,3,15,5,238,670,2,77,0,0
2603,104,313,351,998,3,15,5,247,685,3,77,0,0
2604,187,289,437,968,3,15,5,250,679,4,77,0,0
2605,242,263,486,924,3,15,5,244,661,5,77,0,0
2606,279,251,521,911,3,15,5,242,660,6,77,0,0
2607,315,239,544,867,3,15,5,229,628,7,77,0,0
2608,347,216,561,802,3,15,5,214,586,8,77,0,0
2609,363,199,573,783,3,15,5,210,584,9,77,0,0
2610,384,187,571,710,3,15,5,187,523,10,77,0,0
2611,387,170,567,669,3,15,5,180,499,11,77,0,0
2612,383,159,558,643,3,15,5,175,484,12,77,0,0
2613,371,142,537,600,3,15,5,166,458,13,77,0,0
2614,358,132,521,586,3,15,5,163,454,14,77,0,0
2615,357,132,512,566,3,15,5,155,434,15,77,0,0
2616,356,120,500,527,3,15,5,144,407,16,77,0,0
2617,354,120,489,505,3,15,5,135,385,17,77,0,0
2618,347,110,475,476,3,15,5,128,366,18,77,0,0
2619,337,101,463,462,3,15,5,126,361,19,77,0,0
2620,336,99,458,454,3,15,5,122,355,20,77,0,0
2621,341,88,455,421,3,15,5,114,333,21,77,0,0
2622,339,83,448,406,3,15,5,109,323,22,77,0,0
2623,336,82,439,391,3,15,5,103,309,23,77,0,0
2624,327,75,428,372,3,15,5,101,297,24,77,0,0
2625,323,75,420,365,3,15,5,97,290,25,77,0,0
2626,328,75,420,350,3,15,5,92,275,26,77,0,0
2627,326,66,416,337,3,15,5,90,271,27,77,0,0
2628,325,67,411,332,3,15,5,86,265,28,77,0,0
2629,323,65,405,318,3,15,5,82,253,29,77,0,0
2630,321,63,399,308,3,15,5,78,245,30,77,0,0
2631,321,65,397,304,3,15,5,76,239,31,77,0,0
2632,322,63,395,292,3,15,5,73,229,32,77,0,0
2633,324,64,392,281,3,15,5,68,217,33,77,0,0
2634,322,71,386,275,3,15,5,64,204,34,77,0,0
2635,318,58,384,266,3,15,5,66,208,35,77,0,0
2636,315,44,384,265,3,15,5,69,221,36,77,0,0
2637,319,46,384,253,3,15,5,65,207,37,77,0,0
2638,318,39,383,247,3,15,5,65,208,38,77,0,0
2639,319,33,384,244,3,15,5,65,211,39,77,0,0
2640,321,33,382,233,3,15,5,61,200,40,77,0,0
2641,317,30,378,230,3,15,5,61,200,41,77,0,0
2642,320,35,377,223,3,15,5,57,188,42,77,0,0
2643,321,31,378,217,3,15,5,57,186,43,77,0,0
2644,322,34,377,214,3,15,5,55,180,44,77,0,0
2645,322,23,378,208,3,15,5,56,185,45,77,0,0
2646,321,25,375,202,3,15,5,54,177,46,77,0,0
2647,324,27,377,201,3,15,5,53,174,47,77,0,0
2648,327,25,379,195,3,15,5,52,170,48,77,0,0
2649,330,26,380,192,3,15,5,50,166,49,77,0,0
2650,331,26,380,189,3,15,5,49,163,50,77,0,0
2651,331,22,379,183,3,15,5,48,161,51,77,0,0
2652,331,23,378,180,3,15,5,47,157,52,77,0,0
2653,333,20,379,175,3,15,5,46,155,53,77,0,0
2654,333,17,379,172,3,15,5,46,155,54,77,0,0
2655,333,17,378,169,3,15,5,45,152,55,77,0,0
2656,333,16,377,165,3,15,5,44,149,56,77,0,0
2657,332,15,375,162,3,15,5,43,147,57,77,0,0
2658,331,16,374,162,3,15,5,43,146,58,77,0,0
2659,332,16,374,157,3,15,5,42,141,59,77,0,0
2660,329,15,371,155,3,15,5,42,140,60,77,0,0
2661,327,15,368,154,3,15,5,41,139,61,77,0,0
2662,324,13,366,153,3,15,5,42,140,62,77,0,0
2663,322,14,365,152,3,15,5,43,138,63,77,0,0
2664,322,13,364,148,3,15,5,42,135,64,77,0,0
2665,321,12,364,149,3,15,5,43,137,65,77,0,0
2666,319,11,360,145,3,15,5,41,134,66,77,0,0
2667,318,11,357,136,3,15,5,39,125,67,77,0,0
2668,317,11,356,137,3,15,5,39,126,68,77,0,0
2669,317,11,356,136,3,15,5,39,125,69,77,0,0
2670,317,10,354,133,3,15,5,37,123,70,77,0,0
2671,316,13,352,131,3,15,5,36,118,71,77,0,0
2672,316,11,351,129,3,15,5,35,118,72,77,0,0
2673,316,9,351,126,3,15,5,35,117,73,77,0,0
2674,316,9,352,125,3,15,5,36,116,74,77,0,0
2675,317,6,353,128,3,15,5,36,122,75,77,0,0
2676,318,9,353,125,3,15,5,35,116,76,77,0,0
2677,318,8,353,123,3,15,5,35,115,77,77,1,0
3248,325,8,360,103,4,15,5,35,95,0,0,0,0
3251,329,12,366,117,5,15,5,37,105,0,79,0,1
3252,328,12,366,120,5,15,5,38,108,1,79,0,0
3253,328,12,365,117,5,15,5,37,105,2,79,0,0
3254,329,11,367,117,5,15,5,38,106,3,79,0,0
3255,332,15,368,117,5,15,5,36,102,4,79,0,0
3256,333,15,371,121,5,15,5,38,106,5,79,0,0
3257,335,13,371,119,5,15,5,36,106,6,79,0,0
3258,333,14,372,125,5,15,5,39,111,7,79,0,0
3259,333,14,372,126,5,15,5,39,112,8,79,0,0
3260,334,15,372,126,5,15,5,38,111,9,79,0,0
3261,334,16,374,135,5,15,5,40,119,10,79,0,0
3262,335,18,375,138,5,15,5,40,120,11,79,0,0
3263,333,17,375,144,5,15,5,42,127,12,79,0,0
3264,332,15,376,147,5,15,5,44,132,13,79,0,0
3265,332,13,376,146,5,15,5,44,133,14,79,0,0
3266,336,13,381,152,5,15,5,45,139,15,79,0,0
3267,339,16,383,154,5,15,5,44,138,16,79,0,0
3268,341,17,386,155,5,15,5,45,138,17,79,0,0
3269,343,18,388,158,5,15,5,45,140,18,79,0,0
3270,343,17,389,158,5,15,5,46,141,19,79,0,0
3271,343,17,389,162,5,15,5,46,145,20,79,0,0
3272,344,19,390,166,5,15,5,46,147,21,79,0,0
3273,345,18,391,167,5,15,5,46,149,22,79,0,0
3274,345,19,392,171,5,15,5,47,152,23,79,0,0
3275,345,22,390,176,5,15,5,45,154,24,79,0,0
3276,341,17,390,182,5,15,5,49,165,25,79,0,0
3277,343,24,389,185,5,15,5,46,161,26,79,0,0
3278,344,27,390,189,5,15,5,46,162,27,79,0,0
3279,344,27,391,190,5,15,5,47,163,28,79,0,0
3280,344,28,391,196,5,15,5,47,168,29,79,0,0
3281,342,30,390,200,5,15,5,48,170,30,79,0,0
3282,341,29,390,204,5,15,5,49,175,31,79,0,0
3283,342,29,392,211,5,15,5,50,182,32,79,0,0
3284,345,30,395,215,5,15,5,50,185,33,79,0,0
3285,346,35,395,218,5,15,5,49,183,34,79,0,0
3286,345,38,396,222,5,15,5,51,184,35,79,0,0
3287,344,37,396,226,5,15,5,52,189,36,79,0,0
3288,346,40,400,236,5,15,5,54,196,37,79,0,0
3289,350,47,405,243,5,15,5,55,196,38,79,0,0
3290,355,54,409,244,5,15,5,54,190,39,79,0,0
3291,359,68,411,250,5,15,5,52,182,40,79,0,0
3292,360,75,413,257,5,15,5,53,182,41,79,0,0
3293,362,82,414,261,5,15,5,52,179,42,79,0,0
3294,361,73,419,268,5,15,5,58,195,43,79,0,0
3295,363,74,423,274,5,15,5,60,200,44,79,0,0
3296,366,75,426,275,5,15,5,60,200,45,79,0,0
3297,364,71,431,289,5,15,5,67,218,46,79,0,0
3298,363,70,433,297,5,15,5,70,227,47,79,0,0
3299,362,67,438,312,5,15,5,76,245,48,79,0,0
3300,363,69,442,324,5,15,5,79,255,49,79,0,0
3301,369,71,448,324,5,15,5,79,253,50,79,0,0
3302,367,72,452,338,5,15,5,85,266,51,79,0,0
3303,364,77,453,354,5,15,5,89,277,52,79,0,0
3304,364,82,453,357,5,15,5,89,275,53,79,0,0
3305,364,81,458,377,5,15,5,94,296,54,79,0,0
3306,370,81,467,385,5,15,5,97,304,55,79,0,0
3307,369,80,472,402,5,15,5,103,322,56,79,0,0
3308,365,92,475,425,5,15,5,110,333,57,79,0,0
3309,368,94,481,436,5,15,5,113,342,58,79,0,0
3310,376,98,492,453,5,15,5,116,355,59,79,0,0
3311,386,109,505,478,5,15,5,119,369,60,79,0,0
3312,390,102,517,494,5,15,5,127,392,61,79,0,0
3313,386,113,525,532,5,15,5,139,419,62,79,0,0
3314,389,126,533,553,5,15,5,144,427,63,79,0,0
3315,390,133,536,568,5,15,5,146,435,64,79,0,0
3316,392,149,542,600,5,15,5,150,451,65,79,0,0
3317,398,162,553,630,5,15,5,155,468,66,79,0,0
3318,395,167,558,656,5,15,5,163,489,67,79,0,0
3319,377,181,555,719,5,15,5,178,538,68,79,0,0
3320,365,195,544,735,5,15,5,179,540,69,79,0,0
3321,342,207,537,796,5,15,5,195,589,70,79,0,0
3322,325,231,530,852,5,15,5,205,621,71,79,0,0
3323,302,243,513,877,5,15,5,211,634,72,79,0,0
3324,264,270,491,932,5,15,5,227,662,73,79,0,0
3325,218,289,460,971,5,15,5,242,682,74,79,0,0
3326,126,311,380,1016,5,15,5,254,705,75,79,0,0
3327,69,353,334,1065,5,15,5,265,712,76,79,0,0
3328,23,462,256,1080,5,15,5,233,618,77,79,0,0
3329,13,678,173,1080,5,15,5,160,402,78,79,0,0
3330,0,719,148,1080,5,15,5,148,361,79,79,1,0
5204,1566,713,1920,1078,7,15,5,354,365,0,13,0,0
5206,1405,546,1920,1072,7,15,5,515,526,0,13,0,0
5207,1372,491,1920,1069,7,15,5,548,578,1,13,0,0
5208,1353,439,1920,1066,7,15,5,567,627,2,13,0,0
5209,1363,406,1920,1062,7,15,5,557,656,3,13,0,0
5210,1402,381,1920,1028,7,15,5,518,647,4,13,0,0
5211,1455,353,1920,955,7,15,5,465,602,5,13,0,0
5212,1485,343,1920,927,7,15,5,435,584,6,13,0,0
5213,1547,336,1920,865,7,15,5,373,529,7,13,0,0
5214,1596,334,1920,836,7,15,5,324,502,8,13,0,0
5215,1627,320,1920,817,7,15,5,293,497,9,13,0,0
5216,1672,318,1920,775,7,15,5,248,457,10,13,0,0
5217,1705,354,1920,753,7,15,5,215,399,11,13,0,0
5218,1740,352,1920,721,7,15,5,180,369,12,13,0,0
5219,1750,336,1920,697,7,15,5,170,361,13,13,0,0
5219,1850,399,1920,714,8,15,5,70,315,0,0,0,0
2514,245,145,307,383,1,15,6,62,238,0,92,0,1
2515,271,145,332,376,1,15,6,61,231,1,92,0,0
2516,284,142,347,375,1,15,6,63,233,2,92,0,0
2517,301,142,364,369,1,15,6,63,227,3,92,0,0
2518,316,140,379,360,1,15,6,63,220,4,92,0,0
2519,321,133,386,353,1,15,6,65,220,5,92,0,0
2520,325,133,388,343,1,15,6,63,210,6,92,0,0
2521,331,130,395,337,1,15,6,64,207,7,92,0,0
2522,336,123,401,330,1,15,6,65,207,8,92,0,0
2523,339,123,404,322,1,15,6,65,199,9,92,0,0
2524,340,120,407,317,1,15,6,67,197,10,92,0,0
2525,340,117,407,309,1,15,6,67,192,11,92,0,0
2526,341,117,408,307,1,15,6,67,190,12,92,0,0
2527,340,115,408,303,1,15,6,68,188,13,92,0,0
2528,338,115,404,298,1,15,6,66,183,14,92,0,0
2529,331,116,396,296,1,15,6,65,180,15,92,0,0
2530,325,115,390,292,1,15,6,65,177,16,92,0,0
2531,322,117,383,288,1,15,6,61,171,17,92,0,0
2532,320,116,380,287,1,15,6,60,171,18,92,0,0
2533,319,115,377,287,1,15,6,58,172,19,92,0,0
2534,317,114,374,286,1,15,6,57,172,20,92,0,0
2535,316,116,371,287,1,15,6,55,171,21,92,0,0
2536,313,118,367,288,1,15,6,54,170,22,92,0,0
2537,312,119,366,287,1,15,6,54,168,23,92,0,0
2538,312,119,365,287,1,15,6,53,168,24,92,0,0
2539,315,119,367,287,1,15,6,52,168,25,92,0,0
2540,315,119,367,288,1,15,6,52,169,26,92,0,0
2541,314,119,366,289,1,15,6,52,170,27,92,0,0
2542,311,120,363,290,1,15,6,52,170,28,92,0,0
2543,307,121,359,289,1,15,6,52,168,29,92,0,0
2544,306,125,358,288,1,15,6,52,163,30,92,0,0
2545,305,127,358,288,1,15,6,53,161,31,92,0,0
2546,304,127,357,288,1,15,6,53,161,32,92,0,0
2547,304,123,358,289,1,15,6,54,166,33,92,0,0
2548,309,120,364,286,1,15,6,55,166,34,92,0,0
2549,312,118,367,287,1,15,6,55,169,35,92,0,0
2550,316,115,371,286,1,15,6,55,171,36,92,0,0
2551,322,115,378,288,1,15,6,56,173,37,92,0,0
2552,325,116,382,293,1,15,6,57,177,38,92,0,0
2553,322,118,380,297,1,15,6,58,179,39,92,0,0
2554,321,118,380,298,1,15,6,59,180,40,92,0,0
2555,321,119,381,304,1,15,6,60,185,41,92,0,0
2556,325,122,384,309,1,15,6,59,187,42,92,0,0
2557,331,120,392,310,1,15,6,61,190,43,92,0,0
2558,337,120,401,320,1,15,6,64,200,44,92,0,0
2559,342,125,406,324,1,15,6,64,199,45,92,0,0
2560,349,124,414,329,1,15,6,65,205,46,92,0,0
2561,358,127,424,336,1,15,6,66,209,47,92,0,0
2562,367,130,433,342,1,15,6,66,212,48,92,0,0
2563,375,128,441,346,1,15,6,66,218,49,92,0,0
2564,385,131,451,353,1,15,6,66,222,50,92,0,0
2565,391,133,457,361,1,15,6,66,228,51,92,0,0
2566,401,134,468,367,1,15,6,67,233,52,92,0,0
2567,409,137,479,380,1,15,6,70,243,53,92,0,0
2568,422,138,493,378,1,15,6,71,240,54,92,0,0
2569,435,141,507,383,1,15,6,72,242,55,92,0,0
2570,443,146,519,401,1,15,6,76,255,56,92,0,0
2571,453,148,528,401,1,15,6,75,253,57,92,0,0
2572,465,151,544,412,1,15,6,79,261,58,92,0,0
2573,477,155,557,419,1,15,6,80,264,59,92,0,0
2574,490,156,574,427,1,15,6,84,271,60,92,0,0
2575,502,161,589,442,1,15,6,87,281,61,92,0,0
2576,511,163,601,452,1,15,6,90,289,62,92,0,0
2577,525,165,618,465,1,15,6,93,300,63,92,0,0
2578,538,176,631,473,1,15,6,93,297,64,92,0,0
2579,556,175,653,486,1,15,6,97,311,65,92,0,0
2580,572,182,672,500,1,15,6,100,318,66,92,0,0
2581,582,189,687,520,1,15,6,105,331,67,92,0,0
2582,594,188,703,533,1,15,6,109,345,68,92,0,0
2583,610,198,722,554,1,15,6,112,356,69,92,0,0
2584,628,206,744,570,1,15,6,116,364,70,92,0,0
2585,645,215,768,594,1,15,6,123,379,71,92,0,0
2586,658,232,786,626,1,15,6,128,394,72,92,0,0
2587,674,235,805,639,1,15,6,131,404,73,92,0,0
2588,694,245,830,665,1,15,6,136,420,74,92,0,0
2589,714,260,858,697,1,15,6,144,437,75,92,0,0
2590,745,265,895,717,1,15,6,150,452,76,92,0,0
2591,770,285,931,767,1,15,6,161,482,77,92,0,0
2592,798,299,963,794,1,15,6,165,495,78,92,0,0
2593,831,311,1004,832,1,15,6,173,521,79,92,0,0
2594,857,336,1041,879,1,15,6,184,543,80,92,0,0
2595,916,347,1107,904,1,15,6,191,557,81,92,0,0
2596,966,366,1175,977,1,15,6,209,611,82,92,0,0
2597,1011,398,1228,1029,1,15,6,217,631,83,92,0,0
2598,1079,418,1299,1056,1,15,6,220,638,84,92,0,0
2599,1131,455,1355,1075,1,15,6,224,620,85,92,0,0
2600,1201,494,1427,1080,1,15,6,226,586,86,92,0,0
2601,1305,523,1531,1080,1,15,6,226,557,87,92,0,0
2602,1392,574,1612,1080,1,15,6,220,506,88,92,0,0
2603,1525,618,1729,1080,1,15,6,204,462,89,92,0,0
2604,1637,672,1828,1078,1,15,6,191,406,90,92,0,0
2605,1747,728,1911,1076,1,15,6,164,348,91,92,0,0
2606,1821,761,1920,1080,1,15,6,99,319,92,92,1,0
2768,765,168,824,423,2,15,6,59,255,0,18,0,0
2769,734,168,794,422,2,15,6,60,254,1,18,0,0
2770,709,171,772,430,2,15,6,63,259,2,18,0,0
2771,693,171,757,435,2,15,6,64,264,3,18,0,0
2772,658,173,726,439,2,15,6,68,266,4,18,0,0
2773,626,177,699,447,2,15,6,73,270,5,18,0,0
2774,601,169,678,452,2,15,6,77,283,6,18,0,0
2775,561,171,641,453,2,15,6,80,282,7,18,0,0
2776,529,172,615,457,2,15,6,86,285,8,18,0,0
2777,498,170,585,456,2,15,6,87,286,9,18,0,0
2778,462,172,550,464,2,15,6,88,292,10,18,0,0
2779,425,176,519,471,2,15,6,94,295,11,18,0,0
2780,395,177,491,477,2,15,6,96,300,12,18,0,0
2781,355,170,452,479,2,15,6,97,309,13,18,0,0
2782,320,178,421,486,2,15,6,101,308,14,18,0,0
2783,290,181,392,488,2,15,6,102,307,15,18,0,0
2784,248,182,346,483,2,15,6,98,301,16,18,0,0
2785,229,187,326,489,2,15,6,97,302,17,18,0,0
2786,199,189,296,493,2,15,6,97,304,18,18,0,0
2843,244,198,300,460,3,15,6,56,262,0,22,0,1
2844,254,178,313,451,3,15,6,59,273,1,22,0,0
2845,262,170,322,449,3,15,6,60,279,2,22,0,0
2846,292,166,354,443,3,15,6,62,277,3,22,0,0
2847,313,169,377,440,3,15,6,64,271,4,22,0,0
2848,340,165,405,435,3,15,6,65,270,5,22,0,0
2849,374,156,440,427,3,15,6,66,271,6,22,0,0
2850,402,160,470,425,3,15,6,68,265,7,22,0,0
2851,431,157,498,412,3,15,6,67,255,8,22,0,0
2852,462,152,530,409,3,15,6,68,257,9,22,0,0
2853,483,157,555,411,3,15,6,72,254,10,22,0,0
2854,509,157,581,407,3,15,6,72,250,11,22,0,0
2855,539,157,609,401,3,15,6,70,244,12,22,0,0
2856,562,158,636,403,3,15,6,74,245,13,22,0,0
2857,585,155,660,401,3,15,6,75,246,14,22,0,0
2858,620,156,691,389,3,15,6,71,233,15,22,0,0
2859,639,170,708,389,3,15,6,69,219,16,22,0,0
2860,657,165,733,391,3,15,6,76,226,17,22,0,0
2861,693,161,770,390,3,15,6,77,229,18,22,0,0
2862,716,161,795,390,3,15,6,79,229,19,22,0,0
2863,736,162,815,388,3,15,6,79,226,20,22,0,0
2864,765,163,837,381,3,15,6,72,218,21,22,0,0
2865,790,163,862,378,3,15,6,72,215,22,22,1,0
3331,1691,823,1920,1077,4,15,6,229,254,0,0,0,0
3333,1461,674,1812,1075,5,15,6,351,401,0,27,0,1
3334,1332,632,1708,1061,5,15,6,376,429,1,27,0,0
3335,1231,579,1654,1065,5,15,6,423,486,2,27,0,0
3336,1097,545,1548,1067,5,15,6,451,522,3,27,0,0
3337,995,515,1459,1061,5,15,6,464,546,4,27,0,0
3338,910,466,1410,1071,5,15,6,500,605,5,27,0,0
3339,815,435,1325,1070,5,15,6,510,635,6,27,0,0
3340,748,401,1249,1049,5,15,6,501,648,7,27,0,0
3341,685,365,1157,999,5,15,6,472,634,8,27,0,0
3342,628,351,1074,968,5,15,6,446,617,9,27,0,0
3343,601,322,1005,906,5,15,6,404,584,10,27,0,0
3344,581,304,960,874,5,15,6,379,570,11,27,0,0
3345,554,295,908,851,5,15,6,354,556,12,27,0,0
3346,516,270,835,791,5,15,6,319,521,13,27,0,0
3347,475,265,768,763,5,15,6,293,498,14,27,0,0
3348,455,253,734,742,5,15,6,279,489,15,27,0,0
3349,427,239,685,711,5,15,6,258,472,16,27,0,0
3350,410,237,657,699,5,15,6,247,462,17,27,0,0
3351,383,225,606,658,5,15,6,223,433,18,27,0,0
3352,351,218,556,631,5,15,6,205,413,19,27,0,0
3353,331,220,523,615,5,15,6,192,395,20,27,0,0
3354,303,211,482,593,5,15,6,179,382,21,27,0,0
3355,281,207,452,581,5,15,6,171,374,22,27,0,0
3356,258,204,421,571,5,15,6,163,367,23,27,0,0
3357,224,193,378,551,5,15,6,154,358,24,27,0,0
3358,210,192,354,536,5,15,6,144,344,25,27,0,0
3359,203,201,334,529,5,15,6,131,328,26,27,0,0
3360,172,195,299,511,5,15,6,127,316,27,27,1,0
1,1582,82,1625,201,1,15,7,43,119,0,9,0,0
2,1583,84,1624,200,1,15,7,41,116,1,9,0,0
3,1586,83,1627,198,1,15,7,41,115,2,9,0,0
4,1587,85,1628,197,1,15,7,41,112,3,9,0,0
5,1588,83,1628,197,1,15,7,40,114,4,9,0,0
6,1587,83,1625,193,1,15,7,38,110,5,9,0,0
7,1585,79,1625,193,1,15,7,40,114,6,9,0,0
8,1585,77,1625,194,1,15,7,40,117,7,9,0,0
9,1585,82,1622,191,1,15,7,37,109,8,9,0,0
10,1585,82,1622,189,1,15,7,37,107,9,9,0,0
20,1605,72,1641,180,1,15,7,36,108,0,9,0,0
21,1606,73,1643,181,1,15,7,37,108,1,9,0,0
22,1607,74,1643,179,1,15,7,36,105,2,9,0,0
23,1608,74,1643,177,1,15,7,35,103,3,9,0,0
5153,1647,83,1682,207,4,15,7,35,124,0,78,0,1
5154,1645,82,1681,210,4,15,7,36,128,1,78,0,0
5155,1642,88,1678,212,4,15,7,36,124,2,78,0,0
5156,1639,85,1677,215,4,15,7,38,130,3,78,0,0
5157,1636,85,1675,220,4,15,7,39,135,4,78,0,0
5158,1634,84,1674,222,4,15,7,40,138,5,78,0,0
5159,1631,87,1672,224,4,15,7,41,137,6,78,0,0
5160,1629,92,1669,227,4,15,7,40,135,7,78,0,0
5161,1627,94,1668,232,4,15,7,41,138,8,78,0,0
5162,1626,103,1665,234,4,15,7,39,131,9,78,0,0
5163,1623,106,1661,235,4,15,7,38,129,10,78,0,0
5164,1620,108,1660,239,4,15,7,40,131,11,78,0,0
5165,1616,108,1657,245,4,15,7,41,137,12,78,0,0
5166,1613,106,1656,252,4,15,7,43,146,13,78,0,0
5167,1611,113,1654,257,4,15,7,43,144,14,78,0,0
5168,1607,114,1650,258,4,15,7,43,144,15,78,0,0
5169,1603,110,1650,265,4,15,7,47,155,16,78,0,0
5170,1601,109,1649,268,4,15,7,48,159,17,78,0,0
5171,1600,107,1651,275,4,15,7,51,168,18,78,0,0
5172,1598,106,1651,280,4,15,7,53,174,19,78,0,0
5173,1596,105,1651,285,4,15,7,55,180,20,78,0,0
5174,1594,108,1650,292,4,15,7,56,184,21,78,0,0
5175,1592,112,1648,296,4,15,7,56,184,22,78,0,0
5176,1590,111,1649,306,4,15,7,59,195,23,78,0,0
5177,1587,108,1649,313,4,15,7,62,205,24,78,0,0
5178,1584,107,1647,317,4,15,7,63,210,25,78,0,0
5179,1578,108,1644,327,4,15,7,66,219,26,78,0,0
5180,1572,110,1639,332,4,15,7,67,222,27,78,0,0
5181,1568,111,1639,344,4,15,7,71,233,28,78,0,0
5182,1562,113,1636,353,4,15,7,74,240,29,78,0,0
5183,1554,110,1630,357,4,15,7,76,247,30,78,0,0
5184,1543,115,1622,369,4,15,7,79,254,31,78,0,0
5185,1533,115,1614,375,4,15,7,81,260,32,78,0,0
5186,1528,121,1612,391,4,15,7,84,270,33,78,0,0
5187,1520,120,1607,400,4,15,7,87,280,34,78,0,0
5188,1509,121,1599,410,4,15,7,90,289,35,78,0,0
5189,1499,129,1592,427,4,15,7,93,298,36,78,0,0
5190,1490,126,1587,439,4,15,7,97,313,37,78,0,0
5191,1483,131,1586,466,4,15,7,103,335,38,78,0,0
5192,1473,137,1579,479,4,15,7,106,342,39,78,0,0
5193,1458,141,1569,495,4,15,7,111,354,40,78,0,0
5194,1444,149,1560,519,4,15,7,116,370,41,78,0,0
5195,1432,148,1551,532,4,15,7,119,384,42,78,0,0
5196,1414,154,1543,565,4,15,7,129,411,43,78,0,0
5197,1398,161,1532,589,4,15,7,134,428,44,78,0,0
5198,1375,164,1517,615,4,15,7,142,451,45,78,0,0
5199,1354,177,1502,650,4,15,7,148,473,46,78,0,0
5200,1327,174,1483,671,4,15,7,156,497,47,78,0,0
5201,1306,200,1471,719,4,15,7,165,519,48,78,0,0
5202,1274,211,1448,752,4,15,7,174,541,49,78,0,0
5203,1209,218,1392,783,4,15,7,183,565,50,78,0,0
5204,1143,224,1342,817,4,15,7,199,593,51,78,0,0
5205,1064,227,1268,838,4,15,7,204,611,52,78,0,0
5206,968,243,1187,872,4,15,7,219,629,53,78,0,0
5207,882,259,1100,890,4,15,7,218,631,54,78,0,0
5208,782,265,1002,898,4,15,7,220,633,55,78,0,0
5209,673,277,903,902,4,15,7,230,625,56,78,0,0
5210,560,279,783,897,4,15,7,223,618,57,78,0,0
5211,477,276,701,878,4,15,7,224,602,58,78,0,0
5212,404,281,623,856,4,15,7,219,575,59,78,0,0
5213,308,280,518,835,4,15,7,210,555,60,78,0,0
5214,253,289,461,827,4,15,7,208,538,61,78,0,0
5215,186,279,384,799,4,15,7,198,520,62,78,0,0
5216,154,283,342,773,4,15,7,188,490,63,78,0,0
5217,123,284,304,751,4,15,7,181,467,64,78,0,0
5218,74,277,248,728,4,15,7,174,451,65,78,0,0
5219,46,278,217,717,4,15,7,171,439,66,78,0,0
5220,19,271,180,691,4,15,7,161,420,67,78,0,0
5221,12,275,160,661,4,15,7,148,386,68,78,0,0
5222,3,276,146,645,4,15,7,143,369,69,78,0,0
5223,0,268,125,632,4,15,7,125,364,70,78,0,0
5224,0,266,110,625,4,15,7,110,359,71,78,0,0
5225,0,263,94,601,4,15,7,94,338,72,78,0,0
5226,0,259,86,588,4,15,7,86,329,73,78,0,0
5227,0,282,76,574,4,15,7,76,292,74,78,0,0
5228,0,286,64,561,4,15,7,64,275,75,78,0,0
5229,0,299,52,555,4,15,7,52,256,76,78,0,0
5230,0,306,41,533,4,15,7,41,227,77,78,0,0
5231,0,342,36,524,4,15,7,36,182,78,78,1,0
5932,1667,90,1702,209,7,15,7,35,119,0,65,0,0
5933,1663,91,1698,209,7,15,7,35,118,1,65,0,0
5935,1656,92,1691,210,7,15,7,35,118,0,65,0,1
5936,1652,92,1687,212,7,15,7,35,120,1,65,0,0
5937,1647,97,1682,215,7,15,7,35,118,2,65,0,0
5938,1642,100,1677,220,7,15,7,35,120,3,65,0,0
5939,1638,98,1675,221,7,15,7,37,123,4,65,0,0
5940,1637,96,1675,224,7,15,7,38,128,5,65,0,0
5941,1635,95,1675,228,7,15,7,40,133,6,65,0,0
5942,1635,94,1675,229,7,15,7,40,135,7,65,0,0
5943,1636,97,1675,231,7,15,7,39,134,8,65,0,0
5944,1634,96,1676,234,7,15,7,42,138,9,65,0,0
5945,1635,98,1676,236,7,15,7,41,138,10,65,0,0
5946,1637,100,1678,238,7,15,7,41,138,11,65,0,0
5947,1637,102,1680,241,7,15,7,43,139,12,65,0,0
5948,1636,103,1680,246,7,15,7,44,143,13,65,0,0
5949,1636,104,1681,248,7,15,7,45,144,14,65,0,0
5950,1637,103,1683,256,7,15,7,46,153,15,65,0,0
5951,1641,106,1687,261,7,15,7,46,155,16,65,0,0
5952,1644,106,1691,263,7,15,7,47,157,17,65,0,0
5953,1646,111,1692,268,7,15,7,46,157,18,65,0,0
5954,1646,112,1692,269,7,15,7,46,157,19,65,0,0
5955,1648,117,1695,274,7,15,7,47,157,20,65,0,0
5956,1651,119,1698,276,7,15,7,47,157,21,65,0,0
5957,1653,119,1702,282,7,15,7,49,163,22,65,0,0
5958,1653,120,1704,291,7,15,7,51,171,23,65,0,0
5959,1652,120,1704,295,7,15,7,52,175,24,65,0,0
5960,1652,121,1706,303,7,15,7,54,182,25,65,0,0
5961,1651,123,1706,305,7,15,7,55,182,26,65,0,0
5962,1651,123,1706,307,7,15,7,55,184,27,65,0,0
5963,1648,127,1703,311,7,15,7,55,184,28,65,0,0
5964,1644,127,1700,313,7,15,7,56,186,29,65,0,0
5965,1640,126,1700,326,7,15,7,60,200,30,65,0,0
5966,1639,130,1700,333,7,15,7,61,203,31,65,0,0
5967,1637,130,1698,336,7,15,7,61,206,32,65,0,0
5968,1633,133,1695,341,7,15,7,62,208,33,65,0,0
5969,1630,134,1693,344,7,15,7,63,210,34,65,0,0
5970,1627,136,1692,355,7,15,7,65,219,35,65,0,0
5971,1627,139,1694,363,7,15,7,67,224,36,65,0,0
5972,1624,140,1693,368,7,15,7,69,228,37,65,0,0
5973,1616,145,1688,380,7,15,7,72,235,38,65,0,0
5974,1613,147,1687,386,7,15,7,74,239,39,65,0,0
5975,1614,147,1691,395,7,15,7,77,248,40,65,0,0
5976,1612,153,1691,405,7,15,7,79,252,41,65,0,0
5977,1608,155,1688,410,7,15,7,80,255,42,65,0,0
5978,1605,160,1689,424,7,15,7,84,264,43,65,0,0
5979,1601,162,1687,430,7,15,7,86,268,44,65,0,0
5980,1595,163,1685,450,7,15,7,90,287,45,65,0,0
5981,1591,170,1683,461,7,15,7,92,291,46,65,0,0
5982,1585,175,1678,470,7,15,7,93,295,47,65,0,0
5983,1575,180,1673,489,7,15,7,98,309,48,65,0,0
5984,1563,180,1664,500,7,15,7,101,320,49,65,0,0
5985,1554,182,1660,521,7,15,7,106,339,50,65,0,0
5986,1545,187,1655,539,7,15,7,110,352,51,65,0,0
5987,1540,192,1651,545,7,15,7,111,353,52,65,0,0
5988,1527,201,1642,567,7,15,7,115,366,53,65,0,0
5989,1513,205,1631,581,7,15,7,118,376,54,65,0,0
5990,1496,211,1623,614,7,15,7,127,403,55,65,0,0
5991,1480,219,1612,641,7,15,7,132,422,56,65,0,0
5992,1460,228,1595,653,7,15,7,135,425,57,65,0,0
5993,1427,245,1566,684,7,15,7,139,439,58,65,0,0
5994,1404,243,1549,701,7,15,7,145,458,59,65,0,0
5995,1368,251,1523,741,7,15,7,155,490,60,65,0,0
5996,1326,266,1486,770,7,15,7,160,504,61,65,0,0
5997,1273,275,1436,781,7,15,7,163,506,62,65,0,0
5998,1215,292,1386,807,7,15,7,171,515,63,65,0,0
5999,1147,283,1322,815,7,15,7,175,532,64,65,0,0
6000,1059,295,1247,850,7,15,7,188,555,65,65,1,0
2839,1608,110,1645,248,1,15,8,37,138,0,1,0,0
2840,1594,112,1632,252,1,15,8,38,140,1,1,0,0
2841,1569,104,1609,252,2,15,8,40,148,0,11,0,0
2842,1556,108,1596,254,2,15,8,40,146,1,11,0,0
2843,1541,110,1582,258,2,15,8,41,148,2,11,0,0
2844,1523,109,1564,260,2,15,8,41,151,3,11,0,0
2845,1507,112,1549,263,2,15,8,42,151,4,11,0,0
2846,1492,115,1536,265,2,15,8,44,150,5,11,0,0
2847,1474,114,1519,268,2,15,8,45,154,6,11,0,0
2848,1459,117,1503,267,2,15,8,44,150,7,11,0,0
2849,1444,118,1490,269,2,15,8,46,151,8,11,0,0
2850,1428,117,1474,269,2,15,8,46,152,9,11,0,0
2851,1414,114,1464,276,2,15,8,50,162,10,11,0,0
2852,1399,115,1450,278,2,15,8,51,163,11,11,0,0
3081,1421,117,1471,264,3,15,8,50,147,0,13,0,0
3082,1431,118,1482,266,3,15,8,51,148,1,13,0,0
3083,1444,116,1495,263,3,15,8,51,147,2,13,0,0
3084,1463,113,1514,262,3,15,8,51,149,3,13,0,0
3085,1480,112,1533,264,3,15,8,53,152,4,13,0,0
3086,1493,111,1544,261,3,15,8,51,150,5,13,0,0
3087,1507,109,1559,258,3,15,8,52,149,6,13,0,0
3088,1522,110,1574,258,3,15,8,52,148,7,13,0,0
3089,1539,103,1591,255,3,15,8,52,152,8,13,0,0
3090,1556,103,1608,251,3,15,8,52,148,9,13,0,0
3091,1573,105,1622,247,3,15,8,49,142,10,13,0,0
3092,1589,104,1637,245,3,15,8,48,141,11,13,0,0
3093,1603,104,1651,246,3,15,8,48,142,12,13,0,0
3094,1618,104,1666,244,3,15,8,48,140,13,13,0,0
383,552,272,637,499,1,17,10,85,227,0,41,0,1
384,539,272,624,499,1,17,10,85,227,1,41,0,0
385,506,268,593,500,1,17,10,87,232,2,41,0,0
386,480,265,568,498,1,17,10,88,233,3,41,0,0
387,447,263,533,493,1,17,10,86,230,4,41,0,0
388,405,265,490,490,1,17,10,85,225,5,41,0,0
389,381,263,467,488,1,17,10,86,225,6,41,0,0
390,361,259,443,479,1,17,10,82,220,7,41,0,0
391,335,259,418,482,1,17,10,83,223,8,41,0,0
392,313,255,394,475,1,17,10,81,220,9,41,0,0
393,290,250,372,472,1,17,10,82,222,10,41,0,0
394,276,254,354,468,1,17,10,78,214,11,41,0,0
395,259,248,337,464,1,17,10,78,216,12,41,0,0
396,244,247,320,459,1,17,10,76,212,13,41,0,0
397,233,242,308,455,1,17,10,75,213,14,41,0,0
398,224,236,299,451,1,17,10,75,215,15,41,0,0
399,214,235,286,446,1,17,10,72,211,16,41,0,0
400,209,238,279,440,1,17,10,70,202,17,41,0,0
401,205,238,271,429,1,17,10,66,191,18,41,0,0
402,203,239,267,425,1,17,10,64,186,19,41,0,0
403,200,235,264,418,1,17,10,64,183,20,41,0,0
404,195,233,258,416,1,17,10,63,183,21,41,0,0
405,191,233,250,407,1,17,10,59,174,22,41,0,0
406,189,232,247,402,1,17,10,58,170,23,41,0,0
407,185,231,243,404,1,17,10,58,173,24,41,0,0
408,184,232,241,403,1,17,10,57,171,25,41,0,0
409,185,228,241,397,1,17,10,56,169,26,41,0,0
410,184,228,240,395,1,17,10,56,167,27,41,0,0
411,183,229,237,392,1,17,10,54,163,28,41,0,0
412,183,226,237,386,1,17,10,54,160,29,41,0,0
413,184,226,237,384,1,17,10,53,158,30,41,0,0
414,187,227,239,382,1,17,10,52,155,31,41,0,0
415,191,224,244,380,1,17,10,53,156,32,41,0,0
416,195,223,247,377,1,17,10,52,154,33,41,0,0
417,198,221,249,371,1,17,10,51,150,34,41,0,0
418,200,220,250,370,1,17,10,50,150,35,41,0,0
419,204,222,253,367,1,17,10,49,145,36,41,0,0
420,209,222,256,362,1,17,10,47,140,37,41,0,0
421,217,218,262,356,1,17,10,45,138,38,41,0,0
422,226,219,266,343,1,17,10,40,124,39,41,0,0
423,237,214,276,337,1,17,10,39,123,40,41,0,0
424,241,213,278,332,1,17,10,37,119,41,41,1,0
2786,160,193,195,288,3,17,10,35,95,0,29,0,1
2787,161,193,196,290,3,17,10,35,97,1,29,0,0
2788,160,195,196,292,3,17,10,36,97,2,29,0,0
2789,160,195,196,294,3,17,10,36,99,3,29,0,0
2790,159,196,195,296,3,17,10,36,100,4,29,0,0
2791,160,197,196,297,3,17,10,36,100,5,29,0,0
2792,160,198,197,299,3,17,10,37,101,6,29,0,0
2793,160,198,198,300,3,17,10,38,102,7,29,0,0
2794,160,199,197,300,3,17,10,37,101,8,29,0,0
2795,159,199,196,299,3,17,10,37,100,9,29,0,0
2796,159,201,196,302,3,17,10,37,101,10,29,0,0
2797,160,203,197,302,3,17,10,37,99,11,29,0,0
2798,161,204,200,311,3,17,10,39,107,12,29,0,0
2799,161,204,201,315,3,17,10,40,111,13,29,0,0
2800,161,204,202,317,3,17,10,41,113,14,29,0,0
2801,163,207,203,318,3,17,10,40,111,15,29,0,0
2802,166,208,207,320,3,17,10,41,112,16,29,0,0
2803,169,209,210,323,3,17,10,41,114,17,29,0,0
2804,172,210,214,326,3,17,10,42,116,18,29,0,0
2805,175,212,215,327,3,17,10,40,115,19,29,0,0
2806,178,212,219,327,3,17,10,41,115,20,29,0,0
2807,183,215,223,328,3,17,10,40,113,21,29,0,0
2808,191,216,230,330,3,17,10,39,114,22,29,0,0
2809,201,217,241,331,3,17,10,40,114,23,29,0,0
2810,210,219,250,335,3,17,10,40,116,24,29,0,0
2811,218,219,259,335,3,17,10,41,116,25,29,0,0
2812,226,220,267,335,3,17,10,41,115,26,29,0,0
2813,240,225,280,335,3,17,10,40,110,27,29,0,0
2814,250,227,289,337,3,17,10,39,110,28,29,0,0
2815,256,229,295,338,3,17,10,39,109,29,29,1,0
3323,159,198,194,302,6,17,10,35,104,0,46,0,1
3324,158,200,194,306,6,17,10,36,106,1,46,0,0
3325,157,201,193,307,6,17,10,36,106,2,46,0,0
3326,155,201,193,311,6,17,10,38,110,3,46,0,0
3327,154,203,192,312,6,17,10,38,109,4,46,0,0
3328,152,204,190,315,6,17,10,38,111,5,46,0,0
3329,149,207,188,319,6,17,10,39,112,6,46,0,0
3330,147,210,185,320,6,17,10,38,110,7,46,0,0
3331,145,210,183,324,6,17,10,38,114,8,46,0,0
3332,144,213,182,327,6,17,10,38,114,9,46,0,0
3333,143,214,181,329,6,17,10,38,115,10,46,0,0
3334,142,215,181,331,6,17,10,39,116,11,46,0,0
3335,140,216,179,336,6,17,10,39,120,12,46,0,0
3336,138,216,178,338,6,17,10,40,122,13,46,0,0
3337,136,217,177,342,6,17,10,41,125,14,46,0,0
3338,134,220,176,345,6,17,10,42,125,15,46,0,0
3339,134,219,176,346,6,17,10,42,127,16,46,0,0
3340,133,223,175,349,6,17,10,42,126,17,46,0,0
3341,130,221,173,352,6,17,10,43,131,18,46,0,0
3342,127,223,172,358,6,17,10,45,135,19,46,0,0
3343,127,226,172,360,6,17,10,45,134,20,46,0,0
3344,128,224,175,363,6,17,10,47,139,21,46,0,0
3345,129,230,174,366,6,17,10,45,136,22,46,0,0
3346,127,232,173,371,6,17,10,46,139,23,46,0,0
3347,126,231,173,375,6,17,10,47,144,24,46,0,0
3348,125,234,173,381,6,17,10,48,147,25,46,0,0
3349,125,232,175,387,6,17,10,50,155,26,46,0,0
3350,125,234,175,393,6,17,10,50,159,27,46,0,0
3351,122,239,172,397,6,17,10,50,158,28,46,0,0
3352,119,240,170,401,6,17,10,51,161,29,46,0,0
3353,115,241,168,412,6,17,10,53,171,30,46,0,0
3354,114,241,168,413,6,17,10,54,172,31,46,0,0
3355,113,242,168,421,6,17,10,55,179,32,46,0,0
3356,111,250,166,431,6,17,10,55,181,33,46,0,0
3357,105,246,163,435,6,17,10,58,189,34,46,0,0
3358,101,253,159,442,6,17,10,58,189,35,46,0,0
3359,98,254,158,449,6,17,10,60,195,36,46,0,0
3360,97,256,157,453,6,17,10,60,197,37,46,0,0
3361,91,260,153,464,6,17,10,62,204,38,46,0,0
3362,83,261,147,469,6,17,10,64,208,39,46,0,0
3363,72,260,138,477,6,17,10,66,217,40,46,0,0
3364,61,262,130,490,6,17,10,69,228,41,46,0,0
3365,54,262,124,497,6,17,10,70,235,42,46,0,0
3366,44,269,115,506,6,17,10,71,237,43,46,0,0
3367,31,274,102,519,6,17,10,71,245,44,46,0,0
3368,21,277,91,529,6,17,10,70,252,45,46,0,0
3369,14,280,86,537,6,17,10,72,257,46,46,1,0
256,1175,119,1212,250,1,17,15,37,131,0,42,0,1
257,1187,116,1226,253,1,17,15,39,137,1,42,0,0
258,1196,115,1239,264,1,17,15,43,149,2,42,0,0
259,1213,118,1254,256,1,17,15,41,138,3,42,0,0
260,1231,118,1273,260,1,17,15,42,142,4,42,0,0
261,1246,122,1288,262,1,17,15,42,140,5,42,0,0
262,1257,119,1302,271,1,17,15,45,152,6,42,0,0
263,1269,121,1314,269,1,17,15,45,148,7,42,0,0
264,1283,124,1326,266,1,17,15,43,142,8,42,0,0
265,1291,129,1337,278,1,17,15,46,149,9,42,0,0
266,1302,131,1347,279,1,17,15,45,148,10,42,0,0
267,1309,126,1359,284,1,17,15,50,158,11,42,0,0
268,1315,129,1368,290,1,17,15,53,161,12,42,0,0
269,1321,127,1375,291,1,17,15,54,164,13,42,0,0
270,1324,126,1381,300,1,17,15,57,174,14,42,0,0
271,1328,125,1386,303,1,17,15,58,178,15,42,0,0
272,1332,129,1392,307,1,17,15,60,178,16,42,0,0
273,1334,136,1396,319,1,17,15,62,183,17,42,0,0
274,1335,138,1397,321,1,17,15,62,183,18,42,0,0
275,1335,140,1398,329,1,17,15,63,189,19,42,0,0
276,1334,142,1397,334,1,17,15,63,192,20,42,0,0
277,1332,142,1396,339,1,17,15,64,197,21,42,0,0
278,1330,145,1394,344,1,17,15,64,199,22,42,0,0
279,1326,149,1390,344,1,17,15,64,195,23,42,0,0
280,1322,148,1390,356,1,17,15,68,208,24,42,0,0
281,1319,151,1389,365,1,17,15,70,214,25,42,0,0
282,1315,150,1386,365,1,17,15,71,215,26,42,0,0
283,1311,154,1383,371,1,17,15,72,217,27,42,0,0
284,1307,161,1377,374,1,17,15,70,213,28,42,0,0
285,1303,162,1378,388,1,17,15,75,226,29,42,0,0
286,1299,167,1377,399,1,17,15,78,232,30,42,0,0
287,1297,167,1377,402,1,17,15,80,235,31,42,0,0
288,1293,166,1378,411,1,17,15,85,245,32,42,0,0
289,1290,171,1377,422,1,17,15,87,251,33,42,0,0
290,1287,169,1377,432,1,17,15,90,263,34,42,0,0
291,1285,175,1381,453,1,17,15,96,278,35,42,0,0
292,1289,177,1385,455,1,17,15,96,278,36,42,0,0
293,1292,181,1391,466,1,17,15,99,285,37,42,0,0
294,1298,187,1402,483,1,17,15,104,296,38,42,0,0
295,1314,186,1421,492,1,17,15,107,306,39,42,0,0
296,1327,192,1433,493,1,17,15,106,301,40,42,0,0
297,1340,174,1451,500,1,17,15,111,326,41,42,0,0
298,1344,175,1457,508,1,17,15,113,333,42,42,1,0
300,1351,223,1457,546,1,17,15,106,323,0,42,0,0
301,1355,227,1462,556,1,17,15,107,329,1,42,0,0
260,1197,128,1232,264,2,17,15,35,136,0,40,0,1
261,1203,130,1238,265,2,17,15,35,135,1,40,0,0
262,1211,131,1247,266,2,17,15,36,135,2,40,0,0
263,1219,134,1255,272,2,17,15,36,138,3,40,0,0
264,1227,133,1265,274,2,17,15,38,141,4,40,0,0
265,1234,136,1272,277,2,17,15,38,141,5,40,0,0
266,1238,136,1279,284,2,17,15,41,148,6,40,0,0
267,1242,135,1283,286,2,17,15,41,151,7,40,0,0
268,1246,138,1289,291,2,17,15,43,153,8,40,0,0
269,1253,141,1296,294,2,17,15,43,153,9,40,0,0
270,1259,144,1303,298,2,17,15,44,154,10,40,0,0
271,1262,148,1307,300,2,17,15,45,152,11,40,0,0
272,1266,148,1311,303,2,17,15,45,155,12,40,0,0
273,1268,151,1315,311,2,17,15,47,160,13,40,0,0
274,1271,150,1321,318,2,17,15,50,168,14,40,0,0
275,1272,150,1325,325,2,17,15,53,175,15,40,0,0
276,1270,153,1323,331,2,17,15,53,178,16,40,0,0
277,1265,152,1320,335,2,17,15,55,183,17,40,0,0
278,1259,158,1316,345,2,17,15,57,187,18,40,0,0
279,1257,158,1316,354,2,17,15,59,196,19,40,0,0
280,1257,163,1317,356,2,17,15,60,193,20,40,0,0
281,1249,166,1310,365,2,17,15,61,199,21,40,0,0
282,1240,166,1303,370,2,17,15,63,204,22,40,0,0
283,1233,169,1298,377,2,17,15,65,208,23,40,0,0
284,1226,171,1297,397,2,17,15,71,226,24,40,0,0
285,1221,171,1291,393,2,17,15,70,222,25,40,0,0
286,1211,177,1281,396,2,17,15,70,219,26,40,0,0
287,1199,175,1272,405,2,17,15,73,230,27,40,0,0
288,1192,175,1267,409,2,17,15,75,234,28,40,0,0
289,1189,180,1265,421,2,17,15,76,241,29,40,0,0
290,1188,179,1267,429,2,17,15,79,250,30,40,0,0
291,1190,185,1271,445,2,17,15,81,260,31,40,0,0
292,1193,187,1278,459,2,17,15,85,272,32,40,0,0
293,1200,193,1285,463,2,17,15,85,270,33,40,0,0
294,1207,197,1297,482,2,17,15,90,285,34,40,0,0
295,1225,200,1315,487,2,17,15,90,287,35,40,0,0
296,1241,215,1331,500,2,17,15,90,285,36,40,0,0
297,1263,227,1354,517,2,17,15,91,290,37,40,0,0
298,1288,228,1382,527,2,17,15,94,299,38,40,0,0
299,1307,234,1405,537,2,17,15,98,303,39,40,0,0
300,1314,239,1414,547,2,17,15,100,308,40,40,1,0
1150,1173,118,1217,261,3,17,15,44,143,0,41,0,1
1151,1183,118,1226,258,3,17,15,43,140,1,41,0,0
1152,1192,117,1237,263,3,17,15,45,146,2,41,0,0
1153,1203,117,1248,264,3,17,15,45,147,3,41,0,0
1154,1209,117,1256,268,3,17,15,47,151,4,41,0,0
1155,1219,122,1267,271,3,17,15,48,149,5,41,0,0
1156,1226,126,1276,282,3,17,15,50,156,6,41,0,0
1157,1231,127,1280,278,3,17,15,49,151,7,41,0,0
1158,1234,129,1284,282,3,17,15,50,153,8,41,0,0
1159,1236,132,1286,283,3,17,15,50,151,9,41,0,0
1160,1239,130,1290,286,3,17,15,51,156,10,41,0,0
1161,1242,135,1293,288,3,17,15,51,153,11,41,0,0
1162,1246,134,1299,294,3,17,15,53,160,12,41,0,0
1163,1246,136,1300,298,3,17,15,54,162,13,41,0,0
1164,1247,143,1302,307,3,17,15,55,164,14,41,0,0
1165,1248,141,1305,311,3,17,15,57,170,15,41,0,0
1166,1249,144,1308,318,3,17,15,59,174,16,41,0,0
1167,1251,144,1311,322,3,17,15,60,178,17,41,0,0
1168,1251,144,1312,323,3,17,15,61,179,18,41,0,0
1169,1248,144,1313,336,3,17,15,65,192,19,41,0,0
1170,1245,143,1313,344,3,17,15,68,201,20,41,0,0
1171,1245,143,1313,347,3,17,15,68,204,21,41,0,0
1172,1245,145,1314,354,3,17,15,69,209,22,41,0,0
1173,1242,144,1314,360,3,17,15,72,216,23,41,0,0
1174,1239,147,1313,369,3,17,15,74,222,24,41,0,0
1175,1234,147,1311,375,3,17,15,77,228,25,41,0,0
1176,1230,141,1310,379,3,17,15,80,238,26,41,0,0
1177,1230,147,1308,383,3,17,15,78,236,27,41,0,0
1178,1229,151,1310,394,3,17,15,81,243,28,41,0,0
1179,1230,149,1313,400,3,17,15,83,251,29,41,0,0
1180,1231,162,1315,412,3,17,15,84,250,30,41,0,0
1181,1232,169,1313,412,3,17,15,81,243,31,41,0,0
1182,1233,173,1317,428,3,17,15,84,255,32,41,0,0
1183,1238,176,1326,443,3,17,15,88,267,33,41,0,0
1184,1246,176,1336,450,3,17,15,90,274,34,41,0,0
1185,1254,180,1349,462,3,17,15,95,282,35,41,0,0
1186,1267,186,1364,474,3,17,15,97,288,36,41,0,0
1187,1280,186,1376,477,3,17,15,96,291,37,41,0,0
1188,1289,191,1391,494,3,17,15,102,303,38,41,0,0
1189,1304,194,1409,502,3,17,15,105,308,39,41,0,0
1190,1334,194,1440,514,3,17,15,106,320,40,41,0,0
1191,1341,196,1449,523,3,17,15,108,327,41,41,1,0
3293,1221,128,1256,274,4,17,15,35,146,0,39,0,1
3294,1224,130,1260,275,4,17,15,36,145,1,39,0,0
3295,1227,133,1264,280,4,17,15,37,147,2,39,0,0
3296,1227,134,1266,282,4,17,15,39,148,3,39,0,0
3297,1226,136,1266,283,4,17,15,40,147,4,39,0,0
3298,1226,140,1268,290,4,17,15,42,150,5,39,0,0
3299,1227,140,1271,293,4,17,15,44,153,6,39,0,0
3300,1228,141,1274,297,4,17,15,46,156,7,39,0,0
3301,1226,142,1274,301,4,17,15,48,159,8,39,0,0
3302,1222,144,1271,304,4,17,15,49,160,9,39,0,0
3303,1221,144,1271,306,4,17,15,50,162,10,39,0,0
3304,1221,144,1274,314,4,17,15,53,170,11,39,0,0
3305,1223,142,1278,316,4,17,15,55,174,12,39,0,0
3306,1222,143,1279,322,4,17,15,57,179,13,39,0,0
3307,1218,144,1278,329,4,17,15,60,185,14,39,0,0
3308,1215,143,1277,336,4,17,15,62,193,15,39,0,0
3309,1212,145,1277,343,4,17,15,65,198,16,39,0,0
3310,1213,146,1279,351,4,17,15,66,205,17,39,0,0
3311,1213,148,1281,357,4,17,15,68,209,18,39,0,0
3312,1210,149,1280,363,4,17,15,70,214,19,39,0,0
3313,1204,148,1275,367,4,17,15,71,219,20,39,0,0
3314,1202,150,1274,372,4,17,15,72,222,21,39,0,0
3315,1201,155,1272,375,4,17,15,71,220,22,39,0,0
3316,1201,155,1274,379,4,17,15,73,224,23,39,0,0
3317,1201,164,1274,390,4,17,15,73,226,24,39,0,0
3318,1197,168,1272,401,4,17,15,75,233,25,39,0,0
3319,1194,170,1269,405,4,17,15,75,235,26,39,0,0
3320,1193,176,1269,416,4,17,15,76,240,27,39,0,0
3321,1197,178,1274,422,4,17,15,77,244,28,39,0,0
3322,1204,179,1283,429,4,17,15,79,250,29,39,0,0
3323,1212,183,1293,442,4,17,15,81,259,30,39,0,0
3324,1218,185,1302,453,4,17,15,84,268,31,39,0,0
3325,1227,189,1313,464,4,17,15,86,275,32,39,0,0
3326,1237,195,1326,477,4,17,15,89,282,33,39,0,0
3327,1257,198,1346,483,4,17,15,89,285,34,39,0,0
3328,1278,198,1370,496,4,17,15,92,298,35,39,0,0
3329,1296,201,1390,503,4,17,15,94,302,36,39,0,0
3330,1323,207,1416,510,4,17,15,93,303,37,39,0,0
3331,1340,208,1433,511,4,17,15,93,303,38,39,0,0
3332,1350,211,1444,519,4,17,15,94,308,39,39,1,0
2793,1875,632,1917,795,2,17,5,42,163,0,18,0,0
2794,1851,565,1915,813,2,17,5,64,248,1,18,0,0
2795,1840,490,1920,814,2,17,5,80,324,2,18,0,0
2796,1810,449,1907,819,2,17,5,97,370,3,18,0,0
2797,1785,433,1896,843,2,17,5,111,410,4,18,0,0
2798,1769,398,1896,860,2,17,5,127,462,5,18,0,0
2799,1755,396,1896,900,2,17,5,141,504,6,18,0,0
2800,1740,395,1894,933,2,17,5,154,538,7,18,0,0
2801,1713,398,1879,954,2,17,5,166,556,8,18,0,0
2802,1667,410,1854,993,2,17,5,187,583,9,18,0,0
2803,1639,427,1837,1014,2,17,5,198,587,10,18,0,0
2804,1617,448,1830,1055,2,17,5,213,607,11,18,0,0
2805,1604,490,1817,1071,2,17,5,213,581,12,18,0,0
2806,1587,521,1804,1075,2,17,5,217,554,13,18,0,0
2807,1577,567,1790,1071,2,17,5,213,504,14,18,0,0
2808,1567,622,1772,1074,2,17,5,205,452,15,18,0,0
2809,1563,682,1760,1076,2,17,5,197,394,16,18,0,0
2810,1594,793,1762,1073,2,17,5,168,280,17,18,0,0
2811,1591,820,1749,1080,2,17,5,158,260,18,18,0,0
3322,1832,569,1918,758,4,17,5,86,189,0,22,0,1
3323,1801,460,1920,777,4,17,5,119,317,1,22,0,0
3324,1781,412,1920,794,4,17,5,139,382,2,22,0,0
3325,1739,370,1920,814,4,17,5,181,444,3,22,0,0
3326,1716,356,1920,829,4,17,5,204,473,4,22,0,0
3327,1654,350,1879,848,4,17,5,225,498,5,22,0,0
3328,1595,356,1831,872,4,17,5,236,516,6,22,0,0
3329,1551,352,1801,899,4,17,5,250,547,7,22,0,0
3330,1468,367,1734,941,4,17,5,266,574,8,22,0,0
3331,1399,382,1674,971,4,17,5,275,589,9,22,0,0
3332,1291,383,1584,993,4,17,5,293,610,10,22,0,0
3333,1170,395,1485,1032,4,17,5,315,637,11,22,0,0
3334,1080,393,1402,1049,4,17,5,322,656,12,22,0,0
3335,938,387,1276,1068,4,17,5,338,681,13,22,0,0
3336,831,410,1163,1076,4,17,5,332,666,14,22,0,0
3337,674,405,1015,1080,4,17,5,341,675,15,22,0,0
3338,541,423,883,1080,4,17,5,342,657,16,22,0,0
3339,365,413,711,1080,4,17,5,346,667,17,22,0,0
3340,212,432,556,1079,4,17,5,344,647,18,22,0,0
3341,94,474,436,1080,4,17,5,342,606,19,22,0,0
3342,0,540,278,1080,4,17,5,278,540,20,22,0,0
3343,0,639,193,1080,4,17,5,193,441,21,22,0,0
3344,0,659,99,1080,4,17,5,99,421,22,22,1,0
390,241,258,309,517,1,17,6,68,259,0,29,0,1
391,236,198,322,528,1,17,6,86,330,1,29,0,0
392,240,190,330,532,1,17,6,90,342,2,29,0,0
393,259,196,354,553,1,17,6,95,357,3,29,0,0
394,293,199,390,564,1,17,6,97,365,4,29,0,0
395,337,207,439,578,1,17,6,102,371,5,29,0,0
396,355,211,462,598,1,17,6,107,387,6,29,0,0
397,385,211,494,601,1,17,6,109,390,7,29,0,0
398,414,220,526,617,1,17,6,112,397,8,29,0,0
399,433,226,552,645,1,17,6,119,419,9,29,0,0
400,457,233,582,666,1,17,6,125,433,10,29,0,0
401,477,245,610,702,1,17,6,133,457,11,29,0,0
402,500,249,638,719,1,17,6,138,470,12,29,0,0
403,518,257,667,761,1,17,6,149,504,13,29,0,0
404,533,273,689,805,1,17,6,156,532,14,29,0,0
405,553,278,712,817,1,17,6,159,539,15,29,0,0
406,571,300,742,873,1,17,6,171,573,16,29,0,0
407,594,318,774,912,1,17,6,180,594,17,29,0,0
408,627,325,813,934,1,17,6,186,609,18,29,0,0
409,650,350,853,1016,1,17,6,203,666,19,29,0,0
410,675,379,883,1062,1,17,6,208,683,20,29,0,0
411,704,394,914,1079,1,17,6,210,685,21,29,0,0
412,739,429,944,1080,1,17,6,205,651,22,29,0,0
413,790,463,994,1080,1,17,6,204,617,23,29,0,0
414,840,499,1044,1080,1,17,6,204,581,24,29,0,0
415,885,569,1080,1080,1,17,6,195,511,25,29,0,0
416,931,630,1120,1080,1,17,6,189,450,26,29,0,0
417,988,717,1162,1077,1,17,6,174,360,27,29,0,0
418,1093,842,1229,1078,1,17,6,136,236,28,29,0,0
419,1151,896,1262,1080,1,17,6,111,184,29,29,1,0
3345,1728,850,1897,1075,3,17,6,169,225,0,0,0,0
3346,1568,744,1811,1069,4,17,6,243,325,0,0,0,0
3347,1398,682,1696,1073,5,17,6,298,391,0,49,0,1
3348,1264,596,1625,1072,5,17,6,361,476,1,49,0,0
3349,1163,554,1550,1064,5,17,6,387,510,2,49,0,0
3350,1041,503,1467,1071,5,17,6,426,568,3,49,0,0
3351,958,446,1412,1066,5,17,6,454,620,4,49,0,0
3352,878,411,1349,1072,5,17,6,471,661,5,49,0,0
3353,842,379,1277,1008,5,17,6,435,629,6,49,0,0
3354,803,346,1210,952,5,17,6,407,606,7,49,0,0
3355,769,324,1152,916,5,17,6,383,592,8,49,0,0
3356,752,295,1094,841,5,17,6,342,546,9,49,0,0
3357,736,283,1044,793,5,17,6,308,510,10,49,0,0
3358,727,268,999,736,5,17,6,272,468,11,49,0,0
3359,716,249,963,689,5,17,6,247,440,12,49,0,0
3360,703,243,933,667,5,17,6,230,424,13,49,0,0
3361,693,227,901,624,5,17,6,208,397,14,49,0,0
3362,692,219,876,581,5,17,6,184,362,15,49,0,0
3363,683,215,861,576,5,17,6,178,361,16,49,0,0
3364,679,199,845,546,5,17,6,166,347,17,49,0,0
3365,679,193,836,532,5,17,6,157,339,18,49,0,0
3366,678,186,824,511,5,17,6,146,325,19,49,0,0
3367,681,182,816,487,5,17,6,135,305,20,49,0,0
3368,685,182,811,475,5,17,6,126,293,21,49,0,0
3369,693,174,812,458,5,17,6,119,284,22,49,0,0
3370,701,170,816,450,5,17,6,115,280,23,49,0,0
3371,708,168,818,442,5,17,6,110,274,24,49,0,0
3372,714,162,816,421,5,17,6,102,259,25,49,0,0
3373,717,162,814,412,5,17,6,97,250,26,49,0,0
3374,724,160,815,397,5,17,6,91,237,27,49,0,0
3375,729,153,817,387,5,17,6,88,234,28,49,0,0
3376,734,154,818,381,5,17,6,84,227,29,49,0,0
3377,735,148,814,364,5,17,6,79,216,30,49,0,0
3378,735,145,812,355,5,17,6,77,210,31,49,0,0
3379,733,142,810,354,5,17,6,77,212,32,49,0,0
3380,734,138,807,340,5,17,6,73,202,33,49,0,0
3381,738,140,807,335,5,17,6,69,195,34,49,0,0
3382,738,140,805,332,5,17,6,67,192,35,49,0,0
3383,739,138,805,326,5,17,6,66,188,36,49,0,0
3384,745,139,806,316,5,17,6,61,177,37,49,0,0
3385,750,134,811,313,5,17,6,61,179,38,49,0,0
3386,756,133,815,313,5,17,6,59,180,39,49,0,0
3387,762,135,818,312,5,17,6,56,177,40,49,0,0
3388,765,133,819,312,5,17,6,54,179,41,49,0,0
3389,768,135,819,311,5,17,6,51,176,42,49,0,0
3390,771,144,813,290,5,17,6,42,146,43,49,0,0
3391,771,148,809,283,5,17,6,38,135,44,49,0,0
3392,768,157,806,290,5,17,6,38,133,45,49,0,0
3393,764,163,803,297,5,17,6,39,134,46,49,0,0
3394,762,172,799,299,5,17,6,37,127,47,49,0,0
3395,760,182,797,301,5,17,6,37,119,48,49,0,0
3396,756,187,792,302,5,17,6,36,115,49,49,1,0
418,1823,834,1920,1079,6,17,7,97,245,0,0,0,0
419,1630,651,1909,1073,7,17,7,279,422,0,74,0,1
420,1590,486,1920,1053,7,17,7,330,567,1,74,0,0
421,1507,430,1920,1070,7,17,7,413,640,2,74,0,0
422,1410,395,1845,1062,7,17,7,435,667,3,74,0,0
423,1354,365,1779,1026,7,17,7,425,661,4,74,0,0
424,1327,336,1748,1005,7,17,7,421,669,5,74,0,0
425,1312,318,1720,983,7,17,7,408,665,6,74,0,0
426,1308,287,1674,901,7,17,7,366,614,7,74,0,0
427,1297,275,1642,868,7,17,7,345,593,8,74,0,0
428,1294,266,1615,834,7,17,7,321,568,9,74,0,0
429,1299,242,1585,764,7,17,7,286,522,10,74,0,0
430,1306,236,1576,740,7,17,7,270,504,11,74,0,0
431,1313,222,1561,699,7,17,7,248,477,12,74,0,0
432,1318,210,1548,667,7,17,7,230,457,13,74,0,0
433,1319,202,1538,654,7,17,7,219,452,14,74,0,0
434,1324,186,1524,613,7,17,7,200,427,15,74,0,0
435,1331,166,1522,584,7,17,7,191,418,16,74,0,0
436,1340,168,1519,570,7,17,7,179,402,17,74,0,0
437,1354,162,1520,540,7,17,7,166,378,18,74,0,0
438,1365,157,1522,528,7,17,7,157,371,19,74,0,0
439,1371,152,1519,514,7,17,7,148,362,20,74,0,0
440,1383,149,1515,481,7,17,7,132,332,21,74,0,0
441,1393,146,1519,468,7,17,7,126,322,22,74,0,0
442,1406,145,1528,461,7,17,7,122,316,23,74,0,0
443,1417,137,1536,450,7,17,7,119,313,24,74,0,0
444,1427,137,1539,439,7,17,7,112,302,25,74,0,0
445,1440,135,1545,428,7,17,7,105,293,26,74,0,0
446,1453,130,1555,418,7,17,7,102,288,27,74,0,0
447,1463,131,1562,407,7,17,7,99,276,28,74,0,0
448,1479,126,1575,394,7,17,7,96,268,29,74,0,0
449,1488,118,1583,389,7,17,7,95,271,30,74,0,0
450,1499,124,1588,386,7,17,7,89,262,31,74,0,0
451,1507,118,1593,377,7,17,7,86,259,32,74,0,0
452,1517,123,1594,358,7,17,7,77,235,33,74,0,0
453,1527,124,1602,353,7,17,7,75,229,34,74,0,0
454,1537,119,1613,347,7,17,7,76,228,35,74,0,0
455,1547,119,1621,344,7,17,7,74,225,36,74,0,0
456,1553,117,1627,339,7,17,7,74,222,37,74,0,0
457,1553,113,1626,330,7,17,7,73,217,38,74,0,0
458,1550,116,1619,322,7,17,7,69,206,39,74,0,0
459,1550,112,1619,320,7,17,7,69,208,40,74,0,0
460,1550,110,1617,313,7,17,7,67,203,41,74,0,0
461,1552,110,1616,309,7,17,7,64,199,42,74,0,0
462,1553,111,1612,299,7,17,7,59,188,43,74,0,0
463,1554,110,1610,295,7,17,7,56,185,44,74,0,0
464,1556,106,1612,290,7,17,7,56,184,45,74,0,0
465,1561,104,1614,282,7,17,7,53,178,46,74,0,0
466,1564,104,1617,279,7,17,7,53,175,47,74,0,0
467,1567,104,1619,281,7,17,7,52,177,48,74,0,0
468,1570,102,1621,273,7,17,7,51,171,49,74,0,0
469,1576,105,1625,269,7,17,7,49,164,50,74,0,0
470,1580,107,1628,268,7,17,7,48,161,51,74,0,0
471,1585,102,1632,263,7,17,7,47,161,52,74,0,0
472,1589,104,1635,262,7,17,7,46,158,53,74,0,0
473,1591,104,1635,256,7,17,7,44,152,54,74,0,0
474,1593,99,1637,252,7,17,7,44,153,55,74,0,0
475,1596,100,1639,248,7,17,7,43,148,56,74,0,0
476,1598,99,1641,246,7,17,7,43,147,57,74,0,0
477,1600,97,1642,242,7,17,7,42,145,58,74,0,0
478,1602,100,1643,241,7,17,7,41,141,59,74,0,0
479,1601,96,1642,236,7,17,7,41,140,60,74,0,0
480,1603,94,1644,234,7,17,7,41,140,61,74,0,0
481,1604,96,1644,232,7,17,7,40,136,62,74,0,0
482,1603,89,1643,230,7,17,7,40,141,63,74,0,0
483,1602,87,1643,228,7,17,7,41,141,64,74,0,0
484,1602,86,1642,226,7,17,7,40,140,65,74,0,0
485,1603,83,1642,222,7,17,7,39,139,66,74,0,0
486,1604,84,1641,218,7,17,7,37,134,67,74,0,0
487,1604,82,1642,219,7,17,7,38,137,68,74,0,0
488,1606,80,1643,216,7,17,7,37,136,69,74,0,0
489,1607,79,1644,216,7,17,7,37,137,70,74,0,0
490,1608,79,1644,212,7,17,7,36,133,71,74,0,0
491,1608,74,1645,209,7,17,7,37,135,72,74,0,0
492,1610,76,1645,206,7,17,7,35,130,73,74,0,0
493,1611,77,1646,203,7,17,7,35,126,74,74,1,0
497,1615,73,1650,199,7,17,7,35,126,0,74,0,0
2779,19,258,54,497,10,17,7,35,239,0,104,0,1
2780,20,249,59,497,10,17,7,39,248,1,104,0,0
2781,21,248,64,512,10,17,7,43,264,2,104,0,0
2782,23,248,70,522,10,17,7,47,274,3,104,0,0
2783,25,249,76,527,10,17,7,51,278,4,104,0,0
2784,36,249,93,534,10,17,7,57,285,5,104,0,0
2785,41,253,103,538,10,17,7,62,285,6,104,0,0
2786,44,253,111,544,10,17,7,67,291,7,104,0,0
2787,49,256,123,562,10,17,7,74,306,8,104,0,0
2788,54,260,132,573,10,17,7,78,313,9,104,0,0
2789,63,262,148,580,10,17,7,85,318,10,104,0,0
2790,79,271,170,590,10,17,7,91,319,11,104,0,0
2791,88,271,184,596,10,17,7,96,325,12,104,0,0
2792,91,271,197,619,10,17,7,106,348,13,104,0,0
2793,100,278,213,645,10,17,7,113,367,14,104,0,0
2794,108,278,228,655,10,17,7,120,377,15,104,0,0
2795,131,280,260,666,10,17,7,129,386,16,104,0,0
2796,149,283,284,675,10,17,7,135,392,17,104,0,0
2797,161,279,303,685,10,17,7,142,406,18,104,0,0
2798,181,279,335,713,10,17,7,154,434,19,104,0,0
2799,203,287,364,736,10,17,7,161,449,20,104,0,0
2800,226,282,392,744,10,17,7,166,462,21,104,0,0
2801,275,291,451,759,10,17,7,176,468,22,104,0,0
2802,316,293,500,770,10,17,7,184,477,23,104,0,0
2803,346,292,541,794,10,17,7,195,502,24,104,0,0
2804,393,299,599,827,10,17,7,206,528,25,104,0,0
2805,429,303,636,839,10,17,7,207,536,26,104,0,0
2806,506,310,720,851,10,17,7,214,541,27,104,0,0
2807,570,313,792,860,10,17,7,222,547,28,104,0,0
2808,629,301,853,866,10,17,7,224,565,29,104,0,0
2809,726,308,959,883,10,17,7,233,575,30,104,0,0
2810,791,315,1025,889,10,17,7,234,574,31,104,0,0
2811,886,304,1123,895,10,17,7,237,591,32,104,0,0
2812,947,299,1196,904,10,17,7,249,605,33,104,0,0
2813,1036,293,1272,876,10,17,7,236,583,34,104,0,0
2814,1130,278,1359,848,10,17,7,229,570,35,104,0,0
2815,1188,285,1407,823,10,17,7,219,538,36,104,0,0
2816,1256,270,1466,792,10,17,7,210,522,37,104,0,0
2817,1299,265,1505,779,10,17,7,206,514,38,104,0,0
2818,1337,260,1535,757,10,17,7,198,497,39,104,0,0
2819,1373,244,1559,722,10,17,7,186,478,40,104,0,0
2820,1404,239,1583,705,10,17,7,179,466,41,104,0,0
2821,1433,232,1602,673,10,17,7,169,441,42,104,0,0
2822,1459,222,1621,649,10,17,7,162,427,43,104,0,0
2823,1475,215,1633,637,10,17,7,158,422,44,104,0,0
2824,1490,204,1636,598,10,17,7,146,394,45,104,0,0
2825,1500,192,1640,574,10,17,7,140,382,46,104,0,0
2826,1509,194,1640,558,10,17,7,131,364,47,104,0,0
2827,1519,184,1643,529,10,17,7,124,345,48,104,0,0
2828,1526,175,1646,513,10,17,7,120,338,49,104,0,0
2829,1533,173,1649,502,10,17,7,116,329,50,104,0,0
2830,1539,170,1647,480,10,17,7,108,310,51,104,0,0
2831,1540,164,1645,468,10,17,7,105,304,52,104,0,0
2832,1545,162,1647,458,10,17,7,102,296,53,104,0,0
2833,1553,159,1650,443,10,17,7,97,284,54,104,0,0
2834,1559,158,1653,434,10,17,7,94,276,55,104,0,0
2835,1562,154,1653,423,10,17,7,91,269,56,104,0,0
2836,1563,148,1651,410,10,17,7,88,262,57,104,0,0
2837,1567,150,1652,402,10,17,7,85,252,58,104,0,0
2838,1571,145,1653,390,10,17,7,82,245,59,104,0,0
2839,1576,141,1657,383,10,17,7,81,242,60,104,0,0
2840,1580,142,1659,379,10,17,7,79,237,61,104,0,0
2841,1582,137,1657,365,10,17,7,75,228,62,104,0,0
2842,1584,135,1657,359,10,17,7,73,224,63,104,0,0
2843,1586,136,1657,355,10,17,7,71,219,64,104,0,0
2844,1589,132,1658,345,10,17,7,69,213,65,104,0,0
2845,1592,129,1659,339,10,17,7,67,210,66,104,0,0
2846,1594,128,1659,334,10,17,7,65,206,67,104,0,0
2847,1593,122,1658,325,10,17,7,65,203,68,104,0,0
2848,1596,126,1657,321,10,17,7,61,195,69,104,0,0
2849,1598,122,1658,313,10,17,7,60,191,70,104,0,0
2850,1601,124,1659,307,10,17,7,58,183,71,104,0,0
2851,1603,124,1659,304,10,17,7,56,180,72,104,0,0
2852,1603,122,1657,293,10,17,7,54,171,73,104,0,0
2853,1602,116,1658,294,10,17,7,56,178,74,104,0,0
2854,1603,120,1656,289,10,17,7,53,169,75,104,0,0
2855,1604,118,1656,283,10,17,7,52,165,76,104,0,0
2856,1604,118,1655,279,10,17,7,51,161,77,104,0,0
2857,1604,118,1653,274,10,17,7,49,156,78,104,0,0
2858,1600,111,1651,271,10,17,7,51,160,79,104,0,0
2859,1600,110,1650,267,10,17,7,50,157,80,104,0,0
2860,1601,109,1649,263,10,17,7,48,154,81,104,0,0
2861,1599,103,1649,260,10,17,7,50,157,82,104,0,0
2862,1600,103,1649,257,10,17,7,49,154,83,104,0,0
2863,1600,103,1646,249,10,17,7,46,146,84,104,0,0
2864,1601,102,1647,246,10,17,7,46,144,85,104,0,0
2865,1603,103,1648,246,10,17,7,45,143,86,104,0,0
2866,1606,99,1651,242,10,17,7,45,143,87,104,0,0
2867,1609,99,1652,238,10,17,7,43,139,88,104,0,0
2868,1611,98,1654,238,10,17,7,43,140,89,104,0,0
2869,1614,101,1654,231,10,17,7,40,130,90,104,0,0
2870,1617,102,1656,228,10,17,7,39,126,91,104,0,0
2871,1619,96,1659,226,10,17,7,40,130,92,104,0,0
2872,1622,89,1664,227,10,17,7,42,138,93,104,0,0
2873,1623,81,1667,225,10,17,7,44,144,94,104,0,0
2874,1626,84,1667,220,10,17,7,41,136,95,104,0,0
2875,1626,86,1665,217,10,17,7,39,131,96,104,0,0
2876,1628,87,1667,217,10,17,7,39,130,97,104,0,0
2877,1629,87,1668,212,10,17,7,39,125,98,104,0,0
2878,1631,86,1670,212,10,17,7,39,126,99,104,0,0
2879,1633,86,1670,209,10,17,7,37,123,100,104,0,0
2880,1634,88,1669,205,10,17,7,35,117,101,104,0,0
2881,1634,87,1669,206,10,17,7,35,119,102,104,0,0
2882,1635,85,1671,204,10,17,7,36,119,103,104,0,0
2883,1637,84,1672,202,10,17,7,35,118,104,104,1,0
