frame_num,x1,y1,x2,y2,track,hour,camera,w,h,track_length,max_track_len,departure,entrance
680,1585,158,1622,283,1,11,1,37,125,0,21,0,1
681,1575,156,1615,291,1,11,1,40,135,1,21,0,0
682,1565,156,1607,294,1,11,1,42,138,2,21,0,0
683,1553,158,1596,297,1,11,1,43,139,3,21,0,0
684,1541,157,1586,300,1,11,1,45,143,4,21,0,0
685,1529,158,1575,302,1,11,1,46,144,5,21,0,0
686,1519,156,1567,306,1,11,1,48,150,6,21,0,0
687,1510,159,1561,312,1,11,1,51,153,7,21,0,0
688,1498,158,1552,318,1,11,1,54,160,8,21,0,0
689,1486,160,1540,319,1,11,1,54,159,9,21,0,0
690,1474,165,1529,323,1,11,1,55,158,10,21,0,0
691,1460,165,1516,325,1,11,1,56,160,11,21,0,0
692,1449,166,1506,327,1,11,1,57,161,12,21,0,0
693,1437,169,1495,333,1,11,1,58,164,13,21,0,0
694,1420,164,1480,335,1,11,1,60,171,14,21,0,0
695,1409,169,1469,335,1,11,1,60,166,15,21,0,0
696,1383,168,1445,341,1,11,1,62,173,16,21,0,0
697,1361,168,1421,337,1,11,1,60,169,17,21,0,0
698,1338,171,1398,333,1,11,1,60,162,18,21,0,0
699,1308,171,1368,335,1,11,1,60,164,19,21,0,0
700,1281,171,1344,335,1,11,1,63,164,20,21,0,0
701,1264,171,1327,337,1,11,1,63,166,21,21,1,0
737,1581,142,1620,281,2,11,1,39,139,0,18,0,0
738,1568,141,1607,276,2,11,1,39,135,1,18,0,0
739,1558,140,1599,284,2,11,1,41,144,2,18,0,0
740,1546,142,1589,292,2,11,1,43,150,3,18,0,0
741,1532,142,1576,297,2,11,1,44,155,4,18,0,0
742,1518,144,1564,304,2,11,1,46,160,5,18,0,0
743,1505,144,1553,307,2,11,1,48,163,6,18,0,0
744,1492,145,1540,310,2,11,1,48,165,7,18,0,0
745,1481,148,1531,319,2,11,1,50,171,8,18,0,0
746,1460,147,1513,325,2,11,1,53,178,9,18,0,0
747,1442,148,1495,327,2,11,1,53,179,10,18,0,0
748,1421,145,1477,333,2,11,1,56,188,11,18,0,0
749,1403,148,1459,332,2,11,1,56,184,12,18,0,0
750,1372,148,1429,333,2,11,1,57,185,13,18,0,0
751,1344,148,1401,335,2,11,1,57,187,14,18,0,0
752,1315,148,1375,338,2,11,1,60,190,15,18,0,0
753,1277,148,1337,340,2,11,1,60,192,16,18,0,0
754,1262,183,1312,341,2,11,1,50,158,17,18,0,0
755,1242,187,1292,344,2,11,1,50,157,18,18,0,0
986,1261,212,1319,442,3,11,1,58,230,0,30,0,1
987,1264,209,1321,432,3,11,1,57,223,1,30,0,0
988,1275,207,1333,430,3,11,1,58,223,2,30,0,0
989,1293,217,1352,441,3,11,1,59,224,3,30,0,0
990,1310,219,1373,449,3,11,1,63,230,4,30,0,0
991,1324,222,1391,463,3,11,1,67,241,5,30,0,0
992,1340,228,1412,480,3,11,1,72,252,6,30,0,0
993,1346,228,1424,494,3,11,1,78,266,7,30,0,0
994,1346,239,1429,521,3,11,1,83,282,8,30,0,0
995,1349,241,1436,530,3,11,1,87,289,9,30,0,0
996,1351,249,1445,551,3,11,1,94,302,10,30,0,0
997,1354,258,1455,574,3,11,1,101,316,11,30,0,0
998,1348,260,1452,583,3,11,1,104,323,12,30,0,0
999,1338,279,1446,612,3,11,1,108,333,13,30,0,0
1000,1329,290,1441,630,3,11,1,112,340,14,30,0,0
1001,1318,300,1442,668,3,11,1,124,368,15,30,0,0
1002,1306,319,1442,708,3,11,1,136,389,16,30,0,0
1003,1290,327,1429,720,3,11,1,139,393,17,30,0,0
1004,1264,349,1413,772,3,11,1,149,423,18,30,0,0
1005,1242,366,1396,802,3,11,1,154,436,19,30,0,0
1006,1215,375,1391,863,3,11,1,176,488,20,30,0,0
1007,1189,401,1382,919,3,11,1,193,518,21,30,0,0
1008,1176,417,1380,959,3,11,1,204,542,22,30,0,0
1009,1155,460,1371,1033,3,11,1,216,573,23,30,0,0
1010,1122,496,1345,1071,3,11,1,223,575,24,30,0,0
1011,1103,532,1333,1080,3,11,1,230,548,25,30,0,0
1012,1087,596,1312,1080,3,11,1,225,484,26,30,0,0
1013,1055,639,1273,1080,3,11,1,218,441,27,30,0,0
1014,1025,746,1206,1080,3,11,1,181,334,28,30,0,0
1015,959,857,1100,1080,3,11,1,141,223,29,30,0,0
1016,941,902,1065,1080,3,11,1,124,178,30,30,1,0
1707,1261,164,1319,428,5,11,1,58,264,0,37,0,1
1708,1272,170,1331,436,5,11,1,59,266,1,37,0,0
1709,1284,171,1344,436,5,11,1,60,265,2,37,0,0
1710,1301,170,1365,445,5,11,1,64,275,3,37,0,0
1711,1309,175,1378,459,5,11,1,69,284,4,37,0,0
1712,1313,176,1385,464,5,11,1,72,288,5,37,0,0
1713,1317,183,1393,479,5,11,1,76,296,6,37,0,0
1714,1329,188,1410,493,5,11,1,81,305,7,37,0,0
1715,1339,188,1426,506,5,11,1,87,318,8,37,0,0
1716,1341,193,1434,521,5,11,1,93,328,9,37,0,0
1717,1338,194,1437,538,5,11,1,99,344,10,37,0,0
1718,1334,194,1438,551,5,11,1,104,357,11,37,0,0
1719,1334,205,1443,572,5,11,1,109,367,12,37,0,0
1720,1337,209,1451,587,5,11,1,114,378,13,37,0,0
1721,1333,211,1453,602,5,11,1,120,391,14,37,0,0
1722,1320,223,1445,628,5,11,1,125,405,15,37,0,0
1723,1306,226,1437,643,5,11,1,131,417,16,37,0,0
1724,1293,232,1435,677,5,11,1,142,445,17,37,0,0
1725,1285,242,1435,706,5,11,1,150,464,18,37,0,0
1726,1273,249,1428,720,5,11,1,155,471,19,37,0,0
1727,1249,257,1416,762,5,11,1,167,505,20,37,0,0
1728,1229,269,1400,784,5,11,1,171,515,21,37,0,0
1729,1208,277,1387,807,5,11,1,179,530,22,37,0,0
1730,1191,289,1388,864,5,11,1,197,575,23,37,0,0
1731,1179,304,1387,897,5,11,1,208,593,24,37,0,0
1732,1147,316,1366,934,5,11,1,219,618,25,37,0,0
1733,1118,335,1348,981,5,11,1,230,646,26,37,0,0
1734,1080,347,1323,1029,5,11,1,243,682,27,37,0,0
1735,1048,371,1295,1059,5,11,1,247,688,28,37,0,0
1736,1019,406,1265,1078,5,11,1,246,672,29,37,0,0
1737,982,430,1227,1080,5,11,1,245,650,30,37,0,0
1738,943,466,1186,1080,5,11,1,243,614,31,37,0,0
1739,894,517,1130,1080,5,11,1,236,563,32,37,0,0
1740,850,553,1083,1077,5,11,1,233,524,33,37,0,0
1741,804,620,1029,1080,5,11,1,225,460,34,37,0,0
1742,760,712,964,1078,5,11,1,204,366,35,37,0,0
1743,683,802,856,1074,5,11,1,173,272,36,37,0,0
1744,652,848,802,1080,5,11,1,150,232,37,37,1,0
2277,1593,157,1658,281,7,11,1,65,124,0,29,0,1
2278,1593,155,1662,287,7,11,1,69,132,1,29,0,0
2279,1581,158,1650,290,7,11,1,69,132,2,29,0,0
2280,1564,155,1634,291,7,11,1,70,136,3,29,0,0
2281,1549,152,1620,290,7,11,1,71,138,4,29,0,0
2282,1542,151,1611,289,7,11,1,69,138,5,29,0,0
2283,1535,154,1605,295,7,11,1,70,141,6,29,0,0
2284,1541,156,1610,299,7,11,1,69,143,7,29,0,0
2285,1545,154,1609,291,7,11,1,64,137,8,29,0,0
2286,1542,153,1606,294,7,11,1,64,141,9,29,0,0
2287,1538,154,1599,295,7,11,1,61,141,10,29,0,0
2288,1530,154,1595,306,7,11,1,65,152,11,29,0,0
2289,1526,157,1590,314,7,11,1,64,157,12,29,0,0
2290,1523,158,1584,311,7,11,1,61,153,13,29,0,0
2291,1518,160,1578,317,7,11,1,60,157,14,29,0,0
2292,1509,161,1571,323,7,11,1,62,162,15,29,0,0
2293,1501,159,1563,327,7,11,1,62,168,16,29,0,0
2294,1489,164,1551,330,7,11,1,62,166,17,29,0,0
2295,1477,164,1538,331,7,11,1,61,167,18,29,0,0
2296,1462,167,1522,333,7,11,1,60,166,19,29,0,0
2297,1446,166,1510,334,7,11,1,64,168,20,29,0,0
2298,1425,163,1489,335,7,11,1,64,172,21,29,0,0
2299,1405,167,1467,335,7,11,1,62,168,22,29,0,0
2300,1386,164,1451,339,7,11,1,65,175,23,29,0,0
2301,1360,166,1422,333,7,11,1,62,167,24,29,0,0
2302,1339,167,1399,330,7,11,1,60,163,25,29,0,0
2303,1319,170,1380,331,7,11,1,61,161,26,29,0,0
2304,1288,171,1349,334,7,11,1,61,163,27,29,0,0
2305,1267,173,1327,333,7,11,1,60,160,28,29,0,0
2306,1250,174,1309,334,7,11,1,59,160,29,29,1,0
2284,1532,156,1576,306,9,11,1,44,150,0,18,0,0
2285,1526,152,1573,316,9,11,1,47,164,1,18,0,0
2286,1518,154,1567,323,9,11,1,49,169,2,18,0,0
2287,1507,151,1558,323,9,11,1,51,172,3,18,0,0
2288,1499,153,1550,327,9,11,1,51,174,4,18,0,0
2289,1492,157,1543,330,9,11,1,51,173,5,18,0,0
2290,1484,155,1536,332,9,11,1,52,177,6,18,0,0
2291,1474,158,1527,335,9,11,1,53,177,7,18,0,0
2292,1461,161,1515,338,9,11,1,54,177,8,18,0,0
2293,1446,158,1501,338,9,11,1,55,180,9,18,0,0
2294,1427,159,1484,342,9,11,1,57,183,10,18,0,0
2295,1410,158,1468,346,9,11,1,58,188,11,18,0,0
2296,1386,158,1445,343,9,11,1,59,185,12,18,0,0
2297,1366,161,1427,340,9,11,1,61,179,13,18,0,0
2298,1335,163,1392,334,9,11,1,57,171,14,18,0,0
2299,1304,159,1362,331,9,11,1,58,172,15,18,0,0
2300,1283,161,1345,335,9,11,1,62,174,16,18,0,0
2301,1260,162,1321,336,9,11,1,61,174,17,18,0,0
2302,1243,163,1304,338,9,11,1,61,175,18,18,0,0
3400,705,457,1315,1072,10,11,1,610,615,0,1,0,0
3401,721,411,1376,1071,10,11,1,655,660,1,1,0,0
3401,929,440,1140,983,11,11,1,211,543,0,25,0,1
3402,952,404,1175,978,11,11,1,223,574,1,25,0,0
3403,989,386,1199,929,11,11,1,210,543,2,25,0,0
3404,1033,358,1222,848,11,11,1,189,490,3,25,0,0
3405,1064,347,1246,817,11,11,1,182,470,4,25,0,0
3406,1094,329,1265,769,11,11,1,171,440,5,25,0,0
3407,1112,314,1273,729,11,11,1,161,415,6,25,0,0
3408,1134,304,1289,707,11,11,1,155,403,7,25,0,0
3409,1162,289,1305,659,11,11,1,143,370,8,25,0,0
3410,1178,282,1319,647,11,11,1,141,365,9,25,0,0
3411,1187,269,1321,616,11,11,1,134,347,10,25,0,0
3412,1196,256,1328,595,11,11,1,132,339,11,25,0,0
3413,1211,251,1338,582,11,11,1,127,331,12,25,0,0
3414,1228,242,1348,554,11,11,1,120,312,13,25,0,0
3415,1242,240,1356,541,11,11,1,114,301,14,25,0,0
3416,1252,234,1361,522,11,11,1,109,288,15,25,0,0
3417,1260,229,1365,506,11,11,1,105,277,16,25,0,0
3418,1270,229,1371,497,11,11,1,101,268,17,25,0,0
3419,1280,221,1375,471,11,11,1,95,250,18,25,0,0
3420,1285,217,1378,464,11,11,1,93,247,19,25,0,0
3421,1285,211,1376,451,11,11,1,91,240,20,25,0,0
3422,1280,207,1368,437,11,11,1,88,230,21,25,0,0
3423,1269,205,1356,433,11,11,1,87,228,22,25,0,0
3424,1259,201,1344,428,11,11,1,85,227,23,25,0,0
3425,1256,202,1335,416,11,11,1,79,214,24,25,0,0
3426,1259,197,1333,402,11,11,1,74,205,25,25,1,0
3728,404,869,591,1072,15,11,1,187,203,0,0,0,0
3729,519,808,762,1075,16,11,1,243,267,0,39,0,1
3730,575,733,888,1077,16,11,1,313,344,1,39,0,0
3731,612,669,984,1079,16,11,1,372,410,2,39,0,0
3732,642,618,1056,1076,16,11,1,414,458,3,39,0,0
3733,684,564,1141,1078,16,11,1,457,514,4,39,0,0
3734,741,520,1226,1079,16,11,1,485,559,5,39,0,0
3735,794,493,1284,1075,16,11,1,490,582,6,39,0,0
3736,855,461,1326,1041,16,11,1,471,580,7,39,0,0
3737,886,427,1369,1043,16,11,1,483,616,8,39,0,0
3738,933,402,1384,997,16,11,1,451,595,9,39,0,0
3739,990,380,1386,922,16,11,1,396,542,10,39,0,0
3740,1041,370,1396,877,16,11,1,355,507,11,39,0,0
3741,1081,353,1409,843,16,11,1,328,490,12,39,0,0
3742,1115,338,1413,795,16,11,1,298,457,13,39,0,0
3743,1136,327,1420,776,16,11,1,284,449,14,39,0,0
3744,1170,313,1424,729,16,11,1,254,416,15,39,0,0
3745,1203,301,1437,698,16,11,1,234,397,16,39,0,0
3746,1225,296,1449,689,16,11,1,224,393,17,39,0,0
3747,1251,282,1458,659,16,11,1,207,377,18,39,0,0
3748,1268,276,1462,638,16,11,1,194,362,19,39,0,0
3749,1282,268,1466,623,16,11,1,184,355,20,39,0,0
3750,1299,257,1470,595,16,11,1,171,338,21,39,0,0
3751,1314,253,1475,581,16,11,1,161,328,22,39,0,0
3752,1330,248,1485,574,16,11,1,155,326,23,39,0,0
3753,1345,240,1488,547,16,11,1,143,307,24,39,0,0
3754,1352,237,1490,539,16,11,1,138,302,25,39,0,0
3755,1357,234,1490,527,16,11,1,133,293,26,39,0,0
3756,1365,231,1489,510,16,11,1,124,279,27,39,0,0
3757,1367,222,1486,497,16,11,1,119,275,28,39,0,0
3758,1369,222,1483,491,16,11,1,114,269,29,39,0,0
3759,1363,215,1474,478,16,11,1,111,263,30,39,0,0
3760,1360,215,1466,468,16,11,1,106,253,31,39,0,0
3761,1350,210,1450,452,16,11,1,100,242,32,39,0,0
3762,1337,208,1431,438,16,11,1,94,230,33,39,0,0
3763,1324,207,1416,436,16,11,1,92,229,34,39,0,0
3764,1306,203,1396,429,16,11,1,90,226,35,39,0,0
3765,1290,202,1375,419,16,11,1,85,217,36,39,0,0
3766,1276,201,1363,418,16,11,1,87,217,37,39,0,0
3767,1255,198,1339,414,16,11,1,84,216,38,39,0,0
3768,1247,194,1329,404,16,11,1,82,210,39,39,1,0
3736,1218,420,1443,1067,17,11,1,225,647,0,34,0,1
3737,1246,394,1464,1021,17,11,1,218,627,1,34,0,0
3738,1270,372,1479,972,17,11,1,209,600,2,34,0,0
3739,1294,366,1494,939,17,11,1,200,573,3,34,0,0
3740,1310,354,1493,883,17,11,1,183,529,4,34,0,0
3741,1323,327,1493,816,17,11,1,170,489,5,34,0,0
3742,1335,318,1500,795,17,11,1,165,477,6,34,0,0
3743,1355,293,1511,742,17,11,1,156,449,7,34,0,0
3744,1371,285,1520,717,17,11,1,149,432,8,34,0,0
3745,1377,280,1522,704,17,11,1,145,424,9,34,0,0
3746,1382,267,1516,661,17,11,1,134,394,10,34,0,0
3747,1388,260,1519,645,17,11,1,131,385,11,34,0,0
3748,1402,249,1529,624,17,11,1,127,375,12,34,0,0
3749,1413,240,1536,602,17,11,1,123,362,13,34,0,0
3750,1425,236,1545,595,17,11,1,120,359,14,34,0,0
3751,1435,232,1553,589,17,11,1,118,357,15,34,0,0
3752,1446,225,1554,555,17,11,1,108,330,16,34,0,0
3753,1454,218,1561,546,17,11,1,107,328,17,34,0,0
3754,1462,214,1564,528,17,11,1,102,314,18,34,0,0
3755,1472,208,1568,505,17,11,1,96,297,19,34,0,0
3756,1477,208,1569,495,17,11,1,92,287,20,34,0,0
3757,1472,205,1559,477,17,11,1,87,272,21,34,0,0
3758,1464,202,1547,459,17,11,1,83,257,22,34,0,0
3759,1457,199,1543,464,17,11,1,86,265,23,34,0,0
3760,1453,195,1536,452,17,11,1,83,257,24,34,0,0
3761,1446,194,1527,443,17,11,1,81,249,25,34,0,0
3762,1433,194,1511,433,17,11,1,78,239,26,34,0,0
3763,1411,192,1488,423,17,11,1,77,231,27,34,0,0
3764,1389,189,1465,419,17,11,1,76,230,28,34,0,0
3765,1370,184,1445,409,17,11,1,75,225,29,34,0,0
3766,1350,182,1423,401,17,11,1,73,219,30,34,0,0
3767,1329,180,1402,399,17,11,1,73,219,31,34,0,0
3768,1305,181,1379,395,17,11,1,74,214,32,34,0,0
3769,1270,177,1343,392,17,11,1,73,215,33,34,0,0
3770,1254,174,1326,384,17,11,1,72,210,34,34,1,0
4190,1265,204,1309,428,18,11,1,44,224,0,33,0,1
4191,1276,194,1323,433,18,11,1,47,239,1,33,0,0
4192,1282,192,1331,433,18,11,1,49,241,2,33,0,0
4193,1300,196,1352,438,18,11,1,52,242,3,33,0,0
4194,1314,201,1370,452,18,11,1,56,251,4,33,0,0
4195,1323,202,1384,463,18,11,1,61,261,5,33,0,0
4196,1331,213,1396,489,18,11,1,65,276,6,33,0,0
4197,1341,217,1411,505,18,11,1,70,288,7,33,0,0
4198,1344,222,1419,516,18,11,1,75,294,8,33,0,0
4199,1342,231,1422,533,18,11,1,80,302,9,33,0,0
4200,1333,235,1418,550,18,11,1,85,315,10,33,0,0
4201,1321,242,1415,583,18,11,1,94,341,11,33,0,0
4202,1308,244,1408,597,18,11,1,100,353,12,33,0,0
4203,1290,253,1397,615,18,11,1,107,362,13,33,0,0
4204,1267,267,1382,640,18,11,1,115,373,14,33,0,0
4205,1237,272,1360,659,18,11,1,123,387,15,33,0,0
4206,1209,282,1347,705,18,11,1,138,423,16,33,0,0
4207,1184,288,1329,723,18,11,1,145,435,17,33,0,0
4208,1152,300,1304,748,18,11,1,152,448,18,33,0,0
4209,1128,318,1285,779,18,11,1,157,461,19,33,0,0
4210,1089,329,1255,812,18,11,1,166,483,20,33,0,0
4211,1035,350,1224,890,18,11,1,189,540,21,33,0,0
4212,991,366,1193,929,18,11,1,202,563,22,33,0,0
4213,952,390,1165,982,18,11,1,213,592,23,33,0,0
4214,917,423,1136,1026,18,11,1,219,603,24,33,0,0
4215,846,442,1074,1067,18,11,1,228,625,25,33,0,0
4216,772,482,1003,1080,18,11,1,231,598,26,33,0,0
4217,710,514,939,1080,18,11,1,229,566,27,33,0,0
4218,662,565,878,1080,18,11,1,216,515,28,33,0,0
4219,575,628,777,1080,18,11,1,202,452,29,33,0,0
4220,481,682,673,1080,18,11,1,192,398,30,33,0,0
4221,388,765,557,1080,18,11,1,169,315,31,33,0,0
4222,305,862,438,1080,18,11,1,133,218,32,33,0,0
4223,252,910,364,1080,18,11,1,112,170,33,33,1,0
5165,828,467,1092,1079,21,11,1,264,612,0,52,0,1
5166,863,447,1135,1079,21,11,1,272,632,1,52,0,0
5167,910,408,1189,1059,21,11,1,279,651,2,52,0,0
5168,965,389,1239,1031,21,11,1,274,642,3,52,0,0
5169,1018,365,1266,952,21,11,1,248,587,4,52,0,0
5170,1055,343,1291,909,21,11,1,236,566,5,52,0,0
5171,1079,325,1311,886,21,11,1,232,561,6,52,0,0
5172,1119,303,1329,815,21,11,1,210,512,7,52,0,0
5173,1154,290,1352,780,21,11,1,198,490,8,52,0,0
5174,1185,280,1372,746,21,11,1,187,466,9,52,0,0
5175,1210,261,1385,705,21,11,1,175,444,10,52,0,0
5176,1224,258,1394,693,21,11,1,170,435,11,52,0,0
5177,1250,246,1404,640,21,11,1,154,394,12,52,0,0
5178,1268,234,1418,626,21,11,1,150,392,13,52,0,0
5179,1286,232,1427,608,21,11,1,141,376,14,52,0,0
5180,1309,223,1442,580,21,11,1,133,357,15,52,0,0
5181,1319,220,1447,569,21,11,1,128,349,16,52,0,0
5182,1329,214,1453,553,21,11,1,124,339,17,52,0,0
5183,1342,205,1461,532,21,11,1,119,327,18,52,0,0
5184,1353,204,1466,519,21,11,1,113,315,19,52,0,0
5185,1365,201,1473,504,21,11,1,108,303,20,52,0,0
5186,1374,197,1478,489,21,11,1,104,292,21,52,0,0
5187,1379,197,1478,482,21,11,1,99,285,22,52,0,0
5188,1385,189,1481,463,21,11,1,96,274,23,52,0,0
5189,1391,188,1481,446,21,11,1,90,258,24,52,0,0
5190,1397,186,1484,434,21,11,1,87,248,25,52,0,0
5191,1401,181,1486,426,21,11,1,85,245,26,52,0,0
5192,1403,182,1486,423,21,11,1,83,241,27,52,0,0
5193,1409,175,1489,409,21,11,1,80,234,28,52,0,0
5194,1415,172,1493,402,21,11,1,78,230,29,52,0,0
5195,1424,173,1500,397,21,11,1,76,224,30,52,0,0
5196,1432,168,1506,387,21,11,1,74,219,31,52,0,0
5197,1435,169,1506,381,21,11,1,71,212,32,52,0,0
5198,1439,166,1510,377,21,11,1,71,211,33,52,0,0
5199,1445,163,1513,367,21,11,1,68,204,34,52,0,0
5200,1451,165,1517,364,21,11,1,66,199,35,52,0,0
5201,1455,161,1521,361,21,11,1,66,200,36,52,0,0
5202,1458,160,1521,352,21,11,1,63,192,37,52,0,0
5203,1458,158,1520,347,21,11,1,62,189,38,52,0,0
5204,1458,153,1519,337,21,11,1,61,184,39,52,0,0
5205,1459,152,1519,333,21,11,1,60,181,40,52,0,0
5206,1460,149,1520,329,21,11,1,60,180,41,52,0,0
5207,1461,147,1519,324,21,11,1,58,177,42,52,0,0
5208,1461,148,1519,325,21,11,1,58,177,43,52,0,0
5209,1462,147,1516,312,21,11,1,54,165,44,52,0,0
5210,1461,146,1514,307,21,11,1,53,161,45,52,0,0
5211,1460,146,1513,307,21,11,1,53,161,46,52,0,0
5212,1456,144,1508,303,21,11,1,52,159,47,52,0,0
5213,1451,143,1503,299,21,11,1,52,156,48,52,0,0
5214,1444,142,1494,296,21,11,1,50,154,49,52,0,0
5215,1430,141,1480,295,21,11,1,50,154,50,52,0,0
5216,1422,144,1469,290,21,11,1,47,146,51,52,0,0
5217,1418,143,1464,286,21,11,1,46,143,52,52,1,0
1,267,245,318,404,1,11,10,51,159,0,3,0,0
2,263,243,320,421,1,11,10,57,178,1,3,0,0
3,263,242,320,423,1,11,10,57,181,2,3,0,0
4,262,242,321,427,1,11,10,59,185,3,3,0,0
320,578,286,630,559,2,11,10,52,273,0,26,0,1
321,573,282,629,576,2,11,10,56,294,1,26,0,0
322,563,284,623,592,2,11,10,60,308,2,26,0,0
323,553,284,611,585,2,11,10,58,301,3,26,0,0
324,539,287,603,605,2,11,10,64,318,4,26,0,0
325,524,292,591,613,2,11,10,67,321,5,26,0,0
326,514,298,584,619,2,11,10,70,321,6,26,0,0
327,504,302,581,644,2,11,10,77,342,7,26,0,0
328,500,305,583,661,2,11,10,83,356,8,26,0,0
329,499,311,587,676,2,11,10,88,365,9,26,0,0
330,497,317,594,709,2,11,10,97,392,10,26,0,0
331,497,319,599,721,2,11,10,102,402,11,26,0,0
332,501,331,608,747,2,11,10,107,416,12,26,0,0
333,517,339,630,773,2,11,10,113,434,13,26,0,0
334,542,348,661,803,2,11,10,119,455,14,26,0,0
335,569,363,695,845,2,11,10,126,482,15,26,0,0
336,599,368,729,864,2,11,10,130,496,16,26,0,0
337,636,387,771,894,2,11,10,135,507,17,26,0,0
338,666,410,809,926,2,11,10,143,516,18,26,0,0
339,732,438,879,953,2,11,10,147,515,19,26,0,0
340,781,460,943,1006,2,11,10,162,546,20,26,0,0
341,812,485,982,1036,2,11,10,170,551,21,26,0,0
342,854,508,1027,1042,2,11,10,173,534,22,26,0,0
343,878,533,1061,1070,2,11,10,183,537,23,26,0,0
344,925,561,1110,1080,2,11,10,185,519,24,26,0,0
345,1002,582,1189,1079,2,11,10,187,497,25,26,0,0
346,1033,598,1221,1080,2,11,10,188,482,26,26,1,0
348,1267,708,1592,1061,3,11,10,325,353,0,0,0,0
784,255,241,297,371,4,11,10,42,130,0,20,0,1
785,241,242,297,420,4,11,10,56,178,1,20,0,0
786,227,240,290,436,4,11,10,63,196,2,20,0,0
787,221,241,288,448,4,11,10,67,207,3,20,0,0
788,219,250,285,455,4,11,10,66,205,4,20,0,0
789,220,253,286,458,4,11,10,66,205,5,20,0,0
790,225,255,292,463,4,11,10,67,208,6,20,0,0
791,236,259,305,473,4,11,10,69,214,7,20,0,0
792,256,258,327,473,4,11,10,71,215,8,20,0,0
793,273,258,345,477,4,11,10,72,219,9,20,0,0
794,291,260,366,482,4,11,10,75,222,10,20,0,0
795,317,260,391,481,4,11,10,74,221,11,20,0,0
796,342,262,419,487,4,11,10,77,225,12,20,0,0
797,364,263,445,490,4,11,10,81,227,13,20,0,0
798,401,262,480,490,4,11,10,79,228,14,20,0,0
799,437,261,520,490,4,11,10,83,229,15,20,0,0
800,461,273,542,490,4,11,10,81,217,16,20,0,0
801,504,270,583,486,4,11,10,79,216,17,20,0,0
802,532,270,613,486,4,11,10,81,216,18,20,0,0
803,570,273,642,473,4,11,10,72,200,19,20,0,0
804,592,275,664,475,4,11,10,72,200,20,20,1,0
832,591,285,635,465,5,11,10,44,180,0,16,0,0
833,566,287,621,513,5,11,10,55,226,1,16,0,0
834,549,286,608,523,5,11,10,59,237,2,16,0,0
835,540,286,601,534,5,11,10,61,248,3,16,0,0
836,482,287,546,534,5,11,10,64,247,4,16,0,0
837,450,286,515,538,5,11,10,65,252,5,16,0,0
838,406,286,478,550,5,11,10,72,264,6,16,0,0
839,373,288,447,556,5,11,10,74,268,7,16,0,0
840,328,287,407,570,5,11,10,79,283,8,16,0,0
841,291,292,376,577,5,11,10,85,285,9,16,0,0
842,247,290,334,581,5,11,10,87,291,10,16,0,0
843,194,294,285,588,5,11,10,91,294,11,16,0,0
844,147,297,246,607,5,11,10,99,310,12,16,0,0
845,100,292,201,612,5,11,10,101,320,13,16,0,0
846,62,298,167,619,5,11,10,105,321,14,16,0,0
847,21,297,126,620,5,11,10,105,323,15,16,0,0
848,0,298,92,627,5,11,10,92,329,16,16,0,0
835,462,291,583,528,6,11,10,121,237,0,0,0,0
1481,154,184,189,292,7,11,10,35,108,0,74,0,0
1483,154,186,189,296,7,11,10,35,110,0,74,0,1
1484,154,188,190,300,7,11,10,36,112,1,74,0,0
1485,155,187,191,301,7,11,10,36,114,2,74,0,0
1486,156,189,192,305,7,11,10,36,116,3,74,0,0
1487,155,192,191,306,7,11,10,36,114,4,74,0,0
1488,155,193,192,310,7,11,10,37,117,5,74,0,0
1489,156,194,194,313,7,11,10,38,119,6,74,0,0
1490,156,195,194,315,7,11,10,38,120,7,74,0,0
1491,157,196,195,318,7,11,10,38,122,8,74,0,0
1492,155,197,194,320,7,11,10,39,123,9,74,0,0
1493,154,198,193,324,7,11,10,39,126,10,74,0,0
1494,154,203,194,329,7,11,10,40,126,11,74,0,0
1495,155,203,195,330,7,11,10,40,127,12,74,0,0
1496,153,207,193,333,7,11,10,40,126,13,74,0,0
1497,152,210,191,334,7,11,10,39,124,14,74,0,0
1498,152,210,192,335,7,11,10,40,125,15,74,0,0
1499,152,211,194,340,7,11,10,42,129,16,74,0,0
1500,152,209,196,344,7,11,10,44,135,17,74,0,0
1501,152,210,197,349,7,11,10,45,139,18,74,0,0
1502,152,212,196,348,7,11,10,44,136,19,74,0,0
1503,151,211,198,357,7,11,10,47,146,20,74,0,0
1504,150,212,199,363,7,11,10,49,151,21,74,0,0
1505,151,211,200,365,7,11,10,49,154,22,74,0,0
1506,150,212,201,369,7,11,10,51,157,23,74,0,0
1507,150,213,201,372,7,11,10,51,159,24,74,0,0
1508,148,212,201,378,7,11,10,53,166,25,74,0,0
1509,149,211,207,391,7,11,10,58,180,26,74,0,0
1510,154,210,213,396,7,11,10,59,186,27,74,0,0
1511,157,212,216,399,7,11,10,59,187,28,74,0,0
1512,161,218,219,402,7,11,10,58,184,29,74,0,0
1513,165,220,223,403,7,11,10,58,183,30,74,0,0
1514,170,225,230,413,7,11,10,60,188,31,74,0,0
1515,182,225,243,412,7,11,10,61,187,32,74,0,0
1516,187,223,253,423,7,11,10,66,200,33,74,0,0
1517,190,228,256,430,7,11,10,66,202,34,74,0,0
1518,192,227,260,435,7,11,10,68,208,35,74,0,0
1519,197,230,269,449,7,11,10,72,219,36,74,0,0
1520,204,227,279,456,7,11,10,75,229,37,74,0,0
1521,209,228,287,469,7,11,10,78,241,38,74,0,0
1522,213,228,291,473,7,11,10,78,245,39,74,0,0
1523,218,230,297,479,7,11,10,79,249,40,74,0,0
1524,226,234,307,491,7,11,10,81,257,41,74,0,0
1525,236,236,319,499,7,11,10,83,263,42,74,0,0
1526,245,241,329,511,7,11,10,84,270,43,74,0,0
1527,249,245,336,526,7,11,10,87,281,44,74,0,0
1528,256,242,344,530,7,11,10,88,288,45,74,0,0
1529,262,248,354,548,7,11,10,92,300,46,74,0,0
1530,272,252,366,560,7,11,10,94,308,47,74,0,0
1531,282,256,378,573,7,11,10,96,317,48,74,0,0
1532,288,265,387,592,7,11,10,99,327,49,74,0,0
1533,297,265,399,603,7,11,10,102,338,50,74,0,0
1534,312,273,417,617,7,11,10,105,344,51,74,0,0
1535,333,278,444,640,7,11,10,111,362,52,74,0,0
1536,357,282,477,667,7,11,10,120,385,53,74,0,0
1537,377,292,505,690,7,11,10,128,398,54,74,0,0
1538,395,297,527,704,7,11,10,132,407,55,74,0,0
1539,414,306,552,733,7,11,10,138,427,56,74,0,0
1540,440,319,585,761,7,11,10,145,442,57,74,0,0
1541,471,318,630,793,7,11,10,159,475,58,74,0,0
1542,497,341,666,838,7,11,10,169,497,59,74,0,0
1543,518,345,694,859,7,11,10,176,514,60,74,0,0
1544,541,363,728,915,7,11,10,187,552,61,74,0,0
1545,572,377,771,962,7,11,10,199,585,62,74,0,0
1546,632,398,847,1017,7,11,10,215,619,63,74,0,0
1547,687,429,913,1064,7,11,10,226,635,64,74,0,0
1548,731,454,957,1080,7,11,10,226,626,65,74,0,0
1549,788,481,1014,1080,7,11,10,226,599,66,74,0,0
1550,873,529,1091,1080,7,11,10,218,551,67,74,0,0
1551,1001,549,1223,1080,7,11,10,222,531,68,74,0,0
1552,1144,598,1364,1080,7,11,10,220,482,69,74,0,0
1553,1258,641,1468,1080,7,11,10,210,439,70,74,0,0
1554,1391,691,1598,1080,7,11,10,207,389,71,74,0,0
1555,1533,743,1729,1074,7,11,10,196,331,72,74,0,0
1556,1679,770,1867,1076,7,11,10,188,306,73,74,0,0
1557,1780,800,1920,1080,7,11,10,140,280,74,74,1,0
2951,159,204,194,300,8,11,10,35,96,0,19,0,1
2952,161,207,196,303,8,11,10,35,96,1,19,0,0
2953,164,206,200,306,8,11,10,36,100,2,19,0,0
2954,165,207,202,308,8,11,10,37,101,3,19,0,0
2955,165,207,204,312,8,11,10,39,105,4,19,0,0
2956,166,208,206,315,8,11,10,40,107,5,19,0,0
2957,167,209,207,317,8,11,10,40,108,6,19,0,0
2958,170,212,210,320,8,11,10,40,108,7,19,0,0
2959,173,211,214,325,8,11,10,41,114,8,19,0,0
2960,175,212,217,327,8,11,10,42,115,9,19,0,0
2961,177,215,217,326,8,11,10,40,111,10,19,0,0
2962,180,222,219,330,8,11,10,39,108,11,19,0,0
2963,187,226,224,330,8,11,10,37,104,12,19,0,0
2964,195,229,233,333,8,11,10,38,104,13,19,0,0
2965,206,227,246,334,8,11,10,40,107,14,19,0,0
2966,214,228,255,336,8,11,10,41,108,15,19,0,0
2967,222,233,261,336,8,11,10,39,103,16,19,0,0
2968,235,229,276,335,8,11,10,41,106,17,19,0,0
2969,248,230,287,334,8,11,10,39,104,18,19,0,0
2970,254,232,294,336,8,11,10,40,104,19,19,0,0
2982,106,202,141,302,9,11,10,35,100,0,37,0,0
2983,105,199,143,312,9,11,10,38,113,1,37,0,0
2984,108,199,144,308,9,11,10,36,109,2,37,0,0
2985,110,198,146,309,9,11,10,36,111,3,37,0,0
2986,110,198,147,311,9,11,10,37,113,4,37,0,0
2987,110,200,148,319,9,11,10,38,119,5,37,0,0
2988,110,200,149,321,9,11,10,39,121,6,37,0,0
2990,112,196,151,320,9,11,10,39,124,0,37,0,0
2991,113,195,153,322,9,11,10,40,127,1,37,0,0
2993,115,205,154,330,9,11,10,39,125,0,37,0,0
2994,116,206,155,332,9,11,10,39,126,1,37,0,0
2995,119,212,155,331,9,11,10,36,119,2,37,0,0
2997,121,220,156,338,9,11,10,35,118,0,37,0,0
2999,118,217,154,342,9,11,10,36,125,0,37,0,0
3000,118,221,153,346,9,11,10,35,125,1,37,0,0
3002,117,216,155,354,9,11,10,38,138,0,37,0,1
3003,118,223,155,358,9,11,10,37,135,1,37,0,0
3004,117,229,153,360,9,11,10,36,131,2,37,0,0
3005,117,228,154,363,9,11,10,37,135,3,37,0,0
3006,118,227,156,368,9,11,10,38,141,4,37,0,0
3007,119,225,158,370,9,11,10,39,145,5,37,0,0
3008,121,225,160,372,9,11,10,39,147,6,37,0,0
3009,121,227,160,376,9,11,10,39,149,7,37,0,0
3010,121,228,160,378,9,11,10,39,150,8,37,0,0
3011,121,229,162,385,9,11,10,41,156,9,37,0,0
3012,122,228,165,393,9,11,10,43,165,10,37,0,0
3013,125,226,168,392,9,11,10,43,166,11,37,0,0
3014,127,227,171,394,9,11,10,44,167,12,37,0,0
3015,129,229,172,392,9,11,10,43,163,13,37,0,0
3016,129,230,173,396,9,11,10,44,166,14,37,0,0
3017,128,231,175,407,9,11,10,47,176,15,37,0,0
3018,128,233,177,416,9,11,10,49,183,16,37,0,0
3019,129,232,179,418,9,11,10,50,186,17,37,0,0
3020,129,235,180,426,9,11,10,51,191,18,37,0,0
3021,128,236,179,429,9,11,10,51,193,19,37,0,0
3022,128,236,179,430,9,11,10,51,194,20,37,0,0
3023,126,238,180,443,9,11,10,54,205,21,37,0,0
3024,125,239,180,446,9,11,10,55,207,22,37,0,0
3025,122,235,180,456,9,11,10,58,221,23,37,0,0
3026,119,242,176,461,9,11,10,57,219,24,37,0,0
3027,114,246,170,464,9,11,10,56,218,25,37,0,0
3028,110,247,167,468,9,11,10,57,221,26,37,0,0
3029,106,251,164,479,9,11,10,58,228,27,37,0,0
3030,101,252,159,479,9,11,10,58,227,28,37,0,0
3031,94,257,154,489,9,11,10,60,232,29,37,0,0
3032,85,259,146,495,9,11,10,61,236,30,37,0,0
3033,74,256,137,498,9,11,10,63,242,31,37,0,0
3034,64,258,128,506,9,11,10,64,248,32,37,0,0
3035,54,260,120,514,9,11,10,66,254,33,37,0,0
3036,45,263,106,494,9,11,10,61,231,34,37,0,0
3037,36,267,91,469,9,11,10,55,202,35,37,0,0
3038,35,288,73,425,9,11,10,38,137,36,37,0,0
3039,30,292,66,419,9,11,10,36,127,37,37,1,0
2986,34,309,80,479,10,11,10,46,170,0,0,0,0
2987,38,317,145,627,11,11,10,107,310,0,28,0,1
2988,47,323,159,646,11,11,10,112,323,1,28,0,0
2989,42,321,157,652,11,11,10,115,331,2,28,0,0
2990,65,331,183,666,11,11,10,118,335,3,28,0,0
2991,84,340,208,694,11,11,10,124,354,4,28,0,0
2992,112,342,242,709,11,11,10,130,367,5,28,0,0
2993,143,353,278,725,11,11,10,135,372,6,28,0,0
2994,159,357,300,738,11,11,10,141,381,7,28,0,0
2995,167,357,316,758,11,11,10,149,401,8,28,0,0
2996,194,370,353,795,11,11,10,159,425,9,28,0,0
2997,221,385,384,820,11,11,10,163,435,10,28,0,0
2998,254,391,432,858,11,11,10,178,467,11,28,0,0
2999,294,413,485,900,11,11,10,191,487,12,28,0,0
3000,318,430,516,927,11,11,10,198,497,13,28,0,0
3001,350,445,557,959,11,11,10,207,514,14,28,0,0
3002,396,463,622,1015,11,11,10,226,552,15,28,0,0
3003,441,473,672,1036,11,11,10,231,563,16,28,0,0
3004,506,497,739,1066,11,11,10,233,569,17,28,0,0
3005,566,531,795,1078,11,11,10,229,547,18,28,0,0
3006,658,562,879,1079,11,11,10,221,517,19,28,0,0
3007,752,600,968,1080,11,11,10,216,480,20,28,0,0
3008,860,634,1071,1080,11,11,10,211,446,21,28,0,0
3009,988,657,1196,1079,11,11,10,208,422,22,28,0,0
3010,1125,702,1323,1080,11,11,10,198,378,23,28,0,0
3011,1258,757,1442,1080,11,11,10,184,323,24,28,0,0
3012,1384,791,1564,1080,11,11,10,180,289,25,28,0,0
3013,1469,828,1648,1077,11,11,10,179,249,26,28,0,0
3014,1588,861,1765,1078,11,11,10,177,217,27,28,0,0
3015,1692,892,1848,1080,11,11,10,156,188,28,28,1,0
3098,912,404,965,666,12,11,10,53,262,0,64,0,1
3099,909,408,966,692,12,11,10,57,284,1,64,0,0
3100,909,414,962,669,12,11,10,53,255,2,64,0,0
3101,909,417,961,664,12,11,10,52,247,3,64,0,0
3102,913,411,979,722,12,11,10,66,311,4,64,0,0
3103,886,414,959,751,12,11,10,73,337,5,64,0,0
3104,859,409,937,757,12,11,10,78,348,6,64,0,0
3105,827,405,910,764,12,11,10,83,359,7,64,0,0
3106,795,404,881,763,12,11,10,86,359,8,64,0,0
3107,767,404,855,758,12,11,10,88,354,9,64,0,0
3108,736,400,828,765,12,11,10,92,365,10,64,0,0
3109,701,398,798,767,12,11,10,97,369,11,64,0,0
3110,661,386,760,756,12,11,10,99,370,12,64,0,0
3111,622,379,723,745,12,11,10,101,366,13,64,0,0
3112,588,376,690,736,12,11,10,102,360,14,64,0,0
3113,555,366,656,715,12,11,10,101,349,15,64,0,0
3114,532,359,634,700,12,11,10,102,341,16,64,0,0
3115,512,354,615,687,12,11,10,103,333,17,64,0,0
3116,490,343,590,663,12,11,10,100,320,18,64,0,0
3117,463,344,562,653,12,11,10,99,309,19,64,0,0
3118,445,335,542,636,12,11,10,97,301,20,64,0,0
3119,437,325,531,615,12,11,10,94,290,21,64,0,0
3120,425,323,518,606,12,11,10,93,283,22,64,0,0
3121,413,316,504,592,12,11,10,91,276,23,64,0,0
3122,397,308,486,577,12,11,10,89,269,24,64,0,0
3123,383,308,471,572,12,11,10,88,264,25,64,0,0
3124,368,302,453,558,12,11,10,85,256,26,64,0,0
3125,357,295,442,546,12,11,10,85,251,27,64,0,0
3126,348,294,431,536,12,11,10,83,242,28,64,0,0
3127,331,287,412,521,12,11,10,81,234,29,64,0,0
3128,317,286,397,512,12,11,10,80,226,30,64,0,0
3129,306,285,382,499,12,11,10,76,214,31,64,0,0
3130,291,279,367,494,12,11,10,76,215,32,64,0,0
3131,283,281,358,492,12,11,10,75,211,33,64,0,0
3132,274,273,348,487,12,11,10,74,214,34,64,0,0
3133,263,269,337,480,12,11,10,74,211,35,64,0,0
3134,252,267,325,476,12,11,10,73,209,36,64,0,0
3135,244,264,313,463,12,11,10,69,199,37,64,0,0
3136,239,265,307,459,12,11,10,68,194,38,64,0,0
3137,235,263,302,455,12,11,10,67,192,39,64,0,0
3138,231,260,295,444,12,11,10,64,184,40,64,0,0
3139,225,259,286,436,12,11,10,61,177,41,64,0,0
3140,220,257,279,427,12,11,10,59,170,42,64,0,0
3141,216,255,272,417,12,11,10,56,162,43,64,0,0
3142,214,255,268,411,12,11,10,54,156,44,64,0,0
3143,208,250,264,411,12,11,10,56,161,45,64,0,0
3144,204,247,260,409,12,11,10,56,162,46,64,0,0
3145,201,245,257,407,12,11,10,56,162,47,64,0,0
3146,201,243,257,406,12,11,10,56,163,48,64,0,0
3147,202,243,258,406,12,11,10,56,163,49,64,0,0
3148,205,242,259,398,12,11,10,54,156,50,64,0,0
3149,208,240,261,392,12,11,10,53,152,51,64,0,0
3150,210,238,263,391,12,11,10,53,153,52,64,0,0
3151,212,236,264,387,12,11,10,52,151,53,64,0,0
3152,215,240,264,381,12,11,10,49,141,54,64,0,0
3153,220,239,268,379,12,11,10,48,140,55,64,0,0
3154,221,235,270,374,12,11,10,49,139,56,64,0,0
3155,223,234,270,365,12,11,10,47,131,57,64,0,0
3156,225,235,271,359,12,11,10,46,124,58,64,0,0
3157,230,234,274,355,12,11,10,44,121,59,64,0,0
3158,235,235,278,353,12,11,10,43,118,60,64,0,0
3159,239,230,283,351,12,11,10,44,121,61,64,0,0
3160,244,228,289,350,12,11,10,45,122,62,64,0,0
3161,248,225,291,346,12,11,10,43,121,63,64,0,0
3162,250,223,293,342,12,11,10,43,119,64,64,1,0
3101,817,411,999,804,13,11,10,182,393,0,78,0,1
3102,805,409,982,793,13,11,10,177,384,1,78,0,0
3103,734,407,909,785,13,11,10,175,378,2,78,0,0
3104,685,408,857,780,13,11,10,172,372,3,78,0,0
3105,638,393,810,773,13,11,10,172,380,4,78,0,0
3106,568,387,741,767,13,11,10,173,380,5,78,0,0
3107,525,375,699,761,13,11,10,174,386,6,78,0,0
3108,471,362,646,751,13,11,10,175,389,7,78,0,0
3109,437,355,607,736,13,11,10,170,381,8,78,0,0
3110,417,349,579,720,13,11,10,162,371,9,78,0,0
3111,387,345,545,710,13,11,10,158,365,10,78,0,0
3112,362,337,514,691,13,11,10,152,354,11,78,0,0
3113,333,332,481,678,13,11,10,148,346,12,78,0,0
3114,316,325,459,663,13,11,10,143,338,13,78,0,0
3115,308,318,442,640,13,11,10,134,322,14,78,0,0
3116,294,317,422,628,13,11,10,128,311,15,78,0,0
3117,278,310,401,611,13,11,10,123,301,16,78,0,0
3118,258,305,377,601,13,11,10,119,296,17,78,0,0
3119,249,299,363,591,13,11,10,114,292,18,78,0,0
3120,242,296,350,576,13,11,10,108,280,19,78,0,0
3121,235,298,337,568,13,11,10,102,270,20,78,0,0
3122,217,289,316,550,13,11,10,99,261,21,78,0,0
3123,204,286,302,544,13,11,10,98,258,22,78,0,0
3124,201,281,295,532,13,11,10,94,251,23,78,0,0
3125,197,278,286,520,13,11,10,89,242,24,78,0,0
3126,192,278,280,519,13,11,10,88,241,25,78,0,0
3127,181,277,264,504,13,11,10,83,227,26,78,0,0
3128,165,276,247,494,13,11,10,82,218,27,78,0,0
3129,161,271,243,492,13,11,10,82,221,28,78,0,0
3130,162,268,242,488,13,11,10,80,220,29,78,0,0
3131,158,267,238,485,13,11,10,80,218,30,78,0,0
3132,152,264,228,471,13,11,10,76,207,31,78,0,0
3133,142,262,220,472,13,11,10,78,210,32,78,0,0
3134,139,263,213,464,13,11,10,74,201,33,78,0,0
3135,138,258,211,458,13,11,10,73,200,34,78,0,0
3136,135,258,208,461,13,11,10,73,203,35,78,0,0
3137,129,256,199,453,13,11,10,70,197,36,78,0,0
3138,122,255,191,446,13,11,10,69,191,37,78,0,0
3139,122,252,190,442,13,11,10,68,190,38,78,0,0
3140,125,249,190,430,13,11,10,65,181,39,78,0,0
3141,124,247,189,431,13,11,10,65,184,40,78,0,0
3142,121,241,184,421,13,11,10,63,180,41,78,0,0
3143,120,241,180,411,13,11,10,60,170,42,78,0,0
3144,121,240,181,409,13,11,10,60,169,43,78,0,0
3145,123,237,183,407,13,11,10,60,170,44,78,0,0
3146,124,238,183,408,13,11,10,59,170,45,78,0,0
3147,122,236,179,400,13,11,10,57,164,46,78,0,0
3148,123,237,177,389,13,11,10,54,152,47,78,0,0
3149,125,235,178,386,13,11,10,53,151,48,78,0,0
3150,127,233,179,384,13,11,10,52,151,49,78,0,0
3151,127,234,179,384,13,11,10,52,150,50,78,0,0
3152,126,232,178,380,13,11,10,52,148,51,78,0,0
3153,128,234,177,372,13,11,10,49,138,52,78,0,0
3154,129,231,177,367,13,11,10,48,136,53,78,0,0
3155,131,231,178,365,13,11,10,47,134,54,78,0,0
3156,131,230,178,363,13,11,10,47,133,55,78,0,0
3157,132,227,179,355,13,11,10,47,128,56,78,0,0
3158,133,228,178,352,13,11,10,45,124,57,78,0,0
3159,136,226,180,349,13,11,10,44,123,58,78,0,0
3160,139,226,182,344,13,11,10,43,118,59,78,0,0
3161,141,227,182,338,13,11,10,41,111,60,78,0,0
3162,141,224,183,336,13,11,10,42,112,61,78,0,0
3163,142,224,184,335,13,11,10,42,111,62,78,0,0
3164,144,222,186,334,13,11,10,42,112,63,78,0,0
3165,146,223,187,332,13,11,10,41,109,64,78,0,0
3166,144,220,186,331,13,11,10,42,111,65,78,0,0
3167,143,221,184,329,13,11,10,41,108,66,78,0,0
3168,143,220,184,328,13,11,10,41,108,67,78,0,0
3169,142,217,183,326,13,11,10,41,109,68,78,0,0
3170,141,218,180,323,13,11,10,39,105,69,78,0,0
3171,139,214,179,321,13,11,10,40,107,70,78,0,0
3172,137,212,177,319,13,11,10,40,107,71,78,0,0
3173,135,211,174,318,13,11,10,39,107,72,78,0,0
3174,133,208,172,314,13,11,10,39,106,73,78,0,0
3175,133,209,170,310,13,11,10,37,101,74,78,0,0
3176,130,208,165,308,13,11,10,35,100,75,78,0,0
3177,128,205,163,304,13,11,10,35,99,76,78,0,0
3178,127,201,163,302,13,11,10,36,101,77,78,0,0
3179,127,201,162,298,13,11,10,35,97,78,78,1,0
3264,66,219,105,351,14,11,10,39,132,0,1,0,0
3265,83,223,122,352,14,11,10,39,129,1,1,0,0
3268,150,220,186,344,16,11,10,36,124,0,0,0,0
3269,173,210,216,350,17,11,10,43,140,0,1,0,0
3270,190,218,231,350,17,11,10,41,132,1,1,0,0
3271,218,221,260,345,18,11,10,42,124,0,3,0,0
3272,229,217,273,345,18,11,10,44,128,1,3,0,0
3273,248,219,288,336,18,11,10,40,117,2,3,0,0
3274,258,219,296,332,18,11,10,38,113,3,3,0,0
3458,582,279,634,505,19,11,10,52,226,0,42,0,1
3459,558,274,610,501,19,11,10,52,227,1,42,0,0
3460,526,273,582,506,19,11,10,56,233,2,42,0,0
3461,499,269,555,501,19,11,10,56,232,3,42,0,0
3462,459,264,519,500,19,11,10,60,236,4,42,0,0
3463,435,266,496,500,19,11,10,61,234,5,42,0,0
3464,414,262,475,492,19,11,10,61,230,6,42,0,0
3465,394,261,456,489,19,11,10,62,228,7,42,0,0
3466,373,260,434,483,19,11,10,61,223,8,42,0,0
3467,348,256,410,481,19,11,10,62,225,9,42,0,0
3468,325,255,388,479,19,11,10,63,224,10,42,0,0
3469,305,255,366,469,19,11,10,61,214,11,42,0,0
3470,293,249,355,465,19,11,10,62,216,12,42,0,0
3471,279,251,341,460,19,11,10,62,209,13,42,0,0
3472,263,246,324,454,19,11,10,61,208,14,42,0,0
3473,246,242,307,452,19,11,10,61,210,15,42,0,0
3474,235,247,295,450,19,11,10,60,203,16,42,0,0
3475,224,244,283,445,19,11,10,59,201,17,42,0,0
3476,217,241,275,437,19,11,10,58,196,18,42,0,0
3477,209,241,267,435,19,11,10,58,194,19,42,0,0
3478,197,237,254,429,19,11,10,57,192,20,42,0,0
3479,185,237,242,423,19,11,10,57,186,21,42,0,0
3480,175,237,231,421,19,11,10,56,184,22,42,0,0
3481,166,232,222,417,19,11,10,56,185,23,42,0,0
3482,162,232,218,413,19,11,10,56,181,24,42,0,0
3483,156,232,211,410,19,11,10,55,178,25,42,0,0
3484,148,233,202,406,19,11,10,54,173,26,42,0,0
3485,140,234,193,407,19,11,10,53,173,27,42,0,0
3486,133,232,184,399,19,11,10,51,167,28,42,0,0
3487,128,229,179,392,19,11,10,51,163,29,42,0,0
3488,127,230,176,385,19,11,10,49,155,30,42,0,0
3489,121,230,169,386,19,11,10,48,156,31,42,0,0
3490,115,229,162,383,19,11,10,47,154,32,42,0,0
3491,109,232,154,378,19,11,10,45,146,33,42,0,0
3492,103,232,146,372,19,11,10,43,140,34,42,0,0
3493,100,231,142,367,19,11,10,42,136,35,42,0,0
3494,95,235,136,365,19,11,10,41,130,36,42,0,0
3495,86,229,127,361,19,11,10,41,132,37,42,0,0
3496,77,224,118,359,19,11,10,41,135,38,42,0,0
3497,69,223,110,360,19,11,10,41,137,39,42,0,0
3498,60,222,100,359,19,11,10,40,137,40,42,0,0
3499,53,224,93,364,19,11,10,40,140,41,42,0,0
3500,45,223,85,362,19,11,10,40,139,42,42,1,0
4290,55,223,96,364,20,11,10,41,141,0,42,0,1
4291,61,223,99,355,20,11,10,38,132,1,42,0,0
4292,73,223,113,360,20,11,10,40,137,2,42,0,0
4293,80,225,121,365,20,11,10,41,140,3,42,0,0
4294,93,231,134,368,20,11,10,41,137,4,42,0,0
4295,103,232,143,364,20,11,10,40,132,5,42,0,0
4296,110,233,150,366,20,11,10,40,133,6,42,0,0
4297,115,229,157,370,20,11,10,42,141,7,42,0,0
4298,121,230,164,375,20,11,10,43,145,8,42,0,0
4299,128,228,174,380,20,11,10,46,152,9,42,0,0
4300,133,227,181,386,20,11,10,48,159,10,42,0,0
4301,138,229,185,385,20,11,10,47,156,11,42,0,0
4302,142,230,189,385,20,11,10,47,155,12,42,0,0
4303,145,230,194,393,20,11,10,49,163,13,42,0,0
4304,149,233,199,401,20,11,10,50,168,14,42,0,0
4305,154,231,205,404,20,11,10,51,173,15,42,0,0
4306,158,230,212,410,20,11,10,54,180,16,42,0,0
4307,162,232,217,412,20,11,10,55,180,17,42,0,0
4308,165,232,220,416,20,11,10,55,184,18,42,0,0
4309,171,234,228,421,20,11,10,57,187,19,42,0,0
4310,178,236,235,426,20,11,10,57,190,20,42,0,0
4311,187,235,246,428,20,11,10,59,193,21,42,0,0
4312,191,235,252,433,20,11,10,61,198,22,42,0,0
4313,198,240,259,437,20,11,10,61,197,23,42,0,0
4314,210,239,271,441,20,11,10,61,202,24,42,0,0
4315,221,240,284,450,20,11,10,63,210,25,42,0,0
4316,231,246,294,453,20,11,10,63,207,26,42,0,0
4317,242,243,307,459,20,11,10,65,216,27,42,0,0
4318,251,249,317,468,20,11,10,66,219,28,42,0,0
4319,269,254,332,465,20,11,10,63,211,29,42,0,0
4320,286,251,351,469,20,11,10,65,218,30,42,0,0
4321,299,254,368,474,20,11,10,69,220,31,42,0,0
4322,322,253,391,473,20,11,10,69,220,32,42,0,0
4323,346,253,415,476,20,11,10,69,223,33,42,0,0
4324,372,258,441,482,20,11,10,69,224,34,42,0,0
4325,401,261,471,487,20,11,10,70,226,35,42,0,0
4326,427,264,501,492,20,11,10,74,228,36,42,0,0
4327,447,273,523,492,20,11,10,76,219,37,42,0,0
4328,481,275,555,493,20,11,10,74,218,38,42,0,0
4329,505,280,582,498,20,11,10,77,218,39,42,0,0
4330,534,279,612,501,20,11,10,78,222,40,42,0,0
4331,563,276,641,506,20,11,10,78,230,41,42,0,0
4332,584,278,663,510,20,11,10,79,232,42,42,1,0
4541,105,168,140,239,22,11,10,35,71,0,215,0,1
4542,105,167,140,241,22,11,10,35,74,1,215,0,0
4543,105,168,140,241,22,11,10,35,73,2,215,0,0
4544,105,167,140,241,22,11,10,35,74,3,215,0,0
4545,106,166,142,242,22,11,10,36,76,4,215,0,0
4546,106,170,141,244,22,11,10,35,74,5,215,0,0
4547,106,172,142,248,22,11,10,36,76,6,215,0,0
4548,107,170,145,252,22,11,10,38,82,7,215,0,0
4549,108,168,146,253,22,11,10,38,85,8,215,0,0
4550,109,166,148,253,22,11,10,39,87,9,215,0,0
4551,110,169,147,252,22,11,10,37,83,10,215,0,0
4552,109,169,147,255,22,11,10,38,86,11,215,0,0
4553,108,168,148,258,22,11,10,40,90,12,215,0,0
4554,108,171,147,261,22,11,10,39,90,13,215,0,0
4555,109,173,147,263,22,11,10,38,90,14,215,0,0
4556,109,173,147,262,22,11,10,38,89,15,215,0,0
4557,109,175,146,263,22,11,10,37,88,16,215,0,0
4558,108,173,146,265,22,11,10,38,92,17,215,0,0
4559,109,174,146,266,22,11,10,37,92,18,215,0,0
4560,108,173,147,266,22,11,10,39,93,19,215,0,0
4561,108,173,147,266,22,11,10,39,93,20,215,0,0
4562,109,173,148,269,22,11,10,39,96,21,215,0,0
4563,109,175,148,271,22,11,10,39,96,22,215,0,0
4564,110,177,147,271,22,11,10,37,94,23,215,0,0
4565,110,177,148,274,22,11,10,38,97,24,215,0,0
4566,110,174,149,273,22,11,10,39,99,25,215,0,0
4567,110,176,148,274,22,11,10,38,98,26,215,0,0
4568,110,177,148,276,22,11,10,38,99,27,215,0,0
4569,110,178,147,278,22,11,10,37,100,28,215,0,0
4570,111,177,149,279,22,11,10,38,102,29,215,0,0
4571,111,173,150,282,22,11,10,39,109,30,215,0,0
4572,111,174,150,281,22,11,10,39,107,31,215,0,0
4573,111,174,150,285,22,11,10,39,111,32,215,0,0
4574,110,173,150,287,22,11,10,40,114,33,215,0,0
4575,111,174,150,287,22,11,10,39,113,34,215,0,0
4576,111,170,152,290,22,11,10,41,120,35,215,0,0
4577,111,168,153,293,22,11,10,42,125,36,215,0,0
4578,112,171,153,294,22,11,10,41,123,37,215,0,0
4579,111,171,152,297,22,11,10,41,126,38,215,0,0
4580,110,170,152,299,22,11,10,42,129,39,215,0,0
4581,110,172,151,301,22,11,10,41,129,40,215,0,0
4582,109,171,152,304,22,11,10,43,133,41,215,0,0
4583,110,173,152,306,22,11,10,42,133,42,215,0,0
4584,110,176,152,308,22,11,10,42,132,43,215,0,0
4585,109,178,151,310,22,11,10,42,132,44,215,0,0
4586,110,180,151,308,22,11,10,41,128,45,215,0,0
4587,111,180,153,310,22,11,10,42,130,46,215,0,0
4588,111,181,154,314,22,11,10,43,133,47,215,0,0
4589,112,182,154,314,22,11,10,42,132,48,215,0,0
4590,113,183,155,318,22,11,10,42,135,49,215,0,0
4591,113,182,158,322,22,11,10,45,140,50,215,0,0
4592,114,183,157,316,22,11,10,43,133,51,215,0,0
4593,115,183,158,318,22,11,10,43,135,52,215,0,0
4594,117,184,161,323,22,11,10,44,139,53,215,0,0
4595,118,185,163,326,22,11,10,45,141,54,215,0,0
4596,119,186,165,332,22,11,10,46,146,55,215,0,0
4597,121,185,167,334,22,11,10,46,149,56,215,0,0
4598,123,187,170,338,22,11,10,47,151,57,215,0,0
4599,124,188,173,346,22,11,10,49,158,58,215,0,0
4600,127,191,176,349,22,11,10,49,158,59,215,0,0
4601,128,195,179,355,22,11,10,51,160,60,215,0,0
4602,129,194,181,361,22,11,10,52,167,61,215,0,0
4603,130,194,182,360,22,11,10,52,166,62,215,0,0
4604,131,196,183,361,22,11,10,52,165,63,215,0,0
4605,129,199,183,370,22,11,10,54,171,64,215,0,0
4606,130,202,183,370,22,11,10,53,168,65,215,0,0
4607,129,203,184,379,22,11,10,55,176,66,215,0,0
4608,130,206,185,385,22,11,10,55,179,67,215,0,0
4609,129,210,184,386,22,11,10,55,176,68,215,0,0
4610,129,213,182,380,22,11,10,53,167,69,215,0,0
4611,131,213,185,383,22,11,10,54,170,70,215,0,0
4612,130,210,188,391,22,11,10,58,181,71,215,0,0
4613,131,207,193,400,22,11,10,62,193,72,215,0,0
4614,134,215,195,404,22,11,10,61,189,73,215,0,0
4615,133,214,195,406,22,11,10,62,192,74,215,0,0
4616,133,211,198,415,22,11,10,65,204,75,215,0,0
4617,135,219,199,421,22,11,10,64,202,76,215,0,0
4618,136,216,202,425,22,11,10,66,209,77,215,0,0
4619,140,221,206,430,22,11,10,66,209,78,215,0,0
4620,143,219,212,440,22,11,10,69,221,79,215,0,0
4621,145,220,216,445,22,11,10,71,225,80,215,0,0
4622,149,226,219,450,22,11,10,70,224,81,215,0,0
4623,153,228,224,457,22,11,10,71,229,82,215,0,0
4624,157,228,229,459,22,11,10,72,231,83,215,0,0
4625,159,231,233,466,22,11,10,74,235,84,215,0,0
4626,160,235,235,475,22,11,10,75,240,85,215,0,0
4627,161,236,237,475,22,11,10,76,239,86,215,0,0
4628,165,238,242,484,22,11,10,77,246,87,215,0,0
4629,168,238,247,491,22,11,10,79,253,88,215,0,0
4630,171,238,252,499,22,11,10,81,261,89,215,0,0
4631,173,239,256,509,22,11,10,83,270,90,215,0,0
4632,176,241,260,515,22,11,10,84,274,91,215,0,0
4633,181,244,264,518,22,11,10,83,274,92,215,0,0
4634,188,252,275,537,22,11,10,87,285,93,215,0,0
4635,197,256,285,544,22,11,10,88,288,94,215,0,0
4636,207,258,296,553,22,11,10,89,295,95,215,0,0
4637,217,267,308,565,22,11,10,91,298,96,215,0,0
4638,225,268,320,582,22,11,10,95,314,97,215,0,0
4639,239,268,336,585,22,11,10,97,317,98,215,0,0
4640,256,279,356,606,22,11,10,100,327,99,215,0,0
4641,272,278,376,617,22,11,10,104,339,100,215,0,0
4642,291,281,397,625,22,11,10,106,344,101,215,0,0
4643,307,291,417,640,22,11,10,110,349,102,215,0,0
4644,327,292,439,650,22,11,10,112,358,103,215,0,0
4645,348,293,466,670,22,11,10,118,377,104,215,0,0
4646,367,300,492,693,22,11,10,125,393,105,215,0,0
4647,385,303,515,708,22,11,10,130,405,106,215,0,0
4648,408,305,543,723,22,11,10,135,418,107,215,0,0
4649,425,328,564,746,22,11,10,139,418,108,215,0,0
4650,450,336,593,768,22,11,10,143,432,109,215,0,0
4651,487,338,632,778,22,11,10,145,440,110,215,0,0
4652,523,346,676,805,22,11,10,153,459,111,215,0,0
4653,549,360,709,825,22,11,10,160,465,112,215,0,0
4654,607,367,772,831,22,11,10,165,464,113,215,0,0
4655,657,370,840,871,22,11,10,183,501,114,215,0,0
4656,701,394,899,898,22,11,10,198,504,115,215,0,0
4657,711,407,925,911,22,11,10,214,504,116,215,0,0
4658,712,412,942,914,22,11,10,230,502,117,215,0,0
4659,699,414,944,918,22,11,10,245,504,118,215,0,0
4660,689,412,958,933,22,11,10,269,521,119,215,0,0
4661,679,406,971,950,22,11,10,292,544,120,215,0,0
4662,677,404,984,961,22,11,10,307,557,121,215,0,0
4663,673,402,990,964,22,11,10,317,562,122,215,0,0
4664,670,402,994,965,22,11,10,324,563,123,215,0,0
4665,667,404,996,965,22,11,10,329,561,124,215,0,0
4666,667,406,1001,967,22,11,10,334,561,125,215,0,0
4667,666,407,1005,967,22,11,10,339,560,126,215,0,0
4668,666,409,1008,967,22,11,10,342,558,127,215,0,0
4669,665,410,1009,966,22,11,10,344,556,128,215,0,0
4670,663,409,1011,966,22,11,10,348,557,129,215,0,0
4671,660,407,1012,964,22,11,10,352,557,130,215,0,0
4672,658,406,1012,964,22,11,10,354,558,131,215,0,0
4673,654,404,1011,964,22,11,10,357,560,132,215,0,0
4674,651,401,1010,960,22,11,10,359,559,133,215,0,0
4675,652,404,1012,962,22,11,10,360,558,134,215,0,0
4676,645,399,1010,960,22,11,10,365,561,135,215,0,0
4677,649,405,1012,962,22,11,10,363,557,136,215,0,0
4678,651,407,1013,962,22,11,10,362,555,137,215,0,0
4679,652,411,1013,961,22,11,10,361,550,138,215,0,0
4680,655,414,1014,961,22,11,10,359,547,139,215,0,0
4681,661,418,1017,961,22,11,10,356,543,140,215,0,0
4682,667,418,1020,956,22,11,10,353,538,141,215,0,0
4683,671,419,1021,953,22,11,10,350,534,142,215,0,0
4684,673,419,1022,951,22,11,10,349,532,143,215,0,0
4685,676,416,1026,955,22,11,10,350,539,144,215,0,0
4686,677,414,1028,958,22,11,10,351,544,145,215,0,0
4687,673,412,1024,959,22,11,10,351,547,146,215,0,0
4688,667,411,1019,959,22,11,10,352,548,147,215,0,0
4689,654,407,1011,958,22,11,10,357,551,148,215,0,0
4690,649,404,1010,958,22,11,10,361,554,149,215,0,0
4691,648,405,1010,957,22,11,10,362,552,150,215,0,0
4692,647,405,1011,958,22,11,10,364,553,151,215,0,0
4693,646,405,1012,957,22,11,10,366,552,152,215,0,0
4694,647,406,1013,957,22,11,10,366,551,153,215,0,0
4695,646,406,1014,957,22,11,10,368,551,154,215,0,0
4696,650,410,1016,959,22,11,10,366,549,155,215,0,0
4697,652,412,1017,960,22,11,10,365,548,156,215,0,0
4698,655,412,1019,960,22,11,10,364,548,157,215,0,0
4699,657,413,1020,959,22,11,10,363,546,158,215,0,0
4700,656,413,1018,959,22,11,10,362,546,159,215,0,0
4701,659,412,1021,959,22,11,10,362,547,160,215,0,0
4702,659,412,1020,958,22,11,10,361,546,161,215,0,0
4703,660,412,1020,958,22,11,10,360,546,162,215,0,0
4704,661,413,1020,958,22,11,10,359,545,163,215,0,0
4705,662,413,1020,958,22,11,10,358,545,164,215,0,0
4706,663,412,1021,959,22,11,10,358,547,165,215,0,0
4707,663,412,1020,959,22,11,10,357,547,166,215,0,0
4708,663,412,1020,960,22,11,10,357,548,167,215,0,0
4709,663,412,1019,960,22,11,10,356,548,168,215,0,0
4710,663,412,1019,961,22,11,10,356,549,169,215,0,0
4711,665,412,1018,959,22,11,10,353,547,170,215,0,0
4712,663,412,1017,959,22,11,10,354,547,171,215,0,0
4713,662,412,1015,959,22,11,10,353,547,172,215,0,0
4714,661,412,1015,958,22,11,10,354,546,173,215,0,0
4715,661,412,1015,958,22,11,10,354,546,174,215,0,0
4716,661,412,1015,959,22,11,10,354,547,175,215,0,0
4717,661,412,1015,959,22,11,10,354,547,176,215,0,0
4718,661,412,1015,959,22,11,10,354,547,177,215,0,0
4719,662,412,1016,960,22,11,10,354,548,178,215,0,0
4720,662,412,1015,960,22,11,10,353,548,179,215,0,0
4721,663,412,1015,960,22,11,10,352,548,180,215,0,0
4722,664,411,1016,960,22,11,10,352,549,181,215,0,0
4723,664,410,1017,960,22,11,10,353,550,182,215,0,0
4724,663,408,1015,958,22,11,10,352,550,183,215,0,0
4725,664,409,1015,958,22,11,10,351,549,184,215,0,0
4726,670,411,1016,956,22,11,10,346,545,185,215,0,0
4727,674,413,1017,955,22,11,10,343,542,186,215,0,0
4728,674,416,1017,953,22,11,10,343,537,187,215,0,0
4729,675,417,1017,953,22,11,10,342,536,188,215,0,0
4730,677,418,1019,951,22,11,10,342,533,189,215,0,0
4731,679,420,1022,956,22,11,10,343,536,190,215,0,0
4732,679,417,1024,958,22,11,10,345,541,191,215,0,0
4733,677,414,1023,959,22,11,10,346,545,192,215,0,0
4734,676,414,1021,959,22,11,10,345,545,193,215,0,0
4735,676,414,1020,959,22,11,10,344,545,194,215,0,0
4736,676,413,1020,960,22,11,10,344,547,195,215,0,0
4737,675,410,1019,958,22,11,10,344,548,196,215,0,0
4738,675,408,1020,958,22,11,10,345,550,197,215,0,0
4739,678,407,1022,960,22,11,10,344,553,198,215,0,0
4740,679,406,1023,962,22,11,10,344,556,199,215,0,0
4741,680,405,1023,961,22,11,10,343,556,200,215,0,0
4742,682,404,1021,956,22,11,10,339,552,201,215,0,0
4743,690,404,1018,938,22,11,10,328,534,202,215,0,0
4744,700,400,1023,930,22,11,10,323,530,203,215,0,0
4745,701,402,1017,927,22,11,10,316,525,204,215,0,0
4746,704,403,1014,924,22,11,10,310,521,205,215,0,0
4747,700,395,991,903,22,11,10,291,508,206,215,0,0
4748,712,384,984,879,22,11,10,272,495,207,215,0,0
4749,725,385,984,871,22,11,10,259,486,208,215,0,0
4750,751,385,996,858,22,11,10,245,473,209,215,0,0
4751,785,384,1017,849,22,11,10,232,465,210,215,0,0
4752,807,384,1028,845,22,11,10,221,461,211,215,0,0
4753,832,379,1035,817,22,11,10,203,438,212,215,0,0
4754,851,378,1042,801,22,11,10,191,423,213,215,0,0
4755,859,387,1042,803,22,11,10,183,416,214,215,0,0
4756,869,386,1048,793,22,11,10,179,407,215,215,1,0
4607,111,204,147,292,23,11,10,36,88,0,149,0,0
4615,114,209,158,321,23,11,10,44,112,0,149,0,1
4616,114,210,159,327,23,11,10,45,117,1,149,0,0
4617,117,207,160,320,23,11,10,43,113,2,149,0,0
4618,118,207,161,327,23,11,10,43,120,3,149,0,0
4619,119,206,161,328,23,11,10,42,122,4,149,0,0
4620,122,210,162,328,23,11,10,40,118,5,149,0,0
4621,124,213,161,326,23,11,10,37,113,6,149,0,0
4622,127,217,163,326,23,11,10,36,109,7,149,0,0
4623,128,217,165,331,23,11,10,37,114,8,149,0,0
4624,130,223,165,333,23,11,10,35,110,9,149,0,0
4625,131,223,167,336,23,11,10,36,113,10,149,0,0
4626,133,223,170,337,23,11,10,37,114,11,149,0,0
4627,136,223,173,337,23,11,10,37,114,12,149,0,0
4628,138,226,176,344,23,11,10,38,118,13,149,0,0
4629,139,229,177,346,23,11,10,38,117,14,149,0,0
4630,140,227,178,346,23,11,10,38,119,15,149,0,0
4631,142,225,184,354,23,11,10,42,129,16,149,0,0
4632,145,228,187,357,23,11,10,42,129,17,149,0,0
4633,150,227,193,358,23,11,10,43,131,18,149,0,0
4634,152,228,196,365,23,11,10,44,137,19,149,0,0
4635,154,229,197,364,23,11,10,43,135,20,149,0,0
4636,154,229,198,369,23,11,10,44,140,21,149,0,0
4637,154,231,199,371,23,11,10,45,140,22,149,0,0
4638,157,230,202,370,23,11,10,45,140,23,149,0,0
4639,159,230,204,371,23,11,10,45,141,24,149,0,0
4640,160,234,205,376,23,11,10,45,142,25,149,0,0
4641,161,232,207,378,23,11,10,46,146,26,149,0,0
4642,162,231,211,384,23,11,10,49,153,27,149,0,0
4643,162,223,216,392,23,11,10,54,169,28,149,0,0
4644,163,223,219,400,23,11,10,56,177,29,149,0,0
4645,166,220,222,402,23,11,10,56,182,30,149,0,0
4646,168,231,222,404,23,11,10,54,173,31,149,0,0
4647,169,232,222,406,23,11,10,53,174,32,149,0,0
4648,169,231,223,411,23,11,10,54,180,33,149,0,0
4649,172,232,226,413,23,11,10,54,181,34,149,0,0
4650,175,232,233,420,23,11,10,58,188,35,149,0,0
4651,178,236,237,426,23,11,10,59,190,36,149,0,0
4652,177,236,237,429,23,11,10,60,193,37,149,0,0
4653,177,237,240,439,23,11,10,63,202,38,149,0,0
4654,181,241,245,445,23,11,10,64,204,39,149,0,0
4655,184,243,249,452,23,11,10,65,209,40,149,0,0
4656,188,247,254,452,23,11,10,66,205,41,149,0,0
4657,188,247,258,468,23,11,10,70,221,42,149,0,0
4658,188,248,258,469,23,11,10,70,221,43,149,0,0
4659,186,243,259,474,23,11,10,73,231,44,149,0,0
4660,185,239,260,477,23,11,10,75,238,45,149,0,0
4661,188,244,263,480,23,11,10,75,236,46,149,0,0
4662,193,252,268,488,23,11,10,75,236,47,149,0,0
4663,196,253,272,495,23,11,10,76,242,48,149,0,0
4664,194,247,273,498,23,11,10,79,251,49,149,0,0
4665,195,248,277,504,23,11,10,82,256,50,149,0,0
4666,205,268,281,510,23,11,10,76,242,51,149,0,0
4667,212,276,288,515,23,11,10,76,239,52,149,0,0
4668,218,291,294,521,23,11,10,76,230,53,149,0,0
4669,214,286,295,531,23,11,10,81,245,54,149,0,0
4670,208,272,296,541,23,11,10,88,269,55,149,0,0
4671,214,289,298,551,23,11,10,84,262,56,149,0,0
4672,220,296,304,556,23,11,10,84,260,57,149,0,0
4673,227,293,317,569,23,11,10,90,276,58,149,0,0
4674,231,294,326,582,23,11,10,95,288,59,149,0,0
4675,231,288,329,586,23,11,10,98,298,60,149,0,0
4676,229,278,333,597,23,11,10,104,319,61,149,0,0
4677,232,294,333,608,23,11,10,101,314,62,149,0,0
4678,241,311,339,617,23,11,10,98,306,63,149,0,0
4679,253,318,355,627,23,11,10,102,309,64,149,0,0
4680,254,332,355,639,23,11,10,101,307,65,149,0,0
4681,248,298,360,640,23,11,10,112,342,66,149,0,0
4682,249,296,367,660,23,11,10,118,364,67,149,0,0
4683,253,308,375,685,23,11,10,122,377,68,149,0,0
4684,263,319,382,691,23,11,10,119,372,69,149,0,0
4685,270,311,393,696,23,11,10,123,385,70,149,0,0
4686,278,302,407,714,23,11,10,129,412,71,149,0,0
4687,294,323,417,721,23,11,10,123,398,72,149,0,0
4688,311,341,429,727,23,11,10,118,386,73,149,0,0
4689,324,343,443,736,23,11,10,119,393,74,149,0,0
4690,349,354,473,754,23,11,10,124,400,75,149,0,0
4691,362,365,490,766,23,11,10,128,401,76,149,0,0
4692,382,368,510,767,23,11,10,128,399,77,149,0,0
4693,397,366,530,783,23,11,10,133,417,78,149,0,0
4694,414,376,548,798,23,11,10,134,422,79,149,0,0
4695,430,380,563,805,23,11,10,133,425,80,149,0,0
4696,441,382,571,808,23,11,10,130,426,81,149,0,0
4697,457,392,584,812,23,11,10,127,420,82,149,0,0
4698,477,399,610,825,23,11,10,133,426,83,149,0,0
4699,491,406,626,834,23,11,10,135,428,84,149,0,0
4700,504,408,639,836,23,11,10,135,428,85,149,0,0
4701,521,410,658,842,23,11,10,137,432,86,149,0,0
4702,532,411,673,861,23,11,10,141,450,87,149,0,0
4703,533,415,675,871,23,11,10,142,456,88,149,0,0
4704,527,415,670,883,23,11,10,143,468,89,149,0,0
4705,521,418,661,886,23,11,10,140,468,90,149,0,0
4706,519,423,656,887,23,11,10,137,464,91,149,0,0
4707,516,429,650,888,23,11,10,134,459,92,149,0,0
4708,513,430,645,889,23,11,10,132,459,93,149,0,0
4709,512,430,642,890,23,11,10,130,460,94,149,0,0
4710,511,432,640,890,23,11,10,129,458,95,149,0,0
4711,509,429,638,888,23,11,10,129,459,96,149,0,0
4712,506,428,635,889,23,11,10,129,461,97,149,0,0
4713,506,426,634,888,23,11,10,128,462,98,149,0,0
4714,507,418,635,882,23,11,10,128,464,99,149,0,0
4715,509,420,636,885,23,11,10,127,465,100,149,0,0
4716,511,419,638,886,23,11,10,127,467,101,149,0,0
4717,512,419,639,887,23,11,10,127,468,102,149,0,0
4718,514,421,640,885,23,11,10,126,464,103,149,0,0
4719,514,420,640,885,23,11,10,126,465,104,149,0,0
4720,514,421,639,883,23,11,10,125,462,105,149,0,0
4721,515,421,638,881,23,11,10,123,460,106,149,0,0
4722,517,421,640,882,23,11,10,123,461,107,149,0,0
4723,517,426,639,884,23,11,10,122,458,108,149,0,0
4724,515,422,637,885,23,11,10,122,463,109,149,0,0
4725,517,424,637,881,23,11,10,120,457,110,149,0,0
4726,519,427,637,878,23,11,10,118,451,111,149,0,0
4727,516,422,635,880,23,11,10,119,458,112,149,0,0
4728,524,425,643,878,23,11,10,119,453,113,149,0,0
4729,519,423,639,880,23,11,10,120,457,114,149,0,0
4730,510,427,630,881,23,11,10,120,454,115,149,0,0
4731,511,431,630,879,23,11,10,119,448,116,149,0,0
4732,511,432,630,879,23,11,10,119,447,117,149,0,0
4733,506,434,627,881,23,11,10,121,447,118,149,0,0
4734,504,437,626,881,23,11,10,122,444,119,149,0,0
4735,504,436,627,880,23,11,10,123,444,120,149,0,0
4736,505,437,628,880,23,11,10,123,443,121,149,0,0
4737,505,432,630,881,23,11,10,125,449,122,149,0,0
4738,505,434,630,881,23,11,10,125,447,123,149,0,0
4739,505,434,631,881,23,11,10,126,447,124,149,0,0
4740,502,432,629,883,23,11,10,127,451,125,149,0,0
4741,503,432,630,882,23,11,10,127,450,126,149,0,0
4742,505,433,630,881,23,11,10,125,448,127,149,0,0
4743,503,433,629,881,23,11,10,126,448,128,149,0,0
4744,502,433,629,881,23,11,10,127,448,129,149,0,0
4745,501,432,629,881,23,11,10,128,449,130,149,0,0
4746,503,436,631,879,23,11,10,128,443,131,149,0,0
4747,508,434,638,881,23,11,10,130,447,132,149,0,0
4748,522,433,652,879,23,11,10,130,446,133,149,0,0
4749,536,433,668,877,23,11,10,132,444,134,149,0,0
4750,547,435,682,877,23,11,10,135,442,135,149,0,0
4751,569,425,709,874,23,11,10,140,449,136,149,0,0
4752,600,421,740,870,23,11,10,140,449,137,149,0,0
4753,632,425,774,865,23,11,10,142,440,138,149,0,0
4754,653,435,796,858,23,11,10,143,423,139,149,0,0
4755,685,436,828,850,23,11,10,143,414,140,149,0,0
4756,727,434,868,847,23,11,10,141,413,141,149,0,0
4757,751,438,891,845,23,11,10,140,407,142,149,0,0
4758,773,430,919,845,23,11,10,146,415,143,149,0,0
4759,804,420,947,829,23,11,10,143,409,144,149,0,0
4760,827,407,971,824,23,11,10,144,417,145,149,0,0
4761,843,410,982,816,23,11,10,139,406,146,149,0,0
4762,856,413,994,813,23,11,10,138,400,147,149,0,0
4763,870,419,1004,806,23,11,10,134,387,148,149,0,0
4764,889,418,1022,801,23,11,10,133,383,149,149,1,0
4770,930,378,1037,706,23,11,10,107,328,0,149,0,0
4771,942,374,1047,695,23,11,10,105,321,1,149,0,0
4634,180,239,218,370,26,11,10,38,131,0,123,0,0
4636,189,245,234,400,26,11,10,45,155,0,123,0,1
4637,191,246,242,423,26,11,10,51,177,1,123,0,0
4638,192,249,247,440,26,11,10,55,191,2,123,0,0
4639,193,253,253,458,26,11,10,60,205,3,123,0,0
4640,193,250,256,464,26,11,10,63,214,4,123,0,0
4641,196,253,259,466,26,11,10,63,213,5,123,0,0
4642,203,253,266,469,26,11,10,63,216,6,123,0,0
4643,206,256,271,475,26,11,10,65,219,7,123,0,0
4644,209,262,272,477,26,11,10,63,215,8,123,0,0
4645,210,262,275,484,26,11,10,65,222,9,123,0,0
4646,213,263,280,491,26,11,10,67,228,10,123,0,0
4647,217,270,284,496,26,11,10,67,226,11,123,0,0
4648,222,271,290,498,26,11,10,68,227,12,123,0,0
4649,225,277,293,502,26,11,10,68,225,13,123,0,0
4650,224,280,295,515,26,11,10,71,235,14,123,0,0
4651,228,281,299,515,26,11,10,71,234,15,123,0,0
4652,227,284,301,523,26,11,10,74,239,16,123,0,0
4653,231,287,308,535,26,11,10,77,248,17,123,0,0
4654,236,287,314,539,26,11,10,78,252,18,123,0,0
4655,239,292,321,560,26,11,10,82,268,19,123,0,0
4656,238,299,321,568,26,11,10,83,269,20,123,0,0
4657,241,302,327,579,26,11,10,86,277,21,123,0,0
4658,246,308,337,599,26,11,10,91,291,22,123,0,0
4659,253,310,346,604,26,11,10,93,294,23,123,0,0
4660,263,312,360,617,26,11,10,97,305,24,123,0,0
4661,275,319,374,631,26,11,10,99,312,25,123,0,0
4662,286,321,390,649,26,11,10,104,328,26,123,0,0
4663,296,324,403,658,26,11,10,107,334,27,123,0,0
4664,309,332,422,685,26,11,10,113,353,28,123,0,0
4665,334,335,452,697,26,11,10,118,362,29,123,0,0
4666,371,337,496,708,26,11,10,125,371,30,123,0,0
4667,391,345,516,709,26,11,10,125,364,31,123,0,0
4668,415,349,542,718,26,11,10,127,369,32,123,0,0
4669,457,353,583,720,26,11,10,126,367,33,123,0,0
4670,491,356,618,720,26,11,10,127,364,34,123,0,0
4671,509,356,641,723,26,11,10,132,367,35,123,0,0
4672,536,350,670,723,26,11,10,134,373,36,123,0,0
4673,558,346,695,723,26,11,10,137,377,37,123,0,0
4674,579,347,713,719,26,11,10,134,372,38,123,0,0
4675,591,350,725,726,26,11,10,134,376,39,123,0,0
4676,596,354,729,735,26,11,10,133,381,40,123,0,0
4677,601,357,730,736,26,11,10,129,379,41,123,0,0
4678,615,360,740,727,26,11,10,125,367,42,123,0,0
4679,624,369,745,717,26,11,10,121,348,43,123,0,0
4680,618,368,740,721,26,11,10,122,353,44,123,0,0
4681,616,372,736,722,26,11,10,120,350,45,123,0,0
4682,613,374,733,723,26,11,10,120,349,46,123,0,0
4683,611,375,731,728,26,11,10,120,353,47,123,0,0
4684,610,375,729,729,26,11,10,119,354,48,123,0,0
4685,607,374,726,731,26,11,10,119,357,49,123,0,0
4686,604,372,723,730,26,11,10,119,358,50,123,0,0
4687,604,373,723,735,26,11,10,119,362,51,123,0,0
4688,604,374,720,728,26,11,10,116,354,52,123,0,0
4689,604,378,717,723,26,11,10,113,345,53,123,0,0
4690,602,376,716,724,26,11,10,114,348,54,123,0,0
4691,601,375,715,726,26,11,10,114,351,55,123,0,0
4692,601,374,714,726,26,11,10,113,352,56,123,0,0
4693,599,374,712,725,26,11,10,113,351,57,123,0,0
4694,598,374,712,727,26,11,10,114,353,58,123,0,0
4695,598,374,711,730,26,11,10,113,356,59,123,0,0
4696,597,378,709,734,26,11,10,112,356,60,123,0,0
4697,596,377,708,736,26,11,10,112,359,61,123,0,0
4698,596,380,708,739,26,11,10,112,359,62,123,0,0
4699,598,381,707,733,26,11,10,109,352,63,123,0,0
4700,607,379,709,714,26,11,10,102,335,64,123,0,0
4701,616,378,711,692,26,11,10,95,314,65,123,0,0
4702,620,379,712,690,26,11,10,92,311,66,123,0,0
4703,621,373,714,692,26,11,10,93,319,67,123,0,0
4704,617,377,711,700,26,11,10,94,323,68,123,0,0
4705,609,382,706,714,26,11,10,97,332,69,123,0,0
4706,605,383,703,718,26,11,10,98,335,70,123,0,0
4707,603,383,701,717,26,11,10,98,334,71,123,0,0
4708,598,379,702,728,26,11,10,104,349,72,123,0,0
4709,598,377,703,727,26,11,10,105,350,73,123,0,0
4710,598,377,703,726,26,11,10,105,349,74,123,0,0
4711,597,376,704,729,26,11,10,107,353,75,123,0,0
4712,596,381,705,740,26,11,10,109,359,76,123,0,0
4713,600,382,704,722,26,11,10,104,340,77,123,0,0
4714,600,382,704,719,26,11,10,104,337,78,123,0,0
4715,601,382,703,714,26,11,10,102,332,79,123,0,0
4716,596,378,704,731,26,11,10,108,353,80,123,0,0
4717,595,378,705,741,26,11,10,110,363,81,123,0,0
4718,598,382,705,740,26,11,10,107,358,82,123,0,0
4719,601,385,704,724,26,11,10,103,339,83,123,0,0
4720,603,387,702,717,26,11,10,99,330,84,123,0,0
4721,602,386,704,725,26,11,10,102,339,85,123,0,0
4722,600,385,703,726,26,11,10,103,341,86,123,0,0
4723,596,385,703,734,26,11,10,107,349,87,123,0,0
4724,595,383,704,741,26,11,10,109,358,88,123,0,0
4725,594,384,701,736,26,11,10,107,352,89,123,0,0
4726,593,381,699,725,26,11,10,106,344,90,123,0,0
4727,596,379,702,727,26,11,10,106,348,91,123,0,0
4728,603,378,704,710,26,11,10,101,332,92,123,0,0
4729,604,382,704,707,26,11,10,100,325,93,123,0,0
4730,603,377,706,713,26,11,10,103,336,94,123,0,0
4731,603,376,707,718,26,11,10,104,342,95,123,0,0
4732,603,376,707,719,26,11,10,104,343,96,123,0,0
4733,603,376,708,721,26,11,10,105,345,97,123,0,0
4734,604,375,710,723,26,11,10,106,348,98,123,0,0
4735,605,375,711,724,26,11,10,106,349,99,123,0,0
4736,604,375,711,728,26,11,10,107,353,100,123,0,0
4737,602,374,710,727,26,11,10,108,353,101,123,0,0
4738,602,374,710,727,26,11,10,108,353,102,123,0,0
4739,602,374,709,725,26,11,10,107,351,103,123,0,0
4740,603,376,710,725,26,11,10,107,349,104,123,0,0
4741,604,376,712,725,26,11,10,108,349,105,123,0,0
4742,604,378,712,724,26,11,10,108,346,106,123,0,0
4743,606,378,714,720,26,11,10,108,342,107,123,0,0
4744,607,377,717,720,26,11,10,110,343,108,123,0,0
4745,611,376,721,715,26,11,10,110,339,109,123,0,0
4746,618,376,731,720,26,11,10,113,344,110,123,0,0
4747,624,375,743,731,26,11,10,119,356,111,123,0,0
4748,638,379,760,737,26,11,10,122,358,112,123,0,0
4749,659,387,780,739,26,11,10,121,352,113,123,0,0
4750,679,390,802,749,26,11,10,123,359,114,123,0,0
4751,699,394,824,757,26,11,10,125,363,115,123,0,0
4752,727,398,852,759,26,11,10,125,361,116,123,0,0
4753,759,398,882,757,26,11,10,123,359,117,123,0,0
4754,783,398,906,765,26,11,10,123,367,118,123,0,0
4755,806,405,927,768,26,11,10,121,363,119,123,0,0
4756,834,400,954,768,26,11,10,120,368,120,123,0,0
4757,852,394,965,746,26,11,10,113,352,121,123,0,0
4758,872,400,965,696,26,11,10,93,296,122,123,0,0
4759,888,402,980,690,26,11,10,92,288,123,123,1,0
4763,912,382,982,601,26,11,10,70,219,0,123,0,0
4764,935,380,985,521,26,11,10,50,141,1,123,0,0
4765,949,378,992,499,26,11,10,43,121,2,123,0,0
4655,173,234,217,318,27,11,10,44,84,0,0,0,0
4663,194,237,263,330,28,11,10,69,93,0,0,0,0
4666,190,237,253,397,29,11,10,63,160,0,100,0,1
4667,192,238,255,400,29,11,10,63,162,1,100,0,0
4668,198,246,259,401,29,11,10,61,155,2,100,0,0
4669,209,243,262,376,29,11,10,53,133,3,100,0,0
4670,217,249,262,359,29,11,10,45,110,4,100,0,0
4671,212,250,268,386,29,11,10,56,136,5,100,0,0
4672,205,249,274,416,29,11,10,69,167,6,100,0,0
4673,203,254,280,446,29,11,10,77,192,7,100,0,0
4674,213,251,286,429,29,11,10,73,178,8,100,0,0
4675,227,253,291,407,29,11,10,64,154,9,100,0,0
4676,230,254,295,411,29,11,10,65,157,10,100,0,0
4677,235,263,293,396,29,11,10,58,133,11,100,0,0
4678,235,264,299,410,29,11,10,64,146,12,100,0,0
4679,240,268,306,417,29,11,10,66,149,13,100,0,0
4680,253,272,316,411,29,11,10,63,139,14,100,0,0
4681,277,276,330,388,29,11,10,53,112,15,100,0,0
4682,287,282,333,375,29,11,10,46,93,16,100,0,0
4683,293,288,341,382,29,11,10,48,94,17,100,0,0
4684,299,289,353,393,29,11,10,54,104,18,100,0,0
4685,307,293,360,394,29,11,10,53,101,19,100,0,0
4688,343,303,407,420,29,11,10,64,117,0,100,0,1
4689,351,309,416,426,29,11,10,65,117,1,100,0,0
4690,342,309,429,467,29,11,10,87,158,2,100,0,0
4691,335,311,442,508,29,11,10,107,197,3,100,0,0
4692,332,316,464,570,29,11,10,132,254,4,100,0,0
4693,339,318,480,596,29,11,10,141,278,5,100,0,0
4694,345,322,499,638,29,11,10,154,316,6,100,0,0
4695,351,323,510,663,29,11,10,159,340,7,100,0,0
4696,356,329,517,686,29,11,10,161,357,8,100,0,0
4697,362,332,523,703,29,11,10,161,371,9,100,0,0
4698,364,337,522,709,29,11,10,158,372,10,100,0,0
4699,366,339,520,714,29,11,10,154,375,11,100,0,0
4700,365,342,518,719,29,11,10,153,377,12,100,0,0
4701,367,349,519,731,29,11,10,152,382,13,100,0,0
4702,368,351,520,742,29,11,10,152,391,14,100,0,0
4703,372,353,524,746,29,11,10,152,393,15,100,0,0
4704,375,353,525,748,29,11,10,150,395,16,100,0,0
4705,369,352,523,759,29,11,10,154,407,17,100,0,0
4706,362,354,516,769,29,11,10,154,415,18,100,0,0
4707,356,357,507,774,29,11,10,151,417,19,100,0,0
4708,353,358,500,773,29,11,10,147,415,20,100,0,0
4709,348,359,492,771,29,11,10,144,412,21,100,0,0
4710,343,359,481,767,29,11,10,138,408,22,100,0,0
4711,342,357,478,771,29,11,10,136,414,23,100,0,0
4712,340,355,475,775,29,11,10,135,420,24,100,0,0
4713,342,356,473,775,29,11,10,131,419,25,100,0,0
4714,344,356,471,774,29,11,10,127,418,26,100,0,0
4715,344,355,469,775,29,11,10,125,420,27,100,0,0
4716,345,354,468,773,29,11,10,123,419,28,100,0,0
4717,346,353,467,772,29,11,10,121,419,29,100,0,0
4718,348,353,466,772,29,11,10,118,419,30,100,0,0
4719,349,353,466,771,29,11,10,117,418,31,100,0,0
4720,350,353,465,771,29,11,10,115,418,32,100,0,0
4721,351,353,465,770,29,11,10,114,417,33,100,0,0
4722,353,355,464,761,29,11,10,111,406,34,100,0,0
4723,353,355,463,759,29,11,10,110,404,35,100,0,0
4724,353,355,463,763,29,11,10,110,408,36,100,0,0
4725,353,354,463,766,29,11,10,110,412,37,100,0,0
4726,352,353,462,767,29,11,10,110,414,38,100,0,0
4727,351,353,461,768,29,11,10,110,415,39,100,0,0
4728,352,353,461,767,29,11,10,109,414,40,100,0,0
4729,353,355,459,760,29,11,10,106,405,41,100,0,0
4730,353,353,461,767,29,11,10,108,414,42,100,0,0
4731,353,352,462,769,29,11,10,109,417,43,100,0,0
4732,353,352,462,769,29,11,10,109,417,44,100,0,0
4733,354,353,460,767,29,11,10,106,414,45,100,0,0
4734,352,355,458,770,29,11,10,106,415,46,100,0,0
4735,352,355,457,771,29,11,10,105,416,47,100,0,0
4736,353,353,457,769,29,11,10,104,416,48,100,0,0
4737,353,353,457,769,29,11,10,104,416,49,100,0,0
4738,354,354,458,771,29,11,10,104,417,50,100,0,0
4739,354,355,457,772,29,11,10,103,417,51,100,0,0
4740,355,355,457,769,29,11,10,102,414,52,100,0,0
4741,355,353,458,770,29,11,10,103,417,53,100,0,0
4742,355,355,457,771,29,11,10,102,416,54,100,0,0
4743,355,353,458,771,29,11,10,103,418,55,100,0,0
4744,356,354,458,771,29,11,10,102,417,56,100,0,0
4745,355,355,457,771,29,11,10,102,416,57,100,0,0
4746,356,355,458,769,29,11,10,102,414,58,100,0,0
4747,358,355,459,768,29,11,10,101,413,59,100,0,0
4748,364,355,464,764,29,11,10,100,409,60,100,0,0
4749,371,358,472,764,29,11,10,101,406,61,100,0,0
4750,376,357,480,767,29,11,10,104,410,62,100,0,0
4751,386,352,493,766,29,11,10,107,414,63,100,0,0
4752,412,352,519,760,29,11,10,107,408,64,100,0,0
4753,430,354,541,759,29,11,10,111,405,65,100,0,0
4754,444,357,564,758,29,11,10,120,401,66,100,0,0
4755,506,359,620,748,29,11,10,114,389,67,100,0,0
4756,550,360,665,752,29,11,10,115,392,68,100,0,0
4757,583,369,703,755,29,11,10,120,386,69,100,0,0
4758,602,366,731,759,29,11,10,129,393,70,100,0,0
4759,648,371,774,747,29,11,10,126,376,71,100,0,0
4760,695,380,817,748,29,11,10,122,368,72,100,0,0
4761,725,393,845,742,29,11,10,120,349,73,100,0,0
4762,748,393,870,734,29,11,10,122,341,74,100,0,0
4763,794,384,922,743,29,11,10,128,359,75,100,0,0
4764,836,390,960,740,29,11,10,124,350,76,100,0,0
4765,862,383,989,740,29,11,10,127,357,77,100,0,0
4766,869,374,999,735,29,11,10,130,361,78,100,0,0
4767,872,370,1005,733,29,11,10,133,363,79,100,0,0
4768,871,369,1008,738,29,11,10,137,369,80,100,0,0
4769,870,366,1011,740,29,11,10,141,374,81,100,0,0
4770,878,374,1012,737,29,11,10,134,363,82,100,0,0
4771,888,375,1018,733,29,11,10,130,358,83,100,0,0
4772,899,379,1023,726,29,11,10,124,347,84,100,0,0
4773,904,376,1025,723,29,11,10,121,347,85,100,0,0
4774,900,374,1021,726,29,11,10,121,352,86,100,0,0
4775,899,374,1019,729,29,11,10,120,355,87,100,0,0
4776,901,376,1017,722,29,11,10,116,346,88,100,0,0
4777,893,374,1011,726,29,11,10,118,352,89,100,0,0
4778,889,371,1007,724,29,11,10,118,353,90,100,0,0
4779,886,370,1005,729,29,11,10,119,359,91,100,0,0
4780,881,367,1001,734,29,11,10,120,367,92,100,0,0
4781,880,365,1000,737,29,11,10,120,372,93,100,0,0
4782,879,364,996,733,29,11,10,117,369,94,100,0,0
4783,879,369,990,724,29,11,10,111,355,95,100,0,0
4784,878,371,984,719,29,11,10,106,348,96,100,0,0
4785,879,375,981,716,29,11,10,102,341,97,100,0,0
4786,880,375,975,703,29,11,10,95,328,98,100,0,0
4787,879,380,966,697,29,11,10,87,317,99,100,0,0
4788,879,381,965,694,29,11,10,86,313,100,100,1,0
4672,639,332,709,604,30,11,10,70,272,0,0,0,0
4686,305,299,395,416,31,11,10,90,117,0,1,0,0
4687,313,299,408,422,31,11,10,95,123,1,1,0,0
4761,822,398,883,610,32,11,10,61,212,0,0,0,0
4762,902,377,961,501,33,11,10,59,124,0,0,0,0
4785,247,225,290,347,34,11,10,43,122,0,43,0,1
4786,244,215,290,347,34,11,10,46,132,1,43,0,0
4787,238,219,282,344,34,11,10,44,125,2,43,0,0
4788,230,219,274,347,34,11,10,44,128,3,43,0,0
4789,222,219,268,350,34,11,10,46,131,4,43,0,0
4790,215,223,261,355,34,11,10,46,132,5,43,0,0
4791,209,227,255,360,34,11,10,46,133,6,43,0,0
4792,205,227,253,362,34,11,10,48,135,7,43,0,0
4793,203,226,253,370,34,11,10,50,144,8,43,0,0
4794,198,226,250,374,34,11,10,52,148,9,43,0,0
4795,192,228,245,379,34,11,10,53,151,10,43,0,0
4796,186,231,239,384,34,11,10,53,153,11,43,0,0
4797,182,230,236,386,34,11,10,54,156,12,43,0,0
4798,178,231,231,390,34,11,10,53,159,13,43,0,0
4799,177,231,230,388,34,11,10,53,157,14,43,0,0
4800,172,229,227,393,34,11,10,55,164,15,43,0,0
4801,168,234,223,399,34,11,10,55,165,16,43,0,0
4802,165,235,221,406,34,11,10,56,171,17,43,0,0
4803,163,237,221,416,34,11,10,58,179,18,43,0,0
4804,165,238,224,423,34,11,10,59,185,19,43,0,0
4805,170,244,226,422,34,11,10,56,178,20,43,0,0
4806,171,249,227,430,34,11,10,56,181,21,43,0,0
4807,173,249,232,436,34,11,10,59,187,22,43,0,0
4808,177,255,235,442,34,11,10,58,187,23,43,0,0
4809,180,256,239,451,34,11,10,59,195,24,43,0,0
4810,185,255,247,457,34,11,10,62,202,25,43,0,0
4811,187,259,250,464,34,11,10,63,205,26,43,0,0
4812,186,260,249,469,34,11,10,63,209,27,43,0,0
4813,184,261,248,474,34,11,10,64,213,28,43,0,0
4814,182,262,249,485,34,11,10,67,223,29,43,0,0
4815,182,263,250,488,34,11,10,68,225,30,43,0,0
4816,178,263,247,493,34,11,10,69,230,31,43,0,0
4817,166,266,238,498,34,11,10,72,232,32,43,0,0
4818,152,268,224,505,34,11,10,72,237,33,43,0,0
4819,140,274,213,509,34,11,10,73,235,34,43,0,0
4820,123,277,198,519,34,11,10,75,242,35,43,0,0
4821,101,274,179,530,34,11,10,78,256,36,43,0,0
4822,79,278,160,535,34,11,10,81,257,37,43,0,0
4823,59,282,138,535,34,11,10,79,253,38,43,0,0
4824,45,283,121,537,34,11,10,76,254,39,43,0,0
4825,33,283,109,542,34,11,10,76,259,40,43,0,0
4826,25,290,97,543,34,11,10,72,253,41,43,0,0
4827,15,286,86,544,34,11,10,71,258,42,43,0,0
4828,5,287,77,549,34,11,10,72,262,43,43,1,0
4833,14,293,86,569,34,11,10,72,276,0,43,0,0
4834,26,297,99,580,34,11,10,73,283,1,43,0,0
4835,42,295,117,584,34,11,10,75,289,2,43,0,0
4836,65,303,145,593,34,11,10,80,290,3,43,0,0
4837,80,308,164,600,34,11,10,84,292,4,43,0,0
4838,112,309,197,605,34,11,10,85,296,5,43,0,0
4839,142,317,237,638,34,11,10,95,321,6,43,0,0
4840,176,326,274,653,34,11,10,98,327,7,43,0,0
4841,207,331,317,692,34,11,10,110,361,8,43,0,0
4842,250,344,360,697,34,11,10,110,353,9,43,0,0
4843,307,352,428,728,34,11,10,121,376,10,43,0,0
4844,359,367,482,749,34,11,10,123,382,11,43,0,0
4845,408,383,541,782,34,11,10,133,399,12,43,0,0
4846,432,389,568,797,34,11,10,136,408,13,43,0,0
4846,532,408,710,851,36,11,10,178,443,0,0,0,0
4847,613,436,840,877,37,11,10,227,441,0,314,0,1
4848,677,455,907,902,37,11,10,230,447,1,314,0,0
4849,722,477,956,928,37,11,10,234,451,2,314,0,0
4850,765,485,1006,948,37,11,10,241,463,3,314,0,0
4851,778,485,1037,985,37,11,10,259,500,4,314,0,0
4852,758,484,1013,987,37,11,10,255,503,5,314,0,0
4853,742,474,999,987,37,11,10,257,513,6,314,0,0
4854,700,469,958,987,37,11,10,258,518,7,314,0,0
4855,665,467,923,986,37,11,10,258,519,8,314,0,0
4856,641,464,896,982,37,11,10,255,518,9,314,0,0
4857,615,454,870,979,37,11,10,255,525,10,314,0,0
4858,603,449,854,975,37,11,10,251,526,11,314,0,0
4859,600,448,846,975,37,11,10,246,527,12,314,0,0
4860,601,446,843,972,37,11,10,242,526,13,314,0,0
4861,603,445,842,973,37,11,10,239,528,14,314,0,0
4862,604,443,839,972,37,11,10,235,529,15,314,0,0
4863,605,443,836,972,37,11,10,231,529,16,314,0,0
4864,606,443,833,971,37,11,10,227,528,17,314,0,0
4865,608,443,831,970,37,11,10,223,527,18,314,0,0
4866,610,445,830,970,37,11,10,220,525,19,314,0,0
4867,612,442,830,970,37,11,10,218,528,20,314,0,0
4868,615,442,830,969,37,11,10,215,527,21,314,0,0
4869,618,441,831,969,37,11,10,213,528,22,314,0,0
4870,621,442,830,969,37,11,10,209,527,23,314,0,0
4871,622,445,829,968,37,11,10,207,523,24,314,0,0
4872,618,448,824,969,37,11,10,206,521,25,314,0,0
4873,613,445,818,969,37,11,10,205,524,26,314,0,0
4874,603,443,804,966,37,11,10,201,523,27,314,0,0
4875,596,439,795,964,37,11,10,199,525,28,314,0,0
4876,594,438,789,963,37,11,10,195,525,29,314,0,0
4877,597,433,787,953,37,11,10,190,520,30,314,0,0
4878,603,427,785,929,37,11,10,182,502,31,314,0,0
4879,594,430,769,910,37,11,10,175,480,32,314,0,0
4880,584,426,761,905,37,11,10,177,479,33,314,0,0
4881,577,414,757,900,37,11,10,180,486,34,314,0,0
4882,565,416,743,899,37,11,10,178,483,35,314,0,0
4883,554,417,732,897,37,11,10,178,480,36,314,0,0
4884,549,418,724,895,37,11,10,175,477,37,314,0,0
4885,543,416,719,894,37,11,10,176,478,38,314,0,0
4886,540,413,719,897,37,11,10,179,484,39,314,0,0
4887,539,411,719,897,37,11,10,180,486,40,314,0,0
4888,538,412,719,899,37,11,10,181,487,41,314,0,0
4889,538,413,719,900,37,11,10,181,487,42,314,0,0
4890,538,412,720,902,37,11,10,182,490,43,314,0,0
4891,538,415,720,900,37,11,10,182,485,44,314,0,0
4892,539,416,721,900,37,11,10,182,484,45,314,0,0
4893,537,415,721,901,37,11,10,184,486,46,314,0,0
4894,538,414,722,902,37,11,10,184,488,47,314,0,0
4895,537,414,723,902,37,11,10,186,488,48,314,0,0
4896,537,410,723,900,37,11,10,186,490,49,314,0,0
4897,536,409,723,899,37,11,10,187,490,50,314,0,0
4898,536,408,724,899,37,11,10,188,491,51,314,0,0
4899,536,410,724,900,37,11,10,188,490,52,314,0,0
4900,535,409,724,900,37,11,10,189,491,53,314,0,0
4901,535,412,724,902,37,11,10,189,490,54,314,0,0
4902,535,413,724,903,37,11,10,189,490,55,314,0,0
4903,535,413,724,904,37,11,10,189,491,56,314,0,0
4904,535,413,725,904,37,11,10,190,491,57,314,0,0
4905,535,413,724,901,37,11,10,189,488,58,314,0,0
4906,535,413,725,903,37,11,10,190,490,59,314,0,0
4907,535,414,725,904,37,11,10,190,490,60,314,0,0
4908,535,414,726,904,37,11,10,191,490,61,314,0,0
4909,535,414,725,904,37,11,10,190,490,62,314,0,0
4910,535,414,725,905,37,11,10,190,491,63,314,0,0
4911,535,415,725,904,37,11,10,190,489,64,314,0,0
4912,534,415,725,904,37,11,10,191,489,65,314,0,0
4913,535,417,724,904,37,11,10,189,487,66,314,0,0
4914,534,413,725,904,37,11,10,191,491,67,314,0,0
4915,535,412,725,903,37,11,10,190,491,68,314,0,0
4916,536,413,727,906,37,11,10,191,493,69,314,0,0
4917,535,412,726,904,37,11,10,191,492,70,314,0,0
4918,534,411,725,904,37,11,10,191,493,71,314,0,0
4919,534,411,726,903,37,11,10,192,492,72,314,0,0
4920,536,408,727,902,37,11,10,191,494,73,314,0,0
4921,537,408,727,900,37,11,10,190,492,74,314,0,0
4922,538,408,728,900,37,11,10,190,492,75,314,0,0
4923,539,413,727,900,37,11,10,188,487,76,314,0,0
4924,539,411,727,900,37,11,10,188,489,77,314,0,0
4925,538,409,726,899,37,11,10,188,490,78,314,0,0
4926,538,409,726,900,37,11,10,188,491,79,314,0,0
4927,538,413,725,902,37,11,10,187,489,80,314,0,0
4928,538,414,725,902,37,11,10,187,488,81,314,0,0
4929,537,410,725,901,37,11,10,188,491,82,314,0,0
4930,536,408,724,899,37,11,10,188,491,83,314,0,0
4931,534,406,723,901,37,11,10,189,495,84,314,0,0
4932,522,413,710,913,37,11,10,188,500,85,314,0,0
4933,512,409,703,930,37,11,10,191,521,86,314,0,0
4934,506,406,696,939,37,11,10,190,533,87,314,0,0
4935,499,414,686,944,37,11,10,187,530,88,314,0,0
4936,491,422,671,951,37,11,10,180,529,89,314,0,0
4937,497,433,671,951,37,11,10,174,518,90,314,0,0
4938,510,433,687,955,37,11,10,177,522,91,314,0,0
4939,522,440,704,965,37,11,10,182,525,92,314,0,0
4940,524,446,710,976,37,11,10,186,530,93,314,0,0
4941,534,453,722,983,37,11,10,188,530,94,314,0,0
4942,554,457,746,990,37,11,10,192,533,95,314,0,0
4943,570,460,769,1017,37,11,10,199,557,96,314,0,0
4944,579,464,784,1045,37,11,10,205,581,97,314,0,0
4945,577,472,780,1062,37,11,10,203,590,98,314,0,0
4946,571,473,771,1069,37,11,10,200,596,99,314,0,0
4947,567,478,762,1072,37,11,10,195,594,100,314,0,0
4948,564,482,754,1075,37,11,10,190,593,101,314,0,0
4949,566,482,752,1072,37,11,10,186,590,102,314,0,0
4950,569,478,752,1068,37,11,10,183,590,103,314,0,0
4951,581,479,763,1071,37,11,10,182,592,104,314,0,0
4952,591,471,773,1066,37,11,10,182,595,105,314,0,0
4953,601,471,783,1066,37,11,10,182,595,106,314,0,0
4954,620,474,797,1049,37,11,10,177,575,107,314,0,0
4955,633,473,812,1044,37,11,10,179,571,108,314,0,0
4956,645,485,825,1043,37,11,10,180,558,109,314,0,0
4957,655,494,836,1045,37,11,10,181,551,110,314,0,0
4958,663,495,847,1043,37,11,10,184,548,111,314,0,0
4959,667,491,855,1042,37,11,10,188,551,112,314,0,0
4960,662,487,853,1044,37,11,10,191,557,113,314,0,0
4961,648,479,841,1041,37,11,10,193,562,114,314,0,0
4962,626,474,817,1028,37,11,10,191,554,115,314,0,0
4963,601,468,791,1018,37,11,10,190,550,116,314,0,0
4964,589,459,780,1016,37,11,10,191,557,117,314,0,0
4965,591,447,780,1013,37,11,10,189,566,118,314,0,0
4966,593,434,775,994,37,11,10,182,560,119,314,0,0
4967,586,427,761,974,37,11,10,175,547,120,314,0,0
4968,555,431,726,953,37,11,10,171,522,121,314,0,0
4969,530,429,700,933,37,11,10,170,504,122,314,0,0
4970,516,428,689,923,37,11,10,173,495,123,314,0,0
4971,505,422,678,908,37,11,10,173,486,124,314,0,0
4972,487,417,650,888,37,11,10,163,471,125,314,0,0
4973,465,410,627,893,37,11,10,162,483,126,314,0,0
4974,446,406,603,887,37,11,10,157,481,127,314,0,0
4975,430,402,584,886,37,11,10,154,484,128,314,0,0
4976,412,390,564,882,37,11,10,152,492,129,314,0,0
4977,387,385,534,865,37,11,10,147,480,130,314,0,0
4978,370,384,515,854,37,11,10,145,470,131,314,0,0
4979,362,388,504,851,37,11,10,142,463,132,314,0,0
4980,355,389,495,847,37,11,10,140,458,133,314,0,0
4981,339,389,475,846,37,11,10,136,457,134,314,0,0
4982,327,387,460,847,37,11,10,133,460,135,314,0,0
4983,319,383,450,847,37,11,10,131,464,136,314,0,0
4984,313,376,441,842,37,11,10,128,466,137,314,0,0
4985,306,369,432,834,37,11,10,126,465,138,314,0,0
4986,298,363,417,809,37,11,10,119,446,139,314,0,0
4987,284,363,401,795,37,11,10,117,432,140,314,0,0
4988,274,361,393,789,37,11,10,119,428,141,314,0,0
4989,261,353,379,775,37,11,10,118,422,142,314,0,0
4990,238,347,354,760,37,11,10,116,413,143,314,0,0
4991,222,345,336,751,37,11,10,114,406,144,314,0,0
4992,214,344,328,749,37,11,10,114,405,145,314,0,0
4993,213,336,324,736,37,11,10,111,400,146,314,0,0
4994,206,329,313,712,37,11,10,107,383,147,314,0,0
4995,197,327,302,701,37,11,10,105,374,148,314,0,0
4996,194,324,299,700,37,11,10,105,376,149,314,0,0
4997,188,322,294,701,37,11,10,106,379,150,314,0,0
4998,180,323,285,697,37,11,10,105,374,151,314,0,0
4999,168,322,273,687,37,11,10,105,365,152,314,0,0
5000,171,320,277,688,37,11,10,106,368,153,314,0,0
5001,179,319,286,694,37,11,10,107,375,154,314,0,0
5002,185,320,291,700,37,11,10,106,380,155,314,0,0
5003,194,320,299,703,37,11,10,105,383,156,314,0,0
5004,205,321,307,701,37,11,10,102,380,157,314,0,0
5005,217,324,317,700,37,11,10,100,376,158,314,0,0
5006,246,332,353,709,37,11,10,107,377,159,314,0,0
5007,254,340,366,713,37,11,10,112,373,160,314,0,0
5008,267,338,385,718,37,11,10,118,380,161,314,0,0
5009,295,338,410,719,37,11,10,115,381,162,314,0,0
5010,313,341,429,734,37,11,10,116,393,163,314,0,0
5011,325,349,443,754,37,11,10,118,405,164,314,0,0
5012,338,352,455,763,37,11,10,117,411,165,314,0,0
5013,354,356,472,765,37,11,10,118,409,166,314,0,0
5014,378,360,501,771,37,11,10,123,411,167,314,0,0
5015,391,365,521,783,37,11,10,130,418,168,314,0,0
5016,400,363,534,788,37,11,10,134,425,169,314,0,0
5017,424,367,557,793,37,11,10,133,426,170,314,0,0
5018,447,369,581,814,37,11,10,134,445,171,314,0,0
5019,475,371,610,822,37,11,10,135,451,172,314,0,0
5020,488,374,625,827,37,11,10,137,453,173,314,0,0
5021,499,380,636,830,37,11,10,137,450,174,314,0,0
5022,526,389,658,836,37,11,10,132,447,175,314,0,0
5023,540,393,670,839,37,11,10,130,446,176,314,0,0
5024,548,393,676,839,37,11,10,128,446,177,314,0,0
5025,551,384,680,839,37,11,10,129,455,178,314,0,0
5026,552,381,680,836,37,11,10,128,455,179,314,0,0
5027,552,382,679,836,37,11,10,127,454,180,314,0,0
5028,552,383,677,835,37,11,10,125,452,181,314,0,0
5029,550,388,674,838,37,11,10,124,450,182,314,0,0
5030,549,389,672,840,37,11,10,123,451,183,314,0,0
5031,550,390,671,839,37,11,10,121,449,184,314,0,0
5032,549,383,671,837,37,11,10,122,454,185,314,0,0
5033,549,381,671,837,37,11,10,122,456,186,314,0,0
5034,549,380,670,836,37,11,10,121,456,187,314,0,0
5035,548,380,670,836,37,11,10,122,456,188,314,0,0
5036,548,382,669,836,37,11,10,121,454,189,314,0,0
5037,548,381,669,836,37,11,10,121,455,190,314,0,0
5038,548,381,669,836,37,11,10,121,455,191,314,0,0
5039,550,386,669,838,37,11,10,119,452,192,314,0,0
5040,549,389,668,839,37,11,10,119,450,193,314,0,0
5041,548,391,666,838,37,11,10,118,447,194,314,0,0
5042,548,392,666,839,37,11,10,118,447,195,314,0,0
5043,548,393,666,839,37,11,10,118,446,196,314,0,0
5044,550,387,668,837,37,11,10,118,450,197,314,0,0
5045,558,395,674,834,37,11,10,116,439,198,314,0,0
5046,575,400,695,836,37,11,10,120,436,199,314,0,0
5047,590,411,716,836,37,11,10,126,425,200,314,0,0
5048,620,409,750,834,37,11,10,130,425,201,314,0,0
5049,679,405,809,832,37,11,10,130,427,202,314,0,0
5050,717,410,852,826,37,11,10,135,416,203,314,0,0
5051,769,414,902,815,37,11,10,133,401,204,314,0,0
5052,820,412,953,809,37,11,10,133,397,205,314,0,0
5053,848,415,980,805,37,11,10,132,390,206,314,0,0
5054,875,405,1006,792,37,11,10,131,387,207,314,0,0
5055,891,395,1016,767,37,11,10,125,372,208,314,0,0
5056,895,391,1017,750,37,11,10,122,359,209,314,0,0
5057,900,387,1018,731,37,11,10,118,344,210,314,0,0
5058,894,387,1012,723,37,11,10,118,336,211,314,0,0
5059,887,390,1006,721,37,11,10,119,331,212,314,0,0
5060,887,393,1006,720,37,11,10,119,327,213,314,0,0
5061,887,395,1007,719,37,11,10,120,324,214,314,0,0
5062,886,395,1006,719,37,11,10,120,324,215,314,0,0
5063,884,395,1006,718,37,11,10,122,323,216,314,0,0
5064,880,394,1005,719,37,11,10,125,325,217,314,0,0
5065,879,393,1005,718,37,11,10,126,325,218,314,0,0
5066,878,393,1005,717,37,11,10,127,324,219,314,0,0
5067,875,393,1004,717,37,11,10,129,324,220,314,0,0
5068,875,393,1005,718,37,11,10,130,325,221,314,0,0
5069,873,393,1005,719,37,11,10,132,326,222,314,0,0
5070,873,392,1006,720,37,11,10,133,328,223,314,0,0
5071,866,391,1001,725,37,11,10,135,334,224,314,0,0
5072,846,395,990,754,37,11,10,144,359,225,314,0,0
5073,833,397,978,761,37,11,10,145,364,226,314,0,0
5074,811,392,955,761,37,11,10,144,369,227,314,0,0
5075,766,400,912,765,37,11,10,146,365,228,314,0,0
5076,738,399,886,770,37,11,10,148,371,229,314,0,0
5077,707,396,854,776,37,11,10,147,380,230,314,0,0
5078,663,388,812,781,37,11,10,149,393,231,314,0,0
5079,633,382,782,779,37,11,10,149,397,232,314,0,0
5080,603,378,752,772,37,11,10,149,394,233,314,0,0
5081,574,379,722,770,37,11,10,148,391,234,314,0,0
5082,565,384,720,794,37,11,10,155,410,235,314,0,0
5083,583,392,748,821,37,11,10,165,429,236,314,0,0
5084,598,402,764,827,37,11,10,166,425,237,314,0,0
5085,616,416,793,855,37,11,10,177,439,238,314,0,0
5086,647,447,844,899,37,11,10,197,452,239,314,0,0
5087,681,474,887,918,37,11,10,206,444,240,314,0,0
5088,731,479,952,946,37,11,10,221,467,241,314,0,0
5089,754,485,979,956,37,11,10,225,471,242,314,0,0
5090,765,486,995,962,37,11,10,230,476,243,314,0,0
5091,749,483,975,962,37,11,10,226,479,244,314,0,0
5092,741,471,966,961,37,11,10,225,490,245,314,0,0
5093,746,455,963,944,37,11,10,217,489,246,314,0,0
5094,753,439,959,912,37,11,10,206,473,247,314,0,0
5095,758,431,955,895,37,11,10,197,464,248,314,0,0
5096,765,427,956,888,37,11,10,191,461,249,314,0,0
5097,774,427,963,890,37,11,10,189,463,250,314,0,0
5098,782,430,965,887,37,11,10,183,457,251,314,0,0
5099,798,423,964,844,37,11,10,166,421,252,314,0,0
5100,809,413,965,815,37,11,10,156,402,253,314,0,0
5101,822,410,975,804,37,11,10,153,394,254,314,0,0
5102,849,406,992,776,37,11,10,143,370,255,314,0,0
5103,865,399,1002,758,37,11,10,137,359,256,314,0,0
5104,873,396,1002,740,37,11,10,129,344,257,314,0,0
5105,873,392,999,730,37,11,10,126,338,258,314,0,0
5106,876,391,1000,726,37,11,10,124,335,259,314,0,0
5107,881,390,1005,723,37,11,10,124,333,260,314,0,0
5108,877,388,1003,724,37,11,10,126,336,261,314,0,0
5109,873,386,1002,724,37,11,10,129,338,262,314,0,0
5110,874,382,1005,725,37,11,10,131,343,263,314,0,0
5111,880,379,1010,725,37,11,10,130,346,264,314,0,0
5112,881,378,1011,725,37,11,10,130,347,265,314,0,0
5113,881,375,1012,726,37,11,10,131,351,266,314,0,0
5114,882,374,1013,725,37,11,10,131,351,267,314,0,0
5115,883,375,1013,725,37,11,10,130,350,268,314,0,0
5116,886,374,1015,723,37,11,10,129,349,269,314,0,0
5117,884,376,1012,723,37,11,10,128,347,270,314,0,0
5118,888,379,1013,724,37,11,10,125,345,271,314,0,0
5119,886,386,1007,722,37,11,10,121,336,272,314,0,0
5120,882,385,1003,723,37,11,10,121,338,273,314,0,0
5121,879,383,1001,723,37,11,10,122,340,274,314,0,0
5122,881,382,1002,724,37,11,10,121,342,275,314,0,0
5123,885,382,1004,724,37,11,10,119,342,276,314,0,0
5124,887,382,1005,724,37,11,10,118,342,277,314,0,0
5125,886,382,1004,724,37,11,10,118,342,278,314,0,0
5126,880,381,998,723,37,11,10,118,342,279,314,0,0
5127,877,380,997,722,37,11,10,120,342,280,314,0,0
5128,879,379,999,722,37,11,10,120,343,281,314,0,0
5129,880,380,1000,722,37,11,10,120,342,282,314,0,0
5130,887,382,1005,723,37,11,10,118,341,283,314,0,0
5131,887,383,1004,723,37,11,10,117,340,284,314,0,0
5132,890,383,1007,724,37,11,10,117,341,285,314,0,0
5133,890,383,1006,723,37,11,10,116,340,286,314,0,0
5134,890,384,1005,724,37,11,10,115,340,287,314,0,0
5135,882,381,1000,724,37,11,10,118,343,288,314,0,0
5136,875,379,995,724,37,11,10,120,345,289,314,0,0
5137,878,380,998,724,37,11,10,120,344,290,314,0,0
5138,884,383,1002,724,37,11,10,118,341,291,314,0,0
5139,886,383,1003,724,37,11,10,117,341,292,314,0,0
5140,884,383,1002,724,37,11,10,118,341,293,314,0,0
5141,882,384,1000,724,37,11,10,118,340,294,314,0,0
5142,877,384,997,724,37,11,10,120,340,295,314,0,0
5143,875,384,997,723,37,11,10,122,339,296,314,0,0
5144,871,383,995,723,37,11,10,124,340,297,314,0,0
5145,866,381,993,723,37,11,10,127,342,298,314,0,0
5146,865,382,994,723,37,11,10,129,341,299,314,0,0
5147,865,382,996,722,37,11,10,131,340,300,314,0,0
5148,865,382,997,722,37,11,10,132,340,301,314,0,0
5149,869,383,1001,723,37,11,10,132,340,302,314,0,0
5150,874,383,1005,723,37,11,10,131,340,303,314,0,0
5151,875,379,1007,722,37,11,10,132,343,304,314,0,0
5152,876,378,1007,723,37,11,10,131,345,305,314,0,0
5153,877,376,1008,723,37,11,10,131,347,306,314,0,0
5154,881,377,1010,724,37,11,10,129,347,307,314,0,0
5155,884,378,1010,724,37,11,10,126,346,308,314,0,0
5156,884,380,1008,726,37,11,10,124,346,309,314,0,0
5157,884,380,1005,724,37,11,10,121,344,310,314,0,0
5158,881,378,1000,723,37,11,10,119,345,311,314,0,0
5159,882,377,995,711,37,11,10,113,334,312,314,0,0
5160,886,373,990,688,37,11,10,104,315,313,314,0,0
5161,886,372,989,684,37,11,10,103,312,314,314,1,0
5377,854,436,963,782,38,11,10,109,346,0,57,0,1
5378,817,437,927,784,38,11,10,110,347,1,57,0,0
5379,771,424,883,774,38,11,10,112,350,2,57,0,0
5380,701,413,818,773,38,11,10,117,360,3,57,0,0
5381,644,396,760,749,38,11,10,116,353,4,57,0,0
5382,576,383,693,732,38,11,10,117,349,5,57,0,0
5383,535,375,647,707,38,11,10,112,332,6,57,0,0
5384,475,363,589,694,38,11,10,114,331,7,57,0,0
5385,431,362,542,674,38,11,10,111,312,8,57,0,0
5386,413,344,523,654,38,11,10,110,310,9,57,0,0
5387,387,338,496,642,38,11,10,109,304,10,57,0,0
5388,361,326,466,618,38,11,10,105,292,11,57,0,0
5389,341,318,445,608,38,11,10,104,290,12,57,0,0
5390,330,317,428,593,38,11,10,98,276,13,57,0,0
5391,319,310,412,575,38,11,10,93,265,14,57,0,0
5392,307,308,398,566,38,11,10,91,258,15,57,0,0
5393,290,300,377,546,38,11,10,87,246,16,57,0,0
5394,270,295,358,541,38,11,10,88,246,17,57,0,0
5395,264,291,347,528,38,11,10,83,237,18,57,0,0
5396,256,284,338,518,38,11,10,82,234,19,57,0,0
5397,243,281,325,515,38,11,10,82,234,20,57,0,0
5398,229,277,308,498,38,11,10,79,221,21,57,0,0
5399,220,280,296,494,38,11,10,76,214,22,57,0,0
5400,217,279,290,483,38,11,10,73,204,23,57,0,0
5401,211,271,285,479,38,11,10,74,208,24,57,0,0
5402,205,269,278,474,38,11,10,73,205,25,57,0,0
5403,199,266,269,463,38,11,10,70,197,26,57,0,0
5404,197,266,265,459,38,11,10,68,193,27,57,0,0
5405,196,262,260,446,38,11,10,64,184,28,57,0,0
5406,192,260,256,443,38,11,10,64,183,29,57,0,0
5407,188,259,250,438,38,11,10,62,179,30,57,0,0
5408,182,256,244,437,38,11,10,62,181,31,57,0,0
5409,182,257,241,430,38,11,10,59,173,32,57,0,0
5410,180,254,238,422,38,11,10,58,168,33,57,0,0
5411,179,255,233,415,38,11,10,54,160,34,57,0,0
5412,174,251,228,408,38,11,10,54,157,35,57,0,0
5413,172,248,224,399,38,11,10,52,151,36,57,0,0
5414,171,247,222,397,38,11,10,51,150,37,57,0,0
5415,169,242,220,393,38,11,10,51,151,38,57,0,0
5416,167,242,217,391,38,11,10,50,149,39,57,0,0
5417,163,240,214,389,38,11,10,51,149,40,57,0,0
5418,162,240,211,384,38,11,10,49,144,41,57,0,0
5419,162,240,209,380,38,11,10,47,140,42,57,0,0
5420,161,236,208,379,38,11,10,47,143,43,57,0,0
5421,159,237,205,374,38,11,10,46,137,44,57,0,0
5422,154,237,200,371,38,11,10,46,134,45,57,0,0
5423,152,237,198,371,38,11,10,46,134,46,57,0,0
5424,151,238,195,367,38,11,10,44,129,47,57,0,0
5425,150,235,193,362,38,11,10,43,127,48,57,0,0
5426,147,234,189,358,38,11,10,42,124,49,57,0,0
5427,142,231,184,352,38,11,10,42,121,50,57,0,0
5428,139,232,181,352,38,11,10,42,120,51,57,0,0
5429,138,232,178,346,38,11,10,40,114,52,57,0,0
5430,137,230,177,345,38,11,10,40,115,53,57,0,0
5431,135,231,174,343,38,11,10,39,112,54,57,0,0
5432,131,229,169,339,38,11,10,38,110,55,57,0,0
5433,128,229,165,338,38,11,10,37,109,56,57,0,0
5434,126,232,161,337,38,11,10,35,105,57,57,1,0
5436,119,227,154,331,38,11,10,35,104,0,57,0,0
5437,113,224,149,329,38,11,10,36,105,1,57,0,0
5438,109,223,146,329,38,11,10,37,106,2,57,0,0
5439,108,223,143,328,38,11,10,35,105,3,57,0,0
5378,935,374,992,630,39,11,10,57,256,0,23,0,1
5379,916,376,989,702,39,11,10,73,326,1,23,0,0
5380,911,377,987,711,39,11,10,76,334,2,23,0,0
5381,907,375,985,712,39,11,10,78,337,3,23,0,0
5382,903,378,984,712,39,11,10,81,334,4,23,0,0
5383,894,376,980,712,39,11,10,86,336,5,23,0,0
5384,889,375,979,712,39,11,10,90,337,6,23,0,0
5385,883,374,978,711,39,11,10,95,337,7,23,0,0
5386,879,373,980,711,39,11,10,101,338,8,23,0,0
5387,878,373,983,711,39,11,10,105,338,9,23,0,0
5388,876,372,986,711,39,11,10,110,339,10,23,0,0
5389,872,372,988,711,39,11,10,116,339,11,23,0,0
5390,871,371,991,711,39,11,10,120,340,12,23,0,0
5391,878,376,998,711,39,11,10,120,335,13,23,0,0
5392,875,376,998,711,39,11,10,123,335,14,23,0,0
5393,881,381,1005,711,39,11,10,124,330,15,23,0,0
5394,894,383,1015,709,39,11,10,121,326,16,23,0,0
5395,903,380,1021,707,39,11,10,118,327,17,23,0,0
5396,914,381,1028,704,39,11,10,114,323,18,23,0,0
5397,915,383,1027,704,39,11,10,112,321,19,23,0,0
5398,914,384,1025,706,39,11,10,111,322,20,23,0,0
5399,917,383,1026,709,39,11,10,109,326,21,23,0,0
5400,919,388,1022,706,39,11,10,103,318,22,23,0,0
5401,921,389,1024,706,39,11,10,103,317,23,23,1,0
324,1350,124,1671,874,3,11,11,321,750,0,26,0,1
325,1352,102,1673,854,3,11,11,321,752,1,26,0,0
326,1364,82,1660,777,3,11,11,296,695,2,26,0,0
327,1357,47,1635,698,3,11,11,278,651,3,26,0,0
328,1352,36,1621,665,3,11,11,269,629,4,26,0,0
329,1378,25,1616,584,3,11,11,238,559,5,26,0,0
330,1385,11,1608,539,3,11,11,223,528,6,26,0,0
331,1387,4,1601,514,3,11,11,214,510,7,26,0,0
332,1405,3,1590,447,3,11,11,185,444,8,26,0,0
333,1406,1,1586,423,3,11,11,180,422,9,26,0,0
334,1409,0,1583,400,3,11,11,174,400,10,26,0,0
335,1421,0,1577,356,3,11,11,156,356,11,26,0,0
336,1424,0,1575,345,3,11,11,151,345,12,26,0,0
337,1435,0,1575,320,3,11,11,140,320,13,26,0,0
338,1441,0,1567,288,3,11,11,126,288,14,26,0,0
339,1441,2,1563,278,3,11,11,122,276,15,26,0,0
340,1447,0,1559,251,3,11,11,112,251,16,26,0,0
341,1448,0,1555,235,3,11,11,107,235,17,26,0,0
342,1451,0,1555,228,3,11,11,104,228,18,26,0,0
343,1463,1,1557,206,3,11,11,94,205,19,26,0,0
344,1471,1,1561,191,3,11,11,90,190,20,26,0,0
345,1478,0,1559,170,3,11,11,81,170,21,26,0,0
346,1487,0,1564,156,3,11,11,77,156,22,26,0,0
347,1490,0,1565,149,3,11,11,75,149,23,26,0,0
348,1503,0,1575,141,3,11,11,72,141,24,26,0,0
349,1514,3,1581,130,3,11,11,67,127,25,26,0,0
350,1523,3,1582,115,3,11,11,59,112,26,26,1,0
336,1540,148,1596,222,4,11,11,56,74,0,0,0,0
347,1549,7,1597,140,5,11,11,48,133,0,1,0,0
348,1553,11,1597,131,5,11,11,44,120,1,1,0,0
351,1811,777,1919,1079,6,11,11,108,302,0,0,0,0
1555,1766,766,1920,1080,8,11,11,154,314,0,1,0,0
1556,1720,746,1884,1076,8,11,11,164,330,1,1,0,0
54,1011,314,1049,386,3,11,12,38,72,0,0,0,0
80,1851,403,1920,665,5,11,12,69,262,0,24,0,1
81,1848,413,1920,689,5,11,12,72,276,1,24,0,0
82,1843,399,1920,696,5,11,12,77,297,2,24,0,0
83,1837,415,1915,711,5,11,12,78,296,3,24,0,0
84,1828,412,1913,733,5,11,12,85,321,4,24,0,0
85,1810,402,1902,739,5,11,12,92,337,5,24,0,0
86,1793,406,1891,752,5,11,12,98,346,6,24,0,0
87,1783,404,1889,765,5,11,12,106,361,7,24,0,0
88,1774,409,1891,799,5,11,12,117,390,8,24,0,0
89,1765,421,1892,837,5,11,12,127,416,9,24,0,0
90,1760,431,1892,849,5,11,12,132,418,10,24,0,0
91,1743,441,1886,875,5,11,12,143,434,11,24,0,0
92,1734,454,1884,897,5,11,12,150,443,12,24,0,0
93,1727,467,1884,917,5,11,12,157,450,13,24,0,0
94,1711,486,1885,971,5,11,12,174,485,14,24,0,0
95,1703,518,1887,1015,5,11,12,184,497,15,24,0,0
96,1672,526,1871,1035,5,11,12,199,509,16,24,0,0
97,1643,551,1851,1062,5,11,12,208,511,17,24,0,0
98,1613,547,1835,1076,5,11,12,222,529,18,24,0,0
99,1597,564,1823,1080,5,11,12,226,516,19,24,0,0
100,1577,621,1797,1080,5,11,12,220,459,20,24,0,0
101,1574,666,1794,1080,5,11,12,220,414,21,24,0,0
102,1577,717,1792,1080,5,11,12,215,363,22,24,0,0
103,1598,771,1803,1080,5,11,12,205,309,23,24,0,0
104,1597,798,1793,1080,5,11,12,196,282,24,24,1,0
283,1858,484,1920,721,6,11,12,62,237,0,29,0,1
284,1849,438,1920,720,6,11,12,71,282,1,29,0,0
285,1833,420,1915,732,6,11,12,82,312,2,29,0,0
286,1830,455,1907,743,6,11,12,77,288,3,29,0,0
287,1824,439,1908,750,6,11,12,84,311,4,29,0,0
288,1816,421,1913,779,6,11,12,97,358,5,29,0,0
289,1811,411,1915,795,6,11,12,104,384,6,29,0,0
290,1796,369,1914,802,6,11,12,118,433,7,29,0,0
291,1785,342,1916,828,6,11,12,131,486,8,29,0,0
292,1777,329,1915,840,6,11,12,138,511,9,29,0,0
293,1775,329,1918,861,6,11,12,143,532,10,29,0,0
294,1779,410,1914,907,6,11,12,135,497,11,29,0,0
295,1783,449,1914,933,6,11,12,131,484,12,29,0,0
296,1777,485,1905,939,6,11,12,128,454,13,29,0,0
297,1761,513,1896,977,6,11,12,135,464,14,29,0,0
298,1753,536,1893,996,6,11,12,140,460,15,29,0,0
299,1747,542,1893,1005,6,11,12,146,463,16,29,0,0
300,1736,563,1895,1053,6,11,12,159,490,17,29,0,0
301,1729,590,1891,1071,6,11,12,162,481,18,29,0,0
302,1711,605,1880,1078,6,11,12,169,473,19,29,0,0
303,1692,629,1867,1080,6,11,12,175,451,20,29,0,0
304,1674,639,1856,1080,6,11,12,182,441,21,29,0,0
305,1652,660,1837,1080,6,11,12,185,420,22,29,0,0
306,1623,688,1805,1079,6,11,12,182,391,23,29,0,0
307,1584,709,1770,1074,6,11,12,186,365,24,29,0,0
308,1527,733,1723,1080,6,11,12,196,347,25,29,0,0
309,1469,767,1667,1080,6,11,12,198,313,26,29,0,0
310,1383,792,1583,1080,6,11,12,200,288,27,29,0,0
311,1298,816,1500,1078,6,11,12,202,262,28,29,0,0
312,1213,877,1391,1080,6,11,12,178,203,29,29,1,0
435,8,545,217,1044,9,11,12,209,499,0,91,0,1
436,49,531,249,1005,9,11,12,200,474,1,91,0,0
437,106,501,329,1026,9,11,12,223,525,2,91,0,0
438,212,476,465,1065,9,11,12,253,589,3,91,0,0
439,284,460,549,1072,9,11,12,265,612,4,91,0,0
440,325,427,599,1062,9,11,12,274,635,5,91,0,0
441,362,400,642,1054,9,11,12,280,654,6,91,0,0
442,396,391,670,1037,9,11,12,274,646,7,91,0,0
443,430,381,682,977,9,11,12,252,596,8,91,0,0
444,460,358,698,925,9,11,12,238,567,9,91,0,0
445,487,353,716,903,9,11,12,229,550,10,91,0,0
446,513,337,725,845,9,11,12,212,508,11,91,0,0
447,515,330,716,813,9,11,12,201,483,12,91,0,0
448,513,315,703,772,9,11,12,190,457,13,91,0,0
449,505,297,688,738,9,11,12,183,441,14,91,0,0
450,494,287,672,720,9,11,12,178,433,15,91,0,0
451,482,276,659,710,9,11,12,177,434,16,91,0,0
452,483,270,645,668,9,11,12,162,398,17,91,0,0
453,468,257,626,648,9,11,12,158,391,18,91,0,0
454,449,257,595,617,9,11,12,146,360,19,91,0,0
455,434,249,574,597,9,11,12,140,348,20,91,0,0
456,423,242,560,587,9,11,12,137,345,21,91,0,0
457,417,237,545,558,9,11,12,128,321,22,91,0,0
458,415,233,541,546,9,11,12,126,313,23,91,0,0
459,404,226,528,536,9,11,12,124,310,24,91,0,0
460,397,215,520,521,9,11,12,123,306,25,91,0,0
461,391,208,514,515,9,11,12,123,307,26,91,0,0
462,392,204,507,492,9,11,12,115,288,27,91,0,0
463,394,200,503,472,9,11,12,109,272,28,91,0,0
464,393,200,498,462,9,11,12,105,262,29,91,0,0
465,388,201,488,452,9,11,12,100,251,30,91,0,0
466,385,207,480,444,9,11,12,95,237,31,91,0,0
467,385,202,477,438,9,11,12,92,236,32,91,0,0
468,383,192,474,426,9,11,12,91,234,33,91,0,0
469,381,192,471,420,9,11,12,90,228,34,91,0,0
470,373,189,461,411,9,11,12,88,222,35,91,0,0
471,369,181,456,402,9,11,12,87,221,36,91,0,0
472,368,180,453,399,9,11,12,85,219,37,91,0,0
473,367,176,449,387,9,11,12,82,211,38,91,0,0
474,368,173,447,377,9,11,12,79,204,39,91,0,0
475,365,171,443,373,9,11,12,78,202,40,91,0,0
476,361,172,437,367,9,11,12,76,195,41,91,0,0
477,361,173,433,363,9,11,12,72,190,42,91,0,0
478,359,174,428,357,9,11,12,69,183,43,91,0,0
479,360,169,428,350,9,11,12,68,181,44,91,0,0
480,358,166,424,342,9,11,12,66,176,45,91,0,0
481,351,160,417,338,9,11,12,66,178,46,91,0,0
482,351,163,415,332,9,11,12,64,169,47,91,0,0
483,348,161,412,333,9,11,12,64,172,48,91,0,0
484,347,156,409,326,9,11,12,62,170,49,91,0,0
485,347,154,407,321,9,11,12,60,167,50,91,0,0
486,345,151,406,320,9,11,12,61,169,51,91,0,0
487,344,154,401,312,9,11,12,57,158,52,91,0,0
488,342,154,397,309,9,11,12,55,155,53,91,0,0
489,342,154,394,302,9,11,12,52,148,54,91,0,0
490,338,144,393,299,9,11,12,55,155,55,91,0,0
491,334,141,388,296,9,11,12,54,155,56,91,0,0
492,328,137,383,293,9,11,12,55,156,57,91,0,0
493,325,135,380,291,9,11,12,55,156,58,91,0,0
494,324,136,377,286,9,11,12,53,150,59,91,0,0
495,323,138,373,280,9,11,12,50,142,60,91,0,0
496,322,131,373,278,9,11,12,51,147,61,91,0,0
497,321,133,370,275,9,11,12,49,142,62,91,0,0
498,320,133,368,273,9,11,12,48,140,63,91,0,0
499,319,129,368,272,9,11,12,49,143,64,91,0,0
500,321,129,368,270,9,11,12,47,141,65,91,0,0
501,323,135,367,268,9,11,12,44,133,66,91,0,0
502,322,128,367,266,9,11,12,45,138,67,91,0,0
503,319,123,365,263,9,11,12,46,140,68,91,0,0
504,319,123,363,258,9,11,12,44,135,69,91,0,0
505,319,123,362,254,9,11,12,43,131,70,91,0,0
506,319,124,361,253,9,11,12,42,129,71,91,0,0
507,316,119,359,252,9,11,12,43,133,72,91,0,0
508,314,125,355,252,9,11,12,41,127,73,91,0,0
509,314,123,355,249,9,11,12,41,126,74,91,0,0
510,314,122,354,245,9,11,12,40,123,75,91,0,0
511,314,121,353,242,9,11,12,39,121,76,91,0,0
512,312,122,351,240,9,11,12,39,118,77,91,0,0
513,307,125,347,239,9,11,12,40,114,78,91,0,0
514,307,122,346,237,9,11,12,39,115,79,91,0,0
515,307,121,346,234,9,11,12,39,113,80,91,0,0
516,306,121,345,232,9,11,12,39,111,81,91,0,0
517,305,121,343,230,9,11,12,38,109,82,91,0,0
518,303,120,342,229,9,11,12,39,109,83,91,0,0
519,302,124,340,228,9,11,12,38,104,84,91,0,0
520,302,126,338,226,9,11,12,36,100,85,91,0,0
521,302,125,338,224,9,11,12,36,99,86,91,0,0
522,301,123,337,222,9,11,12,36,99,87,91,0,0
523,300,122,337,222,9,11,12,37,100,88,91,0,0
524,300,122,336,221,9,11,12,36,99,89,91,0,0
525,300,123,336,220,9,11,12,36,97,90,91,0,0
526,301,124,336,219,9,11,12,35,95,91,91,1,0
545,336,477,917,1069,11,11,12,581,592,0,4,0,0
546,279,429,894,1071,11,11,12,615,642,1,4,0,0
547,224,382,860,1068,11,11,12,636,686,2,4,0,0
548,188,340,834,1065,11,11,12,646,725,3,4,0,0
549,132,292,819,1062,11,11,12,687,770,4,4,0,0
549,393,333,597,957,12,11,12,204,624,0,58,0,1
550,380,326,582,945,12,11,12,202,619,1,58,0,0
551,357,299,545,877,12,11,12,188,578,2,58,0,0
552,339,272,522,826,12,11,12,183,554,3,58,0,0
553,342,261,517,788,12,11,12,175,527,4,58,0,0
554,345,240,508,735,12,11,12,163,495,5,58,0,0
555,342,241,494,706,12,11,12,152,465,6,58,0,0
556,334,234,473,657,12,11,12,139,423,7,58,0,0
557,327,225,464,643,12,11,12,137,418,8,58,0,0
558,329,220,457,609,12,11,12,128,389,9,58,0,0
559,328,196,454,582,12,11,12,126,386,10,58,0,0
560,325,190,448,570,12,11,12,123,380,11,58,0,0
561,316,188,428,538,12,11,12,112,350,12,58,0,0
562,307,187,415,525,12,11,12,108,338,13,58,0,0
563,306,178,409,500,12,11,12,103,322,14,58,0,0
564,304,174,402,484,12,11,12,98,310,15,58,0,0
565,301,177,393,473,12,11,12,92,296,16,58,0,0
566,296,160,387,457,12,11,12,91,297,17,58,0,0
567,294,169,380,450,12,11,12,86,281,18,58,0,0
568,294,164,377,435,12,11,12,83,271,19,58,0,0
569,294,163,372,421,12,11,12,78,258,20,58,0,0
570,292,162,366,407,12,11,12,74,245,21,58,0,0
571,290,157,362,399,12,11,12,72,242,22,58,0,0
572,287,139,363,394,12,11,12,76,255,23,58,0,0
573,289,126,364,385,12,11,12,75,259,24,58,0,0
574,289,123,362,379,12,11,12,73,256,25,58,0,0
575,289,134,356,369,12,11,12,67,235,26,58,0,0
576,288,145,350,363,12,11,12,62,218,27,58,0,0
577,289,145,350,358,12,11,12,61,213,28,58,0,0
578,292,132,353,347,12,11,12,61,215,29,58,0,0
579,294,142,350,341,12,11,12,56,199,30,58,0,0
580,293,139,349,335,12,11,12,56,196,31,58,0,0
581,294,133,350,330,12,11,12,56,197,32,58,0,0
582,295,121,353,324,12,11,12,58,203,33,58,0,0
583,296,116,355,319,12,11,12,59,203,34,58,0,0
584,297,118,355,318,12,11,12,58,200,35,58,0,0
585,297,117,352,308,12,11,12,55,191,36,58,0,0
586,295,116,349,306,12,11,12,54,190,37,58,0,0
587,297,125,347,299,12,11,12,50,174,38,58,0,0
588,300,153,341,295,12,11,12,41,142,39,58,0,0
589,298,149,340,292,12,11,12,42,143,40,58,0,0
590,295,134,339,285,12,11,12,44,151,41,58,0,0
591,291,126,336,282,12,11,12,45,156,42,58,0,0
592,289,119,335,278,12,11,12,46,159,43,58,0,0
593,288,118,334,277,12,11,12,46,159,44,58,0,0
594,286,118,331,273,12,11,12,45,155,45,58,0,0
595,285,116,329,271,12,11,12,44,155,46,58,0,0
596,283,114,327,267,12,11,12,44,153,47,58,0,0
597,284,112,327,261,12,11,12,43,149,48,58,0,0
598,286,115,325,252,12,11,12,39,137,49,58,0,0
599,285,115,324,252,12,11,12,39,137,50,58,0,0
600,285,114,324,251,12,11,12,39,137,51,58,0,0
601,283,116,321,249,12,11,12,38,133,52,58,0,0
602,282,113,321,248,12,11,12,39,135,53,58,0,0
603,282,111,321,247,12,11,12,39,136,54,58,0,0
604,283,112,321,244,12,11,12,38,132,55,58,0,0
605,283,112,321,243,12,11,12,38,131,56,58,0,0
606,285,113,321,239,12,11,12,36,126,57,58,0,0
607,287,114,322,236,12,11,12,35,122,58,58,1,0
721,1838,422,1920,714,13,11,12,82,292,0,68,0,1
722,1832,408,1920,727,13,11,12,88,319,1,68,0,0
723,1805,407,1900,740,13,11,12,95,333,2,68,0,0
724,1783,395,1885,749,13,11,12,102,354,3,68,0,0
725,1751,395,1857,752,13,11,12,106,357,4,68,0,0
726,1713,405,1824,766,13,11,12,111,361,5,68,0,0
727,1693,398,1809,770,13,11,12,116,372,6,68,0,0
728,1650,404,1775,794,13,11,12,125,390,7,68,0,0
729,1615,407,1748,808,13,11,12,133,401,8,68,0,0
730,1569,397,1712,820,13,11,12,143,423,9,68,0,0
731,1506,398,1661,838,13,11,12,155,440,10,68,0,0
732,1460,394,1620,850,13,11,12,160,456,11,68,0,0
733,1387,392,1560,869,13,11,12,173,477,12,68,0,0
734,1323,400,1504,890,13,11,12,181,490,13,68,0,0
735,1267,391,1453,898,13,11,12,186,507,14,68,0,0
736,1170,399,1364,910,13,11,12,194,511,15,68,0,0
737,1103,391,1303,918,13,11,12,200,527,16,68,0,0
738,999,383,1209,928,13,11,12,210,545,17,68,0,0
739,917,381,1135,929,13,11,12,218,548,18,68,0,0
740,849,369,1066,921,13,11,12,217,552,19,68,0,0
741,734,352,961,918,13,11,12,227,566,20,68,0,0
742,644,341,874,900,13,11,12,230,559,21,68,0,0
743,576,315,802,877,13,11,12,226,562,22,68,0,0
744,517,322,737,862,13,11,12,220,540,23,68,0,0
745,461,305,666,817,13,11,12,205,512,24,68,0,0
746,398,300,594,794,13,11,12,196,494,25,68,0,0
747,356,291,547,773,13,11,12,191,482,26,68,0,0
748,337,273,517,735,13,11,12,180,462,27,68,0,0
749,324,268,495,714,13,11,12,171,446,28,68,0,0
750,312,258,465,667,13,11,12,153,409,29,68,0,0
751,304,247,449,644,13,11,12,145,397,30,68,0,0
752,302,245,440,628,13,11,12,138,383,31,68,0,0
753,307,240,432,593,13,11,12,125,353,32,68,0,0
754,309,235,424,567,13,11,12,115,332,33,68,0,0
755,312,233,417,537,13,11,12,105,304,34,68,0,0
756,314,224,415,522,13,11,12,101,298,35,68,0,0
757,316,217,415,513,13,11,12,99,296,36,68,0,0
758,321,216,411,488,13,11,12,90,272,37,68,0,0
759,323,219,409,477,13,11,12,86,258,38,68,0,0
760,323,204,408,462,13,11,12,85,258,39,68,0,0
761,325,202,403,441,13,11,12,78,239,40,68,0,0
762,325,198,402,435,13,11,12,77,237,41,68,0,0
763,325,191,399,421,13,11,12,74,230,42,68,0,0
764,322,185,397,417,13,11,12,75,232,43,68,0,0
765,323,192,391,403,13,11,12,68,211,44,68,0,0
766,319,178,386,388,13,11,12,67,210,45,68,0,0
767,316,181,382,388,13,11,12,66,207,46,68,0,0
768,315,181,377,377,13,11,12,62,196,47,68,0,0
769,311,170,374,370,13,11,12,63,200,48,68,0,0
770,307,174,367,366,13,11,12,60,192,49,68,0,0
771,305,177,362,358,13,11,12,57,181,50,68,0,0
772,302,181,357,355,13,11,12,55,174,51,68,0,0
773,303,180,354,342,13,11,12,51,162,52,68,0,0
774,303,170,355,336,13,11,12,52,166,53,68,0,0
775,302,176,353,334,13,11,12,51,158,54,68,0,0
776,300,168,350,327,13,11,12,50,159,55,68,0,0
777,300,168,348,320,13,11,12,48,152,56,68,0,0
778,301,164,348,316,13,11,12,47,152,57,68,0,0
779,301,158,349,310,13,11,12,48,152,58,68,0,0
780,304,157,352,311,13,11,12,48,154,59,68,0,0
781,305,151,352,301,13,11,12,47,150,60,68,0,0
782,307,151,353,297,13,11,12,46,146,61,68,0,0
783,311,147,356,293,13,11,12,45,146,62,68,0,0
784,312,144,356,287,13,11,12,44,143,63,68,0,0
785,312,130,361,292,13,11,12,49,162,64,68,0,0
786,315,141,359,286,13,11,12,44,145,65,68,0,0
787,320,151,359,281,13,11,12,39,130,66,68,0,0
788,322,154,358,276,13,11,12,36,122,67,68,0,0
789,323,153,358,271,13,11,12,35,118,68,68,1,0
791,321,144,358,268,13,11,12,37,124,0,68,0,0
792,320,144,356,265,13,11,12,36,121,1,68,0,0
793,320,138,356,264,13,11,12,36,126,2,68,0,0
794,320,136,356,260,13,11,12,36,124,3,68,0,0
796,321,131,356,254,13,11,12,35,123,0,68,0,0
800,317,120,353,242,13,11,12,36,122,0,68,0,0
801,315,117,350,239,13,11,12,35,122,1,68,0,0
1744,1324,445,1920,1062,14,11,12,596,617,0,1,0,0
1745,1294,405,1920,1061,14,11,12,626,656,1,1,0,0
1745,1613,432,1848,990,15,11,12,235,558,0,12,0,0
1746,1622,425,1856,982,15,11,12,234,557,1,12,0,0
1747,1643,406,1860,923,15,11,12,217,517,2,12,0,0
1748,1663,399,1864,874,15,11,12,201,475,3,12,0,0
1749,1684,407,1873,851,15,11,12,189,444,4,12,0,0
1750,1727,398,1906,820,15,11,12,179,422,5,12,0,0
1751,1748,402,1920,810,15,11,12,172,408,6,12,0,0
1752,1766,388,1920,792,15,11,12,154,404,7,12,0,0
1753,1785,395,1920,761,15,11,12,135,366,8,12,0,0
1754,1795,406,1920,747,15,11,12,125,341,9,12,0,0
1755,1820,410,1920,726,15,11,12,100,316,10,12,0,0
1756,1835,422,1920,721,15,11,12,85,299,11,12,0,0
1757,1852,425,1920,701,15,11,12,68,276,12,12,0,0
2030,23,555,303,1041,16,11,12,280,486,0,63,0,0
2031,19,515,331,1056,16,11,12,312,541,1,63,0,0
2032,77,492,400,1051,16,11,12,323,559,2,63,0,0
2033,167,466,510,1065,16,11,12,343,599,3,63,0,0
2034,224,430,575,1045,16,11,12,351,615,4,63,0,0
2035,245,396,608,1039,16,11,12,363,643,5,63,0,0
2036,272,378,611,986,16,11,12,339,608,6,63,0,0
2037,280,349,606,950,16,11,12,326,601,7,63,0,0
2038,296,336,608,924,16,11,12,312,588,8,63,0,0
2039,325,324,596,841,16,11,12,271,517,9,63,0,0
2040,334,300,590,806,16,11,12,256,506,10,63,0,0
2041,356,296,570,730,16,11,12,214,434,11,63,0,0
2042,381,278,587,695,16,11,12,206,417,12,63,0,0
2048,284,248,421,535,16,11,12,137,287,0,63,0,1
2049,268,240,417,569,16,11,12,149,329,1,63,0,0
2050,269,231,420,576,16,11,12,151,345,2,63,0,0
2051,279,226,415,545,16,11,12,136,319,3,63,0,0
2052,282,222,412,531,16,11,12,130,309,4,63,0,0
2053,282,222,404,517,16,11,12,122,295,5,63,0,0
2054,278,212,397,502,16,11,12,119,290,6,63,0,0
2055,272,208,391,499,16,11,12,119,291,7,63,0,0
2056,271,209,385,489,16,11,12,114,280,8,63,0,0
2057,273,202,380,466,16,11,12,107,264,9,63,0,0
2058,276,200,377,454,16,11,12,101,254,10,63,0,0
2059,273,199,371,448,16,11,12,98,249,11,63,0,0
2060,271,192,367,436,16,11,12,96,244,12,63,0,0
2061,269,189,365,434,16,11,12,96,245,13,63,0,0
2062,274,189,364,416,16,11,12,90,227,14,63,0,0
2063,278,182,365,406,16,11,12,87,224,15,63,0,0
2064,278,182,362,400,16,11,12,84,218,16,63,0,0
2065,276,180,358,392,16,11,12,82,212,17,63,0,0
2066,273,178,354,388,16,11,12,81,210,18,63,0,0
2067,273,178,352,386,16,11,12,79,208,19,63,0,0
2068,276,177,351,373,16,11,12,75,196,20,63,0,0
2069,278,174,351,367,16,11,12,73,193,21,63,0,0
2070,277,174,349,365,16,11,12,72,191,22,63,0,0
2071,276,172,346,357,16,11,12,70,185,23,63,0,0
2072,275,171,345,356,16,11,12,70,185,24,63,0,0
2073,278,171,345,348,16,11,12,67,177,25,63,0,0
2074,279,166,345,343,16,11,12,66,177,26,63,0,0
2075,281,168,345,342,16,11,12,64,174,27,63,0,0
2076,281,167,343,335,16,11,12,62,168,28,63,0,0
2077,280,161,340,327,16,11,12,60,166,29,63,0,0
2078,281,160,338,320,16,11,12,57,160,30,63,0,0
2079,285,162,339,315,16,11,12,54,153,31,63,0,0
2080,286,158,343,318,16,11,12,57,160,32,63,0,0
2081,286,159,341,314,16,11,12,55,155,33,63,0,0
2082,286,156,338,305,16,11,12,52,149,34,63,0,0
2083,288,154,338,301,16,11,12,50,147,35,63,0,0
2084,289,154,339,300,16,11,12,50,146,36,63,0,0
2085,291,152,339,293,16,11,12,48,141,37,63,0,0
2086,292,153,338,287,16,11,12,46,134,38,63,0,0
2087,289,152,334,286,16,11,12,45,134,39,63,0,0
2088,289,149,334,282,16,11,12,45,133,40,63,0,0
2089,291,150,335,280,16,11,12,44,130,41,63,0,0
2090,293,149,337,278,16,11,12,44,129,42,63,0,0
2091,295,148,338,276,16,11,12,43,128,43,63,0,0
2092,296,151,338,274,16,11,12,42,123,44,63,0,0
2093,294,149,336,272,16,11,12,42,123,45,63,0,0
2094,293,146,335,269,16,11,12,42,123,46,63,0,0
2095,293,146,335,268,16,11,12,42,122,47,63,0,0
2096,295,145,336,261,16,11,12,41,116,48,63,0,0
2097,295,144,335,259,16,11,12,40,115,49,63,0,0
2098,293,144,333,258,16,11,12,40,114,50,63,0,0
2099,292,142,331,256,16,11,12,39,114,51,63,0,0
2100,291,137,331,254,16,11,12,40,117,52,63,0,0
2101,292,140,330,251,16,11,12,38,111,53,63,0,0
2102,292,135,330,247,16,11,12,38,112,54,63,0,0
2103,292,134,330,245,16,11,12,38,111,55,63,0,0
2104,291,135,328,242,16,11,12,37,107,56,63,0,0
2105,291,135,326,240,16,11,12,35,105,57,63,0,0
2106,290,133,326,237,16,11,12,36,104,58,63,0,0
2107,293,134,329,237,16,11,12,36,103,59,63,0,0
2108,296,131,332,236,16,11,12,36,105,60,63,0,0
2109,297,130,332,234,16,11,12,35,104,61,63,0,0
2110,316,125,354,238,16,11,12,38,113,62,63,0,0
2111,319,123,357,236,16,11,12,38,113,63,63,1,0
2035,7,546,268,1033,17,11,12,261,487,0,89,0,1
2036,54,527,309,1000,17,11,12,255,473,1,89,0,0
2037,118,497,393,1008,17,11,12,275,511,2,89,0,0
2038,159,456,456,1015,17,11,12,297,559,3,89,0,0
2039,200,434,497,1000,17,11,12,297,566,4,89,0,0
2040,234,416,525,977,17,11,12,291,561,5,89,0,0
2041,262,385,540,931,17,11,12,278,546,6,89,0,0
2042,275,362,542,900,17,11,12,267,538,7,89,0,0
2043,286,294,539,815,17,11,12,253,521,8,89,0,0
2044,286,276,528,784,17,11,12,242,508,9,89,0,0
2045,278,262,518,778,17,11,12,240,516,10,89,0,0
2046,282,252,502,734,17,11,12,220,482,11,89,0,0
2047,287,251,492,712,17,11,12,205,461,12,89,0,0
2048,297,260,489,699,17,11,12,192,439,13,89,0,0
2049,323,256,495,657,17,11,12,172,401,14,89,0,0
2050,350,264,507,640,17,11,12,157,376,15,89,0,0
2051,366,257,514,620,17,11,12,148,363,16,89,0,0
2052,373,243,511,588,17,11,12,138,345,17,89,0,0
2053,377,240,508,575,17,11,12,131,335,18,89,0,0
2054,384,230,507,552,17,11,12,123,322,19,89,0,0
2055,385,220,502,531,17,11,12,117,311,20,89,0,0
2056,384,218,497,519,17,11,12,113,301,21,89,0,0
2057,387,212,493,500,17,11,12,106,288,22,89,0,0
2058,388,206,490,486,17,11,12,102,280,23,89,0,0
2059,391,207,489,477,17,11,12,98,270,24,89,0,0
2060,396,200,489,462,17,11,12,93,262,25,89,0,0
2061,397,200,486,451,17,11,12,89,251,26,89,0,0
2062,391,200,478,443,17,11,12,87,243,27,89,0,0
2063,387,197,471,434,17,11,12,84,237,28,89,0,0
2064,379,195,461,426,17,11,12,82,231,29,89,0,0
2065,374,195,453,420,17,11,12,79,225,30,89,0,0
2066,371,192,446,411,17,11,12,75,219,31,89,0,0
2067,367,191,440,402,17,11,12,73,211,32,89,0,0
2068,358,186,430,398,17,11,12,72,212,33,89,0,0
2069,349,178,421,389,17,11,12,72,211,34,89,0,0
2070,346,177,417,387,17,11,12,71,210,35,89,0,0
2071,343,176,412,380,17,11,12,69,204,36,89,0,0
2072,342,177,407,371,17,11,12,65,194,37,89,0,0
2073,337,175,401,366,17,11,12,64,191,38,89,0,0
2074,334,173,396,360,17,11,12,62,187,39,89,0,0
2075,330,173,390,354,17,11,12,60,181,40,89,0,0
2076,329,175,386,350,17,11,12,57,175,41,89,0,0
2077,329,177,383,341,17,11,12,54,164,42,89,0,0
2078,331,176,383,337,17,11,12,52,161,43,89,0,0
2079,332,176,383,337,17,11,12,51,161,44,89,0,0
2080,331,173,381,330,17,11,12,50,157,45,89,0,0
2081,330,169,380,326,17,11,12,50,157,46,89,0,0
2082,329,168,378,327,17,11,12,49,159,47,89,0,0
2083,331,162,379,319,17,11,12,48,157,48,89,0,0
2084,332,158,380,315,17,11,12,48,157,49,89,0,0
2085,333,159,380,313,17,11,12,47,154,50,89,0,0
2086,333,157,379,307,17,11,12,46,150,51,89,0,0
2087,334,155,379,303,17,11,12,45,148,52,89,0,0
2088,338,157,382,300,17,11,12,44,143,53,89,0,0
2089,341,153,384,295,17,11,12,43,142,54,89,0,0
2090,343,152,387,294,17,11,12,44,142,55,89,0,0
2091,344,151,387,290,17,11,12,43,139,56,89,0,0
2092,344,148,386,285,17,11,12,42,137,57,89,0,0
2093,345,149,386,280,17,11,12,41,131,58,89,0,0
2094,345,146,386,274,17,11,12,41,128,59,89,0,0
2095,345,144,386,272,17,11,12,41,128,60,89,0,0
2096,345,143,386,271,17,11,12,41,128,61,89,0,0
2097,345,144,385,270,17,11,12,40,126,62,89,0,0
2098,343,141,383,268,17,11,12,40,127,63,89,0,0
2099,342,143,381,267,17,11,12,39,124,64,89,0,0
2100,341,140,380,263,17,11,12,39,123,65,89,0,0
2101,338,144,375,260,17,11,12,37,116,66,89,0,0
2102,335,148,370,259,17,11,12,35,111,67,89,0,0
2103,331,144,366,256,17,11,12,35,112,68,89,0,0
2104,327,142,363,254,17,11,12,36,112,69,89,0,0
2105,326,139,362,253,17,11,12,36,114,70,89,0,0
2106,323,133,360,249,17,11,12,37,116,71,89,0,0
2107,324,135,359,247,17,11,12,35,112,72,89,0,0
2108,322,132,358,247,17,11,12,36,115,73,89,0,0
2109,314,127,352,244,17,11,12,38,117,74,89,0,0
2110,305,125,341,239,17,11,12,36,114,75,89,0,0
2111,302,122,340,236,17,11,12,38,114,76,89,0,0
2112,303,121,342,236,17,11,12,39,115,77,89,0,0
2113,305,121,345,237,17,11,12,40,116,78,89,0,0
2114,302,119,344,237,17,11,12,42,118,79,89,0,0
2115,300,119,342,236,17,11,12,42,117,80,89,0,0
2116,298,118,340,235,17,11,12,42,117,81,89,0,0
2117,298,121,339,233,17,11,12,41,112,82,89,0,0
2118,299,122,339,230,17,11,12,40,108,83,89,0,0
2119,295,121,335,228,17,11,12,40,107,84,89,0,0
2120,293,120,333,225,17,11,12,40,105,85,89,0,0
2121,297,121,335,223,17,11,12,38,102,86,89,0,0
2122,302,123,340,223,17,11,12,38,100,87,89,0,0
2123,306,122,342,221,17,11,12,36,99,88,89,0,0
2124,308,122,344,220,17,11,12,36,98,89,89,1,0
2042,341,290,487,500,18,11,12,146,210,0,0,0,0
2146,1874,433,1919,729,20,11,12,45,296,0,0,0,0
2148,1842,467,1919,737,21,11,12,77,270,0,17,0,0
2149,1832,456,1915,750,21,11,12,83,294,1,17,0,0
2150,1828,441,1918,755,21,11,12,90,314,2,17,0,0
2151,1827,435,1920,764,21,11,12,93,329,3,17,0,0
2152,1822,426,1920,782,21,11,12,98,356,4,17,0,0
2153,1823,435,1920,799,21,11,12,97,364,5,17,0,0
2154,1821,444,1920,809,21,11,12,99,365,6,17,0,0
2155,1806,432,1914,809,21,11,12,108,377,7,17,0,0
2156,1798,432,1907,808,21,11,12,109,376,8,17,0,0
2157,1794,435,1903,804,21,11,12,109,369,9,17,0,0
2158,1791,437,1900,791,21,11,12,109,354,10,17,0,0
2159,1789,430,1902,791,21,11,12,113,361,11,17,0,0
2160,1799,423,1912,782,21,11,12,113,359,12,17,0,0
2161,1816,434,1920,771,21,11,12,104,337,13,17,0,0
2162,1824,442,1920,755,21,11,12,96,313,14,17,0,0
2163,1830,449,1920,745,21,11,12,90,296,15,17,0,0
2164,1846,456,1920,722,21,11,12,74,266,16,17,0,0
2165,1850,458,1920,717,21,11,12,70,259,17,17,0,0
3243,1178,561,1686,1073,26,11,12,508,512,0,22,0,1
3244,1194,540,1708,1072,26,11,12,514,532,1,22,0,0
3245,1209,506,1738,1073,26,11,12,529,567,2,22,0,0
3246,1222,480,1754,1071,26,11,12,532,591,3,22,0,0
3247,1239,459,1770,1070,26,11,12,531,611,4,22,0,0
3248,1287,444,1786,1042,26,11,12,499,598,5,22,0,0
3249,1331,435,1788,1006,26,11,12,457,571,6,22,0,0
3250,1364,439,1788,985,26,11,12,424,546,7,22,0,0
3251,1424,433,1809,943,26,11,12,385,510,8,22,0,0
3252,1482,426,1838,916,26,11,12,356,490,9,22,0,0
3253,1520,426,1853,900,26,11,12,333,474,10,22,0,0
3254,1566,421,1871,871,26,11,12,305,450,11,22,0,0
3255,1604,415,1884,843,26,11,12,280,428,12,22,0,0
3256,1627,417,1891,830,26,11,12,264,413,13,22,0,0
3257,1657,409,1910,814,26,11,12,253,405,14,22,0,0
3258,1701,411,1920,802,26,11,12,219,391,15,22,0,0
3259,1727,420,1920,794,26,11,12,193,374,16,22,0,0
3260,1761,423,1920,766,26,11,12,159,343,17,22,0,0
3261,1780,430,1920,752,26,11,12,140,322,18,22,0,0
3262,1799,440,1920,735,26,11,12,121,295,19,22,0,0
3263,1814,433,1920,719,26,11,12,106,286,20,22,0,0
3264,1829,440,1920,721,26,11,12,91,281,21,22,0,0
3265,1846,438,1920,708,26,11,12,74,270,22,22,1,0
4679,310,113,350,185,28,11,12,40,72,0,0,0,0
190,891,208,941,429,1,11,13,50,221,0,0,0,0
191,827,203,925,430,2,11,13,98,227,0,80,0,1
192,807,202,906,430,2,11,13,99,228,1,80,0,0
193,777,191,877,425,2,11,13,100,234,2,80,0,0
194,741,187,839,417,2,11,13,98,230,3,80,0,0
195,711,195,804,410,2,11,13,93,215,4,80,0,0
196,679,184,774,406,2,11,13,95,222,5,80,0,0
197,646,182,740,405,2,11,13,94,223,6,80,0,0
198,627,177,715,390,2,11,13,88,213,7,80,0,0
199,608,173,692,378,2,11,13,84,205,8,80,0,0
200,578,171,664,380,2,11,13,86,209,9,80,0,0
201,562,170,649,383,2,11,13,87,213,10,80,0,0
202,549,169,631,373,2,11,13,82,204,11,80,0,0
203,533,167,614,373,2,11,13,81,206,12,80,0,0
204,524,163,600,359,2,11,13,76,196,13,80,0,0
205,510,158,586,353,2,11,13,76,195,14,80,0,0
206,504,156,576,344,2,11,13,72,188,15,80,0,0
207,499,153,569,338,2,11,13,70,185,16,80,0,0
208,494,154,562,336,2,11,13,68,182,17,80,0,0
209,492,155,558,333,2,11,13,66,178,18,80,0,0
210,489,151,554,327,2,11,13,65,176,19,80,0,0
211,484,149,549,326,2,11,13,65,177,20,80,0,0
212,483,147,545,319,2,11,13,62,172,21,80,0,0
213,482,145,544,314,2,11,13,62,169,22,80,0,0
214,483,145,543,309,2,11,13,60,164,23,80,0,0
215,486,144,546,304,2,11,13,60,160,24,80,0,0
216,488,142,548,303,2,11,13,60,161,25,80,0,0
217,490,143,548,299,2,11,13,58,156,26,80,0,0
218,492,141,550,297,2,11,13,58,156,27,80,0,0
219,495,141,550,292,2,11,13,55,151,28,80,0,0
220,500,140,554,290,2,11,13,54,150,29,80,0,0
221,507,135,561,284,2,11,13,54,149,30,80,0,0
222,512,135,563,280,2,11,13,51,145,31,80,0,0
223,517,135,568,279,2,11,13,51,144,32,80,0,0
224,521,133,572,278,2,11,13,51,145,33,80,0,0
225,524,137,573,277,2,11,13,49,140,34,80,0,0
226,526,137,576,276,2,11,13,50,139,35,80,0,0
227,525,137,575,276,2,11,13,50,139,36,80,0,0
228,525,137,576,276,2,11,13,51,139,37,80,0,0
229,524,137,576,276,2,11,13,52,139,38,80,0,0
230,525,139,576,276,2,11,13,51,137,39,80,0,0
231,525,139,576,277,2,11,13,51,138,40,80,0,0
232,525,139,577,278,2,11,13,52,139,41,80,0,0
233,525,139,578,278,2,11,13,53,139,42,80,0,0
234,525,139,578,278,2,11,13,53,139,43,80,0,0
235,524,139,579,279,2,11,13,55,140,44,80,0,0
236,523,138,578,279,2,11,13,55,141,45,80,0,0
237,523,138,578,278,2,11,13,55,140,46,80,0,0
238,523,139,579,279,2,11,13,56,140,47,80,0,0
239,522,138,578,279,2,11,13,56,141,48,80,0,0
240,522,138,579,279,2,11,13,57,141,49,80,0,0
241,523,136,581,279,2,11,13,58,143,50,80,0,0
242,522,136,581,279,2,11,13,59,143,51,80,0,0
243,521,136,580,279,2,11,13,59,143,52,80,0,0
244,521,136,580,279,2,11,13,59,143,53,80,0,0
245,521,136,580,279,2,11,13,59,143,54,80,0,0
246,521,137,580,279,2,11,13,59,142,55,80,0,0
247,521,137,580,279,2,11,13,59,142,56,80,0,0
248,520,137,580,279,2,11,13,60,142,57,80,0,0
249,520,137,580,279,2,11,13,60,142,58,80,0,0
250,520,137,581,279,2,11,13,61,142,59,80,0,0
251,519,135,580,279,2,11,13,61,144,60,80,0,0
252,519,133,581,279,2,11,13,62,146,61,80,0,0
253,518,131,581,280,2,11,13,63,149,62,80,0,0
254,516,135,578,279,2,11,13,62,144,63,80,0,0
255,512,134,574,279,2,11,13,62,145,64,80,0,0
256,508,145,563,275,2,11,13,55,130,65,80,0,0
257,507,147,558,272,2,11,13,51,125,66,80,0,0
258,506,142,559,271,2,11,13,53,129,67,80,0,0
259,514,138,567,271,2,11,13,53,133,68,80,0,0
260,515,143,565,270,2,11,13,50,127,69,80,0,0
261,515,143,565,269,2,11,13,50,126,70,80,0,0
262,518,154,560,266,2,11,13,42,112,71,80,0,0
263,519,152,561,265,2,11,13,42,113,72,80,0,0
264,520,150,561,265,2,11,13,41,115,73,80,0,0
265,523,149,564,266,2,11,13,41,117,74,80,0,0
266,523,151,562,266,2,11,13,39,115,75,80,0,0
267,527,150,568,271,2,11,13,41,121,76,80,0,0
268,529,152,569,271,2,11,13,40,119,77,80,0,0
269,523,156,562,271,2,11,13,39,115,78,80,0,0
270,521,158,558,269,2,11,13,37,111,79,80,0,0
271,521,159,558,268,2,11,13,37,109,80,80,1,0
275,527,149,569,271,2,11,13,42,122,0,80,0,1
276,523,154,562,269,2,11,13,39,115,1,80,0,0
277,523,154,562,269,2,11,13,39,115,2,80,0,0
278,521,146,561,267,2,11,13,40,121,3,80,0,0
279,515,149,555,270,2,11,13,40,121,4,80,0,0
280,512,149,552,270,2,11,13,40,121,5,80,0,0
281,510,150,550,269,2,11,13,40,119,6,80,0,0
282,505,144,547,269,2,11,13,42,125,7,80,0,0
283,503,138,546,268,2,11,13,43,130,8,80,0,0
284,502,139,544,266,2,11,13,42,127,9,80,0,0
285,501,139,543,267,2,11,13,42,128,10,80,0,0
286,500,138,543,270,2,11,13,43,132,11,80,0,0
287,499,138,543,272,2,11,13,44,134,12,80,0,0
288,498,135,543,272,2,11,13,45,137,13,80,0,0
289,498,134,542,270,2,11,13,44,136,14,80,0,0
290,499,137,541,269,2,11,13,42,132,15,80,0,0
291,497,141,537,271,2,11,13,40,130,16,80,0,0
292,496,142,535,269,2,11,13,39,127,17,80,0,0
293,497,141,537,269,2,11,13,40,128,18,80,0,0
294,499,139,540,268,2,11,13,41,129,19,80,0,0
295,494,136,537,269,2,11,13,43,133,20,80,0,0
296,492,133,536,269,2,11,13,44,136,21,80,0,0
297,489,131,534,269,2,11,13,45,138,22,80,0,0
298,487,130,532,268,2,11,13,45,138,23,80,0,0
299,486,132,530,268,2,11,13,44,136,24,80,0,0
300,484,133,527,268,2,11,13,43,135,25,80,0,0
301,484,134,527,268,2,11,13,43,134,26,80,0,0
302,484,133,527,268,2,11,13,43,135,27,80,0,0
303,484,133,527,268,2,11,13,43,135,28,80,0,0
304,484,133,527,267,2,11,13,43,134,29,80,0,0
305,484,132,527,267,2,11,13,43,135,30,80,0,0
306,483,130,528,266,2,11,13,45,136,31,80,0,0
307,484,130,529,265,2,11,13,45,135,32,80,0,0
308,485,128,530,266,2,11,13,45,138,33,80,0,0
309,485,128,530,266,2,11,13,45,138,34,80,0,0
310,485,128,529,265,2,11,13,44,137,35,80,0,0
311,484,127,530,267,2,11,13,46,140,36,80,0,0
312,485,127,530,265,2,11,13,45,138,37,80,0,0
313,486,128,530,263,2,11,13,44,135,38,80,0,0
314,486,129,530,263,2,11,13,44,134,39,80,0,0
315,489,131,533,261,2,11,13,44,130,40,80,0,0
316,492,131,537,263,2,11,13,45,132,41,80,0,0
317,494,131,538,262,2,11,13,44,131,42,80,0,0
318,492,131,536,260,2,11,13,44,129,43,80,0,0
319,487,131,531,258,2,11,13,44,127,44,80,0,0
320,481,132,524,257,2,11,13,43,125,45,80,0,0
321,474,131,517,257,2,11,13,43,126,46,80,0,0
322,469,134,511,257,2,11,13,42,123,47,80,0,0
323,465,132,507,258,2,11,13,42,126,48,80,0,0
324,462,132,503,254,2,11,13,41,122,49,80,0,0
325,453,136,493,253,2,11,13,40,117,50,80,0,0
326,444,135,485,252,2,11,13,41,117,51,80,0,0
327,438,131,479,250,2,11,13,41,119,52,80,0,0
328,433,129,475,249,2,11,13,42,120,53,80,0,0
329,430,129,471,248,2,11,13,41,119,54,80,0,0
330,425,128,466,249,2,11,13,41,121,55,80,0,0
331,421,128,462,248,2,11,13,41,120,56,80,0,0
338,429,131,468,247,2,11,13,39,116,0,80,0,1
339,429,134,469,249,2,11,13,40,115,1,80,0,0
340,430,132,471,249,2,11,13,41,117,2,80,0,0
341,431,134,472,251,2,11,13,41,117,3,80,0,0
342,428,132,471,253,2,11,13,43,121,4,80,0,0
343,426,131,471,255,2,11,13,45,124,5,80,0,0
344,427,133,472,256,2,11,13,45,123,6,80,0,0
345,432,143,475,259,2,11,13,43,116,7,80,0,0
346,437,144,481,259,2,11,13,44,115,8,80,0,0
347,443,140,490,264,2,11,13,47,124,9,80,0,0
348,448,141,495,264,2,11,13,47,123,10,80,0,0
349,451,139,499,267,2,11,13,48,128,11,80,0,0
350,455,137,503,267,2,11,13,48,130,12,80,0,0
351,460,135,508,268,2,11,13,48,133,13,80,0,0
352,464,136,513,269,2,11,13,49,133,14,80,0,0
353,471,135,522,271,2,11,13,51,136,15,80,0,0
354,481,134,533,272,2,11,13,52,138,16,80,0,0
355,487,138,539,279,2,11,13,52,141,17,80,0,0
356,497,138,550,280,2,11,13,53,142,18,80,0,0
357,511,135,565,279,2,11,13,54,144,19,80,0,0
358,519,134,575,282,2,11,13,56,148,20,80,0,0
359,524,136,580,283,2,11,13,56,147,21,80,0,0
360,533,134,590,283,2,11,13,57,149,22,80,0,0
361,547,137,603,284,2,11,13,56,147,23,80,0,0
362,552,131,611,286,2,11,13,59,155,24,80,0,0
363,565,142,618,284,2,11,13,53,142,25,80,0,0
364,572,142,625,285,2,11,13,53,143,26,80,0,0
195,734,199,781,273,3,11,13,47,74,0,0,0,0
216,542,173,580,277,4,11,13,38,104,0,1,0,0
217,541,168,581,278,4,11,13,40,110,1,1,0,0
219,540,150,580,279,5,11,13,40,129,0,1,0,0
220,537,144,579,279,5,11,13,42,135,1,1,0,0
256,542,158,577,274,6,11,13,35,116,0,3,0,0
257,539,149,577,274,6,11,13,38,125,1,3,0,0
258,538,140,579,277,6,11,13,41,137,2,3,0,0
259,537,135,580,278,6,11,13,43,143,3,3,0,0
328,657,446,877,1052,8,11,13,220,606,0,61,0,1
329,664,437,883,1041,8,11,13,219,604,1,61,0,0
330,668,410,882,999,8,11,13,214,589,2,61,0,0
331,671,389,862,914,8,11,13,191,525,3,61,0,0
332,666,377,851,883,8,11,13,185,506,4,61,0,0
333,650,358,824,830,8,11,13,174,472,5,61,0,0
334,645,343,812,794,8,11,13,167,451,6,61,0,0
335,638,329,805,783,8,11,13,167,454,7,61,0,0
336,646,314,802,735,8,11,13,156,421,8,61,0,0
337,643,304,789,699,8,11,13,146,395,9,61,0,0
338,632,298,774,686,8,11,13,142,388,10,61,0,0
339,631,286,768,660,8,11,13,137,374,11,61,0,0
340,628,278,764,651,8,11,13,136,373,12,61,0,0
341,636,273,766,628,8,11,13,130,355,13,61,0,0
342,642,262,769,605,8,11,13,127,343,14,61,0,0
343,645,258,770,595,8,11,13,125,337,15,61,0,0
344,645,252,767,582,8,11,13,122,330,16,61,0,0
345,653,245,769,559,8,11,13,116,314,17,61,0,0
346,658,243,771,547,8,11,13,113,304,18,61,0,0
347,668,243,779,540,8,11,13,111,297,19,61,0,0
348,682,239,794,536,8,11,13,112,297,20,61,0,0
349,705,239,816,532,8,11,13,111,293,21,61,0,0
350,724,240,832,525,8,11,13,108,285,22,61,0,0
351,739,236,845,517,8,11,13,106,281,23,61,0,0
352,756,234,858,506,8,11,13,102,272,24,61,0,0
353,766,233,867,501,8,11,13,101,268,25,61,0,0
354,782,235,881,493,8,11,13,99,258,26,61,0,0
355,805,234,902,484,8,11,13,97,250,27,61,0,0
356,823,234,919,481,8,11,13,96,247,28,61,0,0
357,832,232,927,481,8,11,13,95,249,29,61,0,0
358,838,233,930,475,8,11,13,92,242,30,61,0,0
359,836,232,929,475,8,11,13,93,243,31,61,0,0
360,836,232,931,476,8,11,13,95,244,32,61,0,0
361,836,233,932,478,8,11,13,96,245,33,61,0,0
362,832,238,927,481,8,11,13,95,243,34,61,0,0
363,824,244,918,482,8,11,13,94,238,35,61,0,0
364,818,249,916,497,8,11,13,98,248,36,61,0,0
365,813,252,917,511,8,11,13,104,259,37,61,0,0
366,810,251,916,517,8,11,13,106,266,38,61,0,0
367,802,256,911,525,8,11,13,109,269,39,61,0,0
368,793,261,904,533,8,11,13,111,272,40,61,0,0
369,785,259,901,541,8,11,13,116,282,41,61,0,0
370,779,260,904,566,8,11,13,125,306,42,61,0,0
371,782,267,910,581,8,11,13,128,314,43,61,0,0
372,780,269,910,584,8,11,13,130,315,44,61,0,0
373,774,271,907,588,8,11,13,133,317,45,61,0,0
374,767,270,900,588,8,11,13,133,318,46,61,0,0
375,767,266,899,584,8,11,13,132,318,47,61,0,0
376,759,280,881,578,8,11,13,122,298,48,61,0,0
377,758,267,884,579,8,11,13,126,312,49,61,0,0
378,763,260,890,578,8,11,13,127,318,50,61,0,0
379,777,255,899,564,8,11,13,122,309,51,61,0,0
380,789,256,907,552,8,11,13,118,296,52,61,0,0
381,806,253,921,540,8,11,13,115,287,53,61,0,0
382,821,253,931,533,8,11,13,110,280,54,61,0,0
383,830,251,937,529,8,11,13,107,278,55,61,0,0
384,841,248,940,508,8,11,13,99,260,56,61,0,0
385,850,245,945,503,8,11,13,95,258,57,61,0,0
386,854,242,948,502,8,11,13,94,260,58,61,0,0
387,862,243,950,495,8,11,13,88,252,59,61,0,0
388,875,244,953,475,8,11,13,78,231,60,61,0,0
389,882,243,957,468,8,11,13,75,225,61,61,1,0
394,874,252,944,463,8,11,13,70,211,0,61,0,1
395,868,258,936,469,8,11,13,68,211,1,61,0,0
396,860,246,935,475,8,11,13,75,229,2,61,0,0
397,856,240,935,478,8,11,13,79,238,3,61,0,0
398,853,240,933,477,8,11,13,80,237,4,61,0,0
399,843,243,927,486,8,11,13,84,243,5,61,0,0
400,833,248,921,492,8,11,13,88,244,6,61,0,0
401,823,248,914,496,8,11,13,91,248,7,61,0,0
402,813,248,911,506,8,11,13,98,258,8,61,0,0
403,808,249,912,522,8,11,13,104,273,9,61,0,0
404,806,251,913,529,8,11,13,107,278,10,61,0,0
405,801,254,916,549,8,11,13,115,295,11,61,0,0
406,798,260,917,563,8,11,13,119,303,12,61,0,0
407,794,264,915,571,8,11,13,121,307,13,61,0,0
408,789,271,916,590,8,11,13,127,319,14,61,0,0
409,783,278,915,606,8,11,13,132,328,15,61,0,0
410,781,286,914,614,8,11,13,133,328,16,61,0,0
411,783,295,922,640,8,11,13,139,345,17,61,0,0
412,793,301,938,658,8,11,13,145,357,18,61,0,0
413,807,308,960,682,8,11,13,153,374,19,61,0,0
414,821,324,985,720,8,11,13,164,396,20,61,0,0
415,835,335,1004,734,8,11,13,169,399,21,61,0,0
416,849,347,1027,773,8,11,13,178,426,22,61,0,0
417,863,366,1049,808,8,11,13,186,442,23,61,0,0
418,891,370,1084,827,8,11,13,193,457,24,61,0,0
419,916,402,1125,890,8,11,13,209,488,25,61,0,0
420,939,423,1155,929,8,11,13,216,506,26,61,0,0
421,965,440,1187,958,8,11,13,222,518,27,61,0,0
422,989,480,1223,1025,8,11,13,234,545,28,61,0,0
423,1035,509,1272,1054,8,11,13,237,545,29,61,0,0
424,1091,537,1331,1075,8,11,13,240,538,30,61,0,0
425,1150,578,1376,1065,8,11,13,226,487,31,61,0,0
426,1221,616,1442,1076,8,11,13,221,460,32,61,0,0
427,1296,657,1512,1080,8,11,13,216,423,33,61,0,0
428,1371,704,1580,1080,8,11,13,209,376,34,61,0,0
429,1496,758,1688,1080,8,11,13,192,322,35,61,0,0
430,1572,822,1750,1080,8,11,13,178,258,36,61,0,0
431,1633,857,1795,1080,8,11,13,162,223,37,61,0,0
376,800,261,884,422,10,11,13,84,161,0,0,0,0
687,573,141,611,287,12,11,13,38,146,0,97,0,1
688,563,134,602,281,12,11,13,39,147,1,97,0,0
689,548,136,586,281,12,11,13,38,145,2,97,0,0
690,532,135,572,287,12,11,13,40,152,3,97,0,0
691,522,136,561,282,12,11,13,39,146,4,97,0,0
692,509,137,548,281,12,11,13,39,144,5,97,0,0
693,494,137,534,279,12,11,13,40,142,6,97,0,0
694,484,137,524,276,12,11,13,40,139,7,97,0,0
695,474,135,514,273,12,11,13,40,138,8,97,0,0
696,461,137,502,272,12,11,13,41,135,9,97,0,0
697,452,132,493,269,12,11,13,41,137,10,97,0,0
698,445,131,487,271,12,11,13,42,140,11,97,0,0
699,440,134,480,267,12,11,13,40,133,12,97,0,0
700,437,138,476,259,12,11,13,39,121,13,97,0,0
701,433,136,472,257,12,11,13,39,121,14,97,0,0
702,428,135,467,254,12,11,13,39,119,15,97,0,0
703,420,134,459,254,12,11,13,39,120,16,97,0,0
704,415,131,454,252,12,11,13,39,121,17,97,0,0
705,411,133,450,251,12,11,13,39,118,18,97,0,0
706,406,133,445,250,12,11,13,39,117,19,97,0,0
707,402,130,442,248,12,11,13,40,118,20,97,0,0
708,396,127,437,248,12,11,13,41,121,21,97,0,0
709,392,126,433,248,12,11,13,41,122,22,97,0,0
710,390,125,431,249,12,11,13,41,124,23,97,0,0
711,390,125,431,248,12,11,13,41,123,24,97,0,0
712,390,125,430,248,12,11,13,40,123,25,97,0,0
713,390,126,430,248,12,11,13,40,122,26,97,0,0
714,390,126,431,248,12,11,13,41,122,27,97,0,0
715,391,127,431,248,12,11,13,40,121,28,97,0,0
716,390,126,431,249,12,11,13,41,123,29,97,0,0
717,390,125,431,249,12,11,13,41,124,30,97,0,0
718,389,127,430,248,12,11,13,41,121,31,97,0,0
719,389,127,430,248,12,11,13,41,121,32,97,0,0
720,388,125,430,249,12,11,13,42,124,33,97,0,0
721,388,124,430,249,12,11,13,42,125,34,97,0,0
722,390,124,432,248,12,11,13,42,124,35,97,0,0
723,393,124,435,249,12,11,13,42,125,36,97,0,0
724,397,128,438,250,12,11,13,41,122,37,97,0,0
725,403,128,444,250,12,11,13,41,122,38,97,0,0
726,411,135,450,250,12,11,13,39,115,39,97,0,0
727,414,139,453,251,12,11,13,39,112,40,97,0,0
728,421,146,459,251,12,11,13,38,105,41,97,0,0
729,433,145,473,254,12,11,13,40,109,42,97,0,0
730,442,146,481,255,12,11,13,39,109,43,97,0,0
731,448,148,487,255,12,11,13,39,107,44,97,0,0
732,453,145,493,255,12,11,13,40,110,45,97,0,0
733,460,147,499,257,12,11,13,39,110,46,97,0,0
734,464,149,504,260,12,11,13,40,111,47,97,0,0
735,470,145,513,262,12,11,13,43,117,48,97,0,0
736,477,140,523,266,12,11,13,46,126,49,97,0,0
737,482,140,529,267,12,11,13,47,127,50,97,0,0
738,487,138,534,266,12,11,13,47,128,51,97,0,0
739,490,134,540,269,12,11,13,50,135,52,97,0,0
740,493,135,544,272,12,11,13,51,137,53,97,0,0
741,496,138,547,277,12,11,13,51,139,54,97,0,0
742,499,139,551,281,12,11,13,52,142,55,97,0,0
743,503,140,556,285,12,11,13,53,145,56,97,0,0
744,506,142,559,288,12,11,13,53,146,57,97,0,0
745,507,141,559,287,12,11,13,52,146,58,97,0,0
746,509,143,561,290,12,11,13,52,147,59,97,0,0
747,513,145,565,292,12,11,13,52,147,60,97,0,0
748,517,143,572,297,12,11,13,55,154,61,97,0,0
749,519,145,574,301,12,11,13,55,156,62,97,0,0
750,518,148,574,306,12,11,13,56,158,63,97,0,0
751,519,147,575,308,12,11,13,56,161,64,97,0,0
752,517,148,576,314,12,11,13,59,166,65,97,0,0
753,520,149,578,313,12,11,13,58,164,66,97,0,0
754,522,149,581,318,12,11,13,59,169,67,97,0,0
755,520,150,582,324,12,11,13,62,174,68,97,0,0
756,518,152,581,330,12,11,13,63,178,69,97,0,0
757,516,152,580,335,12,11,13,64,183,70,97,0,0
758,515,154,581,345,12,11,13,66,191,71,97,0,0
759,515,155,582,349,12,11,13,67,194,72,97,0,0
760,517,152,586,351,12,11,13,69,199,73,97,0,0
761,520,157,589,355,12,11,13,69,198,74,97,0,0
762,522,164,590,362,12,11,13,68,198,75,97,0,0
763,524,165,592,364,12,11,13,68,199,76,97,0,0
764,527,169,597,370,12,11,13,70,201,77,97,0,0
765,536,175,603,369,12,11,13,67,194,78,97,0,0
766,548,175,617,374,12,11,13,69,199,79,97,0,0
767,556,177,626,383,12,11,13,70,206,80,97,0,0
768,563,180,633,390,12,11,13,70,210,81,97,0,0
769,571,180,642,396,12,11,13,71,216,82,97,0,0
770,579,182,653,403,12,11,13,74,221,83,97,0,0
771,589,196,664,410,12,11,13,75,214,84,97,0,0
772,607,200,683,410,12,11,13,76,210,85,97,0,0
773,627,203,703,413,12,11,13,76,210,86,97,0,0
774,639,205,717,422,12,11,13,78,217,87,97,0,0
775,657,206,734,423,12,11,13,77,217,88,97,0,0
776,672,217,748,426,12,11,13,76,209,89,97,0,0
777,685,208,769,435,12,11,13,84,227,90,97,0,0
778,722,221,802,437,12,11,13,80,216,91,97,0,0
779,748,214,833,445,12,11,13,85,231,92,97,0,0
780,765,216,854,452,12,11,13,89,236,93,97,0,0
781,806,223,893,453,12,11,13,87,230,94,97,0,0
782,831,224,920,457,12,11,13,89,233,95,97,0,0
783,844,236,933,461,12,11,13,89,225,96,97,0,0
784,862,240,951,466,12,11,13,89,226,97,97,1,0
1214,545,156,580,262,14,11,13,35,106,0,0,0,0
1215,511,155,558,265,15,11,13,47,110,0,59,0,1
1216,498,148,548,265,15,11,13,50,117,1,59,0,0
1217,485,149,537,272,15,11,13,52,123,2,59,0,0
1218,475,148,529,274,15,11,13,54,126,3,59,0,0
1219,464,148,520,279,15,11,13,56,131,4,59,0,0
1220,459,152,515,283,15,11,13,56,131,5,59,0,0
1221,454,150,512,286,15,11,13,58,136,6,59,0,0
1222,450,152,510,293,15,11,13,60,141,7,59,0,0
1223,448,153,507,293,15,11,13,59,140,8,59,0,0
1224,442,156,501,297,15,11,13,59,141,9,59,0,0
1225,438,163,495,301,15,11,13,57,138,10,59,0,0
1226,436,161,495,305,15,11,13,59,144,11,59,0,0
1227,437,164,497,311,15,11,13,60,147,12,59,0,0
1228,437,168,498,317,15,11,13,61,149,13,59,0,0
1229,432,166,496,322,15,11,13,64,156,14,59,0,0
1230,430,171,494,327,15,11,13,64,156,15,59,0,0
1231,429,172,494,332,15,11,13,65,160,16,59,0,0
1232,429,173,496,338,15,11,13,67,165,17,59,0,0
1233,427,175,497,348,15,11,13,70,173,18,59,0,0
1234,422,176,494,355,15,11,13,72,179,19,59,0,0
1235,418,182,490,362,15,11,13,72,180,20,59,0,0
1236,416,182,490,367,15,11,13,74,185,21,59,0,0
1237,418,186,494,377,15,11,13,76,191,22,59,0,0
1238,419,192,498,388,15,11,13,79,196,23,59,0,0
1239,416,192,496,392,15,11,13,80,200,24,59,0,0
1240,414,198,495,405,15,11,13,81,207,25,59,0,0
1241,413,198,496,410,15,11,13,83,212,26,59,0,0
1242,417,200,506,426,15,11,13,89,226,27,59,0,0
1243,421,207,511,436,15,11,13,90,229,28,59,0,0
1244,418,208,511,446,15,11,13,93,238,29,59,0,0
1245,417,219,513,467,15,11,13,96,248,30,59,0,0
1246,416,218,516,478,15,11,13,100,260,31,59,0,0
1247,421,226,524,494,15,11,13,103,268,32,59,0,0
1248,429,235,535,507,15,11,13,106,272,33,59,0,0
1249,427,238,535,517,15,11,13,108,279,34,59,0,0
1250,422,251,537,545,15,11,13,115,294,35,59,0,0
1251,422,256,540,557,15,11,13,118,301,36,59,0,0
1252,429,264,555,583,15,11,13,126,319,37,59,0,0
1253,435,277,566,606,15,11,13,131,329,38,59,0,0
1254,432,281,568,624,15,11,13,136,343,39,59,0,0
1255,424,297,570,665,15,11,13,146,368,40,59,0,0
1256,417,311,569,694,15,11,13,152,383,41,59,0,0
1257,413,318,578,725,15,11,13,165,407,42,59,0,0
1258,391,333,578,782,15,11,13,187,449,43,59,0,0
1259,374,342,575,803,15,11,13,201,461,44,59,0,0
1260,340,347,562,843,15,11,13,222,496,45,59,0,0
1261,319,364,557,887,15,11,13,238,523,46,59,0,0
1262,329,374,571,904,15,11,13,242,530,47,59,0,0
1263,353,383,600,931,15,11,13,247,548,48,59,0,0
1264,345,391,599,945,15,11,13,254,554,49,59,0,0
1265,373,399,624,949,15,11,13,251,550,50,59,0,0
1266,416,409,653,943,15,11,13,237,534,51,59,0,0
1267,440,411,670,952,15,11,13,230,541,52,59,0,0
1268,456,406,680,947,15,11,13,224,541,53,59,0,0
1269,449,417,670,957,15,11,13,221,540,54,59,0,0
1270,426,444,646,985,15,11,13,220,541,55,59,0,0
1271,379,450,602,1004,15,11,13,223,554,56,59,0,0
1272,326,457,553,1019,15,11,13,227,562,57,59,0,0
1273,297,516,507,1022,15,11,13,210,506,58,59,0,0
1274,287,530,497,1037,15,11,13,210,507,59,59,1,0
1986,534,126,581,272,16,11,13,47,146,0,11,0,0
1987,521,134,563,264,16,11,13,42,130,1,11,0,0
1988,501,130,541,253,16,11,13,40,123,2,11,0,0
1989,482,129,522,252,16,11,13,40,123,3,11,0,0
1990,465,129,507,258,16,11,13,42,129,4,11,0,0
1991,444,130,487,261,16,11,13,43,131,5,11,0,0
1992,427,129,471,261,16,11,13,44,132,6,11,0,0
1993,401,124,447,259,16,11,13,46,135,7,11,0,0
1994,379,125,426,259,16,11,13,47,134,8,11,0,0
1995,361,124,408,259,16,11,13,47,135,9,11,0,0
1996,348,123,395,256,16,11,13,47,133,10,11,0,0
1997,330,122,378,256,16,11,13,48,134,11,11,0,0
2006,301,331,415,766,17,11,13,114,435,0,19,0,1
2007,318,313,436,766,17,11,13,118,453,1,19,0,0
2008,381,318,504,776,17,11,13,123,458,2,19,0,0
2009,411,321,541,787,17,11,13,130,466,3,19,0,0
2010,468,320,602,797,17,11,13,134,477,4,19,0,0
2011,527,343,680,867,17,11,13,153,524,5,19,0,0
2012,593,363,749,891,17,11,13,156,528,6,19,0,0
2013,638,378,799,922,17,11,13,161,544,7,19,0,0
2014,680,411,854,992,17,11,13,174,581,8,19,0,0
2015,730,426,914,1026,17,11,13,184,600,9,19,0,0
2016,757,445,956,1068,17,11,13,199,623,10,19,0,0
2017,835,488,1041,1078,17,11,13,206,590,11,19,0,0
2018,903,524,1103,1080,17,11,13,200,556,12,19,0,0
2019,959,572,1152,1080,17,11,13,193,508,13,19,0,0
2020,1082,640,1261,1080,17,11,13,179,440,14,19,0,0
2021,1209,694,1379,1080,17,11,13,170,386,15,19,0,0
2022,1332,775,1488,1080,17,11,13,156,305,16,19,0,0
2023,1494,835,1637,1075,17,11,13,143,240,17,19,0,0
2024,1672,909,1789,1078,17,11,13,117,169,18,19,0,0
2025,1798,960,1885,1080,17,11,13,87,120,19,19,0,0
2010,290,326,390,778,18,11,13,100,452,0,17,0,0
2011,302,317,402,770,18,11,13,100,453,1,17,0,0
2012,349,323,450,770,18,11,13,101,447,2,17,0,0
2013,396,337,504,797,18,11,13,108,460,3,17,0,0
2014,446,339,560,817,18,11,13,114,478,4,17,0,0
2015,486,348,613,873,18,11,13,127,525,5,17,0,0
2016,530,368,665,910,18,11,13,135,542,6,17,0,0
2017,573,385,712,923,18,11,13,139,538,7,17,0,0
2018,621,408,776,983,18,11,13,155,575,8,17,0,0
2019,660,436,825,1030,18,11,13,165,594,9,17,0,0
2020,711,449,886,1065,18,11,13,175,616,10,17,0,0
2021,767,482,944,1076,18,11,13,177,594,11,17,0,0
2022,833,520,1008,1079,18,11,13,175,559,12,17,0,0
2023,902,555,1079,1080,18,11,13,177,525,13,17,0,0
2024,985,614,1153,1080,18,11,13,168,466,14,17,0,0
2025,1099,657,1264,1077,18,11,13,165,420,15,17,0,0
2026,1208,712,1371,1078,18,11,13,163,366,16,17,0,0
2027,1281,743,1437,1080,18,11,13,156,337,17,17,0,0
3161,343,142,381,251,21,11,13,38,109,0,0,0,0
3164,405,142,443,259,23,11,13,38,117,0,0,0,0
3168,478,146,528,256,26,11,13,50,110,0,4,0,0
3169,497,148,546,255,26,11,13,49,107,1,4,0,0
3170,516,148,567,261,26,11,13,51,113,2,4,0,0
3171,534,148,588,269,26,11,13,54,121,3,4,0,0
3172,546,148,603,274,26,11,13,57,126,4,4,0,0
3465,339,134,383,259,27,11,13,44,125,0,11,0,0
3466,352,137,396,262,27,11,13,44,125,1,11,0,0
3467,367,134,413,265,27,11,13,46,131,2,11,0,0
3468,383,136,430,266,27,11,13,47,130,3,11,0,0
3469,405,136,452,266,27,11,13,47,130,4,11,0,0
3470,427,136,474,262,27,11,13,47,126,5,11,0,0
3471,449,137,497,265,27,11,13,48,128,6,11,0,0
3472,470,139,517,264,27,11,13,47,125,7,11,0,0
3473,489,135,538,264,27,11,13,49,129,8,11,0,0
3474,504,141,552,265,27,11,13,48,124,9,11,0,0
3475,528,138,578,267,27,11,13,50,129,10,11,0,0
3476,547,138,597,268,27,11,13,50,130,11,11,0,0
4483,524,146,568,251,28,11,13,44,105,0,13,0,0
4484,502,145,548,255,28,11,13,46,110,1,13,0,0
4485,492,139,540,253,28,11,13,48,114,2,13,0,0
4486,472,138,521,255,28,11,13,49,117,3,13,0,0
4487,457,138,507,257,28,11,13,50,119,4,13,0,0
4488,441,143,488,254,28,11,13,47,111,5,13,0,0
4489,418,137,468,254,28,11,13,50,117,6,13,0,0
4490,402,131,453,253,28,11,13,51,122,7,13,0,0
4491,385,128,437,255,28,11,13,52,127,8,13,0,0
4492,368,130,419,254,28,11,13,51,124,9,13,0,0
4493,352,129,402,252,28,11,13,50,123,10,13,0,0
4494,337,129,386,251,28,11,13,49,122,11,13,0,0
4495,328,133,374,249,28,11,13,46,116,12,13,0,0
4496,313,132,359,249,28,11,13,46,117,13,13,0,0
4910,868,233,933,508,29,11,13,65,275,0,38,0,1
4911,843,230,908,503,29,11,13,65,273,1,38,0,0
4912,823,222,887,488,29,11,13,64,266,2,38,0,0
4913,780,215,848,485,29,11,13,68,270,3,38,0,0
4914,753,206,820,469,29,11,13,67,263,4,38,0,0
4915,732,202,799,460,29,11,13,67,258,5,38,0,0
4916,705,201,774,451,29,11,13,69,250,6,38,0,0
4917,687,195,752,429,29,11,13,65,234,7,38,0,0
4918,659,188,727,426,29,11,13,68,238,8,38,0,0
4919,640,183,707,415,29,11,13,67,232,9,38,0,0
4920,627,175,695,405,29,11,13,68,230,10,38,0,0
4921,616,175,683,393,29,11,13,67,218,11,38,0,0
4922,607,172,674,384,29,11,13,67,212,12,38,0,0
4923,596,167,663,380,29,11,13,67,213,13,38,0,0
4924,586,167,653,377,29,11,13,67,210,14,38,0,0
4925,577,161,643,367,29,11,13,66,206,15,38,0,0
4926,574,160,641,367,29,11,13,67,207,16,38,0,0
4927,569,161,636,364,29,11,13,67,203,17,38,0,0
4928,560,157,625,353,29,11,13,65,196,18,38,0,0
4929,548,156,612,346,29,11,13,64,190,19,38,0,0
4930,541,151,603,339,29,11,13,62,188,20,38,0,0
4931,534,148,595,334,29,11,13,61,186,21,38,0,0
4932,530,149,589,327,29,11,13,59,178,22,38,0,0
4933,525,144,582,316,29,11,13,57,172,23,38,0,0
4934,518,143,573,309,29,11,13,55,166,24,38,0,0
4935,512,142,567,306,29,11,13,55,164,25,38,0,0
4936,506,141,560,303,29,11,13,54,162,26,38,0,0
4937,501,142,554,299,29,11,13,53,157,27,38,0,0
4938,496,140,549,295,29,11,13,53,155,28,38,0,0
4939,493,139,545,293,29,11,13,52,154,29,38,0,0
4940,488,137,540,290,29,11,13,52,153,30,38,0,0
4941,487,132,540,287,29,11,13,53,155,31,38,0,0
4942,489,132,540,282,29,11,13,51,150,32,38,0,0
4943,492,132,543,280,29,11,13,51,148,33,38,0,0
4944,496,131,547,277,29,11,13,51,146,34,38,0,0
4945,503,133,552,272,29,11,13,49,139,35,38,0,0
4946,515,131,561,262,29,11,13,46,131,36,38,0,0
4947,525,130,572,262,29,11,13,47,132,37,38,0,0
4948,526,129,572,257,29,11,13,46,128,38,38,1,0
82,2,506,76,781,1,11,14,74,275,0,90,0,1
83,0,499,80,814,1,11,14,80,315,1,90,0,0
84,8,482,90,787,1,11,14,82,305,2,90,0,0
85,15,464,113,823,1,11,14,98,359,3,90,0,0
86,50,466,156,833,1,11,14,106,367,4,90,0,0
87,77,460,193,842,1,11,14,116,382,5,90,0,0
88,96,450,222,856,1,11,14,126,406,6,90,0,0
89,132,450,264,864,1,11,14,132,414,7,90,0,0
90,169,456,309,882,1,11,14,140,426,8,90,0,0
91,202,449,354,890,1,11,14,152,441,9,90,0,0
92,263,455,425,900,1,11,14,162,445,10,90,0,0
93,305,448,476,904,1,11,14,171,456,11,90,0,0
94,348,442,537,933,1,11,14,189,491,12,90,0,0
95,404,444,607,963,1,11,14,203,519,13,90,0,0
96,445,439,655,974,1,11,14,210,535,14,90,0,0
97,529,440,750,979,1,11,14,221,539,15,90,0,0
98,595,439,821,975,1,11,14,226,536,16,90,0,0
99,670,423,903,978,1,11,14,233,555,17,90,0,0
100,771,416,1009,970,1,11,14,238,554,18,90,0,0
101,843,408,1083,962,1,11,14,240,554,19,90,0,0
102,908,392,1147,963,1,11,14,239,571,20,90,0,0
103,979,386,1218,962,1,11,14,239,576,21,90,0,0
104,1041,367,1276,941,1,11,14,235,574,22,90,0,0
105,1106,348,1335,912,1,11,14,229,564,23,90,0,0
106,1170,347,1383,871,1,11,14,213,524,24,90,0,0
107,1219,327,1420,827,1,11,14,201,500,25,90,0,0
108,1257,312,1458,811,1,11,14,201,499,26,90,0,0
109,1297,317,1488,787,1,11,14,191,470,27,90,0,0
110,1327,298,1507,741,1,11,14,180,443,28,90,0,0
111,1351,292,1522,714,1,11,14,171,422,29,90,0,0
112,1368,290,1532,698,1,11,14,164,408,30,90,0,0
113,1393,279,1548,670,1,11,14,155,391,31,90,0,0
114,1409,274,1561,656,1,11,14,152,382,32,90,0,0
115,1430,271,1577,646,1,11,14,147,375,33,90,0,0
116,1446,257,1584,612,1,11,14,138,355,34,90,0,0
117,1457,253,1588,592,1,11,14,131,339,35,90,0,0
118,1467,246,1593,574,1,11,14,126,328,36,90,0,0
119,1481,238,1604,564,1,11,14,123,326,37,90,0,0
120,1488,239,1610,560,1,11,14,122,321,38,90,0,0
121,1499,233,1615,537,1,11,14,116,304,39,90,0,0
122,1513,229,1624,521,1,11,14,111,292,40,90,0,0
123,1525,232,1628,505,1,11,14,103,273,41,90,0,0
124,1534,222,1638,498,1,11,14,104,276,42,90,0,0
125,1539,221,1641,494,1,11,14,102,273,43,90,0,0
126,1542,222,1641,483,1,11,14,99,261,44,90,0,0
127,1552,220,1645,467,1,11,14,93,247,45,90,0,0
128,1558,223,1647,458,1,11,14,89,235,46,90,0,0
129,1563,220,1649,447,1,11,14,86,227,47,90,0,0
130,1564,214,1649,440,1,11,14,85,226,48,90,0,0
131,1561,213,1648,437,1,11,14,87,224,49,90,0,0
132,1565,209,1649,427,1,11,14,84,218,50,90,0,0
133,1568,208,1650,422,1,11,14,82,214,51,90,0,0
134,1571,208,1651,417,1,11,14,80,209,52,90,0,0
135,1574,205,1649,404,1,11,14,75,199,53,90,0,0
136,1573,203,1648,401,1,11,14,75,198,54,90,0,0
137,1572,202,1647,396,1,11,14,75,194,55,90,0,0
138,1575,198,1647,389,1,11,14,72,191,56,90,0,0
139,1577,198,1647,385,1,11,14,70,187,57,90,0,0
140,1580,198,1646,378,1,11,14,66,180,58,90,0,0
141,1579,194,1646,374,1,11,14,67,180,59,90,0,0
142,1580,197,1643,367,1,11,14,63,170,60,90,0,0
143,1578,189,1643,362,1,11,14,65,173,61,90,0,0
144,1581,189,1644,357,1,11,14,63,168,62,90,0,0
145,1584,189,1645,355,1,11,14,61,166,63,90,0,0
146,1587,185,1648,351,1,11,14,61,166,64,90,0,0
147,1590,185,1649,347,1,11,14,59,162,65,90,0,0
148,1592,185,1649,343,1,11,14,57,158,66,90,0,0
149,1594,183,1650,337,1,11,14,56,154,67,90,0,0
150,1597,183,1650,333,1,11,14,53,150,68,90,0,0
151,1601,184,1652,328,1,11,14,51,144,69,90,0,0
152,1602,181,1653,326,1,11,14,51,145,70,90,0,0
153,1601,182,1652,325,1,11,14,51,143,71,90,0,0
154,1600,181,1650,321,1,11,14,50,140,72,90,0,0
155,1600,179,1649,317,1,11,14,49,138,73,90,0,0
156,1600,178,1648,317,1,11,14,48,139,74,90,0,0
157,1600,177,1647,316,1,11,14,47,139,75,90,0,0
158,1600,177,1647,314,1,11,14,47,137,76,90,0,0
159,1600,179,1645,310,1,11,14,45,131,77,90,0,0
160,1600,179,1643,303,1,11,14,43,124,78,90,0,0
161,1599,181,1640,298,1,11,14,41,117,79,90,0,0
162,1599,179,1639,294,1,11,14,40,115,80,90,0,0
163,1600,175,1640,291,1,11,14,40,116,81,90,0,0
164,1600,178,1638,288,1,11,14,38,110,82,90,0,0
165,1599,179,1637,290,1,11,14,38,111,83,90,0,0
166,1600,178,1637,285,1,11,14,37,107,84,90,0,0
167,1601,177,1637,282,1,11,14,36,105,85,90,0,0
168,1602,173,1639,281,1,11,14,37,108,86,90,0,0
169,1604,169,1641,276,1,11,14,37,107,87,90,0,0
170,1605,170,1641,273,1,11,14,36,103,88,90,0,0
171,1605,169,1642,274,1,11,14,37,105,89,90,0,0
172,1606,168,1641,269,1,11,14,35,101,90,90,1,0
174,1607,164,1643,268,1,11,14,36,104,0,90,0,0
175,1608,163,1644,267,1,11,14,36,104,1,90,0,0
176,1608,164,1643,265,1,11,14,35,101,2,90,0,0
177,1609,163,1644,264,1,11,14,35,101,3,90,0,0
181,1609,159,1644,261,1,11,14,35,102,0,90,0,0
283,0,478,80,787,2,11,14,80,309,0,35,0,1
284,5,471,90,798,2,11,14,85,327,1,35,0,0
285,12,463,100,798,2,11,14,88,335,2,35,0,0
286,42,470,134,806,2,11,14,92,336,3,35,0,0
287,58,467,153,808,2,11,14,95,341,4,35,0,0
288,69,464,169,814,2,11,14,100,350,5,35,0,0
289,101,466,208,824,2,11,14,107,358,6,35,0,0
290,123,468,234,831,2,11,14,111,363,7,35,0,0
291,147,464,265,838,2,11,14,118,374,8,35,0,0
292,190,461,317,842,2,11,14,127,381,9,35,0,0
293,223,460,355,843,2,11,14,132,383,10,35,0,0
294,239,449,381,857,2,11,14,142,408,11,35,0,0
295,283,457,432,871,2,11,14,149,414,12,35,0,0
296,313,457,466,877,2,11,14,153,420,13,35,0,0
297,344,451,503,884,2,11,14,159,433,14,35,0,0
298,394,451,562,892,2,11,14,168,441,15,35,0,0
299,435,445,610,895,2,11,14,175,450,16,35,0,0
300,469,441,648,911,2,11,14,179,470,17,35,0,0
301,527,451,715,935,2,11,14,188,484,18,35,0,0
302,568,454,760,953,2,11,14,192,499,19,35,0,0
303,618,450,816,959,2,11,14,198,509,20,35,0,0
304,685,459,887,965,2,11,14,202,506,21,35,0,0
305,731,453,939,970,2,11,14,208,517,22,35,0,0
306,782,449,1004,1009,2,11,14,222,560,23,35,0,0
307,847,456,1077,1032,2,11,14,230,576,24,35,0,0
308,910,457,1143,1049,2,11,14,233,592,25,35,0,0
309,988,462,1223,1059,2,11,14,235,597,26,35,0,0
310,1052,488,1290,1071,2,11,14,238,583,27,35,0,0
311,1142,488,1384,1076,2,11,14,242,588,28,35,0,0
312,1220,495,1464,1075,2,11,14,244,580,29,35,0,0
313,1282,500,1535,1076,2,11,14,253,576,30,35,0,0
314,1393,508,1641,1069,2,11,14,248,561,31,35,0,0
315,1460,518,1710,1067,2,11,14,250,549,32,35,0,0
316,1578,538,1803,1021,2,11,14,225,483,33,35,0,0
317,1667,547,1879,996,2,11,14,212,449,34,35,0,0
318,1740,554,1920,993,2,11,14,180,439,35,35,1,0
489,1598,183,1634,306,5,11,14,36,123,0,54,0,0
491,1603,185,1643,315,5,11,14,40,130,0,54,0,1
492,1600,186,1640,316,5,11,14,40,130,1,54,0,0
493,1595,185,1636,318,5,11,14,41,133,2,54,0,0
494,1590,180,1633,321,5,11,14,43,141,3,54,0,0
495,1589,181,1632,321,5,11,14,43,140,4,54,0,0
496,1587,178,1633,331,5,11,14,46,153,5,54,0,0
497,1587,180,1633,335,5,11,14,46,155,6,54,0,0
498,1586,181,1632,339,5,11,14,46,158,7,54,0,0
499,1586,181,1632,342,5,11,14,46,161,8,54,0,0
500,1587,186,1633,346,5,11,14,46,160,9,54,0,0
501,1587,183,1634,353,5,11,14,47,170,10,54,0,0
502,1587,183,1636,359,5,11,14,49,176,11,54,0,0
503,1587,186,1636,362,5,11,14,49,176,12,54,0,0
504,1589,187,1640,369,5,11,14,51,182,13,54,0,0
505,1594,190,1646,372,5,11,14,52,182,14,54,0,0
506,1594,191,1648,378,5,11,14,54,187,15,54,0,0
507,1594,191,1650,388,5,11,14,56,197,16,54,0,0
508,1594,193,1652,392,5,11,14,58,199,17,54,0,0
509,1595,195,1654,402,5,11,14,59,207,18,54,0,0
510,1597,198,1656,401,5,11,14,59,203,19,54,0,0
511,1595,198,1657,414,5,11,14,62,216,20,54,0,0
512,1595,206,1656,415,5,11,14,61,209,21,54,0,0
513,1593,208,1655,422,5,11,14,62,214,22,54,0,0
514,1591,212,1657,439,5,11,14,66,227,23,54,0,0
515,1589,211,1657,442,5,11,14,68,231,24,54,0,0
516,1585,213,1658,459,5,11,14,73,246,25,54,0,0
517,1582,218,1658,472,5,11,14,76,254,26,54,0,0
518,1580,218,1659,479,5,11,14,79,261,27,54,0,0
519,1576,217,1660,499,5,11,14,84,282,28,54,0,0
520,1573,217,1659,506,5,11,14,86,289,29,54,0,0
521,1571,224,1658,518,5,11,14,87,294,30,54,0,0
522,1566,237,1652,528,5,11,14,86,291,31,54,0,0
523,1560,238,1649,541,5,11,14,89,303,32,54,0,0
524,1550,241,1648,580,5,11,14,98,339,33,54,0,0
525,1544,239,1645,592,5,11,14,101,353,34,54,0,0
526,1535,242,1644,617,5,11,14,109,375,35,54,0,0
527,1523,251,1636,633,5,11,14,113,382,36,54,0,0
528,1519,254,1636,646,5,11,14,117,392,37,54,0,0
529,1512,264,1634,673,5,11,14,122,409,38,54,0,0
530,1508,272,1632,689,5,11,14,124,417,39,54,0,0
531,1496,288,1624,712,5,11,14,128,424,40,54,0,0
532,1486,294,1622,748,5,11,14,136,454,41,54,0,0
533,1472,303,1617,783,5,11,14,145,480,42,54,0,0
534,1456,319,1611,829,5,11,14,155,510,43,54,0,0
535,1445,327,1610,857,5,11,14,165,530,44,54,0,0
536,1430,347,1604,890,5,11,14,174,543,45,54,0,0
537,1406,362,1591,930,5,11,14,185,568,46,54,0,0
538,1373,381,1581,1016,5,11,14,208,635,47,54,0,0
539,1343,411,1558,1059,5,11,14,215,648,48,54,0,0
540,1312,436,1531,1080,5,11,14,219,644,49,54,0,0
541,1279,494,1488,1078,5,11,14,209,584,50,54,0,0
542,1227,530,1434,1067,5,11,14,207,537,51,54,0,0
543,1165,612,1365,1078,5,11,14,200,466,52,54,0,0
544,1091,697,1279,1080,5,11,14,188,383,53,54,0,0
545,1065,729,1247,1080,5,11,14,182,351,54,54,1,0
721,1,531,68,803,7,11,14,67,272,0,18,0,0
722,2,524,74,817,7,11,14,72,293,1,18,0,0
723,5,519,90,861,7,11,14,85,342,2,18,0,0
724,4,501,100,888,7,11,14,96,387,3,18,0,0
725,16,496,117,893,7,11,14,101,397,4,18,0,0
726,34,499,147,929,7,11,14,113,430,5,18,0,0
727,39,510,159,950,7,11,14,120,440,6,18,0,0
728,39,517,173,994,7,11,14,134,477,7,18,0,0
729,50,537,197,1035,7,11,14,147,498,8,18,0,0
730,58,542,214,1049,7,11,14,156,507,9,18,0,0
731,78,559,244,1073,7,11,14,166,514,10,18,0,0
732,96,584,264,1080,7,11,14,168,496,11,18,0,0
733,108,592,281,1080,7,11,14,173,488,12,18,0,0
734,131,628,300,1080,7,11,14,169,452,13,18,0,0
735,152,657,325,1080,7,11,14,173,423,14,18,0,0
736,173,703,345,1080,7,11,14,172,377,15,18,0,0
737,181,774,338,1080,7,11,14,157,306,16,18,0,0
738,152,834,293,1078,7,11,14,141,244,17,18,0,0
739,163,864,292,1080,7,11,14,129,216,18,18,0,0
1672,1569,151,1604,272,9,11,14,35,121,0,82,0,1
1673,1566,152,1601,275,9,11,14,35,123,1,82,0,0
1674,1562,152,1598,277,9,11,14,36,125,2,82,0,0
1675,1562,156,1598,280,9,11,14,36,124,3,82,0,0
1676,1563,156,1599,281,9,11,14,36,125,4,82,0,0
1677,1561,155,1599,283,9,11,14,38,128,5,82,0,0
1678,1560,159,1596,285,9,11,14,36,126,6,82,0,0
1679,1557,157,1595,287,9,11,14,38,130,7,82,0,0
1680,1556,159,1594,290,9,11,14,38,131,8,82,0,0
1681,1558,161,1596,292,9,11,14,38,131,9,82,0,0
1682,1557,160,1596,295,9,11,14,39,135,10,82,0,0
1683,1556,164,1596,302,9,11,14,40,138,11,82,0,0
1684,1554,163,1595,303,9,11,14,41,140,12,82,0,0
1685,1554,163,1595,306,9,11,14,41,143,13,82,0,0
1686,1558,163,1600,312,9,11,14,42,149,14,82,0,0
1687,1559,163,1602,313,9,11,14,43,150,15,82,0,0
1688,1559,163,1603,317,9,11,14,44,154,16,82,0,0
1689,1559,163,1603,318,9,11,14,44,155,17,82,0,0
1690,1559,163,1603,320,9,11,14,44,157,18,82,0,0
1691,1562,169,1606,323,9,11,14,44,154,19,82,0,0
1692,1563,168,1608,326,9,11,14,45,158,20,82,0,0
1693,1563,173,1608,332,9,11,14,45,159,21,82,0,0
1694,1561,174,1607,336,9,11,14,46,162,22,82,0,0
1695,1560,173,1607,342,9,11,14,47,169,23,82,0,0
1696,1560,174,1609,347,9,11,14,49,173,24,82,0,0
1697,1560,171,1612,352,9,11,14,52,181,25,82,0,0
1698,1560,173,1613,358,9,11,14,53,185,26,82,0,0
1699,1559,175,1613,363,9,11,14,54,188,27,82,0,0
1700,1559,176,1614,367,9,11,14,55,191,28,82,0,0
1701,1561,178,1617,375,9,11,14,56,197,29,82,0,0
1702,1563,177,1621,382,9,11,14,58,205,30,82,0,0
1703,1563,178,1624,390,9,11,14,61,212,31,82,0,0
1704,1562,182,1624,399,9,11,14,62,217,32,82,0,0
1705,1561,182,1624,402,9,11,14,63,220,33,82,0,0
1706,1562,190,1626,412,9,11,14,64,222,34,82,0,0
1707,1563,192,1630,421,9,11,14,67,229,35,82,0,0
1708,1561,194,1630,427,9,11,14,69,233,36,82,0,0
1709,1556,196,1626,435,9,11,14,70,239,37,82,0,0
1710,1551,195,1624,442,9,11,14,73,247,38,82,0,0
1711,1547,198,1624,458,9,11,14,77,260,39,82,0,0
1712,1545,203,1624,468,9,11,14,79,265,40,82,0,0
1713,1540,203,1621,473,9,11,14,81,270,41,82,0,0
1714,1532,207,1616,487,9,11,14,84,280,42,82,0,0
1715,1524,208,1610,495,9,11,14,86,287,43,82,0,0
1716,1518,211,1610,516,9,11,14,92,305,44,82,0,0
1717,1516,214,1614,534,9,11,14,98,320,45,82,0,0
1718,1506,215,1607,542,9,11,14,101,327,46,82,0,0
1719,1491,223,1596,564,9,11,14,105,341,47,82,0,0
1720,1479,225,1588,584,9,11,14,109,359,48,82,0,0
1721,1472,229,1586,600,9,11,14,114,371,49,82,0,0
1722,1467,238,1592,634,9,11,14,125,396,50,82,0,0
1723,1457,239,1586,645,9,11,14,129,406,51,82,0,0
1724,1434,248,1567,669,9,11,14,133,421,52,82,0,0
1725,1415,254,1553,694,9,11,14,138,440,53,82,0,0
1726,1397,258,1543,719,9,11,14,146,461,54,82,0,0
1727,1386,272,1546,766,9,11,14,160,494,55,82,0,0
1728,1365,276,1530,788,9,11,14,165,512,56,82,0,0
1729,1320,289,1490,818,9,11,14,170,529,57,82,0,0
1730,1282,296,1460,850,9,11,14,178,554,58,82,0,0
1731,1233,310,1410,873,9,11,14,177,563,59,82,0,0
1732,1150,336,1340,918,9,11,14,190,582,60,82,0,0
1733,1093,347,1291,946,9,11,14,198,599,61,82,0,0
1734,1004,356,1203,956,9,11,14,199,600,62,82,0,0
1735,914,380,1125,981,9,11,14,211,601,63,82,0,0
1736,805,390,1025,989,9,11,14,220,599,64,82,0,0
1737,708,398,930,993,9,11,14,222,595,65,82,0,0
1738,624,411,856,1000,9,11,14,232,589,66,82,0,0
1739,490,408,725,997,9,11,14,235,589,67,82,0,0
1740,393,418,633,991,9,11,14,240,573,68,82,0,0
1741,319,420,553,968,9,11,14,234,548,69,82,0,0
1742,252,425,477,951,9,11,14,225,526,70,82,0,0
1743,204,434,427,936,9,11,14,223,502,71,82,0,0
1744,134,432,350,919,9,11,14,216,487,72,82,0,0
1745,71,434,284,907,9,11,14,213,473,73,82,0,0
1746,33,438,233,879,9,11,14,200,441,74,82,0,0
1747,8,426,201,855,9,11,14,193,429,75,82,0,0
1748,0,440,180,842,9,11,14,180,402,76,82,0,0
1749,0,439,154,822,9,11,14,154,383,77,82,0,0
1750,0,450,127,814,9,11,14,127,364,78,82,0,0
1751,0,462,107,806,9,11,14,107,344,79,82,0,0
1752,0,476,85,779,9,11,14,85,303,80,82,0,0
1753,0,486,79,770,9,11,14,79,284,81,82,0,0
1754,0,494,47,759,9,11,14,47,265,82,82,1,0
1716,1502,246,1542,375,10,11,14,40,129,0,3,0,0
1717,1498,257,1536,380,10,11,14,38,123,1,3,0,0
1718,1494,251,1532,376,10,11,14,38,125,2,3,0,0
1719,1491,250,1530,375,10,11,14,39,125,3,3,0,0
1721,1459,274,1504,425,10,11,14,45,151,0,3,0,0
1722,1450,279,1497,435,10,11,14,47,156,1,3,0,0
2142,0,618,70,751,11,11,14,70,133,0,20,0,1
2143,0,539,96,761,11,11,14,96,222,1,20,0,0
2144,0,499,108,768,11,11,14,108,269,2,20,0,0
2145,0,474,123,785,11,11,14,123,311,3,20,0,0
2146,0,466,129,799,11,11,14,129,333,4,20,0,0
2147,0,464,134,806,11,11,14,134,342,5,20,0,0
2148,0,461,152,802,11,11,14,152,341,6,20,0,0
2149,0,442,173,805,11,11,14,173,363,7,20,0,0
2150,4,441,181,803,11,11,14,177,362,8,20,0,0
2151,7,437,189,812,11,11,14,182,375,9,20,0,0
2152,7,432,196,822,11,11,14,189,390,10,20,0,0
2153,11,434,201,825,11,11,14,190,391,11,20,0,0
2154,0,430,191,829,11,11,14,191,399,12,20,0,0
2155,0,439,182,830,11,11,14,182,391,13,20,0,0
2156,0,450,177,828,11,11,14,177,378,14,20,0,0
2157,0,460,161,813,11,11,14,161,353,15,20,0,0
2158,0,461,139,805,11,11,14,139,344,16,20,0,0
2159,0,470,126,798,11,11,14,126,328,17,20,0,0
2160,0,468,107,780,11,11,14,107,312,18,20,0,0
2161,0,476,92,762,11,11,14,92,286,19,20,0,0
2162,0,474,87,758,11,11,14,87,284,20,20,1,0
2162,0,595,51,751,12,11,14,51,156,0,0,0,0
3160,1593,180,1629,279,13,11,14,36,99,0,96,0,0
3161,1592,180,1627,281,13,11,14,35,101,1,96,0,0
3162,1591,181,1627,282,13,11,14,36,101,2,96,0,0
3164,1592,182,1628,284,13,11,14,36,102,0,96,0,1
3165,1592,182,1629,288,13,11,14,37,106,1,96,0,0
3166,1591,181,1630,291,13,11,14,39,110,2,96,0,0
3167,1591,183,1630,293,13,11,14,39,110,3,96,0,0
3168,1592,183,1632,297,13,11,14,40,114,4,96,0,0
3169,1593,184,1635,302,13,11,14,42,118,5,96,0,0
3170,1595,186,1636,302,13,11,14,41,116,6,96,0,0
3171,1595,186,1638,308,13,11,14,43,122,7,96,0,0
3172,1594,185,1637,309,13,11,14,43,124,8,96,0,0
3173,1592,186,1636,312,13,11,14,44,126,9,96,0,0
3174,1591,186,1636,316,13,11,14,45,130,10,96,0,0
3175,1592,186,1637,318,13,11,14,45,132,11,96,0,0
3176,1593,188,1638,321,13,11,14,45,133,12,96,0,0
3177,1592,188,1639,325,13,11,14,47,137,13,96,0,0
3178,1590,187,1639,328,13,11,14,49,141,14,96,0,0
3179,1589,188,1638,330,13,11,14,49,142,15,96,0,0
3180,1589,191,1638,332,13,11,14,49,141,16,96,0,0
3181,1590,193,1639,334,13,11,14,49,141,17,96,0,0
3182,1591,194,1641,335,13,11,14,50,141,18,96,0,0
3183,1590,191,1644,341,13,11,14,54,150,19,96,0,0
3184,1590,193,1644,344,13,11,14,54,151,20,96,0,0
3185,1589,194,1644,347,13,11,14,55,153,21,96,0,0
3186,1589,193,1647,354,13,11,14,58,161,22,96,0,0
3187,1591,199,1650,359,13,11,14,59,160,23,96,0,0
3188,1594,199,1654,362,13,11,14,60,163,24,96,0,0
3189,1596,199,1657,366,13,11,14,61,167,25,96,0,0
3190,1596,202,1658,371,13,11,14,62,169,26,96,0,0
3191,1595,202,1657,371,13,11,14,62,169,27,96,0,0
3192,1594,205,1657,374,13,11,14,63,169,28,96,0,0
3193,1592,206,1658,384,13,11,14,66,178,29,96,0,0
3194,1591,206,1659,392,13,11,14,68,186,30,96,0,0
3195,1591,206,1660,396,13,11,14,69,190,31,96,0,0
3196,1589,210,1659,401,13,11,14,70,191,32,96,0,0
3197,1588,214,1658,407,13,11,14,70,193,33,96,0,0
3198,1585,215,1657,410,13,11,14,72,195,34,96,0,0
3199,1583,216,1659,421,13,11,14,76,205,35,96,0,0
3200,1582,221,1659,428,13,11,14,77,207,36,96,0,0
3201,1580,220,1659,433,13,11,14,79,213,37,96,0,0
3202,1576,225,1655,439,13,11,14,79,214,38,96,0,0
3203,1571,229,1651,446,13,11,14,80,217,39,96,0,0
3204,1565,230,1645,445,13,11,14,80,215,40,96,0,0
3205,1561,232,1643,452,13,11,14,82,220,41,96,0,0
3206,1559,233,1645,462,13,11,14,86,229,42,96,0,0
3207,1558,231,1648,471,13,11,14,90,240,43,96,0,0
3208,1555,235,1649,480,13,11,14,94,245,44,96,0,0
3209,1548,237,1645,493,13,11,14,97,256,45,96,0,0
3210,1541,236,1642,500,13,11,14,101,264,46,96,0,0
3211,1537,238,1644,515,13,11,14,107,277,47,96,0,0
3212,1534,240,1644,528,13,11,14,110,288,48,96,0,0
3213,1533,240,1646,532,13,11,14,113,292,49,96,0,0
3214,1532,245,1645,541,13,11,14,113,296,50,96,0,0
3215,1527,253,1643,557,13,11,14,116,304,51,96,0,0
3216,1519,254,1638,569,13,11,14,119,315,52,96,0,0
3217,1513,262,1638,594,13,11,14,125,332,53,96,0,0
3218,1508,271,1638,618,13,11,14,130,347,54,96,0,0
3219,1504,276,1634,627,13,11,14,130,351,55,96,0,0
3220,1497,284,1629,640,13,11,14,132,356,56,96,0,0
3221,1484,295,1621,663,13,11,14,137,368,57,96,0,0
3222,1470,299,1611,678,13,11,14,141,379,58,96,0,0
3223,1459,306,1610,712,13,11,14,151,406,59,96,0,0
3224,1451,322,1608,743,13,11,14,157,421,60,96,0,0
3225,1442,329,1603,761,13,11,14,161,432,61,96,0,0
3226,1426,338,1593,778,13,11,14,167,440,62,96,0,0
3227,1401,352,1574,810,13,11,14,173,458,63,96,0,0
3228,1376,357,1552,826,13,11,14,176,469,64,96,0,0
3229,1342,372,1533,887,13,11,14,191,515,65,96,0,0
3230,1309,385,1508,929,13,11,14,199,544,66,96,0,0
3231,1269,403,1467,952,13,11,14,198,549,67,96,0,0
3232,1201,412,1406,973,13,11,14,205,561,68,96,0,0
3233,1130,432,1347,1001,13,11,14,217,569,69,96,0,0
3234,1049,435,1279,1018,13,11,14,230,583,70,96,0,0
3235,958,451,1199,1058,13,11,14,241,607,71,96,0,0
3236,880,465,1135,1080,13,11,14,255,615,72,96,0,0
3237,774,478,1030,1080,13,11,14,256,602,73,96,0,0
3238,690,488,946,1080,13,11,14,256,592,74,96,0,0
3239,616,507,879,1080,13,11,14,263,573,75,96,0,0
3240,538,514,803,1079,13,11,14,265,565,76,96,0,0
3241,453,513,719,1079,13,11,14,266,566,77,96,0,0
3242,396,520,664,1070,13,11,14,268,550,78,96,0,0
3243,321,518,590,1059,13,11,14,269,541,79,96,0,0
3244,240,520,503,1046,13,11,14,263,526,80,96,0,0
3245,189,526,450,1032,13,11,14,261,506,81,96,0,0
3246,146,520,394,999,13,11,14,248,479,82,96,0,0
3247,119,514,354,973,13,11,14,235,459,83,96,0,0
3248,93,503,326,958,13,11,14,233,455,84,96,0,0
3249,68,501,291,931,13,11,14,223,430,85,96,0,0
3250,32,487,249,910,13,11,14,217,423,86,96,0,0
3251,13,478,233,907,13,11,14,220,429,87,96,0,0
3252,2,476,211,885,13,11,14,209,409,88,96,0,0
3253,0,490,182,851,13,11,14,182,361,89,96,0,0
3254,0,471,172,830,13,11,14,172,359,90,96,0,0
3255,0,498,151,814,13,11,14,151,316,91,96,0,0
3256,0,488,135,809,13,11,14,135,321,92,96,0,0
3257,0,492,116,796,13,11,14,116,304,93,96,0,0
3258,0,492,88,782,13,11,14,88,290,94,96,0,0
3259,0,491,92,769,13,11,14,92,278,95,96,0,0
3260,0,491,70,755,13,11,14,70,264,96,96,1,0
681,3,766,274,1077,1,11,15,271,311,0,16,0,0
682,85,707,406,1077,1,11,15,321,370,1,16,0,0
683,182,670,528,1069,1,11,15,346,399,2,16,0,0
684,303,626,682,1066,1,11,15,379,440,3,16,0,0
685,415,572,815,1043,1,11,15,400,471,4,16,0,0
686,506,536,931,1046,1,11,15,425,510,5,16,0,0
687,581,495,1040,1058,1,11,15,459,563,6,16,0,0
688,661,452,1146,1067,1,11,15,485,615,7,16,0,0
689,735,430,1222,1068,1,11,15,487,638,8,16,0,0
690,830,405,1281,1018,1,11,15,451,613,9,16,0,0
691,899,377,1332,988,1,11,15,433,611,10,16,0,0
692,960,360,1370,958,1,11,15,410,598,11,16,0,0
693,1044,343,1406,893,1,11,15,362,550,12,16,0,0
694,1099,344,1430,858,1,11,15,331,514,13,16,0,0
695,1153,333,1464,827,1,11,15,311,494,14,16,0,0
696,1223,322,1512,807,1,11,15,289,485,15,16,0,0
697,1291,299,1583,787,1,11,15,292,488,16,16,0,0
697,1303,666,1397,802,2,11,15,94,136,0,0,0,0
739,155,662,393,1078,3,11,15,238,416,0,0,0,0
740,320,578,574,1071,4,11,15,254,493,0,0,0,0
741,480,524,830,1075,5,11,15,350,551,0,9,0,0
742,575,480,947,1068,5,11,15,372,588,1,9,0,0
743,635,426,1037,1069,5,11,15,402,643,2,9,0,0
744,724,397,1137,1068,5,11,15,413,671,3,9,0,0
745,835,365,1233,1025,5,11,15,398,660,4,9,0,0
746,934,338,1326,1000,5,11,15,392,662,5,9,0,0
747,1035,322,1388,933,5,11,15,353,611,6,9,0,0
748,1111,307,1440,888,5,11,15,329,581,7,9,0,0
749,1172,301,1481,859,5,11,15,309,558,8,9,0,0
750,1244,279,1550,831,5,11,15,306,552,9,9,0,0
986,1364,230,1434,505,6,11,15,70,275,0,35,0,1
987,1337,230,1408,504,6,11,15,71,274,1,35,0,0
988,1309,229,1380,499,6,11,15,71,270,2,35,0,0
989,1285,221,1354,475,6,11,15,69,254,3,35,0,0
990,1257,214,1331,481,6,11,15,74,267,4,35,0,0
991,1238,209,1310,469,6,11,15,72,260,5,35,0,0
992,1224,200,1295,450,6,11,15,71,250,6,35,0,0
993,1215,197,1289,447,6,11,15,74,250,7,35,0,0
994,1208,196,1276,423,6,11,15,68,227,8,35,0,0
995,1202,191,1270,411,6,11,15,68,220,9,35,0,0
996,1197,188,1263,400,6,11,15,66,212,10,35,0,0
997,1193,177,1261,391,6,11,15,68,214,11,35,0,0
998,1192,175,1262,397,6,11,15,70,222,12,35,0,0
999,1194,173,1263,390,6,11,15,69,217,13,35,0,0
1000,1198,172,1263,376,6,11,15,65,204,14,35,0,0
1001,1200,173,1263,367,6,11,15,63,194,15,35,0,0
1002,1202,169,1264,358,6,11,15,62,189,16,35,0,0
1003,1204,169,1264,347,6,11,15,60,178,17,35,0,0
1004,1209,166,1267,337,6,11,15,58,171,18,35,0,0
1005,1210,156,1270,330,6,11,15,60,174,19,35,0,0
1006,1209,155,1268,328,6,11,15,59,173,20,35,0,0
1007,1209,154,1267,320,6,11,15,58,166,21,35,0,0
1008,1209,153,1265,313,6,11,15,56,160,22,35,0,0
1009,1209,152,1265,309,6,11,15,56,157,23,35,0,0
1010,1208,151,1264,306,6,11,15,56,155,24,35,0,0
1011,1205,150,1260,304,6,11,15,55,154,25,35,0,0
1012,1203,145,1258,297,6,11,15,55,152,26,35,0,0
1013,1203,146,1256,293,6,11,15,53,147,27,35,0,0
1014,1204,145,1256,287,6,11,15,52,142,28,35,0,0
1015,1203,139,1255,283,6,11,15,52,144,29,35,0,0
1016,1202,139,1253,280,6,11,15,51,141,30,35,0,0
1017,1199,136,1248,273,6,11,15,49,137,31,35,0,0
1018,1195,133,1244,270,6,11,15,49,137,32,35,0,0
1019,1190,133,1238,267,6,11,15,48,134,33,35,0,0
1020,1181,133,1227,260,6,11,15,46,127,34,35,0,0
1021,1179,131,1223,255,6,11,15,44,124,35,35,1,0
1707,1377,189,1442,520,7,11,15,65,331,0,44,0,1
1708,1349,187,1413,506,7,11,15,64,319,1,44,0,0
1709,1333,183,1398,500,7,11,15,65,317,2,44,0,0
1710,1307,180,1373,497,7,11,15,66,317,3,44,0,0
1711,1278,178,1345,486,7,11,15,67,308,4,44,0,0
1712,1265,163,1334,472,7,11,15,69,309,5,44,0,0
1713,1251,160,1327,491,7,11,15,76,331,6,44,0,0
1714,1239,161,1312,472,7,11,15,73,311,7,44,0,0
1715,1222,149,1293,446,7,11,15,71,297,8,44,0,0
1716,1214,149,1286,439,7,11,15,72,290,9,44,0,0
1717,1211,148,1283,431,7,11,15,72,283,10,44,0,0
1718,1208,144,1279,415,7,11,15,71,271,11,44,0,0
1719,1206,146,1275,404,7,11,15,69,258,12,44,0,0
1720,1200,146,1270,400,7,11,15,70,254,13,44,0,0
1721,1199,141,1266,380,7,11,15,67,239,14,44,0,0
1722,1203,143,1268,372,7,11,15,65,229,15,44,0,0
1723,1204,141,1270,365,7,11,15,66,224,16,44,0,0
1724,1208,141,1273,358,7,11,15,65,217,17,44,0,0
1725,1208,141,1274,357,7,11,15,66,216,18,44,0,0
1726,1207,137,1274,356,7,11,15,67,219,19,44,0,0
1727,1208,135,1275,348,7,11,15,67,213,20,44,0,0
1728,1211,135,1276,341,7,11,15,65,206,21,44,0,0
1729,1215,133,1279,337,7,11,15,64,204,22,44,0,0
1730,1217,132,1280,326,7,11,15,63,194,23,44,0,0
1731,1216,135,1276,317,7,11,15,60,182,24,44,0,0
1732,1215,129,1279,320,7,11,15,64,191,25,44,0,0
1733,1217,130,1281,320,7,11,15,64,190,26,44,0,0
1734,1220,126,1285,320,7,11,15,65,194,27,44,0,0
1735,1221,125,1283,309,7,11,15,62,184,28,44,0,0
1736,1221,127,1282,306,7,11,15,61,179,29,44,0,0
1737,1220,122,1280,300,7,11,15,60,178,30,44,0,0
1738,1221,119,1281,297,7,11,15,60,178,31,44,0,0
1739,1222,119,1282,296,7,11,15,60,177,32,44,0,0
1740,1224,117,1284,292,7,11,15,60,175,33,44,0,0
1741,1225,118,1284,290,7,11,15,59,172,34,44,0,0
1742,1221,118,1279,287,7,11,15,58,169,35,44,0,0
1743,1217,117,1275,286,7,11,15,58,169,36,44,0,0
1744,1216,115,1271,273,7,11,15,55,158,37,44,0,0
1745,1215,117,1269,268,7,11,15,54,151,38,44,0,0
1746,1211,112,1267,272,7,11,15,56,160,39,44,0,0
1747,1210,111,1265,268,7,11,15,55,157,40,44,0,0
1748,1198,114,1249,257,7,11,15,51,143,41,44,0,0
1749,1194,111,1236,222,7,11,15,42,111,42,44,0,0
1750,1192,109,1231,213,7,11,15,39,104,43,44,0,0
1751,1181,117,1216,211,7,11,15,35,94,44,44,1,0
2281,0,788,204,1071,8,11,15,204,283,0,0,0,0
2282,105,732,343,1075,9,11,15,238,343,0,0,0,0
2283,251,681,516,1074,10,11,15,265,393,0,15,0,0
2284,337,620,644,1075,10,11,15,307,455,1,15,0,0
2285,424,588,746,1068,10,11,15,322,480,2,15,0,0
2286,525,550,870,1070,10,11,15,345,520,3,15,0,0
2287,591,497,966,1069,10,11,15,375,572,4,15,0,0
2288,662,467,1047,1068,10,11,15,385,601,5,15,0,0
2289,721,433,1119,1069,10,11,15,398,636,6,15,0,0
2290,793,395,1174,1024,10,11,15,381,629,7,15,0,0
2291,855,375,1227,1002,10,11,15,372,627,8,15,0,0
2292,913,359,1262,960,10,11,15,349,601,9,15,0,0
2293,998,340,1323,916,10,11,15,325,576,10,15,0,0
2294,1046,338,1360,904,10,11,15,314,566,11,15,0,0
2295,1133,331,1416,856,10,11,15,283,525,12,15,0,0
2296,1197,329,1462,835,10,11,15,265,506,13,15,0,0
2297,1239,397,1459,821,10,11,15,220,424,14,15,0,0
2298,1300,389,1514,803,10,11,15,214,414,15,15,0,0
2284,0,914,78,1076,11,11,15,78,162,0,0,0,0
2285,1,806,215,1077,12,11,15,214,271,0,0,0,0
2286,108,750,352,1072,13,11,15,244,322,0,0,0,0
2287,236,683,523,1076,14,11,15,287,393,0,14,0,0
2288,315,631,636,1073,14,11,15,321,442,1,14,0,0
2289,379,586,730,1072,14,11,15,351,486,2,14,0,0
2290,443,528,831,1073,14,11,15,388,545,3,14,0,0
2291,524,497,925,1070,14,11,15,401,573,4,14,0,0
2292,590,461,1001,1066,14,11,15,411,605,5,14,0,0
2293,664,429,1070,1046,14,11,15,406,617,6,14,0,0
2294,732,414,1125,1027,14,11,15,393,613,7,14,0,0
2295,827,383,1192,975,14,11,15,365,592,8,14,0,0
2296,914,370,1253,930,14,11,15,339,560,9,14,0,0
2297,969,361,1296,910,14,11,15,327,549,10,14,0,0
2298,1064,348,1370,880,14,11,15,306,532,11,14,0,0
2299,1126,345,1424,880,14,11,15,298,535,12,14,0,0
2300,1186,339,1466,853,14,11,15,280,514,13,14,0,0
2301,1250,319,1531,836,14,11,15,281,517,14,14,0,0
3388,1188,135,1231,264,15,11,15,43,129,0,38,0,1
3389,1196,131,1238,257,15,11,15,42,126,1,38,0,0
3390,1206,131,1250,264,15,11,15,44,133,2,38,0,0
3391,1216,135,1261,269,15,11,15,45,134,3,38,0,0
3392,1224,137,1270,274,15,11,15,46,137,4,38,0,0
3393,1229,137,1276,277,15,11,15,47,140,5,38,0,0
3394,1234,134,1284,282,15,11,15,50,148,6,38,0,0
3395,1240,137,1289,285,15,11,15,49,148,7,38,0,0
3396,1245,141,1295,290,15,11,15,50,149,8,38,0,0
3397,1252,143,1303,292,15,11,15,51,149,9,38,0,0
3398,1258,146,1311,298,15,11,15,53,152,10,38,0,0
3399,1260,148,1315,303,15,11,15,55,155,11,38,0,0
3400,1265,150,1320,304,15,11,15,55,154,12,38,0,0
3401,1268,150,1325,313,15,11,15,57,163,13,38,0,0
3402,1272,149,1330,314,15,11,15,58,165,14,38,0,0
3403,1273,149,1333,321,15,11,15,60,172,15,38,0,0
3404,1272,147,1335,327,15,11,15,63,180,16,38,0,0
3405,1272,148,1337,333,15,11,15,65,185,17,38,0,0
3406,1270,153,1336,344,15,11,15,66,191,18,38,0,0
3407,1271,157,1337,346,15,11,15,66,189,19,38,0,0
3408,1272,162,1340,356,15,11,15,68,194,20,38,0,0
3409,1273,169,1342,366,15,11,15,69,197,21,38,0,0
3410,1269,173,1341,372,15,11,15,72,199,22,38,0,0
3411,1269,177,1343,383,15,11,15,74,206,23,38,0,0
3412,1273,178,1349,389,15,11,15,76,211,24,38,0,0
3413,1276,182,1355,397,15,11,15,79,215,25,38,0,0
3414,1274,186,1356,407,15,11,15,82,221,26,38,0,0
3415,1270,185,1354,413,15,11,15,84,228,27,38,0,0
3416,1269,195,1355,429,15,11,15,86,234,28,38,0,0
3417,1272,198,1358,433,15,11,15,86,235,29,38,0,0
3418,1276,202,1364,444,15,11,15,88,242,30,38,0,0
3419,1275,206,1370,463,15,11,15,95,257,31,38,0,0
3420,1275,208,1371,465,15,11,15,96,257,32,38,0,0
3421,1279,215,1376,477,15,11,15,97,262,33,38,0,0
3422,1288,218,1389,489,15,11,15,101,271,34,38,0,0
3423,1305,226,1409,502,15,11,15,104,276,35,38,0,0
3424,1321,233,1430,522,15,11,15,109,289,36,38,0,0
3425,1342,240,1450,539,15,11,15,108,299,37,38,0,0
3426,1348,244,1458,549,15,11,15,110,305,38,38,1,0
3426,1382,423,1418,534,16,11,15,36,111,0,0,0,0
3721,1181,124,1216,256,17,11,15,35,132,0,43,0,0
3725,1239,135,1275,265,17,11,15,36,130,0,43,0,1
3726,1248,139,1285,272,17,11,15,37,133,1,43,0,0
3727,1256,138,1295,275,17,11,15,39,137,2,43,0,0
3728,1261,138,1302,282,17,11,15,41,144,3,43,0,0
3729,1266,140,1307,282,17,11,15,41,142,4,43,0,0
3730,1268,141,1310,285,17,11,15,42,144,5,43,0,0
3731,1268,141,1311,289,17,11,15,43,148,6,43,0,0
3732,1268,141,1313,291,17,11,15,45,150,7,43,0,0
3733,1268,145,1313,295,17,11,15,45,150,8,43,0,0
3734,1268,147,1314,297,17,11,15,46,150,9,43,0,0
3735,1266,148,1314,301,17,11,15,48,153,10,43,0,0
3736,1262,151,1310,305,17,11,15,48,154,11,43,0,0
3737,1258,154,1306,307,17,11,15,48,153,12,43,0,0
3738,1254,155,1303,309,17,11,15,49,154,13,43,0,0
3739,1251,156,1302,312,17,11,15,51,156,14,43,0,0
3740,1249,153,1304,321,17,11,15,55,168,15,43,0,0
3741,1246,157,1303,332,17,11,15,57,175,16,43,0,0
3742,1244,162,1300,335,17,11,15,56,173,17,43,0,0
3743,1240,161,1299,339,17,11,15,59,178,18,43,0,0
3744,1237,165,1298,349,17,11,15,61,184,19,43,0,0
3745,1234,166,1297,357,17,11,15,63,191,20,43,0,0
3746,1229,169,1294,362,17,11,15,65,193,21,43,0,0
3747,1223,172,1289,372,17,11,15,66,200,22,43,0,0
3748,1215,173,1284,381,17,11,15,69,208,23,43,0,0
3749,1211,174,1281,382,17,11,15,70,208,24,43,0,0
3750,1209,176,1279,386,17,11,15,70,210,25,43,0,0
3751,1205,174,1276,389,17,11,15,71,215,26,43,0,0
3752,1201,177,1274,397,17,11,15,73,220,27,43,0,0
3753,1195,184,1269,406,17,11,15,74,222,28,43,0,0
3754,1187,183,1264,416,17,11,15,77,233,29,43,0,0
3755,1188,189,1264,412,17,11,15,76,223,30,43,0,0
3756,1184,190,1267,427,17,11,15,83,237,31,43,0,0
3757,1179,191,1265,435,17,11,15,86,244,32,43,0,0
3758,1181,194,1265,437,17,11,15,84,243,33,43,0,0
3759,1182,202,1268,448,17,11,15,86,246,34,43,0,0
3760,1189,205,1277,457,17,11,15,88,252,35,43,0,0
3761,1191,213,1286,482,17,11,15,95,269,36,43,0,0
3762,1200,213,1303,509,17,11,15,103,296,37,43,0,0
3763,1226,219,1324,499,17,11,15,98,280,38,43,0,0
3764,1247,228,1347,509,17,11,15,100,281,39,43,0,0
3765,1278,232,1379,515,17,11,15,101,283,40,43,0,0
3766,1306,235,1406,518,17,11,15,100,283,41,43,0,0
3767,1338,244,1432,516,17,11,15,94,272,42,43,0,0
3768,1348,248,1444,523,17,11,15,96,275,43,43,1,0
3723,1202,128,1258,261,18,11,15,56,133,0,47,0,1
3724,1190,126,1250,267,18,11,15,60,141,1,47,0,0
3725,1197,125,1259,272,18,11,15,62,147,2,47,0,0
3726,1198,132,1255,270,18,11,15,57,138,3,47,0,0
3727,1199,129,1261,279,18,11,15,62,150,4,47,0,0
3728,1200,128,1264,285,18,11,15,64,157,5,47,0,0
3729,1200,131,1260,280,18,11,15,60,149,6,47,0,0
3730,1198,131,1258,283,18,11,15,60,152,7,47,0,0
3731,1195,132,1256,290,18,11,15,61,158,8,47,0,0
3732,1193,135,1254,294,18,11,15,61,159,9,47,0,0
3733,1190,134,1251,294,18,11,15,61,160,10,47,0,0
3734,1188,133,1249,296,18,11,15,61,163,11,47,0,0
3735,1187,137,1247,300,18,11,15,60,163,12,47,0,0
3736,1188,138,1247,301,18,11,15,59,163,13,47,0,0
3737,1186,139,1246,305,18,11,15,60,166,14,47,0,0
3738,1183,142,1243,309,18,11,15,60,167,15,47,0,0
3739,1179,142,1241,314,18,11,15,62,172,16,47,0,0
3740,1177,143,1239,318,18,11,15,62,175,17,47,0,0
3741,1177,146,1239,323,18,11,15,62,177,18,47,0,0
3742,1175,148,1239,330,18,11,15,64,182,19,47,0,0
3743,1171,150,1237,337,18,11,15,66,187,20,47,0,0
3744,1168,150,1234,340,18,11,15,66,190,21,47,0,0
3745,1165,150,1233,348,18,11,15,68,198,22,47,0,0
3746,1161,155,1230,356,18,11,15,69,201,23,47,0,0
3747,1159,156,1228,361,18,11,15,69,205,24,47,0,0
3748,1154,161,1225,370,18,11,15,71,209,25,47,0,0
3749,1148,164,1221,382,18,11,15,73,218,26,47,0,0
3750,1141,162,1215,386,18,11,15,74,224,27,47,0,0
3751,1136,163,1212,390,18,11,15,76,227,28,47,0,0
3752,1132,166,1207,392,18,11,15,75,226,29,47,0,0
3753,1124,168,1200,395,18,11,15,76,227,30,47,0,0
3754,1116,172,1192,400,18,11,15,76,228,31,47,0,0
3755,1108,175,1187,411,18,11,15,79,236,32,47,0,0
3756,1098,175,1180,421,18,11,15,82,246,33,47,0,0
3757,1092,178,1176,433,18,11,15,84,255,34,47,0,0
3758,1093,185,1177,441,18,11,15,84,256,35,47,0,0
3759,1093,184,1179,447,18,11,15,86,263,36,47,0,0
3760,1094,190,1184,463,18,11,15,90,273,37,47,0,0
3761,1095,189,1190,480,18,11,15,95,291,38,47,0,0
3762,1101,188,1202,495,18,11,15,101,307,39,47,0,0
3763,1117,196,1221,509,18,11,15,104,313,40,47,0,0
3764,1142,203,1247,518,18,11,15,105,315,41,47,0,0
3765,1174,212,1281,533,18,11,15,107,321,42,47,0,0
3766,1196,219,1309,552,18,11,15,113,333,43,47,0,0
3767,1235,221,1348,557,18,11,15,113,336,44,47,0,0
3768,1271,232,1386,562,18,11,15,115,330,45,47,0,0
3769,1302,243,1415,559,18,11,15,113,316,46,47,0,0
3770,1315,248,1430,568,18,11,15,115,320,47,47,1,0
4192,1308,214,1438,496,19,11,15,130,282,0,41,0,1
4193,1299,208,1435,504,19,11,15,136,296,1,41,0,0
4194,1278,202,1415,502,19,11,15,137,300,2,41,0,0
4195,1250,197,1382,484,19,11,15,132,287,3,41,0,0
4196,1234,192,1359,468,19,11,15,125,276,4,41,0,0
4197,1217,190,1339,465,19,11,15,122,275,5,41,0,0
4198,1208,183,1321,440,19,11,15,113,257,6,41,0,0
4199,1204,181,1314,431,19,11,15,110,250,7,41,0,0
4200,1205,179,1311,422,19,11,15,106,243,8,41,0,0
4201,1204,173,1306,409,19,11,15,102,236,9,41,0,0
4202,1205,172,1303,404,19,11,15,98,232,10,41,0,0
4203,1207,169,1299,389,19,11,15,92,220,11,41,0,0
4204,1211,167,1298,378,19,11,15,87,211,12,41,0,0
4205,1217,164,1305,381,19,11,15,88,217,13,41,0,0
4206,1224,152,1313,373,19,11,15,89,221,14,41,0,0
4207,1231,150,1317,367,19,11,15,86,217,15,41,0,0
4208,1236,145,1319,360,19,11,15,83,215,16,41,0,0
4209,1243,145,1320,346,19,11,15,77,201,17,41,0,0
4210,1251,146,1324,340,19,11,15,73,194,18,41,0,0
4211,1257,143,1329,334,19,11,15,72,191,19,41,0,0
4212,1262,143,1331,328,19,11,15,69,185,20,41,0,0
4213,1266,144,1330,320,19,11,15,64,176,21,41,0,0
4214,1269,146,1329,309,19,11,15,60,163,22,41,0,0
4215,1272,147,1331,308,19,11,15,59,161,23,41,0,0
4216,1277,146,1334,302,19,11,15,57,156,24,41,0,0
4217,1279,146,1336,300,19,11,15,57,154,25,41,0,0
4218,1279,143,1335,295,19,11,15,56,152,26,41,0,0
4219,1278,140,1334,292,19,11,15,56,152,27,41,0,0
4220,1279,141,1334,290,19,11,15,55,149,28,41,0,0
4221,1283,142,1335,282,19,11,15,52,140,29,41,0,0
4222,1282,139,1334,278,19,11,15,52,139,30,41,0,0
4223,1275,132,1330,278,19,11,15,55,146,31,41,0,0
4224,1269,130,1323,273,19,11,15,54,143,32,41,0,0
4225,1263,133,1315,272,19,11,15,52,139,33,41,0,0
4226,1254,126,1308,268,19,11,15,54,142,34,41,0,0
4227,1246,124,1298,267,19,11,15,52,143,35,41,0,0
4228,1235,124,1288,267,19,11,15,53,143,36,41,0,0
4229,1222,122,1273,261,19,11,15,51,139,37,41,0,0
4230,1209,125,1258,259,19,11,15,49,134,38,41,0,0
4231,1194,122,1243,256,19,11,15,49,134,39,41,0,0
4232,1178,117,1225,251,19,11,15,47,134,40,41,0,0
4233,1170,115,1217,247,19,11,15,47,132,41,41,1,0
5156,1174,119,1218,253,20,11,15,44,134,0,61,0,1
5157,1183,120,1231,266,20,11,15,48,146,1,61,0,0
5158,1194,121,1241,266,20,11,15,47,145,2,61,0,0
5159,1208,122,1257,269,20,11,15,49,147,3,61,0,0
5160,1220,123,1268,270,20,11,15,48,147,4,61,0,0
5161,1231,121,1280,268,20,11,15,49,147,5,61,0,0
5162,1239,122,1290,276,20,11,15,51,154,6,61,0,0
5163,1247,121,1297,275,20,11,15,50,154,7,61,0,0
5164,1250,124,1302,281,20,11,15,52,157,8,61,0,0
5165,1253,129,1306,288,20,11,15,53,159,9,61,0,0
5166,1254,128,1308,289,20,11,15,54,161,10,61,0,0
5167,1255,131,1308,292,20,11,15,53,161,11,61,0,0
5168,1257,134,1310,296,20,11,15,53,162,12,61,0,0
5169,1257,135,1312,300,20,11,15,55,165,13,61,0,0
5170,1255,139,1311,306,20,11,15,56,167,14,61,0,0
5171,1253,138,1310,307,20,11,15,57,169,15,61,0,0
5172,1248,138,1310,322,20,11,15,62,184,16,61,0,0
5173,1246,139,1309,326,20,11,15,63,187,17,61,0,0
5174,1244,137,1309,331,20,11,15,65,194,18,61,0,0
5175,1238,138,1306,340,20,11,15,68,202,19,61,0,0
5176,1233,139,1304,351,20,11,15,71,212,20,61,0,0
5177,1229,138,1302,359,20,11,15,73,221,21,61,0,0
5178,1226,144,1300,371,20,11,15,74,227,22,61,0,0
5179,1225,146,1297,369,20,11,15,72,223,23,61,0,0
5180,1222,153,1293,374,20,11,15,71,221,24,61,0,0
5181,1215,159,1288,385,20,11,15,73,226,25,61,0,0
5182,1209,157,1285,393,20,11,15,76,236,26,61,0,0
5183,1206,164,1283,400,20,11,15,77,236,27,61,0,0
5184,1202,164,1280,405,20,11,15,78,241,28,61,0,0
5185,1198,168,1278,415,20,11,15,80,247,29,61,0,0
5186,1190,172,1273,429,20,11,15,83,257,30,61,0,0
5187,1183,173,1269,436,20,11,15,86,263,31,61,0,0
5188,1179,179,1267,445,20,11,15,88,266,32,61,0,0
5189,1175,180,1267,459,20,11,15,92,279,33,61,0,0
5190,1171,180,1267,474,20,11,15,96,294,34,61,0,0
5191,1166,190,1265,493,20,11,15,99,303,35,61,0,0
5192,1160,193,1262,504,20,11,15,102,311,36,61,0,0
5193,1153,195,1263,528,20,11,15,110,333,37,61,0,0
5194,1150,200,1263,546,20,11,15,113,346,38,61,0,0
5195,1144,203,1261,556,20,11,15,117,353,39,61,0,0
5196,1129,212,1253,586,20,11,15,124,374,40,61,0,0
5197,1117,220,1243,602,20,11,15,126,382,41,61,0,0
5198,1105,224,1240,630,20,11,15,135,406,42,61,0,0
5199,1092,235,1234,664,20,11,15,142,429,43,61,0,0
5200,1077,239,1225,683,20,11,15,148,444,44,61,0,0
5201,1058,250,1212,714,20,11,15,154,464,45,61,0,0
5202,1040,265,1200,743,20,11,15,160,478,46,61,0,0
5203,1025,268,1193,770,20,11,15,168,502,47,61,0,0
5204,1014,287,1193,823,20,11,15,179,536,48,61,0,0
5205,1001,298,1189,855,20,11,15,188,557,49,61,0,0
5206,985,311,1185,905,20,11,15,200,594,50,61,0,0
5207,963,338,1175,968,20,11,15,212,630,51,61,0,0
5208,943,356,1162,999,20,11,15,219,643,52,61,0,0
5209,922,382,1155,1057,20,11,15,233,675,53,61,0,0
5210,910,409,1145,1076,20,11,15,235,667,54,61,0,0
5211,901,436,1135,1080,20,11,15,234,644,55,61,0,0
5212,896,489,1123,1080,20,11,15,227,591,56,61,0,0
5213,889,537,1111,1080,20,11,15,222,543,57,61,0,0
5214,903,590,1119,1080,20,11,15,216,490,58,61,0,0
5215,961,640,1167,1076,20,11,15,206,436,59,61,0,0
5216,1056,684,1255,1076,20,11,15,199,392,60,61,0,0
5217,1076,714,1266,1080,20,11,15,190,366,61,61,1,0
5217,1201,769,1498,1068,21,11,15,297,299,0,0,0,0
5218,1401,792,1616,1066,22,11,15,215,274,0,0,0,0
329,885,528,1403,1068,1,11,2,518,540,0,25,0,1
330,913,516,1420,1066,1,11,2,507,550,1,25,0,0
331,935,496,1440,1066,1,11,2,505,570,2,25,0,0
332,948,485,1444,1067,1,11,2,496,582,3,25,0,0
333,968,480,1447,1066,1,11,2,479,586,4,25,0,0
334,981,483,1439,1066,1,11,2,458,583,5,25,0,0
335,984,486,1424,1068,1,11,2,440,582,6,25,0,0
336,983,494,1404,1070,1,11,2,421,576,7,25,0,0
337,976,502,1381,1071,1,11,2,405,569,8,25,0,0
338,947,511,1339,1069,1,11,2,392,558,9,25,0,0
339,918,522,1296,1068,1,11,2,378,546,10,25,0,0
340,881,522,1249,1066,1,11,2,368,544,11,25,0,0
341,856,529,1209,1067,1,11,2,353,538,12,25,0,0
342,825,539,1159,1071,1,11,2,334,532,13,25,0,0
343,772,542,1091,1066,1,11,2,319,524,14,25,0,0
344,708,546,1022,1073,1,11,2,314,527,15,25,0,0
345,634,568,939,1075,1,11,2,305,507,16,25,0,0
346,582,598,864,1070,1,11,2,282,472,17,25,0,0
347,512,607,787,1072,1,11,2,275,465,18,25,0,0
348,440,639,699,1075,1,11,2,259,436,19,25,0,0
349,348,674,591,1072,1,11,2,243,398,20,25,0,0
350,247,694,483,1072,1,11,2,236,378,21,25,0,0
351,148,717,378,1073,1,11,2,230,356,22,25,0,0
352,61,759,277,1078,1,11,2,216,319,23,25,0,0
353,14,843,178,1079,1,11,2,164,236,24,25,0,0
354,0,874,99,1079,1,11,2,99,205,25,25,1,0
406,819,352,878,480,2,11,2,59,128,0,5,0,0
407,819,352,878,480,2,11,2,59,128,1,5,0,0
408,818,348,880,483,2,11,2,62,135,2,5,0,0
409,818,348,880,483,2,11,2,62,135,3,5,0,0
410,818,347,881,484,2,11,2,63,137,4,5,0,0
411,817,346,882,485,2,11,2,65,139,5,5,0,0
493,822,367,879,479,3,11,2,57,112,0,0,0,0
696,0,817,120,1080,4,11,2,120,263,0,0,0,0
697,64,753,266,1078,5,11,2,202,325,0,0,0,0
698,174,684,383,1075,6,11,2,209,391,0,0,0,0
699,283,639,489,1076,7,11,2,206,437,0,0,0,0
700,416,629,626,1073,8,11,2,210,444,0,0,0,0
701,529,606,760,1069,9,11,2,231,463,0,38,0,1
702,623,575,873,1072,9,11,2,250,497,1,38,0,0
703,702,561,959,1070,9,11,2,257,509,2,38,0,0
704,764,532,1034,1069,9,11,2,270,537,3,38,0,0
705,819,504,1102,1068,9,11,2,283,564,4,38,0,0
706,868,499,1153,1071,9,11,2,285,572,5,38,0,0
707,917,491,1201,1067,9,11,2,284,576,6,38,0,0
708,947,478,1234,1065,9,11,2,287,587,7,38,0,0
709,959,473,1246,1065,9,11,2,287,592,8,38,0,0
710,955,466,1243,1068,9,11,2,288,602,9,38,0,0
711,952,463,1238,1069,9,11,2,286,606,10,38,0,0
712,949,458,1235,1071,9,11,2,286,613,11,38,0,0
713,949,461,1229,1072,9,11,2,280,611,12,38,0,0
714,946,459,1222,1072,9,11,2,276,613,13,38,0,0
715,943,462,1214,1070,9,11,2,271,608,14,38,0,0
716,943,462,1209,1071,9,11,2,266,609,15,38,0,0
717,934,457,1198,1073,9,11,2,264,616,16,38,0,0
718,936,457,1197,1075,9,11,2,261,618,17,38,0,0
719,933,456,1192,1072,9,11,2,259,616,18,38,0,0
720,930,455,1186,1070,9,11,2,256,615,19,38,0,0
721,934,460,1186,1070,9,11,2,252,610,20,38,0,0
722,930,462,1178,1070,9,11,2,248,608,21,38,0,0
723,937,466,1186,1069,9,11,2,249,603,22,38,0,0
724,944,475,1197,1068,9,11,2,253,593,23,38,0,0
725,942,498,1193,1068,9,11,2,251,570,24,38,0,0
726,931,515,1186,1069,9,11,2,255,554,25,38,0,0
727,896,526,1153,1067,9,11,2,257,541,26,38,0,0
728,856,548,1106,1064,9,11,2,250,516,27,38,0,0
729,831,561,1085,1071,9,11,2,254,510,28,38,0,0
730,811,585,1061,1071,9,11,2,250,486,29,38,0,0
731,775,605,1020,1073,9,11,2,245,468,30,38,0,0
732,707,636,946,1075,9,11,2,239,439,31,38,0,0
733,610,649,848,1073,9,11,2,238,424,32,38,0,0
734,512,673,741,1071,9,11,2,229,398,33,38,0,0
735,404,731,610,1073,9,11,2,206,342,34,38,0,0
736,280,791,460,1073,9,11,2,180,282,35,38,0,0
737,147,833,310,1073,9,11,2,163,240,36,38,0,0
738,42,882,180,1076,9,11,2,138,194,37,38,0,0
739,0,917,79,1077,9,11,2,79,160,38,38,1,0
805,818,346,884,488,10,11,2,66,142,0,0,0,0
835,823,355,875,479,11,11,2,52,124,0,0,0,0
871,822,350,881,484,12,11,2,59,134,0,5,0,0
872,822,350,880,482,12,11,2,58,132,1,5,0,0
873,822,350,880,482,12,11,2,58,132,2,5,0,0
874,822,350,880,482,12,11,2,58,132,3,5,0,0
875,822,350,880,482,12,11,2,58,132,4,5,0,0
876,822,351,880,483,12,11,2,58,132,5,5,0,0
920,818,351,877,479,13,11,2,59,128,0,0,0,0
1041,822,352,877,478,14,11,2,55,126,0,5,0,0
1042,821,352,876,478,14,11,2,55,126,1,5,0,0
1043,821,352,876,478,14,11,2,55,126,2,5,0,0
1044,821,352,876,478,14,11,2,55,126,3,5,0,0
1045,821,352,875,477,14,11,2,54,125,4,5,0,0
1046,821,352,875,476,14,11,2,54,124,5,5,0,0
1061,818,349,874,474,14,11,2,56,125,0,5,0,0
1062,818,352,873,475,14,11,2,55,123,1,5,0,0
1063,817,350,874,473,14,11,2,57,123,2,5,0,0
1064,818,353,874,475,14,11,2,56,122,3,5,0,0
1065,818,354,874,475,14,11,2,56,121,4,5,0,0
1066,818,354,874,474,14,11,2,56,120,5,5,0,0
1180,303,149,338,269,15,11,2,35,120,0,38,0,1
1181,302,150,339,277,15,11,2,37,127,1,38,0,0
1182,302,150,338,274,15,11,2,36,124,2,38,0,0
1183,301,149,339,278,15,11,2,38,129,3,38,0,0
1184,301,150,339,281,15,11,2,38,131,4,38,0,0
1185,299,149,338,284,15,11,2,39,135,5,38,0,0
1186,298,150,338,288,15,11,2,40,138,6,38,0,0
1187,298,152,338,291,15,11,2,40,139,7,38,0,0
1188,298,151,339,293,15,11,2,41,142,8,38,0,0
1189,297,155,339,299,15,11,2,42,144,9,38,0,0
1190,295,155,337,302,15,11,2,42,147,10,38,0,0
1191,292,154,336,306,15,11,2,44,152,11,38,0,0
1192,291,156,336,310,15,11,2,45,154,12,38,0,0
1193,294,158,339,311,15,11,2,45,153,13,38,0,0
1194,294,160,340,315,15,11,2,46,155,14,38,0,0
1195,293,163,341,320,15,11,2,48,157,15,38,0,0
1196,292,162,341,324,15,11,2,49,162,16,38,0,0
1197,290,166,340,329,15,11,2,50,163,17,38,0,0
1198,292,167,343,332,15,11,2,51,165,18,38,0,0
1199,293,169,344,334,15,11,2,51,165,19,38,0,0
1200,291,174,344,341,15,11,2,53,167,20,38,0,0
1201,289,175,344,348,15,11,2,55,173,21,38,0,0
1202,286,175,344,355,15,11,2,58,180,22,38,0,0
1203,284,175,344,359,15,11,2,60,184,23,38,0,0
1204,284,174,345,363,15,11,2,61,189,24,38,0,0
1205,283,177,347,371,15,11,2,64,194,25,38,0,0
1206,281,178,347,376,15,11,2,66,198,26,38,0,0
1207,278,178,347,384,15,11,2,69,206,27,38,0,0
1208,278,182,348,393,15,11,2,70,211,28,38,0,0
1209,282,182,354,398,15,11,2,72,216,29,38,0,0
1210,284,186,357,406,15,11,2,73,220,30,38,0,0
1211,280,191,354,415,15,11,2,74,224,31,38,0,0
1212,275,191,350,419,15,11,2,75,228,32,38,0,0
1213,269,194,345,430,15,11,2,76,236,33,38,0,0
1214,261,197,338,439,15,11,2,77,242,34,38,0,0
1215,253,199,330,444,15,11,2,77,245,35,38,0,0
1216,247,200,321,447,15,11,2,74,247,36,38,0,0
1217,246,218,312,446,15,11,2,66,228,37,38,0,0
1218,243,222,309,452,15,11,2,66,230,38,38,1,0
1231,250,227,306,435,15,11,2,56,208,0,38,0,0
1232,251,228,303,434,15,11,2,52,206,1,38,0,0
1233,250,226,299,434,15,11,2,49,208,2,38,0,0
1234,251,226,297,431,15,11,2,46,205,3,38,0,0
1235,252,226,296,431,15,11,2,44,205,4,38,0,0
1236,254,228,290,410,15,11,2,36,182,5,38,0,0
1237,253,229,289,407,15,11,2,36,178,6,38,0,0
1239,251,221,290,423,15,11,2,39,202,0,38,0,0
1240,252,222,289,421,15,11,2,37,199,1,38,0,0
1241,253,221,289,426,15,11,2,36,205,2,38,0,0
1242,254,223,289,428,15,11,2,35,205,3,38,0,0
1277,271,206,310,462,15,11,2,39,256,0,38,0,0
1278,277,208,322,465,15,11,2,45,257,1,38,0,0
1279,282,207,332,467,15,11,2,50,260,2,38,0,0
1280,287,203,341,465,15,11,2,54,262,3,38,0,0
1281,287,202,344,464,15,11,2,57,262,4,38,0,0
1282,281,204,341,467,15,11,2,60,263,5,38,0,0
1283,277,214,339,467,15,11,2,62,253,6,38,0,0
1284,273,235,332,464,15,11,2,59,229,7,38,0,0
1285,274,237,332,465,15,11,2,58,228,8,38,0,0
1318,818,349,879,480,17,11,2,61,131,0,0,0,0
1542,819,346,880,483,18,11,2,61,137,0,0,0,0
1996,488,396,731,1063,20,11,2,243,667,0,75,0,1
1997,479,370,730,1062,20,11,2,251,692,1,75,0,0
1998,467,373,705,1025,20,11,2,238,652,2,75,0,0
1999,435,338,660,955,20,11,2,225,617,3,75,0,0
2000,422,326,641,927,20,11,2,219,601,4,75,0,0
2001,410,314,617,883,20,11,2,207,569,5,75,0,0
2002,404,298,594,822,20,11,2,190,524,6,75,0,0
2003,397,300,579,802,20,11,2,182,502,7,75,0,0
2004,373,275,549,761,20,11,2,176,486,8,75,0,0
2005,343,264,515,741,20,11,2,172,477,9,75,0,0
2006,333,265,496,720,20,11,2,163,455,10,75,0,0
2007,322,251,474,678,20,11,2,152,427,11,75,0,0
2008,319,245,466,665,20,11,2,147,420,12,75,0,0
2009,309,246,449,646,20,11,2,140,400,13,75,0,0
2010,293,238,427,620,20,11,2,134,382,14,75,0,0
2011,282,234,412,607,20,11,2,130,373,15,75,0,0
2012,280,227,405,588,20,11,2,125,361,16,75,0,0
2013,288,225,407,565,20,11,2,119,340,17,75,0,0
2014,293,227,407,558,20,11,2,114,331,18,75,0,0
2015,284,219,394,537,20,11,2,110,318,19,75,0,0
2016,285,213,392,525,20,11,2,107,312,20,75,0,0
2017,291,212,394,517,20,11,2,103,305,21,75,0,0
2018,296,208,393,496,20,11,2,97,288,22,75,0,0
2019,293,205,388,486,20,11,2,95,281,23,75,0,0
2020,286,202,379,479,20,11,2,93,277,24,75,0,0
2021,280,200,371,468,20,11,2,91,268,25,75,0,0
2022,278,201,367,461,20,11,2,89,260,26,75,0,0
2023,278,199,365,454,20,11,2,87,255,27,75,0,0
2024,277,194,363,443,20,11,2,86,249,28,75,0,0
2025,277,195,360,438,20,11,2,83,243,29,75,0,0
2026,273,188,355,426,20,11,2,82,238,30,75,0,0
2027,271,184,351,414,20,11,2,80,230,31,75,0,0
2028,273,185,349,404,20,11,2,76,219,32,75,0,0
2029,273,178,349,397,20,11,2,76,219,33,75,0,0
2030,272,176,348,395,20,11,2,76,219,34,75,0,0
2031,271,177,345,394,20,11,2,74,217,35,75,0,0
2032,268,174,340,382,20,11,2,72,208,36,75,0,0
2033,270,175,340,379,20,11,2,70,204,37,75,0,0
2034,271,173,339,375,20,11,2,68,202,38,75,0,0
2035,271,175,337,368,20,11,2,66,193,39,75,0,0
2036,273,171,338,363,20,11,2,65,192,40,75,0,0
2037,273,169,337,358,20,11,2,64,189,41,75,0,0
2038,278,170,339,352,20,11,2,61,182,42,75,0,0
2039,281,170,341,351,20,11,2,60,181,43,75,0,0
2040,286,160,345,341,20,11,2,59,181,44,75,0,0
2041,289,161,347,339,20,11,2,58,178,45,75,0,0
2042,290,161,346,337,20,11,2,56,176,46,75,0,0
2043,290,157,346,332,20,11,2,56,175,47,75,0,0
2044,290,159,343,327,20,11,2,53,168,48,75,0,0
2045,290,158,342,326,20,11,2,52,168,49,75,0,0
2046,287,152,340,324,20,11,2,53,172,50,75,0,0
2047,289,154,339,320,20,11,2,50,166,51,75,0,0
2048,289,156,338,316,20,11,2,49,160,52,75,0,0
2049,287,152,335,312,20,11,2,48,160,53,75,0,0
2050,285,151,333,309,20,11,2,48,158,54,75,0,0
2051,289,152,335,304,20,11,2,46,152,55,75,0,0
2052,290,151,335,301,20,11,2,45,150,56,75,0,0
2053,289,150,334,299,20,11,2,45,149,57,75,0,0
2054,286,144,332,296,20,11,2,46,152,58,75,0,0
2055,288,146,331,290,20,11,2,43,144,59,75,0,0
2056,287,140,331,293,20,11,2,44,153,60,75,0,0
2057,287,141,331,290,20,11,2,44,149,61,75,0,0
2058,288,143,330,285,20,11,2,42,142,62,75,0,0
2059,288,144,329,284,20,11,2,41,140,63,75,0,0
2060,288,140,330,281,20,11,2,42,141,64,75,0,0
2061,292,145,331,277,20,11,2,39,132,65,75,0,0
2062,292,142,331,277,20,11,2,39,135,66,75,0,0
2063,291,142,330,276,20,11,2,39,134,67,75,0,0
2064,289,137,329,276,20,11,2,40,139,68,75,0,0
2065,289,136,329,275,20,11,2,40,139,69,75,0,0
2066,290,137,329,269,20,11,2,39,132,70,75,0,0
2067,289,133,328,269,20,11,2,39,136,71,75,0,0
2068,289,133,328,267,20,11,2,39,134,72,75,0,0
2069,291,134,328,265,20,11,2,37,131,73,75,0,0
2070,291,137,327,263,20,11,2,36,126,74,75,0,0
2071,291,135,327,262,20,11,2,36,127,75,75,1,0
3105,321,163,356,275,21,11,2,35,112,0,64,0,1
3106,320,164,356,279,21,11,2,36,115,1,64,0,0
3107,320,169,355,281,21,11,2,35,112,2,64,0,0
3108,322,169,357,282,21,11,2,35,113,3,64,0,0
3109,321,169,358,288,21,11,2,37,119,4,64,0,0
3110,320,172,357,288,21,11,2,37,116,5,64,0,0
3111,318,173,356,294,21,11,2,38,121,6,64,0,0
3112,318,174,356,296,21,11,2,38,122,7,64,0,0
3113,318,175,358,299,21,11,2,40,124,8,64,0,0
3114,319,178,358,301,21,11,2,39,123,9,64,0,0
3115,319,180,359,303,21,11,2,40,123,10,64,0,0
3116,318,179,360,309,21,11,2,42,130,11,64,0,0
3117,319,180,362,313,21,11,2,43,133,12,64,0,0
3118,321,179,365,316,21,11,2,44,137,13,64,0,0
3119,322,179,367,320,21,11,2,45,141,14,64,0,0
3120,322,180,369,324,21,11,2,47,144,15,64,0,0
3121,321,183,369,330,21,11,2,48,147,16,64,0,0
3122,323,184,370,332,21,11,2,47,148,17,64,0,0
3123,325,185,374,335,21,11,2,49,150,18,64,0,0
3124,327,189,376,341,21,11,2,49,152,19,64,0,0
3125,326,190,377,346,21,11,2,51,156,20,64,0,0
3126,327,192,380,351,21,11,2,53,159,21,64,0,0
3127,329,195,383,358,21,11,2,54,163,22,64,0,0
3128,333,191,390,363,21,11,2,57,172,23,64,0,0
3129,337,197,394,367,21,11,2,57,170,24,64,0,0
3130,338,198,397,375,21,11,2,59,177,25,64,0,0
3131,337,199,399,383,21,11,2,62,184,26,64,0,0
3132,338,202,402,392,21,11,2,64,190,27,64,0,0
3133,340,203,405,397,21,11,2,65,194,28,64,0,0
3134,343,206,410,402,21,11,2,67,196,29,64,0,0
3135,343,207,413,411,21,11,2,70,204,30,64,0,0
3136,346,207,420,420,21,11,2,74,213,31,64,0,0
3137,351,212,426,430,21,11,2,75,218,32,64,0,0
3138,358,214,433,435,21,11,2,75,221,33,64,0,0
3139,362,221,438,443,21,11,2,76,222,34,64,0,0
3140,363,225,441,453,21,11,2,78,228,35,64,0,0
3141,365,227,446,463,21,11,2,81,236,36,64,0,0
3142,370,237,451,477,21,11,2,81,240,37,64,0,0
3143,379,239,463,484,21,11,2,84,245,38,64,0,0
3144,386,243,473,498,21,11,2,87,255,39,64,0,0
3145,390,247,479,509,21,11,2,89,262,40,64,0,0
3146,395,252,489,526,21,11,2,94,274,41,64,0,0
3147,402,259,500,544,21,11,2,98,285,42,64,0,0
3148,414,264,516,558,21,11,2,102,294,43,64,0,0
3149,422,274,527,577,21,11,2,105,303,44,64,0,0
3150,421,280,531,592,21,11,2,110,312,45,64,0,0
3151,418,286,537,623,21,11,2,119,337,46,64,0,0
3152,419,295,543,650,21,11,2,124,355,47,64,0,0
3153,430,304,555,660,21,11,2,125,356,48,64,0,0
3154,441,316,574,695,21,11,2,133,379,49,64,0,0
3155,445,329,585,725,21,11,2,140,396,50,64,0,0
3156,449,339,596,753,21,11,2,147,414,51,64,0,0
3157,459,352,615,794,21,11,2,156,442,52,64,0,0
3158,476,361,638,817,21,11,2,162,456,53,64,0,0
3159,490,388,663,870,21,11,2,173,482,54,64,0,0
3160,495,408,678,913,21,11,2,183,505,55,64,0,0
3161,502,426,694,949,21,11,2,192,523,56,64,0,0
3162,514,458,721,1023,21,11,2,207,565,57,64,0,0
3163,541,483,755,1057,21,11,2,214,574,58,64,0,0
3164,583,522,796,1072,21,11,2,213,550,59,64,0,0
3165,614,570,824,1080,21,11,2,210,510,60,64,0,0
3166,637,623,833,1078,21,11,2,196,455,61,64,0,0
3167,705,695,882,1079,21,11,2,177,384,62,64,0,0
3168,802,760,968,1080,21,11,2,166,320,63,64,0,0
3169,836,793,995,1080,21,11,2,159,287,64,64,1,0
3405,327,166,362,270,24,11,2,35,104,0,66,0,0
3408,327,168,362,277,24,11,2,35,109,0,66,0,1
3409,329,172,364,277,24,11,2,35,105,1,66,0,0
3410,331,172,366,281,24,11,2,35,109,2,66,0,0
3411,332,173,369,286,24,11,2,37,113,3,66,0,0
3412,335,175,372,288,24,11,2,37,113,4,66,0,0
3413,336,174,375,289,24,11,2,39,115,5,66,0,0
3414,336,176,376,294,24,11,2,40,118,6,66,0,0
3415,337,173,379,296,24,11,2,42,123,7,66,0,0
3416,339,174,381,299,24,11,2,42,125,8,66,0,0
3417,340,175,382,300,24,11,2,42,125,9,66,0,0
3418,342,175,385,301,24,11,2,43,126,10,66,0,0
3419,342,177,387,307,24,11,2,45,130,11,66,0,0
3420,344,178,389,309,24,11,2,45,131,12,66,0,0
3421,345,181,391,313,24,11,2,46,132,13,66,0,0
3422,345,182,392,318,24,11,2,47,136,14,66,0,0
3423,343,182,391,321,24,11,2,48,139,15,66,0,0
3424,340,180,392,328,24,11,2,52,148,16,66,0,0
3425,339,180,392,333,24,11,2,53,153,17,66,0,0
3426,338,180,391,336,24,11,2,53,156,18,66,0,0
3427,337,185,389,339,24,11,2,52,154,19,66,0,0
3428,337,187,389,340,24,11,2,52,153,20,66,0,0
3429,340,185,396,351,24,11,2,56,166,21,66,0,0
3430,344,193,400,355,24,11,2,56,162,22,66,0,0
3431,349,192,407,359,24,11,2,58,167,23,66,0,0
3432,354,198,411,366,24,11,2,57,168,24,66,0,0
3433,357,203,416,373,24,11,2,59,170,25,66,0,0
3434,363,203,424,378,24,11,2,61,175,26,66,0,0
3435,369,207,432,386,24,11,2,63,179,27,66,0,0
3436,374,206,439,391,24,11,2,65,185,28,66,0,0
3437,375,206,442,397,24,11,2,67,191,29,66,0,0
3438,375,210,443,405,24,11,2,68,195,30,66,0,0
3439,379,209,451,414,24,11,2,72,205,31,66,0,0
3440,388,219,462,425,24,11,2,74,206,32,66,0,0
3441,393,217,470,430,24,11,2,77,213,33,66,0,0
3442,396,225,473,438,24,11,2,77,213,34,66,0,0
3443,395,228,475,451,24,11,2,80,223,35,66,0,0
3444,397,227,481,458,24,11,2,84,231,36,66,0,0
3445,397,231,484,467,24,11,2,87,236,37,66,0,0
3446,403,238,489,474,24,11,2,86,236,38,66,0,0
3447,404,239,493,484,24,11,2,89,245,39,66,0,0
3448,406,251,497,501,24,11,2,91,250,40,66,0,0
3449,409,255,502,509,24,11,2,93,254,41,66,0,0
3450,414,260,512,524,24,11,2,98,264,42,66,0,0
3451,420,268,523,545,24,11,2,103,277,43,66,0,0
3452,425,268,533,559,24,11,2,108,291,44,66,0,0
3453,428,277,539,579,24,11,2,111,302,45,66,0,0
3454,433,286,548,597,24,11,2,115,311,46,66,0,0
3455,431,288,553,618,24,11,2,122,330,47,66,0,0
3456,431,297,562,652,24,11,2,131,355,48,66,0,0
3457,440,305,573,666,24,11,2,133,361,49,66,0,0
3458,443,317,583,702,24,11,2,140,385,50,66,0,0
3459,456,337,598,729,24,11,2,142,392,51,66,0,0
3460,472,342,620,740,24,11,2,148,398,52,66,0,0
3461,478,354,640,780,24,11,2,162,426,53,66,0,0
3462,501,368,670,805,24,11,2,169,437,54,66,0,0
3463,518,381,701,854,24,11,2,183,473,55,66,0,0
3464,536,408,727,904,24,11,2,191,496,56,66,0,0
3465,558,427,751,923,24,11,2,193,496,57,66,0,0
3466,579,455,786,979,24,11,2,207,524,58,66,0,0
3467,597,489,814,1036,24,11,2,217,547,59,66,0,0
3468,626,516,850,1067,24,11,2,224,551,60,66,0,0
3469,656,582,868,1076,24,11,2,212,494,61,66,0,0
3470,694,640,896,1080,24,11,2,202,440,62,66,0,0
3471,773,696,964,1080,24,11,2,191,384,63,66,0,0
3472,883,762,1062,1080,24,11,2,179,318,64,66,0,0
3473,993,834,1153,1080,24,11,2,160,246,65,66,0,0
3474,1047,873,1192,1080,24,11,2,145,207,66,66,1,0
3404,284,155,319,270,25,11,2,35,115,0,66,0,0
3405,287,155,322,270,25,11,2,35,115,1,66,0,0
3408,292,156,328,275,25,11,2,36,119,0,66,0,1
3409,293,159,329,280,25,11,2,36,121,1,66,0,0
3410,294,159,331,283,25,11,2,37,124,2,66,0,0
3411,294,158,332,287,25,11,2,38,129,3,66,0,0
3412,294,162,332,290,25,11,2,38,128,4,66,0,0
3413,294,160,333,294,25,11,2,39,134,5,66,0,0
3414,293,162,333,298,25,11,2,40,136,6,66,0,0
3415,293,166,333,300,25,11,2,40,134,7,66,0,0
3416,295,165,336,303,25,11,2,41,138,8,66,0,0
3417,295,167,337,307,25,11,2,42,140,9,66,0,0
3418,295,169,338,308,25,11,2,43,139,10,66,0,0
3419,292,169,337,311,25,11,2,45,142,11,66,0,0
3420,290,169,338,317,25,11,2,48,148,12,66,0,0
3421,288,171,336,321,25,11,2,48,150,13,66,0,0
3422,286,170,336,325,25,11,2,50,155,14,66,0,0
3423,287,173,337,330,25,11,2,50,157,15,66,0,0
3424,286,173,338,333,25,11,2,52,160,16,66,0,0
3425,288,175,339,336,25,11,2,51,161,17,66,0,0
3426,291,178,343,340,25,11,2,52,162,18,66,0,0
3427,295,181,346,341,25,11,2,51,160,19,66,0,0
3428,293,180,347,350,25,11,2,54,170,20,66,0,0
3429,288,180,345,357,25,11,2,57,177,21,66,0,0
3430,284,179,342,361,25,11,2,58,182,22,66,0,0
3431,283,182,342,368,25,11,2,59,186,23,66,0,0
3432,282,183,341,371,25,11,2,59,188,24,66,0,0
3433,280,184,341,377,25,11,2,61,193,25,66,0,0
3434,279,189,342,387,25,11,2,63,198,26,66,0,0
3435,279,189,343,393,25,11,2,64,204,27,66,0,0
3436,281,195,346,400,25,11,2,65,205,28,66,0,0
3437,285,199,350,405,25,11,2,65,206,29,66,0,0
3438,290,199,357,410,25,11,2,67,211,30,66,0,0
3439,290,202,361,422,25,11,2,71,220,31,66,0,0
3440,289,202,362,430,25,11,2,73,228,32,66,0,0
3441,289,204,364,435,25,11,2,75,231,33,66,0,0
3442,288,209,365,451,25,11,2,77,242,34,66,0,0
3443,291,213,368,456,25,11,2,77,243,35,66,0,0
3444,290,218,370,466,25,11,2,80,248,36,66,0,0
3445,286,222,369,483,25,11,2,83,261,37,66,0,0
3446,282,222,367,488,25,11,2,85,266,38,66,0,0
3447,284,228,371,499,25,11,2,87,271,39,66,0,0
3448,286,232,376,514,25,11,2,90,282,40,66,0,0
3449,294,234,386,522,25,11,2,92,288,41,66,0,0
3450,297,241,394,543,25,11,2,97,302,42,66,0,0
3451,296,243,399,563,25,11,2,103,320,43,66,0,0
3452,296,245,402,576,25,11,2,106,331,44,66,0,0
3453,299,258,407,593,25,11,2,108,335,45,66,0,0
3454,309,262,420,608,25,11,2,111,346,46,66,0,0
3455,311,269,430,642,25,11,2,119,373,47,66,0,0
3456,311,278,436,672,25,11,2,125,394,48,66,0,0
3457,314,283,442,684,25,11,2,128,401,49,66,0,0
3458,312,293,447,715,25,11,2,135,422,50,66,0,0
3459,313,307,450,735,25,11,2,137,428,51,66,0,0
3460,313,314,456,761,25,11,2,143,447,52,66,0,0
3461,310,330,464,810,25,11,2,154,480,53,66,0,0
3462,304,340,462,833,25,11,2,158,493,54,66,0,0
3463,297,361,465,881,25,11,2,168,520,55,66,0,0
3464,285,388,463,941,25,11,2,178,553,56,66,0,0
3465,285,404,467,967,25,11,2,182,563,57,66,0,0
3466,280,429,473,1026,25,11,2,193,597,58,66,0,0
3467,270,464,468,1060,25,11,2,198,596,59,66,0,0
3468,261,486,463,1080,25,11,2,202,594,60,66,0,0
3469,264,531,460,1080,25,11,2,196,549,61,66,0,0
3470,298,585,487,1080,25,11,2,189,495,62,66,0,0
3471,336,638,523,1080,25,11,2,187,442,63,66,0,0
3472,400,737,577,1080,25,11,2,177,343,64,66,0,0
3473,458,861,604,1080,25,11,2,146,219,65,66,0,0
3474,488,910,612,1080,25,11,2,124,170,66,66,1,0
3749,819,395,876,476,30,11,2,57,81,0,1,0,0
3750,819,395,876,476,30,11,2,57,81,1,1,0,0
4286,821,352,877,479,31,11,2,56,127,0,4,0,0
4287,821,352,877,479,31,11,2,56,127,1,4,0,0
4288,821,351,876,477,31,11,2,55,126,2,4,0,0
4289,821,350,877,477,31,11,2,56,127,3,4,0,0
4290,821,350,877,477,31,11,2,56,127,4,4,0,0
4491,561,517,1111,1072,34,11,2,550,555,0,4,0,0
4492,495,474,1067,1072,34,11,2,572,598,1,4,0,0
4493,458,451,1029,1072,34,11,2,571,621,2,4,0,0
4494,444,421,991,1043,34,11,2,547,622,3,4,0,0
4495,380,381,960,1041,34,11,2,580,660,4,4,0,0
4495,620,403,806,1002,35,11,2,186,599,0,165,0,1
4496,610,403,789,975,35,11,2,179,572,1,165,0,0
4497,560,382,726,914,35,11,2,166,532,2,165,0,0
4498,526,365,690,890,35,11,2,164,525,3,165,0,0
4499,510,345,671,859,35,11,2,161,514,4,165,0,0
4500,503,325,652,800,35,11,2,149,475,5,165,0,0
4501,498,322,640,778,35,11,2,142,456,6,165,0,0
4502,479,307,614,737,35,11,2,135,430,7,165,0,0
4503,448,296,582,721,35,11,2,134,425,8,165,0,0
4504,435,293,568,713,35,11,2,133,420,9,165,0,0
4505,435,282,559,672,35,11,2,124,390,10,165,0,0
4506,437,278,554,648,35,11,2,117,370,11,165,0,0
4507,431,272,544,627,35,11,2,113,355,12,165,0,0
4508,418,260,528,602,35,11,2,110,342,13,165,0,0
4509,412,255,522,597,35,11,2,110,342,14,165,0,0
4510,417,251,524,582,35,11,2,107,331,15,165,0,0
4511,423,240,525,558,35,11,2,102,318,16,165,0,0
4512,428,238,526,545,35,11,2,98,307,17,165,0,0
4513,425,230,520,526,35,11,2,95,296,18,165,0,0
4514,423,227,516,515,35,11,2,93,288,19,165,0,0
4515,424,226,515,513,35,11,2,91,287,20,165,0,0
4516,424,222,512,498,35,11,2,88,276,21,165,0,0
4517,426,217,510,484,35,11,2,84,267,22,165,0,0
4518,423,211,507,478,35,11,2,84,267,23,165,0,0
4519,416,208,497,464,35,11,2,81,256,24,165,0,0
4520,411,211,488,458,35,11,2,77,247,25,165,0,0
4521,412,208,487,449,35,11,2,75,241,26,165,0,0
4522,413,203,486,438,35,11,2,73,235,27,165,0,0
4523,412,203,482,431,35,11,2,70,228,28,165,0,0
4524,403,195,474,424,35,11,2,71,229,29,165,0,0
4525,403,193,471,415,35,11,2,68,222,30,165,0,0
4526,403,193,470,412,35,11,2,67,219,31,165,0,0
4527,402,186,469,402,35,11,2,67,216,32,165,0,0
4528,402,189,466,397,35,11,2,64,208,33,165,0,0
4529,395,186,458,388,35,11,2,63,202,34,165,0,0
4530,390,178,452,381,35,11,2,62,203,35,165,0,0
4531,387,177,448,380,35,11,2,61,203,36,165,0,0
4532,388,176,446,370,35,11,2,58,194,37,165,0,0
4533,386,177,443,365,35,11,2,57,188,38,165,0,0
4534,382,176,438,362,35,11,2,56,186,39,165,0,0
4535,377,173,433,358,35,11,2,56,185,40,165,0,0
4536,374,177,427,351,35,11,2,53,174,41,165,0,0
4537,373,177,425,347,35,11,2,52,170,42,165,0,0
4538,372,174,424,343,35,11,2,52,169,43,165,0,0
4539,370,174,422,342,35,11,2,52,168,44,165,0,0
4540,366,170,418,337,35,11,2,52,167,45,165,0,0
4541,363,168,414,333,35,11,2,51,165,46,165,0,0
4542,363,169,413,330,35,11,2,50,161,47,165,0,0
4543,363,166,413,323,35,11,2,50,157,48,165,0,0
4544,365,166,413,319,35,11,2,48,153,49,165,0,0
4545,363,167,411,320,35,11,2,48,153,50,165,0,0
4546,361,167,410,319,35,11,2,49,152,51,165,0,0
4547,362,168,408,315,35,11,2,46,147,52,165,0,0
4548,366,170,411,313,35,11,2,45,143,53,165,0,0
4549,369,170,413,307,35,11,2,44,137,54,165,0,0
4550,371,169,415,304,35,11,2,44,135,55,165,0,0
4551,368,168,412,301,35,11,2,44,133,56,165,0,0
4552,366,161,410,299,35,11,2,44,138,57,165,0,0
4553,365,162,408,295,35,11,2,43,133,58,165,0,0
4554,366,159,410,293,35,11,2,44,134,59,165,0,0
4555,366,157,409,290,35,11,2,43,133,60,165,0,0
4556,364,161,405,288,35,11,2,41,127,61,165,0,0
4557,359,156,402,287,35,11,2,43,131,62,165,0,0
4558,357,151,400,284,35,11,2,43,133,63,165,0,0
4559,355,150,397,283,35,11,2,42,133,64,165,0,0
4560,353,150,395,280,35,11,2,42,130,65,165,0,0
4561,350,151,392,279,35,11,2,42,128,66,165,0,0
4562,348,152,390,278,35,11,2,42,126,67,165,0,0
4563,345,149,388,276,35,11,2,43,127,68,165,0,0
4564,344,148,387,276,35,11,2,43,128,69,165,0,0
4565,345,147,389,274,35,11,2,44,127,70,165,0,0
4566,346,148,389,272,35,11,2,43,124,71,165,0,0
4567,347,148,389,271,35,11,2,42,123,72,165,0,0
4568,347,149,389,270,35,11,2,42,121,73,165,0,0
4569,344,149,387,270,35,11,2,43,121,74,165,0,0
4570,342,146,387,269,35,11,2,45,123,75,165,0,0
4571,342,146,386,268,35,11,2,44,122,76,165,0,0
4572,342,146,387,268,35,11,2,45,122,77,165,0,0
4573,344,146,389,266,35,11,2,45,120,78,165,0,0
4574,345,148,389,266,35,11,2,44,118,79,165,0,0
4575,345,147,389,265,35,11,2,44,118,80,165,0,0
4576,345,147,389,266,35,11,2,44,119,81,165,0,0
4577,345,148,389,267,35,11,2,44,119,82,165,0,0
4578,345,148,390,267,35,11,2,45,119,83,165,0,0
4579,345,147,390,267,35,11,2,45,120,84,165,0,0
4580,345,149,390,267,35,11,2,45,118,85,165,0,0
4581,345,148,389,268,35,11,2,44,120,86,165,0,0
4582,345,148,389,268,35,11,2,44,120,87,165,0,0
4583,345,147,390,268,35,11,2,45,121,88,165,0,0
4584,345,146,390,268,35,11,2,45,122,89,165,0,0
4585,345,146,390,268,35,11,2,45,122,90,165,0,0
4586,345,146,390,268,35,11,2,45,122,91,165,0,0
4587,345,147,390,268,35,11,2,45,121,92,165,0,0
4588,346,147,390,268,35,11,2,44,121,93,165,0,0
4589,346,147,390,268,35,11,2,44,121,94,165,0,0
4590,347,149,391,268,35,11,2,44,119,95,165,0,0
4591,347,149,391,268,35,11,2,44,119,96,165,0,0
4592,347,149,391,268,35,11,2,44,119,97,165,0,0
4593,348,150,392,268,35,11,2,44,118,98,165,0,0
4594,349,149,392,268,35,11,2,43,119,99,165,0,0
4595,350,148,394,270,35,11,2,44,122,100,165,0,0
4596,352,149,394,270,35,11,2,42,121,101,165,0,0
4597,350,146,392,269,35,11,2,42,123,102,165,0,0
4598,348,150,389,269,35,11,2,41,119,103,165,0,0
4599,347,150,388,270,35,11,2,41,120,104,165,0,0
4600,345,148,388,270,35,11,2,43,122,105,165,0,0
4601,340,156,381,272,35,11,2,41,116,106,165,0,0
4602,336,160,375,272,35,11,2,39,112,107,165,0,0
4603,335,163,374,273,35,11,2,39,110,108,165,0,0
4604,336,168,373,274,35,11,2,37,106,109,165,0,0
4605,336,159,377,276,35,11,2,41,117,110,165,0,0
4606,338,153,382,277,35,11,2,44,124,111,165,0,0
4607,340,155,384,280,35,11,2,44,125,112,165,0,0
4608,342,157,384,281,35,11,2,42,124,113,165,0,0
4609,344,159,386,282,35,11,2,42,123,114,165,0,0
4610,344,157,388,285,35,11,2,44,128,115,165,0,0
4611,345,156,390,288,35,11,2,45,132,116,165,0,0
4612,346,150,393,290,35,11,2,47,140,117,165,0,0
4613,348,148,395,290,35,11,2,47,142,118,165,0,0
4614,349,155,394,292,35,11,2,45,137,119,165,0,0
4615,350,157,394,292,35,11,2,44,135,120,165,0,0
4616,352,160,396,294,35,11,2,44,134,121,165,0,0
4617,355,160,400,296,35,11,2,45,136,122,165,0,0
4618,358,157,403,293,35,11,2,45,136,123,165,0,0
4619,360,154,405,293,35,11,2,45,139,124,165,0,0
4620,363,158,407,291,35,11,2,44,133,125,165,0,0
4621,366,158,409,292,35,11,2,43,134,126,165,0,0
4622,366,158,410,293,35,11,2,44,135,127,165,0,0
4623,366,158,409,294,35,11,2,43,136,128,165,0,0
4624,366,155,410,292,35,11,2,44,137,129,165,0,0
4625,366,153,411,292,35,11,2,45,139,130,165,0,0
4626,365,154,410,294,35,11,2,45,140,131,165,0,0
4627,364,155,408,295,35,11,2,44,140,132,165,0,0
4628,365,157,408,294,35,11,2,43,137,133,165,0,0
4629,363,159,404,292,35,11,2,41,133,134,165,0,0
4630,360,157,402,292,35,11,2,42,135,135,165,0,0
4631,358,157,399,291,35,11,2,41,134,136,165,0,0
4632,358,159,397,291,35,11,2,39,132,137,165,0,0
4633,358,154,399,294,35,11,2,41,140,138,165,0,0
4634,358,154,400,296,35,11,2,42,142,139,165,0,0
4635,360,154,402,295,35,11,2,42,141,140,165,0,0
4636,362,153,402,292,35,11,2,40,139,141,165,0,0
4637,362,154,402,292,35,11,2,40,138,142,165,0,0
4638,362,154,402,292,35,11,2,40,138,143,165,0,0
4639,362,153,401,289,35,11,2,39,136,144,165,0,0
4640,363,154,402,287,35,11,2,39,133,145,165,0,0
4641,364,153,403,288,35,11,2,39,135,146,165,0,0
4642,364,154,402,284,35,11,2,38,130,147,165,0,0
4643,362,152,400,280,35,11,2,38,128,148,165,0,0
4644,360,149,398,278,35,11,2,38,129,149,165,0,0
4645,357,148,396,281,35,11,2,39,133,150,165,0,0
4646,356,147,394,276,35,11,2,38,129,151,165,0,0
4647,354,149,391,273,35,11,2,37,124,152,165,0,0
4648,351,149,388,271,35,11,2,37,122,153,165,0,0
4649,347,146,385,267,35,11,2,38,121,154,165,0,0
4650,348,148,384,264,35,11,2,36,116,155,165,0,0
4651,347,147,383,260,35,11,2,36,113,156,165,0,0
4652,347,147,383,259,35,11,2,36,112,157,165,0,0
4653,346,145,383,256,35,11,2,37,111,158,165,0,0
4654,343,143,380,252,35,11,2,37,109,159,165,0,0
4655,345,146,381,250,35,11,2,36,104,160,165,0,0
4656,344,145,380,249,35,11,2,36,104,161,165,0,0
4657,344,149,379,247,35,11,2,35,98,162,165,0,0
4658,341,147,376,245,35,11,2,35,98,163,165,0,0
4659,338,142,374,244,35,11,2,36,102,164,165,0,0
4660,338,143,373,242,35,11,2,35,99,165,165,1,0
4677,323,130,358,220,35,11,2,35,90,0,165,0,0
4679,322,128,357,218,35,11,2,35,90,0,165,0,0
4681,321,126,357,216,35,11,2,36,90,0,165,0,0
4682,321,127,357,216,35,11,2,36,89,1,165,0,0
4683,321,129,356,215,35,11,2,35,86,2,165,0,0
4684,320,127,355,213,35,11,2,35,86,3,165,0,0
4686,320,125,355,210,35,11,2,35,85,0,165,0,0
4531,823,355,877,481,36,11,2,54,126,0,5,0,0
4532,823,354,878,481,36,11,2,55,127,1,5,0,0
4533,823,354,877,480,36,11,2,54,126,2,5,0,0
4534,823,354,877,480,36,11,2,54,126,3,5,0,0
4535,821,352,877,483,36,11,2,56,131,4,5,0,0
4536,820,351,877,484,36,11,2,57,133,5,5,0,0
4562,823,349,880,478,36,11,2,57,129,0,5,0,0
4563,823,349,881,477,36,11,2,58,128,1,5,0,0
4564,822,349,880,478,36,11,2,58,129,2,5,0,0
4565,822,348,881,478,36,11,2,59,130,3,5,0,0
4566,822,348,881,478,36,11,2,59,130,4,5,0,0
4606,816,349,880,481,37,11,2,64,132,0,5,0,0
4607,815,348,880,481,37,11,2,65,133,1,5,0,0
4608,815,348,880,482,37,11,2,65,134,2,5,0,0
4609,815,347,881,484,37,11,2,66,137,3,5,0,0
4610,815,347,881,485,37,11,2,66,138,4,5,0,0
4611,815,346,882,485,37,11,2,67,139,5,5,0,0
4646,811,351,877,477,38,11,2,66,126,0,5,0,0
4647,811,351,876,476,38,11,2,65,125,1,5,0,0
4648,811,352,876,475,38,11,2,65,123,2,5,0,0
4649,811,352,876,475,38,11,2,65,123,3,5,0,0
4650,812,352,877,475,38,11,2,65,123,4,5,0,0
4651,812,352,877,475,38,11,2,65,123,5,5,0,0
4706,819,363,878,478,39,11,2,59,115,0,5,0,0
4707,817,356,880,478,39,11,2,63,122,1,5,0,0
4708,817,357,879,479,39,11,2,62,122,2,5,0,0
4709,818,359,878,478,39,11,2,60,119,3,5,0,0
4710,816,354,880,478,39,11,2,64,124,4,5,0,0
4711,816,352,880,478,39,11,2,64,126,5,5,0,0
4811,819,349,880,483,40,11,2,61,134,0,4,0,0
4812,819,348,880,483,40,11,2,61,135,1,4,0,0
4813,817,343,882,486,40,11,2,65,143,2,4,0,0
4814,818,346,881,484,40,11,2,63,138,3,4,0,0
4815,818,345,881,484,40,11,2,63,139,4,4,0,0
4881,820,352,878,480,41,11,2,58,128,0,5,0,0
4882,820,352,877,479,41,11,2,57,127,1,5,0,0
4883,820,352,878,478,41,11,2,58,126,2,5,0,0
4884,820,352,877,478,41,11,2,57,126,3,5,0,0
4885,820,352,877,478,41,11,2,57,126,4,5,0,0
4886,820,352,877,478,41,11,2,57,126,5,5,0,0
5021,822,351,876,478,42,11,2,54,127,0,5,0,0
5022,822,351,876,478,42,11,2,54,127,1,5,0,0
5023,822,352,875,478,42,11,2,53,126,2,5,0,0
5024,822,353,875,478,42,11,2,53,125,3,5,0,0
5025,821,353,875,478,42,11,2,54,125,4,5,0,0
5026,821,353,874,478,42,11,2,53,125,5,5,0,0
5109,259,267,311,478,43,11,2,52,211,0,55,0,1
5110,252,214,316,477,43,11,2,64,263,1,55,0,0
5111,260,205,327,478,43,11,2,67,273,2,55,0,0
5112,282,204,350,474,43,11,2,68,270,3,55,0,0
5113,296,203,364,470,43,11,2,68,267,4,55,0,0
5114,308,200,375,461,43,11,2,67,261,5,55,0,0
5115,317,201,384,457,43,11,2,67,256,6,55,0,0
5116,319,200,385,449,43,11,2,66,249,7,55,0,0
5117,319,195,384,438,43,11,2,65,243,8,55,0,0
5118,319,192,383,430,43,11,2,64,238,9,55,0,0
5119,321,195,385,429,43,11,2,64,234,10,55,0,0
5120,327,187,391,420,43,11,2,64,233,11,55,0,0
5121,330,184,394,412,43,11,2,64,228,12,55,0,0
5122,330,185,393,407,43,11,2,63,222,13,55,0,0
5123,325,182,388,400,43,11,2,63,218,14,55,0,0
5124,319,179,382,396,43,11,2,63,217,15,55,0,0
5125,318,181,380,394,43,11,2,62,213,16,55,0,0
5126,317,179,378,382,43,11,2,61,203,17,55,0,0
5127,315,176,376,377,43,11,2,61,201,18,55,0,0
5128,310,177,370,371,43,11,2,60,194,19,55,0,0
5129,303,175,362,365,43,11,2,59,190,20,55,0,0
5130,299,175,356,361,43,11,2,57,186,21,55,0,0
5131,296,176,352,360,43,11,2,56,184,22,55,0,0
5132,293,171,349,355,43,11,2,56,184,23,55,0,0
5133,292,171,347,352,43,11,2,55,181,24,55,0,0
5134,289,170,344,349,43,11,2,55,179,25,55,0,0
5135,285,168,339,344,43,11,2,54,176,26,55,0,0
5136,284,167,337,339,43,11,2,53,172,27,55,0,0
5137,284,167,336,337,43,11,2,52,170,28,55,0,0
5138,286,167,336,330,43,11,2,50,163,29,55,0,0
5139,287,167,337,326,43,11,2,50,159,30,55,0,0
5140,286,164,335,325,43,11,2,49,161,31,55,0,0
5141,285,161,334,322,43,11,2,49,161,32,55,0,0
5142,285,162,333,317,43,11,2,48,155,33,55,0,0
5143,287,164,334,316,43,11,2,47,152,34,55,0,0
5144,290,159,336,310,43,11,2,46,151,35,55,0,0
5145,291,159,336,307,43,11,2,45,148,36,55,0,0
5146,288,157,334,307,43,11,2,46,150,37,55,0,0
5147,287,155,332,304,43,11,2,45,149,38,55,0,0
5148,287,158,331,301,43,11,2,44,143,39,55,0,0
5149,288,155,332,299,43,11,2,44,144,40,55,0,0
5150,289,154,333,298,43,11,2,44,144,41,55,0,0
5151,290,153,334,298,43,11,2,44,145,42,55,0,0
5152,289,151,333,295,43,11,2,44,144,43,55,0,0
5153,290,152,331,288,43,11,2,41,136,44,55,0,0
5154,291,153,331,285,43,11,2,40,132,45,55,0,0
5155,292,153,331,280,43,11,2,39,127,46,55,0,0
5156,292,152,331,281,43,11,2,39,129,47,55,0,0
5157,291,151,330,279,43,11,2,39,128,48,55,0,0
5158,291,151,328,276,43,11,2,37,125,49,55,0,0
5159,290,151,328,276,43,11,2,38,125,50,55,0,0
5160,291,151,327,271,43,11,2,36,120,51,55,0,0
5161,291,151,327,270,43,11,2,36,119,52,55,0,0
5162,291,150,327,270,43,11,2,36,120,53,55,0,0
5163,289,149,325,269,43,11,2,36,120,54,55,0,0
5164,288,149,323,264,43,11,2,35,115,55,55,1,0
72,307,130,342,218,2,11,3,35,88,0,0,0,0
89,352,140,387,238,4,11,3,35,98,0,8,0,0
90,358,143,394,245,4,11,3,36,102,1,8,0,0
91,362,144,398,247,4,11,3,36,103,2,8,0,0
93,375,144,413,250,4,11,3,38,106,0,8,0,0
94,379,144,419,254,4,11,3,40,110,1,8,0,0
95,390,145,425,242,4,11,3,35,97,2,8,0,0
97,396,145,435,251,4,11,3,39,106,0,8,0,0
98,399,146,442,260,4,11,3,43,114,1,8,0,0
99,407,147,451,262,4,11,3,44,115,2,8,0,0
100,420,146,460,249,4,11,3,40,103,3,8,0,0
101,427,146,470,254,4,11,3,43,108,4,8,0,0
102,439,146,481,255,4,11,3,42,109,5,8,0,0
103,453,146,490,240,4,11,3,37,94,6,8,0,0
104,459,150,503,260,4,11,3,44,110,7,8,0,0
105,467,151,511,263,4,11,3,44,112,8,8,0,0
197,236,221,294,571,5,11,3,58,350,0,27,0,1
198,256,248,312,586,5,11,3,56,338,1,27,0,0
199,273,262,332,609,5,11,3,59,347,2,27,0,0
200,297,257,359,612,5,11,3,62,355,3,27,0,0
201,336,273,404,641,5,11,3,68,368,4,27,0,0
202,359,278,432,657,5,11,3,73,379,5,27,0,0
203,388,277,465,665,5,11,3,77,388,6,27,0,0
204,410,286,494,696,5,11,3,84,410,7,27,0,0
205,432,287,524,718,5,11,3,92,431,8,27,0,0
206,466,288,568,742,5,11,3,102,454,9,27,0,0
207,489,302,598,776,5,11,3,109,474,10,27,0,0
208,512,309,626,791,5,11,3,114,482,11,27,0,0
209,534,326,657,839,5,11,3,123,513,12,27,0,0
210,548,336,680,871,5,11,3,132,535,13,27,0,0
211,564,345,701,886,5,11,3,137,541,14,27,0,0
212,584,372,735,947,5,11,3,151,575,15,27,0,0
213,604,392,765,984,5,11,3,161,592,16,27,0,0
214,619,407,795,1031,5,11,3,176,624,17,27,0,0
215,628,434,816,1067,5,11,3,188,633,18,27,0,0
216,632,456,827,1080,5,11,3,195,624,19,27,0,0
217,647,480,844,1080,5,11,3,197,600,20,27,0,0
218,670,529,863,1080,5,11,3,193,551,21,27,0,0
219,703,570,896,1080,5,11,3,193,510,22,27,0,0
220,736,623,928,1077,5,11,3,192,454,23,27,0,0
221,754,702,938,1077,5,11,3,184,375,24,27,0,0
222,770,774,947,1077,5,11,3,177,303,25,27,0,0
223,818,876,954,1075,5,11,3,136,199,26,27,0,0
224,855,927,962,1080,5,11,3,107,153,27,27,1,0
280,331,134,366,226,8,11,3,35,92,0,64,0,0
283,334,140,369,231,8,11,3,35,91,0,64,0,0
284,335,141,370,233,8,11,3,35,92,1,64,0,0
292,366,145,401,238,8,11,3,35,93,0,64,0,1
293,371,147,407,241,8,11,3,36,94,1,64,0,0
294,376,145,414,244,8,11,3,38,99,2,64,0,0
295,380,145,419,246,8,11,3,39,101,3,64,0,0
296,383,145,422,248,8,11,3,39,103,4,64,0,0
297,388,145,426,245,8,11,3,38,100,5,64,0,0
298,392,146,430,244,8,11,3,38,98,6,64,0,0
299,396,148,435,247,8,11,3,39,99,7,64,0,0
300,401,150,441,250,8,11,3,40,100,8,64,0,0
301,405,151,445,251,8,11,3,40,100,9,64,0,0
302,407,151,449,253,8,11,3,42,102,10,64,0,0
303,409,150,451,254,8,11,3,42,104,11,64,0,0
304,412,152,454,255,8,11,3,42,103,12,64,0,0
305,415,152,458,257,8,11,3,43,105,13,64,0,0
306,417,152,462,259,8,11,3,45,107,14,64,0,0
307,419,153,463,259,8,11,3,44,106,15,64,0,0
308,420,152,465,261,8,11,3,45,109,16,64,0,0
309,420,152,466,264,8,11,3,46,112,17,64,0,0
310,421,152,467,266,8,11,3,46,114,18,64,0,0
311,423,154,469,268,8,11,3,46,114,19,64,0,0
312,423,154,471,269,8,11,3,48,115,20,64,0,0
313,423,154,472,273,8,11,3,49,119,21,64,0,0
314,421,156,470,275,8,11,3,49,119,22,64,0,0
315,420,156,470,278,8,11,3,50,122,23,64,0,0
316,421,157,472,282,8,11,3,51,125,24,64,0,0
317,422,156,475,284,8,11,3,53,128,25,64,0,0
318,422,157,475,287,8,11,3,53,130,26,64,0,0
319,421,161,475,292,8,11,3,54,131,27,64,0,0
320,417,162,471,295,8,11,3,54,133,28,64,0,0
321,415,165,469,298,8,11,3,54,133,29,64,0,0
322,413,167,469,304,8,11,3,56,137,30,64,0,0
323,415,169,470,304,8,11,3,55,135,31,64,0,0
324,414,169,471,307,8,11,3,57,138,32,64,0,0
325,412,171,468,310,8,11,3,56,139,33,64,0,0
326,408,170,466,313,8,11,3,58,143,34,64,0,0
327,405,170,466,319,8,11,3,61,149,35,64,0,0
328,404,171,466,324,8,11,3,62,153,36,64,0,0
329,403,170,466,325,8,11,3,63,155,37,64,0,0
330,400,172,465,331,8,11,3,65,159,38,64,0,0
331,397,174,462,334,8,11,3,65,160,39,64,0,0
332,395,175,460,336,8,11,3,65,161,40,64,0,0
333,393,176,461,345,8,11,3,68,169,41,64,0,0
334,392,175,462,353,8,11,3,70,178,42,64,0,0
335,390,174,461,357,8,11,3,71,183,43,64,0,0
336,388,182,459,364,8,11,3,71,182,44,64,0,0
337,384,183,457,368,8,11,3,73,185,45,64,0,0
338,384,186,456,369,8,11,3,72,183,46,64,0,0
339,381,191,456,381,8,11,3,75,190,47,64,0,0
340,381,192,457,382,8,11,3,76,190,48,64,0,0
341,378,192,455,386,8,11,3,77,194,49,64,0,0
342,371,197,449,395,8,11,3,78,198,50,64,0,0
343,365,198,443,399,8,11,3,78,201,51,64,0,0
344,359,198,438,406,8,11,3,79,208,52,64,0,0
345,356,202,435,410,8,11,3,79,208,53,64,0,0
346,351,202,432,417,8,11,3,81,215,54,64,0,0
347,345,202,426,418,8,11,3,81,216,55,64,0,0
348,331,206,414,426,8,11,3,83,220,56,64,0,0
349,321,208,404,431,8,11,3,83,223,57,64,0,0
350,303,208,385,433,8,11,3,82,225,58,64,0,0
351,289,212,369,435,8,11,3,80,223,59,64,0,0
352,275,215,355,443,8,11,3,80,228,60,64,0,0
353,261,221,339,446,8,11,3,78,225,61,64,0,0
354,242,220,321,451,8,11,3,79,231,62,64,0,0
355,234,232,308,449,8,11,3,74,217,63,64,0,0
356,225,234,299,453,8,11,3,74,219,64,64,1,0
368,232,216,304,435,8,11,3,72,219,0,64,0,0
369,238,215,310,434,8,11,3,72,219,1,64,0,0
370,250,211,323,429,8,11,3,73,218,2,64,0,0
371,260,209,333,426,8,11,3,73,217,3,64,0,0
372,269,210,340,422,8,11,3,71,212,4,64,0,0
373,275,205,347,415,8,11,3,72,210,5,64,0,0
374,281,201,353,409,8,11,3,72,208,6,64,0,0
375,288,202,359,406,8,11,3,71,204,7,64,0,0
376,293,202,365,407,8,11,3,72,205,8,64,0,0
377,294,195,369,407,8,11,3,75,212,9,64,0,0
378,293,198,366,411,8,11,3,73,213,10,64,0,0
379,284,200,357,418,8,11,3,73,218,11,64,0,0
380,273,206,343,418,8,11,3,70,212,12,64,0,0
381,256,213,326,420,8,11,3,70,207,13,64,0,0
382,241,212,313,425,8,11,3,72,213,14,64,0,0
383,238,212,310,426,8,11,3,72,214,15,64,0,0
404,232,240,291,433,8,11,3,59,193,0,64,0,1
405,233,221,299,439,8,11,3,66,218,1,64,0,0
406,239,213,305,435,8,11,3,66,222,2,64,0,0
407,245,210,312,427,8,11,3,67,217,3,64,0,0
408,259,208,324,413,8,11,3,65,205,4,64,0,0
409,269,206,336,407,8,11,3,67,201,5,64,0,0
410,280,203,349,407,8,11,3,69,204,6,64,0,0
411,289,200,358,402,8,11,3,69,202,7,64,0,0
412,295,199,365,401,8,11,3,70,202,8,64,0,0
413,298,196,368,394,8,11,3,70,198,9,64,0,0
414,302,192,370,380,8,11,3,68,188,10,64,0,0
415,302,189,372,380,8,11,3,70,191,11,64,0,0
416,304,189,373,371,8,11,3,69,182,12,64,0,0
417,304,185,372,363,8,11,3,68,178,13,64,0,0
418,309,185,375,359,8,11,3,66,174,14,64,0,0
419,311,184,374,352,8,11,3,63,168,15,64,0,0
420,312,183,374,346,8,11,3,62,163,16,64,0,0
421,314,183,375,340,8,11,3,61,157,17,64,0,0
422,318,179,378,333,8,11,3,60,154,18,64,0,0
423,320,178,380,332,8,11,3,60,154,19,64,0,0
424,319,177,377,327,8,11,3,58,150,20,64,0,0
425,319,173,376,320,8,11,3,57,147,21,64,0,0
426,320,174,376,316,8,11,3,56,142,22,64,0,0
427,321,170,376,312,8,11,3,55,142,23,64,0,0
428,322,169,375,307,8,11,3,53,138,24,64,0,0
429,319,171,373,310,8,11,3,54,139,25,64,0,0
430,317,167,372,308,8,11,3,55,141,26,64,0,0
431,319,168,371,302,8,11,3,52,134,27,64,0,0
432,320,166,372,301,8,11,3,52,135,28,64,0,0
433,320,163,371,295,8,11,3,51,132,29,64,0,0
434,317,163,366,291,8,11,3,49,128,30,64,0,0
435,310,162,358,286,8,11,3,48,124,31,64,0,0
436,301,159,350,285,8,11,3,49,126,32,64,0,0
437,294,157,343,285,8,11,3,49,128,33,64,0,0
438,289,158,336,282,8,11,3,47,124,34,64,0,0
439,284,159,328,275,8,11,3,44,116,35,64,0,0
440,281,158,324,271,8,11,3,43,113,36,64,0,0
539,434,143,482,275,17,11,3,48,132,0,7,0,0
540,418,141,465,271,17,11,3,47,130,1,7,0,0
541,397,144,445,275,17,11,3,48,131,2,7,0,0
542,387,145,435,276,17,11,3,48,131,3,7,0,0
543,350,152,395,275,17,11,3,45,123,4,7,0,0
544,325,145,371,273,17,11,3,46,128,5,7,0,0
545,300,138,348,274,17,11,3,48,136,6,7,0,0
546,280,137,328,274,17,11,3,48,137,7,7,0,0
731,314,138,349,241,20,11,3,35,103,0,3,0,0
735,302,149,337,252,20,11,3,35,103,0,3,0,0
736,296,149,332,258,20,11,3,36,109,1,3,0,0
737,291,150,326,257,20,11,3,35,107,2,3,0,0
738,288,152,324,259,20,11,3,36,107,3,3,0,0
743,924,836,1100,1073,23,11,3,176,237,0,37,0,1
744,843,776,1061,1066,23,11,3,218,290,1,37,0,0
745,764,720,1026,1067,23,11,3,262,347,2,37,0,0
746,688,653,1001,1068,23,11,3,313,415,3,37,0,0
747,622,595,977,1070,23,11,3,355,475,4,37,0,0
748,549,557,929,1072,23,11,3,380,515,5,37,0,0
749,473,512,878,1070,23,11,3,405,558,6,37,0,0
750,427,477,848,1072,23,11,3,421,595,7,37,0,0
751,405,453,830,1070,23,11,3,425,617,8,37,0,0
752,392,424,819,1071,23,11,3,427,647,9,37,0,0
753,388,400,803,1054,23,11,3,415,654,10,37,0,0
754,380,386,775,1032,23,11,3,395,646,11,37,0,0
755,377,362,739,978,23,11,3,362,616,12,37,0,0
756,377,343,717,941,23,11,3,340,598,13,37,0,0
757,386,327,707,911,23,11,3,321,584,14,37,0,0
758,408,307,694,846,23,11,3,286,539,15,37,0,0
759,417,298,684,820,23,11,3,267,522,16,37,0,0
760,415,292,665,799,23,11,3,250,507,17,37,0,0
761,413,278,642,755,23,11,3,229,477,18,37,0,0
762,409,272,626,737,23,11,3,217,465,19,37,0,0
763,410,268,618,724,23,11,3,208,456,20,37,0,0
764,414,262,601,685,23,11,3,187,423,21,37,0,0
765,406,255,583,668,23,11,3,177,413,22,37,0,0
766,393,255,560,653,23,11,3,167,398,23,37,0,0
767,380,248,534,627,23,11,3,154,379,24,37,0,0
768,369,246,514,617,23,11,3,145,371,25,37,0,0
769,363,245,498,603,23,11,3,135,358,26,37,0,0
770,354,242,484,594,23,11,3,130,352,27,37,0,0
771,343,238,470,587,23,11,3,127,349,28,37,0,0
772,330,244,452,581,23,11,3,122,337,29,37,0,0
773,312,247,428,566,23,11,3,116,319,30,37,0,0
774,291,245,406,561,23,11,3,115,316,31,37,0,0
775,277,243,390,559,23,11,3,113,316,32,37,0,0
776,263,239,369,539,23,11,3,106,300,33,37,0,0
777,250,233,353,530,23,11,3,103,297,34,37,0,0
778,238,236,340,529,23,11,3,102,293,35,37,0,0
779,232,253,328,528,23,11,3,96,275,36,37,0,0
780,219,252,311,518,23,11,3,92,266,37,37,1,0
1229,777,472,976,1021,27,11,3,199,549,0,47,0,1
1230,756,432,940,941,27,11,3,184,509,1,47,0,0
1231,743,419,924,918,27,11,3,181,499,2,47,0,0
1232,719,394,890,863,27,11,3,171,469,3,47,0,0
1233,687,366,848,806,27,11,3,161,440,4,47,0,0
1234,667,354,822,778,27,11,3,155,424,5,47,0,0
1235,653,336,795,722,27,11,3,142,386,6,47,0,0
1236,647,327,785,701,27,11,3,138,374,7,47,0,0
1237,633,315,763,668,27,11,3,130,353,8,47,0,0
1238,620,300,745,637,27,11,3,125,337,9,47,0,0
1239,606,298,725,620,27,11,3,119,322,10,47,0,0
1240,594,281,707,587,27,11,3,113,306,11,47,0,0
1241,587,272,698,572,27,11,3,111,300,12,47,0,0
1242,579,265,688,561,27,11,3,109,296,13,47,0,0
1243,563,251,668,536,27,11,3,105,285,14,47,0,0
1244,551,248,653,526,27,11,3,102,278,15,47,0,0
1245,541,239,637,501,27,11,3,96,262,16,47,0,0
1246,536,233,630,491,27,11,3,94,258,17,47,0,0
1247,531,230,622,477,27,11,3,91,247,18,47,0,0
1248,518,221,605,460,27,11,3,87,239,19,47,0,0
1249,507,218,593,451,27,11,3,86,233,20,47,0,0
1250,500,212,582,437,27,11,3,82,225,21,47,0,0
1251,497,211,578,430,27,11,3,81,219,22,47,0,0
1252,496,208,574,423,27,11,3,78,215,23,47,0,0
1253,490,202,566,408,27,11,3,76,206,24,47,0,0
1254,482,201,556,400,27,11,3,74,199,25,47,0,0
1255,477,198,549,391,27,11,3,72,193,26,47,0,0
1256,475,194,546,384,27,11,3,71,190,27,47,0,0
1257,474,196,544,385,27,11,3,70,189,28,47,0,0
1258,475,190,543,374,27,11,3,68,184,29,47,0,0
1259,475,190,542,368,27,11,3,67,178,30,47,0,0
1260,475,189,542,362,27,11,3,67,173,31,47,0,0
1261,479,181,548,354,27,11,3,69,173,32,47,0,0
1262,479,178,548,352,27,11,3,69,174,33,47,0,0
1263,482,178,551,348,27,11,3,69,170,34,47,0,0
1264,479,178,547,342,27,11,3,68,164,35,47,0,0
1265,477,178,546,340,27,11,3,69,162,36,47,0,0
1266,466,178,535,341,27,11,3,69,163,37,47,0,0
1267,459,178,526,338,27,11,3,67,160,38,47,0,0
1268,455,178,520,337,27,11,3,65,159,39,47,0,0
1269,453,179,515,337,27,11,3,62,158,40,47,0,0
1270,452,182,513,337,27,11,3,61,155,41,47,0,0
1271,455,183,516,338,27,11,3,61,155,42,47,0,0
1272,461,182,523,339,27,11,3,62,157,43,47,0,0
1273,477,179,536,332,27,11,3,59,153,44,47,0,0
1274,488,178,548,330,27,11,3,60,152,45,47,0,0
1275,495,186,553,331,27,11,3,58,145,46,47,0,0
1276,498,186,555,328,27,11,3,57,142,47,47,1,0
1734,459,135,502,263,28,11,3,43,128,0,20,0,1
1735,447,136,487,256,28,11,3,40,120,1,20,0,0
1736,434,139,476,262,28,11,3,42,123,2,20,0,0
1737,424,140,464,258,28,11,3,40,118,3,20,0,0
1738,410,147,449,261,28,11,3,39,114,4,20,0,0
1739,395,138,437,261,28,11,3,42,123,5,20,0,0
1740,383,133,425,252,28,11,3,42,119,6,20,0,0
1741,375,133,418,256,28,11,3,43,123,7,20,0,0
1742,368,131,411,255,28,11,3,43,124,8,20,0,0
1743,361,133,401,252,28,11,3,40,119,9,20,0,0
1744,355,135,395,251,28,11,3,40,116,10,20,0,0
1745,350,132,390,250,28,11,3,40,118,11,20,0,0
1746,346,131,386,247,28,11,3,40,116,12,20,0,0
1747,344,131,383,246,28,11,3,39,115,13,20,0,0
1748,342,131,380,240,28,11,3,38,109,14,20,0,0
1749,339,131,376,240,28,11,3,37,109,15,20,0,0
1750,335,129,373,238,28,11,3,38,109,16,20,0,0
1751,334,129,370,235,28,11,3,36,106,17,20,0,0
1752,334,129,369,233,28,11,3,35,104,18,20,0,0
1753,333,128,368,231,28,11,3,35,103,19,20,0,0
1754,332,128,367,232,28,11,3,35,104,20,20,1,0
2007,557,175,608,363,31,11,3,51,188,0,24,0,1
2008,549,181,598,362,31,11,3,49,181,1,24,0,0
2009,529,175,578,354,31,11,3,49,179,2,24,0,0
2010,497,174,549,359,31,11,3,52,185,3,24,0,0
2011,476,176,528,356,31,11,3,52,180,4,24,0,0
2012,457,174,509,354,31,11,3,52,180,5,24,0,0
2013,433,173,489,355,31,11,3,56,182,6,24,0,0
2014,416,173,470,350,31,11,3,54,177,7,24,0,0
2015,407,170,461,341,31,11,3,54,171,8,24,0,0
2016,399,171,452,338,31,11,3,53,167,9,24,0,0
2017,392,169,444,331,31,11,3,52,162,10,24,0,0
2018,383,165,436,328,31,11,3,53,163,11,24,0,0
2019,378,168,431,325,31,11,3,53,157,12,24,0,0
2020,375,165,426,319,31,11,3,51,154,13,24,0,0
2021,369,165,417,311,31,11,3,48,146,14,24,0,0
2022,363,165,411,311,31,11,3,48,146,15,24,0,0
2023,356,164,404,311,31,11,3,48,147,16,24,0,0
2024,346,165,395,310,31,11,3,49,145,17,24,0,0
2025,341,162,388,302,31,11,3,47,140,18,24,0,0
2026,337,157,383,296,31,11,3,46,139,19,24,0,0
2027,331,160,375,293,31,11,3,44,133,20,24,0,0
2028,320,157,366,296,31,11,3,46,139,21,24,0,0
2029,310,152,356,296,31,11,3,46,144,22,24,0,0
2030,302,157,347,292,31,11,3,45,135,23,24,0,0
2031,289,155,331,286,31,11,3,42,131,24,24,1,0
2012,550,181,608,363,32,11,3,58,182,0,24,0,1
2013,534,181,590,357,32,11,3,56,176,1,24,0,0
2014,505,178,564,361,32,11,3,59,183,2,24,0,0
2015,492,178,550,356,32,11,3,58,178,3,24,0,0
2016,472,178,530,354,32,11,3,58,176,4,24,0,0
2017,457,179,514,352,32,11,3,57,173,5,24,0,0
2018,444,178,501,352,32,11,3,57,174,6,24,0,0
2019,432,175,487,343,32,11,3,55,168,7,24,0,0
2020,420,175,474,338,32,11,3,54,163,8,24,0,0
2021,409,174,462,333,32,11,3,53,159,9,24,0,0
2022,402,171,454,328,32,11,3,52,157,10,24,0,0
2023,396,172,447,324,32,11,3,51,152,11,24,0,0
2024,390,169,440,318,32,11,3,50,149,12,24,0,0
2025,383,166,433,313,32,11,3,50,147,13,24,0,0
2026,379,170,427,310,32,11,3,48,140,14,24,0,0
2027,369,165,418,305,32,11,3,49,140,15,24,0,0
2028,361,163,410,305,32,11,3,49,142,16,24,0,0
2029,355,162,404,304,32,11,3,49,142,17,24,0,0
2030,347,157,395,299,32,11,3,48,142,18,24,0,0
2031,338,158,385,297,32,11,3,47,139,19,24,0,0
2032,327,160,374,298,32,11,3,47,138,20,24,0,0
2033,312,157,358,293,32,11,3,46,136,21,24,0,0
2034,299,158,344,292,32,11,3,45,134,22,24,0,0
2035,285,156,328,287,32,11,3,43,131,23,24,0,0
2036,274,155,317,284,32,11,3,43,129,24,24,1,0
3234,467,147,503,263,37,11,3,36,116,0,1,0,0
3235,460,151,496,267,37,11,3,36,116,1,1,0,0
3235,436,151,474,265,38,11,3,38,114,0,19,0,1
3236,443,150,480,262,38,11,3,37,112,1,19,0,0
3237,435,150,473,262,38,11,3,38,112,2,19,0,0
3238,421,153,461,268,38,11,3,40,115,3,19,0,0
3239,410,152,447,259,38,11,3,37,107,4,19,0,0
3240,395,149,434,260,38,11,3,39,111,5,19,0,0
3241,384,149,424,261,38,11,3,40,112,6,19,0,0
3242,375,150,414,259,38,11,3,39,109,7,19,0,0
3243,367,148,407,259,38,11,3,40,111,8,19,0,0
3244,360,148,400,257,38,11,3,40,109,9,19,0,0
3245,354,147,393,256,38,11,3,39,109,10,19,0,0
3246,349,147,387,251,38,11,3,38,104,11,19,0,0
3247,346,147,385,254,38,11,3,39,107,12,19,0,0
3248,346,146,382,244,38,11,3,36,98,13,19,0,0
3249,344,145,381,245,38,11,3,37,100,14,19,0,0
3250,341,144,379,248,38,11,3,38,104,15,19,0,0
3251,338,143,376,247,38,11,3,38,104,16,19,0,0
3252,335,140,374,248,38,11,3,39,108,17,19,0,0
3253,335,140,372,246,38,11,3,37,106,18,19,0,0
3254,336,141,372,241,38,11,3,36,100,19,19,0,0
4917,237,218,292,473,41,11,3,55,255,0,27,0,1
4918,240,211,299,486,41,11,3,59,275,1,27,0,0
4919,251,214,313,493,41,11,3,62,279,2,27,0,0
4920,257,221,323,516,41,11,3,66,295,3,27,0,0
4921,267,218,335,522,41,11,3,68,304,4,27,0,0
4922,279,228,352,544,41,11,3,73,316,5,27,0,0
4923,291,235,366,558,41,11,3,75,323,6,27,0,0
4924,297,237,378,573,41,11,3,81,336,7,27,0,0
4925,303,248,391,598,41,11,3,88,350,8,27,0,0
4926,309,253,401,611,41,11,3,92,358,9,27,0,0
4927,316,262,414,638,41,11,3,98,376,10,27,0,0
4928,325,271,430,669,41,11,3,105,398,11,27,0,0
4929,334,276,446,687,41,11,3,112,411,12,27,0,0
4930,335,289,460,731,41,11,3,125,442,13,27,0,0
4931,346,298,479,760,41,11,3,133,462,14,27,0,0
4932,362,308,504,797,41,11,3,142,489,15,27,0,0
4933,382,324,531,835,41,11,3,149,511,16,27,0,0
4934,399,331,559,868,41,11,3,160,537,17,27,0,0
4935,408,354,590,952,41,11,3,182,598,18,27,0,0
4936,434,375,625,993,41,11,3,191,618,19,27,0,0
4937,471,397,675,1049,41,11,3,204,652,20,27,0,0
4938,507,429,710,1070,41,11,3,203,641,21,27,0,0
4939,561,448,770,1080,41,11,3,209,632,22,27,0,0
4940,616,501,828,1080,41,11,3,212,579,23,27,0,0
4941,686,557,894,1080,41,11,3,208,523,24,27,0,0
4942,748,617,943,1080,41,11,3,195,463,25,27,0,0
4943,855,705,1030,1080,41,11,3,175,375,26,27,0,0
4944,899,738,1067,1080,41,11,3,168,342,27,27,1,0
229,1752,687,1920,1080,1,11,4,168,393,0,0,0,0
231,1785,660,1920,1080,2,11,4,135,420,0,126,0,1
232,1787,639,1920,1076,2,11,4,133,437,1,126,0,0
233,1793,675,1920,1078,2,11,4,127,403,2,126,0,0
234,1798,676,1920,1069,2,11,4,122,393,3,126,0,0
235,1798,666,1920,1076,2,11,4,122,410,4,126,0,0
236,1797,647,1920,1079,2,11,4,123,432,5,126,0,0
237,1795,624,1920,1079,2,11,4,125,455,6,126,0,0
238,1796,626,1920,1080,2,11,4,124,454,7,126,0,0
239,1797,631,1920,1080,2,11,4,123,449,8,126,0,0
240,1799,652,1920,1080,2,11,4,121,428,9,126,0,0
241,1800,651,1920,1080,2,11,4,120,429,10,126,0,0
242,1802,660,1920,1080,2,11,4,118,420,11,126,0,0
243,1801,657,1920,1076,2,11,4,119,419,12,126,0,0
244,1801,662,1920,1078,2,11,4,119,416,13,126,0,0
245,1801,663,1920,1079,2,11,4,119,416,14,126,0,0
246,1802,674,1920,1079,2,11,4,118,405,15,126,0,0
247,1803,678,1920,1080,2,11,4,117,402,16,126,0,0
248,1803,679,1919,1077,2,11,4,116,398,17,126,0,0
249,1803,679,1919,1076,2,11,4,116,397,18,126,0,0
250,1804,680,1919,1074,2,11,4,115,394,19,126,0,0
251,1802,678,1919,1078,2,11,4,117,400,20,126,0,0
252,1801,675,1919,1079,2,11,4,118,404,21,126,0,0
253,1800,672,1919,1079,2,11,4,119,407,22,126,0,0
254,1800,672,1919,1080,2,11,4,119,408,23,126,0,0
255,1798,667,1919,1080,2,11,4,121,413,24,126,0,0
256,1794,643,1920,1074,2,11,4,126,431,25,126,0,0
257,1778,559,1920,1071,2,11,4,142,512,26,126,0,0
258,1767,525,1920,1075,2,11,4,153,550,27,126,0,0
259,1759,503,1920,1077,2,11,4,161,574,28,126,0,0
260,1744,491,1913,1079,2,11,4,169,588,29,126,0,0
261,1736,485,1909,1079,2,11,4,173,594,30,126,0,0
262,1712,483,1891,1074,2,11,4,179,591,31,126,0,0
263,1686,478,1876,1071,2,11,4,190,593,32,126,0,0
264,1671,474,1868,1068,2,11,4,197,594,33,126,0,0
265,1652,467,1856,1069,2,11,4,204,602,34,126,0,0
266,1639,464,1846,1072,2,11,4,207,608,35,126,0,0
267,1637,460,1849,1073,2,11,4,212,613,36,126,0,0
268,1633,459,1849,1074,2,11,4,216,615,37,126,0,0
269,1631,459,1850,1075,2,11,4,219,616,38,126,0,0
270,1631,457,1852,1074,2,11,4,221,617,39,126,0,0
271,1630,459,1850,1070,2,11,4,220,611,40,126,0,0
272,1634,464,1854,1068,2,11,4,220,604,41,126,0,0
273,1632,465,1856,1070,2,11,4,224,605,42,126,0,0
274,1632,466,1857,1069,2,11,4,225,603,43,126,0,0
275,1631,464,1858,1068,2,11,4,227,604,44,126,0,0
276,1629,463,1857,1068,2,11,4,228,605,45,126,0,0
277,1626,462,1855,1070,2,11,4,229,608,46,126,0,0
278,1623,460,1853,1071,2,11,4,230,611,47,126,0,0
279,1622,463,1852,1069,2,11,4,230,606,48,126,0,0
280,1620,463,1850,1066,2,11,4,230,603,49,126,0,0
281,1619,462,1854,1073,2,11,4,235,611,50,126,0,0
282,1628,464,1865,1074,2,11,4,237,610,51,126,0,0
283,1636,470,1877,1075,2,11,4,241,605,52,126,0,0
284,1642,476,1886,1075,2,11,4,244,599,53,126,0,0
285,1646,486,1891,1074,2,11,4,245,588,54,126,0,0
286,1648,496,1894,1074,2,11,4,246,578,55,126,0,0
287,1649,501,1896,1070,2,11,4,247,569,56,126,0,0
288,1652,503,1900,1067,2,11,4,248,564,57,126,0,0
289,1653,503,1902,1061,2,11,4,249,558,58,126,0,0
290,1646,501,1902,1068,2,11,4,256,567,59,126,0,0
291,1635,500,1896,1069,2,11,4,261,569,60,126,0,0
292,1631,505,1895,1072,2,11,4,264,567,61,126,0,0
293,1622,499,1893,1070,2,11,4,271,571,62,126,0,0
294,1607,497,1884,1069,2,11,4,277,572,63,126,0,0
295,1581,497,1860,1068,2,11,4,279,571,64,126,0,0
296,1581,499,1861,1072,2,11,4,280,573,65,126,0,0
297,1581,507,1859,1073,2,11,4,278,566,66,126,0,0
298,1569,508,1848,1070,2,11,4,279,562,67,126,0,0
299,1560,507,1839,1066,2,11,4,279,559,68,126,0,0
300,1545,507,1820,1062,2,11,4,275,555,69,126,0,0
301,1523,512,1796,1061,2,11,4,273,549,70,126,0,0
302,1501,517,1775,1064,2,11,4,274,547,71,126,0,0
303,1496,516,1773,1064,2,11,4,277,548,72,126,0,0
304,1493,513,1774,1065,2,11,4,281,552,73,126,0,0
305,1487,514,1772,1067,2,11,4,285,553,74,126,0,0
306,1490,515,1775,1066,2,11,4,285,551,75,126,0,0
307,1488,516,1773,1066,2,11,4,285,550,76,126,0,0
308,1489,517,1773,1067,2,11,4,284,550,77,126,0,0
309,1488,518,1770,1067,2,11,4,282,549,78,126,0,0
310,1488,517,1770,1067,2,11,4,282,550,79,126,0,0
311,1493,516,1775,1067,2,11,4,282,551,80,126,0,0
312,1495,517,1779,1069,2,11,4,284,552,81,126,0,0
313,1494,519,1780,1069,2,11,4,286,550,82,126,0,0
314,1491,520,1777,1069,2,11,4,286,549,83,126,0,0
315,1478,517,1767,1068,2,11,4,289,551,84,126,0,0
316,1469,513,1759,1068,2,11,4,290,555,85,126,0,0
317,1456,506,1745,1067,2,11,4,289,561,86,126,0,0
318,1420,501,1709,1070,2,11,4,289,569,87,126,0,0
319,1382,490,1670,1071,2,11,4,288,581,88,126,0,0
320,1347,480,1633,1071,2,11,4,286,591,89,126,0,0
321,1310,487,1587,1074,2,11,4,277,587,90,126,0,0
322,1265,503,1533,1075,2,11,4,268,572,91,126,0,0
323,1193,513,1457,1078,2,11,4,264,565,92,126,0,0
324,1116,509,1375,1072,2,11,4,259,563,93,126,0,0
325,1043,511,1302,1072,2,11,4,259,561,94,126,0,0
326,980,502,1243,1074,2,11,4,263,572,95,126,0,0
327,897,499,1158,1070,2,11,4,261,571,96,126,0,0
328,838,511,1094,1072,2,11,4,256,561,97,126,0,0
329,785,529,1039,1070,2,11,4,254,541,98,126,0,0
330,713,553,958,1070,2,11,4,245,517,99,126,0,0
331,648,565,892,1073,2,11,4,244,508,100,126,0,0
332,592,572,837,1071,2,11,4,245,499,101,126,0,0
333,543,576,791,1066,2,11,4,248,490,102,126,0,0
334,514,577,769,1065,2,11,4,255,488,103,126,0,0
335,507,581,771,1069,2,11,4,264,488,104,126,0,0
336,507,588,777,1069,2,11,4,270,481,105,126,0,0
337,513,590,789,1068,2,11,4,276,478,106,126,0,0
338,524,588,806,1066,2,11,4,282,478,107,126,0,0
339,550,587,837,1072,2,11,4,287,485,108,126,0,0
340,601,587,885,1074,2,11,4,284,487,109,126,0,0
341,647,586,929,1074,2,11,4,282,488,110,126,0,0
342,684,581,962,1064,2,11,4,278,483,111,126,0,0
343,713,584,993,1064,2,11,4,280,480,112,126,0,0
344,747,600,1025,1069,2,11,4,278,469,113,126,0,0
345,797,611,1069,1073,2,11,4,272,462,114,126,0,0
346,875,613,1146,1075,2,11,4,271,462,115,126,0,0
347,964,622,1229,1074,2,11,4,265,452,116,126,0,0
348,1070,616,1337,1072,2,11,4,267,456,117,126,0,0
349,1177,586,1460,1071,2,11,4,283,485,118,126,0,0
350,1279,579,1569,1069,2,11,4,290,490,119,126,0,0
351,1357,589,1642,1067,2,11,4,285,478,120,126,0,0
352,1441,595,1724,1071,2,11,4,283,476,121,126,0,0
353,1523,596,1804,1071,2,11,4,281,475,122,126,0,0
354,1599,594,1880,1072,2,11,4,281,478,123,126,0,0
355,1653,582,1920,1073,2,11,4,267,491,124,126,0,0
356,1702,574,1920,1077,2,11,4,218,503,125,126,0,0
357,1761,572,1920,1078,2,11,4,159,506,126,126,1,0
386,1171,265,1265,394,3,11,4,94,129,0,0,0,0
388,1171,267,1264,394,4,11,4,93,127,0,0,0,0
390,1166,267,1267,396,5,11,4,101,129,0,0,0,0
697,1778,593,1920,1075,6,11,4,142,482,0,45,0,1
698,1722,593,1863,1066,6,11,4,141,473,1,45,0,0
699,1657,611,1799,1070,6,11,4,142,459,2,45,0,0
700,1598,624,1737,1065,6,11,4,139,441,3,45,0,0
701,1490,612,1637,1063,6,11,4,147,451,4,45,0,0
702,1373,617,1522,1064,6,11,4,149,447,5,45,0,0
703,1231,609,1387,1071,6,11,4,156,462,6,45,0,0
704,1097,602,1261,1073,6,11,4,164,471,7,45,0,0
705,968,613,1134,1075,6,11,4,166,462,8,45,0,0
706,842,629,1010,1078,6,11,4,168,449,9,45,0,0
707,703,619,885,1075,6,11,4,182,456,10,45,0,0
708,578,618,776,1077,6,11,4,198,459,11,45,0,0
709,497,618,706,1077,6,11,4,209,459,12,45,0,0
710,446,623,661,1074,6,11,4,215,451,13,45,0,0
711,407,638,622,1066,6,11,4,215,428,14,45,0,0
712,371,659,591,1072,6,11,4,220,413,15,45,0,0
713,357,673,581,1073,6,11,4,224,400,16,45,0,0
714,347,671,583,1074,6,11,4,236,403,17,45,0,0
715,342,666,592,1077,6,11,4,250,411,18,45,0,0
716,346,660,603,1071,6,11,4,257,411,19,45,0,0
717,347,655,615,1073,6,11,4,268,418,20,45,0,0
718,346,652,624,1075,6,11,4,278,423,21,45,0,0
719,362,651,652,1076,6,11,4,290,425,22,45,0,0
720,351,649,647,1076,6,11,4,296,427,23,45,0,0
721,356,649,657,1077,6,11,4,301,428,24,45,0,0
722,355,650,660,1075,6,11,4,305,425,25,45,0,0
723,358,652,667,1076,6,11,4,309,424,26,45,0,0
724,365,639,683,1066,6,11,4,318,427,27,45,0,0
725,378,629,708,1071,6,11,4,330,442,28,45,0,0
726,422,625,754,1071,6,11,4,332,446,29,45,0,0
727,474,622,809,1070,6,11,4,335,448,30,45,0,0
728,524,620,864,1070,6,11,4,340,450,31,45,0,0
729,584,614,925,1073,6,11,4,341,459,32,45,0,0
730,659,604,999,1075,6,11,4,340,471,33,45,0,0
731,755,585,1095,1077,6,11,4,340,492,34,45,0,0
732,860,575,1187,1070,6,11,4,327,495,35,45,0,0
733,965,562,1292,1068,6,11,4,327,506,36,45,0,0
734,1069,571,1383,1067,6,11,4,314,496,37,45,0,0
735,1164,563,1479,1071,6,11,4,315,508,38,45,0,0
736,1262,554,1579,1073,6,11,4,317,519,39,45,0,0
737,1352,554,1661,1069,6,11,4,309,515,40,45,0,0
738,1446,544,1755,1072,6,11,4,309,528,41,45,0,0
739,1531,544,1836,1074,6,11,4,305,530,42,45,0,0
740,1605,556,1900,1069,6,11,4,295,513,43,45,0,0
741,1663,590,1920,1075,6,11,4,257,485,44,45,0,0
742,1726,591,1920,1076,6,11,4,194,485,45,45,1,0
996,1172,266,1264,398,7,11,4,92,132,0,5,0,0
997,1172,266,1264,398,7,11,4,92,132,1,5,0,0
998,1170,266,1263,398,7,11,4,93,132,2,5,0,0
999,1170,266,1263,399,7,11,4,93,133,3,5,0,0
1000,1171,266,1264,398,7,11,4,93,132,4,5,0,0
1001,1171,266,1264,398,7,11,4,93,132,5,5,0,0
1161,1613,162,1649,266,9,11,4,36,104,0,60,0,1
1162,1611,162,1647,268,9,11,4,36,106,1,60,0,0
1163,1611,161,1649,271,9,11,4,38,110,2,60,0,0
1164,1610,163,1648,271,9,11,4,38,108,3,60,0,0
1165,1608,164,1647,274,9,11,4,39,110,4,60,0,0
1166,1605,166,1645,282,9,11,4,40,116,5,60,0,0
1167,1602,171,1642,284,9,11,4,40,113,6,60,0,0
1168,1600,172,1641,287,9,11,4,41,115,7,60,0,0
1169,1598,174,1638,289,9,11,4,40,115,8,60,0,0
1170,1596,175,1637,292,9,11,4,41,117,9,60,0,0
1171,1592,178,1634,297,9,11,4,42,119,10,60,0,0
1172,1590,180,1633,302,9,11,4,43,122,11,60,0,0
1173,1589,182,1633,305,9,11,4,44,123,12,60,0,0
1174,1588,184,1632,310,9,11,4,44,126,13,60,0,0
1175,1587,184,1633,313,9,11,4,46,129,14,60,0,0
1176,1583,184,1631,319,9,11,4,48,135,15,60,0,0
1177,1584,188,1630,322,9,11,4,46,134,16,60,0,0
1178,1582,190,1630,326,9,11,4,48,136,17,60,0,0
1179,1582,190,1631,330,9,11,4,49,140,18,60,0,0
1180,1581,189,1632,335,9,11,4,51,146,19,60,0,0
1181,1578,188,1632,343,9,11,4,54,155,20,60,0,0
1182,1573,190,1629,352,9,11,4,56,162,21,60,0,0
1183,1572,192,1629,356,9,11,4,57,164,22,60,0,0
1184,1570,195,1628,360,9,11,4,58,165,23,60,0,0
1185,1569,198,1626,363,9,11,4,57,165,24,60,0,0
1186,1565,200,1624,371,9,11,4,59,171,25,60,0,0
1187,1561,205,1621,381,9,11,4,60,176,26,60,0,0
1188,1559,208,1620,385,9,11,4,61,177,27,60,0,0
1189,1557,212,1619,392,9,11,4,62,180,28,60,0,0
1190,1555,212,1620,400,9,11,4,65,188,29,60,0,0
1191,1552,214,1617,402,9,11,4,65,188,30,60,0,0
1192,1546,218,1614,417,9,11,4,68,199,31,60,0,0
1193,1543,223,1612,424,9,11,4,69,201,32,60,0,0
1194,1541,227,1615,435,9,11,4,74,208,33,60,0,0
1195,1539,228,1618,449,9,11,4,79,221,34,60,0,0
1196,1534,229,1615,456,9,11,4,81,227,35,60,0,0
1197,1527,238,1610,472,9,11,4,83,234,36,60,0,0
1198,1522,243,1606,481,9,11,4,84,238,37,60,0,0
1199,1521,248,1609,494,9,11,4,88,246,38,60,0,0
1200,1519,256,1612,513,9,11,4,93,257,39,60,0,0
1201,1511,255,1608,520,9,11,4,97,265,40,60,0,0
1202,1505,266,1605,542,9,11,4,100,276,41,60,0,0
1203,1499,273,1603,558,9,11,4,104,285,42,60,0,0
1204,1494,274,1608,580,9,11,4,114,306,43,60,0,0
1205,1494,289,1612,602,9,11,4,118,313,44,60,0,0
1206,1490,294,1610,612,9,11,4,120,318,45,60,0,0
1207,1479,303,1607,642,9,11,4,128,339,46,60,0,0
1208,1468,311,1602,667,9,11,4,134,356,47,60,0,0
1209,1458,313,1606,705,9,11,4,148,392,48,60,0,0
1210,1452,336,1605,738,9,11,4,153,402,49,60,0,0
1211,1441,343,1600,758,9,11,4,159,415,50,60,0,0
1212,1427,360,1594,797,9,11,4,167,437,51,60,0,0
1213,1410,382,1586,841,9,11,4,176,459,52,60,0,0
1214,1401,389,1593,888,9,11,4,192,499,53,60,0,0
1215,1409,419,1614,954,9,11,4,205,535,54,60,0,0
1216,1423,435,1633,982,9,11,4,210,547,55,60,0,0
1217,1430,473,1655,1047,9,11,4,225,574,56,60,0,0
1218,1450,522,1674,1073,9,11,4,224,551,57,60,0,0
1219,1512,552,1736,1080,9,11,4,224,528,58,60,0,0
1220,1593,608,1810,1080,9,11,4,217,472,59,60,0,0
1221,1605,628,1824,1080,9,11,4,219,452,60,60,1,0
1221,1807,732,1917,1078,10,11,4,110,346,0,0,0,0
1581,1171,265,1265,398,11,11,4,94,133,0,5,0,0
1582,1170,265,1264,398,11,11,4,94,133,1,5,0,0
1583,1169,264,1265,399,11,11,4,96,135,2,5,0,0
1584,1170,265,1265,399,11,11,4,95,134,3,5,0,0
1585,1170,265,1265,399,11,11,4,95,134,4,5,0,0
1586,1170,265,1265,399,11,11,4,95,134,5,5,0,0
1663,1160,273,1267,400,12,11,4,107,127,0,0,0,0
1930,1609,145,1654,294,14,11,4,45,149,0,68,0,1
1931,1608,149,1651,291,14,11,4,43,142,1,68,0,0
1932,1608,147,1653,295,14,11,4,45,148,2,68,0,0
1933,1606,148,1651,297,14,11,4,45,149,3,68,0,0
1934,1606,149,1652,298,14,11,4,46,149,4,68,0,0
1935,1605,149,1653,304,14,11,4,48,155,5,68,0,0
1936,1605,149,1654,306,14,11,4,49,157,6,68,0,0
1937,1604,149,1654,309,14,11,4,50,160,7,68,0,0
1938,1599,147,1654,318,14,11,4,55,171,8,68,0,0
1939,1597,149,1652,321,14,11,4,55,172,9,68,0,0
1940,1596,146,1653,324,14,11,4,57,178,10,68,0,0
1941,1594,148,1653,328,14,11,4,59,180,11,68,0,0
1942,1592,155,1648,328,14,11,4,56,173,12,68,0,0
1943,1590,161,1644,329,14,11,4,54,168,13,68,0,0
1944,1590,160,1647,336,14,11,4,57,176,14,68,0,0
1945,1590,158,1649,341,14,11,4,59,183,15,68,0,0
1946,1588,165,1647,346,14,11,4,59,181,16,68,0,0
1947,1586,170,1644,351,14,11,4,58,181,17,68,0,0
1948,1584,170,1643,355,14,11,4,59,185,18,68,0,0
1949,1582,171,1642,361,14,11,4,60,190,19,68,0,0
1950,1580,167,1643,367,14,11,4,63,200,20,68,0,0
1951,1578,168,1642,370,14,11,4,64,202,21,68,0,0
1952,1575,171,1640,378,14,11,4,65,207,22,68,0,0
1953,1573,174,1638,381,14,11,4,65,207,23,68,0,0
1954,1570,173,1638,388,14,11,4,68,215,24,68,0,0
1955,1568,171,1638,395,14,11,4,70,224,25,68,0,0
1956,1565,172,1636,400,14,11,4,71,228,26,68,0,0
1957,1564,176,1635,406,14,11,4,71,230,27,68,0,0
1958,1560,179,1633,417,14,11,4,73,238,28,68,0,0
1959,1559,179,1633,423,14,11,4,74,244,29,68,0,0
1960,1558,182,1634,430,14,11,4,76,248,30,68,0,0
1961,1556,187,1634,439,14,11,4,78,252,31,68,0,0
1962,1557,188,1636,445,14,11,4,79,257,32,68,0,0
1963,1558,189,1640,457,14,11,4,82,268,33,68,0,0
1964,1556,191,1640,465,14,11,4,84,274,34,68,0,0
1965,1553,192,1639,470,14,11,4,86,278,35,68,0,0
1966,1552,195,1641,482,14,11,4,89,287,36,68,0,0
1967,1551,197,1644,491,14,11,4,93,294,37,68,0,0
1968,1547,196,1644,501,14,11,4,97,305,38,68,0,0
1969,1541,203,1641,514,14,11,4,100,311,39,68,0,0
1970,1537,203,1640,524,14,11,4,103,321,40,68,0,0
1971,1531,206,1638,539,14,11,4,107,333,41,68,0,0
1972,1530,216,1642,565,14,11,4,112,349,42,68,0,0
1973,1532,220,1647,572,14,11,4,115,352,43,68,0,0
1974,1530,222,1651,591,14,11,4,121,369,44,68,0,0
1975,1526,226,1652,608,14,11,4,126,382,45,68,0,0
1976,1524,230,1651,614,14,11,4,127,384,46,68,0,0
1977,1518,236,1654,648,14,11,4,136,412,47,68,0,0
1978,1516,246,1657,672,14,11,4,141,426,48,68,0,0
1979,1512,249,1658,683,14,11,4,146,434,49,68,0,0
1980,1505,258,1659,714,14,11,4,154,456,50,68,0,0
1981,1496,268,1657,744,14,11,4,161,476,51,68,0,0
1982,1482,274,1653,775,14,11,4,171,501,52,68,0,0
1983,1471,284,1654,820,14,11,4,183,536,53,68,0,0
1984,1461,296,1649,842,14,11,4,188,546,54,68,0,0
1985,1447,305,1648,883,14,11,4,201,578,55,68,0,0
1986,1429,320,1644,937,14,11,4,215,617,56,68,0,0
1987,1414,329,1634,958,14,11,4,220,629,57,68,0,0
1988,1390,357,1626,1029,14,11,4,236,672,58,68,0,0
1989,1377,379,1621,1069,14,11,4,244,690,59,68,0,0
1990,1357,398,1603,1080,14,11,4,246,682,60,68,0,0
1991,1322,430,1566,1080,14,11,4,244,650,61,68,0,0
1992,1277,459,1519,1080,14,11,4,242,621,62,68,0,0
1993,1223,492,1461,1080,14,11,4,238,588,63,68,0,0
1994,1166,552,1397,1080,14,11,4,231,528,64,68,0,0
1995,1087,600,1314,1080,14,11,4,227,480,65,68,0,0
1996,1006,659,1226,1079,14,11,4,220,420,66,68,0,0
1997,912,752,1100,1074,14,11,4,188,322,67,68,0,0
1998,872,792,1042,1080,14,11,4,170,288,68,68,1,0
2131,1146,268,1267,408,16,11,4,121,140,0,5,0,0
2132,1145,267,1266,407,16,11,4,121,140,1,5,0,0
2133,1139,263,1269,414,16,11,4,130,151,2,5,0,0
2134,1135,262,1269,417,16,11,4,134,155,3,5,0,0
2135,1135,258,1273,419,16,11,4,138,161,4,5,0,0
2136,1133,257,1275,421,16,11,4,142,164,5,5,0,0
2304,1154,262,1272,405,17,11,4,118,143,0,0,0,0
3171,957,542,1482,1069,19,11,4,525,527,0,5,0,0
3172,997,508,1540,1069,19,11,4,543,561,1,5,0,0
3173,1042,462,1593,1052,19,11,4,551,590,2,5,0,0
3174,1080,437,1624,1041,19,11,4,544,604,3,5,0,0
3175,1118,410,1625,996,19,11,4,507,586,4,5,0,0
3176,1144,371,1679,989,19,11,4,535,618,5,5,0,0
3176,1282,412,1468,889,20,11,4,186,477,0,61,0,1
3177,1293,390,1482,876,20,11,4,189,486,1,61,0,0
3178,1328,366,1504,819,20,11,4,176,453,2,61,0,0
3179,1344,348,1518,796,20,11,4,174,448,3,61,0,0
3180,1357,334,1525,766,20,11,4,168,432,4,61,0,0
3181,1367,317,1522,718,20,11,4,155,401,5,61,0,0
3182,1380,312,1527,694,20,11,4,147,382,6,61,0,0
3183,1400,290,1541,657,20,11,4,141,367,7,61,0,0
3184,1416,281,1554,641,20,11,4,138,360,8,61,0,0
3185,1423,275,1559,632,20,11,4,136,357,9,61,0,0
3186,1429,262,1556,598,20,11,4,127,336,10,61,0,0
3187,1436,252,1559,582,20,11,4,123,330,11,61,0,0
3188,1452,246,1568,555,20,11,4,116,309,12,61,0,0
3189,1465,244,1576,543,20,11,4,111,299,13,61,0,0
3190,1470,241,1579,536,20,11,4,109,295,14,61,0,0
3191,1474,235,1577,515,20,11,4,103,280,15,61,0,0
3192,1480,234,1578,499,20,11,4,98,265,16,61,0,0
3193,1494,229,1588,484,20,11,4,94,255,17,61,0,0
3194,1503,224,1595,475,20,11,4,92,251,18,61,0,0
3195,1509,223,1600,469,20,11,4,91,246,19,61,0,0
3196,1513,219,1599,453,20,11,4,86,234,20,61,0,0
3197,1521,221,1604,446,20,11,4,83,225,21,61,0,0
3198,1532,217,1611,433,20,11,4,79,216,22,61,0,0
3199,1538,209,1618,426,20,11,4,80,217,23,61,0,0
3200,1542,208,1621,423,20,11,4,79,215,24,61,0,0
3201,1542,205,1618,413,20,11,4,76,208,25,61,0,0
3202,1546,204,1618,402,20,11,4,72,198,26,61,0,0
3203,1553,204,1622,395,20,11,4,69,191,27,61,0,0
3204,1558,201,1624,384,20,11,4,66,183,28,61,0,0
3205,1560,201,1625,385,20,11,4,65,184,29,61,0,0
3206,1558,198,1622,377,20,11,4,64,179,30,61,0,0
3207,1557,192,1619,371,20,11,4,62,179,31,61,0,0
3208,1559,191,1619,364,20,11,4,60,173,32,61,0,0
3209,1563,191,1621,356,20,11,4,58,165,33,61,0,0
3210,1564,190,1621,352,20,11,4,57,162,34,61,0,0
3211,1562,188,1618,346,20,11,4,56,158,35,61,0,0
3212,1561,186,1615,339,20,11,4,54,153,36,61,0,0
3213,1562,186,1615,335,20,11,4,53,149,37,61,0,0
3214,1565,185,1617,329,20,11,4,52,144,38,61,0,0
3215,1567,185,1618,328,20,11,4,51,143,39,61,0,0
3216,1567,181,1617,323,20,11,4,50,142,40,61,0,0
3217,1566,178,1616,319,20,11,4,50,141,41,61,0,0
3218,1566,177,1617,318,20,11,4,51,141,42,61,0,0
3219,1570,175,1619,311,20,11,4,49,136,43,61,0,0
3220,1571,176,1619,309,20,11,4,48,133,44,61,0,0
3221,1570,174,1617,303,20,11,4,47,129,45,61,0,0
3222,1570,174,1616,300,20,11,4,46,126,46,61,0,0
3223,1570,171,1616,297,20,11,4,46,126,47,61,0,0
3224,1572,172,1617,295,20,11,4,45,123,48,61,0,0
3225,1573,173,1618,293,20,11,4,45,120,49,61,0,0
3226,1573,170,1618,291,20,11,4,45,121,50,61,0,0
3227,1575,173,1617,287,20,11,4,42,114,51,61,0,0
3228,1574,173,1616,286,20,11,4,42,113,52,61,0,0
3229,1575,171,1616,284,20,11,4,41,113,53,61,0,0
3230,1577,172,1617,280,20,11,4,40,108,54,61,0,0
3231,1580,171,1618,273,20,11,4,38,102,55,61,0,0
3232,1580,169,1619,272,20,11,4,39,103,56,61,0,0
3233,1580,166,1618,270,20,11,4,38,104,57,61,0,0
3234,1579,156,1620,269,20,11,4,41,113,58,61,0,0
3235,1582,158,1622,266,20,11,4,40,108,59,61,0,0
3236,1584,160,1622,264,20,11,4,38,104,60,61,0,0
3237,1586,163,1621,260,20,11,4,35,97,61,61,1,0
3241,1589,157,1624,254,20,11,4,35,97,0,61,0,0
3243,1588,153,1623,251,20,11,4,35,98,0,61,0,0
3471,1395,871,1566,1075,25,11,4,171,204,0,8,0,0
3472,1362,784,1604,1071,25,11,4,242,287,1,8,0,0
3473,1335,695,1647,1065,25,11,4,312,370,2,8,0,0
3474,1323,623,1693,1064,25,11,4,370,441,3,8,0,0
3475,1309,537,1741,1062,25,11,4,432,525,4,8,0,0
3476,1286,449,1779,1064,25,11,4,493,615,5,8,0,0
3477,1276,415,1783,1064,25,11,4,507,649,6,8,0,0
3478,1282,397,1782,1060,25,11,4,500,663,7,8,0,0
3479,1269,344,1808,1058,25,11,4,539,714,8,8,0,0
3477,944,507,1498,1064,26,11,4,554,557,0,4,0,0
3478,988,470,1525,1030,26,11,4,537,560,1,4,0,0
3479,1017,442,1548,1020,26,11,4,531,578,2,4,0,0
3480,1052,420,1540,973,26,11,4,488,553,3,4,0,0
3481,1083,383,1594,964,26,11,4,511,581,4,4,0,0
3479,1447,399,1633,986,27,11,4,186,587,0,60,0,1
3480,1444,397,1632,989,27,11,4,188,592,1,60,0,0
3481,1460,368,1628,899,27,11,4,168,531,2,60,0,0
3482,1466,351,1628,859,27,11,4,162,508,3,60,0,0
3483,1466,335,1629,845,27,11,4,163,510,4,60,0,0
3484,1480,323,1626,779,27,11,4,146,456,5,60,0,0
3485,1489,310,1629,747,27,11,4,140,437,6,60,0,0
3486,1498,299,1634,723,27,11,4,136,424,7,60,0,0
3487,1514,284,1643,681,27,11,4,129,397,8,60,0,0
3488,1517,278,1645,670,27,11,4,128,392,9,60,0,0
3489,1521,273,1645,655,27,11,4,124,382,10,60,0,0
3490,1532,260,1649,617,27,11,4,117,357,11,60,0,0
3491,1539,258,1650,601,27,11,4,111,343,12,60,0,0
3492,1546,250,1653,579,27,11,4,107,329,13,60,0,0
3493,1550,242,1653,559,27,11,4,103,317,14,60,0,0
3494,1555,242,1657,556,27,11,4,102,314,15,60,0,0
3495,1558,236,1653,527,27,11,4,95,291,16,60,0,0
3496,1561,232,1653,514,27,11,4,92,282,17,60,0,0
3497,1563,230,1654,508,27,11,4,91,278,18,60,0,0
3498,1569,223,1655,490,27,11,4,86,267,19,60,0,0
3499,1571,221,1656,483,27,11,4,85,262,20,60,0,0
3500,1571,221,1653,472,27,11,4,82,251,21,60,0,0
3501,1571,214,1651,460,27,11,4,80,246,22,60,0,0
3502,1572,211,1651,454,27,11,4,79,243,23,60,0,0
3503,1576,208,1654,446,27,11,4,78,238,24,60,0,0
3504,1583,203,1658,435,27,11,4,75,232,25,60,0,0
3505,1587,203,1660,431,27,11,4,73,228,26,60,0,0
3506,1591,198,1662,419,27,11,4,71,221,27,60,0,0
3507,1594,195,1663,411,27,11,4,69,216,28,60,0,0
3508,1595,195,1662,409,27,11,4,67,214,29,60,0,0
3509,1600,192,1665,397,27,11,4,65,205,30,60,0,0
3510,1605,192,1667,389,27,11,4,62,197,31,60,0,0
3511,1609,192,1671,389,27,11,4,62,197,32,60,0,0
3512,1609,187,1670,382,27,11,4,61,195,33,60,0,0
3513,1609,185,1669,375,27,11,4,60,190,34,60,0,0
3514,1611,184,1668,367,27,11,4,57,183,35,60,0,0
3515,1611,182,1666,361,27,11,4,55,179,36,60,0,0
3516,1613,181,1667,358,27,11,4,54,177,37,60,0,0
3517,1612,179,1664,349,27,11,4,52,170,38,60,0,0
3518,1613,177,1664,345,27,11,4,51,168,39,60,0,0
3519,1613,177,1664,343,27,11,4,51,166,40,60,0,0
3520,1613,174,1664,338,27,11,4,51,164,41,60,0,0
3521,1614,172,1664,334,27,11,4,50,162,42,60,0,0
3522,1614,172,1663,332,27,11,4,49,160,43,60,0,0
3523,1612,170,1661,326,27,11,4,49,156,44,60,0,0
3524,1611,169,1658,320,27,11,4,47,151,45,60,0,0
3525,1612,169,1658,315,27,11,4,46,146,46,60,0,0
3526,1611,167,1657,312,27,11,4,46,145,47,60,0,0
3527,1611,165,1656,308,27,11,4,45,143,48,60,0,0
3528,1611,166,1655,307,27,11,4,44,141,49,60,0,0
3529,1609,161,1654,303,27,11,4,45,142,50,60,0,0
3530,1610,160,1654,301,27,11,4,44,141,51,60,0,0
3531,1610,159,1654,299,27,11,4,44,140,52,60,0,0
3532,1610,159,1652,295,27,11,4,42,136,53,60,0,0
3533,1610,160,1651,291,27,11,4,41,131,54,60,0,0
3534,1609,156,1649,285,27,11,4,40,129,55,60,0,0
3535,1610,155,1649,281,27,11,4,39,126,56,60,0,0
3536,1612,156,1651,281,27,11,4,39,125,57,60,0,0
3537,1616,155,1654,280,27,11,4,38,125,58,60,0,0
3538,1620,154,1656,277,27,11,4,36,123,59,60,0,0
3539,1622,156,1658,276,27,11,4,36,120,60,60,1,0
3481,1218,412,1403,869,28,11,4,185,457,0,58,0,1
3482,1235,402,1421,862,28,11,4,186,460,1,58,0,0
3483,1265,378,1439,808,28,11,4,174,430,2,58,0,0
3484,1279,354,1454,785,28,11,4,175,431,3,58,0,0
3485,1295,344,1467,766,28,11,4,172,422,4,58,0,0
3486,1315,325,1475,720,28,11,4,160,395,5,58,0,0
3487,1335,312,1490,698,28,11,4,155,386,6,58,0,0
3488,1357,302,1504,670,28,11,4,147,368,7,58,0,0
3489,1370,290,1511,644,28,11,4,141,354,8,58,0,0
3490,1382,284,1521,635,28,11,4,139,351,9,58,0,0
3491,1396,277,1524,602,28,11,4,128,325,10,58,0,0
3492,1410,265,1536,584,28,11,4,126,319,11,58,0,0
3493,1425,260,1546,568,28,11,4,121,308,12,58,0,0
3494,1437,253,1551,547,28,11,4,114,294,13,58,0,0
3495,1443,248,1555,535,28,11,4,112,287,14,58,0,0
3496,1454,244,1562,522,28,11,4,108,278,15,58,0,0
3497,1465,235,1569,505,28,11,4,104,270,16,58,0,0
3498,1470,231,1572,499,28,11,4,102,268,17,58,0,0
3499,1481,228,1578,483,28,11,4,97,255,18,58,0,0
3500,1488,224,1581,471,28,11,4,93,247,19,58,0,0
3501,1491,219,1583,468,28,11,4,92,249,20,58,0,0
3502,1498,219,1584,452,28,11,4,86,233,21,58,0,0
3503,1504,218,1587,446,28,11,4,83,228,22,58,0,0
3504,1512,222,1591,439,28,11,4,79,217,23,58,0,0
3505,1520,213,1596,425,28,11,4,76,212,24,58,0,0
3506,1523,210,1598,419,28,11,4,75,209,25,58,0,0
3507,1525,208,1597,408,28,11,4,72,200,26,58,0,0
3508,1529,206,1598,400,28,11,4,69,194,27,58,0,0
3509,1532,208,1599,396,28,11,4,67,188,28,58,0,0
3510,1536,205,1601,388,28,11,4,65,183,29,58,0,0
3511,1537,201,1602,382,28,11,4,65,181,30,58,0,0
3512,1538,200,1602,379,28,11,4,64,179,31,58,0,0
3513,1542,198,1603,368,28,11,4,61,170,32,58,0,0
3514,1547,199,1606,362,28,11,4,59,163,33,58,0,0
3515,1553,199,1609,358,28,11,4,56,159,34,58,0,0
3516,1555,186,1614,353,28,11,4,59,167,35,58,0,0
3517,1556,183,1615,351,28,11,4,59,168,36,58,0,0
3518,1557,183,1613,341,28,11,4,56,158,37,58,0,0
3519,1558,182,1612,338,28,11,4,54,156,38,58,0,0
3520,1559,182,1612,336,28,11,4,53,154,39,58,0,0
3521,1562,182,1613,329,28,11,4,51,147,40,58,0,0
3522,1563,182,1612,323,28,11,4,49,141,41,58,0,0
3523,1562,183,1610,319,28,11,4,48,136,42,58,0,0
3524,1562,181,1609,315,28,11,4,47,134,43,58,0,0
3525,1564,181,1610,311,28,11,4,46,130,44,58,0,0
3526,1566,180,1611,308,28,11,4,45,128,45,58,0,0
3527,1567,177,1612,305,28,11,4,45,128,46,58,0,0
3528,1568,176,1612,303,28,11,4,44,127,47,58,0,0
3529,1568,170,1613,298,28,11,4,45,128,48,58,0,0
3530,1571,171,1615,297,28,11,4,44,126,49,58,0,0
3531,1574,172,1617,295,28,11,4,43,123,50,58,0,0
3532,1576,170,1617,290,28,11,4,41,120,51,58,0,0
3533,1579,170,1618,286,28,11,4,39,116,52,58,0,0
3534,1582,169,1620,282,28,11,4,38,113,53,58,0,0
3535,1583,167,1621,280,28,11,4,38,113,54,58,0,0
3536,1585,167,1622,281,28,11,4,37,114,55,58,0,0
3537,1587,165,1624,279,28,11,4,37,114,56,58,0,0
3538,1589,164,1625,277,28,11,4,36,113,57,58,0,0
3539,1591,166,1626,276,28,11,4,35,110,58,58,1,0
3912,1163,267,1270,405,31,11,4,107,138,0,3,0,0
3913,1162,267,1269,405,31,11,4,107,138,1,3,0,0
3914,1162,267,1269,405,31,11,4,107,138,2,3,0,0
3915,1162,267,1269,405,31,11,4,107,138,3,3,0,0
4364,1171,267,1264,391,34,11,4,93,124,0,0,0,0
4398,1574,161,1610,280,37,11,4,36,119,0,99,0,1
4399,1574,160,1611,282,37,11,4,37,122,1,99,0,0
4400,1571,149,1612,285,37,11,4,41,136,2,99,0,0
4401,1570,154,1611,287,37,11,4,41,133,3,99,0,0
4402,1569,154,1611,291,37,11,4,42,137,4,99,0,0
4403,1568,167,1607,293,37,11,4,39,126,5,99,0,0
4404,1566,173,1605,297,37,11,4,39,124,6,99,0,0
4405,1565,166,1606,299,37,11,4,41,133,7,99,0,0
4406,1566,169,1607,300,37,11,4,41,131,8,99,0,0
4407,1566,166,1608,303,37,11,4,42,137,9,99,0,0
4408,1563,169,1606,307,37,11,4,43,138,10,99,0,0
4409,1561,172,1604,309,37,11,4,43,137,11,99,0,0
4410,1559,171,1603,312,37,11,4,44,141,12,99,0,0
4411,1558,170,1604,316,37,11,4,46,146,13,99,0,0
4412,1559,168,1606,318,37,11,4,47,150,14,99,0,0
4413,1559,171,1608,321,37,11,4,49,150,15,99,0,0
4414,1559,180,1606,325,37,11,4,47,145,16,99,0,0
4415,1558,184,1604,326,37,11,4,46,142,17,99,0,0
4416,1557,184,1604,329,37,11,4,47,145,18,99,0,0
4417,1557,182,1606,332,37,11,4,49,150,19,99,0,0
4418,1558,183,1607,333,37,11,4,49,150,20,99,0,0
4419,1557,185,1607,339,37,11,4,50,154,21,99,0,0
4420,1553,188,1603,342,37,11,4,50,154,22,99,0,0
4421,1549,185,1601,345,37,11,4,52,160,23,99,0,0
4422,1545,180,1599,346,37,11,4,54,166,24,99,0,0
4423,1543,174,1600,352,37,11,4,57,178,25,99,0,0
4424,1543,175,1601,355,37,11,4,58,180,26,99,0,0
4425,1543,177,1601,356,37,11,4,58,179,27,99,0,0
4426,1542,182,1600,363,37,11,4,58,181,28,99,0,0
4427,1539,185,1597,365,37,11,4,58,180,29,99,0,0
4428,1536,187,1593,365,37,11,4,57,178,30,99,0,0
4429,1532,186,1591,370,37,11,4,59,184,31,99,0,0
4430,1530,189,1590,373,37,11,4,60,184,32,99,0,0
4431,1527,189,1589,376,37,11,4,62,187,33,99,0,0
4432,1523,192,1586,383,37,11,4,63,191,34,99,0,0
4433,1518,197,1582,388,37,11,4,64,191,35,99,0,0
4434,1512,194,1578,392,37,11,4,66,198,36,99,0,0
4435,1507,191,1576,399,37,11,4,69,208,37,99,0,0
4436,1505,191,1575,407,37,11,4,70,216,38,99,0,0
4437,1502,192,1574,409,37,11,4,72,217,39,99,0,0
4438,1496,195,1570,420,37,11,4,74,225,40,99,0,0
4439,1489,194,1567,427,37,11,4,78,233,41,99,0,0
4440,1480,197,1559,432,37,11,4,79,235,42,99,0,0
4441,1472,203,1552,443,37,11,4,80,240,43,99,0,0
4442,1467,202,1549,447,37,11,4,82,245,44,99,0,0
4443,1464,205,1546,452,37,11,4,82,247,45,99,0,0
4444,1460,210,1544,463,37,11,4,84,253,46,99,0,0
4445,1453,212,1538,469,37,11,4,85,257,47,99,0,0
4446,1447,214,1533,475,37,11,4,86,261,48,99,0,0
4447,1443,218,1533,493,37,11,4,90,275,49,99,0,0
4448,1440,217,1532,500,37,11,4,92,283,50,99,0,0
4449,1436,228,1529,514,37,11,4,93,286,51,99,0,0
4450,1427,235,1523,527,37,11,4,96,292,52,99,0,0
4451,1420,233,1518,535,37,11,4,98,302,53,99,0,0
4452,1413,241,1514,553,37,11,4,101,312,54,99,0,0
4453,1409,245,1513,569,37,11,4,104,324,55,99,0,0
4454,1406,247,1513,578,37,11,4,107,331,56,99,0,0
4455,1402,256,1512,596,37,11,4,110,340,57,99,0,0
4456,1397,262,1507,604,37,11,4,110,342,58,99,0,0
4457,1391,267,1506,626,37,11,4,115,359,59,99,0,0
4458,1389,278,1509,656,37,11,4,120,378,60,99,0,0
4459,1388,277,1513,673,37,11,4,125,396,61,99,0,0
4460,1385,286,1514,690,37,11,4,129,404,62,99,0,0
4461,1377,294,1509,710,37,11,4,132,416,63,99,0,0
4462,1368,302,1501,720,37,11,4,133,418,64,99,0,0
4463,1354,312,1493,746,37,11,4,139,434,65,99,0,0
4464,1343,320,1487,774,37,11,4,144,454,66,99,0,0
4465,1337,325,1483,787,37,11,4,146,462,67,99,0,0
4466,1329,328,1478,796,37,11,4,149,468,68,99,0,0
4467,1317,326,1469,802,37,11,4,152,476,69,99,0,0
4468,1309,322,1464,806,37,11,4,155,484,70,99,0,0
4469,1302,321,1458,807,37,11,4,156,486,71,99,0,0
4470,1298,322,1455,808,37,11,4,157,486,72,99,0,0
4471,1297,328,1452,804,37,11,4,155,476,73,99,0,0
4472,1296,327,1451,803,37,11,4,155,476,74,99,0,0
4473,1295,327,1450,802,37,11,4,155,475,75,99,0,0
4474,1295,328,1449,801,37,11,4,154,473,76,99,0,0
4475,1295,329,1448,800,37,11,4,153,471,77,99,0,0
4476,1292,331,1445,799,37,11,4,153,468,78,99,0,0
4477,1289,332,1441,800,37,11,4,152,468,79,99,0,0
4478,1284,332,1437,799,37,11,4,153,467,80,99,0,0
4479,1280,334,1432,799,37,11,4,152,465,81,99,0,0
4480,1274,338,1426,806,37,11,4,152,468,82,99,0,0
4481,1269,346,1427,833,37,11,4,158,487,83,99,0,0
4482,1264,362,1427,862,37,11,4,163,500,84,99,0,0
4483,1263,369,1427,872,37,11,4,164,503,85,99,0,0
4484,1257,383,1425,891,37,11,4,168,508,86,99,0,0
4485,1235,399,1415,938,37,11,4,180,539,87,99,0,0
4486,1208,404,1397,969,37,11,4,189,565,88,99,0,0
4487,1181,414,1380,1009,37,11,4,199,595,89,99,0,0
4488,1156,441,1362,1056,37,11,4,206,615,90,99,0,0
4489,1129,461,1339,1074,37,11,4,210,613,91,99,0,0
4490,1092,493,1300,1080,37,11,4,208,587,92,99,0,0
4491,1036,519,1243,1080,37,11,4,207,561,93,99,0,0
4492,966,538,1177,1080,37,11,4,211,542,94,99,0,0
4493,910,590,1122,1080,37,11,4,212,490,95,99,0,0
4494,831,660,1036,1079,37,11,4,205,419,96,99,0,0
4495,714,713,914,1079,37,11,4,200,366,97,99,0,0
4496,615,807,784,1080,37,11,4,169,273,98,99,0,0
4497,566,847,716,1080,37,11,4,150,233,99,99,1,0
4514,1179,268,1263,395,40,11,4,84,127,0,0,0,0
4553,1166,265,1270,403,41,11,4,104,138,0,0,0,0
4839,1163,273,1270,401,42,11,4,107,128,0,0,0,0
4947,1788,510,1920,1080,43,11,4,132,570,0,0,0,0
4948,1531,492,1889,1066,44,11,4,358,574,0,67,0,1
4949,1466,479,1832,1070,44,11,4,366,591,1,67,0,0
4950,1384,445,1767,1066,44,11,4,383,621,2,67,0,0
4951,1317,424,1711,1067,44,11,4,394,643,3,67,0,0
4952,1288,384,1662,1006,44,11,4,374,622,4,67,0,0
4953,1267,370,1622,973,44,11,4,355,603,5,67,0,0
4954,1253,339,1585,920,44,11,4,332,581,6,67,0,0
4955,1246,318,1550,861,44,11,4,304,543,7,67,0,0
4956,1253,313,1537,830,44,11,4,284,517,8,67,0,0
4957,1265,289,1522,770,44,11,4,257,481,9,67,0,0
4958,1282,279,1522,743,44,11,4,240,464,10,67,0,0
4959,1291,269,1516,717,44,11,4,225,448,11,67,0,0
4960,1306,257,1511,677,44,11,4,205,420,12,67,0,0
4961,1320,258,1508,657,44,11,4,188,399,13,67,0,0
4962,1336,247,1506,616,44,11,4,170,369,14,67,0,0
4963,1346,234,1510,599,44,11,4,164,365,15,67,0,0
4964,1354,228,1511,587,44,11,4,157,359,16,67,0,0
4965,1371,225,1514,558,44,11,4,143,333,17,67,0,0
4966,1385,226,1515,537,44,11,4,130,311,18,67,0,0
4967,1403,214,1528,517,44,11,4,125,303,19,67,0,0
4968,1415,204,1537,510,44,11,4,122,306,20,67,0,0
4969,1425,200,1543,499,44,11,4,118,299,21,67,0,0
4970,1443,197,1554,480,44,11,4,111,283,22,67,0,0
4971,1457,202,1560,466,44,11,4,103,264,23,67,0,0
4972,1476,198,1573,451,44,11,4,97,253,24,67,0,0
4973,1489,197,1584,446,44,11,4,95,249,25,67,0,0
4974,1499,197,1591,445,44,11,4,92,248,26,67,0,0
4975,1511,195,1597,429,44,11,4,86,234,27,67,0,0
4976,1519,197,1603,425,44,11,4,84,228,28,67,0,0
4977,1530,198,1610,417,44,11,4,80,219,29,67,0,0
4978,1543,187,1625,415,44,11,4,82,228,30,67,0,0
4979,1554,189,1631,406,44,11,4,77,217,31,67,0,0
4980,1566,189,1636,392,44,11,4,70,203,32,67,0,0
4981,1575,182,1645,388,44,11,4,70,206,33,67,0,0
4982,1584,182,1652,384,44,11,4,68,202,34,67,0,0
4983,1591,178,1657,376,44,11,4,66,198,35,67,0,0
4984,1595,175,1661,373,44,11,4,66,198,36,67,0,0
4985,1602,175,1664,363,44,11,4,62,188,37,67,0,0
4986,1607,173,1668,361,44,11,4,61,188,38,67,0,0
4987,1614,173,1673,358,44,11,4,59,185,39,67,0,0
4988,1622,172,1678,349,44,11,4,56,177,40,67,0,0
4989,1626,170,1682,349,44,11,4,56,179,41,67,0,0
4990,1630,172,1684,347,44,11,4,54,175,42,67,0,0
4991,1633,172,1684,337,44,11,4,51,165,43,67,0,0
4992,1633,172,1683,333,44,11,4,50,161,44,67,0,0
4993,1635,170,1682,324,44,11,4,47,154,45,67,0,0
4994,1632,169,1678,321,44,11,4,46,152,46,67,0,0
4995,1630,167,1675,317,44,11,4,45,150,47,67,0,0
4996,1625,162,1671,315,44,11,4,46,153,48,67,0,0
4997,1624,158,1670,312,44,11,4,46,154,49,67,0,0
4998,1624,160,1667,304,44,11,4,43,144,50,67,0,0
4999,1621,159,1665,304,44,11,4,44,145,51,67,0,0
5000,1619,160,1662,303,44,11,4,43,143,52,67,0,0
5001,1616,159,1659,298,44,11,4,43,139,53,67,0,0
5002,1616,156,1659,295,44,11,4,43,139,54,67,0,0
5003,1618,158,1659,289,44,11,4,41,131,55,67,0,0
5004,1617,156,1658,289,44,11,4,41,133,56,67,0,0
5005,1615,151,1658,287,44,11,4,43,136,57,67,0,0
5006,1614,154,1655,284,44,11,4,41,130,58,67,0,0
5007,1614,155,1654,282,44,11,4,40,127,59,67,0,0
5008,1615,157,1653,279,44,11,4,38,122,60,67,0,0
5009,1616,156,1655,278,44,11,4,39,122,61,67,0,0
5010,1617,155,1655,275,44,11,4,38,120,62,67,0,0
5011,1617,156,1654,270,44,11,4,37,114,63,67,0,0
5012,1618,155,1654,267,44,11,4,36,112,64,67,0,0
5013,1620,158,1656,266,44,11,4,36,108,65,67,0,0
5014,1622,157,1658,265,44,11,4,36,108,66,67,0,0
5015,1624,154,1659,261,44,11,4,35,107,67,67,1,0
4989,1167,267,1273,398,45,11,4,106,131,0,1,0,0
4990,1167,266,1274,398,45,11,4,107,132,1,1,0,0
5001,1148,262,1269,406,46,11,4,121,144,0,10,0,0
5002,1148,262,1269,406,46,11,4,121,144,1,10,0,0
5003,1147,262,1269,406,46,11,4,122,144,2,10,0,0
5004,1147,263,1268,407,46,11,4,121,144,3,10,0,0
5005,1150,264,1269,405,46,11,4,119,141,4,10,0,0
5006,1150,264,1269,405,46,11,4,119,141,5,10,0,0
5021,1160,259,1277,402,46,11,4,117,143,0,10,0,0
5022,1162,258,1275,401,46,11,4,113,143,1,10,0,0
5023,1164,258,1275,400,46,11,4,111,142,2,10,0,0
5024,1165,258,1274,400,46,11,4,109,142,3,10,0,0
5025,1165,260,1274,404,46,11,4,109,144,4,10,0,0
5026,1166,260,1274,404,46,11,4,108,144,5,10,0,0
5041,1165,269,1265,402,46,11,4,100,133,0,10,0,0
5042,1162,269,1264,401,46,11,4,102,132,1,10,0,0
5043,1163,269,1265,401,46,11,4,102,132,2,10,0,0
5044,1163,270,1265,402,46,11,4,102,132,3,10,0,0
5045,1163,270,1266,402,46,11,4,103,132,4,10,0,0
5046,1163,270,1266,402,46,11,4,103,132,5,10,0,0
5047,1162,268,1267,402,46,11,4,105,134,6,10,0,0
5048,1159,263,1269,403,46,11,4,110,140,7,10,0,0
5049,1159,262,1269,403,46,11,4,110,141,8,10,0,0
5050,1160,262,1269,403,46,11,4,109,141,9,10,0,0
5051,1159,262,1269,403,46,11,4,110,141,10,10,0,0
5136,1162,271,1272,405,47,11,4,110,134,0,6,0,0
5137,1163,271,1270,403,47,11,4,107,132,1,6,0,0
5138,1164,272,1270,401,47,11,4,106,129,2,6,0,0
5139,1165,272,1270,400,47,11,4,105,128,3,6,0,0
5140,1163,271,1271,402,47,11,4,108,131,4,6,0,0
5141,1160,270,1271,406,47,11,4,111,136,5,6,0,0
5142,1159,269,1271,407,47,11,4,112,138,6,6,0,0
5144,1161,268,1272,405,47,11,4,111,137,0,6,0,0
5145,1159,267,1272,406,47,11,4,113,139,1,6,0,0
5146,1159,266,1272,407,47,11,4,113,141,2,6,0,0
5151,1157,270,1265,401,47,11,4,108,131,0,6,0,0
5152,1157,270,1265,401,47,11,4,108,131,1,6,0,0
5153,1157,269,1266,401,47,11,4,109,132,2,6,0,0
5154,1157,269,1267,401,47,11,4,110,132,3,6,0,0
5155,1157,269,1266,401,47,11,4,109,132,4,6,0,0
5156,1157,269,1266,401,47,11,4,109,132,5,6,0,0
5306,1161,268,1270,404,48,11,4,109,136,0,5,0,0
5307,1160,267,1271,405,48,11,4,111,138,1,5,0,0
5308,1160,266,1271,406,48,11,4,111,140,2,5,0,0
5309,1160,267,1270,406,48,11,4,110,139,3,5,0,0
5310,1159,267,1270,406,48,11,4,111,139,4,5,0,0
5311,1159,267,1270,407,48,11,4,111,140,5,5,0,0
5336,1154,263,1269,407,48,11,4,115,144,0,5,0,0
5337,1153,262,1269,407,48,11,4,116,145,1,5,0,0
5338,1153,262,1269,406,48,11,4,116,144,2,5,0,0
5339,1152,263,1268,406,48,11,4,116,143,3,5,0,0
5340,1151,263,1268,406,48,11,4,117,143,4,5,0,0
5341,1151,263,1268,406,48,11,4,117,143,5,5,0,0
5590,1157,263,1269,406,49,11,4,112,143,0,0,0,0
1485,1828,516,1920,770,1,11,5,92,254,0,15,0,0
1486,1806,428,1920,778,1,11,5,114,350,1,15,0,0
1487,1774,368,1920,815,1,11,5,146,447,2,15,0,0
1488,1750,359,1920,846,1,11,5,170,487,3,15,0,0
1489,1723,325,1916,860,1,11,5,193,535,4,15,0,0
1490,1661,320,1872,888,1,11,5,211,568,5,15,0,0
1491,1612,321,1833,907,1,11,5,221,586,6,15,0,0
1492,1538,326,1783,954,1,11,5,245,628,7,15,0,0
1493,1470,336,1733,996,1,11,5,263,660,8,15,0,0
1494,1394,338,1668,1013,1,11,5,274,675,9,15,0,0
1495,1249,356,1545,1053,1,11,5,296,697,10,15,0,0
1496,1144,365,1451,1073,1,11,5,307,708,11,15,0,0
1497,1036,374,1345,1080,1,11,5,309,706,12,15,0,0
1498,907,391,1208,1074,1,11,5,301,683,13,15,0,0
1499,741,391,1042,1075,1,11,5,301,684,14,15,0,0
1500,667,385,978,1080,1,11,5,311,695,15,15,0,0
1500,488,429,822,1067,2,11,5,334,638,0,0,0,0
1501,257,412,571,1072,3,11,5,314,660,0,4,0,0
1502,121,431,430,1077,3,11,5,309,646,1,4,0,0
1503,36,517,303,1074,3,11,5,267,557,2,4,0,0
1504,0,643,160,1074,3,11,5,160,431,3,4,0,0
1505,0,715,61,1074,3,11,5,61,359,4,4,0,0
2951,1841,541,1920,793,4,11,5,79,252,0,14,0,0
2952,1811,508,1911,825,4,11,5,100,317,1,14,0,0
2953,1802,479,1917,845,4,11,5,115,366,2,14,0,0
2954,1783,469,1912,878,4,11,5,129,409,3,14,0,0
2955,1761,454,1909,922,4,11,5,148,468,4,14,0,0
2956,1728,458,1885,936,4,11,5,157,478,5,14,0,0
2957,1682,475,1858,983,4,11,5,176,508,6,14,0,0
2958,1655,490,1842,1009,4,11,5,187,519,7,14,0,0
2959,1618,518,1821,1058,4,11,5,203,540,8,14,0,0
2960,1589,554,1796,1073,4,11,5,207,519,9,14,0,0
2961,1557,589,1764,1078,4,11,5,207,489,10,14,0,0
2962,1543,651,1739,1080,4,11,5,196,429,11,14,0,0
2963,1510,718,1698,1080,4,11,5,188,362,12,14,0,0
2964,1510,815,1684,1080,4,11,5,174,265,13,14,0,0
2965,1496,845,1660,1080,4,11,5,164,235,14,14,0,0
2965,1867,311,1919,562,5,11,5,52,251,0,39,0,1
2966,1852,296,1908,562,5,11,5,56,266,1,39,0,0
2967,1843,300,1902,577,5,11,5,59,277,2,39,0,0
2968,1839,291,1902,578,5,11,5,63,287,3,39,0,0
2969,1828,287,1898,600,5,11,5,70,313,4,39,0,0
2970,1817,273,1895,611,5,11,5,78,338,5,39,0,0
2971,1807,269,1890,615,5,11,5,83,346,6,39,0,0
2972,1781,263,1872,620,5,11,5,91,357,7,39,0,0
2973,1763,269,1859,624,5,11,5,96,355,8,39,0,0
2974,1750,263,1854,636,5,11,5,104,373,9,39,0,0
2975,1726,263,1840,661,5,11,5,114,398,10,39,0,0
2976,1710,266,1830,674,5,11,5,120,408,11,39,0,0
2977,1683,270,1809,680,5,11,5,126,410,12,39,0,0
2978,1647,272,1784,694,5,11,5,137,422,13,39,0,0
2979,1622,270,1767,704,5,11,5,145,434,14,39,0,0
2980,1601,268,1756,729,5,11,5,155,461,15,39,0,0
2981,1568,284,1731,755,5,11,5,163,471,16,39,0,0
2982,1542,283,1712,767,5,11,5,170,484,17,39,0,0
2983,1495,285,1675,778,5,11,5,180,493,18,39,0,0
2984,1443,294,1634,801,5,11,5,191,507,19,39,0,0
2985,1408,289,1609,813,5,11,5,201,524,20,39,0,0
2986,1361,291,1578,851,5,11,5,217,560,21,39,0,0
2987,1306,297,1536,883,5,11,5,230,586,22,39,0,0
2988,1264,299,1497,891,5,11,5,233,592,23,39,0,0
2989,1175,304,1423,914,5,11,5,248,610,24,39,0,0
2990,1112,313,1367,934,5,11,5,255,621,25,39,0,0
2991,1060,316,1324,967,5,11,5,264,651,26,39,0,0
2992,953,329,1234,1011,5,11,5,281,682,27,39,0,0
2993,879,329,1166,1039,5,11,5,287,710,28,39,0,0
2994,786,329,1071,1043,5,11,5,285,714,29,39,0,0
2995,687,345,982,1057,5,11,5,295,712,30,39,0,0
2996,573,348,872,1059,5,11,5,299,711,31,39,0,0
2997,454,349,759,1071,5,11,5,305,722,32,39,0,0
2998,376,369,685,1074,5,11,5,309,705,33,39,0,0
2999,259,375,573,1077,5,11,5,314,702,34,39,0,0
3000,160,382,480,1080,5,11,5,320,698,35,39,0,0
3001,79,400,407,1080,5,11,5,328,680,36,39,0,0
3002,0,408,310,1076,5,11,5,310,668,37,39,0,0
3003,0,502,245,1080,5,11,5,245,578,38,39,0,0
3004,0,519,172,1080,5,11,5,172,561,39,39,1,0
3004,1,878,187,1073,6,11,5,186,195,0,0,0,0
3151,0,736,133,974,7,11,5,133,238,0,3,0,0
3152,0,539,220,1032,7,11,5,220,493,1,3,0,0
3153,0,497,278,1060,7,11,5,278,563,2,3,0,0
3154,0,451,307,1077,7,11,5,307,626,3,3,0,0
3154,166,476,417,1056,8,11,5,251,580,0,0,0,0
3155,304,466,577,1063,9,11,5,273,597,0,26,0,1
3156,426,475,694,1061,9,11,5,268,586,1,26,0,0
3157,538,461,801,1042,9,11,5,263,581,2,26,0,0
3158,679,467,938,1039,9,11,5,259,572,3,26,0,0
3159,821,447,1075,1014,9,11,5,254,567,4,26,0,0
3160,909,441,1182,1048,9,11,5,273,607,5,26,0,0
3161,1004,433,1286,1054,9,11,5,282,621,6,26,0,0
3162,1130,427,1419,1066,9,11,5,289,639,7,26,0,0
3163,1213,437,1498,1062,9,11,5,285,625,8,26,0,0
3164,1321,412,1596,1020,9,11,5,275,608,9,26,0,0
3165,1374,407,1640,989,9,11,5,266,582,10,26,0,0
3166,1436,399,1691,954,9,11,5,255,555,11,26,0,0
3167,1501,386,1750,931,9,11,5,249,545,12,26,0,0
3168,1542,386,1784,917,9,11,5,242,531,13,26,0,0
3169,1597,364,1821,860,9,11,5,224,496,14,26,0,0
3170,1620,363,1838,843,9,11,5,218,480,15,26,0,0
3171,1652,357,1857,805,9,11,5,205,448,16,26,0,0
3172,1692,352,1889,787,9,11,5,197,435,17,26,0,0
3173,1718,349,1908,773,9,11,5,190,424,18,26,0,0
3174,1747,340,1920,735,9,11,5,173,395,19,26,0,0
3175,1758,343,1920,716,9,11,5,162,373,20,26,0,0
3176,1779,335,1920,699,9,11,5,141,364,21,26,0,0
3177,1806,363,1920,693,9,11,5,114,330,22,26,0,0
3178,1825,365,1920,675,9,11,5,95,310,23,26,0,0
3179,1841,370,1920,659,9,11,5,79,289,24,26,0,0
3180,1853,394,1920,645,9,11,5,67,251,25,26,0,0
3181,1880,398,1920,627,9,11,5,40,229,26,26,1,0
3190,329,13,364,100,11,11,5,35,87,0,79,0,1
3191,327,13,363,104,11,11,5,36,91,1,79,0,0
3192,327,12,364,106,11,11,5,37,94,2,79,0,0
3193,325,12,363,108,11,11,5,38,96,3,79,0,0
3194,324,11,363,110,11,11,5,39,99,4,79,0,0
3195,325,12,363,111,11,11,5,38,99,5,79,0,0
3196,326,14,365,115,11,11,5,39,101,6,79,0,0
3197,328,14,366,116,11,11,5,38,102,7,79,0,0
3198,328,12,368,119,11,11,5,40,107,8,79,0,0
3199,329,12,369,121,11,11,5,40,109,9,79,0,0
3200,329,9,370,122,11,11,5,41,113,10,79,0,0
3201,330,11,371,124,11,11,5,41,113,11,79,0,0
3202,333,12,374,124,11,11,5,41,112,12,79,0,0
3203,334,12,376,127,11,11,5,42,115,13,79,0,0
3204,335,12,377,129,11,11,5,42,117,14,79,0,0
3205,334,11,377,129,11,11,5,43,118,15,79,0,0
3206,334,14,376,129,11,11,5,42,115,16,79,0,0
3207,335,17,376,131,11,11,5,41,114,17,79,0,0
3208,335,17,377,135,11,11,5,42,118,18,79,0,0
3209,334,19,376,137,11,11,5,42,118,19,79,0,0
3210,332,18,375,141,11,11,5,43,123,20,79,0,0
3211,330,18,374,145,11,11,5,44,127,21,79,0,0
3212,328,18,373,150,11,11,5,45,132,22,79,0,0
3213,327,17,374,153,11,11,5,47,136,23,79,0,0
3214,326,18,373,156,11,11,5,47,138,24,79,0,0
3215,325,21,372,159,11,11,5,47,138,25,79,0,0
3216,322,21,371,163,11,11,5,49,142,26,79,0,0
3217,322,25,371,168,11,11,5,49,143,27,79,0,0
3218,324,28,372,170,11,11,5,48,142,28,79,0,0
3219,325,29,375,174,11,11,5,50,145,29,79,0,0
3220,327,32,377,179,11,11,5,50,147,30,79,0,0
3221,329,31,380,183,11,11,5,51,152,31,79,0,0
3222,331,32,383,187,11,11,5,52,155,32,79,0,0
3223,334,37,385,189,11,11,5,51,152,33,79,0,0
3224,338,36,390,192,11,11,5,52,156,34,79,0,0
3225,340,36,394,199,11,11,5,54,163,35,79,0,0
3226,340,38,394,203,11,11,5,54,165,36,79,0,0
3227,340,38,396,207,11,11,5,56,169,37,79,0,0
3228,342,43,397,212,11,11,5,55,169,38,79,0,0
3229,343,38,402,218,11,11,5,59,180,39,79,0,0
3230,345,41,403,224,11,11,5,58,183,40,79,0,0
3231,344,44,405,234,11,11,5,61,190,41,79,0,0
3232,345,44,408,240,11,11,5,63,196,42,79,0,0
3233,346,49,409,246,11,11,5,63,197,43,79,0,0
3234,351,64,411,251,11,11,5,60,187,44,79,0,0
3235,354,74,412,256,11,11,5,58,182,45,79,0,0
3236,353,64,417,267,11,11,5,64,203,46,79,0,0
3237,352,64,419,274,11,11,5,67,210,47,79,0,0
3238,352,60,423,281,11,11,5,71,221,48,79,0,0
3239,351,67,425,294,11,11,5,74,227,49,79,0,0
3240,354,70,429,300,11,11,5,75,230,50,79,0,0
3241,351,73,430,315,11,11,5,79,242,51,79,0,0
3242,350,76,431,327,11,11,5,81,251,52,79,0,0
3243,348,75,432,331,11,11,5,84,256,53,79,0,0
3244,347,76,436,348,11,11,5,89,272,54,79,0,0
3245,351,76,443,359,11,11,5,92,283,55,79,0,0
3246,352,80,447,373,11,11,5,95,293,56,79,0,0
3247,352,88,452,398,11,11,5,100,310,57,79,0,0
3248,350,88,454,410,11,11,5,104,322,58,79,0,0
3249,351,95,459,431,11,11,5,108,336,59,79,0,0
3250,355,103,467,449,11,11,5,112,346,60,79,0,0
3251,360,109,476,468,11,11,5,116,359,61,79,0,0
3252,368,122,492,503,11,11,5,124,381,62,79,0,0
3253,369,124,499,523,11,11,5,130,399,63,79,0,0
3254,372,135,508,553,11,11,5,136,418,64,79,0,0
3255,378,151,517,581,11,11,5,139,430,65,79,0,0
3256,390,159,535,605,11,11,5,145,446,66,79,0,0
3257,396,176,553,652,11,11,5,157,476,67,79,0,0
3258,401,192,567,692,11,11,5,166,500,68,79,0,0
3259,406,205,587,746,11,11,5,181,541,69,79,0,0
3260,410,229,606,819,11,11,5,196,590,70,79,0,0
3261,431,246,635,851,11,11,5,204,605,71,79,0,0
3262,442,286,668,946,11,11,5,226,660,72,79,0,0
3263,454,322,694,1011,11,11,5,240,689,73,79,0,0
3264,467,359,714,1059,11,11,5,247,700,74,79,0,0
3265,499,433,735,1080,11,11,5,236,647,75,79,0,0
3266,569,493,802,1080,11,11,5,233,587,76,79,0,0
3267,651,589,872,1080,11,11,5,221,491,77,79,0,0
3268,743,722,934,1080,11,11,5,191,358,78,79,0,0
3269,777,765,958,1080,11,11,5,181,315,79,79,1,0
3489,1,954,86,1075,13,11,5,85,121,0,0,0,0
3490,1,792,166,1073,14,11,5,165,281,0,0,0,0
3491,5,373,303,1049,15,11,5,298,676,0,80,0,1
3492,17,356,315,1031,15,11,5,298,675,1,80,0,0
3493,75,326,383,1024,15,11,5,308,698,2,80,0,0
3494,151,309,462,1013,15,11,5,311,704,3,80,0,0
3495,200,276,490,936,15,11,5,290,660,4,80,0,0
3496,275,261,556,899,15,11,5,281,638,5,80,0,0
3497,326,249,593,858,15,11,5,267,609,6,80,0,0
3498,372,219,629,805,15,11,5,257,586,7,80,0,0
3499,393,212,639,782,15,11,5,246,570,8,80,0,0
3500,402,199,623,716,15,11,5,221,517,9,80,0,0
3501,400,168,615,676,15,11,5,215,508,10,80,0,0
3502,407,169,610,657,15,11,5,203,488,11,80,0,0
3503,409,131,606,612,15,11,5,197,481,12,80,0,0
3504,410,125,595,586,15,11,5,185,461,13,80,0,0
3505,410,128,581,563,15,11,5,171,435,14,80,0,0
3506,401,121,561,532,15,11,5,160,411,15,80,0,0
3507,390,112,548,521,15,11,5,158,409,16,80,0,0
3508,390,107,542,504,15,11,5,152,397,17,80,0,0
3509,388,94,530,470,15,11,5,142,376,18,80,0,0
3510,384,89,520,458,15,11,5,136,369,19,80,0,0
3511,378,87,504,433,15,11,5,126,346,20,80,0,0
3512,372,80,493,415,15,11,5,121,335,21,80,0,0
3513,368,79,487,408,15,11,5,119,329,22,80,0,0
3514,372,77,481,383,15,11,5,109,306,23,80,0,0
3515,369,75,474,372,15,11,5,105,297,24,80,0,0
3516,364,76,464,363,15,11,5,100,287,25,80,0,0
3517,359,77,453,344,15,11,5,94,267,26,80,0,0
3518,357,77,450,341,15,11,5,93,264,27,80,0,0
3519,357,76,449,336,15,11,5,92,260,28,80,0,0
3520,359,78,446,321,15,11,5,87,243,29,80,0,0
3521,358,76,442,313,15,11,5,84,237,30,80,0,0
3522,355,75,435,304,15,11,5,80,229,31,80,0,0
3523,352,70,430,293,15,11,5,78,223,32,80,0,0
3524,351,71,427,288,15,11,5,76,217,33,80,0,0
3525,355,69,429,276,15,11,5,74,207,34,80,0,0
3526,351,61,425,270,15,11,5,74,209,35,80,0,0
3527,348,60,420,266,15,11,5,72,206,36,80,0,0
3528,344,56,413,254,15,11,5,69,198,37,80,0,0
3529,341,52,409,248,15,11,5,68,196,38,80,0,0
3530,341,51,409,248,15,11,5,68,197,39,80,0,0
3531,344,45,411,239,15,11,5,67,194,40,80,0,0
3532,345,42,411,235,15,11,5,66,193,41,80,0,0
3533,344,41,408,232,15,11,5,64,191,42,80,0,0
3534,343,35,405,221,15,11,5,62,186,43,80,0,0
3535,341,31,403,217,15,11,5,62,186,44,80,0,0
3536,344,34,403,212,15,11,5,59,178,45,80,0,0
3537,345,29,404,209,15,11,5,59,180,46,80,0,0
3538,346,34,400,200,15,11,5,54,166,47,80,0,0
3539,343,31,397,197,15,11,5,54,166,48,80,0,0
3540,340,28,393,195,15,11,5,53,167,49,80,0,0
3541,338,28,391,193,15,11,5,53,165,50,80,0,0
3542,338,27,389,186,15,11,5,51,159,51,80,0,0
3543,338,26,387,183,15,11,5,49,157,52,80,0,0
3544,337,27,385,180,15,11,5,48,153,53,80,0,0
3545,335,25,382,177,15,11,5,47,152,54,80,0,0
3546,334,23,381,172,15,11,5,47,149,55,80,0,0
3547,335,23,381,170,15,11,5,46,147,56,80,0,0
3548,335,22,381,166,15,11,5,46,144,57,80,0,0
3549,336,22,380,162,15,11,5,44,140,58,80,0,0
3550,334,21,378,161,15,11,5,44,140,59,80,0,0
3551,332,16,377,158,15,11,5,45,142,60,80,0,0
3552,331,15,376,156,15,11,5,45,141,61,80,0,0
3553,331,18,373,151,15,11,5,42,133,62,80,0,0
3554,330,17,372,149,15,11,5,42,132,63,80,0,0
3555,328,16,371,149,15,11,5,43,133,64,80,0,0
3556,324,14,367,147,15,11,5,43,133,65,80,0,0
3557,321,11,364,146,15,11,5,43,135,66,80,0,0
3558,320,10,364,147,15,11,5,44,137,67,80,0,0
3559,320,9,364,144,15,11,5,44,135,68,80,0,0
3560,320,10,362,141,15,11,5,42,131,69,80,0,0
3561,319,9,360,137,15,11,5,41,128,70,80,0,0
3562,318,6,359,135,15,11,5,41,129,71,80,0,0
3563,318,7,358,135,15,11,5,40,128,72,80,0,0
3564,319,7,359,133,15,11,5,40,126,73,80,0,0
3565,319,6,359,132,15,11,5,40,126,74,80,0,0
3566,319,6,358,130,15,11,5,39,124,75,80,0,0
3567,318,5,358,131,15,11,5,40,126,76,80,0,0
3568,317,4,357,131,15,11,5,40,127,77,80,0,0
3569,317,3,356,129,15,11,5,39,126,78,80,0,0
3570,320,3,357,124,15,11,5,37,121,79,80,0,0
3571,321,6,356,118,15,11,5,35,112,80,80,1,0
4208,320,5,356,103,16,11,5,36,98,0,85,0,1
4209,320,6,357,111,16,11,5,37,105,1,85,0,0
4210,320,6,360,118,16,11,5,40,112,2,85,0,0
4211,323,6,364,120,16,11,5,41,114,3,85,0,0
4212,325,7,366,120,16,11,5,41,113,4,85,0,0
4213,325,7,367,122,16,11,5,42,115,5,85,0,0
4214,323,7,365,122,16,11,5,42,115,6,85,0,0
4215,323,9,366,127,16,11,5,43,118,7,85,0,0
4216,325,13,367,130,16,11,5,42,117,8,85,0,0
4217,324,11,367,130,16,11,5,43,119,9,85,0,0
4218,324,12,367,132,16,11,5,43,120,10,85,0,0
4219,323,13,366,135,16,11,5,43,122,11,85,0,0
4220,322,12,366,136,16,11,5,44,124,12,85,0,0
4221,322,16,366,141,16,11,5,44,125,13,85,0,0
4222,324,17,368,142,16,11,5,44,125,14,85,0,0
4223,326,16,370,144,16,11,5,44,128,15,85,0,0
4224,325,17,370,148,16,11,5,45,131,16,85,0,0
4225,324,17,369,151,16,11,5,45,134,17,85,0,0
4226,324,18,369,152,16,11,5,45,134,18,85,0,0
4227,325,20,370,154,16,11,5,45,134,19,85,0,0
4228,325,19,371,155,16,11,5,46,136,20,85,0,0
4229,325,19,371,157,16,11,5,46,138,21,85,0,0
4230,325,21,371,159,16,11,5,46,138,22,85,0,0
4231,325,21,372,161,16,11,5,47,140,23,85,0,0
4232,326,23,374,167,16,11,5,48,144,24,85,0,0
4233,328,26,375,169,16,11,5,47,143,25,85,0,0
4234,329,25,377,172,16,11,5,48,147,26,85,0,0
4235,329,26,378,176,16,11,5,49,150,27,85,0,0
4236,331,31,379,180,16,11,5,48,149,28,85,0,0
4237,330,29,379,183,16,11,5,49,154,29,85,0,0
4238,333,32,382,188,16,11,5,49,156,30,85,0,0
4239,335,31,384,191,16,11,5,49,160,31,85,0,0
4240,334,31,384,194,16,11,5,50,163,32,85,0,0
4241,332,32,383,201,16,11,5,51,169,33,85,0,0
4242,331,32,382,205,16,11,5,51,173,34,85,0,0
4243,331,36,382,208,16,11,5,51,172,35,85,0,0
4244,331,38,382,211,16,11,5,51,173,36,85,0,0
4245,331,35,384,214,16,11,5,53,179,37,85,0,0
4246,334,37,386,217,16,11,5,52,180,38,85,0,0
4247,334,42,387,224,16,11,5,53,182,39,85,0,0
4248,334,40,388,227,16,11,5,54,187,40,85,0,0
4249,335,44,391,236,16,11,5,56,192,41,85,0,0
4250,336,45,393,240,16,11,5,57,195,42,85,0,0
4251,342,44,400,243,16,11,5,58,199,43,85,0,0
4252,344,50,405,253,16,11,5,61,203,44,85,0,0
4253,343,54,404,258,16,11,5,61,204,45,85,0,0
4254,341,54,405,263,16,11,5,64,209,46,85,0,0
4255,342,57,408,273,16,11,5,66,216,47,85,0,0
4256,344,57,412,278,16,11,5,68,221,48,85,0,0
4257,347,63,415,284,16,11,5,68,221,49,85,0,0
4258,346,70,415,295,16,11,5,69,225,50,85,0,0
4259,340,72,411,301,16,11,5,71,229,51,85,0,0
4260,338,72,412,309,16,11,5,74,237,52,85,0,0
4261,340,74,416,318,16,11,5,76,244,53,85,0,0
4262,347,75,425,325,16,11,5,78,250,54,85,0,0
4263,350,75,433,339,16,11,5,83,264,55,85,0,0
4264,350,76,436,351,16,11,5,86,275,56,85,0,0
4265,348,76,436,361,16,11,5,88,285,57,85,0,0
4266,350,83,440,375,16,11,5,90,292,58,85,0,0
4267,356,85,449,387,16,11,5,93,302,59,85,0,0
4268,360,84,457,399,16,11,5,97,315,60,85,0,0
4269,362,91,464,418,16,11,5,102,327,61,85,0,0
4270,363,93,468,430,16,11,5,105,337,62,85,0,0
4271,365,95,474,448,16,11,5,109,353,63,85,0,0
4272,371,103,483,466,16,11,5,112,363,64,85,0,0
4273,380,103,494,473,16,11,5,114,370,65,85,0,0
4274,383,111,507,503,16,11,5,124,392,66,85,0,0
4275,381,119,511,530,16,11,5,130,411,67,85,0,0
4276,378,122,510,539,16,11,5,132,417,68,85,0,0
4277,382,136,519,569,16,11,5,137,433,69,85,0,0
4278,388,137,531,593,16,11,5,143,456,70,85,0,0
4279,396,143,546,610,16,11,5,150,467,71,85,0,0
4280,395,161,555,655,16,11,5,160,494,72,85,0,0
4281,389,173,554,683,16,11,5,165,510,73,85,0,0
4282,381,185,552,712,16,11,5,171,527,74,85,0,0
4283,367,202,555,782,16,11,5,188,580,75,85,0,0
4284,363,213,554,799,16,11,5,191,586,76,85,0,0
4285,350,231,552,850,16,11,5,202,619,77,85,0,0
4286,329,259,541,901,16,11,5,212,642,78,85,0,0
4287,274,276,491,924,16,11,5,217,648,79,85,0,0
4288,187,301,432,1015,16,11,5,245,714,80,85,0,0
4289,139,332,398,1065,16,11,5,259,733,81,85,0,0
4290,73,357,333,1080,16,11,5,260,723,82,85,0,0
4291,41,395,296,1080,16,11,5,255,685,83,85,0,0
4292,34,591,228,1080,16,11,5,194,489,84,85,0,0
4293,15,624,207,1080,16,11,5,192,456,85,85,1,0
4573,1868,341,1919,624,17,11,5,51,283,0,29,0,1
4574,1858,329,1911,623,17,11,5,53,294,1,29,0,0
4575,1826,301,1889,637,17,11,5,63,336,2,29,0,0
4576,1811,281,1882,645,17,11,5,71,364,3,29,0,0
4577,1802,271,1882,665,17,11,5,80,394,4,29,0,0
4578,1770,273,1857,676,17,11,5,87,403,5,29,0,0
4579,1746,262,1842,684,17,11,5,96,422,6,29,0,0
4580,1697,259,1804,693,17,11,5,107,434,7,29,0,0
4581,1648,263,1766,704,17,11,5,118,441,8,29,0,0
4582,1614,255,1744,715,17,11,5,130,460,9,29,0,0
4583,1559,248,1709,752,17,11,5,150,504,10,29,0,0
4584,1515,265,1675,778,17,11,5,160,513,11,29,0,0
4585,1482,256,1653,787,17,11,5,171,531,12,29,0,0
4586,1404,267,1591,811,17,11,5,187,544,13,29,0,0
4587,1345,277,1548,842,17,11,5,203,565,14,29,0,0
4588,1307,273,1528,876,17,11,5,221,603,15,29,0,0
4589,1221,286,1463,927,17,11,5,242,641,16,29,0,0
4590,1159,291,1417,961,17,11,5,258,670,17,29,0,0
4591,1079,288,1346,966,17,11,5,267,678,18,29,0,0
4592,965,302,1257,1026,17,11,5,292,724,19,29,0,0
4593,868,305,1169,1047,17,11,5,301,742,20,29,0,0
4594,761,324,1065,1068,17,11,5,304,744,21,29,0,0
4595,664,356,972,1080,17,11,5,308,724,22,29,0,0
4596,559,363,864,1077,17,11,5,305,714,23,29,0,0
4597,420,371,724,1076,17,11,5,304,705,24,29,0,0
4598,295,387,605,1077,17,11,5,310,690,25,29,0,0
4599,123,388,435,1075,17,11,5,312,687,26,29,0,0
4600,47,419,357,1079,17,11,5,310,660,27,29,0,0
4601,0,510,223,1080,17,11,5,223,570,28,29,0,0
4602,0,528,134,1080,17,11,5,134,552,29,29,1,0
4593,1869,438,1919,688,18,11,5,50,250,0,22,0,1
4594,1870,438,1919,687,18,11,5,49,249,1,22,0,0
4595,1837,400,1898,697,18,11,5,61,297,2,22,0,0
4596,1815,347,1892,710,18,11,5,77,363,3,22,0,0
4597,1807,334,1891,725,18,11,5,84,391,4,22,0,0
4598,1786,335,1881,759,18,11,5,95,424,5,22,0,0
4599,1765,339,1870,780,18,11,5,105,441,6,22,0,0
4600,1737,349,1848,788,18,11,5,111,439,7,22,0,0
4601,1689,357,1814,814,18,11,5,125,457,8,22,0,0
4602,1655,355,1792,834,18,11,5,137,479,9,22,0,0
4603,1617,356,1774,885,18,11,5,157,529,10,22,0,0
4604,1569,382,1738,918,18,11,5,169,536,11,22,0,0
4605,1532,388,1711,939,18,11,5,179,551,12,22,0,0
4606,1446,405,1643,967,18,11,5,197,562,13,22,0,0
4607,1374,416,1587,997,18,11,5,213,581,14,22,0,0
4608,1319,417,1548,1035,18,11,5,229,618,15,22,0,0
4609,1223,437,1467,1064,18,11,5,244,627,16,22,0,0
4610,1136,453,1386,1080,18,11,5,250,627,17,22,0,0
4611,1032,465,1282,1080,18,11,5,250,615,18,22,0,0
4612,913,484,1162,1077,18,11,5,249,593,19,22,0,0
4613,787,485,1033,1078,18,11,5,246,593,20,22,0,0
4614,670,517,916,1079,18,11,5,246,562,21,22,0,0
4615,602,524,851,1080,18,11,5,249,556,22,22,1,0
4602,1850,428,1919,619,19,11,5,69,191,0,31,0,1
4603,1837,371,1920,627,19,11,5,83,256,1,31,0,0
4604,1831,353,1920,637,19,11,5,89,284,2,31,0,0
4605,1822,341,1920,653,19,11,5,98,312,3,31,0,0
4606,1811,329,1920,669,19,11,5,109,340,4,31,0,0
4607,1790,322,1914,670,19,11,5,124,348,5,31,0,0
4608,1763,326,1894,682,19,11,5,131,356,6,31,0,0
4609,1748,326,1884,690,19,11,5,136,364,7,31,0,0
4610,1728,322,1879,725,19,11,5,151,403,8,31,0,0
4611,1706,331,1866,755,19,11,5,160,424,9,31,0,0
4612,1688,335,1848,756,19,11,5,160,421,10,31,0,0
4613,1637,339,1807,770,19,11,5,170,431,11,31,0,0
4614,1595,348,1772,783,19,11,5,177,435,12,31,0,0
4615,1565,344,1756,810,19,11,5,191,466,13,31,0,0
4616,1519,350,1724,841,19,11,5,205,491,14,31,0,0
4617,1480,364,1693,873,19,11,5,213,509,15,31,0,0
4618,1412,363,1638,887,19,11,5,226,524,16,31,0,0
4619,1332,383,1568,910,19,11,5,236,527,17,31,0,0
4620,1279,386,1524,927,19,11,5,245,541,18,31,0,0
4621,1208,392,1487,1003,19,11,5,279,611,19,31,0,0
4622,1136,412,1430,1050,19,11,5,294,638,20,31,0,0
4623,1055,420,1351,1071,19,11,5,296,651,21,31,0,0
4624,927,446,1221,1073,19,11,5,294,627,22,31,0,0
4625,842,456,1135,1074,19,11,5,293,618,23,31,0,0
4626,739,454,1037,1077,19,11,5,298,623,24,31,0,0
4627,677,495,974,1079,19,11,5,297,584,25,31,0,0
4628,545,512,833,1080,19,11,5,288,568,26,31,0,0
4629,401,528,681,1080,19,11,5,280,552,27,31,0,0
4630,254,552,524,1080,19,11,5,270,528,28,31,0,0
4631,103,565,365,1080,19,11,5,262,515,29,31,0,0
4632,18,591,266,1078,19,11,5,248,487,30,31,0,0
4633,0,605,173,1080,19,11,5,173,475,31,31,1,0
4615,440,558,724,1071,20,11,5,284,513,0,0,0,0
4616,298,563,539,1076,21,11,5,241,513,0,0,0,0
4617,128,603,427,1077,22,11,5,299,474,0,1,0,0
4618,10,602,306,1071,22,11,5,296,469,1,1,0,0
4624,1848,521,1920,783,23,11,5,72,262,0,18,0,0
4625,1820,504,1907,817,23,11,5,87,313,1,18,0,0
4626,1803,436,1914,835,23,11,5,111,399,2,18,0,0
4627,1792,413,1920,878,23,11,5,128,465,3,18,0,0
4628,1769,413,1909,914,23,11,5,140,501,4,18,0,0
4629,1754,394,1905,927,23,11,5,151,533,5,18,0,0
4630,1706,402,1869,946,23,11,5,163,544,6,18,0,0
4631,1656,419,1837,981,23,11,5,181,562,7,18,0,0
4632,1617,424,1812,1001,23,11,5,195,577,8,18,0,0
4633,1563,428,1781,1047,23,11,5,218,619,9,18,0,0
4634,1511,451,1738,1067,23,11,5,227,616,10,18,0,0
4635,1454,452,1692,1076,23,11,5,238,624,11,18,0,0
4636,1357,468,1605,1078,23,11,5,248,610,12,18,0,0
4637,1269,493,1517,1079,23,11,5,248,586,13,18,0,0
4638,1165,491,1421,1077,23,11,5,256,586,14,18,0,0
4639,1045,522,1296,1075,23,11,5,251,553,15,18,0,0
4640,909,544,1154,1077,23,11,5,245,533,16,18,0,0
4641,752,544,1000,1074,23,11,5,248,530,17,18,0,0
4642,677,547,928,1080,23,11,5,251,533,18,18,0,0
4642,508,567,788,1071,24,11,5,280,504,0,0,0,0
4643,298,578,598,1070,25,11,5,300,492,0,3,0,0
4644,160,589,456,1073,25,11,5,296,484,1,3,0,0
4645,47,616,329,1075,25,11,5,282,459,2,3,0,0
4646,0,629,256,1077,25,11,5,256,448,3,3,0,0
5418,4,656,249,1070,26,11,5,245,414,0,34,0,1
5419,53,618,324,1076,26,11,5,271,458,1,34,0,0
5420,148,580,443,1077,26,11,5,295,497,2,34,0,0
5421,275,559,582,1075,26,11,5,307,516,3,34,0,0
5422,398,523,724,1074,26,11,5,326,551,4,34,0,0
5423,519,505,852,1072,26,11,5,333,567,5,34,0,0
5424,621,489,962,1072,26,11,5,341,583,6,34,0,0
5425,720,467,1070,1072,26,11,5,350,605,7,34,0,0
5426,799,455,1153,1073,26,11,5,354,618,8,34,0,0
5427,900,423,1256,1061,26,11,5,356,638,9,34,0,0
5428,976,412,1318,1034,26,11,5,342,622,10,34,0,0
5429,1037,403,1368,1009,26,11,5,331,606,11,34,0,0
5430,1130,387,1444,975,26,11,5,314,588,12,34,0,0
5431,1178,382,1482,959,26,11,5,304,577,13,34,0,0
5432,1247,353,1528,900,26,11,5,281,547,14,34,0,0
5433,1287,348,1547,858,26,11,5,260,510,15,34,0,0
5434,1328,345,1573,823,26,11,5,245,478,16,34,0,0
5435,1393,332,1627,797,26,11,5,234,465,17,34,0,0
5436,1430,328,1658,785,26,11,5,228,457,18,34,0,0
5437,1480,312,1692,747,26,11,5,212,435,19,34,0,0
5438,1509,316,1706,719,26,11,5,197,403,20,34,0,0
5439,1542,316,1732,701,26,11,5,190,385,21,34,0,0
5440,1592,305,1777,689,26,11,5,185,384,22,34,0,0
5441,1617,307,1799,684,26,11,5,182,377,23,34,0,0
5442,1660,300,1830,661,26,11,5,170,361,24,34,0,0
5443,1679,306,1841,648,26,11,5,162,342,25,34,0,0
5444,1705,309,1862,638,26,11,5,157,329,26,34,0,0
5445,1746,308,1896,631,26,11,5,150,323,27,34,0,0
5446,1765,309,1912,626,26,11,5,147,317,28,34,0,0
5447,1794,308,1920,608,26,11,5,126,300,29,34,0,0
5448,1806,315,1920,596,26,11,5,114,281,30,34,0,0
5449,1823,325,1920,586,26,11,5,97,261,31,34,0,0
5450,1840,330,1920,582,26,11,5,80,252,32,34,0,0
5451,1852,337,1920,576,26,11,5,68,239,33,34,0,0
5452,1877,339,1920,564,26,11,5,43,225,34,34,1,0
1,367,271,495,762,1,11,6,128,491,0,8,0,0
2,365,274,489,746,1,11,6,124,472,1,8,0,0
3,338,280,465,761,1,11,6,127,481,2,8,0,0
4,306,271,426,717,1,11,6,120,446,3,8,0,0
5,276,263,403,725,1,11,6,127,462,4,8,0,0
6,250,262,365,671,1,11,6,115,409,5,8,0,0
7,224,256,321,604,1,11,6,97,348,6,8,0,0
8,216,301,284,553,1,11,6,68,252,7,8,0,0
9,196,309,253,519,1,11,6,57,210,8,8,0,0
317,314,107,364,232,2,11,6,50,125,0,1,0,0
318,328,105,378,228,2,11,6,50,123,1,1,0,0
320,366,98,421,226,3,11,6,55,128,0,0,0,0
322,415,101,451,218,4,11,6,36,117,0,4,0,0
323,430,99,469,224,4,11,6,39,125,1,4,0,0
324,450,103,487,221,4,11,6,37,118,2,4,0,0
325,466,104,504,224,4,11,6,38,120,3,4,0,0
326,479,104,517,226,4,11,6,38,122,4,4,0,0
322,244,140,301,386,5,11,6,57,246,0,25,0,1
323,254,138,311,385,5,11,6,57,247,1,25,0,0
324,265,134,323,383,5,11,6,58,249,2,25,0,0
325,277,135,335,381,5,11,6,58,246,3,25,0,0
326,288,130,346,372,5,11,6,58,242,4,25,0,0
327,299,121,357,364,5,11,6,58,243,5,25,0,0
328,309,125,364,355,5,11,6,55,230,6,25,0,0
329,316,119,372,344,5,11,6,56,225,7,25,0,0
330,323,120,377,336,5,11,6,54,216,8,25,0,0
331,322,115,375,329,5,11,6,53,214,9,25,0,0
332,322,115,373,319,5,11,6,51,204,10,25,0,0
333,321,116,372,314,5,11,6,51,198,11,25,0,0
334,318,111,369,306,5,11,6,51,195,12,25,0,0
335,314,112,365,303,5,11,6,51,191,13,25,0,0
336,310,111,359,298,5,11,6,49,187,14,25,0,0
337,306,109,355,293,5,11,6,49,184,15,25,0,0
338,304,112,351,291,5,11,6,47,179,16,25,0,0
339,304,113,350,286,5,11,6,46,173,17,25,0,0
340,307,111,352,279,5,11,6,45,168,18,25,0,0
341,307,110,352,277,5,11,6,45,167,19,25,0,0
342,308,107,355,274,5,11,6,47,167,20,25,0,0
343,307,108,353,269,5,11,6,46,161,21,25,0,0
344,303,106,350,266,5,11,6,47,160,22,25,0,0
345,303,105,349,261,5,11,6,46,156,23,25,0,0
346,303,104,348,256,5,11,6,45,152,24,25,0,0
347,303,103,347,251,5,11,6,44,148,25,25,1,0
777,227,269,294,586,6,11,6,67,317,0,19,0,1
778,234,274,323,691,6,11,6,89,417,1,19,0,0
779,268,278,365,724,6,11,6,97,446,2,19,0,0
780,297,284,399,734,6,11,6,102,450,3,19,0,0
781,342,278,448,731,6,11,6,106,453,4,19,0,0
782,395,267,508,739,6,11,6,113,472,5,19,0,0
783,440,262,553,720,6,11,6,113,458,6,19,0,0
784,472,250,589,711,6,11,6,117,461,7,19,0,0
785,479,243,599,702,6,11,6,120,459,8,19,0,0
786,488,243,605,680,6,11,6,117,437,9,19,0,0
787,486,233,596,640,6,11,6,110,407,10,19,0,0
788,471,231,577,615,6,11,6,106,384,11,19,0,0
789,447,230,555,604,6,11,6,108,374,12,19,0,0
790,405,219,510,576,6,11,6,105,357,13,19,0,0
791,366,213,472,570,6,11,6,106,357,14,19,0,0
792,332,210,436,552,6,11,6,104,342,15,19,0,0
793,294,201,395,530,6,11,6,101,329,16,19,0,0
794,260,193,365,533,6,11,6,105,340,17,19,0,0
795,245,208,343,527,6,11,6,98,319,18,19,0,0
796,230,205,327,517,6,11,6,97,312,19,19,0,0
835,249,168,317,447,7,11,6,68,279,0,16,0,0
836,275,168,343,445,7,11,6,68,277,1,16,0,0
837,312,167,376,422,7,11,6,64,255,2,16,0,0
838,363,165,425,409,7,11,6,62,244,3,16,0,0
839,399,164,466,411,7,11,6,67,247,4,16,0,0
840,442,157,509,404,7,11,6,67,247,5,16,0,0
841,486,151,556,400,7,11,6,70,249,6,16,0,0
842,527,146,597,388,7,11,6,70,242,7,16,0,0
843,561,143,629,376,7,11,6,68,233,8,16,0,0
844,582,142,652,374,7,11,6,70,232,9,16,0,0
845,622,145,690,367,7,11,6,68,222,10,16,0,0
846,663,141,733,364,7,11,6,70,223,11,16,0,0
847,690,147,761,362,7,11,6,71,215,12,16,0,0
848,725,142,798,355,7,11,6,73,213,13,16,0,0
849,733,136,809,356,7,11,6,76,220,14,16,0,0
850,759,141,831,348,7,11,6,72,207,15,16,0,0
851,790,140,861,343,7,11,6,71,203,16,16,0,0
1502,1772,892,1919,1077,8,11,6,147,185,0,0,0,0
1503,1551,744,1807,1076,9,11,6,256,332,0,0,0,0
1504,1266,651,1680,1066,10,11,6,414,415,0,7,0,0
1505,1080,584,1563,1068,10,11,6,483,484,1,7,0,0
1506,959,500,1526,1074,10,11,6,567,574,2,7,0,0
1507,826,444,1437,1073,10,11,6,611,629,3,7,0,0
1508,696,389,1338,1066,10,11,6,642,677,4,7,0,0
1509,604,350,1254,1055,10,11,6,650,705,5,7,0,0
1510,522,315,1177,1051,10,11,6,655,736,6,7,0,0
1511,423,270,1116,1049,10,11,6,693,779,7,7,0,0
1511,708,284,908,924,11,11,6,200,640,0,45,0,1
1512,662,281,856,902,11,11,6,194,621,1,45,0,0
1513,607,257,786,828,11,11,6,179,571,2,45,0,0
1514,558,237,735,798,11,11,6,177,561,3,45,0,0
1515,532,230,701,764,11,11,6,169,534,4,45,0,0
1516,522,207,680,708,11,11,6,158,501,5,45,0,0
1517,505,199,656,678,11,11,6,151,479,6,45,0,0
1518,476,188,617,630,11,11,6,141,442,7,45,0,0
1519,462,175,601,608,11,11,6,139,433,8,45,0,0
1520,451,174,588,598,11,11,6,137,424,9,45,0,0
1521,447,170,569,547,11,11,6,122,377,10,45,0,0
1522,437,165,555,526,11,11,6,118,361,11,45,0,0
1523,418,156,534,509,11,11,6,116,353,12,45,0,0
1524,407,152,518,490,11,11,6,111,338,13,45,0,0
1525,403,152,513,484,11,11,6,110,332,14,45,0,0
1526,400,140,507,466,11,11,6,107,326,15,45,0,0
1527,397,141,496,441,11,11,6,99,300,16,45,0,0
1528,388,136,485,430,11,11,6,97,294,17,45,0,0
1529,381,132,475,415,11,11,6,94,283,18,45,0,0
1530,381,137,470,408,11,11,6,89,271,19,45,0,0
1531,377,131,464,391,11,11,6,87,260,20,45,0,0
1532,371,127,455,377,11,11,6,84,250,21,45,0,0
1533,360,125,444,376,11,11,6,84,251,22,45,0,0
1534,351,121,431,360,11,11,6,80,239,23,45,0,0
1535,346,120,426,360,11,11,6,80,240,24,45,0,0
1536,342,110,421,346,11,11,6,79,236,25,45,0,0
1537,339,110,415,337,11,11,6,76,227,26,45,0,0
1538,331,111,406,331,11,11,6,75,220,27,45,0,0
1539,328,111,400,319,11,11,6,72,208,28,45,0,0
1540,331,112,400,316,11,11,6,69,204,29,45,0,0
1541,333,110,400,305,11,11,6,67,195,30,45,0,0
1542,333,107,399,301,11,11,6,66,194,31,45,0,0
1543,330,107,395,297,11,11,6,65,190,32,45,0,0
1544,328,101,392,288,11,11,6,64,187,33,45,0,0
1545,333,105,394,283,11,11,6,61,178,34,45,0,0
1546,335,106,393,275,11,11,6,58,169,35,45,0,0
1547,335,106,392,271,11,11,6,57,165,36,45,0,0
1548,331,104,387,268,11,11,6,56,164,37,45,0,0
1549,326,98,384,263,11,11,6,58,165,38,45,0,0
1550,325,102,380,259,11,11,6,55,157,39,45,0,0
1551,324,100,377,253,11,11,6,53,153,40,45,0,0
1552,320,99,372,248,11,11,6,52,149,41,45,0,0
1553,311,99,363,245,11,11,6,52,146,42,45,0,0
1554,301,98,351,240,11,11,6,50,142,43,45,0,0
1555,291,98,341,239,11,11,6,50,141,44,45,0,0
1556,287,97,335,233,11,11,6,48,136,45,45,1,0
2979,751,185,822,391,12,11,6,71,206,0,35,0,1
2980,740,165,820,397,12,11,6,80,232,1,35,0,0
2981,727,164,806,394,12,11,6,79,230,2,35,0,0
2982,696,173,774,394,12,11,6,78,221,3,35,0,0
2983,662,158,742,384,12,11,6,80,226,4,35,0,0
2984,621,154,702,376,12,11,6,81,222,5,35,0,0
2985,584,153,666,371,12,11,6,82,218,6,35,0,0
2986,573,149,651,351,12,11,6,78,202,7,35,0,0
2987,548,149,628,354,12,11,6,80,205,8,35,0,0
2988,532,146,612,350,12,11,6,80,204,9,35,0,0
2989,513,142,592,341,12,11,6,79,199,10,35,0,0
2990,489,142,569,338,12,11,6,80,196,11,35,0,0
2991,472,139,551,329,12,11,6,79,190,12,35,0,0
2992,465,137,544,327,12,11,6,79,190,13,35,0,0
2993,454,135,532,321,12,11,6,78,186,14,35,0,0
2994,443,136,518,316,12,11,6,75,180,15,35,0,0
2995,430,134,502,307,12,11,6,72,173,16,35,0,0
2996,416,133,488,301,12,11,6,72,168,17,35,0,0
2997,406,129,479,296,12,11,6,73,167,18,35,0,0
2998,400,123,472,291,12,11,6,72,168,19,35,0,0
2999,391,122,464,290,12,11,6,73,168,20,35,0,0
3000,382,123,452,286,12,11,6,70,163,21,35,0,0
3001,375,124,441,279,12,11,6,66,155,22,35,0,0
3002,365,122,430,276,12,11,6,65,154,23,35,0,0
3003,359,119,422,271,12,11,6,63,152,24,35,0,0
3004,353,118,415,267,12,11,6,62,149,25,35,0,0
3005,342,117,405,266,12,11,6,63,149,26,35,0,0
3006,332,113,395,264,12,11,6,63,151,27,35,0,0
3007,321,112,384,261,12,11,6,63,149,28,35,0,0
3008,312,113,374,259,12,11,6,62,146,29,35,0,0
3009,304,112,366,255,12,11,6,62,143,30,35,0,0
3010,301,112,359,249,12,11,6,58,137,31,35,0,0
3011,295,116,351,245,12,11,6,56,129,32,35,0,0
3012,289,115,341,235,12,11,6,52,120,33,35,0,0
3013,282,114,334,236,12,11,6,52,122,34,35,0,0
3014,274,114,324,232,12,11,6,50,118,35,35,1,0
3001,1796,868,1920,1079,13,11,6,124,211,0,51,0,1
3002,1727,765,1907,1070,13,11,6,180,305,1,51,0,0
3003,1635,721,1844,1074,13,11,6,209,353,2,51,0,0
3004,1502,659,1752,1077,13,11,6,250,418,3,51,0,0
3005,1392,590,1679,1071,13,11,6,287,481,4,51,0,0
3006,1296,549,1606,1071,13,11,6,310,522,5,51,0,0
3007,1193,502,1528,1069,13,11,6,335,567,6,51,0,0
3008,1102,455,1462,1071,13,11,6,360,616,7,51,0,0
3009,1014,432,1382,1068,13,11,6,368,636,8,51,0,0
3010,955,400,1331,1065,13,11,6,376,665,9,51,0,0
3011,914,373,1281,1045,13,11,6,367,672,10,51,0,0
3012,868,357,1220,1019,13,11,6,352,662,11,51,0,0
3013,835,329,1164,967,13,11,6,329,638,12,51,0,0
3014,797,307,1108,923,13,11,6,311,616,13,51,0,0
3015,770,297,1060,890,13,11,6,290,593,14,51,0,0
3016,758,280,1017,828,13,11,6,259,548,15,51,0,0
3017,741,268,984,801,13,11,6,243,533,16,51,0,0
3018,723,258,957,787,13,11,6,234,529,17,51,0,0
3019,713,243,927,739,13,11,6,214,496,18,51,0,0
3020,704,236,902,708,13,11,6,198,472,19,51,0,0
3021,690,228,879,691,13,11,6,189,463,20,51,0,0
3022,682,217,859,660,13,11,6,177,443,21,51,0,0
3023,679,212,847,643,13,11,6,168,431,22,51,0,0
3024,679,208,837,621,13,11,6,158,413,23,51,0,0
3025,677,201,825,593,13,11,6,148,392,24,51,0,0
3026,675,196,817,583,13,11,6,142,387,25,51,0,0
3027,675,191,807,554,13,11,6,132,363,26,51,0,0
3028,675,191,799,539,13,11,6,124,348,27,51,0,0
3029,676,188,797,530,13,11,6,121,342,28,51,0,0
3030,683,182,797,505,13,11,6,114,323,29,51,0,0
3031,687,176,797,491,13,11,6,110,315,30,51,0,0
3032,691,177,799,488,13,11,6,108,311,31,51,0,0
3033,695,174,796,468,13,11,6,101,294,32,51,0,0
3034,700,172,799,459,13,11,6,99,287,33,51,0,0
3035,709,170,803,445,13,11,6,94,275,34,51,0,0
3036,713,164,806,436,13,11,6,93,272,35,51,0,0
3037,722,161,812,426,13,11,6,90,265,36,51,0,0
3038,727,162,815,425,13,11,6,88,263,37,51,0,0
3039,732,155,817,411,13,11,6,85,256,38,51,0,0
3040,734,152,817,408,13,11,6,83,256,39,51,0,0
3041,738,152,818,400,13,11,6,80,248,40,51,0,0
3042,741,148,819,389,13,11,6,78,241,41,51,0,0
3043,743,148,819,382,13,11,6,76,234,42,51,0,0
3044,742,146,819,382,13,11,6,77,236,43,51,0,0
3045,743,142,815,367,13,11,6,72,225,44,51,0,0
3046,743,146,811,357,13,11,6,68,211,45,51,0,0
3047,741,142,810,354,13,11,6,69,212,46,51,0,0
3048,739,140,806,345,13,11,6,67,205,47,51,0,0
3049,737,144,799,332,13,11,6,62,188,48,51,0,0
3050,729,143,793,335,13,11,6,64,192,49,51,0,0
3051,722,139,785,330,13,11,6,63,191,50,51,0,0
3052,720,137,782,322,13,11,6,62,185,51,51,1,0
3054,705,130,766,315,13,11,6,61,185,0,51,0,0
3055,699,128,759,307,13,11,6,60,179,1,51,0,0
3056,696,126,754,300,13,11,6,58,174,2,51,0,0
3102,260,139,300,335,14,11,6,40,196,0,50,0,1
3103,277,138,317,332,14,11,6,40,194,1,50,0,0
3104,289,141,330,335,14,11,6,41,194,2,50,0,0
3105,312,139,354,332,14,11,6,42,193,3,50,0,0
3106,329,142,373,339,14,11,6,44,197,4,50,0,0
3107,334,142,381,343,14,11,6,47,201,5,50,0,0
3108,342,145,390,346,14,11,6,48,201,6,50,0,0
3109,351,147,402,352,14,11,6,51,205,7,50,0,0
3110,367,148,420,354,14,11,6,53,206,8,50,0,0
3111,377,155,434,363,14,11,6,57,208,9,50,0,0
3112,377,154,437,371,14,11,6,60,217,10,50,0,0
3113,381,158,443,374,14,11,6,62,216,11,50,0,0
3114,391,160,455,382,14,11,6,64,222,12,50,0,0
3115,409,158,479,392,14,11,6,70,234,13,50,0,0
3116,417,160,493,402,14,11,6,76,242,14,50,0,0
3117,420,159,497,406,14,11,6,77,247,15,50,0,0
3118,424,166,503,417,14,11,6,79,251,16,50,0,0
3119,433,170,516,430,14,11,6,83,260,17,50,0,0
3120,452,172,540,438,14,11,6,88,266,18,50,0,0
3121,465,180,558,456,14,11,6,93,276,19,50,0,0
3122,468,183,563,462,14,11,6,95,279,20,50,0,0
3123,474,186,572,475,14,11,6,98,289,21,50,0,0
3124,490,188,591,481,14,11,6,101,293,22,50,0,0
3125,512,192,619,494,14,11,6,107,302,23,50,0,0
3126,527,202,642,522,14,11,6,115,320,24,50,0,0
3127,533,208,650,531,14,11,6,117,323,25,50,0,0
3128,545,216,662,543,14,11,6,117,327,26,50,0,0
3129,561,220,681,555,14,11,6,120,335,27,50,0,0
3130,577,224,702,572,14,11,6,125,348,28,50,0,0
3131,591,235,723,604,14,11,6,132,369,29,50,0,0
3132,612,241,744,612,14,11,6,132,371,30,50,0,0
3133,635,258,770,639,14,11,6,135,381,31,50,0,0
3134,655,258,796,656,14,11,6,141,398,32,50,0,0
3135,694,266,851,693,14,11,6,157,427,33,50,0,0
3136,722,283,889,728,14,11,6,167,445,34,50,0,0
3137,731,293,898,740,14,11,6,167,447,35,50,0,0
3138,746,312,918,777,14,11,6,172,465,36,50,0,0
3139,785,329,965,804,14,11,6,180,475,37,50,0,0
3140,824,345,1030,873,14,11,6,206,528,38,50,0,0
3141,856,367,1074,918,14,11,6,218,551,39,50,0,0
3142,882,391,1096,940,14,11,6,214,549,40,50,0,0
3143,914,426,1140,1010,14,11,6,226,584,41,50,0,0
3144,970,450,1202,1043,14,11,6,232,593,42,50,0,0
3145,1052,478,1294,1072,14,11,6,242,594,43,50,0,0
3146,1103,517,1341,1080,14,11,6,238,563,44,50,0,0
3147,1160,555,1389,1080,14,11,6,229,525,45,50,0,0
3148,1247,615,1462,1080,14,11,6,215,465,46,50,0,0
3149,1345,664,1550,1080,14,11,6,205,416,47,50,0,0
3150,1454,734,1638,1080,14,11,6,184,346,48,50,0,0
3151,1595,826,1744,1076,14,11,6,149,250,49,50,0,0
3152,1671,869,1801,1080,14,11,6,130,211,50,50,1,0
3106,259,175,294,344,15,11,6,35,169,0,45,0,1
3107,259,153,298,344,15,11,6,39,191,1,45,0,0
3108,264,148,304,337,15,11,6,40,189,2,45,0,0
3109,274,150,314,339,15,11,6,40,189,3,45,0,0
3110,282,149,324,342,15,11,6,42,193,4,45,0,0
3111,290,150,334,344,15,11,6,44,194,5,45,0,0
3112,293,156,340,359,15,11,6,47,203,6,45,0,0
3113,294,156,343,366,15,11,6,49,210,7,45,0,0
3114,295,157,346,372,15,11,6,51,215,8,45,0,0
3115,297,161,351,378,15,11,6,54,217,9,45,0,0
3116,299,163,355,382,15,11,6,56,219,10,45,0,0
3117,296,168,355,393,15,11,6,59,225,11,45,0,0
3118,292,173,356,409,15,11,6,64,236,12,45,0,0
3119,292,172,359,411,15,11,6,67,239,13,45,0,0
3120,299,178,367,418,15,11,6,68,240,14,45,0,0
3121,305,182,376,426,15,11,6,71,244,15,45,0,0
3122,303,183,379,437,15,11,6,76,254,16,45,0,0
3123,304,193,384,456,15,11,6,80,263,17,45,0,0
3124,312,196,396,461,15,11,6,84,265,18,45,0,0
3125,323,199,412,476,15,11,6,89,277,19,45,0,0
3126,335,206,425,485,15,11,6,90,279,20,45,0,0
3127,346,209,442,499,15,11,6,96,290,21,45,0,0
3128,346,221,448,529,15,11,6,102,308,22,45,0,0
3129,352,229,463,568,15,11,6,111,339,23,45,0,0
3130,371,235,481,568,15,11,6,110,333,24,45,0,0
3131,385,245,499,587,15,11,6,114,342,25,45,0,0
3132,400,247,517,593,15,11,6,117,346,26,45,0,0
3133,411,262,535,624,15,11,6,124,362,27,45,0,0
3134,415,279,547,662,15,11,6,132,383,28,45,0,0
3135,431,284,564,669,15,11,6,133,385,29,45,0,0
3136,445,299,587,707,15,11,6,142,408,30,45,0,0
3137,465,313,613,734,15,11,6,148,421,31,45,0,0
3138,480,325,630,746,15,11,6,150,421,32,45,0,0
3139,486,350,655,820,15,11,6,169,470,33,45,0,0
3140,507,361,681,843,15,11,6,174,482,34,45,0,0
3141,528,373,717,891,15,11,6,189,518,35,45,0,0
3142,550,405,745,936,15,11,6,195,531,36,45,0,0
3143,565,430,763,957,15,11,6,198,527,37,45,0,0
3144,572,473,789,1036,15,11,6,217,563,38,45,0,0
3145,592,524,810,1071,15,11,6,218,547,39,45,0,0
3146,605,559,823,1080,15,11,6,218,521,40,45,0,0
3147,623,633,823,1080,15,11,6,200,447,41,45,0,0
3148,656,700,842,1080,15,11,6,186,380,42,45,0,0
3149,685,779,853,1080,15,11,6,168,301,43,45,0,0
3150,723,921,841,1080,15,11,6,118,159,44,45,0,0
3151,754,976,843,1080,15,11,6,89,104,45,45,1,0
3462,242,210,293,532,17,11,6,51,322,0,30,0,1
3463,247,193,303,547,17,11,6,56,354,1,30,0,0
3464,260,192,319,554,17,11,6,59,362,2,30,0,0
3465,284,201,344,559,17,11,6,60,358,3,30,0,0
3466,312,211,377,580,17,11,6,65,369,4,30,0,0
3467,333,208,401,586,17,11,6,68,378,5,30,0,0
3468,344,214,420,605,17,11,6,76,391,6,30,0,0
3469,367,223,449,627,17,11,6,82,404,7,30,0,0
3470,403,223,490,638,17,11,6,87,415,8,30,0,0
3471,445,231,543,669,17,11,6,98,438,9,30,0,0
3472,465,240,568,685,17,11,6,103,445,10,30,0,0
3473,483,241,592,694,17,11,6,109,453,11,30,0,0
3474,494,253,615,731,17,11,6,121,478,12,30,0,0
3475,532,261,659,755,17,11,6,127,494,13,30,0,0
3476,576,266,707,770,17,11,6,131,504,14,30,0,0
3477,615,281,759,814,17,11,6,144,533,15,30,0,0
3478,656,292,804,828,17,11,6,148,536,16,30,0,0
3479,674,299,842,885,17,11,6,168,586,17,30,0,0
3480,702,327,882,931,17,11,6,180,604,18,30,0,0
3481,774,347,954,949,17,11,6,180,602,19,30,0,0
3482,832,366,1024,992,17,11,6,192,626,20,30,0,0
3483,873,393,1084,1051,17,11,6,211,658,21,30,0,0
3484,945,415,1161,1071,17,11,6,216,656,22,30,0,0
3485,1007,451,1229,1080,17,11,6,222,629,23,30,0,0
3486,1084,494,1305,1080,17,11,6,221,586,24,30,0,0
3487,1201,523,1416,1080,17,11,6,215,557,25,30,0,0
3488,1323,568,1539,1080,17,11,6,216,512,26,30,0,0
3489,1442,607,1645,1071,17,11,6,203,464,27,30,0,0
3490,1550,653,1751,1079,17,11,6,201,426,28,30,0,0
3491,1656,714,1844,1079,17,11,6,188,365,29,30,0,0
3492,1739,746,1916,1080,17,11,6,177,334,30,30,1,0
4291,1766,787,1919,1065,18,11,6,153,278,0,31,0,1
4292,1681,748,1861,1071,18,11,6,180,323,1,31,0,0
4293,1573,699,1786,1078,18,11,6,213,379,2,31,0,0
4294,1447,656,1685,1075,18,11,6,238,419,3,31,0,0
4295,1306,619,1568,1074,18,11,6,262,455,4,31,0,0
4296,1190,565,1480,1070,18,11,6,290,505,5,31,0,0
4297,1072,522,1389,1070,18,11,6,317,548,6,31,0,0
4298,978,488,1311,1070,18,11,6,333,582,7,31,0,0
4299,891,444,1244,1074,18,11,6,353,630,8,31,0,0
4300,798,417,1161,1073,18,11,6,363,656,9,31,0,0
4301,741,391,1096,1046,18,11,6,355,655,10,31,0,0
4302,713,361,1050,1000,18,11,6,337,639,11,31,0,0
4303,686,342,1014,979,18,11,6,328,637,12,31,0,0
4304,653,326,952,925,18,11,6,299,599,13,31,0,0
4305,613,303,886,869,18,11,6,273,566,14,31,0,0
4306,569,297,826,837,18,11,6,257,540,15,31,0,0
4307,544,274,783,789,18,11,6,239,515,16,31,0,0
4308,520,260,750,767,18,11,6,230,507,17,31,0,0
4309,497,253,720,754,18,11,6,223,501,18,31,0,0
4310,468,243,670,715,18,11,6,202,472,19,31,0,0
4311,444,238,629,680,18,11,6,185,442,20,31,0,0
4312,426,234,605,669,18,11,6,179,435,21,31,0,0
4313,400,219,567,637,18,11,6,167,418,22,31,0,0
4314,383,215,545,626,18,11,6,162,411,23,31,0,0
4315,359,214,516,619,18,11,6,157,405,24,31,0,0
4316,329,208,471,588,18,11,6,142,380,25,31,0,0
4317,299,209,435,571,18,11,6,136,362,26,31,0,0
4318,278,208,412,559,18,11,6,134,351,27,31,0,0
4319,244,198,373,548,18,11,6,129,350,28,31,0,0
4320,223,192,351,545,18,11,6,128,353,29,31,0,0
4321,214,245,316,536,18,11,6,102,291,30,31,0,0
4322,185,244,281,521,18,11,6,96,277,31,31,1,0
4601,1832,827,1920,1075,19,11,6,88,248,0,0,0,0
4602,1656,767,1908,1072,20,11,6,252,305,0,147,0,1
4603,1528,669,1856,1066,20,11,6,328,397,1,147,0,0
4604,1404,612,1780,1066,20,11,6,376,454,2,147,0,0
4605,1269,559,1687,1068,20,11,6,418,509,3,147,0,0
4606,1103,494,1571,1068,20,11,6,468,574,4,147,0,0
4607,984,453,1474,1065,20,11,6,490,612,5,147,0,0
4608,900,415,1411,1071,20,11,6,511,656,6,147,0,0
4609,835,370,1352,1055,20,11,6,517,685,7,147,0,0
4610,779,348,1296,1055,20,11,6,517,707,8,147,0,0
4611,728,325,1221,1026,20,11,6,493,701,9,147,0,0
4612,695,295,1139,946,20,11,6,444,651,10,147,0,0
4613,658,283,1072,915,20,11,6,414,632,11,147,0,0
4614,634,263,1016,867,20,11,6,382,604,12,147,0,0
4615,621,242,967,808,20,11,6,346,566,13,147,0,0
4616,601,231,936,792,20,11,6,335,561,14,147,0,0
4617,583,221,881,738,20,11,6,298,517,15,147,0,0
4618,570,209,842,697,20,11,6,272,488,16,147,0,0
4619,551,210,807,684,20,11,6,256,474,17,147,0,0
4620,540,197,775,645,20,11,6,235,448,18,147,0,0
4621,527,187,750,622,20,11,6,223,435,19,147,0,0
4622,519,186,732,615,20,11,6,213,429,20,147,0,0
4623,510,178,703,577,20,11,6,193,399,21,147,0,0
4624,507,172,686,553,20,11,6,179,381,22,147,0,0
4625,498,173,672,556,20,11,6,174,383,23,147,0,0
4626,493,163,654,526,20,11,6,161,363,24,147,0,0
4627,490,160,644,510,20,11,6,154,350,25,147,0,0
4628,484,161,630,500,20,11,6,146,339,26,147,0,0
4629,475,157,614,484,20,11,6,139,327,27,147,0,0
4630,464,151,596,466,20,11,6,132,315,28,147,0,0
4631,458,153,585,462,20,11,6,127,309,29,147,0,0
4632,449,145,571,447,20,11,6,122,302,30,147,0,0
4633,438,139,559,443,20,11,6,121,304,31,147,0,0
4634,431,142,548,436,20,11,6,117,294,32,147,0,0
4635,415,139,526,420,20,11,6,111,281,33,147,0,0
4636,403,136,513,418,20,11,6,110,282,34,147,0,0
4637,394,139,499,412,20,11,6,105,273,35,147,0,0
4638,383,133,485,403,20,11,6,102,270,36,147,0,0
4639,377,130,474,391,20,11,6,97,261,37,147,0,0
4640,371,133,465,386,20,11,6,94,253,38,147,0,0
4641,358,130,450,383,20,11,6,92,253,39,147,0,0
4642,351,125,438,366,20,11,6,87,241,40,147,0,0
4643,345,127,428,361,20,11,6,83,234,41,147,0,0
4644,334,120,418,356,20,11,6,84,236,42,147,0,0
4645,326,114,410,350,20,11,6,84,236,43,147,0,0
4646,325,118,405,345,20,11,6,80,227,44,147,0,0
4647,318,117,397,341,20,11,6,79,224,45,147,0,0
4648,313,117,388,332,20,11,6,75,215,46,147,0,0
4649,304,116,379,334,20,11,6,75,218,47,147,0,0
4650,299,114,371,325,20,11,6,72,211,48,147,0,0
4651,295,111,362,314,20,11,6,67,203,49,147,0,0
4652,292,113,355,313,20,11,6,63,200,50,147,0,0
4653,289,114,349,311,20,11,6,60,197,51,147,0,0
4654,289,113,347,301,20,11,6,58,188,52,147,0,0
4655,291,113,350,304,20,11,6,59,191,53,147,0,0
4656,294,113,354,302,20,11,6,60,189,54,147,0,0
4657,298,112,361,303,20,11,6,63,191,55,147,0,0
4658,299,111,363,299,20,11,6,64,188,56,147,0,0
4659,299,112,365,295,20,11,6,66,183,57,147,0,0
4660,298,111,367,296,20,11,6,69,185,58,147,0,0
4661,296,110,366,297,20,11,6,70,187,59,147,0,0
4662,293,109,365,298,20,11,6,72,189,60,147,0,0
4663,293,108,366,298,20,11,6,73,190,61,147,0,0
4664,289,109,363,302,20,11,6,74,193,62,147,0,0
4665,289,108,373,322,20,11,6,84,214,63,147,0,0
4666,289,113,377,339,20,11,6,88,226,64,147,0,0
4667,286,109,376,344,20,11,6,90,235,65,147,0,0
4668,283,120,369,345,20,11,6,86,225,66,147,0,0
4669,276,121,361,345,20,11,6,85,224,67,147,0,0
4670,273,127,357,350,20,11,6,84,223,68,147,0,0
4671,270,138,347,347,20,11,6,77,209,69,147,0,0
4672,263,144,337,348,20,11,6,74,204,70,147,0,0
4673,260,143,334,348,20,11,6,74,205,71,147,0,0
4674,259,144,332,350,20,11,6,73,206,72,147,0,0
4675,258,145,330,349,20,11,6,72,204,73,147,0,0
4676,258,147,330,351,20,11,6,72,204,74,147,0,0
4677,258,149,330,355,20,11,6,72,206,75,147,0,0
4678,260,149,330,354,20,11,6,70,205,76,147,0,0
4679,262,147,332,352,20,11,6,70,205,77,147,0,0
4680,265,147,333,349,20,11,6,68,202,78,147,0,0
4681,266,148,334,348,20,11,6,68,200,79,147,0,0
4682,268,149,334,346,20,11,6,66,197,80,147,0,0
4683,268,150,333,344,20,11,6,65,194,81,147,0,0
4684,267,152,332,343,20,11,6,65,191,82,147,0,0
4685,267,153,331,341,20,11,6,64,188,83,147,0,0
4686,268,152,332,341,20,11,6,64,189,84,147,0,0
4687,269,151,332,340,20,11,6,63,189,85,147,0,0
4688,268,153,331,340,20,11,6,63,187,86,147,0,0
4689,268,152,331,340,20,11,6,63,188,87,147,0,0
4690,268,151,332,341,20,11,6,64,190,88,147,0,0
4691,268,149,332,342,20,11,6,64,193,89,147,0,0
4692,267,149,332,342,20,11,6,65,193,90,147,0,0
4693,267,149,332,343,20,11,6,65,194,91,147,0,0
4694,268,147,334,343,20,11,6,66,196,92,147,0,0
4695,267,148,333,343,20,11,6,66,195,93,147,0,0
4696,267,148,333,341,20,11,6,66,193,94,147,0,0
4697,268,148,334,341,20,11,6,66,193,95,147,0,0
4698,268,147,335,342,20,11,6,67,195,96,147,0,0
4699,269,147,336,342,20,11,6,67,195,97,147,0,0
4700,268,147,335,342,20,11,6,67,195,98,147,0,0
4701,268,147,336,342,20,11,6,68,195,99,147,0,0
4702,269,147,336,340,20,11,6,67,193,100,147,0,0
4703,270,147,337,339,20,11,6,67,192,101,147,0,0
4704,270,148,337,338,20,11,6,67,190,102,147,0,0
4705,270,148,337,338,20,11,6,67,190,103,147,0,0
4706,270,150,337,339,20,11,6,67,189,104,147,0,0
4707,270,150,337,339,20,11,6,67,189,105,147,0,0
4708,270,150,337,339,20,11,6,67,189,106,147,0,0
4709,270,150,338,339,20,11,6,68,189,107,147,0,0
4710,268,149,337,340,20,11,6,69,191,108,147,0,0
4711,268,147,337,340,20,11,6,69,193,109,147,0,0
4712,268,147,337,341,20,11,6,69,194,110,147,0,0
4713,268,147,338,341,20,11,6,70,194,111,147,0,0
4714,268,147,338,341,20,11,6,70,194,112,147,0,0
4715,268,147,338,341,20,11,6,70,194,113,147,0,0
4716,268,147,338,341,20,11,6,70,194,114,147,0,0
4717,268,147,338,341,20,11,6,70,194,115,147,0,0
4718,269,147,339,341,20,11,6,70,194,116,147,0,0
4719,269,147,338,341,20,11,6,69,194,117,147,0,0
4720,269,147,338,341,20,11,6,69,194,118,147,0,0
4721,268,148,337,340,20,11,6,69,192,119,147,0,0
4722,268,148,337,340,20,11,6,69,192,120,147,0,0
4723,267,148,337,341,20,11,6,70,193,121,147,0,0
4724,267,148,337,341,20,11,6,70,193,122,147,0,0
4725,267,147,336,341,20,11,6,69,194,123,147,0,0
4726,266,147,337,343,20,11,6,71,196,124,147,0,0
4727,268,147,338,342,20,11,6,70,195,125,147,0,0
4728,268,147,338,342,20,11,6,70,195,126,147,0,0
4729,269,147,339,342,20,11,6,70,195,127,147,0,0
4730,269,146,339,342,20,11,6,70,196,128,147,0,0
4731,269,148,338,341,20,11,6,69,193,129,147,0,0
4732,269,148,337,341,20,11,6,68,193,130,147,0,0
4733,270,148,338,341,20,11,6,68,193,131,147,0,0
4734,270,148,338,340,20,11,6,68,192,132,147,0,0
4735,270,150,337,340,20,11,6,67,190,133,147,0,0
4736,269,151,336,341,20,11,6,67,190,134,147,0,0
4737,272,146,340,343,20,11,6,68,197,135,147,0,0
4738,271,146,340,343,20,11,6,69,197,136,147,0,0
4739,274,143,343,341,20,11,6,69,198,137,147,0,0
4740,273,141,343,344,20,11,6,70,203,138,147,0,0
4741,273,137,344,344,20,11,6,71,207,139,147,0,0
4742,275,143,341,338,20,11,6,66,195,140,147,0,0
4743,266,135,335,342,20,11,6,69,207,141,147,0,0
4744,257,127,329,350,20,11,6,72,223,142,147,0,0
4745,251,118,321,343,20,11,6,70,225,143,147,0,0
4746,249,124,314,342,20,11,6,65,218,144,147,0,0
4747,248,134,308,342,20,11,6,60,208,145,147,0,0
4748,251,154,304,341,20,11,6,53,187,146,147,0,0
4749,249,156,302,340,20,11,6,53,184,147,147,1,0
4622,1181,757,1467,1070,23,11,6,286,313,0,0,0,0
4623,980,678,1343,1071,24,11,6,363,393,0,69,0,1
4624,890,625,1301,1071,24,11,6,411,446,1,69,0,0
4625,795,577,1245,1071,24,11,6,450,494,2,69,0,0
4626,704,524,1196,1072,24,11,6,492,548,3,69,0,0
4627,620,469,1149,1073,24,11,6,529,604,4,69,0,0
4628,559,415,1100,1052,24,11,6,541,637,5,69,0,0
4629,518,398,1048,1043,24,11,6,530,645,6,69,0,0
4630,501,368,988,983,24,11,6,487,615,7,69,0,0
4631,491,324,940,914,24,11,6,449,590,8,69,0,0
4632,483,311,892,872,24,11,6,409,561,9,69,0,0
4633,475,295,837,810,24,11,6,362,515,10,69,0,0
4634,463,284,795,775,24,11,6,332,491,11,69,0,0
4635,457,280,768,759,24,11,6,311,479,12,69,0,0
4636,455,263,732,706,24,11,6,277,443,13,69,0,0
4637,455,253,712,681,24,11,6,257,428,14,69,0,0
4638,450,246,688,658,24,11,6,238,412,15,69,0,0
4639,440,231,658,622,24,11,6,218,391,16,69,0,0
4640,434,229,640,610,24,11,6,206,381,17,69,0,0
4641,431,223,623,589,24,11,6,192,366,18,69,0,0
4642,436,211,611,555,24,11,6,175,344,19,69,0,0
4643,438,204,605,543,24,11,6,167,339,20,69,0,0
4644,431,195,591,528,24,11,6,160,333,21,69,0,0
4645,426,187,574,500,24,11,6,148,313,22,69,0,0
4646,425,186,567,498,24,11,6,142,312,23,69,0,0
4647,423,181,561,494,24,11,6,138,313,24,69,0,0
4648,427,176,554,469,24,11,6,127,293,25,69,0,0
4649,427,177,550,468,24,11,6,123,291,26,69,0,0
4650,421,174,537,451,24,11,6,116,277,27,69,0,0
4651,421,171,531,438,24,11,6,110,267,28,69,0,0
4652,422,171,528,437,24,11,6,106,266,29,69,0,0
4653,423,164,520,412,24,11,6,97,248,30,69,0,0
4654,421,159,518,410,24,11,6,97,251,31,69,0,0
4655,418,158,515,411,24,11,6,97,253,32,69,0,0
4656,412,155,503,393,24,11,6,91,238,33,69,0,0
4657,406,153,495,390,24,11,6,89,237,34,69,0,0
4658,401,153,487,387,24,11,6,86,234,35,69,0,0
4659,398,150,479,372,24,11,6,81,222,36,69,0,0
4660,391,146,470,364,24,11,6,79,218,37,69,0,0
4661,380,148,458,361,24,11,6,78,213,38,69,0,0
4662,366,145,442,353,24,11,6,76,208,39,69,0,0
4663,355,145,428,346,24,11,6,73,201,40,69,0,0
4664,340,142,413,345,24,11,6,73,203,41,69,0,0
4665,332,139,403,337,24,11,6,71,198,42,69,0,0
4669,313,111,377,297,24,11,6,64,186,0,69,0,1
4670,312,111,372,289,24,11,6,60,178,1,69,0,0
4671,312,110,371,294,24,11,6,59,184,2,69,0,0
4672,311,109,370,298,24,11,6,59,189,3,69,0,0
4673,311,108,370,299,24,11,6,59,191,4,69,0,0
4674,312,112,369,299,24,11,6,57,187,5,69,0,0
4675,312,112,369,301,24,11,6,57,189,6,69,0,0
4676,313,114,369,300,24,11,6,56,186,7,69,0,0
4677,313,114,369,299,24,11,6,56,185,8,69,0,0
4678,314,115,369,301,24,11,6,55,186,9,69,0,0
4679,314,113,369,302,24,11,6,55,189,10,69,0,0
4680,314,111,369,302,24,11,6,55,191,11,69,0,0
4681,313,112,367,305,24,11,6,54,193,12,69,0,0
4682,313,114,366,304,24,11,6,53,190,13,69,0,0
4683,314,113,367,304,24,11,6,53,191,14,69,0,0
4684,316,111,368,304,24,11,6,52,193,15,69,0,0
4685,318,112,370,306,24,11,6,52,194,16,69,0,0
4686,319,112,371,305,24,11,6,52,193,17,69,0,0
4687,319,114,370,303,24,11,6,51,189,18,69,0,0
4688,319,114,371,304,24,11,6,52,190,19,69,0,0
4689,319,114,370,304,24,11,6,51,190,20,69,0,0
4690,318,115,369,302,24,11,6,51,187,21,69,0,0
4691,316,115,367,304,24,11,6,51,189,22,69,0,0
4692,315,115,366,305,24,11,6,51,190,23,69,0,0
4693,315,115,366,306,24,11,6,51,191,24,69,0,0
4694,315,113,367,313,24,11,6,52,200,25,69,0,0
4695,315,115,368,313,24,11,6,53,198,26,69,0,0
4696,314,116,369,323,24,11,6,55,207,27,69,0,0
4697,318,116,374,326,24,11,6,56,210,28,69,0,0
4698,320,117,375,321,24,11,6,55,204,29,69,0,0
4699,321,117,376,319,24,11,6,55,202,30,69,0,0
4700,321,116,376,318,24,11,6,55,202,31,69,0,0
4701,318,115,372,314,24,11,6,54,199,32,69,0,0
4702,317,115,370,309,24,11,6,53,194,33,69,0,0
4703,318,115,370,307,24,11,6,52,192,34,69,0,0
4704,317,115,368,304,24,11,6,51,189,35,69,0,0
4705,317,115,368,303,24,11,6,51,188,36,69,0,0
4706,317,115,368,303,24,11,6,51,188,37,69,0,0
4707,318,115,368,301,24,11,6,50,186,38,69,0,0
4708,319,115,369,301,24,11,6,50,186,39,69,0,0
4709,318,115,368,301,24,11,6,50,186,40,69,0,0
4710,318,114,368,300,24,11,6,50,186,41,69,0,0
4711,318,114,368,302,24,11,6,50,188,42,69,0,0
4712,318,113,368,301,24,11,6,50,188,43,69,0,0
4713,317,113,367,302,24,11,6,50,189,44,69,0,0
4714,318,113,367,302,24,11,6,49,189,45,69,0,0
4715,318,113,367,302,24,11,6,49,189,46,69,0,0
4716,318,113,367,302,24,11,6,49,189,47,69,0,0
4717,318,114,367,303,24,11,6,49,189,48,69,0,0
4718,318,115,367,303,24,11,6,49,188,49,69,0,0
4719,319,115,367,302,24,11,6,48,187,50,69,0,0
4720,318,114,367,301,24,11,6,49,187,51,69,0,0
4721,319,114,367,301,24,11,6,48,187,52,69,0,0
4722,319,113,367,301,24,11,6,48,188,53,69,0,0
4723,319,113,368,301,24,11,6,49,188,54,69,0,0
4724,318,112,367,302,24,11,6,49,190,55,69,0,0
4725,318,112,367,303,24,11,6,49,191,56,69,0,0
4726,318,112,366,301,24,11,6,48,189,57,69,0,0
4727,319,112,366,300,24,11,6,47,188,58,69,0,0
4728,318,112,366,299,24,11,6,48,187,59,69,0,0
4729,318,112,365,300,24,11,6,47,188,60,69,0,0
4730,318,112,366,302,24,11,6,48,190,61,69,0,0
4731,319,112,367,302,24,11,6,48,190,62,69,0,0
4732,318,111,366,301,24,11,6,48,190,63,69,0,0
4733,319,112,367,301,24,11,6,48,189,64,69,0,0
4734,319,112,367,301,24,11,6,48,189,65,69,0,0
4735,318,113,365,300,24,11,6,47,187,66,69,0,0
4736,316,113,363,301,24,11,6,47,188,67,69,0,0
4737,313,118,360,301,24,11,6,47,183,68,69,0,0
4738,310,116,357,299,24,11,6,47,183,69,69,1,0
4635,1391,826,1595,1068,27,11,6,204,242,0,0,0,0
4636,1200,764,1486,1069,28,11,6,286,305,0,51,0,1
4637,1055,696,1400,1064,28,11,6,345,368,1,51,0,0
4638,959,624,1371,1067,28,11,6,412,443,2,51,0,0
4639,860,578,1310,1069,28,11,6,450,491,3,51,0,0
4640,766,524,1257,1072,28,11,6,491,548,4,51,0,0
4641,659,476,1183,1074,28,11,6,524,598,5,51,0,0
4642,589,450,1121,1073,28,11,6,532,623,6,51,0,0
4643,576,410,1078,1021,28,11,6,502,611,7,51,0,0
4644,559,378,1036,979,28,11,6,477,601,8,51,0,0
4645,542,366,986,952,28,11,6,444,586,9,51,0,0
4646,526,339,924,884,28,11,6,398,545,10,51,0,0
4647,487,321,863,853,28,11,6,376,532,11,51,0,0
4648,477,314,829,827,28,11,6,352,513,12,51,0,0
4649,490,290,807,773,28,11,6,317,483,13,51,0,0
4650,491,278,787,749,28,11,6,296,471,14,51,0,0
4651,488,270,759,720,28,11,6,271,450,15,51,0,0
4652,468,256,717,683,28,11,6,249,427,16,51,0,0
4653,452,252,689,668,28,11,6,237,416,17,51,0,0
4654,451,243,676,651,28,11,6,225,408,18,51,0,0
4655,468,231,671,615,28,11,6,203,384,19,51,0,0
4656,474,229,661,596,28,11,6,187,367,20,51,0,0
4657,468,223,639,571,28,11,6,171,348,21,51,0,0
4658,453,212,614,548,28,11,6,161,336,22,51,0,0
4659,446,210,600,539,28,11,6,154,329,23,51,0,0
4660,449,205,593,521,28,11,6,144,316,24,51,0,0
4661,453,200,591,513,28,11,6,138,313,25,51,0,0
4662,453,199,581,499,28,11,6,128,300,26,51,0,0
4663,445,190,569,486,28,11,6,124,296,27,51,0,0
4664,438,183,562,479,28,11,6,124,296,28,51,0,0
4665,435,182,556,478,28,11,6,121,296,29,51,0,0
4666,439,178,552,461,28,11,6,113,283,30,51,0,0
4667,443,173,551,449,28,11,6,108,276,31,51,0,0
4668,444,174,545,445,28,11,6,101,271,32,51,0,0
4669,433,169,536,451,28,11,6,103,282,33,51,0,0
4670,427,167,518,417,28,11,6,91,250,34,51,0,0
4671,437,168,496,320,28,11,6,59,152,35,51,0,0
4672,437,166,501,334,28,11,6,64,168,36,51,0,0
4673,434,162,493,317,28,11,6,59,155,37,51,0,0
4678,462,154,504,264,28,11,6,42,110,0,51,0,0
4683,427,145,476,264,28,11,6,49,119,0,51,0,0
4684,412,146,479,318,28,11,6,67,172,1,51,0,0
4685,409,145,475,326,28,11,6,66,181,2,51,0,0
4686,403,143,472,331,28,11,6,69,188,3,51,0,0
4704,345,126,415,325,28,11,6,70,199,0,51,0,1
4705,351,128,413,310,28,11,6,62,182,1,51,0,0
4706,355,127,415,307,28,11,6,60,180,2,51,0,0
4707,357,125,416,305,28,11,6,59,180,3,51,0,0
4708,357,125,415,305,28,11,6,58,180,4,51,0,0
4709,356,124,413,305,28,11,6,57,181,5,51,0,0
4710,355,125,412,305,28,11,6,57,180,6,51,0,0
4711,355,121,414,307,28,11,6,59,186,7,51,0,0
4712,354,123,413,308,28,11,6,59,185,8,51,0,0
4713,353,122,412,308,28,11,6,59,186,9,51,0,0
4714,352,120,411,308,28,11,6,59,188,10,51,0,0
4715,350,117,410,311,28,11,6,60,194,11,51,0,0
4716,352,119,411,309,28,11,6,59,190,12,51,0,0
4717,353,118,411,308,28,11,6,58,190,13,51,0,0
4718,353,119,411,308,28,11,6,58,189,14,51,0,0
4719,355,120,412,308,28,11,6,57,188,15,51,0,0
4720,357,122,411,308,28,11,6,54,186,16,51,0,0
4721,357,124,411,308,28,11,6,54,184,17,51,0,0
4722,358,125,411,310,28,11,6,53,185,18,51,0,0
4723,358,126,411,308,28,11,6,53,182,19,51,0,0
4724,358,126,410,307,28,11,6,52,181,20,51,0,0
4725,358,129,409,306,28,11,6,51,177,21,51,0,0
4726,359,130,409,306,28,11,6,50,176,22,51,0,0
4727,359,131,409,308,28,11,6,50,177,23,51,0,0
4728,358,130,409,308,28,11,6,51,178,24,51,0,0
4729,358,129,409,308,28,11,6,51,179,25,51,0,0
4730,358,129,409,309,28,11,6,51,180,26,51,0,0
4731,358,129,409,309,28,11,6,51,180,27,51,0,0
4732,358,130,409,309,28,11,6,51,179,28,51,0,0
4733,358,130,409,309,28,11,6,51,179,29,51,0,0
4734,359,131,409,309,28,11,6,50,178,30,51,0,0
4735,358,131,409,309,28,11,6,51,178,31,51,0,0
4736,359,130,410,309,28,11,6,51,179,32,51,0,0
4737,359,129,411,312,28,11,6,52,183,33,51,0,0
4738,359,128,410,311,28,11,6,51,183,34,51,0,0
4739,358,128,409,310,28,11,6,51,182,35,51,0,0
4740,359,128,409,310,28,11,6,50,182,36,51,0,0
4741,358,129,409,312,28,11,6,51,183,37,51,0,0
4742,359,129,409,310,28,11,6,50,181,38,51,0,0
4743,357,129,408,312,28,11,6,51,183,39,51,0,0
4744,355,129,404,306,28,11,6,49,177,40,51,0,0
4745,348,131,398,306,28,11,6,50,175,41,51,0,0
4746,339,133,392,313,28,11,6,53,180,42,51,0,0
4747,334,135,387,313,28,11,6,53,178,43,51,0,0
4748,326,137,379,317,28,11,6,53,180,44,51,0,0
4749,317,138,368,312,28,11,6,51,174,45,51,0,0
4750,301,137,353,311,28,11,6,52,174,46,51,0,0
4751,289,139,341,310,28,11,6,52,171,47,51,0,0
4752,276,138,328,310,28,11,6,52,172,48,51,0,0
4753,264,138,317,316,28,11,6,53,178,49,51,0,0
4754,253,139,307,324,28,11,6,54,185,50,51,0,0
4755,245,140,299,326,28,11,6,54,186,51,51,1,0
4655,721,424,974,1073,31,11,6,253,649,0,101,0,1
4656,694,388,939,1016,31,11,6,245,628,1,101,0,0
4657,663,363,900,972,31,11,6,237,609,2,101,0,0
4658,622,345,853,942,31,11,6,231,597,3,101,0,0
4659,596,319,810,874,31,11,6,214,555,4,101,0,0
4660,568,294,776,834,31,11,6,208,540,5,101,0,0
4661,548,289,750,817,31,11,6,202,528,6,101,0,0
4662,542,267,722,741,31,11,6,180,474,7,101,0,0
4663,530,256,701,707,31,11,6,171,451,8,101,0,0
4664,514,258,673,677,31,11,6,159,419,9,101,0,0
4665,507,241,656,637,31,11,6,149,396,10,101,0,0
4666,493,227,644,633,31,11,6,151,406,11,101,0,0
4667,484,224,627,612,31,11,6,143,388,12,101,0,0
4668,484,208,615,565,31,11,6,131,357,13,101,0,0
4669,480,201,607,551,31,11,6,127,350,14,101,0,0
4670,467,199,586,527,31,11,6,119,328,15,101,0,0
4671,445,183,567,517,31,11,6,122,334,16,101,0,0
4672,438,176,558,510,31,11,6,120,334,17,101,0,0
4673,435,176,553,509,31,11,6,118,333,18,101,0,0
4674,433,167,546,489,31,11,6,113,322,19,101,0,0
4675,428,160,537,470,31,11,6,109,310,20,101,0,0
4676,420,154,526,461,31,11,6,106,307,21,101,0,0
4677,413,152,514,444,31,11,6,101,292,22,101,0,0
4678,406,159,502,439,31,11,6,96,280,23,101,0,0
4679,400,161,493,436,31,11,6,93,275,24,101,0,0
4680,399,154,487,420,31,11,6,88,266,25,101,0,0
4681,396,150,482,408,31,11,6,86,258,26,101,0,0
4682,388,151,473,406,31,11,6,85,255,27,101,0,0
4683,380,152,461,395,31,11,6,81,243,28,101,0,0
4684,375,150,451,378,31,11,6,76,228,29,101,0,0
4685,370,149,445,374,31,11,6,75,225,30,101,0,0
4686,366,145,445,381,31,11,6,79,236,31,101,0,0
4687,364,142,443,377,31,11,6,79,235,32,101,0,0
4688,362,139,439,368,31,11,6,77,229,33,101,0,0
4689,357,137,434,368,31,11,6,77,231,34,101,0,0
4690,353,136,427,358,31,11,6,74,222,35,101,0,0
4691,350,136,421,352,31,11,6,71,216,36,101,0,0
4692,349,136,417,345,31,11,6,68,209,37,101,0,0
4693,349,136,417,346,31,11,6,68,210,38,101,0,0
4694,348,136,417,350,31,11,6,69,214,39,101,0,0
4695,351,136,420,351,31,11,6,69,215,40,101,0,0
4696,354,137,421,342,31,11,6,67,205,41,101,0,0
4697,361,138,425,337,31,11,6,64,199,42,101,0,0
4698,361,138,427,344,31,11,6,66,206,43,101,0,0
4699,362,137,427,342,31,11,6,65,205,44,101,0,0
4700,363,133,430,341,31,11,6,67,208,45,101,0,0
4701,363,127,429,333,31,11,6,66,206,46,101,0,0
4702,362,125,428,325,31,11,6,66,200,47,101,0,0
4703,371,124,436,321,31,11,6,65,197,48,101,0,0
4704,385,126,448,320,31,11,6,63,194,49,101,0,0
4705,392,124,456,320,31,11,6,64,196,50,101,0,0
4706,397,123,459,321,31,11,6,62,198,51,101,0,0
4707,399,124,461,322,31,11,6,62,198,52,101,0,0
4708,400,122,461,321,31,11,6,61,199,53,101,0,0
4709,400,121,461,321,31,11,6,61,200,54,101,0,0
4710,399,121,460,323,31,11,6,61,202,55,101,0,0
4711,400,123,459,323,31,11,6,59,200,56,101,0,0
4712,400,124,459,323,31,11,6,59,199,57,101,0,0
4713,399,123,458,324,31,11,6,59,201,58,101,0,0
4714,398,123,457,324,31,11,6,59,201,59,101,0,0
4715,398,123,457,324,31,11,6,59,201,60,101,0,0
4716,397,122,456,323,31,11,6,59,201,61,101,0,0
4717,398,122,456,323,31,11,6,58,201,62,101,0,0
4718,398,122,457,323,31,11,6,59,201,63,101,0,0
4719,398,122,457,323,31,11,6,59,201,64,101,0,0
4720,399,123,457,323,31,11,6,58,200,65,101,0,0
4721,399,123,457,323,31,11,6,58,200,66,101,0,0
4722,400,122,457,323,31,11,6,57,201,67,101,0,0
4723,400,122,458,323,31,11,6,58,201,68,101,0,0
4724,401,122,458,322,31,11,6,57,200,69,101,0,0
4725,401,122,458,322,31,11,6,57,200,70,101,0,0
4726,401,122,458,322,31,11,6,57,200,71,101,0,0
4727,401,124,457,323,31,11,6,56,199,72,101,0,0
4728,401,124,457,323,31,11,6,56,199,73,101,0,0
4729,401,124,457,323,31,11,6,56,199,74,101,0,0
4730,402,124,457,322,31,11,6,55,198,75,101,0,0
4731,401,124,457,322,31,11,6,56,198,76,101,0,0
4732,401,124,457,322,31,11,6,56,198,77,101,0,0
4733,401,124,457,322,31,11,6,56,198,78,101,0,0
4734,401,124,457,322,31,11,6,56,198,79,101,0,0
4735,401,124,457,322,31,11,6,56,198,80,101,0,0
4736,402,125,457,322,31,11,6,55,197,81,101,0,0
4737,402,125,457,321,31,11,6,55,196,82,101,0,0
4738,402,126,457,323,31,11,6,55,197,83,101,0,0
4739,401,126,456,323,31,11,6,55,197,84,101,0,0
4740,401,127,456,323,31,11,6,55,196,85,101,0,0
4741,401,127,456,323,31,11,6,55,196,86,101,0,0
4742,401,127,456,322,31,11,6,55,195,87,101,0,0
4743,401,126,455,322,31,11,6,54,196,88,101,0,0
4744,399,124,453,321,31,11,6,54,197,89,101,0,0
4745,396,125,451,322,31,11,6,55,197,90,101,0,0
4746,391,125,446,322,31,11,6,55,197,91,101,0,0
4747,384,127,439,323,31,11,6,55,196,92,101,0,0
4748,375,128,431,328,31,11,6,56,200,93,101,0,0
4749,364,124,421,330,31,11,6,57,206,94,101,0,0
4750,352,127,410,330,31,11,6,58,203,95,101,0,0
4751,339,130,400,331,31,11,6,61,201,96,101,0,0
4752,322,133,379,322,31,11,6,57,189,97,101,0,0
4753,302,134,358,323,31,11,6,56,189,98,101,0,0
4754,288,136,344,325,31,11,6,56,189,99,101,0,0
4755,272,140,329,325,31,11,6,57,185,100,101,0,0
4756,263,141,319,325,31,11,6,56,184,101,101,1,0
4797,686,381,912,1006,36,11,6,226,625,0,251,0,1
4798,690,359,908,961,36,11,6,218,602,1,251,0,0
4799,680,333,879,884,36,11,6,199,551,2,251,0,0
4800,662,318,854,853,36,11,6,192,535,3,251,0,0
4801,636,287,813,784,36,11,6,177,497,4,251,0,0
4802,612,287,778,756,36,11,6,166,469,5,251,0,0
4803,597,273,763,742,36,11,6,166,469,6,251,0,0
4804,577,250,733,691,36,11,6,156,441,7,251,0,0
4805,561,244,706,657,36,11,6,145,413,8,251,0,0
4806,546,233,683,626,36,11,6,137,393,9,251,0,0
4807,524,223,658,608,36,11,6,134,385,10,251,0,0
4808,517,224,649,607,36,11,6,132,383,11,251,0,0
4809,518,216,642,578,36,11,6,124,362,12,251,0,0
4810,520,207,639,555,36,11,6,119,348,13,251,0,0
4811,518,204,634,546,36,11,6,116,342,14,251,0,0
4812,511,193,625,527,36,11,6,114,334,15,251,0,0
4813,518,189,631,517,36,11,6,113,328,16,251,0,0
4814,534,189,641,496,36,11,6,107,307,17,251,0,0
4815,555,181,659,482,36,11,6,104,301,18,251,0,0
4816,568,180,671,477,36,11,6,103,297,19,251,0,0
4817,584,178,681,455,36,11,6,97,277,20,251,0,0
4818,607,175,703,450,36,11,6,96,275,21,251,0,0
4819,619,176,716,447,36,11,6,97,271,22,251,0,0
4820,635,173,731,437,36,11,6,96,264,23,251,0,0
4821,660,175,751,432,36,11,6,91,257,24,251,0,0
4822,675,172,766,432,36,11,6,91,260,25,251,0,0
4823,687,171,776,423,36,11,6,89,252,26,251,0,0
4824,694,163,784,422,36,11,6,90,259,27,251,0,0
4825,694,162,784,422,36,11,6,90,260,28,251,0,0
4826,695,162,784,419,36,11,6,89,257,29,251,0,0
4827,698,165,785,419,36,11,6,87,254,30,251,0,0
4828,698,167,782,420,36,11,6,84,253,31,251,0,0
4829,690,162,772,412,36,11,6,82,250,32,251,0,0
4830,671,160,753,413,36,11,6,82,253,33,251,0,0
4831,652,163,734,411,36,11,6,82,248,34,251,0,0
4832,622,158,702,400,36,11,6,80,242,35,251,0,0
4833,584,156,668,399,36,11,6,84,243,36,251,0,0
4834,562,152,645,388,36,11,6,83,236,37,251,0,0
4835,530,148,611,381,36,11,6,81,233,38,251,0,0
4836,502,152,583,375,36,11,6,81,223,39,251,0,0
4837,476,150,554,369,36,11,6,78,219,40,251,0,0
4838,455,146,533,360,36,11,6,78,214,41,251,0,0
4839,420,144,495,350,36,11,6,75,206,42,251,0,0
4840,394,142,464,339,36,11,6,70,197,43,251,0,0
4841,371,139,438,326,36,11,6,67,187,44,251,0,0
4842,346,139,410,318,36,11,6,64,179,45,251,0,0
4843,321,134,383,307,36,11,6,62,173,46,251,0,0
4844,300,136,362,303,36,11,6,62,167,47,251,0,0
4845,287,135,347,299,36,11,6,60,164,48,251,0,0
4846,281,137,337,291,36,11,6,56,154,49,251,0,0
4847,279,134,334,287,36,11,6,55,153,50,251,0,0
4848,280,130,335,288,36,11,6,55,158,51,251,0,0
4849,282,124,340,292,36,11,6,58,168,52,251,0,0
4850,288,118,347,291,36,11,6,59,173,53,251,0,0
4851,300,117,359,291,36,11,6,59,174,54,251,0,0
4852,309,117,368,290,36,11,6,59,173,55,251,0,0
4853,316,118,375,292,36,11,6,59,174,56,251,0,0
4854,321,118,380,291,36,11,6,59,173,57,251,0,0
4855,325,119,383,291,36,11,6,58,172,58,251,0,0
4856,327,119,385,290,36,11,6,58,171,59,251,0,0
4857,328,119,386,290,36,11,6,58,171,60,251,0,0
4858,328,117,387,290,36,11,6,59,173,61,251,0,0
4859,329,117,387,290,36,11,6,58,173,62,251,0,0
4860,329,117,387,291,36,11,6,58,174,63,251,0,0
4861,329,117,387,291,36,11,6,58,174,64,251,0,0
4862,330,117,388,292,36,11,6,58,175,65,251,0,0
4863,330,117,388,292,36,11,6,58,175,66,251,0,0
4864,330,116,388,292,36,11,6,58,176,67,251,0,0
4865,331,118,388,292,36,11,6,57,174,68,251,0,0
4866,331,119,387,292,36,11,6,56,173,69,251,0,0
4867,331,119,387,292,36,11,6,56,173,70,251,0,0
4868,331,118,387,293,36,11,6,56,175,71,251,0,0
4869,331,117,388,293,36,11,6,57,176,72,251,0,0
4870,331,118,388,292,36,11,6,57,174,73,251,0,0
4871,331,117,388,293,36,11,6,57,176,74,251,0,0
4872,331,118,389,294,36,11,6,58,176,75,251,0,0
4873,330,120,388,296,36,11,6,58,176,76,251,0,0
4874,328,122,385,296,36,11,6,57,174,77,251,0,0
4875,326,123,383,298,36,11,6,57,175,78,251,0,0
4876,326,121,383,299,36,11,6,57,178,79,251,0,0
4877,325,117,384,299,36,11,6,59,182,80,251,0,0
4878,328,118,387,301,36,11,6,59,183,81,251,0,0
4879,331,118,391,301,36,11,6,60,183,82,251,0,0
4880,335,117,395,302,36,11,6,60,185,83,251,0,0
4881,339,117,398,302,36,11,6,59,185,84,251,0,0
4882,339,117,399,302,36,11,6,60,185,85,251,0,0
4883,339,116,400,303,36,11,6,61,187,86,251,0,0
4884,341,116,401,301,36,11,6,60,185,87,251,0,0
4885,340,115,401,302,36,11,6,61,187,88,251,0,0
4886,339,115,401,303,36,11,6,62,188,89,251,0,0
4887,340,114,402,303,36,11,6,62,189,90,251,0,0
4888,339,113,402,304,36,11,6,63,191,91,251,0,0
4889,339,113,402,304,36,11,6,63,191,92,251,0,0
4890,339,112,403,304,36,11,6,64,192,93,251,0,0
4891,340,113,403,304,36,11,6,63,191,94,251,0,0
4892,340,114,402,304,36,11,6,62,190,95,251,0,0
4893,339,114,402,304,36,11,6,63,190,96,251,0,0
4894,339,113,402,304,36,11,6,63,191,97,251,0,0
4895,339,113,403,304,36,11,6,64,191,98,251,0,0
4896,339,113,403,304,36,11,6,64,191,99,251,0,0
4897,339,112,403,304,36,11,6,64,192,100,251,0,0
4898,339,112,403,304,36,11,6,64,192,101,251,0,0
4899,339,112,403,304,36,11,6,64,192,102,251,0,0
4900,339,112,403,304,36,11,6,64,192,103,251,0,0
4901,338,112,403,304,36,11,6,65,192,104,251,0,0
4902,338,112,403,304,36,11,6,65,192,105,251,0,0
4903,338,112,403,305,36,11,6,65,193,106,251,0,0
4904,338,112,403,305,36,11,6,65,193,107,251,0,0
4905,338,112,403,305,36,11,6,65,193,108,251,0,0
4906,340,115,404,304,36,11,6,64,189,109,251,0,0
4907,339,115,403,304,36,11,6,64,189,110,251,0,0
4908,340,116,404,304,36,11,6,64,188,111,251,0,0
4909,340,116,404,304,36,11,6,64,188,112,251,0,0
4910,341,116,404,303,36,11,6,63,187,113,251,0,0
4911,341,116,404,303,36,11,6,63,187,114,251,0,0
4912,341,116,404,303,36,11,6,63,187,115,251,0,0
4913,341,116,404,303,36,11,6,63,187,116,251,0,0
4914,341,116,404,303,36,11,6,63,187,117,251,0,0
4915,342,117,404,303,36,11,6,62,186,118,251,0,0
4916,342,118,405,304,36,11,6,63,186,119,251,0,0
4917,342,117,404,304,36,11,6,62,187,120,251,0,0
4918,341,117,403,304,36,11,6,62,187,121,251,0,0
4919,342,117,402,304,36,11,6,60,187,122,251,0,0
4920,342,119,402,303,36,11,6,60,184,123,251,0,0
4921,341,117,401,304,36,11,6,60,187,124,251,0,0
4922,341,119,400,304,36,11,6,59,185,125,251,0,0
4923,341,116,401,304,36,11,6,60,188,126,251,0,0
4924,340,110,402,304,36,11,6,62,194,127,251,0,0
4925,340,109,402,304,36,11,6,62,195,128,251,0,0
4926,340,110,402,304,36,11,6,62,194,129,251,0,0
4927,340,112,402,304,36,11,6,62,192,130,251,0,0
4928,343,112,404,303,36,11,6,61,191,131,251,0,0
4929,349,114,408,300,36,11,6,59,186,132,251,0,0
4930,354,114,410,295,36,11,6,56,181,133,251,0,0
4931,358,114,413,297,36,11,6,55,183,134,251,0,0
4932,363,118,417,298,36,11,6,54,180,135,251,0,0
4933,367,120,419,298,36,11,6,52,178,136,251,0,0
4934,369,118,422,296,36,11,6,53,178,137,251,0,0
4935,368,119,421,294,36,11,6,53,175,138,251,0,0
4936,367,121,419,293,36,11,6,52,172,139,251,0,0
4937,363,119,416,290,36,11,6,53,171,140,251,0,0
4938,357,116,411,290,36,11,6,54,174,141,251,0,0
4939,352,116,406,289,36,11,6,54,173,142,251,0,0
4940,351,116,405,289,36,11,6,54,173,143,251,0,0
4941,354,116,408,288,36,11,6,54,172,144,251,0,0
4942,359,118,411,284,36,11,6,52,166,145,251,0,0
4943,364,119,416,282,36,11,6,52,163,146,251,0,0
4944,368,117,420,280,36,11,6,52,163,147,251,0,0
4945,370,118,422,280,36,11,6,52,162,148,251,0,0
4946,369,115,421,281,36,11,6,52,166,149,251,0,0
4947,368,115,420,281,36,11,6,52,166,150,251,0,0
4948,366,105,420,283,36,11,6,54,178,151,251,0,0
4949,363,99,417,283,36,11,6,54,184,152,251,0,0
4950,359,105,411,283,36,11,6,52,178,153,251,0,0
4951,353,103,404,282,36,11,6,51,179,154,251,0,0
4952,347,103,400,286,36,11,6,53,183,155,251,0,0
4953,345,109,395,285,36,11,6,50,176,156,251,0,0
4954,343,112,392,284,36,11,6,49,172,157,251,0,0
4955,341,113,390,286,36,11,6,49,173,158,251,0,0
4956,341,114,390,286,36,11,6,49,172,159,251,0,0
4957,343,116,392,284,36,11,6,49,168,160,251,0,0
4958,345,119,392,283,36,11,6,47,164,161,251,0,0
4959,347,119,395,282,36,11,6,48,163,162,251,0,0
4960,347,118,397,285,36,11,6,50,167,163,251,0,0
4961,347,118,397,290,36,11,6,50,172,164,251,0,0
4962,344,118,395,290,36,11,6,51,172,165,251,0,0
4963,341,119,392,293,36,11,6,51,174,166,251,0,0
4964,341,121,391,294,36,11,6,50,173,167,251,0,0
4965,344,121,395,297,36,11,6,51,176,168,251,0,0
4966,345,121,398,297,36,11,6,53,176,169,251,0,0
4967,348,120,402,299,36,11,6,54,179,170,251,0,0
4968,353,124,406,300,36,11,6,53,176,171,251,0,0
4969,362,121,415,300,36,11,6,53,179,172,251,0,0
4970,369,120,420,301,36,11,6,51,181,173,251,0,0
4971,374,120,427,311,36,11,6,53,191,174,251,0,0
4972,379,121,431,311,36,11,6,52,190,175,251,0,0
4973,384,122,434,307,36,11,6,50,185,176,251,0,0
4974,389,125,438,307,36,11,6,49,182,177,251,0,0
4975,394,122,444,310,36,11,6,50,188,178,251,0,0
4976,398,124,449,315,36,11,6,51,191,179,251,0,0
4977,405,122,456,314,36,11,6,51,192,180,251,0,0
4978,412,120,462,311,36,11,6,50,191,181,251,0,0
4979,418,121,467,310,36,11,6,49,189,182,251,0,0
4980,422,123,469,310,36,11,6,47,187,183,251,0,0
4981,424,123,471,311,36,11,6,47,188,184,251,0,0
4982,425,124,473,316,36,11,6,48,192,185,251,0,0
4983,428,126,476,318,36,11,6,48,192,186,251,0,0
4984,434,132,483,321,36,11,6,49,189,187,251,0,0
4985,438,137,488,327,36,11,6,50,190,188,251,0,0
4986,445,138,497,331,36,11,6,52,193,189,251,0,0
4987,454,135,507,331,36,11,6,53,196,190,251,0,0
4988,460,136,514,333,36,11,6,54,197,191,251,0,0
4989,462,139,516,338,36,11,6,54,199,192,251,0,0
4990,464,139,519,345,36,11,6,55,206,193,251,0,0
4991,468,140,525,348,36,11,6,57,208,194,251,0,0
4992,471,138,530,351,36,11,6,59,213,195,251,0,0
4993,473,143,531,348,36,11,6,58,205,196,251,0,0
4994,478,141,536,349,36,11,6,58,208,197,251,0,0
4995,485,141,545,347,36,11,6,60,206,198,251,0,0
4996,492,139,555,349,36,11,6,63,210,199,251,0,0
4997,488,137,552,348,36,11,6,64,211,200,251,0,0
4998,482,137,546,345,36,11,6,64,208,201,251,0,0
4999,477,134,541,347,36,11,6,64,213,202,251,0,0
5000,471,134,534,349,36,11,6,63,215,203,251,0,0
5001,466,135,527,350,36,11,6,61,215,204,251,0,0
5002,458,137,517,342,36,11,6,59,205,205,251,0,0
5003,442,137,504,347,36,11,6,62,210,206,251,0,0
5004,435,137,501,347,36,11,6,66,210,207,251,0,0
5005,423,136,488,342,36,11,6,65,206,208,251,0,0
5006,411,134,474,337,36,11,6,63,203,209,251,0,0
5007,404,134,465,336,36,11,6,61,202,210,251,0,0
5008,399,134,458,331,36,11,6,59,197,211,251,0,0
5009,395,133,454,330,36,11,6,59,197,212,251,0,0
5010,388,131,447,326,36,11,6,59,195,213,251,0,0
5011,377,132,437,325,36,11,6,60,193,214,251,0,0
5012,370,130,432,325,36,11,6,62,195,215,251,0,0
5013,365,130,426,320,36,11,6,61,190,216,251,0,0
5014,358,125,418,317,36,11,6,60,192,217,251,0,0
5015,352,126,411,320,36,11,6,59,194,218,251,0,0
5016,347,124,405,320,36,11,6,58,196,219,251,0,0
5017,342,126,398,319,36,11,6,56,193,220,251,0,0
5018,338,124,392,312,36,11,6,54,188,221,251,0,0
5019,335,124,387,311,36,11,6,52,187,222,251,0,0
5020,334,124,384,309,36,11,6,50,185,223,251,0,0
5021,333,125,382,309,36,11,6,49,184,224,251,0,0
5022,333,124,380,309,36,11,6,47,185,225,251,0,0
5023,333,125,379,310,36,11,6,46,185,226,251,0,0
5024,333,125,379,309,36,11,6,46,184,227,251,0,0
5025,335,125,380,308,36,11,6,45,183,228,251,0,0
5026,337,125,381,309,36,11,6,44,184,229,251,0,0
5027,338,124,381,309,36,11,6,43,185,230,251,0,0
5028,338,125,381,310,36,11,6,43,185,231,251,0,0
5029,339,126,381,310,36,11,6,42,184,232,251,0,0
5030,339,126,382,310,36,11,6,43,184,233,251,0,0
5031,339,126,382,311,36,11,6,43,185,234,251,0,0
5032,340,126,382,311,36,11,6,42,185,235,251,0,0
5033,340,126,382,311,36,11,6,42,185,236,251,0,0
5034,340,126,381,311,36,11,6,41,185,237,251,0,0
5035,340,126,381,311,36,11,6,41,185,238,251,0,0
5036,340,126,381,311,36,11,6,41,185,239,251,0,0
5037,340,126,381,310,36,11,6,41,184,240,251,0,0
5038,341,125,381,309,36,11,6,40,184,241,251,0,0
5039,341,125,382,309,36,11,6,41,184,242,251,0,0
5040,341,125,382,309,36,11,6,41,184,243,251,0,0
5041,339,123,380,311,36,11,6,41,188,244,251,0,0
5042,333,125,375,310,36,11,6,42,185,245,251,0,0
5043,318,127,364,317,36,11,6,46,190,246,251,0,0
5044,309,132,358,320,36,11,6,49,188,247,251,0,0
5045,298,132,345,311,36,11,6,47,179,248,251,0,0
5046,274,130,322,317,36,11,6,48,187,249,251,0,0
5047,263,132,313,326,36,11,6,50,194,250,251,0,0
5048,256,133,306,327,36,11,6,50,194,251,251,1,0
5074,257,142,303,326,36,11,6,46,184,0,251,0,1
5075,262,143,310,328,36,11,6,48,185,1,251,0,0
5076,267,144,318,328,36,11,6,51,184,2,251,0,0
5077,278,140,331,330,36,11,6,53,190,3,251,0,0
5078,287,134,341,329,36,11,6,54,195,4,251,0,0
5079,296,135,349,327,36,11,6,53,192,5,251,0,0
5080,304,134,355,319,36,11,6,51,185,6,251,0,0
5081,306,131,358,314,36,11,6,52,183,7,251,0,0
5082,305,132,356,307,36,11,6,51,175,8,251,0,0
5083,302,138,352,303,36,11,6,50,165,9,251,0,0
5084,299,140,348,295,36,11,6,49,155,10,251,0,0
5085,294,138,343,294,36,11,6,49,156,11,251,0,0
5086,293,135,342,294,36,11,6,49,159,12,251,0,0
5087,291,134,341,293,36,11,6,50,159,13,251,0,0
5088,289,133,339,295,36,11,6,50,162,14,251,0,0
5089,284,128,336,298,36,11,6,52,170,15,251,0,0
5090,274,125,327,302,36,11,6,53,177,16,251,0,0
5091,266,123,321,303,36,11,6,55,180,17,251,0,0
5092,262,123,317,305,36,11,6,55,182,18,251,0,0
5093,259,127,314,311,36,11,6,55,184,19,251,0,0
5094,255,129,310,321,36,11,6,55,192,20,251,0,0
5095,254,138,305,320,36,11,6,51,182,21,251,0,0
5096,251,139,303,321,36,11,6,52,182,22,251,0,0
5377,259,157,317,338,37,11,6,58,181,0,3,0,0
5378,261,152,319,334,37,11,6,58,182,1,3,0,0
5379,255,169,307,333,37,11,6,52,164,2,3,0,0
5380,253,176,302,333,37,11,6,49,157,3,3,0,0
5379,278,161,344,347,38,11,6,66,186,0,39,0,1
5380,297,155,364,346,38,11,6,67,191,1,39,0,0
5381,313,165,383,359,38,11,6,70,194,2,39,0,0
5382,319,168,390,363,38,11,6,71,195,3,39,0,0
5383,320,169,393,370,38,11,6,73,201,4,39,0,0
5384,329,172,402,375,38,11,6,73,203,5,39,0,0
5385,343,171,421,384,38,11,6,78,213,6,39,0,0
5386,353,174,437,401,38,11,6,84,227,7,39,0,0
5387,354,174,441,411,38,11,6,87,237,8,39,0,0
5388,356,180,443,421,38,11,6,87,241,9,39,0,0
5389,368,184,456,427,38,11,6,88,243,10,39,0,0
5390,385,187,478,440,38,11,6,93,253,11,39,0,0
5391,393,195,493,466,38,11,6,100,271,12,39,0,0
5392,399,196,497,463,38,11,6,98,267,13,39,0,0
5393,406,206,505,477,38,11,6,99,271,14,39,0,0
5394,425,209,528,490,38,11,6,103,281,15,39,0,0
5395,442,216,552,512,38,11,6,110,296,16,39,0,0
5396,449,226,564,534,38,11,6,115,308,17,39,0,0
5397,454,230,574,553,38,11,6,120,323,18,39,0,0
5398,462,241,588,582,38,11,6,126,341,19,39,0,0
5399,481,244,610,594,38,11,6,129,350,20,39,0,0
5400,500,257,632,611,38,11,6,132,354,21,39,0,0
5401,506,270,647,650,38,11,6,141,380,22,39,0,0
5402,514,279,658,673,38,11,6,144,394,23,39,0,0
5403,530,291,680,704,38,11,6,150,413,24,39,0,0
5404,559,302,718,731,38,11,6,159,429,25,39,0,0
5405,578,323,750,787,38,11,6,172,464,26,39,0,0
5406,597,336,770,805,38,11,6,173,469,27,39,0,0
5407,615,356,800,859,38,11,6,185,503,28,39,0,0
5408,642,377,835,901,38,11,6,193,524,29,39,0,0
5409,690,396,892,931,38,11,6,202,535,30,39,0,0
5410,722,430,946,1018,38,11,6,224,588,31,39,0,0
5411,749,451,977,1051,38,11,6,228,600,32,39,0,0
5412,788,492,1009,1074,38,11,6,221,582,33,39,0,0
5413,856,537,1069,1080,38,11,6,213,543,34,39,0,0
5414,947,581,1159,1080,38,11,6,212,499,35,39,0,0
5415,1033,654,1232,1080,38,11,6,199,426,36,39,0,0
5416,1101,714,1288,1080,38,11,6,187,366,37,39,0,0
5417,1228,803,1391,1080,38,11,6,163,277,38,39,0,0
5418,1288,843,1437,1080,38,11,6,149,237,39,39,1,0
1473,1,343,36,486,2,11,7,35,143,0,27,0,1
1474,0,303,41,494,2,11,7,41,191,1,27,0,0
1475,0,273,50,509,2,11,7,50,236,2,27,0,0
1476,0,261,58,523,2,11,7,58,262,3,27,0,0
1477,0,233,68,527,2,11,7,68,294,4,27,0,0
1478,11,229,86,536,2,11,7,75,307,5,27,0,0
1479,18,225,98,541,2,11,7,80,316,6,27,0,0
1480,21,221,108,558,2,11,7,87,337,7,27,0,0
1481,25,225,119,580,2,11,7,94,355,8,27,0,0
1482,32,225,131,591,2,11,7,99,366,9,27,0,0
1483,54,231,161,605,2,11,7,107,374,10,27,0,0
1484,73,231,187,620,2,11,7,114,389,11,27,0,0
1485,84,226,210,644,2,11,7,126,418,12,27,0,0
1486,102,234,237,673,2,11,7,135,439,13,27,0,0
1487,115,240,257,693,2,11,7,142,453,14,27,0,0
1488,148,239,304,714,2,11,7,156,475,15,27,0,0
1489,173,237,344,742,2,11,7,171,505,16,27,0,0
1490,198,240,381,764,2,11,7,183,524,17,27,0,0
1491,232,255,432,816,2,11,7,200,561,18,27,0,0
1492,262,266,472,846,2,11,7,210,580,19,27,0,0
1493,320,280,547,879,2,11,7,227,599,20,27,0,0
1494,376,298,622,930,2,11,7,246,632,21,27,0,0
1495,430,299,699,974,2,11,7,269,675,22,27,0,0
1496,503,318,801,1044,2,11,7,298,726,23,27,0,0
1497,572,341,876,1077,2,11,7,304,736,24,27,0,0
1498,691,366,992,1080,2,11,7,301,714,25,27,0,0
1499,807,384,1113,1080,2,11,7,306,696,26,27,0,0
1500,852,391,1166,1080,2,11,7,314,689,27,27,1,0
1496,745,480,806,579,3,11,7,61,99,0,0,0,0
1500,1026,425,1380,1075,4,11,7,354,650,0,1,0,0
1501,1171,469,1498,1068,4,11,7,327,599,1,1,0,0
1502,1360,499,1750,1073,5,11,7,390,574,0,0,0,0
1503,1586,538,1920,1080,6,11,7,334,542,0,1,0,0
1504,1692,731,1907,1080,6,11,7,215,349,1,1,0,0
2943,27,283,62,556,8,11,7,35,273,0,85,0,1
2944,35,282,74,562,8,11,7,39,280,1,85,0,0
2945,52,288,97,568,8,11,7,45,280,2,85,0,0
2946,66,289,116,573,8,11,7,50,284,3,85,0,0
2947,78,289,136,592,8,11,7,58,303,4,85,0,0
2948,94,291,160,614,8,11,7,66,323,5,85,0,0
2949,106,291,179,620,8,11,7,73,329,6,85,0,0
2950,138,298,219,631,8,11,7,81,333,7,85,0,0
2951,160,297,249,641,8,11,7,89,344,8,85,0,0
2952,177,295,278,672,8,11,7,101,377,9,85,0,0
2953,200,299,313,701,8,11,7,113,402,10,85,0,0
2954,222,302,341,713,8,11,7,119,411,11,85,0,0
2955,269,309,400,726,8,11,7,131,417,12,85,0,0
2956,309,314,448,739,8,11,7,139,425,13,85,0,0
2957,338,313,493,774,8,11,7,155,461,14,85,0,0
2958,386,327,553,809,8,11,7,167,482,15,85,0,0
2959,430,329,603,825,8,11,7,173,496,16,85,0,0
2960,512,338,696,840,8,11,7,184,502,17,85,0,0
2961,579,345,771,858,8,11,7,192,513,18,85,0,0
2962,649,345,846,879,8,11,7,197,534,19,85,0,0
2963,742,353,953,899,8,11,7,211,546,20,85,0,0
2964,831,348,1041,906,8,11,7,210,558,21,85,0,0
2965,932,350,1143,902,8,11,7,211,552,22,85,0,0
2966,1006,344,1225,910,8,11,7,219,566,23,85,0,0
2967,1110,330,1320,884,8,11,7,210,554,24,85,0,0
2968,1192,339,1393,850,8,11,7,201,511,25,85,0,0
2969,1276,324,1468,817,8,11,7,192,493,26,85,0,0
2970,1343,309,1535,803,8,11,7,192,494,27,85,0,0
2971,1389,298,1584,796,8,11,7,195,498,28,85,0,0
2972,1431,278,1613,748,8,11,7,182,470,29,85,0,0
2973,1460,268,1629,707,8,11,7,169,439,30,85,0,0
2974,1486,253,1646,672,8,11,7,160,419,31,85,0,0
2975,1508,236,1665,649,8,11,7,157,413,32,85,0,0
2976,1522,230,1677,638,8,11,7,155,408,33,85,0,0
2977,1530,217,1675,604,8,11,7,145,387,34,85,0,0
2978,1536,215,1672,580,8,11,7,136,365,35,85,0,0
2979,1548,208,1673,546,8,11,7,125,338,36,85,0,0
2980,1558,198,1679,524,8,11,7,121,326,37,85,0,0
2981,1563,194,1682,519,8,11,7,119,325,38,85,0,0
2982,1563,182,1679,499,8,11,7,116,317,39,85,0,0
2983,1567,179,1675,475,8,11,7,108,296,40,85,0,0
2984,1573,179,1676,461,8,11,7,103,282,41,85,0,0
2985,1581,174,1679,444,8,11,7,98,270,42,85,0,0
2986,1587,173,1682,436,8,11,7,95,263,43,85,0,0
2987,1588,166,1680,416,8,11,7,92,250,44,85,0,0
2988,1589,163,1677,405,8,11,7,88,242,45,85,0,0
2989,1591,160,1677,398,8,11,7,86,238,46,85,0,0
2990,1596,153,1679,382,8,11,7,83,229,47,85,0,0
2991,1599,153,1680,380,8,11,7,81,227,48,85,0,0
2992,1598,145,1677,365,8,11,7,79,220,49,85,0,0
2993,1598,142,1675,356,8,11,7,77,214,50,85,0,0
2994,1600,142,1675,352,8,11,7,75,210,51,85,0,0
2995,1606,138,1679,342,8,11,7,73,204,52,85,0,0
2996,1610,138,1683,341,8,11,7,73,203,53,85,0,0
2997,1611,137,1680,330,8,11,7,69,193,54,85,0,0
2998,1610,135,1676,321,8,11,7,66,186,55,85,0,0
2999,1611,134,1675,317,8,11,7,64,183,56,85,0,0
3000,1614,129,1677,308,8,11,7,63,179,57,85,0,0
3001,1615,132,1675,302,8,11,7,60,170,58,85,0,0
3002,1613,125,1672,294,8,11,7,59,169,59,85,0,0
3003,1612,122,1670,289,8,11,7,58,167,60,85,0,0
3004,1612,123,1668,285,8,11,7,56,162,61,85,0,0
3005,1614,121,1668,278,8,11,7,54,157,62,85,0,0
3006,1614,121,1667,273,8,11,7,53,152,63,85,0,0
3007,1613,121,1664,268,8,11,7,51,147,64,85,0,0
3008,1612,119,1661,262,8,11,7,49,143,65,85,0,0
3009,1611,118,1659,258,8,11,7,48,140,66,85,0,0
3010,1612,117,1659,254,8,11,7,47,137,67,85,0,0
3011,1613,114,1659,250,8,11,7,46,136,68,85,0,0
3012,1612,113,1658,246,8,11,7,46,133,69,85,0,0
3013,1610,113,1655,242,8,11,7,45,129,70,85,0,0
3014,1611,115,1654,239,8,11,7,43,124,71,85,0,0
3015,1614,112,1656,234,8,11,7,42,122,72,85,0,0
3016,1616,110,1658,232,8,11,7,42,122,73,85,0,0
3017,1617,109,1659,230,8,11,7,42,121,74,85,0,0
3018,1616,104,1659,228,8,11,7,43,124,75,85,0,0
3019,1617,106,1658,224,8,11,7,41,118,76,85,0,0
3020,1620,105,1660,221,8,11,7,40,116,77,85,0,0
3021,1623,105,1661,218,8,11,7,38,113,78,85,0,0
3022,1624,107,1662,216,8,11,7,38,109,79,85,0,0
3023,1624,104,1661,213,8,11,7,37,109,80,85,0,0
3024,1625,104,1661,211,8,11,7,36,107,81,85,0,0
3025,1626,103,1662,208,8,11,7,36,105,82,85,0,0
3026,1628,100,1664,206,8,11,7,36,106,83,85,0,0
3027,1630,99,1666,205,8,11,7,36,106,84,85,0,0
3028,1631,98,1666,203,8,11,7,35,105,85,85,1,0
3031,1633,94,1668,197,8,11,7,35,103,0,85,0,0
3032,1634,93,1669,195,8,11,7,35,102,1,85,0,0
2975,4,523,58,732,9,11,7,54,209,0,0,0,0
2977,2,405,102,779,10,11,7,100,374,0,25,0,1
2978,0,405,104,800,10,11,7,104,395,1,25,0,0
2979,7,374,130,832,10,11,7,123,458,2,25,0,0
2980,11,350,146,848,10,11,7,135,498,3,25,0,0
2981,34,354,173,852,10,11,7,139,498,4,25,0,0
2982,60,361,209,875,10,11,7,149,514,5,25,0,0
2983,74,363,231,885,10,11,7,157,522,6,25,0,0
2984,84,367,260,939,10,11,7,176,572,7,25,0,0
2985,114,383,302,973,10,11,7,188,590,8,25,0,0
2986,132,391,328,988,10,11,7,196,597,9,25,0,0
2987,183,400,396,1011,10,11,7,213,611,10,25,0,0
2988,219,414,447,1042,10,11,7,228,628,11,25,0,0
2989,234,413,473,1066,10,11,7,239,653,12,25,0,0
2990,269,430,507,1072,10,11,7,238,642,13,25,0,0
2991,323,448,561,1076,10,11,7,238,628,14,25,0,0
2992,401,459,646,1078,10,11,7,245,619,15,25,0,0
2993,478,487,721,1079,10,11,7,243,592,16,25,0,0
2994,565,492,815,1078,10,11,7,250,586,17,25,0,0
2995,649,513,897,1080,10,11,7,248,567,18,25,0,0
2996,767,570,999,1078,10,11,7,232,508,19,25,0,0
2997,919,621,1147,1080,10,11,7,228,459,20,25,0,0
2998,1081,655,1311,1080,10,11,7,230,425,21,25,0,0
2999,1252,703,1474,1080,10,11,7,222,377,22,25,0,0
3000,1444,724,1668,1076,10,11,7,224,352,23,25,0,0
3001,1624,781,1829,1080,10,11,7,205,299,24,25,0,0
3002,1756,812,1920,1080,10,11,7,164,268,25,25,1,0
3154,1733,647,1920,1080,11,11,7,187,433,0,1,0,0
3155,1753,512,1920,922,11,11,7,167,410,1,1,0,0
3155,1564,751,1870,1072,12,11,7,306,321,0,5,0,0
3156,1513,501,1920,969,12,11,7,407,468,1,5,0,0
3157,1424,433,1920,978,12,11,7,496,545,2,5,0,0
3158,1359,394,1884,970,12,11,7,525,576,3,5,0,0
3159,1282,366,1818,968,12,11,7,536,602,4,5,0,0
3160,1231,314,1803,957,12,11,7,572,643,5,5,0,0
3156,1385,718,1655,1069,13,11,7,270,351,0,0,0,0
3157,1240,647,1498,1072,14,11,7,258,425,0,0,0,0
3158,1116,606,1349,1063,15,11,7,233,457,0,0,0,0
3159,972,584,1212,1080,16,11,7,240,496,0,0,0,0
3160,763,532,1090,1074,17,11,7,327,542,0,30,0,1
3161,650,516,987,1073,17,11,7,337,557,1,30,0,0
3162,575,475,937,1078,17,11,7,362,603,2,30,0,0
3163,530,453,897,1069,17,11,7,367,616,3,30,0,0
3164,484,443,847,1055,17,11,7,363,612,4,30,0,0
3165,394,424,736,1007,17,11,7,342,583,5,30,0,0
3166,324,414,662,987,17,11,7,338,573,6,30,0,0
3167,279,393,597,944,17,11,7,318,551,7,30,0,0
3168,251,383,548,903,17,11,7,297,520,8,30,0,0
3169,222,379,502,870,17,11,7,280,491,9,30,0,0
3170,158,369,424,842,17,11,7,266,473,10,30,0,0
3171,119,373,375,829,17,11,7,256,456,11,30,0,0
3172,84,356,329,803,17,11,7,245,447,12,30,0,0
3173,70,351,297,772,17,11,7,227,421,13,30,0,0
3174,54,349,268,747,17,11,7,214,398,14,30,0,0
3175,10,338,219,734,17,11,7,209,396,15,30,0,0
3176,0,339,191,728,17,11,7,191,389,16,30,0,0
3177,0,333,162,698,17,11,7,162,365,17,30,0,0
3178,0,325,148,675,17,11,7,148,350,18,30,0,0
3179,0,319,134,657,17,11,7,134,338,19,30,0,0
3180,0,307,120,650,17,11,7,120,343,20,30,0,0
3181,0,308,108,641,17,11,7,108,333,21,30,0,0
3182,0,318,91,614,17,11,7,91,296,22,30,0,0
3183,0,336,80,597,17,11,7,80,261,23,30,0,0
3184,0,329,74,580,17,11,7,74,251,24,30,0,0
3185,0,324,66,574,17,11,7,66,250,25,30,0,0
3186,0,323,61,571,17,11,7,61,248,26,30,0,0
3187,0,318,54,552,17,11,7,54,234,27,30,0,0
3188,0,333,47,544,17,11,7,47,211,28,30,0,0
3189,0,357,39,533,17,11,7,39,176,29,30,0,0
3190,0,361,36,518,17,11,7,36,157,30,30,1,0
3160,1415,350,1611,887,18,11,7,196,537,0,65,0,1
3161,1403,324,1603,871,18,11,7,200,547,1,65,0,0
3162,1393,318,1585,842,18,11,7,192,524,2,65,0,0
3163,1385,293,1561,768,18,11,7,176,475,3,65,0,0
3164,1380,280,1554,745,18,11,7,174,465,4,65,0,0
3165,1380,268,1545,709,18,11,7,165,441,5,65,0,0
3166,1396,247,1552,663,18,11,7,156,416,6,65,0,0
3167,1412,240,1564,643,18,11,7,152,403,7,65,0,0
3168,1435,227,1577,602,18,11,7,142,375,8,65,0,0
3169,1443,218,1581,579,18,11,7,138,361,9,65,0,0
3170,1447,212,1583,569,18,11,7,136,357,10,65,0,0
3171,1461,191,1592,536,18,11,7,131,345,11,65,0,0
3172,1473,188,1598,520,18,11,7,125,332,12,65,0,0
3173,1490,183,1609,499,18,11,7,119,316,13,65,0,0
3174,1497,175,1613,483,18,11,7,116,308,14,65,0,0
3175,1503,174,1617,475,18,11,7,114,301,15,65,0,0
3176,1505,168,1612,452,18,11,7,107,284,16,65,0,0
3177,1513,165,1616,440,18,11,7,103,275,17,65,0,0
3178,1522,165,1620,429,18,11,7,98,264,18,65,0,0
3179,1525,155,1620,409,18,11,7,95,254,19,65,0,0
3180,1527,155,1621,403,18,11,7,94,248,20,65,0,0
3181,1528,149,1618,387,18,11,7,90,238,21,65,0,0
3182,1532,143,1621,377,18,11,7,89,234,22,65,0,0
3183,1537,146,1624,375,18,11,7,87,229,23,65,0,0
3184,1545,139,1629,361,18,11,7,84,222,24,65,0,0
3185,1549,136,1633,361,18,11,7,84,225,25,65,0,0
3186,1554,137,1635,353,18,11,7,81,216,26,65,0,0
3187,1560,135,1637,340,18,11,7,77,205,27,65,0,0
3188,1565,138,1638,337,18,11,7,73,199,28,65,0,0
3189,1572,137,1641,326,18,11,7,69,189,29,65,0,0
3190,1573,133,1642,320,18,11,7,69,187,30,65,0,0
3191,1578,135,1645,317,18,11,7,67,182,31,65,0,0
3192,1581,125,1647,305,18,11,7,66,180,32,65,0,0
3193,1585,126,1649,301,18,11,7,64,175,33,65,0,0
3194,1591,127,1652,294,18,11,7,61,167,34,65,0,0
3195,1594,124,1654,288,18,11,7,60,164,35,65,0,0
3196,1595,122,1656,287,18,11,7,61,165,36,65,0,0
3197,1599,122,1657,277,18,11,7,58,155,37,65,0,0
3198,1603,123,1659,272,18,11,7,56,149,38,65,0,0
3199,1607,123,1661,269,18,11,7,54,146,39,65,0,0
3200,1610,120,1663,264,18,11,7,53,144,40,65,0,0
3201,1610,119,1663,261,18,11,7,53,142,41,65,0,0
3202,1610,120,1660,254,18,11,7,50,134,42,65,0,0
3203,1612,117,1661,250,18,11,7,49,133,43,65,0,0
3204,1614,118,1663,248,18,11,7,49,130,44,65,0,0
3205,1618,114,1666,243,18,11,7,48,129,45,65,0,0
3206,1620,112,1666,236,18,11,7,46,124,46,65,0,0
3207,1620,110,1666,233,18,11,7,46,123,47,65,0,0
3208,1621,107,1668,232,18,11,7,47,125,48,65,0,0
3209,1625,109,1669,229,18,11,7,44,120,49,65,0,0
3210,1629,107,1674,227,18,11,7,45,120,50,65,0,0
3211,1632,105,1676,225,18,11,7,44,120,51,65,0,0
3212,1634,104,1677,222,18,11,7,43,118,52,65,0,0
3213,1634,101,1678,220,18,11,7,44,119,53,65,0,0
3214,1635,101,1677,217,18,11,7,42,116,54,65,0,0
3215,1638,100,1678,211,18,11,7,40,111,55,65,0,0
3216,1638,98,1678,210,18,11,7,40,112,56,65,0,0
3217,1638,99,1677,208,18,11,7,39,109,57,65,0,0
3218,1639,96,1679,206,18,11,7,40,110,58,65,0,0
3219,1642,97,1680,204,18,11,7,38,107,59,65,0,0
3220,1645,97,1683,202,18,11,7,38,105,60,65,0,0
3221,1648,96,1686,201,18,11,7,38,105,61,65,0,0
3222,1650,97,1687,200,18,11,7,37,103,62,65,0,0
3223,1654,97,1689,195,18,11,7,35,98,63,65,0,0
3224,1657,94,1692,194,18,11,7,35,100,64,65,0,0
3225,1659,95,1694,194,18,11,7,35,99,65,65,1,0
3229,1665,87,1700,187,18,11,7,35,100,0,65,0,0
3230,1665,85,1700,186,18,11,7,35,101,1,65,0,0
3270,1098,351,1783,1044,19,11,7,685,693,0,2,0,0
3271,1130,324,1783,1012,19,11,7,653,688,1,2,0,0
3272,1150,273,1846,1006,19,11,7,696,733,2,2,0,0
3272,1358,305,1575,880,20,11,7,217,575,0,58,0,1
3273,1390,294,1596,840,20,11,7,206,546,1,58,0,0
3274,1399,275,1603,818,20,11,7,204,543,2,58,0,0
3275,1419,255,1605,749,20,11,7,186,494,3,58,0,0
3276,1431,246,1615,736,20,11,7,184,490,4,58,0,0
3277,1444,232,1614,686,20,11,7,170,454,5,58,0,0
3278,1469,220,1623,634,20,11,7,154,414,6,58,0,0
3279,1483,212,1628,607,20,11,7,145,395,7,58,0,0
3280,1496,198,1633,571,20,11,7,137,373,8,58,0,0
3281,1500,194,1636,568,20,11,7,136,374,9,58,0,0
3282,1504,189,1635,548,20,11,7,131,359,10,58,0,0
3283,1516,174,1639,515,20,11,7,123,341,11,58,0,0
3284,1528,171,1642,491,20,11,7,114,320,12,58,0,0
3285,1534,168,1640,470,20,11,7,106,302,13,58,0,0
3286,1539,166,1641,454,20,11,7,102,288,14,58,0,0
3287,1535,166,1638,455,20,11,7,103,289,15,58,0,0
3288,1539,151,1639,432,20,11,7,100,281,16,58,0,0
3289,1556,152,1653,419,20,11,7,97,267,17,58,0,0
3290,1566,146,1662,401,20,11,7,96,255,18,58,0,0
3291,1571,144,1665,391,20,11,7,94,247,19,58,0,0
3292,1578,143,1669,386,20,11,7,91,243,20,58,0,0
3293,1584,137,1670,371,20,11,7,86,234,21,58,0,0
3294,1587,132,1671,364,20,11,7,84,232,22,58,0,0
3295,1592,132,1673,356,20,11,7,81,224,23,58,0,0
3296,1598,127,1676,344,20,11,7,78,217,24,58,0,0
3297,1603,128,1678,338,20,11,7,75,210,25,58,0,0
3298,1605,127,1675,326,20,11,7,70,199,26,58,0,0
3299,1604,117,1675,321,20,11,7,71,204,27,58,0,0
3300,1608,126,1673,316,20,11,7,65,190,28,58,0,0
3301,1607,118,1671,306,20,11,7,64,188,29,58,0,0
3302,1611,120,1670,296,20,11,7,59,176,30,58,0,0
3303,1609,116,1668,290,20,11,7,59,174,31,58,0,0
3304,1608,114,1666,285,20,11,7,58,171,32,58,0,0
3305,1610,112,1667,282,20,11,7,57,170,33,58,0,0
3306,1613,106,1670,275,20,11,7,57,169,34,58,0,0
3307,1613,104,1668,271,20,11,7,55,167,35,58,0,0
3308,1612,104,1666,268,20,11,7,54,164,36,58,0,0
3309,1610,97,1663,261,20,11,7,53,164,37,58,0,0
3310,1611,96,1662,258,20,11,7,51,162,38,58,0,0
3311,1612,97,1661,249,20,11,7,49,152,39,58,0,0
3312,1612,97,1659,245,20,11,7,47,148,40,58,0,0
3313,1612,95,1658,243,20,11,7,46,148,41,58,0,0
3314,1610,93,1656,238,20,11,7,46,145,42,58,0,0
3315,1610,90,1655,234,20,11,7,45,144,43,58,0,0
3316,1609,89,1653,231,20,11,7,44,142,44,58,0,0
3317,1608,86,1653,228,20,11,7,45,142,45,58,0,0
3318,1608,85,1653,227,20,11,7,45,142,46,58,0,0
3319,1606,85,1650,222,20,11,7,44,137,47,58,0,0
3320,1606,85,1650,220,20,11,7,44,135,48,58,0,0
3321,1607,81,1651,216,20,11,7,44,135,49,58,0,0
3322,1609,81,1652,212,20,11,7,43,131,50,58,0,0
3323,1610,86,1650,209,20,11,7,40,123,51,58,0,0
3324,1611,87,1651,206,20,11,7,40,119,52,58,0,0
3325,1612,82,1652,204,20,11,7,40,122,53,58,0,0
3326,1617,86,1655,200,20,11,7,38,114,54,58,0,0
3327,1620,86,1657,199,20,11,7,37,113,55,58,0,0
3328,1624,85,1660,197,20,11,7,36,112,56,58,0,0
3329,1627,82,1663,196,20,11,7,36,114,57,58,0,0
3330,1629,82,1664,193,20,11,7,35,111,58,58,1,0
3338,1637,73,1672,178,20,11,7,35,105,0,58,0,0
3339,1637,71,1672,177,20,11,7,35,106,1,58,0,0
3340,1637,72,1672,176,20,11,7,35,104,2,58,0,0
3341,1635,72,1670,175,20,11,7,35,103,3,58,0,0
3344,1635,70,1670,169,20,11,7,35,99,0,58,0,0
3345,1635,69,1670,168,20,11,7,35,99,1,58,0,0
3346,1635,68,1671,165,20,11,7,36,97,2,58,0,0
3347,1638,70,1673,163,20,11,7,35,93,3,58,0,0
3349,1641,67,1676,162,20,11,7,35,95,0,58,0,0
3350,1642,68,1677,162,20,11,7,35,94,1,58,0,0
4717,1610,73,1646,187,25,11,7,36,114,0,69,0,1
4718,1609,75,1645,190,25,11,7,36,115,1,69,0,0
4719,1606,78,1642,192,25,11,7,36,114,2,69,0,0
4720,1603,75,1641,194,25,11,7,38,119,3,69,0,0
4721,1599,80,1636,196,25,11,7,37,116,4,69,0,0
4722,1593,80,1630,198,25,11,7,37,118,5,69,0,0
4723,1589,78,1627,200,25,11,7,38,122,6,69,0,0
4724,1585,80,1624,202,25,11,7,39,122,7,69,0,0
4725,1580,78,1622,207,25,11,7,42,129,8,69,0,0
4726,1577,78,1620,209,25,11,7,43,131,9,69,0,0
4727,1573,78,1616,210,25,11,7,43,132,10,69,0,0
4728,1569,78,1614,217,25,11,7,45,139,11,69,0,0
4729,1566,81,1612,221,25,11,7,46,140,12,69,0,0
4730,1565,80,1613,222,25,11,7,48,142,13,69,0,0
4731,1564,81,1613,224,25,11,7,49,143,14,69,0,0
4732,1560,84,1608,226,25,11,7,48,142,15,69,0,0
4733,1558,86,1606,228,25,11,7,48,142,16,69,0,0
4734,1557,89,1605,231,25,11,7,48,142,17,69,0,0
4735,1554,89,1606,234,25,11,7,52,145,18,69,0,0
4736,1555,97,1605,238,25,11,7,50,141,19,69,0,0
4737,1555,98,1605,241,25,11,7,50,143,20,69,0,0
4738,1556,99,1606,245,25,11,7,50,146,21,69,0,0
4739,1557,97,1610,252,25,11,7,53,155,22,69,0,0
4740,1559,98,1613,253,25,11,7,54,155,23,69,0,0
4741,1558,102,1613,259,25,11,7,55,157,24,69,0,0
4742,1556,103,1610,263,25,11,7,54,160,25,69,0,0
4743,1553,108,1607,266,25,11,7,54,158,26,69,0,0
4744,1553,107,1608,270,25,11,7,55,163,27,69,0,0
4745,1555,105,1611,272,25,11,7,56,167,28,69,0,0
4746,1552,105,1611,278,25,11,7,59,173,29,69,0,0
4747,1545,101,1607,285,25,11,7,62,184,30,69,0,0
4748,1541,106,1601,285,25,11,7,60,179,31,69,0,0
4749,1539,108,1602,296,25,11,7,63,188,32,69,0,0
4750,1535,104,1600,301,25,11,7,65,197,33,69,0,0
4751,1526,107,1592,308,25,11,7,66,201,34,69,0,0
4752,1519,108,1585,310,25,11,7,66,202,35,69,0,0
4753,1514,108,1582,321,25,11,7,68,213,36,69,0,0
4754,1507,108,1578,329,25,11,7,71,221,37,69,0,0
4755,1500,105,1573,334,25,11,7,73,229,38,69,0,0
4756,1488,106,1564,347,25,11,7,76,241,39,69,0,0
4757,1479,111,1554,348,25,11,7,75,237,40,69,0,0
4758,1471,117,1547,357,25,11,7,76,240,41,69,0,0
4759,1465,123,1542,367,25,11,7,77,244,42,69,0,0
4760,1455,122,1534,373,25,11,7,79,251,43,69,0,0
4761,1445,132,1525,384,25,11,7,80,252,44,69,0,0
4762,1435,131,1519,398,25,11,7,84,267,45,69,0,0
4763,1431,138,1518,416,25,11,7,87,278,46,69,0,0
4764,1427,140,1517,429,25,11,7,90,289,47,69,0,0
4765,1417,142,1512,445,25,11,7,95,303,48,69,0,0
4766,1401,148,1500,463,25,11,7,99,315,49,69,0,0
4767,1391,152,1491,474,25,11,7,100,322,50,69,0,0
4768,1382,160,1486,493,25,11,7,104,333,51,69,0,0
4769,1375,165,1486,514,25,11,7,111,349,52,69,0,0
4770,1361,165,1478,531,25,11,7,117,366,53,69,0,0
4771,1343,174,1466,559,25,11,7,123,385,54,69,0,0
4772,1333,178,1458,570,25,11,7,125,392,55,69,0,0
4773,1323,187,1458,610,25,11,7,135,423,56,69,0,0
4774,1319,201,1460,644,25,11,7,141,443,57,69,0,0
4775,1312,206,1458,661,25,11,7,146,455,58,69,0,0
4776,1299,227,1450,695,25,11,7,151,468,59,69,0,0
4777,1293,241,1446,715,25,11,7,153,474,60,69,0,0
4778,1292,255,1456,759,25,11,7,164,504,61,69,0,0
4779,1293,282,1467,817,25,11,7,174,535,62,69,0,0
4780,1303,287,1487,839,25,11,7,184,552,63,69,0,0
4781,1330,302,1527,898,25,11,7,197,596,64,69,0,0
4782,1353,327,1561,951,25,11,7,208,624,65,69,0,0
4783,1370,341,1585,981,25,11,7,215,640,66,69,0,0
4784,1384,375,1613,1039,25,11,7,229,664,67,69,0,0
4785,1437,396,1676,1053,25,11,7,239,657,68,69,0,0
4786,1443,409,1687,1080,25,11,7,244,671,69,69,1,0
4574,4,438,39,630,27,11,7,35,192,0,25,0,1
4575,13,431,51,639,27,11,7,38,208,1,25,0,0
4576,6,386,61,683,27,11,7,55,297,2,25,0,0
4577,3,366,65,699,27,11,7,62,333,3,25,0,0
4578,10,348,80,716,27,11,7,70,368,4,25,0,0
4579,18,355,94,740,27,11,7,76,385,5,25,0,0
4580,20,346,105,760,27,11,7,85,414,6,25,0,0
4581,19,326,120,805,27,11,7,101,479,7,25,0,0
4582,26,337,137,843,27,11,7,111,506,8,25,0,0
4583,30,334,151,860,27,11,7,121,526,9,25,0,0
4584,58,345,195,881,27,11,7,137,536,10,25,0,0
4585,76,356,228,909,27,11,7,152,553,11,25,0,0
4586,88,355,258,938,27,11,7,170,583,12,25,0,0
4587,125,368,319,992,27,11,7,194,624,13,25,0,0
4588,162,388,376,1038,27,11,7,214,650,14,25,0,0
4589,205,392,435,1055,27,11,7,230,663,15,25,0,0
4590,285,420,527,1069,27,11,7,242,649,16,25,0,0
4591,338,425,590,1075,27,11,7,252,650,17,25,0,0
4592,394,423,655,1080,27,11,7,261,657,18,25,0,0
4593,485,454,744,1080,27,11,7,259,626,19,25,0,0
4594,601,474,860,1080,27,11,7,259,606,20,25,0,0
4595,743,490,1005,1080,27,11,7,262,590,21,25,0,0
4596,889,529,1142,1080,27,11,7,253,551,22,25,0,0
4597,1019,533,1288,1079,27,11,7,269,546,23,25,0,0
4598,1169,568,1448,1077,27,11,7,279,509,24,25,0,0
4599,1253,579,1531,1080,27,11,7,278,501,25,25,1,0
4589,5,346,42,575,28,11,7,37,229,0,27,0,1
4590,6,336,47,590,28,11,7,41,254,1,27,0,0
4591,11,327,58,608,28,11,7,47,281,2,27,0,0
4592,14,316,66,617,28,11,7,52,301,3,27,0,0
4593,27,304,86,626,28,11,7,59,322,4,27,0,0
4594,34,311,100,643,28,11,7,66,332,5,27,0,0
4595,36,303,110,655,28,11,7,74,352,6,27,0,0
4596,43,310,126,683,28,11,7,83,373,7,27,0,0
4597,52,317,143,705,28,11,7,91,388,8,27,0,0
4598,63,323,159,712,28,11,7,96,389,9,27,0,0
4599,95,328,203,732,28,11,7,108,404,10,27,0,0
4600,117,334,232,745,28,11,7,115,411,11,27,0,0
4601,133,326,264,781,28,11,7,131,455,12,27,0,0
4602,167,342,310,814,28,11,7,143,472,13,27,0,0
4603,191,346,342,829,28,11,7,151,483,14,27,0,0
4604,241,355,404,844,28,11,7,163,489,15,27,0,0
4605,286,367,466,879,28,11,7,180,512,16,27,0,0
4606,319,371,510,899,28,11,7,191,528,17,27,0,0
4607,371,383,585,956,28,11,7,214,573,18,27,0,0
4608,423,403,648,994,28,11,7,225,591,19,27,0,0
4609,478,401,716,1015,28,11,7,238,614,20,27,0,0
4610,575,421,831,1055,28,11,7,256,634,21,27,0,0
4611,651,430,911,1075,28,11,7,260,645,22,27,0,0
4612,762,446,1026,1078,28,11,7,264,632,23,27,0,0
4613,870,479,1138,1080,28,11,7,268,601,24,27,0,0
4614,984,501,1243,1080,28,11,7,259,579,25,27,0,0
4615,1111,533,1354,1076,28,11,7,243,543,26,27,0,0
4616,1175,545,1420,1080,28,11,7,245,535,27,27,1,0
4606,19,363,62,668,31,11,7,43,305,0,23,0,1
4607,25,365,71,679,31,11,7,46,314,1,23,0,0
4608,25,330,81,702,31,11,7,56,372,2,23,0,0
4609,33,329,98,737,31,11,7,65,408,3,23,0,0
4610,40,335,110,746,31,11,7,70,411,4,23,0,0
4611,61,340,141,753,31,11,7,80,413,5,23,0,0
4612,78,339,171,768,31,11,7,93,429,6,23,0,0
4613,94,346,195,780,31,11,7,101,434,7,23,0,0
4614,110,356,227,823,31,11,7,117,467,8,23,0,0
4615,130,374,259,858,31,11,7,129,484,9,23,0,0
4616,150,381,290,872,31,11,7,140,491,10,23,0,0
4617,193,403,347,898,31,11,7,154,495,11,23,0,0
4618,228,411,394,918,31,11,7,166,507,12,23,0,0
4619,259,413,451,979,31,11,7,192,566,13,23,0,0
4620,308,429,523,1039,31,11,7,215,610,14,23,0,0
4621,352,445,578,1061,31,11,7,226,616,15,23,0,0
4622,431,463,672,1078,31,11,7,241,615,16,23,0,0
4623,502,486,745,1080,31,11,7,243,594,17,23,0,0
4624,580,475,835,1080,31,11,7,255,605,18,23,0,0
4625,716,509,977,1080,31,11,7,261,571,19,23,0,0
4626,835,537,1096,1079,31,11,7,261,542,20,23,0,0
4627,918,548,1174,1077,31,11,7,256,529,21,23,0,0
4628,1001,590,1251,1080,31,11,7,250,490,22,23,0,0
4629,1063,604,1313,1080,31,11,7,250,476,23,23,1,0
4613,3,267,49,522,32,11,7,46,255,0,34,0,1
4614,5,265,54,535,32,11,7,49,270,1,34,0,0
4615,11,273,61,544,32,11,7,50,271,2,34,0,0
4616,18,270,71,548,32,11,7,53,278,3,34,0,0
4617,35,271,93,561,32,11,7,58,290,4,34,0,0
4618,46,283,105,565,32,11,7,59,282,5,34,0,0
4619,51,282,117,578,32,11,7,66,296,6,34,0,0
4620,62,281,135,596,32,11,7,73,315,7,34,0,0
4621,74,283,153,613,32,11,7,79,330,8,34,0,0
4622,88,278,174,620,32,11,7,86,342,9,34,0,0
4623,120,281,217,635,32,11,7,97,354,10,34,0,0
4624,143,284,245,643,32,11,7,102,359,11,34,0,0
4625,152,280,263,663,32,11,7,111,383,12,34,0,0
4626,180,285,302,689,32,11,7,122,404,13,34,0,0
4627,199,283,330,707,32,11,7,131,424,14,34,0,0
4628,233,277,376,717,32,11,7,143,440,15,34,0,0
4629,272,279,431,744,32,11,7,159,465,16,34,0,0
4630,303,286,466,753,32,11,7,163,467,17,34,0,0
4631,328,294,502,788,32,11,7,174,494,18,34,0,0
4632,369,314,553,827,32,11,7,184,513,19,34,0,0
4633,403,313,596,849,32,11,7,193,536,20,34,0,0
4634,473,317,688,880,32,11,7,215,563,21,34,0,0
4635,531,329,757,904,32,11,7,226,575,22,34,0,0
4636,575,331,806,922,32,11,7,231,591,23,34,0,0
4637,652,347,906,983,32,11,7,254,636,24,34,0,0
4638,719,370,985,1036,32,11,7,266,666,25,34,0,0
4639,796,380,1065,1053,32,11,7,269,673,26,34,0,0
4640,907,392,1183,1074,32,11,7,276,682,27,34,0,0
4641,990,425,1262,1071,32,11,7,272,646,28,34,0,0
4642,1110,440,1384,1080,32,11,7,274,640,29,34,0,0
4643,1236,479,1499,1075,32,11,7,263,596,30,34,0,0
4644,1388,517,1639,1070,32,11,7,251,553,31,34,0,0
4645,1544,545,1785,1071,32,11,7,241,526,32,34,0,0
4646,1659,590,1884,1069,32,11,7,225,479,33,34,0,0
4647,1748,611,1920,1080,32,11,7,172,469,34,34,1,0
4616,1330,565,1549,1064,33,11,7,219,499,0,0,0,0
4617,1461,576,1701,1065,34,11,7,240,489,0,0,0,0
4618,1580,634,1879,1080,35,11,7,299,446,0,1,0,0
4619,1678,667,1920,1080,35,11,7,242,413,1,1,0,0
4629,1207,589,1470,1072,37,11,7,263,483,0,0,0,0
4630,1338,613,1679,1072,39,11,7,341,459,0,1,0,0
4631,1469,674,1770,1078,39,11,7,301,404,1,1,0,0
4636,735,387,811,526,40,11,7,76,139,0,0,0,0
4786,1558,449,1874,1062,47,11,7,316,613,0,1,0,0
4787,1611,503,1891,1043,47,11,7,280,540,1,1,0,0
5420,1685,741,1914,1079,51,11,7,229,338,0,0,0,0
5421,1529,699,1790,1072,52,11,7,261,373,0,0,0,0
5422,1349,711,1650,1070,53,11,7,301,359,0,23,0,1
5423,1216,663,1550,1063,53,11,7,334,400,1,23,0,0
5424,1052,653,1404,1072,53,11,7,352,419,2,23,0,0
5425,932,630,1304,1076,53,11,7,372,446,3,23,0,0
5426,816,596,1210,1076,53,11,7,394,480,4,23,0,0
5427,705,586,1098,1072,53,11,7,393,486,5,23,0,0
5428,565,564,971,1076,53,11,7,406,512,6,23,0,0
5429,436,557,845,1075,53,11,7,409,518,7,23,0,0
5430,346,533,764,1077,53,11,7,418,544,8,23,0,0
5431,279,513,699,1075,53,11,7,420,562,9,23,0,0
5432,231,517,642,1072,53,11,7,411,555,10,23,0,0
5433,147,502,550,1061,53,11,7,403,559,11,23,0,0
5434,81,492,482,1058,53,11,7,401,566,12,23,0,0
5435,37,478,424,1038,53,11,7,387,560,13,23,0,0
5436,4,462,359,989,53,11,7,355,527,14,23,0,0
5437,0,456,317,956,53,11,7,317,500,15,23,0,0
5438,0,442,259,926,53,11,7,259,484,16,23,0,0
5439,0,438,222,905,53,11,7,222,467,17,23,0,0
5440,0,422,187,878,53,11,7,187,456,18,23,0,0
5441,0,415,163,841,53,11,7,163,426,19,23,0,0
5442,0,442,141,815,53,11,7,141,373,20,23,0,0
5443,0,446,113,784,53,11,7,113,338,21,23,0,0
5444,0,454,100,776,53,11,7,100,322,22,23,0,0
5445,0,451,60,757,53,11,7,60,306,23,23,1,0
5445,1,453,42,744,54,11,7,41,291,0,0,0,0
3043,1433,105,1477,277,1,11,8,44,172,0,7,0,0
3044,1445,113,1481,252,1,11,8,36,139,1,7,0,0
3046,1482,109,1518,240,1,11,8,36,131,0,7,0,0
3047,1501,106,1537,238,1,11,8,36,132,1,7,0,0
3048,1525,107,1562,236,1,11,8,37,129,2,7,0,0
3049,1546,107,1585,237,1,11,8,39,130,3,7,0,0
3050,1566,112,1603,239,1,11,8,37,127,4,7,0,0
3051,1584,112,1624,240,1,11,8,40,128,5,7,0,0
3052,1607,110,1645,236,1,11,8,38,126,6,7,0,0
3053,1626,110,1664,234,1,11,8,38,124,7,7,0,0
3735,1602,115,1639,239,3,11,8,37,124,0,15,0,0
3736,1587,114,1628,248,3,11,8,41,134,1,15,0,0
3737,1574,114,1615,249,3,11,8,41,135,2,15,0,0
3738,1559,111,1602,253,3,11,8,43,142,3,15,0,0
3739,1549,111,1594,257,3,11,8,45,146,4,15,0,0
3740,1531,111,1577,258,3,11,8,46,147,5,15,0,0
3741,1507,110,1555,259,3,11,8,48,149,6,15,0,0
3742,1494,109,1543,261,3,11,8,49,152,7,15,0,0
3743,1481,109,1531,264,3,11,8,50,155,8,15,0,0
3744,1473,109,1525,269,3,11,8,52,160,9,15,0,0
3745,1460,111,1511,268,3,11,8,51,157,10,15,0,0
3746,1443,111,1495,270,3,11,8,52,159,11,15,0,0
3747,1434,114,1484,270,3,11,8,50,156,12,15,0,0
3748,1425,116,1474,269,3,11,8,49,153,13,15,0,0
3749,1417,118,1468,273,3,11,8,51,155,14,15,0,0
3750,1406,119,1456,275,3,11,8,50,156,15,15,0,0
4031,1415,121,1461,280,4,11,8,46,159,0,14,0,0
4032,1427,119,1473,277,4,11,8,46,158,1,14,0,0
4033,1439,119,1484,276,4,11,8,45,157,2,14,0,0
4034,1456,115,1499,264,4,11,8,43,149,3,14,0,0
4035,1479,110,1524,262,4,11,8,45,152,4,14,0,0
4036,1492,111,1538,261,4,11,8,46,150,5,14,0,0
4037,1504,109,1549,259,4,11,8,45,150,6,14,0,0
4038,1515,110,1562,259,4,11,8,47,149,7,14,0,0
4039,1532,111,1577,255,4,11,8,45,144,8,14,0,0
4040,1550,110,1595,253,4,11,8,45,143,9,14,0,0
4041,1564,111,1611,253,4,11,8,47,142,10,14,0,0
4042,1579,110,1625,251,4,11,8,46,141,11,14,0,0
4043,1594,110,1638,248,4,11,8,44,138,12,14,0,0
4044,1607,108,1651,245,4,11,8,44,137,13,14,0,0
4045,1622,107,1665,243,4,11,8,43,136,14,14,0,0
226,438,84,473,182,7,11,9,35,98,0,86,0,0
227,439,83,474,181,7,11,9,35,98,1,86,0,0
228,441,82,477,181,7,11,9,36,99,2,86,0,0
229,441,79,478,184,7,11,9,37,105,3,86,0,0
230,439,77,478,185,7,11,9,39,108,4,86,0,0
231,445,81,482,185,7,11,9,37,104,5,86,0,0
232,449,83,484,182,7,11,9,35,99,6,86,0,0
234,449,83,485,187,7,11,9,36,104,0,86,0,0
235,449,85,484,188,7,11,9,35,103,1,86,0,0
240,453,83,488,189,7,11,9,35,106,0,86,0,1
241,452,82,489,194,7,11,9,37,112,1,86,0,0
242,454,86,489,195,7,11,9,35,109,2,86,0,0
243,454,86,490,198,7,11,9,36,112,3,86,0,0
244,452,85,488,199,7,11,9,36,114,4,86,0,0
245,449,85,488,205,7,11,9,39,120,5,86,0,0
246,445,83,487,209,7,11,9,42,126,6,86,0,0
247,444,81,488,211,7,11,9,44,130,7,86,0,0
248,446,81,490,213,7,11,9,44,132,8,86,0,0
249,446,81,491,212,7,11,9,45,131,9,86,0,0
250,444,79,491,214,7,11,9,47,135,10,86,0,0
251,446,81,493,218,7,11,9,47,137,11,86,0,0
252,450,82,496,218,7,11,9,46,136,12,86,0,0
253,453,83,497,216,7,11,9,44,133,13,86,0,0
254,456,85,498,214,7,11,9,42,129,14,86,0,0
255,454,85,498,219,7,11,9,44,134,15,86,0,0
256,448,82,496,226,7,11,9,48,144,16,86,0,0
257,451,86,499,232,7,11,9,48,146,17,86,0,0
258,457,94,502,233,7,11,9,45,139,18,86,0,0
259,459,92,505,236,7,11,9,46,144,19,86,0,0
260,462,100,505,235,7,11,9,43,135,20,86,0,0
261,461,99,506,239,7,11,9,45,140,21,86,0,0
262,463,102,508,246,7,11,9,45,144,22,86,0,0
263,466,104,511,246,7,11,9,45,142,23,86,0,0
264,468,102,514,249,7,11,9,46,147,24,86,0,0
265,469,103,516,253,7,11,9,47,150,25,86,0,0
266,470,104,517,254,7,11,9,47,150,26,86,0,0
267,469,105,516,258,7,11,9,47,153,27,86,0,0
268,470,106,518,265,7,11,9,48,159,28,86,0,0
269,471,110,519,267,7,11,9,48,157,29,86,0,0
270,472,106,521,270,7,11,9,49,164,30,86,0,0
271,471,106,522,274,7,11,9,51,168,31,86,0,0
272,470,102,523,276,7,11,9,53,174,32,86,0,0
273,472,112,523,279,7,11,9,51,167,33,86,0,0
274,472,117,523,284,7,11,9,51,167,34,86,0,0
275,472,117,524,286,7,11,9,52,169,35,86,0,0
276,471,119,524,292,7,11,9,53,173,36,86,0,0
277,470,119,525,297,7,11,9,55,178,37,86,0,0
278,469,119,526,302,7,11,9,57,183,38,86,0,0
279,469,123,526,307,7,11,9,57,184,39,86,0,0
280,467,126,525,311,7,11,9,58,185,40,86,0,0
281,464,126,523,314,7,11,9,59,188,41,86,0,0
282,461,133,522,323,7,11,9,61,190,42,86,0,0
283,458,139,519,328,7,11,9,61,189,43,86,0,0
284,454,140,517,334,7,11,9,63,194,44,86,0,0
285,448,142,514,342,7,11,9,66,200,45,86,0,0
286,446,142,514,346,7,11,9,68,204,46,86,0,0
287,441,143,512,353,7,11,9,71,210,47,86,0,0
288,439,149,511,362,7,11,9,72,213,48,86,0,0
289,436,152,510,367,7,11,9,74,215,49,86,0,0
290,432,159,506,377,7,11,9,74,218,50,86,0,0
291,431,164,508,386,7,11,9,77,222,51,86,0,0
292,428,161,508,392,7,11,9,80,231,52,86,0,0
293,425,169,506,401,7,11,9,81,232,53,86,0,0
294,417,170,502,411,7,11,9,85,241,54,86,0,0
295,420,170,509,419,7,11,9,89,249,55,86,0,0
296,420,176,514,432,7,11,9,94,256,56,86,0,0
297,416,177,514,441,7,11,9,98,264,57,86,0,0
298,411,180,512,455,7,11,9,101,275,58,86,0,0
299,408,185,514,476,7,11,9,106,291,59,86,0,0
300,410,184,519,483,7,11,9,109,299,60,86,0,0
301,416,185,531,501,7,11,9,115,316,61,86,0,0
302,419,191,542,522,7,11,9,123,331,62,86,0,0
303,421,190,549,533,7,11,9,128,343,63,86,0,0
304,424,198,553,546,7,11,9,129,348,64,86,0,0
305,427,211,559,567,7,11,9,132,356,65,86,0,0
306,436,213,573,581,7,11,9,137,368,66,86,0,0
307,439,225,586,612,7,11,9,147,387,67,86,0,0
308,443,231,597,631,7,11,9,154,400,68,86,0,0
309,442,232,605,658,7,11,9,163,426,69,86,0,0
310,441,247,611,695,7,11,9,170,448,70,86,0,0
311,442,256,617,718,7,11,9,175,462,71,86,0,0
312,444,260,634,751,7,11,9,190,491,72,86,0,0
313,441,274,648,805,7,11,9,207,531,73,86,0,0
314,444,283,653,815,7,11,9,209,532,74,86,0,0
315,437,299,663,879,7,11,9,226,580,75,86,0,0
316,435,324,672,939,7,11,9,237,615,76,86,0,0
317,442,338,688,969,7,11,9,246,631,77,86,0,0
318,443,374,710,1045,7,11,9,267,671,78,86,0,0
319,453,409,726,1074,7,11,9,273,665,79,86,0,0
320,457,439,732,1080,7,11,9,275,641,80,86,0,0
321,473,508,729,1080,7,11,9,256,572,81,86,0,0
322,491,588,729,1080,7,11,9,238,492,82,86,0,0
323,531,675,754,1080,7,11,9,223,405,83,86,0,0
324,594,816,772,1076,7,11,9,178,260,84,86,0,0
325,672,924,807,1079,7,11,9,135,155,85,86,0,0
326,718,988,809,1080,7,11,9,91,92,86,86,1,0
349,1,854,112,1075,8,11,9,111,221,0,0,0,0
350,5,493,192,1078,9,11,9,187,585,0,1,0,0
351,37,436,243,1079,9,11,9,206,643,1,1,0,0
352,151,417,495,1078,10,11,9,344,661,0,83,0,1
353,200,403,541,1062,10,11,9,341,659,1,83,0,0
354,264,371,622,1069,10,11,9,358,698,2,83,0,0
355,330,350,679,1039,10,11,9,349,689,3,83,0,0
356,396,328,723,980,10,11,9,327,652,4,83,0,0
357,447,320,756,944,10,11,9,309,624,5,83,0,0
358,479,291,758,863,10,11,9,279,572,6,83,0,0
359,490,275,757,834,10,11,9,267,559,7,83,0,0
360,494,265,738,787,10,11,9,244,522,8,83,0,0
361,485,241,708,728,10,11,9,223,487,9,83,0,0
362,469,233,685,717,10,11,9,216,484,10,83,0,0
363,459,221,655,664,10,11,9,196,443,11,83,0,0
364,449,213,636,646,10,11,9,187,433,12,83,0,0
365,438,211,612,621,10,11,9,174,410,13,83,0,0
366,428,201,590,590,10,11,9,162,389,14,83,0,0
367,423,202,577,579,10,11,9,154,377,15,83,0,0
368,430,194,571,546,10,11,9,141,352,16,83,0,0
369,432,183,570,532,10,11,9,138,349,17,83,0,0
370,434,180,567,523,10,11,9,133,343,18,83,0,0
371,435,174,555,494,10,11,9,120,320,19,83,0,0
372,431,171,546,483,10,11,9,115,312,20,83,0,0
373,432,169,539,464,10,11,9,107,295,21,83,0,0
374,429,161,533,453,10,11,9,104,292,22,83,0,0
375,423,159,523,446,10,11,9,100,287,23,83,0,0
376,421,153,514,425,10,11,9,93,272,24,83,0,0
377,418,153,508,417,10,11,9,90,264,25,83,0,0
378,420,148,506,404,10,11,9,86,256,26,83,0,0
379,420,136,508,399,10,11,9,88,263,27,83,0,0
380,421,134,505,390,10,11,9,84,256,28,83,0,0
381,422,118,507,378,10,11,9,85,260,29,83,0,0
382,424,111,508,374,10,11,9,84,263,30,83,0,0
383,429,107,510,364,10,11,9,81,257,31,83,0,0
384,437,123,510,354,10,11,9,73,231,32,83,0,0
385,441,126,510,346,10,11,9,69,220,33,83,0,0
386,443,128,507,334,10,11,9,64,206,34,83,0,0
387,443,128,507,331,10,11,9,64,203,35,83,0,0
388,443,108,510,323,10,11,9,67,215,36,83,0,0
389,443,100,511,320,10,11,9,68,220,37,83,0,0
390,447,113,509,311,10,11,9,62,198,38,83,0,0
391,445,101,508,305,10,11,9,63,204,39,83,0,0
392,445,100,507,301,10,11,9,62,201,40,83,0,0
393,445,96,507,295,10,11,9,62,199,41,83,0,0
394,446,95,507,293,10,11,9,61,198,42,83,0,0
395,445,103,503,290,10,11,9,58,187,43,83,0,0
396,440,92,499,282,10,11,9,59,190,44,83,0,0
397,438,93,496,277,10,11,9,58,184,45,83,0,0
398,437,93,494,273,10,11,9,57,180,46,83,0,0
399,435,92,492,269,10,11,9,57,177,47,83,0,0
400,432,89,491,269,10,11,9,59,180,48,83,0,0
401,430,86,489,263,10,11,9,59,177,49,83,0,0
402,430,91,486,260,10,11,9,56,169,50,83,0,0
403,431,91,485,256,10,11,9,54,165,51,83,0,0
404,431,87,486,255,10,11,9,55,168,52,83,0,0
405,431,87,487,254,10,11,9,56,167,53,83,0,0
406,431,88,486,251,10,11,9,55,163,54,83,0,0
407,429,88,485,250,10,11,9,56,162,55,83,0,0
408,432,87,485,244,10,11,9,53,157,56,83,0,0
409,433,86,486,240,10,11,9,53,154,57,83,0,0
410,434,87,486,239,10,11,9,52,152,58,83,0,0
411,435,86,485,232,10,11,9,50,146,59,83,0,0
412,434,87,483,230,10,11,9,49,143,60,83,0,0
413,435,86,482,226,10,11,9,47,140,61,83,0,0
414,435,85,483,222,10,11,9,48,137,62,83,0,0
415,435,84,483,223,10,11,9,48,139,63,83,0,0
416,436,85,483,219,10,11,9,47,134,64,83,0,0
417,436,85,483,219,10,11,9,47,134,65,83,0,0
418,437,85,484,218,10,11,9,47,133,66,83,0,0
419,439,87,485,215,10,11,9,46,128,67,83,0,0
420,439,84,486,214,10,11,9,47,130,68,83,0,0
421,437,83,483,212,10,11,9,46,129,69,83,0,0
422,436,84,481,209,10,11,9,45,125,70,83,0,0
423,436,83,480,208,10,11,9,44,125,71,83,0,0
424,435,82,478,205,10,11,9,43,123,72,83,0,0
425,436,82,479,203,10,11,9,43,121,73,83,0,0
426,437,83,478,199,10,11,9,41,116,74,83,0,0
427,437,83,477,197,10,11,9,40,114,75,83,0,0
428,436,83,476,194,10,11,9,40,111,76,83,0,0
429,436,83,475,192,10,11,9,39,109,77,83,0,0
430,436,84,474,191,10,11,9,38,107,78,83,0,0
431,436,82,473,188,10,11,9,37,106,79,83,0,0
432,437,84,473,185,10,11,9,36,101,80,83,0,0
433,437,84,473,183,10,11,9,36,99,81,83,0,0
434,438,84,473,184,10,11,9,35,100,82,83,0,0
435,437,85,473,184,10,11,9,36,99,83,83,1,0
652,1838,936,1888,1006,13,11,9,50,70,0,0,0,0
654,1827,939,1871,1012,14,11,9,44,73,0,0,0,0
1302,1415,598,1457,694,23,11,9,42,96,0,4,0,0
1303,1416,598,1456,690,23,11,9,40,92,1,4,0,0
1304,1417,597,1457,689,23,11,9,40,92,2,4,0,0
1305,1420,599,1458,685,23,11,9,38,86,3,4,0,0
1306,1422,599,1458,684,23,11,9,36,85,4,4,0,0
1317,1408,596,1454,697,23,11,9,46,101,0,4,0,0
1318,1407,595,1454,698,23,11,9,47,103,1,4,0,0
1316,1398,618,1435,696,25,11,9,37,78,0,3,0,0
1317,1400,613,1438,694,25,11,9,38,81,1,3,0,0
1319,1406,609,1442,687,25,11,9,36,78,0,3,0,0
1320,1409,600,1447,685,25,11,9,38,85,1,3,0,0
1321,1414,598,1452,683,25,11,9,38,85,2,3,0,0
1322,1417,594,1456,681,25,11,9,39,87,3,3,0,0
1326,1435,590,1470,666,25,11,9,35,76,0,3,0,0
1316,1403,591,1482,696,29,11,9,79,105,0,0,0,0
1418,1508,585,1544,659,33,11,9,36,74,0,0,0,0
1422,1504,583,1548,661,34,11,9,44,78,0,6,0,0
1423,1505,582,1551,664,34,11,9,46,82,1,6,0,0
1424,1506,576,1554,662,34,11,9,48,86,2,6,0,0
1425,1507,574,1557,663,34,11,9,50,89,3,6,0,0
1426,1509,580,1558,668,34,11,9,49,88,4,6,0,0
1427,1509,588,1557,675,34,11,9,48,87,5,6,0,0
1428,1510,590,1559,677,34,11,9,49,87,6,6,0,0
1430,1512,597,1557,680,34,11,9,45,83,0,6,0,0
1431,1514,596,1559,679,34,11,9,45,83,1,6,0,0
1432,1519,601,1559,677,34,11,9,40,76,2,6,0,0
1433,1520,601,1562,680,34,11,9,42,79,3,6,0,0
1434,1526,606,1568,687,34,11,9,42,81,4,6,0,0
1435,1539,622,1575,692,34,11,9,36,70,5,6,0,0
1504,1850,886,1892,959,42,11,9,42,73,0,0,0,0
1509,1832,896,1876,968,43,11,9,44,72,0,0,0,0
1554,2,766,135,1080,52,11,9,133,314,0,0,0,0
1555,6,422,334,1079,53,11,9,328,657,0,68,0,1
1556,29,389,367,1070,53,11,9,338,681,1,68,0,0
1557,143,369,493,1071,53,11,9,350,702,2,68,0,0
1558,259,362,609,1068,53,11,9,350,706,3,68,0,0
1559,330,332,675,1039,53,11,9,345,707,4,68,0,0
1560,397,312,730,1007,53,11,9,333,695,5,68,0,0
1561,447,293,766,972,53,11,9,319,679,6,68,0,0
1562,498,277,788,907,53,11,9,290,630,7,68,0,0
1563,528,270,801,876,53,11,9,273,606,8,68,0,0
1564,563,249,806,799,53,11,9,243,550,9,68,0,0
1565,570,228,799,759,53,11,9,229,531,10,68,0,0
1566,569,222,784,724,53,11,9,215,502,11,68,0,0
1567,570,201,768,675,53,11,9,198,474,12,68,0,0
1568,572,193,762,658,53,11,9,190,465,13,68,0,0
1569,579,183,751,612,53,11,9,172,429,14,68,0,0
1570,577,174,740,587,53,11,9,163,413,15,68,0,0
1571,570,174,726,572,53,11,9,156,398,16,68,0,0
1572,565,160,711,536,53,11,9,146,376,17,68,0,0
1573,562,158,701,523,53,11,9,139,365,18,68,0,0
1574,569,158,694,495,53,11,9,125,337,19,68,0,0
1575,567,147,688,478,53,11,9,121,331,20,68,0,0
1576,564,146,680,468,53,11,9,116,322,21,68,0,0
1577,559,138,667,442,53,11,9,108,304,22,68,0,0
1578,552,137,654,431,53,11,9,102,294,23,68,0,0
1579,553,138,648,416,53,11,9,95,278,24,68,0,0
1580,547,131,640,404,53,11,9,93,273,25,68,0,0
1581,540,131,630,400,53,11,9,90,269,26,68,0,0
1582,531,124,618,384,53,11,9,87,260,27,68,0,0
1583,527,124,612,378,53,11,9,85,254,28,68,0,0
1584,524,123,605,369,53,11,9,81,246,29,68,0,0
1585,524,119,600,356,53,11,9,76,237,30,68,0,0
1586,519,120,594,353,53,11,9,75,233,31,68,0,0
1587,515,116,587,341,53,11,9,72,225,32,68,0,0
1588,512,113,583,335,53,11,9,71,222,33,68,0,0
1589,510,115,579,330,53,11,9,69,215,34,68,0,0
1590,509,112,576,321,53,11,9,67,209,35,68,0,0
1591,504,112,570,319,53,11,9,66,207,36,68,0,0
1592,495,106,561,310,53,11,9,66,204,37,68,0,0
1593,495,104,559,303,53,11,9,64,199,38,68,0,0
1594,497,108,559,299,53,11,9,62,191,39,68,0,0
1595,499,108,557,290,53,11,9,58,182,40,68,0,0
1596,497,104,556,286,53,11,9,59,182,41,68,0,0
1597,496,104,553,280,53,11,9,57,176,42,68,0,0
1598,497,102,553,275,53,11,9,56,173,43,68,0,0
1599,498,102,553,272,53,11,9,55,170,44,68,0,0
1600,500,97,555,266,53,11,9,55,169,45,68,0,0
1601,501,97,554,262,53,11,9,53,165,46,68,0,0
1602,497,96,550,258,53,11,9,53,162,47,68,0,0
1603,497,95,549,254,53,11,9,52,159,48,68,0,0
1604,497,93,549,250,53,11,9,52,157,49,68,0,0
1605,498,93,548,245,53,11,9,50,152,50,68,0,0
1606,496,92,546,243,53,11,9,50,151,51,68,0,0
1607,493,93,543,243,53,11,9,50,150,52,68,0,0
1608,491,91,540,240,53,11,9,49,149,53,68,0,0
1609,491,90,540,236,53,11,9,49,146,54,68,0,0
1610,492,89,539,232,53,11,9,47,143,55,68,0,0
1611,492,90,538,229,53,11,9,46,139,56,68,0,0
1612,492,92,537,227,53,11,9,45,135,57,68,0,0
1613,490,89,534,223,53,11,9,44,134,58,68,0,0
1614,490,91,532,218,53,11,9,42,127,59,68,0,0
1615,491,90,532,213,53,11,9,41,123,60,68,0,0
1616,489,89,529,211,53,11,9,40,122,61,68,0,0
1617,487,94,525,212,53,11,9,38,118,62,68,0,0
1618,486,92,525,211,53,11,9,39,119,63,68,0,0
1619,487,95,523,207,53,11,9,36,112,64,68,0,0
1620,487,93,523,206,53,11,9,36,113,65,68,0,0
1621,485,89,523,206,53,11,9,38,117,66,68,0,0
1622,484,88,521,206,53,11,9,37,118,67,68,0,0
1623,483,88,520,203,53,11,9,37,115,68,68,1,0
2508,1789,708,1833,788,56,11,9,44,80,0,0,0,0
3011,2,740,96,1080,57,11,9,94,340,0,0,0,0
3012,4,508,263,1067,58,11,9,259,559,0,79,0,1
3013,63,483,339,1073,58,11,9,276,590,1,79,0,0
3014,98,452,389,1075,58,11,9,291,623,2,79,0,0
3015,202,428,508,1074,58,11,9,306,646,3,79,0,0
3016,293,417,603,1069,58,11,9,310,652,4,79,0,0
3017,362,395,667,1043,58,11,9,305,648,5,79,0,0
3018,402,371,707,1032,58,11,9,305,661,6,79,0,0
3019,435,348,736,1015,58,11,9,301,667,7,79,0,0
3020,480,331,755,945,58,11,9,275,614,8,79,0,0
3021,511,319,764,889,58,11,9,253,570,9,79,0,0
3022,531,313,773,864,58,11,9,242,551,10,79,0,0
3023,555,290,780,808,58,11,9,225,518,11,79,0,0
3024,564,281,778,775,58,11,9,214,494,12,79,0,0
3025,562,274,770,759,58,11,9,208,485,13,79,0,0
3026,556,261,750,716,58,11,9,194,455,14,79,0,0
3027,546,244,730,680,58,11,9,184,436,15,79,0,0
3028,533,243,711,667,58,11,9,178,424,16,79,0,0
3029,524,239,697,652,58,11,9,173,413,17,79,0,0
3030,518,227,679,613,58,11,9,161,386,18,79,0,0
3031,506,220,660,592,58,11,9,154,372,19,79,0,0
3032,499,216,645,567,58,11,9,146,351,20,79,0,0
3033,493,209,632,544,58,11,9,139,335,21,79,0,0
3034,487,204,625,537,58,11,9,138,333,22,79,0,0
3035,486,200,621,526,58,11,9,135,326,23,79,0,0
3036,486,192,615,503,58,11,9,129,311,24,79,0,0
3037,488,188,612,491,58,11,9,124,303,25,79,0,0
3038,481,187,599,475,58,11,9,118,288,26,79,0,0
3039,474,180,590,462,58,11,9,116,282,27,79,0,0
3040,469,178,583,455,58,11,9,114,277,28,79,0,0
3041,465,176,576,448,58,11,9,111,272,29,79,0,0
3042,463,171,568,430,58,11,9,105,259,30,79,0,0
3043,457,172,558,419,58,11,9,101,247,31,79,0,0
3044,445,169,544,410,58,11,9,99,241,32,79,0,0
3045,433,166,529,400,58,11,9,96,234,33,79,0,0
3046,423,161,520,399,58,11,9,97,238,34,79,0,0
3047,419,159,513,387,58,11,9,94,228,35,79,0,0
3048,418,151,511,379,58,11,9,93,228,36,79,0,0
3049,418,149,509,374,58,11,9,91,225,37,79,0,0
3050,418,145,506,363,58,11,9,88,218,38,79,0,0
3051,418,141,504,356,58,11,9,86,215,39,79,0,0
3052,422,141,506,353,58,11,9,84,212,40,79,0,0
3053,429,140,507,339,58,11,9,78,199,41,79,0,0
3054,434,142,508,331,58,11,9,74,189,42,79,0,0
3055,435,142,508,328,58,11,9,73,186,43,79,0,0
3056,437,142,507,317,58,11,9,70,175,44,79,0,0
3057,438,140,505,310,58,11,9,67,170,45,79,0,0
3058,438,141,504,306,58,11,9,66,165,46,79,0,0
3059,437,130,505,300,58,11,9,68,170,47,79,0,0
3060,436,128,503,298,58,11,9,67,170,48,79,0,0
3061,434,126,500,294,58,11,9,66,168,49,79,0,0
3062,432,123,497,288,58,11,9,65,165,50,79,0,0
3063,433,126,495,285,58,11,9,62,159,51,79,0,0
3064,434,125,492,273,58,11,9,58,148,52,79,0,0
3065,435,122,493,268,58,11,9,58,146,53,79,0,0
3066,434,117,494,269,58,11,9,60,152,54,79,0,0
3067,434,109,495,264,58,11,9,61,155,55,79,0,0
3068,435,106,495,261,58,11,9,60,155,56,79,0,0
3069,438,102,498,258,58,11,9,60,156,57,79,0,0
3070,439,96,499,253,58,11,9,60,157,58,79,0,0
3071,444,106,498,251,58,11,9,54,145,59,79,0,0
3072,450,116,496,240,58,11,9,46,124,60,79,0,0
3073,449,111,497,243,58,11,9,48,132,61,79,0,0
3074,451,114,497,240,58,11,9,46,126,62,79,0,0
3075,453,113,497,231,58,11,9,44,118,63,79,0,0
3076,455,109,498,227,58,11,9,43,118,64,79,0,0
3077,455,101,500,225,58,11,9,45,124,65,79,0,0
3078,454,96,499,223,58,11,9,45,127,66,79,0,0
3079,455,95,499,222,58,11,9,44,127,67,79,0,0
3080,459,103,499,215,58,11,9,40,112,68,79,0,0
3081,459,95,500,214,58,11,9,41,119,69,79,0,0
3082,459,94,500,214,58,11,9,41,120,70,79,0,0
3083,458,89,499,212,58,11,9,41,123,71,79,0,0
3084,458,90,498,210,58,11,9,40,120,72,79,0,0
3085,457,88,497,209,58,11,9,40,121,73,79,0,0
3086,459,87,496,204,58,11,9,37,117,74,79,0,0
3087,460,87,498,206,58,11,9,38,119,75,79,0,0
3088,460,85,499,207,58,11,9,39,122,76,79,0,0
3089,460,91,496,204,58,11,9,36,113,77,79,0,0
3090,460,92,495,204,58,11,9,35,112,78,79,0,0
3091,461,88,496,202,58,11,9,35,114,79,79,1,0
4808,1453,602,1489,682,61,11,9,36,80,0,1,0,0
4809,1459,602,1495,682,61,11,9,36,80,1,1,0,0
4804,1421,601,1457,683,62,11,9,36,82,0,0,0,0
4833,1719,530,1768,617,64,11,9,49,87,0,6,0,0
4834,1717,530,1767,619,64,11,9,50,89,1,6,0,0
4835,1715,530,1766,621,64,11,9,51,91,2,6,0,0
4836,1715,531,1766,621,64,11,9,51,90,3,6,0,0
4837,1712,531,1762,620,64,11,9,50,89,4,6,0,0
4838,1712,538,1758,621,64,11,9,46,83,5,6,0,0
4839,1710,540,1756,622,64,11,9,46,82,6,6,0,0
4904,1574,735,1612,819,65,11,9,38,84,0,7,0,0
4905,1571,739,1610,824,65,11,9,39,85,1,7,0,0
4906,1570,746,1609,829,65,11,9,39,83,2,7,0,0
4907,1567,750,1607,834,65,11,9,40,84,3,7,0,0
4908,1567,754,1605,832,65,11,9,38,78,4,7,0,0
4909,1566,758,1604,837,65,11,9,38,79,5,7,0,0
4910,1564,764,1601,841,65,11,9,37,77,6,7,0,0
4911,1561,768,1599,846,65,11,9,38,78,7,7,0,0
277,1262,143,1302,327,1,13,1,40,184,0,3,0,0
278,1288,143,1329,326,1,13,1,41,183,1,3,0,0
279,1311,144,1351,318,1,13,1,40,174,2,3,0,0
280,1325,145,1363,315,1,13,1,38,170,3,3,0,0
280,1340,141,1404,332,2,13,1,64,191,0,18,0,0
281,1373,146,1436,334,2,13,1,63,188,1,18,0,0
282,1397,140,1462,334,2,13,1,65,194,2,18,0,0
283,1429,142,1494,332,2,13,1,65,190,3,18,0,0
284,1447,144,1511,331,2,13,1,64,187,4,18,0,0
285,1472,142,1536,329,2,13,1,64,187,5,18,0,0
286,1495,144,1559,325,2,13,1,64,181,6,18,0,0
287,1514,143,1575,317,2,13,1,61,174,7,18,0,0
288,1529,145,1588,314,2,13,1,59,169,8,18,0,0
289,1540,146,1597,311,2,13,1,57,165,9,18,0,0
290,1550,142,1607,304,2,13,1,57,162,10,18,0,0
291,1557,144,1613,302,2,13,1,56,158,11,18,0,0
292,1563,144,1619,301,2,13,1,56,157,12,18,0,0
293,1573,142,1626,293,2,13,1,53,151,13,18,0,0
294,1582,144,1630,285,2,13,1,48,141,14,18,0,0
295,1595,144,1639,271,2,13,1,44,127,15,18,0,0
296,1601,143,1648,276,2,13,1,47,133,16,18,0,0
297,1613,147,1659,276,2,13,1,46,129,17,18,0,0
298,1625,147,1669,272,2,13,1,44,125,18,18,0,0
311,1263,187,1314,424,3,13,1,51,237,0,29,0,1
312,1275,186,1328,430,3,13,1,53,244,1,29,0,0
313,1290,193,1344,435,3,13,1,54,242,2,29,0,0
314,1315,193,1370,436,3,13,1,55,243,3,29,0,0
315,1336,201,1398,468,3,13,1,62,267,4,29,0,0
316,1349,204,1415,474,3,13,1,66,270,5,29,0,0
317,1355,209,1426,495,3,13,1,71,286,6,29,0,0
318,1366,216,1442,514,3,13,1,76,298,7,29,0,0
319,1376,216,1458,528,3,13,1,82,312,8,29,0,0
320,1378,228,1465,547,3,13,1,87,319,9,29,0,0
321,1375,231,1466,559,3,13,1,91,328,10,29,0,0
322,1369,239,1467,582,3,13,1,98,343,11,29,0,0
323,1370,253,1473,602,3,13,1,103,349,12,29,0,0
324,1364,265,1472,624,3,13,1,108,359,13,29,0,0
325,1352,279,1468,657,3,13,1,116,378,14,29,0,0
326,1340,284,1463,677,3,13,1,123,393,15,29,0,0
327,1328,294,1462,715,3,13,1,134,421,16,29,0,0
328,1318,308,1463,756,3,13,1,145,448,17,29,0,0
329,1293,317,1448,791,3,13,1,155,474,18,29,0,0
330,1267,335,1430,829,3,13,1,163,494,19,29,0,0
331,1245,342,1419,868,3,13,1,174,526,20,29,0,0
332,1220,365,1414,939,3,13,1,194,574,21,29,0,0
333,1193,389,1400,1000,3,13,1,207,611,22,29,0,0
334,1139,415,1361,1055,3,13,1,222,640,23,29,0,0
335,1097,462,1314,1078,3,13,1,217,616,24,29,0,0
336,1058,482,1278,1080,3,13,1,220,598,25,29,0,0
337,1040,541,1254,1080,3,13,1,214,539,26,29,0,0
338,995,613,1197,1080,3,13,1,202,467,27,29,0,0
339,949,701,1131,1080,3,13,1,182,379,28,29,0,0
340,930,734,1107,1080,3,13,1,177,346,29,29,1,0
1340,1261,162,1312,360,6,13,1,51,198,0,21,0,1
1341,1281,157,1332,356,6,13,1,51,199,1,21,0,0
1342,1303,163,1354,355,6,13,1,51,192,2,21,0,0
1343,1336,157,1386,345,6,13,1,50,188,3,21,0,0
1344,1366,157,1418,347,6,13,1,52,190,4,21,0,0
1345,1390,153,1443,343,6,13,1,53,190,5,21,0,0
1346,1413,154,1464,337,6,13,1,51,183,6,21,0,0
1347,1432,155,1482,331,6,13,1,50,176,7,21,0,0
1348,1448,152,1499,331,6,13,1,51,179,8,21,0,0
1349,1464,153,1515,327,6,13,1,51,174,9,21,0,0
1350,1479,154,1530,322,6,13,1,51,168,10,21,0,0
1351,1489,154,1539,316,6,13,1,50,162,11,21,0,0
1352,1499,153,1548,314,6,13,1,49,161,12,21,0,0
1353,1512,150,1561,306,6,13,1,49,156,13,21,0,0
1354,1522,151,1570,303,6,13,1,48,152,14,21,0,0
1355,1535,153,1582,295,6,13,1,47,142,15,21,0,0
1356,1544,148,1592,291,6,13,1,48,143,16,21,0,0
1357,1559,150,1603,281,6,13,1,44,131,17,21,0,0
1358,1571,147,1618,287,6,13,1,47,140,18,21,0,0
1359,1586,149,1630,282,6,13,1,44,133,19,21,0,0
1360,1604,148,1646,272,6,13,1,42,124,20,21,0,0
1361,1619,147,1659,268,6,13,1,40,121,21,21,1,0
1675,1263,180,1322,411,8,13,1,59,231,0,31,0,1
1676,1275,183,1337,424,8,13,1,62,241,1,31,0,0
1677,1284,187,1345,423,8,13,1,61,236,2,31,0,0
1678,1290,190,1354,434,8,13,1,64,244,3,31,0,0
1679,1298,195,1365,446,8,13,1,67,251,4,31,0,0
1680,1310,196,1380,455,8,13,1,70,259,5,31,0,0
1681,1316,203,1387,466,8,13,1,71,263,6,31,0,0
1682,1316,207,1392,479,8,13,1,76,272,7,31,0,0
1683,1313,212,1394,499,8,13,1,81,287,8,31,0,0
1684,1306,217,1392,520,8,13,1,86,303,9,31,0,0
1685,1293,220,1385,539,8,13,1,92,319,10,31,0,0
1686,1279,232,1376,568,8,13,1,97,336,11,31,0,0
1687,1264,235,1365,579,8,13,1,101,344,12,31,0,0
1688,1249,242,1357,604,8,13,1,108,362,13,31,0,0
1689,1229,248,1340,620,8,13,1,111,372,14,31,0,0
1690,1199,257,1319,659,8,13,1,120,402,15,31,0,0
1691,1175,271,1303,691,8,13,1,128,420,16,31,0,0
1692,1157,277,1289,705,8,13,1,132,428,17,31,0,0
1693,1135,295,1275,748,8,13,1,140,453,18,31,0,0
1694,1103,306,1248,777,8,13,1,145,471,19,31,0,0
1695,1055,325,1222,856,8,13,1,167,531,20,31,0,0
1696,1025,344,1202,895,8,13,1,177,551,21,31,0,0
1697,1014,366,1198,935,8,13,1,184,569,22,31,0,0
1698,984,394,1180,1004,8,13,1,196,610,23,31,0,0
1699,939,419,1146,1057,8,13,1,207,638,24,31,0,0
1700,885,460,1097,1080,8,13,1,212,620,25,31,0,0
1701,863,498,1071,1080,8,13,1,208,582,26,31,0,0
1702,841,549,1041,1080,8,13,1,200,531,27,31,0,0
1703,794,630,978,1079,8,13,1,184,449,28,31,0,0
1704,719,707,896,1080,8,13,1,177,373,29,31,0,0
1705,650,839,790,1080,8,13,1,140,241,30,31,0,0
1706,620,889,741,1080,8,13,1,121,191,31,31,1,0
1916,1264,181,1321,429,9,13,1,57,248,0,29,0,1
1917,1274,183,1333,437,9,13,1,59,254,1,29,0,0
1918,1286,180,1346,436,9,13,1,60,256,2,29,0,0
1919,1303,185,1367,450,9,13,1,64,265,3,29,0,0
1920,1314,188,1382,461,9,13,1,68,273,4,29,0,0
1921,1319,191,1392,477,9,13,1,73,286,5,29,0,0
1922,1325,202,1404,503,9,13,1,79,301,6,29,0,0
1923,1333,202,1417,517,9,13,1,84,315,7,29,0,0
1924,1333,213,1420,530,9,13,1,87,317,8,29,0,0
1925,1327,222,1420,552,9,13,1,93,330,9,29,0,0
1926,1320,223,1419,569,9,13,1,99,346,10,29,0,0
1927,1312,233,1420,602,9,13,1,108,369,11,29,0,0
1928,1302,236,1418,626,9,13,1,116,390,12,29,0,0
1929,1285,241,1409,652,9,13,1,124,411,13,29,0,0
1930,1264,254,1395,687,9,13,1,131,433,14,29,0,0
1931,1245,255,1385,709,9,13,1,140,454,15,29,0,0
1932,1227,274,1384,768,9,13,1,157,494,16,29,0,0
1933,1206,283,1369,797,9,13,1,163,514,17,29,0,0
1934,1178,300,1351,845,9,13,1,173,545,18,29,0,0
1935,1147,325,1330,899,9,13,1,183,574,19,29,0,0
1936,1110,334,1302,927,9,13,1,192,593,20,29,0,0
1937,1080,369,1291,998,9,13,1,211,629,21,29,0,0
1938,1043,397,1271,1053,9,13,1,228,656,22,29,0,0
1939,994,429,1223,1076,9,13,1,229,647,23,29,0,0
1940,943,477,1168,1080,9,13,1,225,603,24,29,0,0
1941,873,519,1092,1080,9,13,1,219,561,25,29,0,0
1942,803,590,1016,1080,9,13,1,213,490,26,29,0,0
1943,748,692,944,1080,9,13,1,196,388,27,29,0,0
1944,686,783,866,1080,9,13,1,180,297,28,29,0,0
1945,656,827,820,1080,9,13,1,164,253,29,29,1,0
2355,1261,215,1323,404,11,13,1,62,189,0,31,0,1
2356,1258,202,1324,404,11,13,1,66,202,1,31,0,0
2357,1265,196,1337,414,11,13,1,72,218,2,31,0,0
2358,1269,198,1342,419,11,13,1,73,221,3,31,0,0
2359,1285,205,1360,430,11,13,1,75,225,4,31,0,0
2360,1293,211,1372,447,11,13,1,79,236,5,31,0,0
2361,1301,210,1385,463,11,13,1,84,253,6,31,0,0
2362,1311,217,1399,478,11,13,1,88,261,7,31,0,0
2363,1319,221,1409,490,11,13,1,90,269,8,31,0,0
2364,1324,225,1418,506,11,13,1,94,281,9,31,0,0
2365,1327,237,1424,528,11,13,1,97,291,10,31,0,0
2366,1330,240,1429,538,11,13,1,99,298,11,31,0,0
2367,1327,248,1432,561,11,13,1,105,313,12,31,0,0
2368,1324,253,1436,587,11,13,1,112,334,13,31,0,0
2369,1320,261,1437,607,11,13,1,117,346,14,31,0,0
2370,1308,272,1431,638,11,13,1,123,366,15,31,0,0
2371,1297,281,1424,655,11,13,1,127,374,16,31,0,0
2372,1285,295,1424,700,11,13,1,139,405,17,31,0,0
2373,1276,308,1421,727,11,13,1,145,419,18,31,0,0
2374,1260,320,1416,768,11,13,1,156,448,19,31,0,0
2375,1243,336,1406,804,11,13,1,163,468,20,31,0,0
2376,1226,353,1396,834,11,13,1,170,481,21,31,0,0
2377,1202,374,1391,905,11,13,1,189,531,22,31,0,0
2378,1185,398,1382,947,11,13,1,197,549,23,31,0,0
2379,1155,430,1368,1025,11,13,1,213,595,24,31,0,0
2380,1127,465,1345,1068,11,13,1,218,603,25,31,0,0
2381,1102,498,1320,1080,11,13,1,218,582,26,31,0,0
2382,1078,562,1284,1080,11,13,1,206,518,27,31,0,0
2383,1055,624,1250,1080,11,13,1,195,456,28,31,0,0
2384,1014,719,1187,1080,11,13,1,173,361,29,31,0,0
2385,949,817,1099,1080,11,13,1,150,263,30,31,0,0
2386,930,859,1067,1080,11,13,1,137,221,31,31,1,0
2541,1261,157,1315,342,13,13,1,54,185,0,23,0,1
2542,1276,150,1330,338,13,13,1,54,188,1,23,0,0
2543,1303,151,1358,337,13,13,1,55,186,2,23,0,0
2544,1331,149,1386,335,13,13,1,55,186,3,23,0,0
2545,1354,148,1411,341,13,13,1,57,193,4,23,0,0
2546,1382,150,1438,338,13,13,1,56,188,5,23,0,0
2547,1404,147,1460,339,13,13,1,56,192,6,23,0,0
2548,1426,151,1480,333,13,13,1,54,182,7,23,0,0
2549,1444,148,1499,331,13,13,1,55,183,8,23,0,0
2550,1461,146,1515,325,13,13,1,54,179,9,23,0,0
2551,1477,149,1531,324,13,13,1,54,175,10,23,0,0
2552,1491,146,1544,316,13,13,1,53,170,11,23,0,0
2553,1505,146,1556,309,13,13,1,51,163,12,23,0,0
2554,1516,148,1565,304,13,13,1,49,156,13,23,0,0
2555,1524,147,1573,303,13,13,1,49,156,14,23,0,0
2556,1533,149,1581,302,13,13,1,48,153,15,23,0,0
2557,1542,143,1591,299,13,13,1,49,156,16,23,0,0
2558,1554,143,1601,294,13,13,1,47,151,17,23,0,0
2559,1565,144,1610,288,13,13,1,45,144,18,23,0,0
2560,1576,143,1620,282,13,13,1,44,139,19,23,0,0
2561,1590,145,1631,276,13,13,1,41,131,20,23,0,0
2562,1605,142,1645,272,13,13,1,40,130,21,23,0,0
2563,1620,145,1660,271,13,13,1,40,126,22,23,0,0
2564,1634,145,1673,267,13,13,1,39,122,23,23,1,0
2553,1476,175,1511,273,15,13,1,35,98,0,1,0,0
2554,1478,174,1513,273,15,13,1,35,99,1,1,0,0
3051,1578,148,1615,273,16,13,1,37,125,0,28,0,1
3052,1568,148,1603,267,16,13,1,35,119,1,28,0,0
3053,1554,146,1593,283,16,13,1,39,137,2,28,0,0
3054,1543,148,1585,292,16,13,1,42,144,3,28,0,0
3055,1537,149,1579,291,16,13,1,42,142,4,28,0,0
3056,1531,156,1570,286,16,13,1,39,130,5,28,0,0
3057,1522,156,1564,297,16,13,1,42,141,6,28,0,0
3058,1514,154,1558,301,16,13,1,44,147,7,28,0,0
3059,1506,152,1551,304,16,13,1,45,152,8,28,0,0
3060,1497,153,1544,309,16,13,1,47,156,9,28,0,0
3061,1492,155,1538,304,16,13,1,46,149,10,28,0,0
3062,1485,156,1532,310,16,13,1,47,154,11,28,0,0
3063,1477,158,1525,313,16,13,1,48,155,12,28,0,0
3064,1467,154,1517,320,16,13,1,50,166,13,28,0,0
3065,1457,156,1508,326,16,13,1,51,170,14,28,0,0
3066,1448,156,1500,328,16,13,1,52,172,15,28,0,0
3067,1438,157,1490,329,16,13,1,52,172,16,28,0,0
3068,1427,158,1480,333,16,13,1,53,175,17,28,0,0
3069,1416,160,1470,335,16,13,1,54,175,18,28,0,0
3070,1398,157,1454,340,16,13,1,56,183,19,28,0,0
3071,1384,160,1441,342,16,13,1,57,182,20,28,0,0
3072,1367,162,1422,341,16,13,1,55,179,21,28,0,0
3073,1348,158,1403,339,16,13,1,55,181,22,28,0,0
3074,1331,162,1386,337,16,13,1,55,175,23,28,0,0
3075,1310,160,1365,337,16,13,1,55,177,24,28,0,0
3076,1286,161,1342,340,16,13,1,56,179,25,28,0,0
3077,1270,163,1328,344,16,13,1,58,181,26,28,0,0
3078,1252,161,1309,349,16,13,1,57,188,27,28,0,0
3079,1237,162,1295,352,16,13,1,58,190,28,28,1,0
3060,1475,178,1510,270,17,13,1,35,92,0,0,0,0
3219,1261,195,1316,431,18,13,1,55,236,0,42,0,1
3220,1263,187,1320,430,18,13,1,57,243,1,42,0,0
3221,1274,185,1331,426,18,13,1,57,241,2,42,0,0
3222,1285,193,1345,439,18,13,1,60,246,3,42,0,0
3223,1289,202,1347,440,18,13,1,58,238,4,42,0,0
3224,1294,206,1354,443,18,13,1,60,237,5,42,0,0
3225,1299,210,1362,457,18,13,1,63,247,6,42,0,0
3226,1304,213,1368,458,18,13,1,64,245,7,42,0,0
3227,1310,206,1378,462,18,13,1,68,256,8,42,0,0
3228,1313,217,1383,477,18,13,1,70,260,9,42,0,0
3229,1304,209,1380,485,18,13,1,76,276,10,42,0,0
3230,1294,212,1377,508,18,13,1,83,296,11,42,0,0
3231,1285,216,1375,527,18,13,1,90,311,12,42,0,0
3232,1288,226,1380,538,18,13,1,92,312,13,42,0,0
3233,1289,236,1383,546,18,13,1,94,310,14,42,0,0
3234,1288,246,1385,563,18,13,1,97,317,15,42,0,0
3235,1279,251,1378,574,18,13,1,99,323,16,42,0,0
3236,1267,255,1370,584,18,13,1,103,329,17,42,0,0
3237,1250,258,1361,607,18,13,1,111,349,18,42,0,0
3238,1241,263,1357,626,18,13,1,116,363,19,42,0,0
3239,1233,271,1350,634,18,13,1,117,363,20,42,0,0
3240,1218,279,1341,659,18,13,1,123,380,21,42,0,0
3241,1196,282,1323,679,18,13,1,127,397,22,42,0,0
3242,1172,280,1307,696,18,13,1,135,416,23,42,0,0
3243,1161,300,1294,701,18,13,1,133,401,24,42,0,0
3244,1147,306,1290,738,18,13,1,143,432,25,42,0,0
3245,1134,318,1279,754,18,13,1,145,436,26,42,0,0
3246,1107,333,1261,798,18,13,1,154,465,27,42,0,0
3247,1080,344,1240,826,18,13,1,160,482,28,42,0,0
3248,1042,354,1209,851,18,13,1,167,497,29,42,0,0
3249,1008,372,1189,905,18,13,1,181,533,30,42,0,0
3250,979,384,1167,936,18,13,1,188,552,31,42,0,0
3251,953,398,1141,948,18,13,1,188,550,32,42,0,0
3252,911,408,1114,999,18,13,1,203,591,33,42,0,0
3253,880,427,1084,1017,18,13,1,204,590,34,42,0,0
3254,816,455,1026,1048,18,13,1,210,593,35,42,0,0
3255,764,497,977,1073,18,13,1,213,576,36,42,0,0
3256,735,534,939,1069,18,13,1,204,535,37,42,0,0
3257,713,570,909,1076,18,13,1,196,506,38,42,0,0
3258,659,609,850,1075,18,13,1,191,466,39,42,0,0
3259,595,664,778,1080,18,13,1,183,416,40,42,0,0
3260,537,702,715,1077,18,13,1,178,375,41,42,0,0
3261,502,729,674,1080,18,13,1,172,351,42,42,1,0
3224,1342,195,1397,399,19,13,1,55,204,0,48,0,1
3225,1351,195,1406,402,19,13,1,55,207,1,48,0,0
3226,1358,193,1416,410,19,13,1,58,217,2,48,0,0
3227,1373,193,1434,419,19,13,1,61,226,3,48,0,0
3228,1386,205,1447,428,19,13,1,61,223,4,48,0,0
3229,1397,200,1462,435,19,13,1,65,235,5,48,0,0
3230,1407,199,1473,440,19,13,1,66,241,6,48,0,0
3231,1412,200,1480,447,19,13,1,68,247,7,48,0,0
3232,1416,203,1485,451,19,13,1,69,248,8,48,0,0
3233,1422,211,1494,471,19,13,1,72,260,9,48,0,0
3234,1428,214,1500,471,19,13,1,72,257,10,48,0,0
3235,1433,217,1506,478,19,13,1,73,261,11,48,0,0
3236,1432,219,1510,495,19,13,1,78,276,12,48,0,0
3237,1435,222,1515,511,19,13,1,80,289,13,48,0,0
3238,1439,226,1520,519,19,13,1,81,293,14,48,0,0
3239,1444,231,1527,530,19,13,1,83,299,15,48,0,0
3240,1446,234,1531,538,19,13,1,85,304,16,48,0,0
3241,1444,235,1533,556,19,13,1,89,321,17,48,0,0
3242,1439,239,1532,571,19,13,1,93,332,18,48,0,0
3243,1430,245,1525,581,19,13,1,95,336,19,48,0,0
3244,1420,257,1520,608,19,13,1,100,351,20,48,0,0
3245,1414,260,1515,617,19,13,1,101,357,21,48,0,0
3246,1404,264,1508,627,19,13,1,104,363,22,48,0,0
3247,1387,271,1495,652,19,13,1,108,381,23,48,0,0
3248,1372,278,1482,659,19,13,1,110,381,24,48,0,0
3249,1361,288,1476,679,19,13,1,115,391,25,48,0,0
3250,1349,296,1471,708,19,13,1,122,412,26,48,0,0
3251,1338,299,1462,717,19,13,1,124,418,27,48,0,0
3252,1321,312,1449,741,19,13,1,128,429,28,48,0,0
3253,1303,325,1435,766,19,13,1,132,441,29,48,0,0
3254,1290,333,1428,786,19,13,1,138,453,30,48,0,0
3255,1275,344,1426,832,19,13,1,151,488,31,48,0,0
3256,1260,354,1415,855,19,13,1,155,501,32,48,0,0
3257,1239,366,1400,886,19,13,1,161,520,33,48,0,0
3258,1204,374,1377,929,19,13,1,173,555,34,48,0,0
3259,1183,387,1358,943,19,13,1,175,556,35,48,0,0
3260,1165,408,1352,992,19,13,1,187,584,36,48,0,0
3261,1158,438,1355,1046,19,13,1,197,608,37,48,0,0
3262,1147,455,1346,1071,19,13,1,199,616,38,48,0,0
3263,1137,481,1334,1080,19,13,1,197,599,39,48,0,0
3264,1114,507,1308,1080,19,13,1,194,573,40,48,0,0
3265,1091,538,1281,1080,19,13,1,190,542,41,48,0,0
3266,1068,578,1254,1080,19,13,1,186,502,42,48,0,0
3267,1035,624,1210,1078,19,13,1,175,454,43,48,0,0
3268,994,671,1161,1080,19,13,1,167,409,44,48,0,0
3269,943,736,1094,1080,19,13,1,151,344,45,48,0,0
3270,867,803,1005,1080,19,13,1,138,277,46,48,0,0
3271,774,870,892,1080,19,13,1,118,210,47,48,0,0
3272,733,914,831,1080,19,13,1,98,166,48,48,1,0
3224,1263,175,1301,415,20,13,1,38,240,0,0,0,0
3226,1263,195,1310,428,21,13,1,47,233,0,18,0,0
3227,1260,195,1311,443,21,13,1,51,248,1,18,0,0
3228,1264,201,1313,441,21,13,1,49,240,2,18,0,0
3229,1274,207,1320,434,21,13,1,46,227,3,18,0,0
3230,1278,210,1323,433,21,13,1,45,223,4,18,0,0
3232,1263,201,1323,491,21,13,1,60,290,0,18,0,0
3233,1255,209,1316,501,21,13,1,61,292,1,18,0,0
3234,1245,214,1310,520,21,13,1,65,306,2,18,0,0
3235,1230,223,1297,534,21,13,1,67,311,3,18,0,0
3236,1219,226,1286,532,21,13,1,67,306,4,18,0,0
3237,1208,221,1279,542,21,13,1,71,321,5,18,0,0
3238,1200,234,1272,556,21,13,1,72,322,6,18,0,0
3239,1181,239,1260,584,21,13,1,79,345,7,18,0,0
3240,1167,244,1251,601,21,13,1,84,357,8,18,0,0
3241,1156,254,1241,610,21,13,1,85,356,9,18,0,0
3242,1145,256,1225,572,21,13,1,80,316,10,18,0,0
3243,1130,256,1209,539,21,13,1,79,283,11,18,0,0
3244,1104,271,1203,626,21,13,1,99,355,12,18,0,0
3245,1078,275,1187,670,21,13,1,109,395,13,18,0,0
3246,1058,285,1164,674,21,13,1,106,389,14,18,0,0
3247,1041,297,1135,628,21,13,1,94,331,15,18,0,0
3248,1033,300,1116,572,21,13,1,83,272,16,18,0,0
3249,1047,309,1113,500,21,13,1,66,191,17,18,0,0
3250,1040,315,1101,493,21,13,1,61,178,18,18,0,0
3226,1289,173,1337,246,22,13,1,48,73,0,0,0,0
3228,1314,174,1372,266,23,13,1,58,92,0,45,0,1
3229,1314,174,1395,304,23,13,1,81,130,1,45,0,0
3230,1303,174,1433,385,23,13,1,130,211,2,45,0,0
3231,1303,173,1455,426,23,13,1,152,253,3,45,0,0
3232,1307,176,1465,444,23,13,1,158,268,4,45,0,0
3233,1310,182,1469,459,23,13,1,159,277,5,45,0,0
3234,1314,183,1471,462,23,13,1,157,279,6,45,0,0
3235,1310,185,1474,486,23,13,1,164,301,7,45,0,0
3236,1305,192,1470,503,23,13,1,165,311,8,45,0,0
3237,1301,193,1462,505,23,13,1,161,312,9,45,0,0
3238,1299,198,1457,513,23,13,1,158,315,10,45,0,0
3239,1292,200,1447,520,23,13,1,155,320,11,45,0,0
3240,1277,197,1436,531,23,13,1,159,334,12,45,0,0
3241,1266,203,1426,548,23,13,1,160,345,13,45,0,0
3242,1260,210,1420,565,23,13,1,160,355,14,45,0,0
3243,1257,209,1416,569,23,13,1,159,360,15,45,0,0
3244,1250,217,1408,579,23,13,1,158,362,16,45,0,0
3245,1236,221,1394,591,23,13,1,158,370,17,45,0,0
3246,1220,222,1382,607,23,13,1,162,385,18,45,0,0
3247,1208,226,1373,624,23,13,1,165,398,19,45,0,0
3248,1206,231,1373,636,23,13,1,167,405,20,45,0,0
3249,1198,235,1370,655,23,13,1,172,420,21,45,0,0
3250,1184,244,1356,671,23,13,1,172,427,22,45,0,0
3251,1163,251,1339,695,23,13,1,176,444,23,45,0,0
3252,1138,252,1318,709,23,13,1,180,457,24,45,0,0
3253,1116,266,1306,752,23,13,1,190,486,25,45,0,0
3254,1098,279,1293,779,23,13,1,195,500,26,45,0,0
3255,1082,286,1278,792,23,13,1,196,506,27,45,0,0
3256,1061,307,1260,829,23,13,1,199,522,28,45,0,0
3257,1034,323,1236,856,23,13,1,202,533,29,45,0,0
3258,1001,327,1215,890,23,13,1,214,563,30,45,0,0
3259,968,341,1196,945,23,13,1,228,604,31,45,0,0
3260,935,354,1171,985,23,13,1,236,631,32,45,0,0
3261,903,370,1143,1016,23,13,1,240,646,33,45,0,0
3262,868,400,1109,1049,23,13,1,241,649,34,45,0,0
3263,810,416,1057,1072,23,13,1,247,656,35,45,0,0
3264,735,437,982,1080,23,13,1,247,643,36,45,0,0
3265,692,475,931,1080,23,13,1,239,605,37,45,0,0
3266,645,506,879,1080,23,13,1,234,574,38,45,0,0
3267,581,544,806,1080,23,13,1,225,536,39,45,0,0
3268,508,598,721,1080,23,13,1,213,482,40,45,0,0
3269,428,633,637,1080,23,13,1,209,447,41,45,0,0
3270,377,684,581,1080,23,13,1,204,396,42,45,0,0
3271,312,754,498,1079,23,13,1,186,325,43,45,0,0
3272,222,825,385,1079,23,13,1,163,254,44,45,0,0
3273,172,868,312,1080,23,13,1,140,212,45,45,1,0
3231,1253,207,1335,373,24,13,1,82,166,0,0,0,0
3250,954,323,1071,638,25,13,1,117,315,0,18,0,0
3251,902,337,1049,735,25,13,1,147,398,1,18,0,0
3252,889,341,1016,682,25,13,1,127,341,2,18,0,0
3253,908,364,998,592,25,13,1,90,228,3,18,0,0
3254,902,376,994,597,25,13,1,92,221,4,18,0,0
3255,854,390,958,633,25,13,1,104,243,5,18,0,0
3256,806,416,922,680,25,13,1,116,264,6,18,0,0
3257,751,431,880,712,25,13,1,129,281,7,18,0,0
3258,683,457,832,770,25,13,1,149,313,8,18,0,0
3259,626,487,798,840,25,13,1,172,353,9,18,0,0
3260,570,517,754,890,25,13,1,184,373,10,18,0,0
3261,497,543,711,977,25,13,1,214,434,11,18,0,0
3262,429,585,655,1036,25,13,1,226,451,12,18,0,0
3263,340,620,569,1069,25,13,1,229,449,13,18,0,0
3264,255,666,481,1080,25,13,1,226,414,14,18,0,0
3265,187,732,394,1080,25,13,1,207,348,15,18,0,0
3266,86,790,270,1080,25,13,1,184,290,16,18,0,0
3267,27,864,168,1080,25,13,1,141,216,17,18,0,0
3268,0,901,103,1080,25,13,1,103,179,18,18,0,0
3538,766,518,1316,1073,29,13,1,550,555,0,5,0,0
3539,804,456,1397,1071,29,13,1,593,615,1,5,0,0
3540,852,419,1440,1047,29,13,1,588,628,2,5,0,0
3541,898,374,1509,1054,29,13,1,611,680,3,5,0,0
3542,948,343,1556,1049,29,13,1,608,706,4,5,0,0
3543,971,291,1621,1047,29,13,1,650,756,5,5,0,0
3543,1189,337,1405,977,30,13,1,216,640,0,24,0,1
3544,1212,317,1412,911,30,13,1,200,594,1,24,0,0
3545,1222,308,1421,898,30,13,1,199,590,2,24,0,0
3546,1259,281,1440,816,30,13,1,181,535,3,24,0,0
3547,1287,267,1461,783,30,13,1,174,516,4,24,0,0
3548,1313,261,1477,745,30,13,1,164,484,5,24,0,0
3549,1335,249,1487,699,30,13,1,152,450,6,24,0,0
3550,1349,245,1496,681,30,13,1,147,436,7,24,0,0
3551,1383,234,1518,635,30,13,1,135,401,8,24,0,0
3552,1412,224,1543,615,30,13,1,131,391,9,24,0,0
3553,1434,222,1563,609,30,13,1,129,387,10,24,0,0
3554,1458,208,1584,590,30,13,1,126,382,11,24,0,0
3555,1473,208,1595,582,30,13,1,122,374,12,24,0,0
3556,1485,203,1599,556,30,13,1,114,353,13,24,0,0
3557,1490,199,1597,529,30,13,1,107,330,14,24,0,0
3558,1492,201,1592,513,30,13,1,100,312,15,24,0,0
3559,1489,190,1588,496,30,13,1,99,306,16,24,0,0
3560,1481,188,1577,482,30,13,1,96,294,17,24,0,0
3561,1467,184,1562,470,30,13,1,95,286,18,24,0,0
3562,1447,181,1540,464,30,13,1,93,283,19,24,0,0
3563,1431,179,1524,463,30,13,1,93,284,20,24,0,0
3564,1403,176,1500,477,30,13,1,97,301,21,24,0,0
3565,1381,174,1472,463,30,13,1,91,289,22,24,0,0
3566,1365,178,1450,445,30,13,1,85,267,23,24,0,0
3567,1357,175,1440,432,30,13,1,83,257,24,24,1,0
3547,1262,178,1334,427,31,13,1,72,249,0,35,0,1
3548,1274,176,1345,420,31,13,1,71,244,1,35,0,0
3549,1293,180,1364,422,31,13,1,71,242,2,35,0,0
3550,1319,181,1393,432,31,13,1,74,251,3,35,0,0
3551,1342,182,1418,438,31,13,1,76,256,4,35,0,0
3552,1357,186,1437,453,31,13,1,80,267,5,35,0,0
3553,1374,186,1459,466,31,13,1,85,280,6,35,0,0
3554,1387,196,1474,480,31,13,1,87,284,7,35,0,0
3555,1394,199,1485,491,31,13,1,91,292,8,35,0,0
3556,1397,200,1491,502,31,13,1,94,302,9,35,0,0
3557,1394,209,1492,523,31,13,1,98,314,10,35,0,0
3558,1390,212,1491,532,31,13,1,101,320,11,35,0,0
3559,1383,215,1490,550,31,13,1,107,335,12,35,0,0
3560,1371,222,1485,572,31,13,1,114,350,13,35,0,0
3561,1361,225,1477,582,31,13,1,116,357,14,35,0,0
3562,1352,235,1474,610,31,13,1,122,375,15,35,0,0
3563,1336,244,1464,632,31,13,1,128,388,16,35,0,0
3564,1315,244,1453,660,31,13,1,138,416,17,35,0,0
3565,1288,253,1439,697,31,13,1,151,444,18,35,0,0
3566,1269,261,1421,706,31,13,1,152,445,19,35,0,0
3567,1241,274,1403,746,31,13,1,162,472,20,35,0,0
3568,1216,287,1386,784,31,13,1,170,497,21,35,0,0
3569,1178,297,1360,820,31,13,1,182,523,22,35,0,0
3570,1136,320,1334,875,31,13,1,198,555,23,35,0,0
3571,1103,333,1309,903,31,13,1,206,570,24,35,0,0
3572,1064,346,1281,948,31,13,1,217,602,25,35,0,0
3573,1026,378,1251,1000,31,13,1,225,622,26,35,0,0
3574,970,388,1209,1042,31,13,1,239,654,27,35,0,0
3575,921,425,1165,1070,31,13,1,244,645,28,35,0,0
3576,872,466,1116,1079,31,13,1,244,613,29,35,0,0
3577,832,500,1072,1080,31,13,1,240,580,30,35,0,0
3578,785,566,1011,1080,31,13,1,226,514,31,35,0,0
3579,695,620,917,1080,31,13,1,222,460,32,35,0,0
3580,615,685,827,1080,31,13,1,212,395,33,35,0,0
3581,499,757,700,1080,31,13,1,201,323,34,35,0,0
3582,451,794,638,1080,31,13,1,187,286,35,35,1,0
3551,1258,203,1367,453,32,13,1,109,250,0,30,0,1
3552,1269,208,1372,445,32,13,1,103,237,1,30,0,0
3553,1280,206,1385,451,32,13,1,105,245,2,30,0,0
3554,1287,213,1393,460,32,13,1,106,247,3,30,0,0
3555,1292,219,1398,470,32,13,1,106,251,4,30,0,0
3556,1291,223,1399,481,32,13,1,108,258,5,30,0,0
3557,1282,230,1396,508,32,13,1,114,278,6,30,0,0
3558,1275,234,1389,519,32,13,1,114,285,7,30,0,0
3559,1263,240,1378,531,32,13,1,115,291,8,30,0,0
3560,1247,247,1366,552,32,13,1,119,305,9,30,0,0
3561,1229,247,1352,566,32,13,1,123,319,10,30,0,0
3562,1205,256,1335,596,32,13,1,130,340,11,30,0,0
3563,1190,261,1323,612,32,13,1,133,351,12,30,0,0
3564,1170,268,1307,634,32,13,1,137,366,13,30,0,0
3565,1150,283,1287,654,32,13,1,137,371,14,30,0,0
3566,1122,286,1262,668,32,13,1,140,382,15,30,0,0
3567,1088,297,1238,709,32,13,1,150,412,16,30,0,0
3568,1064,314,1221,738,32,13,1,157,424,17,30,0,0
3569,1037,324,1195,757,32,13,1,158,433,18,30,0,0
3570,1000,348,1165,815,32,13,1,165,467,19,30,0,0
3571,968,366,1134,840,32,13,1,166,474,20,30,0,0
3572,916,378,1099,900,32,13,1,183,522,21,30,0,0
3573,861,403,1053,948,32,13,1,192,545,22,30,0,0
3574,823,417,1014,963,32,13,1,191,546,23,30,0,0
3575,785,450,981,1016,32,13,1,196,566,24,30,0,0
3576,732,484,917,1025,32,13,1,185,541,25,30,0,0
3577,669,514,856,1057,32,13,1,187,543,26,30,0,0
3578,593,566,774,1066,32,13,1,181,500,27,30,0,0
3579,531,611,701,1076,32,13,1,170,465,28,30,0,0
3580,466,669,616,1078,32,13,1,150,409,29,30,0,0
3581,425,696,572,1080,32,13,1,147,384,30,30,1,0
3567,1322,168,1393,388,33,13,1,71,220,0,4,0,0
3568,1303,171,1377,399,33,13,1,74,228,1,4,0,0
3569,1274,166,1348,395,33,13,1,74,229,2,4,0,0
3570,1251,165,1328,405,33,13,1,77,240,3,4,0,0
3571,1234,163,1312,408,33,13,1,78,245,4,4,0,0
4514,1597,143,1646,278,37,13,1,49,135,0,20,0,1
4515,1584,143,1633,278,37,13,1,49,135,1,20,0,0
4516,1568,146,1617,281,37,13,1,49,135,2,20,0,0
4517,1544,137,1597,287,37,13,1,53,150,3,20,0,0
4518,1524,140,1579,292,37,13,1,55,152,4,20,0,0
4519,1509,140,1563,291,37,13,1,54,151,5,20,0,0
4520,1493,139,1549,296,37,13,1,56,157,6,20,0,0
4521,1478,142,1535,301,37,13,1,57,159,7,20,0,0
4522,1464,142,1522,304,37,13,1,58,162,8,20,0,0
4523,1450,141,1511,311,37,13,1,61,170,9,20,0,0
4524,1436,141,1499,316,37,13,1,63,175,10,20,0,0
4525,1427,141,1490,319,37,13,1,63,178,11,20,0,0
4526,1413,142,1479,325,37,13,1,66,183,12,20,0,0
4527,1399,142,1466,331,37,13,1,67,189,13,20,0,0
4528,1382,142,1450,337,37,13,1,68,195,14,20,0,0
4529,1367,146,1435,339,37,13,1,68,193,15,20,0,0
4530,1347,145,1414,338,37,13,1,67,193,16,20,0,0
4531,1321,145,1391,339,37,13,1,70,194,17,20,0,0
4532,1298,148,1369,341,37,13,1,71,193,18,20,0,0
4533,1264,147,1336,348,37,13,1,72,201,19,20,0,0
4534,1246,148,1318,351,37,13,1,72,203,20,20,1,0
4519,1477,179,1512,271,38,13,1,35,92,0,1,0,0
4520,1472,177,1508,271,38,13,1,36,94,1,1,0,0
4836,1614,144,1649,285,39,13,1,35,141,0,22,0,0
4840,1576,144,1614,295,39,13,1,38,151,0,22,0,1
4841,1571,146,1610,298,39,13,1,39,152,1,22,0,0
4842,1566,147,1607,303,39,13,1,41,156,2,22,0,0
4843,1559,146,1601,303,39,13,1,42,157,3,22,0,0
4844,1552,150,1595,308,39,13,1,43,158,4,22,0,0
4845,1543,151,1586,309,39,13,1,43,158,5,22,0,0
4846,1534,150,1579,316,39,13,1,45,166,6,22,0,0
4847,1525,152,1572,320,39,13,1,47,168,7,22,0,0
4848,1516,153,1563,321,39,13,1,47,168,8,22,0,0
4849,1504,154,1553,325,39,13,1,49,171,9,22,0,0
4850,1491,155,1542,330,39,13,1,51,175,10,22,0,0
4851,1479,158,1531,333,39,13,1,52,175,11,22,0,0
4852,1461,157,1515,335,39,13,1,54,178,12,22,0,0
4853,1447,161,1502,338,39,13,1,55,177,13,22,0,0
4854,1429,159,1484,339,39,13,1,55,180,14,22,0,0
4855,1413,165,1470,342,39,13,1,57,177,15,22,0,0
4856,1393,155,1460,353,39,13,1,67,198,16,22,0,0
4857,1367,160,1429,344,39,13,1,62,184,17,22,0,0
4858,1343,163,1406,345,39,13,1,63,182,18,22,0,0
4859,1319,168,1382,347,39,13,1,63,179,19,22,0,0
4860,1290,165,1355,353,39,13,1,65,188,20,22,0,0
4861,1271,166,1337,353,39,13,1,66,187,21,22,0,0
4862,1254,167,1321,355,39,13,1,67,188,22,22,1,0
4846,1617,157,1653,282,40,13,1,36,125,0,30,0,1
4847,1612,156,1647,278,40,13,1,35,122,1,30,0,0
4848,1601,153,1640,287,40,13,1,39,134,2,30,0,0
4849,1590,150,1632,292,40,13,1,42,142,3,30,0,0
4850,1580,147,1624,295,40,13,1,44,148,4,30,0,0
4851,1571,147,1617,303,40,13,1,46,156,5,30,0,0
4852,1563,149,1610,306,40,13,1,47,157,6,30,0,0
4853,1561,152,1608,308,40,13,1,47,156,7,30,0,0
4854,1565,163,1609,310,40,13,1,44,147,8,30,0,0
4855,1563,166,1608,315,40,13,1,45,149,9,30,0,0
4856,1560,164,1604,313,40,13,1,44,149,10,30,0,0
4857,1553,167,1599,320,40,13,1,46,153,11,30,0,0
4858,1551,169,1595,317,40,13,1,44,148,12,30,0,0
4859,1543,167,1589,324,40,13,1,46,157,13,30,0,0
4860,1535,172,1582,328,40,13,1,47,156,14,30,0,0
4861,1525,170,1573,330,40,13,1,48,160,15,30,0,0
4862,1515,171,1564,333,40,13,1,49,162,16,30,0,0
4863,1506,174,1556,338,40,13,1,50,164,17,30,0,0
4864,1496,174,1549,352,40,13,1,53,178,18,30,0,0
4865,1487,176,1540,351,40,13,1,53,175,19,30,0,0
4866,1464,174,1523,354,40,13,1,59,180,20,30,0,0
4867,1432,166,1495,352,40,13,1,63,186,21,30,0,0
4868,1415,166,1481,355,40,13,1,66,189,22,30,0,0
4869,1391,166,1458,360,40,13,1,67,194,23,30,0,0
4870,1366,163,1436,361,40,13,1,70,198,24,30,0,0
4871,1346,161,1417,361,40,13,1,71,200,25,30,0,0
4872,1319,161,1389,356,40,13,1,70,195,26,30,0,0
4873,1294,162,1362,355,40,13,1,68,193,27,30,0,0
4874,1269,161,1338,355,40,13,1,69,194,28,30,0,0
4875,1257,162,1323,351,40,13,1,66,189,29,30,0,0
4876,1240,162,1307,352,40,13,1,67,190,30,30,1,0
4856,1534,156,1569,286,41,13,1,35,130,0,10,0,0
4857,1525,153,1563,289,41,13,1,38,136,1,10,0,0
4858,1521,156,1559,293,41,13,1,38,137,2,10,0,0
4859,1515,160,1556,307,41,13,1,41,147,3,10,0,0
4860,1505,157,1549,317,41,13,1,44,160,4,10,0,0
4861,1491,156,1535,313,41,13,1,44,157,5,10,0,0
4862,1481,157,1526,318,41,13,1,45,161,6,10,0,0
4863,1477,159,1518,309,41,13,1,41,150,7,10,0,0
4864,1468,163,1512,323,41,13,1,44,160,8,10,0,0
4865,1456,165,1501,330,41,13,1,45,165,9,10,0,0
4866,1448,166,1494,335,41,13,1,46,169,10,10,0,0
4965,1260,184,1312,418,43,13,1,52,234,0,33,0,1
4966,1268,177,1325,432,43,13,1,57,255,1,33,0,0
4967,1271,177,1327,429,43,13,1,56,252,2,33,0,0
4968,1286,179,1345,433,43,13,1,59,254,3,33,0,0
4969,1297,185,1359,447,43,13,1,62,262,4,33,0,0
4970,1305,186,1372,455,43,13,1,67,269,5,33,0,0
4971,1311,189,1382,468,43,13,1,71,279,6,33,0,0
4972,1319,192,1394,480,43,13,1,75,288,7,33,0,0
4973,1324,196,1403,496,43,13,1,79,300,8,33,0,0
4974,1323,201,1407,512,43,13,1,84,311,9,33,0,0
4975,1318,203,1408,528,43,13,1,90,325,10,33,0,0
4976,1315,209,1409,546,43,13,1,94,337,11,33,0,0
4977,1318,210,1416,559,43,13,1,98,349,12,33,0,0
4978,1314,220,1418,584,43,13,1,104,364,13,33,0,0
4979,1305,225,1414,605,43,13,1,109,380,14,33,0,0
4980,1295,231,1413,632,43,13,1,118,401,15,33,0,0
4981,1287,242,1412,665,43,13,1,125,423,16,33,0,0
4982,1278,243,1408,678,43,13,1,130,435,17,33,0,0
4983,1260,255,1396,711,43,13,1,136,456,18,33,0,0
4984,1243,264,1385,735,43,13,1,142,471,19,33,0,0
4985,1234,278,1386,772,43,13,1,152,494,20,33,0,0
4986,1224,291,1390,822,43,13,1,166,531,21,33,0,0
4987,1206,300,1383,860,43,13,1,177,560,22,33,0,0
4988,1183,326,1371,927,43,13,1,188,601,23,33,0,0
4989,1165,341,1360,959,43,13,1,195,618,24,33,0,0
4990,1154,363,1369,1037,43,13,1,215,674,25,33,0,0
4991,1138,388,1359,1068,43,13,1,221,680,26,33,0,0
4992,1115,413,1338,1080,43,13,1,223,667,27,33,0,0
4993,1088,461,1304,1080,43,13,1,216,619,28,33,0,0
4994,1056,497,1270,1080,43,13,1,214,583,29,33,0,0
4995,1034,565,1241,1080,43,13,1,207,515,30,33,0,0
4996,1004,635,1204,1080,43,13,1,200,445,31,33,0,0
4997,969,734,1150,1080,43,13,1,181,346,32,33,0,0
4998,955,773,1125,1080,43,13,1,170,307,33,33,1,0
5378,1597,169,1640,282,45,13,1,43,113,0,26,0,1
5379,1582,158,1630,284,45,13,1,48,126,1,26,0,0
5380,1564,153,1615,288,45,13,1,51,135,2,26,0,0
5381,1546,149,1600,291,45,13,1,54,142,3,26,0,0
5382,1535,149,1590,293,45,13,1,55,144,4,26,0,0
5383,1526,149,1580,291,45,13,1,54,142,5,26,0,0
5384,1516,151,1571,296,45,13,1,55,145,6,26,0,0
5385,1506,152,1561,298,45,13,1,55,146,7,26,0,0
5386,1496,151,1556,310,45,13,1,60,159,8,26,0,0
5387,1488,153,1548,314,45,13,1,60,161,9,26,0,0
5388,1482,152,1541,311,45,13,1,59,159,10,26,0,0
5389,1477,154,1536,314,45,13,1,59,160,11,26,0,0
5390,1469,157,1528,317,45,13,1,59,160,12,26,0,0
5391,1457,153,1520,320,45,13,1,63,167,13,26,0,0
5392,1445,153,1510,326,45,13,1,65,173,14,26,0,0
5393,1437,154,1502,329,45,13,1,65,175,15,26,0,0
5394,1429,154,1493,329,45,13,1,64,175,16,26,0,0
5395,1415,158,1482,334,45,13,1,67,176,17,26,0,0
5396,1403,162,1469,336,45,13,1,66,174,18,26,0,0
5397,1383,156,1451,339,45,13,1,68,183,19,26,0,0
5398,1365,160,1433,338,45,13,1,68,178,20,26,0,0
5399,1348,160,1414,336,45,13,1,66,176,21,26,0,0
5400,1330,163,1395,334,45,13,1,65,171,22,26,0,0
5401,1311,166,1375,332,45,13,1,64,166,23,26,0,0
5402,1286,164,1351,333,45,13,1,65,169,24,26,0,0
5403,1265,166,1329,334,45,13,1,64,168,25,26,0,0
5404,1249,167,1314,335,45,13,1,65,168,26,26,1,0
5385,1479,174,1514,268,46,13,1,35,94,0,0,0,0
5502,1339,152,1374,338,47,13,1,35,186,0,27,0,1
5503,1363,149,1401,337,47,13,1,38,188,1,27,0,0
5504,1388,151,1428,338,47,13,1,40,187,2,27,0,0
5505,1412,154,1454,336,47,13,1,42,182,3,27,0,0
5506,1430,152,1474,335,47,13,1,44,183,4,27,0,0
5507,1450,150,1495,332,47,13,1,45,182,5,27,0,0
5508,1465,151,1513,334,47,13,1,48,183,6,27,0,0
5509,1480,149,1529,333,47,13,1,49,184,7,27,0,0
5510,1492,150,1542,327,47,13,1,50,177,8,27,0,0
5511,1503,149,1553,324,47,13,1,50,175,9,27,0,0
5512,1514,147,1564,316,47,13,1,50,169,10,27,0,0
5513,1521,147,1571,314,47,13,1,50,167,11,27,0,0
5514,1523,147,1575,314,47,13,1,52,167,12,27,0,0
5515,1523,145,1574,306,47,13,1,51,161,13,27,0,0
5516,1521,145,1572,303,47,13,1,51,158,14,27,0,0
5517,1515,144,1566,300,47,13,1,51,156,15,27,0,0
5518,1504,145,1556,300,47,13,1,52,155,16,27,0,0
5519,1491,146,1545,299,47,13,1,54,153,17,27,0,0
5520,1495,146,1548,297,47,13,1,53,151,18,27,0,0
5521,1462,142,1516,294,47,13,1,54,152,19,27,0,0
5522,1450,143,1506,296,47,13,1,56,153,20,27,0,0
5523,1443,141,1500,296,47,13,1,57,155,21,27,0,0
5524,1435,141,1491,294,47,13,1,56,153,22,27,0,0
5525,1429,140,1484,291,47,13,1,55,151,23,27,0,0
5526,1421,142,1476,294,47,13,1,55,152,24,27,0,0
5527,1418,147,1470,291,47,13,1,52,144,25,27,0,0
5528,1418,155,1465,284,47,13,1,47,129,26,27,0,0
5529,1415,156,1460,282,47,13,1,45,126,27,27,1,0
5517,1478,170,1515,272,48,13,1,37,102,0,0,0,0
5520,1435,143,1527,297,49,13,1,92,154,0,0,0,0
5577,1269,204,1309,417,50,13,1,40,213,0,35,0,1
5578,1274,210,1317,432,50,13,1,43,222,1,35,0,0
5579,1279,212,1323,432,50,13,1,44,220,2,35,0,0
5580,1287,220,1333,441,50,13,1,46,221,3,35,0,0
5581,1296,224,1343,444,50,13,1,47,220,4,35,0,0
5582,1305,225,1356,456,50,13,1,51,231,5,35,0,0
5583,1316,230,1371,469,50,13,1,55,239,6,35,0,0
5584,1324,233,1381,478,50,13,1,57,245,7,35,0,0
5585,1328,239,1390,496,50,13,1,62,257,8,35,0,0
5586,1337,244,1401,503,50,13,1,64,259,9,35,0,0
5587,1336,251,1405,519,50,13,1,69,268,10,35,0,0
5588,1342,257,1414,535,50,13,1,72,278,11,35,0,0
5589,1347,261,1423,546,50,13,1,76,285,12,35,0,0
5590,1350,271,1433,574,50,13,1,83,303,13,35,0,0
5591,1345,273,1432,588,50,13,1,87,315,14,35,0,0
5592,1345,286,1432,601,50,13,1,87,315,15,35,0,0
5593,1348,293,1440,615,50,13,1,92,322,16,35,0,0
5594,1347,299,1450,654,50,13,1,103,355,17,35,0,0
5595,1346,308,1453,673,50,13,1,107,365,18,35,0,0
5596,1337,320,1451,704,50,13,1,114,384,19,35,0,0
5597,1331,336,1450,737,50,13,1,119,401,20,35,0,0
5598,1327,347,1451,759,50,13,1,124,412,21,35,0,0
5599,1316,369,1448,805,50,13,1,132,436,22,35,0,0
5600,1302,377,1441,833,50,13,1,139,456,23,35,0,0
5601,1282,402,1434,904,50,13,1,152,502,24,35,0,0
5602,1270,425,1428,940,50,13,1,158,515,25,35,0,0
5603,1256,448,1424,993,50,13,1,168,545,26,35,0,0
5604,1234,480,1414,1053,50,13,1,180,573,27,35,0,0
5605,1212,508,1395,1075,50,13,1,183,567,28,35,0,0
5606,1199,559,1374,1080,50,13,1,175,521,29,35,0,0
5607,1177,600,1349,1080,50,13,1,172,480,30,35,0,0
5608,1153,665,1316,1080,50,13,1,163,415,31,35,0,0
5609,1115,727,1269,1080,50,13,1,154,353,32,35,0,0
5610,1069,822,1205,1080,50,13,1,136,258,33,35,0,0
5611,1060,935,1152,1080,50,13,1,92,145,34,35,0,0
5612,1051,989,1117,1080,50,13,1,66,91,35,35,1,0
5579,1614,146,1653,276,51,13,1,39,130,0,0,0,0
5585,1538,141,1573,278,52,13,1,35,137,0,14,0,0
5586,1523,139,1562,284,52,13,1,39,145,1,14,0,0
5587,1512,140,1552,290,52,13,1,40,150,2,14,0,0
5588,1501,141,1541,289,52,13,1,40,148,3,14,0,0
5589,1488,144,1528,288,52,13,1,40,144,4,14,0,0
5590,1475,144,1516,289,52,13,1,41,145,5,14,0,0
5591,1465,143,1508,294,52,13,1,43,151,6,14,0,0
5592,1451,148,1493,292,52,13,1,42,144,7,14,0,0
5593,1443,146,1485,290,52,13,1,42,144,8,14,0,0
5594,1436,144,1478,289,52,13,1,42,145,9,14,0,0
5595,1428,142,1474,294,52,13,1,46,152,10,14,0,0
5596,1421,143,1468,298,52,13,1,47,155,11,14,0,0
5597,1420,156,1463,294,52,13,1,43,138,12,14,0,0
5598,1411,160,1453,295,52,13,1,42,135,13,14,0,0
5599,1402,162,1444,296,52,13,1,42,134,14,14,0,0
5581,1609,158,1649,288,53,13,1,40,130,0,259,0,1
5582,1601,150,1642,283,53,13,1,41,133,1,259,0,0
5583,1591,159,1630,285,53,13,1,39,126,2,259,0,0
5584,1581,151,1623,289,53,13,1,42,138,3,259,0,0
5585,1569,148,1612,291,53,13,1,43,143,4,259,0,0
5586,1558,150,1602,295,53,13,1,44,145,5,259,0,0
5587,1549,150,1593,299,53,13,1,44,149,6,259,0,0
5588,1539,151,1583,300,53,13,1,44,149,7,259,0,0
5589,1529,152,1573,302,53,13,1,44,150,8,259,0,0
5590,1521,152,1566,304,53,13,1,45,152,9,259,0,0
5591,1514,158,1556,302,53,13,1,42,144,10,259,0,0
5592,1499,154,1544,309,53,13,1,45,155,11,259,0,0
5593,1492,164,1535,311,53,13,1,43,147,12,259,0,0
5594,1486,161,1530,311,53,13,1,44,150,13,259,0,0
5595,1478,155,1522,305,53,13,1,44,150,14,259,0,0
5596,1470,156,1515,310,53,13,1,45,154,15,259,0,0
5597,1468,175,1509,315,53,13,1,41,140,16,259,0,0
5598,1459,163,1505,318,53,13,1,46,155,17,259,0,0
5599,1449,160,1496,318,53,13,1,47,158,18,259,0,0
5600,1441,156,1490,321,53,13,1,49,165,19,259,0,0
5601,1438,156,1485,316,53,13,1,47,160,20,259,0,0
5602,1436,152,1485,320,53,13,1,49,168,21,259,0,0
5603,1435,153,1483,318,53,13,1,48,165,22,259,0,0
5604,1434,153,1484,321,53,13,1,50,168,23,259,0,0
5605,1436,153,1484,318,53,13,1,48,165,24,259,0,0
5606,1436,152,1485,320,53,13,1,49,168,25,259,0,0
5607,1436,151,1485,323,53,13,1,49,172,26,259,0,0
5608,1435,150,1485,323,53,13,1,50,173,27,259,0,0
5609,1437,151,1485,321,53,13,1,48,170,28,259,0,0
5610,1437,151,1485,320,53,13,1,48,169,29,259,0,0
5611,1438,151,1485,320,53,13,1,47,169,30,259,0,0
5612,1438,151,1485,320,53,13,1,47,169,31,259,0,0
5613,1438,151,1485,320,53,13,1,47,169,32,259,0,0
5614,1439,152,1485,319,53,13,1,46,167,33,259,0,0
5615,1439,150,1486,323,53,13,1,47,173,34,259,0,0
5616,1439,150,1486,324,53,13,1,47,174,35,259,0,0
5617,1440,150,1486,323,53,13,1,46,173,36,259,0,0
5618,1441,150,1487,321,53,13,1,46,171,37,259,0,0
5619,1441,152,1486,318,53,13,1,45,166,38,259,0,0
5620,1441,152,1486,319,53,13,1,45,167,39,259,0,0
5621,1444,154,1487,312,53,13,1,43,158,40,259,0,0
5622,1448,154,1492,316,53,13,1,44,162,41,259,0,0
5623,1450,154,1496,320,53,13,1,46,166,42,259,0,0
5624,1454,155,1501,321,53,13,1,47,166,43,259,0,0
5625,1458,155,1505,324,53,13,1,47,169,44,259,0,0
5626,1459,156,1507,324,53,13,1,48,168,45,259,0,0
5627,1461,156,1509,324,53,13,1,48,168,46,259,0,0
5628,1464,157,1510,323,53,13,1,46,166,47,259,0,0
5629,1464,158,1510,323,53,13,1,46,165,48,259,0,0
5630,1464,158,1510,323,53,13,1,46,165,49,259,0,0
5631,1466,168,1509,322,53,13,1,43,154,50,259,0,0
5632,1467,174,1508,322,53,13,1,41,148,51,259,0,0
5633,1467,174,1508,323,53,13,1,41,149,52,259,0,0
5634,1467,176,1507,323,53,13,1,40,147,53,259,0,0
5635,1468,182,1506,323,53,13,1,38,141,54,259,0,0
5636,1468,183,1507,324,53,13,1,39,141,55,259,0,0
5637,1468,185,1506,325,53,13,1,38,140,56,259,0,0
5638,1468,186,1506,325,53,13,1,38,139,57,259,0,0
5639,1468,186,1506,325,53,13,1,38,139,58,259,0,0
5640,1468,187,1506,325,53,13,1,38,138,59,259,0,0
5641,1468,187,1506,325,53,13,1,38,138,60,259,0,0
5642,1467,187,1506,324,53,13,1,39,137,61,259,0,0
5643,1468,189,1506,324,53,13,1,38,135,62,259,0,0
5644,1468,190,1506,324,53,13,1,38,134,63,259,0,0
5645,1468,189,1506,325,53,13,1,38,136,64,259,0,0
5646,1467,186,1507,325,53,13,1,40,139,65,259,0,0
5647,1467,185,1507,325,53,13,1,40,140,66,259,0,0
5648,1467,186,1507,325,53,13,1,40,139,67,259,0,0
5649,1467,188,1507,325,53,13,1,40,137,68,259,0,0
5650,1467,187,1507,325,53,13,1,40,138,69,259,0,0
5651,1468,188,1507,325,53,13,1,39,137,70,259,0,0
5652,1468,188,1507,325,53,13,1,39,137,71,259,0,0
5653,1468,189,1507,325,53,13,1,39,136,72,259,0,0
5654,1468,190,1507,325,53,13,1,39,135,73,259,0,0
5655,1468,191,1507,325,53,13,1,39,134,74,259,0,0
5656,1468,190,1507,325,53,13,1,39,135,75,259,0,0
5657,1468,189,1507,325,53,13,1,39,136,76,259,0,0
5658,1468,190,1507,325,53,13,1,39,135,77,259,0,0
5659,1468,190,1507,325,53,13,1,39,135,78,259,0,0
5660,1467,190,1507,325,53,13,1,40,135,79,259,0,0
5661,1467,191,1507,325,53,13,1,40,134,80,259,0,0
5662,1467,191,1507,325,53,13,1,40,134,81,259,0,0
5663,1467,190,1507,325,53,13,1,40,135,82,259,0,0
5664,1467,188,1507,325,53,13,1,40,137,83,259,0,0
5665,1467,188,1507,325,53,13,1,40,137,84,259,0,0
5666,1467,187,1507,325,53,13,1,40,138,85,259,0,0
5667,1467,187,1507,325,53,13,1,40,138,86,259,0,0
5668,1466,181,1508,325,53,13,1,42,144,87,259,0,0
5669,1467,186,1508,325,53,13,1,41,139,88,259,0,0
5670,1467,187,1507,325,53,13,1,40,138,89,259,0,0
5671,1467,185,1507,325,53,13,1,40,140,90,259,0,0
5672,1467,185,1508,325,53,13,1,41,140,91,259,0,0
5673,1467,182,1508,325,53,13,1,41,143,92,259,0,0
5674,1467,183,1508,325,53,13,1,41,142,93,259,0,0
5675,1468,187,1507,324,53,13,1,39,137,94,259,0,0
5676,1468,188,1507,324,53,13,1,39,136,95,259,0,0
5677,1467,184,1508,324,53,13,1,41,140,96,259,0,0
5678,1466,178,1509,324,53,13,1,43,146,97,259,0,0
5679,1464,170,1508,324,53,13,1,44,154,98,259,0,0
5680,1461,163,1508,324,53,13,1,47,161,99,259,0,0
5681,1452,147,1502,318,53,13,1,50,171,100,259,0,0
5682,1456,144,1507,316,53,13,1,51,172,101,259,0,0
5683,1462,148,1513,320,53,13,1,51,172,102,259,0,0
5684,1463,161,1512,325,53,13,1,49,164,103,259,0,0
5685,1464,161,1513,325,53,13,1,49,164,104,259,0,0
5686,1465,165,1512,326,53,13,1,47,161,105,259,0,0
5687,1467,178,1511,326,53,13,1,44,148,106,259,0,0
5688,1467,182,1509,325,53,13,1,42,143,107,259,0,0
5689,1467,181,1508,324,53,13,1,41,143,108,259,0,0
5690,1468,184,1508,324,53,13,1,40,140,109,259,0,0
5691,1467,183,1508,324,53,13,1,41,141,110,259,0,0
5692,1467,182,1508,324,53,13,1,41,142,111,259,0,0
5693,1467,182,1508,324,53,13,1,41,142,112,259,0,0
5694,1465,179,1507,324,53,13,1,42,145,113,259,0,0
5695,1466,181,1508,324,53,13,1,42,143,114,259,0,0
5696,1467,180,1508,324,53,13,1,41,144,115,259,0,0
5697,1467,178,1508,324,53,13,1,41,146,116,259,0,0
5698,1467,179,1508,324,53,13,1,41,145,117,259,0,0
5699,1467,181,1508,323,53,13,1,41,142,118,259,0,0
5700,1467,181,1508,323,53,13,1,41,142,119,259,0,0
5701,1467,180,1508,323,53,13,1,41,143,120,259,0,0
5702,1467,183,1507,324,53,13,1,40,141,121,259,0,0
5703,1468,185,1507,324,53,13,1,39,139,122,259,0,0
5704,1468,187,1507,324,53,13,1,39,137,123,259,0,0
5705,1467,184,1507,324,53,13,1,40,140,124,259,0,0
5706,1468,184,1508,324,53,13,1,40,140,125,259,0,0
5707,1468,184,1508,324,53,13,1,40,140,126,259,0,0
5708,1468,185,1508,324,53,13,1,40,139,127,259,0,0
5709,1468,187,1508,325,53,13,1,40,138,128,259,0,0
5710,1469,187,1507,325,53,13,1,38,138,129,259,0,0
5711,1468,188,1507,325,53,13,1,39,137,130,259,0,0
5712,1468,188,1507,325,53,13,1,39,137,131,259,0,0
5713,1468,188,1507,325,53,13,1,39,137,132,259,0,0
5714,1467,180,1508,325,53,13,1,41,145,133,259,0,0
5715,1467,184,1507,325,53,13,1,40,141,134,259,0,0
5716,1468,187,1507,325,53,13,1,39,138,135,259,0,0
5717,1468,189,1506,325,53,13,1,38,136,136,259,0,0
5718,1468,188,1507,325,53,13,1,39,137,137,259,0,0
5719,1468,188,1507,325,53,13,1,39,137,138,259,0,0
5720,1468,188,1507,325,53,13,1,39,137,139,259,0,0
5721,1468,186,1507,325,53,13,1,39,139,140,259,0,0
5722,1467,185,1508,325,53,13,1,41,140,141,259,0,0
5723,1468,186,1507,325,53,13,1,39,139,142,259,0,0
5724,1468,186,1507,325,53,13,1,39,139,143,259,0,0
5725,1467,188,1507,325,53,13,1,40,137,144,259,0,0
5726,1468,188,1507,325,53,13,1,39,137,145,259,0,0
5727,1468,188,1507,325,53,13,1,39,137,146,259,0,0
5728,1468,188,1507,325,53,13,1,39,137,147,259,0,0
5729,1468,189,1507,325,53,13,1,39,136,148,259,0,0
5730,1469,189,1507,325,53,13,1,38,136,149,259,0,0
5731,1468,186,1507,325,53,13,1,39,139,150,259,0,0
5732,1468,187,1507,325,53,13,1,39,138,151,259,0,0
5733,1468,187,1507,325,53,13,1,39,138,152,259,0,0
5734,1468,189,1507,324,53,13,1,39,135,153,259,0,0
5735,1468,190,1506,324,53,13,1,38,134,154,259,0,0
5736,1468,190,1507,324,53,13,1,39,134,155,259,0,0
5737,1467,189,1506,324,53,13,1,39,135,156,259,0,0
5738,1467,189,1506,324,53,13,1,39,135,157,259,0,0
5739,1467,187,1506,323,53,13,1,39,136,158,259,0,0
5740,1467,189,1506,324,53,13,1,39,135,159,259,0,0
5741,1467,188,1507,324,53,13,1,40,136,160,259,0,0
5742,1468,189,1507,324,53,13,1,39,135,161,259,0,0
5743,1468,189,1507,325,53,13,1,39,136,162,259,0,0
5744,1468,190,1507,325,53,13,1,39,135,163,259,0,0
5745,1468,191,1507,325,53,13,1,39,134,164,259,0,0
5746,1469,193,1507,324,53,13,1,38,131,165,259,0,0
5747,1469,193,1507,324,53,13,1,38,131,166,259,0,0
5748,1469,194,1507,324,53,13,1,38,130,167,259,0,0
5749,1468,192,1507,323,53,13,1,39,131,168,259,0,0
5750,1468,193,1507,323,53,13,1,39,130,169,259,0,0
5751,1468,192,1507,324,53,13,1,39,132,170,259,0,0
5752,1467,189,1507,324,53,13,1,40,135,171,259,0,0
5753,1467,187,1507,324,53,13,1,40,137,172,259,0,0
5754,1468,190,1507,325,53,13,1,39,135,173,259,0,0
5755,1468,191,1507,325,53,13,1,39,134,174,259,0,0
5756,1467,188,1507,325,53,13,1,40,137,175,259,0,0
5757,1467,188,1507,325,53,13,1,40,137,176,259,0,0
5758,1466,182,1507,325,53,13,1,41,143,177,259,0,0
5759,1467,185,1507,325,53,13,1,40,140,178,259,0,0
5760,1467,186,1507,325,53,13,1,40,139,179,259,0,0
5761,1467,186,1507,325,53,13,1,40,139,180,259,0,0
5762,1467,187,1507,325,53,13,1,40,138,181,259,0,0
5763,1468,189,1506,325,53,13,1,38,136,182,259,0,0
5764,1468,189,1506,325,53,13,1,38,136,183,259,0,0
5765,1468,189,1506,325,53,13,1,38,136,184,259,0,0
5766,1468,190,1506,325,53,13,1,38,135,185,259,0,0
5767,1468,190,1506,325,53,13,1,38,135,186,259,0,0
5768,1468,190,1506,325,53,13,1,38,135,187,259,0,0
5769,1468,190,1506,325,53,13,1,38,135,188,259,0,0
5770,1467,189,1506,325,53,13,1,39,136,189,259,0,0
5771,1467,187,1507,325,53,13,1,40,138,190,259,0,0
5772,1467,186,1507,325,53,13,1,40,139,191,259,0,0
5773,1467,186,1507,325,53,13,1,40,139,192,259,0,0
5774,1467,186,1507,325,53,13,1,40,139,193,259,0,0
5775,1468,189,1506,325,53,13,1,38,136,194,259,0,0
5776,1468,192,1506,324,53,13,1,38,132,195,259,0,0
5777,1468,192,1506,324,53,13,1,38,132,196,259,0,0
5778,1468,191,1506,324,53,13,1,38,133,197,259,0,0
5779,1468,191,1507,324,53,13,1,39,133,198,259,0,0
5780,1468,190,1507,324,53,13,1,39,134,199,259,0,0
5781,1468,189,1507,324,53,13,1,39,135,200,259,0,0
5782,1468,191,1507,325,53,13,1,39,134,201,259,0,0
5783,1468,189,1507,325,53,13,1,39,136,202,259,0,0
5784,1468,191,1506,325,53,13,1,38,134,203,259,0,0
5785,1468,191,1507,324,53,13,1,39,133,204,259,0,0
5786,1467,187,1507,324,53,13,1,40,137,205,259,0,0
5787,1468,188,1507,324,53,13,1,39,136,206,259,0,0
5788,1468,188,1506,324,53,13,1,38,136,207,259,0,0
5789,1467,186,1507,324,53,13,1,40,138,208,259,0,0
5790,1466,180,1508,325,53,13,1,42,145,209,259,0,0
5791,1466,177,1508,325,53,13,1,42,148,210,259,0,0
5792,1466,176,1508,325,53,13,1,42,149,211,259,0,0
5793,1468,184,1507,325,53,13,1,39,141,212,259,0,0
5794,1468,187,1506,325,53,13,1,38,138,213,259,0,0
5795,1468,186,1506,325,53,13,1,38,139,214,259,0,0
5796,1468,186,1507,325,53,13,1,39,139,215,259,0,0
5797,1467,187,1506,325,53,13,1,39,138,216,259,0,0
5798,1468,190,1506,324,53,13,1,38,134,217,259,0,0
5799,1469,191,1506,324,53,13,1,37,133,218,259,0,0
5800,1468,191,1506,323,53,13,1,38,132,219,259,0,0
5801,1469,191,1507,323,53,13,1,38,132,220,259,0,0
5802,1469,192,1507,323,53,13,1,38,131,221,259,0,0
5803,1469,193,1507,323,53,13,1,38,130,222,259,0,0
5804,1469,195,1507,323,53,13,1,38,128,223,259,0,0
5805,1469,195,1506,323,53,13,1,37,128,224,259,0,0
5806,1469,195,1506,323,53,13,1,37,128,225,259,0,0
5807,1469,195,1506,323,53,13,1,37,128,226,259,0,0
5808,1469,195,1506,323,53,13,1,37,128,227,259,0,0
5809,1469,194,1506,323,53,13,1,37,129,228,259,0,0
5810,1469,194,1506,323,53,13,1,37,129,229,259,0,0
5811,1469,193,1506,323,53,13,1,37,130,230,259,0,0
5812,1469,193,1506,323,53,13,1,37,130,231,259,0,0
5813,1469,194,1506,323,53,13,1,37,129,232,259,0,0
5814,1469,194,1506,323,53,13,1,37,129,233,259,0,0
5815,1468,195,1506,323,53,13,1,38,128,234,259,0,0
5816,1468,196,1505,323,53,13,1,37,127,235,259,0,0
5817,1466,191,1506,323,53,13,1,40,132,236,259,0,0
5818,1464,163,1510,322,53,13,1,46,159,237,259,0,0
5819,1460,149,1510,322,53,13,1,50,173,238,259,0,0
5820,1460,145,1512,323,53,13,1,52,178,239,259,0,0
5821,1461,142,1513,325,53,13,1,52,183,240,259,0,0
5822,1461,139,1514,325,53,13,1,53,186,241,259,0,0
5823,1460,143,1512,326,53,13,1,52,183,242,259,0,0
5824,1457,150,1506,325,53,13,1,49,175,243,259,0,0
5825,1451,155,1499,323,53,13,1,48,168,244,259,0,0
5826,1444,156,1494,324,53,13,1,50,168,245,259,0,0
5827,1435,158,1486,327,53,13,1,51,169,246,259,0,0
5828,1424,153,1475,328,53,13,1,51,175,247,259,0,0
5829,1414,153,1467,333,53,13,1,53,180,248,259,0,0
5830,1402,157,1455,338,53,13,1,53,181,249,259,0,0
5831,1389,156,1442,337,53,13,1,53,181,250,259,0,0
5832,1374,156,1428,336,53,13,1,54,180,251,259,0,0
5833,1360,159,1416,336,53,13,1,56,177,252,259,0,0
5834,1341,156,1395,333,53,13,1,54,177,253,259,0,0
5835,1323,159,1378,335,53,13,1,55,176,254,259,0,0
5836,1302,161,1357,337,53,13,1,55,176,255,259,0,0
5837,1284,161,1339,338,53,13,1,55,177,256,259,0,0
5838,1266,159,1320,331,53,13,1,54,172,257,259,0,0
5839,1253,170,1299,322,53,13,1,46,152,258,259,0,0
5840,1240,171,1285,321,53,13,1,45,150,259,259,1,0
5684,1499,147,1550,284,57,13,1,51,137,0,9,0,0
5685,1510,143,1564,288,57,13,1,54,145,1,9,0,0
5686,1525,142,1579,287,57,13,1,54,145,2,9,0,0
5687,1541,142,1594,286,57,13,1,53,144,3,9,0,0
5688,1561,142,1613,281,57,13,1,52,139,4,9,0,0
5689,1581,146,1631,279,57,13,1,50,133,5,9,0,0
5690,1596,149,1644,276,57,13,1,48,127,6,9,0,0
5691,1613,150,1661,277,57,13,1,48,127,7,9,0,0
5692,1626,162,1667,274,57,13,1,41,112,8,9,0,0
5693,1641,164,1680,272,57,13,1,39,108,9,9,0,0
5817,1425,145,1464,286,59,13,1,39,141,0,1,0,0
5818,1433,142,1475,293,59,13,1,42,151,1,1,0,0
5823,1488,148,1536,302,60,13,1,48,154,0,18,0,0
5824,1487,148,1539,314,60,13,1,52,166,1,18,0,0
5825,1489,144,1543,318,60,13,1,54,174,2,18,0,0
5826,1486,145,1541,321,60,13,1,55,176,3,18,0,0
5827,1482,146,1539,325,60,13,1,57,179,4,18,0,0
5828,1478,146,1537,327,60,13,1,59,181,5,18,0,0
5829,1475,148,1535,332,60,13,1,60,184,6,18,0,0
5830,1467,149,1528,335,60,13,1,61,186,7,18,0,0
5831,1456,149,1519,338,60,13,1,63,189,8,18,0,0
5832,1445,151,1509,339,60,13,1,64,188,9,18,0,0
5833,1431,150,1497,344,60,13,1,66,194,10,18,0,0
5834,1413,148,1479,343,60,13,1,66,195,11,18,0,0
5835,1397,153,1464,349,60,13,1,67,196,12,18,0,0
5836,1374,156,1441,353,60,13,1,67,197,13,18,0,0
5837,1351,153,1417,350,60,13,1,66,197,14,18,0,0
5838,1324,154,1394,350,60,13,1,70,196,15,18,0,0
5839,1302,155,1370,347,60,13,1,68,192,16,18,0,0
5840,1272,156,1341,352,60,13,1,69,196,17,18,0,0
5841,1256,157,1326,355,60,13,1,70,198,18,18,0,0
5986,1257,157,1299,368,61,13,1,42,211,0,1,0,0
5987,1266,163,1306,363,61,13,1,40,200,1,1,0,0
5988,1285,167,1348,358,62,13,1,63,191,0,12,0,0
5989,1299,163,1363,356,62,13,1,64,193,1,12,0,0
5990,1301,172,1357,341,62,13,1,56,169,2,12,0,0
5991,1319,172,1373,334,62,13,1,54,162,3,12,0,0
5992,1347,168,1400,328,62,13,1,53,160,4,12,0,0
5993,1370,166,1424,326,62,13,1,54,160,5,12,0,0
5994,1389,162,1443,322,62,13,1,54,160,6,12,0,0
5995,1405,161,1463,334,62,13,1,58,173,7,12,0,0
5996,1421,156,1478,329,62,13,1,57,173,8,12,0,0
5997,1436,157,1492,329,62,13,1,56,172,9,12,0,0
5998,1447,155,1504,329,62,13,1,57,174,10,12,0,0
5999,1460,153,1517,325,62,13,1,57,172,11,12,0,0
6000,1469,153,1525,323,62,13,1,56,170,12,12,0,0
5990,1342,166,1395,343,63,13,1,53,177,0,10,0,0
5991,1366,159,1421,341,63,13,1,55,182,1,10,0,0
5992,1389,160,1445,348,63,13,1,56,188,2,10,0,0
5993,1412,159,1471,354,63,13,1,59,195,3,10,0,0
5994,1432,161,1490,354,63,13,1,58,193,4,10,0,0
5995,1454,160,1511,347,63,13,1,57,187,5,10,0,0
5996,1474,157,1532,346,63,13,1,58,189,6,10,0,0
5997,1485,155,1546,351,63,13,1,61,196,7,10,0,0
5998,1500,154,1559,341,63,13,1,59,187,8,10,0,0
5999,1512,155,1570,341,63,13,1,58,186,9,10,0,0
6000,1522,153,1579,334,63,13,1,57,181,10,10,0,0
707,547,279,637,499,2,13,10,90,220,0,39,0,1
708,543,274,634,498,2,13,10,91,224,1,39,0,0
709,516,266,609,497,2,13,10,93,231,2,39,0,0
710,486,270,578,495,2,13,10,92,225,3,39,0,0
711,455,266,545,489,2,13,10,90,223,4,39,0,0
712,413,263,505,489,2,13,10,92,226,5,39,0,0
713,390,261,483,490,2,13,10,93,229,6,39,0,0
714,369,259,458,482,2,13,10,89,223,7,39,0,0
715,350,258,439,479,2,13,10,89,221,8,39,0,0
716,326,256,408,467,2,13,10,82,211,9,39,0,0
717,303,252,384,462,2,13,10,81,210,10,39,0,0
718,280,252,364,466,2,13,10,84,214,11,39,0,0
719,261,248,342,459,2,13,10,81,211,12,39,0,0
720,246,245,327,458,2,13,10,81,213,13,39,0,0
721,232,242,314,459,2,13,10,82,217,14,39,0,0
722,220,240,296,446,2,13,10,76,206,15,39,0,0
723,204,238,278,438,2,13,10,74,200,16,39,0,0
724,191,241,261,433,2,13,10,70,192,17,39,0,0
725,183,236,252,427,2,13,10,69,191,18,39,0,0
726,176,235,245,427,2,13,10,69,192,19,39,0,0
727,169,236,233,416,2,13,10,64,180,20,39,0,0
728,160,232,224,413,2,13,10,64,181,21,39,0,0
729,150,234,213,413,2,13,10,63,179,22,39,0,0
730,144,232,204,404,2,13,10,60,172,23,39,0,0
731,140,233,199,399,2,13,10,59,166,24,39,0,0
732,135,232,195,396,2,13,10,60,164,25,39,0,0
733,128,229,187,394,2,13,10,59,165,26,39,0,0
734,123,230,180,389,2,13,10,57,159,27,39,0,0
735,115,232,170,389,2,13,10,55,157,28,39,0,0
736,111,231,163,379,2,13,10,52,148,29,39,0,0
737,106,236,158,381,2,13,10,52,145,30,39,0,0
738,101,234,150,373,2,13,10,49,139,31,39,0,0
739,93,232,141,368,2,13,10,48,136,32,39,0,0
740,85,235,131,368,2,13,10,46,133,33,39,0,0
741,77,226,126,368,2,13,10,49,142,34,39,0,0
742,72,224,121,364,2,13,10,49,140,35,39,0,0
743,66,224,114,364,2,13,10,48,140,36,39,0,0
744,58,223,102,354,2,13,10,44,131,37,39,0,0
745,48,223,92,359,2,13,10,44,136,38,39,0,0
746,40,222,84,357,2,13,10,44,135,39,39,1,0
751,212,220,247,334,3,13,10,35,114,0,6,0,0
752,201,222,236,334,3,13,10,35,112,1,6,0,0
753,182,216,219,332,3,13,10,37,116,2,6,0,0
754,168,211,207,330,3,13,10,39,119,3,6,0,0
755,161,210,198,327,3,13,10,37,117,4,6,0,0
756,154,212,190,322,3,13,10,36,110,5,6,0,0
757,146,214,181,322,3,13,10,35,108,6,6,0,0
1617,51,220,96,361,4,13,10,45,141,0,43,0,1
1618,61,223,105,360,4,13,10,44,137,1,43,0,0
1619,72,222,117,363,4,13,10,45,141,2,43,0,0
1620,83,228,126,364,4,13,10,43,136,3,43,0,0
1621,93,233,133,358,4,13,10,40,125,4,43,0,0
1622,101,227,144,363,4,13,10,43,136,5,43,0,0
1623,108,232,153,369,4,13,10,45,137,6,43,0,0
1624,115,231,160,371,4,13,10,45,140,7,43,0,0
1625,120,230,168,377,4,13,10,48,147,8,43,0,0
1626,124,231,172,380,4,13,10,48,149,9,43,0,0
1627,130,231,179,379,4,13,10,49,148,10,43,0,0
1628,135,230,186,387,4,13,10,51,157,11,43,0,0
1629,140,232,192,394,4,13,10,52,162,12,43,0,0
1630,144,233,197,395,4,13,10,53,162,13,43,0,0
1631,147,234,202,401,4,13,10,55,167,14,43,0,0
1632,150,238,204,402,4,13,10,54,164,15,43,0,0
1633,151,235,207,408,4,13,10,56,173,16,43,0,0
1634,154,234,211,415,4,13,10,57,181,17,43,0,0
1635,158,235,216,422,4,13,10,58,187,18,43,0,0
1636,163,232,223,422,4,13,10,60,190,19,43,0,0
1637,166,235,227,427,4,13,10,61,192,20,43,0,0
1638,172,240,231,427,4,13,10,59,187,21,43,0,0
1639,179,238,240,434,4,13,10,61,196,22,43,0,0
1640,186,240,249,443,4,13,10,63,203,23,43,0,0
1641,196,241,259,444,4,13,10,63,203,24,43,0,0
1642,207,241,272,451,4,13,10,65,210,25,43,0,0
1643,215,248,282,458,4,13,10,67,210,26,43,0,0
1644,228,247,293,455,4,13,10,65,208,27,43,0,0
1645,239,246,307,465,4,13,10,68,219,28,43,0,0
1646,250,253,318,470,4,13,10,68,217,29,43,0,0
1647,270,252,337,469,4,13,10,67,217,30,43,0,0
1648,283,254,353,477,4,13,10,70,223,31,43,0,0
1649,301,258,371,482,4,13,10,70,224,32,43,0,0
1650,324,258,395,485,4,13,10,71,227,33,43,0,0
1651,349,258,424,491,4,13,10,75,233,34,43,0,0
1652,378,262,451,492,4,13,10,73,230,35,43,0,0
1653,404,265,476,496,4,13,10,72,231,36,43,0,0
1654,424,273,500,502,4,13,10,76,229,37,43,0,0
1655,455,281,530,507,4,13,10,75,226,38,43,0,0
1656,487,280,565,510,4,13,10,78,230,39,43,0,0
1657,504,273,591,514,4,13,10,87,241,40,43,0,0
1658,539,276,624,514,4,13,10,85,238,41,43,0,0
1659,568,280,649,516,4,13,10,81,236,42,43,0,0
1660,590,281,671,519,4,13,10,81,238,43,43,1,0
1848,249,233,290,383,5,13,10,41,150,0,0,0,0
1849,230,224,266,342,6,13,10,36,118,0,1,0,0
1850,211,215,252,348,6,13,10,41,133,1,1,0,0
1852,150,217,205,351,8,13,10,55,134,0,1,0,0
1853,132,218,187,353,8,13,10,55,135,1,1,0,0
1855,98,226,134,349,9,13,10,36,123,0,0,0,0
1857,49,217,90,354,11,13,10,41,137,0,0,0,0
2044,80,231,115,343,16,13,10,35,112,0,30,0,1
2045,75,230,110,343,16,13,10,35,113,1,30,0,0
2046,70,228,106,346,16,13,10,36,118,2,30,0,0
2047,63,229,100,348,16,13,10,37,119,3,30,0,0
2048,58,229,95,348,16,13,10,37,119,4,30,0,0
2049,55,231,92,350,16,13,10,37,119,5,30,0,0
2050,54,231,90,348,16,13,10,36,117,6,30,0,0
2051,55,233,91,347,16,13,10,36,114,7,30,0,0
2052,56,232,91,348,16,13,10,35,116,8,30,0,0
2053,57,235,93,348,16,13,10,36,113,9,30,0,0
2054,59,232,96,348,16,13,10,37,116,10,30,0,0
2055,63,232,99,348,16,13,10,36,116,11,30,0,0
2056,66,232,102,347,16,13,10,36,115,12,30,0,0
2057,70,232,106,351,16,13,10,36,119,13,30,0,0
2058,73,230,109,350,16,13,10,36,120,14,30,0,0
2059,76,227,113,350,16,13,10,37,123,15,30,0,0
2060,79,231,116,354,16,13,10,37,123,16,30,0,0
2061,86,240,121,355,16,13,10,35,115,17,30,0,0
2062,96,240,131,354,16,13,10,35,114,18,30,0,0
2063,108,235,143,353,16,13,10,35,118,19,30,0,0
2064,117,231,154,354,16,13,10,37,123,20,30,0,0
2065,127,229,165,355,16,13,10,38,126,21,30,0,0
2066,139,227,176,354,16,13,10,37,127,22,30,0,0
2067,150,227,188,355,16,13,10,38,128,23,30,0,0
2068,160,227,198,355,16,13,10,38,128,24,30,0,0
2069,173,224,209,350,16,13,10,36,126,25,30,0,0
2070,183,226,218,347,16,13,10,35,121,26,30,0,0
2071,195,227,231,348,16,13,10,36,121,27,30,0,0
2072,208,228,245,346,16,13,10,37,118,28,30,0,0
2073,219,230,255,343,16,13,10,36,113,29,30,0,0
2074,228,228,263,340,16,13,10,35,112,30,30,1,0
2085,254,218,292,340,16,13,10,38,122,0,30,0,0
2086,246,219,286,338,16,13,10,40,119,1,30,0,0
2087,232,220,270,336,16,13,10,38,116,2,30,0,0
2088,217,218,257,335,16,13,10,40,117,3,30,0,0
2089,205,214,246,333,16,13,10,41,119,4,30,0,0
2090,187,213,228,330,16,13,10,41,117,5,30,0,0
2091,174,212,214,328,16,13,10,40,116,6,30,0,0
2092,162,211,201,327,16,13,10,39,116,7,30,0,0
2093,151,210,190,325,16,13,10,39,115,8,30,0,0
2097,116,199,152,310,16,13,10,36,111,0,30,0,0
2098,110,191,148,310,16,13,10,38,119,1,30,0,0
2099,107,186,145,306,16,13,10,38,120,2,30,0,0
2100,106,188,141,302,16,13,10,35,114,3,30,0,0
2101,99,185,135,300,16,13,10,36,115,4,30,0,0
2070,212,231,250,337,17,13,10,38,106,0,0,0,0
2077,249,219,289,377,18,13,10,40,158,0,0,0,0
2133,542,287,633,553,19,13,10,91,266,0,37,0,1
2134,542,287,633,553,19,13,10,91,266,1,37,0,0
2135,535,284,629,560,19,13,10,94,276,2,37,0,0
2136,518,292,619,588,19,13,10,101,296,3,37,0,0
2137,507,294,609,592,19,13,10,102,298,4,37,0,0
2138,493,300,597,602,19,13,10,104,302,5,37,0,0
2139,479,310,583,613,19,13,10,104,303,6,37,0,0
2140,467,309,573,618,19,13,10,106,309,7,37,0,0
2141,457,316,567,638,19,13,10,110,322,8,37,0,0
2142,451,318,567,660,19,13,10,116,342,9,37,0,0
2143,450,319,569,669,19,13,10,119,350,10,37,0,0
2144,450,327,572,687,19,13,10,122,360,11,37,0,0
2145,445,340,568,704,19,13,10,123,364,12,37,0,0
2146,444,346,571,725,19,13,10,127,379,13,37,0,0
2147,447,356,581,755,19,13,10,134,399,14,37,0,0
2148,458,357,598,770,19,13,10,140,413,15,37,0,0
2149,468,362,616,800,19,13,10,148,438,16,37,0,0
2150,477,375,634,843,19,13,10,157,468,17,37,0,0
2151,489,381,649,856,19,13,10,160,475,18,37,0,0
2152,504,399,670,893,19,13,10,166,494,19,37,0,0
2153,522,414,699,935,19,13,10,177,521,20,37,0,0
2154,555,420,737,957,19,13,10,182,537,21,37,0,0
2155,585,441,778,1013,19,13,10,193,572,22,37,0,0
2156,615,464,810,1047,19,13,10,195,583,23,37,0,0
2157,660,477,856,1068,19,13,10,196,591,24,37,0,0
2158,702,513,895,1075,19,13,10,193,562,25,37,0,0
2159,752,550,943,1074,19,13,10,191,524,26,37,0,0
2160,847,578,1032,1080,19,13,10,185,502,27,37,0,0
2161,931,618,1111,1080,19,13,10,180,462,28,37,0,0
2162,1030,648,1205,1080,19,13,10,175,432,29,37,0,0
2163,1128,676,1300,1077,19,13,10,172,401,30,37,0,0
2164,1244,719,1411,1080,19,13,10,167,361,31,37,0,0
2165,1360,743,1527,1080,19,13,10,167,337,32,37,0,0
2166,1461,779,1623,1079,19,13,10,162,300,33,37,0,0
2167,1587,827,1736,1079,19,13,10,149,252,34,37,0,0
2168,1692,841,1842,1077,19,13,10,150,236,35,37,0,0
2169,1764,867,1899,1073,19,13,10,135,206,36,37,0,0
2170,1853,894,1920,1076,19,13,10,67,182,37,37,1,0
2135,256,222,292,334,20,13,10,36,112,0,14,0,0
2137,234,224,270,335,20,13,10,36,111,0,14,0,0
2138,223,228,259,337,20,13,10,36,109,1,14,0,0
2139,208,224,247,341,20,13,10,39,117,2,14,0,0
2140,192,224,230,339,20,13,10,38,115,3,14,0,0
2141,175,224,213,338,20,13,10,38,114,4,14,0,0
2142,158,224,198,342,20,13,10,40,118,5,14,0,0
2143,146,227,184,343,20,13,10,38,116,6,14,0,0
2144,128,211,171,342,20,13,10,43,131,7,14,0,0
2145,114,205,158,343,20,13,10,44,138,8,14,0,0
2146,106,228,143,342,20,13,10,37,114,9,14,0,0
2147,91,234,126,343,20,13,10,35,109,10,14,0,0
2148,79,233,115,342,20,13,10,36,109,11,14,0,0
2149,67,229,103,342,20,13,10,36,113,12,14,0,0
2150,52,228,89,347,20,13,10,37,119,13,14,0,0
2151,38,228,76,348,20,13,10,38,120,14,14,0,0
2140,208,224,249,337,22,13,10,41,113,0,0,0,0
2205,148,215,183,311,23,13,10,35,96,0,93,0,0
2218,155,222,191,327,23,13,10,36,105,0,93,0,1
2219,157,222,194,330,23,13,10,37,108,1,93,0,0
2220,160,222,196,331,23,13,10,36,109,2,93,0,0
2221,161,223,199,339,23,13,10,38,116,3,93,0,0
2222,163,223,200,334,23,13,10,37,111,4,93,0,0
2223,164,221,201,336,23,13,10,37,115,5,93,0,0
2224,165,223,203,342,23,13,10,38,119,6,93,0,0
2225,166,224,205,345,23,13,10,39,121,7,93,0,0
2226,167,222,208,348,23,13,10,41,126,8,93,0,0
2227,169,220,211,350,23,13,10,42,130,9,93,0,0
2228,171,221,212,350,23,13,10,41,129,10,93,0,0
2229,172,224,211,350,23,13,10,39,126,11,93,0,0
2230,172,225,212,352,23,13,10,40,127,12,93,0,0
2231,171,224,212,355,23,13,10,41,131,13,93,0,0
2232,172,226,213,359,23,13,10,41,133,14,93,0,0
2233,176,228,216,355,23,13,10,40,127,15,93,0,0
2234,179,227,220,357,23,13,10,41,130,16,93,0,0
2235,182,227,223,359,23,13,10,41,132,17,93,0,0
2236,183,227,224,361,23,13,10,41,134,18,93,0,0
2237,182,228,224,360,23,13,10,42,132,19,93,0,0
2238,180,228,222,363,23,13,10,42,135,20,93,0,0
2239,179,229,222,366,23,13,10,43,137,21,93,0,0
2240,179,230,222,368,23,13,10,43,138,22,93,0,0
2241,181,230,223,368,23,13,10,42,138,23,93,0,0
2242,183,231,227,371,23,13,10,44,140,24,93,0,0
2243,185,231,229,372,23,13,10,44,141,25,93,0,0
2244,186,232,230,374,23,13,10,44,142,26,93,0,0
2245,186,234,230,374,23,13,10,44,140,27,93,0,0
2246,184,234,227,373,23,13,10,43,139,28,93,0,0
2247,181,233,226,377,23,13,10,45,144,29,93,0,0
2248,181,234,225,377,23,13,10,44,143,30,93,0,0
2249,181,235,226,378,23,13,10,45,143,31,93,0,0
2250,181,235,228,383,23,13,10,47,148,32,93,0,0
2251,180,235,227,386,23,13,10,47,151,33,93,0,0
2252,174,235,224,391,23,13,10,50,156,34,93,0,0
2253,169,235,219,393,23,13,10,50,158,35,93,0,0
2254,166,236,216,395,23,13,10,50,159,36,93,0,0
2255,164,237,215,398,23,13,10,51,161,37,93,0,0
2256,166,236,218,400,23,13,10,52,164,38,93,0,0
2257,169,235,221,400,23,13,10,52,165,39,93,0,0
2258,171,235,224,402,23,13,10,53,167,40,93,0,0
2259,171,237,224,404,23,13,10,53,167,41,93,0,0
2260,169,237,222,406,23,13,10,53,169,42,93,0,0
2261,166,237,221,409,23,13,10,55,172,43,93,0,0
2262,165,237,221,415,23,13,10,56,178,44,93,0,0
2263,166,237,222,416,23,13,10,56,179,45,93,0,0
2264,168,238,225,421,23,13,10,57,183,46,93,0,0
2265,169,238,228,425,23,13,10,59,187,47,93,0,0
2266,173,244,230,424,23,13,10,57,180,48,93,0,0
2267,174,247,229,423,23,13,10,55,176,49,93,0,0
2268,173,246,230,426,23,13,10,57,180,50,93,0,0
2269,174,246,233,433,23,13,10,59,187,51,93,0,0
2270,177,251,236,437,23,13,10,59,186,52,93,0,0
2271,182,246,243,440,23,13,10,61,194,53,93,0,0
2272,187,247,249,441,23,13,10,62,194,54,93,0,0
2273,191,244,255,447,23,13,10,64,203,55,93,0,0
2274,195,244,258,447,23,13,10,63,203,56,93,0,0
2275,196,244,259,446,23,13,10,63,202,57,93,0,0
2276,200,245,263,449,23,13,10,63,204,58,93,0,0
2277,206,248,268,452,23,13,10,62,204,59,93,0,0
2278,213,249,277,455,23,13,10,64,206,60,93,0,0
2279,222,249,287,456,23,13,10,65,207,61,93,0,0
2280,231,247,297,464,23,13,10,66,217,62,93,0,0
2281,239,251,305,466,23,13,10,66,215,63,93,0,0
2282,246,254,312,469,23,13,10,66,215,64,93,0,0
2283,256,257,320,467,23,13,10,64,210,65,93,0,0
2284,271,261,337,473,23,13,10,66,212,66,93,0,0
2285,279,259,349,480,23,13,10,70,221,67,93,0,0
2286,290,258,359,477,23,13,10,69,219,68,93,0,0
2287,302,257,371,482,23,13,10,69,225,69,93,0,0
2288,312,261,379,485,23,13,10,67,224,70,93,0,0
2289,322,263,388,486,23,13,10,66,223,71,93,0,0
2290,330,262,396,485,23,13,10,66,223,72,93,0,0
2291,346,265,414,491,23,13,10,68,226,73,93,0,0
2292,357,266,427,494,23,13,10,70,228,74,93,0,0
2293,370,265,440,497,23,13,10,70,232,75,93,0,0
2294,383,266,453,498,23,13,10,70,232,76,93,0,0
2295,396,267,465,497,23,13,10,69,230,77,93,0,0
2296,407,268,477,501,23,13,10,70,233,78,93,0,0
2297,416,268,486,503,23,13,10,70,235,79,93,0,0
2298,429,273,497,502,23,13,10,68,229,80,93,0,0
2299,445,279,515,504,23,13,10,70,225,81,93,0,0
2300,454,275,526,502,23,13,10,72,227,82,93,0,0
2301,468,278,539,498,23,13,10,71,220,83,93,0,0
2302,483,270,558,503,23,13,10,75,233,84,93,0,0
2303,494,276,568,499,23,13,10,74,223,85,93,0,0
2304,507,279,581,498,23,13,10,74,219,86,93,0,0
2305,532,275,608,496,23,13,10,76,221,87,93,0,0
2306,543,274,620,496,23,13,10,77,222,88,93,0,0
2307,552,275,629,498,23,13,10,77,223,89,93,0,0
2308,562,276,638,496,23,13,10,76,220,90,93,0,0
2309,572,279,644,491,23,13,10,72,212,91,93,0,0
2310,579,296,643,486,23,13,10,64,190,92,93,0,0
2311,591,298,653,485,23,13,10,62,187,93,93,1,0
2310,249,223,288,328,24,13,10,39,105,0,12,0,0
2311,232,222,272,329,24,13,10,40,107,1,12,0,0
2312,212,215,257,334,24,13,10,45,119,2,12,0,0
2313,199,212,245,333,24,13,10,46,121,3,12,0,0
2314,190,211,233,325,24,13,10,43,114,4,12,0,0
2315,179,211,220,318,24,13,10,41,107,5,12,0,0
2316,166,209,209,320,24,13,10,43,111,6,12,0,0
2317,159,207,201,316,24,13,10,42,109,7,12,0,0
2318,156,208,191,298,24,13,10,35,90,8,12,0,0
2319,151,205,186,297,24,13,10,35,92,9,12,0,0
2320,147,206,182,296,24,13,10,35,90,10,12,0,0
2321,140,204,177,301,24,13,10,37,97,11,12,0,0
2322,136,201,173,302,24,13,10,37,101,12,12,0,0
2377,581,282,634,529,25,13,10,53,247,0,51,0,1
2378,575,279,631,537,25,13,10,56,258,1,51,0,0
2379,568,283,624,541,25,13,10,56,258,2,51,0,0
2380,565,284,624,550,25,13,10,59,266,3,51,0,0
2381,558,283,619,554,25,13,10,61,271,4,51,0,0
2382,549,286,612,562,25,13,10,63,276,5,51,0,0
2383,541,286,607,566,25,13,10,66,280,6,51,0,0
2384,532,287,601,570,25,13,10,69,283,7,51,0,0
2385,524,292,597,583,25,13,10,73,291,8,51,0,0
2386,518,296,595,591,25,13,10,77,295,9,51,0,0
2387,515,298,593,591,25,13,10,78,293,10,51,0,0
2388,509,301,591,602,25,13,10,82,301,11,51,0,0
2389,501,307,586,612,25,13,10,85,305,12,51,0,0
2390,492,309,580,616,25,13,10,88,307,13,51,0,0
2391,481,311,577,635,25,13,10,96,324,14,51,0,0
2392,477,316,578,646,25,13,10,101,330,15,51,0,0
2393,481,319,584,651,25,13,10,103,332,16,51,0,0
2394,482,325,590,666,25,13,10,108,341,17,51,0,0
2395,479,331,590,678,25,13,10,111,347,18,51,0,0
2396,474,336,589,689,25,13,10,115,353,19,51,0,0
2397,474,336,598,712,25,13,10,124,376,20,51,0,0
2398,486,339,614,729,25,13,10,128,390,21,51,0,0
2399,501,345,631,738,25,13,10,130,393,22,51,0,0
2400,508,354,645,769,25,13,10,137,415,23,51,0,0
2401,510,359,651,785,25,13,10,141,426,24,51,0,0
2402,514,363,659,794,25,13,10,145,431,25,51,0,0
2403,529,372,681,827,25,13,10,152,455,26,51,0,0
2404,548,378,703,840,25,13,10,155,462,27,51,0,0
2405,573,388,729,851,25,13,10,156,463,28,51,0,0
2406,589,401,752,887,25,13,10,163,486,29,51,0,0
2407,608,409,775,905,25,13,10,167,496,30,51,0,0
2408,630,422,798,919,25,13,10,168,497,31,51,0,0
2409,651,437,828,965,25,13,10,177,528,32,51,0,0
2410,680,449,859,986,25,13,10,179,537,33,51,0,0
2411,709,464,897,1028,25,13,10,188,564,34,51,0,0
2412,733,485,929,1065,25,13,10,196,580,35,51,0,0
2413,765,494,964,1080,25,13,10,199,586,36,51,0,0
2414,807,514,999,1080,25,13,10,192,566,37,51,0,0
2415,844,543,1032,1080,25,13,10,188,537,38,51,0,0
2416,906,562,1090,1080,25,13,10,184,518,39,51,0,0
2417,953,592,1133,1079,25,13,10,180,487,40,51,0,0
2418,990,621,1171,1080,25,13,10,181,459,41,51,0,0
2419,1064,641,1243,1080,25,13,10,179,439,42,51,0,0
2420,1143,679,1313,1080,25,13,10,170,401,43,51,0,0
2421,1240,704,1406,1078,25,13,10,166,374,44,51,0,0
2422,1327,734,1488,1074,25,13,10,161,340,45,51,0,0
2423,1406,768,1564,1074,25,13,10,158,306,46,51,0,0
2424,1500,803,1655,1078,25,13,10,155,275,47,51,0,0
2425,1589,832,1740,1074,25,13,10,151,242,48,51,0,0
2426,1671,860,1822,1076,25,13,10,151,216,49,51,0,0
2427,1732,876,1878,1071,25,13,10,146,195,50,51,0,0
2428,1809,901,1920,1072,25,13,10,111,171,51,51,1,0
2486,932,403,1018,685,26,13,10,86,282,0,127,0,1
2487,921,396,1014,701,26,13,10,93,305,1,127,0,0
2488,897,394,998,720,26,13,10,101,326,2,127,0,0
2489,896,392,999,724,26,13,10,103,332,3,127,0,0
2490,887,388,995,732,26,13,10,108,344,4,127,0,0
2491,876,387,987,736,26,13,10,111,349,5,127,0,0
2492,853,385,974,767,26,13,10,121,382,6,127,0,0
2493,833,387,955,768,26,13,10,122,381,7,127,0,0
2494,796,382,921,769,26,13,10,125,387,8,127,0,0
2495,749,387,877,771,26,13,10,128,384,9,127,0,0
2496,716,382,850,773,26,13,10,134,391,10,127,0,0
2497,674,373,806,765,26,13,10,132,392,11,127,0,0
2498,614,364,751,759,26,13,10,137,395,12,127,0,0
2499,580,365,720,760,26,13,10,140,395,13,127,0,0
2500,550,365,685,752,26,13,10,135,387,14,127,0,0
2501,511,357,646,749,26,13,10,135,392,15,127,0,0
2502,487,356,622,749,26,13,10,135,393,16,127,0,0
2503,453,348,582,728,26,13,10,129,380,17,127,0,0
2504,412,341,541,720,26,13,10,129,379,18,127,0,0
2505,385,338,516,714,26,13,10,131,376,19,127,0,0
2506,358,332,484,694,26,13,10,126,362,20,127,0,0
2507,324,327,449,683,26,13,10,125,356,21,127,0,0
2508,306,327,429,676,26,13,10,123,349,22,127,0,0
2509,292,314,414,664,26,13,10,122,350,23,127,0,0
2510,284,307,403,652,26,13,10,119,345,24,127,0,0
2511,271,307,387,645,26,13,10,116,338,25,127,0,0
2512,256,306,372,642,26,13,10,116,336,26,127,0,0
2513,244,300,353,618,26,13,10,109,318,27,127,0,0
2514,238,299,344,610,26,13,10,106,311,28,127,0,0
2515,234,295,336,595,26,13,10,102,300,29,127,0,0
2516,230,288,330,586,26,13,10,100,298,30,127,0,0
2517,222,290,319,577,26,13,10,97,287,31,127,0,0
2518,215,291,308,560,26,13,10,93,269,32,127,0,0
2519,210,287,298,543,26,13,10,88,256,33,127,0,0
2520,204,286,292,541,26,13,10,88,255,34,127,0,0
2521,201,279,289,537,26,13,10,88,258,35,127,0,0
2522,201,272,288,526,26,13,10,87,254,36,127,0,0
2523,198,272,283,522,26,13,10,85,250,37,127,0,0
2524,193,275,271,504,26,13,10,78,229,38,127,0,0
2525,181,268,260,498,26,13,10,79,230,39,127,0,0
2526,176,267,255,493,26,13,10,79,226,40,127,0,0
2527,175,266,253,490,26,13,10,78,224,41,127,0,0
2528,174,261,250,483,26,13,10,76,222,42,127,0,0
2529,169,259,243,478,26,13,10,74,219,43,127,0,0
2530,162,258,233,466,26,13,10,71,208,44,127,0,0
2531,154,255,223,461,26,13,10,69,206,45,127,0,0
2532,147,255,216,459,26,13,10,69,204,46,127,0,0
2533,143,250,211,456,26,13,10,68,206,47,127,0,0
2534,140,248,208,454,26,13,10,68,206,48,127,0,0
2535,134,249,199,448,26,13,10,65,199,49,127,0,0
2536,123,238,190,442,26,13,10,67,204,50,127,0,0
2537,114,237,180,441,26,13,10,66,204,51,127,0,0
2538,106,238,171,443,26,13,10,65,205,52,127,0,0
2539,101,239,163,431,26,13,10,62,192,53,127,0,0
2540,97,241,155,424,26,13,10,58,183,54,127,0,0
2541,92,243,148,417,26,13,10,56,174,55,127,0,0
2542,83,242,139,414,26,13,10,56,172,56,127,0,0
2543,79,239,132,404,26,13,10,53,165,57,127,0,0
2544,77,240,128,401,26,13,10,51,161,58,127,0,0
2545,76,240,127,402,26,13,10,51,162,59,127,0,0
2546,71,239,122,405,26,13,10,51,166,60,127,0,0
2547,69,238,119,401,26,13,10,50,163,61,127,0,0
2548,68,238,116,396,26,13,10,48,158,62,127,0,0
2549,65,235,113,396,26,13,10,48,161,63,127,0,0
2550,67,238,112,394,26,13,10,45,156,64,127,0,0
2551,66,238,111,396,26,13,10,45,158,65,127,0,0
2552,64,240,109,398,26,13,10,45,158,66,127,0,0
2553,63,241,109,400,26,13,10,46,159,67,127,0,0
2554,66,241,112,402,26,13,10,46,161,68,127,0,0
2555,71,243,118,403,26,13,10,47,160,69,127,0,0
2556,77,242,126,407,26,13,10,49,165,70,127,0,0
2557,85,243,135,409,26,13,10,50,166,71,127,0,0
2558,89,245,139,411,26,13,10,50,166,72,127,0,0
2559,90,245,142,415,26,13,10,52,170,73,127,0,0
2560,90,244,145,423,26,13,10,55,179,74,127,0,0
2561,93,246,150,429,26,13,10,57,183,75,127,0,0
2562,98,246,155,430,26,13,10,57,184,76,127,0,0
2563,100,245,159,433,26,13,10,59,188,77,127,0,0
2564,101,251,160,438,26,13,10,59,187,78,127,0,0
2565,98,254,158,443,26,13,10,60,189,79,127,0,0
2566,94,253,156,447,26,13,10,62,194,80,127,0,0
2567,92,258,154,453,26,13,10,62,195,81,127,0,0
2568,93,261,156,459,26,13,10,63,198,82,127,0,0
2569,94,260,158,464,26,13,10,64,204,83,127,0,0
2570,95,266,159,468,26,13,10,64,202,84,127,0,0
2571,92,266,158,477,26,13,10,66,211,85,127,0,0
2572,87,263,156,483,26,13,10,69,220,86,127,0,0
2573,83,261,153,487,26,13,10,70,226,87,127,0,0
2574,81,265,151,491,26,13,10,70,226,88,127,0,0
2575,80,265,151,497,26,13,10,71,232,89,127,0,0
2576,77,264,150,499,26,13,10,73,235,90,127,0,0
2577,71,264,144,500,26,13,10,73,236,91,127,0,0
2578,65,263,139,502,26,13,10,74,239,92,127,0,0
2579,60,263,136,504,26,13,10,76,241,93,127,0,0
2580,56,264,131,500,26,13,10,75,236,94,127,0,0
2581,55,266,128,497,26,13,10,73,231,95,127,0,0
2582,56,265,126,493,26,13,10,70,228,96,127,0,0
2583,58,263,125,486,26,13,10,67,223,97,127,0,0
2584,62,264,127,486,26,13,10,65,222,98,127,0,0
2585,67,264,131,488,26,13,10,64,224,99,127,0,0
2586,75,262,139,487,26,13,10,64,225,100,127,0,0
2587,89,264,153,485,26,13,10,64,221,101,127,0,0
2588,95,265,161,485,26,13,10,66,220,102,127,0,0
2589,108,263,171,474,26,13,10,63,211,103,127,0,0
2590,122,261,183,466,26,13,10,61,205,104,127,0,0
2591,134,259,194,463,26,13,10,60,204,105,127,0,0
2592,145,256,206,463,26,13,10,61,207,106,127,0,0
2593,156,253,218,466,26,13,10,62,213,107,127,0,0
2594,168,256,228,463,26,13,10,60,207,108,127,0,0
2595,176,253,239,464,26,13,10,63,211,109,127,0,0
2596,191,253,251,455,26,13,10,60,202,110,127,0,0
2597,205,253,262,448,26,13,10,57,195,111,127,0,0
2598,213,248,270,446,26,13,10,57,198,112,127,0,0
2599,223,245,278,438,26,13,10,55,193,113,127,0,0
2600,229,242,287,445,26,13,10,58,203,114,127,0,0
2601,237,243,295,444,26,13,10,58,201,115,127,0,0
2602,243,242,301,443,26,13,10,58,201,116,127,0,0
2603,251,238,311,440,26,13,10,60,202,117,127,0,0
2604,261,239,325,438,26,13,10,64,199,118,127,0,0
2605,264,243,328,434,26,13,10,64,191,119,127,0,0
2606,265,243,334,435,26,13,10,69,192,120,127,0,0
2607,269,242,340,430,26,13,10,71,188,121,127,0,0
2608,268,241,340,428,26,13,10,72,187,122,127,0,0
2609,262,243,332,423,26,13,10,70,180,123,127,0,0
2610,258,241,329,423,26,13,10,71,182,124,127,0,0
2611,256,242,323,421,26,13,10,67,179,125,127,0,0
2612,257,244,321,417,26,13,10,64,173,126,127,0,0
2613,260,244,323,415,26,13,10,63,171,127,127,1,0
2547,149,221,185,330,27,13,10,36,109,0,74,0,1
2548,151,221,187,331,27,13,10,36,110,1,74,0,0
2549,152,219,190,333,27,13,10,38,114,2,74,0,0
2550,151,221,190,338,27,13,10,39,117,3,74,0,0
2551,154,222,194,341,27,13,10,40,119,4,74,0,0
2552,158,222,199,346,27,13,10,41,124,5,74,0,0
2553,158,224,202,353,27,13,10,44,129,6,74,0,0
2554,159,223,203,354,27,13,10,44,131,7,74,0,0
2555,159,225,204,358,27,13,10,45,133,8,74,0,0
2556,160,229,205,363,27,13,10,45,134,9,74,0,0
2557,163,224,210,365,27,13,10,47,141,10,74,0,0
2558,164,226,212,369,27,13,10,48,143,11,74,0,0
2559,165,225,213,369,27,13,10,48,144,12,74,0,0
2560,167,226,215,374,27,13,10,48,148,13,74,0,0
2561,170,227,220,380,27,13,10,50,153,14,74,0,0
2562,174,227,225,383,27,13,10,51,156,15,74,0,0
2563,178,231,229,388,27,13,10,51,157,16,74,0,0
2564,180,233,231,387,27,13,10,51,154,17,74,0,0
2565,181,233,235,395,27,13,10,54,162,18,74,0,0
2566,182,234,239,406,27,13,10,57,172,19,74,0,0
2567,187,233,246,410,27,13,10,59,177,20,74,0,0
2568,195,233,254,412,27,13,10,59,179,21,74,0,0
2569,199,235,259,417,27,13,10,60,182,22,74,0,0
2570,202,234,262,417,27,13,10,60,183,23,74,0,0
2571,205,240,264,419,27,13,10,59,179,24,74,0,0
2572,211,241,271,424,27,13,10,60,183,25,74,0,0
2573,217,238,281,430,27,13,10,64,192,26,74,0,0
2574,222,239,288,439,27,13,10,66,200,27,74,0,0
2575,226,240,292,436,27,13,10,66,196,28,74,0,0
2576,228,246,295,448,27,13,10,67,202,29,74,0,0
2577,234,249,303,460,27,13,10,69,211,30,74,0,0
2578,246,253,315,462,27,13,10,69,209,31,74,0,0
2579,251,258,324,481,27,13,10,73,223,32,74,0,0
2580,257,260,332,489,27,13,10,75,229,33,74,0,0
2581,263,260,340,494,27,13,10,77,234,34,74,0,0
2582,272,264,351,507,27,13,10,79,243,35,74,0,0
2583,281,265,362,514,27,13,10,81,249,36,74,0,0
2584,290,268,374,527,27,13,10,84,259,37,74,0,0
2585,294,273,378,537,27,13,10,84,264,38,74,0,0
2586,297,274,383,544,27,13,10,86,270,39,74,0,0
2587,303,280,392,555,27,13,10,89,275,40,74,0,0
2588,314,282,406,569,27,13,10,92,287,41,74,0,0
2589,329,281,426,584,27,13,10,97,303,42,74,0,0
2590,344,288,444,595,27,13,10,100,307,43,74,0,0
2591,351,290,453,607,27,13,10,102,317,44,74,0,0
2592,358,295,464,622,27,13,10,106,327,45,74,0,0
2593,369,299,479,642,27,13,10,110,343,46,74,0,0
2594,391,302,504,653,27,13,10,113,351,47,74,0,0
2595,411,317,530,678,27,13,10,119,361,48,74,0,0
2596,424,323,548,695,27,13,10,124,372,49,74,0,0
2597,432,329,554,701,27,13,10,122,372,50,74,0,0
2598,447,345,573,729,27,13,10,126,384,51,74,0,0
2599,468,345,603,754,27,13,10,135,409,52,74,0,0
2600,497,349,640,781,27,13,10,143,432,53,74,0,0
2601,523,362,675,813,27,13,10,152,451,54,74,0,0
2602,542,365,696,826,27,13,10,154,461,55,74,0,0
2603,562,380,721,856,27,13,10,159,476,56,74,0,0
2604,587,395,752,888,27,13,10,165,493,57,74,0,0
2605,625,402,796,913,27,13,10,171,511,58,74,0,0
2606,670,424,854,962,27,13,10,184,538,59,74,0,0
2607,710,441,901,992,27,13,10,191,551,60,74,0,0
2608,740,457,936,1024,27,13,10,196,567,61,74,0,0
2609,776,484,977,1060,27,13,10,201,576,62,74,0,0
2610,834,510,1033,1079,27,13,10,199,569,63,74,0,0
2611,916,533,1116,1080,27,13,10,200,547,64,74,0,0
2612,990,564,1192,1080,27,13,10,202,516,65,74,0,0
2613,1062,579,1258,1078,27,13,10,196,499,66,74,0,0
2614,1150,623,1337,1079,27,13,10,187,456,67,74,0,0
2615,1266,661,1443,1080,27,13,10,177,419,68,74,0,0
2616,1372,688,1545,1080,27,13,10,173,392,69,74,0,0
2617,1484,735,1644,1080,27,13,10,160,345,70,74,0,0
2618,1604,771,1757,1080,27,13,10,153,309,71,74,0,0
2619,1715,808,1855,1074,27,13,10,140,266,72,74,0,0
2620,1792,849,1913,1072,27,13,10,121,223,73,74,0,0
2621,1878,880,1920,1076,27,13,10,42,196,74,74,1,0
2597,241,260,283,423,28,13,10,42,163,0,0,0,0
2753,201,226,236,329,29,13,10,35,103,0,0,0,0
2866,896,397,958,567,30,13,10,62,170,0,0,0,0
2866,845,389,963,796,31,13,10,118,407,0,14,0,0
2867,845,393,958,782,31,13,10,113,389,1,14,0,0
2868,820,392,934,782,31,13,10,114,390,2,14,0,0
2869,773,407,893,807,31,13,10,120,400,3,14,0,0
2870,743,413,869,824,31,13,10,126,411,4,14,0,0
2871,717,415,858,866,31,13,10,141,451,5,14,0,0
2872,706,428,860,904,31,13,10,154,476,6,14,0,0
2873,710,440,872,927,31,13,10,162,487,7,14,0,0
2874,730,467,907,998,31,13,10,177,531,8,14,0,0
2875,745,482,931,1030,31,13,10,186,548,9,14,0,0
2876,778,518,972,1067,31,13,10,194,549,10,14,0,0
2877,844,539,1045,1080,31,13,10,201,541,11,14,0,0
2878,930,583,1128,1080,31,13,10,198,497,12,14,0,0
2879,1017,653,1207,1080,31,13,10,190,427,13,14,0,0
2880,1039,675,1228,1080,31,13,10,189,405,14,14,0,0
2880,1158,701,1449,1073,32,13,10,291,372,0,0,0,0
2881,1325,765,1580,1074,33,13,10,255,309,0,1,0,0
2882,1434,773,1686,1079,33,13,10,252,306,1,1,0,0
2884,1756,867,1920,1075,35,13,10,164,208,0,0,0,0
2967,1782,873,1920,1075,36,13,10,138,202,0,0,0,0
2968,1677,826,1839,1072,37,13,10,162,246,0,0,0,0
2969,1491,795,1682,1071,38,13,10,191,276,0,0,0,0
2970,1301,734,1539,1071,39,13,10,238,337,0,0,0,0
2971,1135,702,1382,1075,40,13,10,247,373,0,0,0,0
2972,950,645,1237,1070,41,13,10,287,425,0,21,0,1
2973,816,602,1131,1068,41,13,10,315,466,1,21,0,0
2974,719,569,1059,1071,41,13,10,340,502,2,21,0,0
2975,628,519,999,1073,41,13,10,371,554,3,21,0,0
2976,544,485,931,1072,41,13,10,387,587,4,21,0,0
2977,477,458,871,1070,41,13,10,394,612,5,21,0,0
2978,425,429,811,1045,41,13,10,386,616,6,21,0,0
2979,381,412,752,1018,41,13,10,371,606,7,21,0,0
2980,365,383,706,958,41,13,10,341,575,8,21,0,0
2981,359,370,673,918,41,13,10,314,548,9,21,0,0
2982,352,364,641,881,41,13,10,289,517,10,21,0,0
2983,356,345,616,825,41,13,10,260,480,11,21,0,0
2984,356,340,598,800,41,13,10,242,460,12,21,0,0
2985,373,334,588,752,41,13,10,215,418,13,21,0,0
2986,389,322,592,730,41,13,10,203,408,14,21,0,0
2987,404,314,594,707,41,13,10,190,393,15,21,0,0
2988,421,306,596,675,41,13,10,175,369,16,21,0,0
2989,438,303,602,656,41,13,10,164,353,17,21,0,0
2990,465,296,619,634,41,13,10,154,338,18,21,0,0
2991,488,294,634,625,41,13,10,146,331,19,21,0,0
2992,507,294,642,608,41,13,10,135,314,20,21,0,0
2993,510,285,640,586,41,13,10,130,301,21,21,1,0
3164,283,238,321,423,42,13,10,38,185,0,38,0,1
3165,270,237,308,424,42,13,10,38,187,1,38,0,0
3166,258,238,297,421,42,13,10,39,183,2,38,0,0
3167,244,238,282,417,42,13,10,38,179,3,38,0,0
3168,232,236,272,415,42,13,10,40,179,4,38,0,0
3169,216,240,256,413,42,13,10,40,173,5,38,0,0
3170,203,236,245,412,42,13,10,42,176,6,38,0,0
3171,198,235,240,408,42,13,10,42,173,7,38,0,0
3172,194,237,235,404,42,13,10,41,167,8,38,0,0
3173,191,238,233,401,42,13,10,42,163,9,38,0,0
3174,190,236,233,400,42,13,10,43,164,10,38,0,0
3175,188,237,232,398,42,13,10,44,161,11,38,0,0
3176,185,237,229,398,42,13,10,44,161,12,38,0,0
3177,183,236,226,389,42,13,10,43,153,13,38,0,0
3178,182,234,224,384,42,13,10,42,150,14,38,0,0
3179,184,234,226,381,42,13,10,42,147,15,38,0,0
3180,188,232,230,378,42,13,10,42,146,16,38,0,0
3181,189,232,231,374,42,13,10,42,142,17,38,0,0
3182,188,232,229,372,42,13,10,41,140,18,38,0,0
3183,185,230,226,369,42,13,10,41,139,19,38,0,0
3184,183,230,223,366,42,13,10,40,136,20,38,0,0
3185,183,229,222,362,42,13,10,39,133,21,38,0,0
3186,183,226,223,361,42,13,10,40,135,22,38,0,0
3187,182,230,221,359,42,13,10,39,129,23,38,0,0
3188,179,230,217,356,42,13,10,38,126,24,38,0,0
3189,175,226,213,352,42,13,10,38,126,25,38,0,0
3190,172,225,210,349,42,13,10,38,124,26,38,0,0
3191,172,226,208,345,42,13,10,36,119,27,38,0,0
3192,171,224,208,344,42,13,10,37,120,28,38,0,0
3193,171,223,207,341,42,13,10,36,118,29,38,0,0
3194,169,222,206,340,42,13,10,37,118,30,38,0,0
3195,167,217,204,338,42,13,10,37,121,31,38,0,0
3196,165,216,204,337,42,13,10,39,121,32,38,0,0
3197,165,215,203,335,42,13,10,38,120,33,38,0,0
3198,163,214,202,333,42,13,10,39,119,34,38,0,0
3199,162,214,200,331,42,13,10,38,117,35,38,0,0
3200,159,217,195,326,42,13,10,36,109,36,38,0,0
3201,155,215,190,324,42,13,10,35,109,37,38,0,0
3202,153,214,188,322,42,13,10,35,108,38,38,1,0
3169,246,247,285,411,43,13,10,39,164,0,0,0,0
3183,208,234,243,357,44,13,10,35,123,0,0,0,0
3817,217,225,261,339,45,13,10,44,114,0,13,0,0
3818,205,223,251,342,45,13,10,46,119,1,13,0,0
3819,193,222,239,340,45,13,10,46,118,2,13,0,0
3820,174,220,221,342,45,13,10,47,122,3,13,0,0
3821,161,220,206,338,45,13,10,45,118,4,13,0,0
3822,147,222,191,338,45,13,10,44,116,5,13,0,0
3823,135,220,179,337,45,13,10,44,117,6,13,0,0
3824,127,224,168,334,45,13,10,41,110,7,13,0,0
3825,120,222,160,330,45,13,10,40,108,8,13,0,0
3826,114,225,152,327,45,13,10,38,102,9,13,0,0
3827,106,220,145,327,45,13,10,39,107,10,13,0,0
3828,101,215,141,324,45,13,10,40,109,11,13,0,0
3829,98,218,134,316,45,13,10,36,98,12,13,0,0
3830,94,216,130,315,45,13,10,36,99,13,13,0,0
3823,214,221,250,338,46,13,10,36,117,0,0,0,0
3829,190,217,225,326,46,13,10,35,109,0,0,0,0
3831,185,214,220,324,46,13,10,35,110,0,0,0,0
4034,250,217,285,337,48,13,10,35,120,0,11,0,0
4040,166,212,201,326,48,13,10,35,114,0,11,0,0
4041,153,212,188,328,48,13,10,35,116,1,11,0,0
4042,143,211,180,329,48,13,10,37,118,2,11,0,0
4043,135,210,173,329,48,13,10,38,119,3,11,0,0
4044,129,207,164,319,48,13,10,35,112,4,11,0,0
4045,123,206,158,315,48,13,10,35,109,5,11,0,0
4046,120,203,155,314,48,13,10,35,111,6,11,0,0
4047,116,199,152,312,48,13,10,36,113,7,11,0,0
4048,113,199,149,311,48,13,10,36,112,8,11,0,0
4049,111,197,147,308,48,13,10,36,111,9,11,0,0
4050,109,196,145,305,48,13,10,36,109,10,11,0,0
4051,107,197,142,301,48,13,10,35,104,11,11,0,0
4038,211,219,251,334,50,13,10,40,115,0,7,0,0
4039,208,218,246,327,50,13,10,38,109,1,7,0,0
4040,199,221,235,325,50,13,10,36,104,2,7,0,0
4041,188,216,226,327,50,13,10,38,111,3,7,0,0
4042,184,213,222,325,50,13,10,38,112,4,7,0,0
4043,180,212,218,327,50,13,10,38,115,5,7,0,0
4044,177,209,213,318,50,13,10,36,109,6,7,0,0
4045,175,211,210,314,50,13,10,35,103,7,7,0,0
4041,208,215,244,329,51,13,10,36,114,0,0,0,0
4309,881,349,963,700,52,13,10,82,351,0,41,0,1
4310,882,355,963,699,52,13,10,81,344,1,41,0,0
4311,885,356,966,702,52,13,10,81,346,2,41,0,0
4312,886,362,971,720,52,13,10,85,358,3,41,0,0
4313,892,367,980,731,52,13,10,88,364,4,41,0,0
4314,889,372,980,737,52,13,10,91,365,5,41,0,0
4315,868,372,965,747,52,13,10,97,375,6,41,0,0
4316,845,371,948,759,52,13,10,103,388,7,41,0,0
4317,822,376,925,764,52,13,10,103,388,8,41,0,0
4318,783,381,892,782,52,13,10,109,401,9,41,0,0
4319,745,388,858,791,52,13,10,113,403,10,41,0,0
4320,715,390,831,801,52,13,10,116,411,11,41,0,0
4321,655,393,778,808,52,13,10,123,415,12,41,0,0
4322,617,400,746,814,52,13,10,129,414,13,41,0,0
4323,557,391,699,827,52,13,10,142,436,14,41,0,0
4324,507,384,666,860,52,13,10,159,476,15,41,0,0
4325,484,395,650,878,52,13,10,166,483,16,41,0,0
4326,470,400,643,897,52,13,10,173,497,17,41,0,0
4327,458,405,637,918,52,13,10,179,513,18,41,0,0
4328,439,412,631,961,52,13,10,192,549,19,41,0,0
4329,412,422,615,996,52,13,10,203,574,20,41,0,0
4330,407,431,618,1027,52,13,10,211,596,21,41,0,0
4331,431,459,642,1058,52,13,10,211,599,22,41,0,0
4332,460,467,675,1074,52,13,10,215,607,23,41,0,0
4333,487,486,704,1079,52,13,10,217,593,24,41,0,0
4334,513,522,730,1080,52,13,10,217,558,25,41,0,0
4335,591,546,804,1075,52,13,10,213,529,26,41,0,0
4336,604,454,796,927,52,13,10,192,473,27,41,0,0
4337,580,427,779,909,52,13,10,199,482,28,41,0,0
4338,581,424,777,899,52,13,10,196,475,29,41,0,0
4339,579,429,780,919,52,13,10,201,490,30,41,0,0
4340,567,444,779,966,52,13,10,212,522,31,41,0,0
4341,550,456,768,990,52,13,10,218,534,32,41,0,0
4342,552,472,782,1041,52,13,10,230,569,33,41,0,0
4343,581,490,815,1066,52,13,10,234,576,34,41,0,0
4344,625,516,856,1074,52,13,10,231,558,35,41,0,0
4345,656,548,887,1079,52,13,10,231,531,36,41,0,0
4346,704,580,925,1076,52,13,10,221,496,37,41,0,0
4347,785,618,995,1077,52,13,10,210,459,38,41,0,0
4348,891,659,1091,1078,52,13,10,200,419,39,41,0,0
4349,1000,713,1186,1073,52,13,10,186,360,40,41,0,0
4350,1045,736,1222,1078,52,13,10,177,342,41,41,1,0
4326,864,436,1006,797,53,13,10,142,361,0,25,0,1
4327,845,434,994,810,53,13,10,149,376,1,25,0,0
4328,836,431,989,818,53,13,10,153,387,2,25,0,0
4329,801,433,972,867,53,13,10,171,434,3,25,0,0
4330,781,443,954,878,53,13,10,173,435,4,25,0,0
4331,770,444,946,886,53,13,10,176,442,5,25,0,0
4332,754,444,943,919,53,13,10,189,475,6,25,0,0
4333,748,464,938,942,53,13,10,190,478,7,25,0,0
4334,754,471,945,953,53,13,10,191,482,8,25,0,0
4335,781,496,975,994,53,13,10,194,498,9,25,0,0
4336,835,518,1023,1007,53,13,10,188,489,10,25,0,0
4337,853,602,1035,1056,53,13,10,182,454,11,25,0,0
4338,878,575,1065,1032,53,13,10,187,457,12,25,0,0
4339,924,579,1121,1056,53,13,10,197,477,13,25,0,0
4340,974,584,1178,1076,53,13,10,204,492,14,25,0,0
4341,1020,613,1223,1080,53,13,10,203,467,15,25,0,0
4342,1110,641,1304,1080,53,13,10,194,439,16,25,0,0
4343,1163,670,1356,1080,53,13,10,193,410,17,25,0,0
4344,1230,712,1416,1080,53,13,10,186,368,18,25,0,0
4345,1337,745,1509,1073,53,13,10,172,328,19,25,0,0
4346,1418,777,1585,1079,53,13,10,167,302,20,25,0,0
4347,1524,811,1678,1079,53,13,10,154,268,21,25,0,0
4348,1625,830,1773,1078,53,13,10,148,248,22,25,0,0
4349,1704,844,1849,1075,53,13,10,145,231,23,25,0,0
4350,1769,873,1898,1069,53,13,10,129,196,24,25,0,0
4351,1842,896,1920,1071,53,13,10,78,175,25,25,1,0
4327,978,387,1021,526,54,13,10,43,139,0,9,0,0
4328,957,389,1007,547,54,13,10,50,158,1,9,0,0
4329,935,393,984,544,54,13,10,49,151,2,9,0,0
4330,891,392,941,542,54,13,10,50,150,3,9,0,0
4331,841,389,897,551,54,13,10,56,162,4,9,0,0
4332,801,387,872,589,54,13,10,71,202,5,9,0,0
4333,762,388,850,635,54,13,10,88,247,6,9,0,0
4334,744,390,828,618,54,13,10,84,228,7,9,0,0
4335,701,397,806,674,54,13,10,105,277,8,9,0,0
4336,669,397,780,691,54,13,10,111,294,9,9,0,0
4336,714,619,960,1071,55,13,10,246,452,0,0,0,0
4338,961,663,1227,1071,56,13,10,266,408,0,1,0,0
4339,1076,713,1309,1068,56,13,10,233,355,1,1,0,0
4340,1240,787,1510,1079,57,13,10,270,292,0,5,0,0
4341,1371,806,1621,1075,57,13,10,250,269,1,5,0,0
4342,1506,837,1729,1076,57,13,10,223,239,2,5,0,0
4343,1643,852,1852,1076,57,13,10,209,224,3,5,0,0
4344,1724,853,1920,1072,57,13,10,196,219,4,5,0,0
4345,1818,863,1920,1071,57,13,10,102,208,5,5,0,0
4448,522,274,624,523,63,13,10,102,249,0,33,0,1
4449,500,274,600,521,63,13,10,100,247,1,33,0,0
4450,464,268,565,516,63,13,10,101,248,2,33,0,0
4451,438,269,537,510,63,13,10,99,241,3,33,0,0
4452,403,267,502,512,63,13,10,99,245,4,33,0,0
4453,366,265,466,512,63,13,10,100,247,5,33,0,0
4454,339,258,436,504,63,13,10,97,246,6,33,0,0
4455,312,253,408,500,63,13,10,96,247,7,33,0,0
4456,286,254,380,497,63,13,10,94,243,8,33,0,0
4457,264,250,354,488,63,13,10,90,238,9,33,0,0
4458,245,249,333,483,63,13,10,88,234,10,33,0,0
4459,230,243,320,488,63,13,10,90,245,11,33,0,0
4460,215,240,300,476,63,13,10,85,236,12,33,0,0
4461,203,238,283,459,63,13,10,80,221,13,33,0,0
4462,193,235,269,452,63,13,10,76,217,14,33,0,0
4463,184,233,258,449,63,13,10,74,216,15,33,0,0
4464,179,236,246,435,63,13,10,67,199,16,33,0,0
4465,177,233,242,429,63,13,10,65,196,17,33,0,0
4466,172,232,235,427,63,13,10,63,195,18,33,0,0
4467,167,232,228,424,63,13,10,61,192,19,33,0,0
4468,165,230,222,416,63,13,10,57,186,20,33,0,0
4469,164,230,220,414,63,13,10,56,184,21,33,0,0
4470,165,227,218,404,63,13,10,53,177,22,33,0,0
4471,164,227,216,402,63,13,10,52,175,23,33,0,0
4472,161,225,211,399,63,13,10,50,174,24,33,0,0
4473,159,223,208,394,63,13,10,49,171,25,33,0,0
4474,158,223,203,389,63,13,10,45,166,26,33,0,0
4475,155,224,198,384,63,13,10,43,160,27,33,0,0
4476,149,223,192,384,63,13,10,43,161,28,33,0,0
4477,143,222,186,383,63,13,10,43,161,29,33,0,0
4478,138,223,179,379,63,13,10,41,156,30,33,0,0
4479,134,222,173,373,63,13,10,39,151,31,33,0,0
4480,128,227,165,369,63,13,10,37,142,32,33,0,0
4481,122,227,158,365,63,13,10,36,138,33,33,1,0
5405,252,218,287,341,64,13,10,35,123,0,7,0,0
5409,208,213,245,335,64,13,10,37,122,0,7,0,0
5410,188,210,225,333,64,13,10,37,123,1,7,0,0
5411,176,210,214,333,64,13,10,38,123,2,7,0,0
5412,167,206,206,332,64,13,10,39,126,3,7,0,0
5413,162,206,200,331,64,13,10,38,125,4,7,0,0
5414,156,204,193,323,64,13,10,37,119,5,7,0,0
5415,150,204,187,322,64,13,10,37,118,6,7,0,0
5416,144,205,179,318,64,13,10,35,113,7,7,0,0
5589,74,218,112,356,66,13,10,38,138,0,0,0,0
5595,156,222,192,372,68,13,10,36,150,0,29,0,1
5596,162,219,198,371,68,13,10,36,152,1,29,0,0
5597,164,217,204,383,68,13,10,40,166,2,29,0,0
5598,167,218,209,389,68,13,10,42,171,3,29,0,0
5599,171,219,214,393,68,13,10,43,174,4,29,0,0
5600,176,223,217,386,68,13,10,41,163,5,29,0,0
5601,177,223,221,394,68,13,10,44,171,6,29,0,0
5602,178,228,225,407,68,13,10,47,179,7,29,0,0
5603,184,228,233,415,68,13,10,49,187,8,29,0,0
5604,190,230,240,418,68,13,10,50,188,9,29,0,0
5605,198,233,248,418,68,13,10,50,185,10,29,0,0
5606,203,232,254,423,68,13,10,51,191,11,29,0,0
5607,208,232,262,434,68,13,10,54,202,12,29,0,0
5608,221,235,274,431,68,13,10,53,196,13,29,0,0
5609,234,233,288,439,68,13,10,54,206,14,29,0,0
5610,243,234,301,451,68,13,10,58,217,15,29,0,0
5611,254,235,312,447,68,13,10,58,212,16,29,0,0
5612,268,239,329,464,68,13,10,61,225,17,29,0,0
5613,281,246,345,478,68,13,10,64,232,18,29,0,0
5614,300,247,363,479,68,13,10,63,232,19,29,0,0
5615,320,252,385,489,68,13,10,65,237,20,29,0,0
5616,344,252,409,491,68,13,10,65,239,21,29,0,0
5617,365,254,434,500,68,13,10,69,246,22,29,0,0
5618,386,256,458,502,68,13,10,72,246,23,29,0,0
5619,422,256,494,507,68,13,10,72,251,24,29,0,0
5620,450,265,525,515,68,13,10,75,250,25,29,0,0
5621,481,264,558,517,68,13,10,77,253,26,29,0,0
5622,515,259,595,520,68,13,10,80,261,27,29,0,0
5623,539,269,619,525,68,13,10,80,256,28,29,0,0
5624,559,272,641,530,68,13,10,82,258,29,29,1,0
5956,899,362,970,683,71,13,10,71,321,0,0,0,0
5957,781,367,961,782,72,13,10,180,415,0,43,0,1
5958,763,363,946,787,72,13,10,183,424,1,43,0,0
5959,715,352,899,784,72,13,10,184,432,2,43,0,0
5960,650,348,833,775,72,13,10,183,427,3,43,0,0
5961,599,337,777,759,72,13,10,178,422,4,43,0,0
5962,551,328,724,738,72,13,10,173,410,5,43,0,0
5963,503,326,674,730,72,13,10,171,404,6,43,0,0
5964,460,316,621,706,72,13,10,161,390,7,43,0,0
5965,412,305,570,687,72,13,10,158,382,8,43,0,0
5966,375,304,526,670,72,13,10,151,366,9,43,0,0
5967,357,296,503,656,72,13,10,146,360,10,43,0,0
5968,325,296,465,642,72,13,10,140,346,11,43,0,0
5969,308,296,444,635,72,13,10,136,339,12,43,0,0
5970,279,291,407,611,72,13,10,128,320,13,43,0,0
5971,259,290,382,596,72,13,10,123,306,14,43,0,0
5972,251,281,368,576,72,13,10,117,295,15,43,0,0
5973,246,275,363,572,72,13,10,117,297,16,43,0,0
5974,233,276,344,561,72,13,10,111,285,17,43,0,0
5975,221,268,328,545,72,13,10,107,277,18,43,0,0
5976,212,267,316,534,72,13,10,104,267,19,43,0,0
5977,213,265,312,522,72,13,10,99,257,20,43,0,0
5978,212,260,308,511,72,13,10,96,251,21,43,0,0
5979,209,261,299,498,72,13,10,90,237,22,43,0,0
5980,200,253,290,492,72,13,10,90,239,23,43,0,0
5981,192,249,279,484,72,13,10,87,235,24,43,0,0
5982,187,250,272,479,72,13,10,85,229,25,43,0,0
5983,184,242,268,470,72,13,10,84,228,26,43,0,0
5984,179,240,261,465,72,13,10,82,225,27,43,0,0
5985,173,243,252,460,72,13,10,79,217,28,43,0,0
5986,166,240,244,456,72,13,10,78,216,29,43,0,0
5987,164,242,239,450,72,13,10,75,208,30,43,0,0
5988,161,239,233,440,72,13,10,72,201,31,43,0,0
5989,158,236,229,433,72,13,10,71,197,32,43,0,0
5990,154,231,225,432,72,13,10,71,201,33,43,0,0
5991,148,224,220,425,72,13,10,72,201,34,43,0,0
5992,146,216,218,422,72,13,10,72,206,35,43,0,0
5993,146,210,216,414,72,13,10,70,204,36,43,0,0
5994,148,212,214,404,72,13,10,66,192,37,43,0,0
5995,149,217,212,401,72,13,10,63,184,38,43,0,0
5996,148,217,210,398,72,13,10,62,181,39,43,0,0
5997,148,214,208,393,72,13,10,60,179,40,43,0,0
5998,149,215,207,389,72,13,10,58,174,41,43,0,0
5999,149,216,204,383,72,13,10,55,167,42,43,0,0
6000,147,217,202,379,72,13,10,55,162,43,43,1,0
2170,1808,900,1920,1075,2,13,11,112,175,0,0,0,0
2171,1679,857,1886,1075,3,13,11,207,218,0,1,0,0
2172,1675,914,1835,1079,3,13,11,160,165,1,1,0,0
2428,1695,823,1919,1063,4,13,11,224,240,0,3,0,0
2429,1599,708,1920,1073,4,13,11,321,365,1,3,0,0
2430,1607,702,1920,1078,4,13,11,313,376,2,3,0,0
2431,1593,682,1920,1080,4,13,11,327,398,3,3,0,0
2886,1763,799,1918,1080,6,13,11,155,281,0,0,0,0
2968,1390,648,1807,1074,10,13,11,417,426,0,1,0,0
2969,1480,568,1920,1073,10,13,11,440,505,1,1,0,0
2970,1772,623,1918,1076,11,13,11,146,453,0,0,0,0
4345,1649,660,1920,1064,12,13,11,271,404,0,3,0,0
4346,1636,650,1916,1067,12,13,11,280,417,1,3,0,0
4347,1612,736,1843,1074,12,13,11,231,338,2,3,0,0
4348,1601,770,1812,1077,12,13,11,211,307,3,3,0,0
4354,1835,716,1919,820,13,13,11,84,104,0,0,0,0
4355,1759,711,1920,1074,14,13,11,161,363,0,5,0,0
4356,1659,505,1909,1068,14,13,11,250,563,1,5,0,0
4357,1605,507,1859,1071,14,13,11,254,564,2,5,0,0
4358,1482,554,1725,1069,14,13,11,243,515,3,5,0,0
4359,1360,673,1561,1066,14,13,11,201,393,4,5,0,0
4360,1293,688,1486,1064,14,13,11,193,376,5,5,0,0
1049,11,609,319,1078,12,13,12,308,469,0,31,0,1
1050,67,572,392,1065,12,13,12,325,493,1,31,0,0
1051,157,549,503,1075,12,13,12,346,526,2,31,0,0
1052,273,539,621,1075,12,13,12,348,536,3,31,0,0
1053,350,514,712,1075,12,13,12,362,561,4,31,0,0
1054,473,496,838,1074,12,13,12,365,578,5,31,0,0
1055,544,478,917,1077,12,13,12,373,599,6,31,0,0
1056,648,464,1018,1072,12,13,12,370,608,7,31,0,0
1057,746,458,1111,1072,12,13,12,365,614,8,31,0,0
1058,829,458,1188,1069,12,13,12,359,611,9,31,0,0
1059,931,449,1281,1058,12,13,12,350,609,10,31,0,0
1060,1009,453,1357,1060,12,13,12,348,607,11,31,0,0
1061,1091,468,1427,1057,12,13,12,336,589,12,31,0,0
1062,1187,457,1521,1054,12,13,12,334,597,13,31,0,0
1063,1242,457,1573,1053,12,13,12,331,596,14,31,0,0
1064,1320,448,1626,1009,12,13,12,306,561,15,31,0,0
1065,1375,440,1665,977,12,13,12,290,537,16,31,0,0
1066,1427,436,1706,955,12,13,12,279,519,17,31,0,0
1067,1499,425,1769,931,12,13,12,270,506,18,31,0,0
1068,1550,430,1804,906,12,13,12,254,476,19,31,0,0
1069,1587,423,1827,885,12,13,12,240,462,20,31,0,0
1070,1605,424,1830,863,12,13,12,225,439,21,31,0,0
1071,1631,426,1849,849,12,13,12,218,423,22,31,0,0
1072,1683,411,1898,831,12,13,12,215,420,23,31,0,0
1073,1707,416,1919,832,12,13,12,212,416,24,31,0,0
1074,1744,421,1920,814,12,13,12,176,393,25,31,0,0
1075,1765,420,1920,790,12,13,12,155,370,26,31,0,0
1076,1776,438,1920,774,12,13,12,144,336,27,31,0,0
1077,1804,453,1920,765,12,13,12,116,312,28,31,0,0
1078,1824,466,1920,757,12,13,12,96,291,29,31,0,0
1079,1836,453,1920,742,12,13,12,84,289,30,31,0,0
1080,1865,455,1920,728,12,13,12,55,273,31,31,1,0
1477,289,110,324,208,14,13,12,35,98,0,74,0,1
1478,290,112,325,210,14,13,12,35,98,1,74,0,0
1479,290,113,325,211,14,13,12,35,98,2,74,0,0
1480,289,111,326,215,14,13,12,37,104,3,74,0,0
1481,288,111,326,218,14,13,12,38,107,4,74,0,0
1482,288,111,327,220,14,13,12,39,109,5,74,0,0
1483,289,113,327,221,14,13,12,38,108,6,74,0,0
1484,289,115,326,222,14,13,12,37,107,7,74,0,0
1485,289,115,328,227,14,13,12,39,112,8,74,0,0
1486,290,116,329,228,14,13,12,39,112,9,74,0,0
1487,291,115,332,231,14,13,12,41,116,10,74,0,0
1488,292,117,333,235,14,13,12,41,118,11,74,0,0
1489,292,116,332,233,14,13,12,40,117,12,74,0,0
1490,293,115,334,237,14,13,12,41,122,13,74,0,0
1491,295,116,336,239,14,13,12,41,123,14,74,0,0
1492,297,117,338,241,14,13,12,41,124,15,74,0,0
1493,297,116,339,243,14,13,12,42,127,16,74,0,0
1494,297,116,339,245,14,13,12,42,129,17,74,0,0
1495,298,120,341,249,14,13,12,43,129,18,74,0,0
1496,301,126,342,251,14,13,12,41,125,19,74,0,0
1497,302,124,343,253,14,13,12,41,129,20,74,0,0
1498,304,130,343,255,14,13,12,39,125,21,74,0,0
1499,303,130,343,257,14,13,12,40,127,22,74,0,0
1500,304,134,344,263,14,13,12,40,129,23,74,0,0
1501,307,141,346,268,14,13,12,39,127,24,74,0,0
1502,309,138,350,271,14,13,12,41,133,25,74,0,0
1503,309,137,351,273,14,13,12,42,136,26,74,0,0
1504,309,135,352,276,14,13,12,43,141,27,74,0,0
1505,309,143,352,282,14,13,12,43,139,28,74,0,0
1506,311,142,355,287,14,13,12,44,145,29,74,0,0
1507,313,146,356,288,14,13,12,43,142,30,74,0,0
1508,312,148,357,294,14,13,12,45,146,31,74,0,0
1509,312,146,357,297,14,13,12,45,151,32,74,0,0
1510,312,149,358,301,14,13,12,46,152,33,74,0,0
1511,315,150,361,304,14,13,12,46,154,34,74,0,0
1512,317,149,365,309,14,13,12,48,160,35,74,0,0
1513,315,145,367,321,14,13,12,52,176,36,74,0,0
1514,313,137,368,327,14,13,12,55,190,37,74,0,0
1515,318,149,371,334,14,13,12,53,185,38,74,0,0
1516,321,150,374,337,14,13,12,53,187,39,74,0,0
1517,324,160,376,340,14,13,12,52,180,40,74,0,0
1518,325,166,377,350,14,13,12,52,184,41,74,0,0
1519,326,168,381,358,14,13,12,55,190,42,74,0,0
1520,330,174,385,364,14,13,12,55,190,43,74,0,0
1521,334,172,390,366,14,13,12,56,194,44,74,0,0
1522,334,174,394,382,14,13,12,60,208,45,74,0,0
1523,335,173,397,390,14,13,12,62,217,46,74,0,0
1524,337,176,402,401,14,13,12,65,225,47,74,0,0
1525,339,176,406,411,14,13,12,67,235,48,74,0,0
1526,339,173,410,418,14,13,12,71,245,49,74,0,0
1527,339,181,412,432,14,13,12,73,251,50,74,0,0
1528,340,184,414,441,14,13,12,74,257,51,74,0,0
1529,340,189,417,455,14,13,12,77,266,52,74,0,0
1530,341,190,421,469,14,13,12,80,279,53,74,0,0
1531,341,189,427,484,14,13,12,86,295,54,74,0,0
1532,341,199,431,507,14,13,12,90,308,55,74,0,0
1533,343,202,435,520,14,13,12,92,318,56,74,0,0
1534,345,213,437,532,14,13,12,92,319,57,74,0,0
1535,350,225,445,553,14,13,12,95,328,58,74,0,0
1536,349,227,454,587,14,13,12,105,360,59,74,0,0
1537,348,238,460,620,14,13,12,112,382,60,74,0,0
1538,352,240,467,632,14,13,12,115,392,61,74,0,0
1539,359,250,479,655,14,13,12,120,405,62,74,0,0
1540,363,256,492,688,14,13,12,129,432,63,74,0,0
1541,367,259,510,735,14,13,12,143,476,64,74,0,0
1542,367,283,517,779,14,13,12,150,496,65,74,0,0
1543,368,291,524,803,14,13,12,156,512,66,74,0,0
1544,349,316,524,891,14,13,12,175,575,67,74,0,0
1545,335,342,518,932,14,13,12,183,590,68,74,0,0
1546,315,368,510,990,14,13,12,195,622,69,74,0,0
1547,271,403,477,1038,14,13,12,206,635,70,74,0,0
1548,187,419,407,1066,14,13,12,220,647,71,74,0,0
1549,126,458,353,1080,14,13,12,227,622,72,74,0,0
1550,53,506,267,1080,14,13,12,214,574,73,74,0,0
1551,34,524,252,1080,14,13,12,218,556,74,74,1,0
2389,1721,853,1901,1076,15,13,12,180,223,0,0,0,0
2390,1558,765,1837,1072,16,13,12,279,307,0,25,0,1
2391,1470,706,1804,1074,16,13,12,334,368,1,25,0,0
2392,1415,636,1807,1071,16,13,12,392,435,2,25,0,0
2393,1385,594,1811,1074,16,13,12,426,480,3,25,0,0
2394,1373,569,1814,1071,16,13,12,441,502,4,25,0,0
2395,1368,533,1831,1071,16,13,12,463,538,5,25,0,0
2396,1387,516,1848,1067,16,13,12,461,551,6,25,0,0
2397,1397,487,1854,1048,16,13,12,457,561,7,25,0,0
2398,1418,467,1850,1011,16,13,12,432,544,8,25,0,0
2399,1442,457,1847,979,16,13,12,405,522,9,25,0,0
2400,1487,433,1861,931,16,13,12,374,498,10,25,0,0
2401,1527,433,1877,916,16,13,12,350,483,11,25,0,0
2402,1563,421,1883,881,16,13,12,320,460,12,25,0,0
2403,1591,409,1883,841,16,13,12,292,432,13,25,0,0
2404,1610,409,1882,823,16,13,12,272,414,14,25,0,0
2405,1642,402,1894,796,16,13,12,252,394,15,25,0,0
2406,1677,395,1917,783,16,13,12,240,388,16,25,0,0
2407,1703,396,1920,772,16,13,12,217,376,17,25,0,0
2408,1726,388,1920,745,16,13,12,194,357,18,25,0,0
2409,1737,392,1920,728,16,13,12,183,336,19,25,0,0
2410,1758,407,1920,715,16,13,12,162,308,20,25,0,0
2411,1787,403,1920,706,16,13,12,133,303,21,25,0,0
2412,1803,409,1920,705,16,13,12,117,296,22,25,0,0
2413,1826,407,1920,679,16,13,12,94,272,23,25,0,0
2414,1831,405,1920,668,16,13,12,89,263,24,25,0,0
2415,1845,402,1920,652,16,13,12,75,250,25,25,1,0
2725,368,135,405,282,20,13,12,37,147,0,36,0,0
2726,372,136,409,289,20,13,12,37,153,1,36,0,0
2727,374,136,412,294,20,13,12,38,158,2,36,0,0
2728,378,135,415,291,20,13,12,37,156,3,36,0,0
2729,381,139,419,296,20,13,12,38,157,4,36,0,0
2730,382,136,421,299,20,13,12,39,163,5,36,0,0
2731,385,138,425,302,20,13,12,40,164,6,36,0,0
2732,388,139,427,305,20,13,12,39,166,7,36,0,0
2733,389,139,430,311,20,13,12,41,172,8,36,0,0
2734,390,142,433,318,20,13,12,43,176,9,36,0,0
2735,389,142,434,323,20,13,12,45,181,10,36,0,0
2736,390,143,437,331,20,13,12,47,188,11,36,0,0
2737,392,143,439,335,20,13,12,47,192,12,36,0,0
2738,393,140,441,339,20,13,12,48,199,13,36,0,0
2739,394,140,443,343,20,13,12,49,203,14,36,0,0
2741,393,153,443,361,20,13,12,50,208,0,36,0,1
2742,395,156,446,368,20,13,12,51,212,1,36,0,0
2743,397,156,449,373,20,13,12,52,217,2,36,0,0
2744,398,159,451,386,20,13,12,53,227,3,36,0,0
2745,401,159,456,397,20,13,12,55,238,4,36,0,0
2746,403,158,462,406,20,13,12,59,248,5,36,0,0
2747,408,170,469,430,20,13,12,61,260,6,36,0,0
2748,413,165,477,435,20,13,12,64,270,7,36,0,0
2749,418,168,482,439,20,13,12,64,271,8,36,0,0
2750,424,175,489,448,20,13,12,65,273,9,36,0,0
2751,427,177,498,464,20,13,12,71,287,10,36,0,0
2752,439,187,511,474,20,13,12,72,287,11,36,0,0
2753,449,187,522,478,20,13,12,73,291,12,36,0,0
2754,456,193,534,499,20,13,12,78,306,13,36,0,0
2755,463,193,546,519,20,13,12,83,326,14,36,0,0
2756,474,197,562,534,20,13,12,88,337,15,36,0,0
2757,486,205,576,548,20,13,12,90,343,16,36,0,0
2758,496,208,588,561,20,13,12,92,353,17,36,0,0
2759,505,217,604,590,20,13,12,99,373,18,36,0,0
2760,515,226,619,613,20,13,12,104,387,19,36,0,0
2761,520,226,633,635,20,13,12,113,409,20,36,0,0
2762,531,232,652,669,20,13,12,121,437,21,36,0,0
2763,546,235,672,689,20,13,12,126,454,22,36,0,0
2764,563,245,702,736,20,13,12,139,491,23,36,0,0
2765,583,259,727,765,20,13,12,144,506,24,36,0,0
2766,604,273,752,785,20,13,12,148,512,25,36,0,0
2767,630,292,791,850,20,13,12,161,558,26,36,0,0
2768,661,304,828,876,20,13,12,167,572,27,36,0,0
2769,691,324,879,966,20,13,12,188,642,28,36,0,0
2770,728,339,928,1014,20,13,12,200,675,29,36,0,0
2771,769,355,976,1054,20,13,12,207,699,30,36,0,0
2772,823,398,1030,1072,20,13,12,207,674,31,36,0,0
2773,899,425,1104,1080,20,13,12,205,655,32,36,0,0
2774,980,474,1182,1080,20,13,12,202,606,33,36,0,0
2775,1077,536,1272,1076,20,13,12,195,540,34,36,0,0
2776,1189,583,1381,1079,20,13,12,192,496,35,36,0,0
2777,1237,607,1428,1080,20,13,12,191,473,36,36,1,0
2746,271,413,542,1062,26,13,12,271,649,0,104,0,1
2747,278,398,544,1035,26,13,12,266,637,1,104,0,0
2748,291,384,545,996,26,13,12,254,612,2,104,0,0
2749,293,374,539,969,26,13,12,246,595,3,104,0,0
2750,278,352,513,921,26,13,12,235,569,4,104,0,0
2751,269,340,494,889,26,13,12,225,549,5,104,0,0
2752,263,332,481,865,26,13,12,218,533,6,104,0,0
2753,261,313,469,824,26,13,12,208,511,7,104,0,0
2754,268,298,463,785,26,13,12,195,487,8,104,0,0
2755,275,294,459,753,26,13,12,184,459,9,104,0,0
2756,269,283,450,741,26,13,12,181,458,10,104,0,0
2757,264,269,434,704,26,13,12,170,435,11,104,0,0
2758,259,265,429,704,26,13,12,170,439,12,104,0,0
2759,263,256,422,670,26,13,12,159,414,13,104,0,0
2760,271,248,423,650,26,13,12,152,402,14,104,0,0
2761,279,248,426,640,26,13,12,147,392,15,104,0,0
2762,279,242,421,625,26,13,12,142,383,16,104,0,0
2763,275,238,409,598,26,13,12,134,360,17,104,0,0
2764,272,233,408,599,26,13,12,136,366,18,104,0,0
2765,277,230,407,582,26,13,12,130,352,19,104,0,0
2766,286,225,410,564,26,13,12,124,339,20,104,0,0
2767,294,225,413,553,26,13,12,119,328,21,104,0,0
2768,292,219,409,543,26,13,12,117,324,22,104,0,0
2769,290,214,403,526,26,13,12,113,312,23,104,0,0
2770,289,211,400,519,26,13,12,111,308,24,104,0,0
2771,292,209,401,513,26,13,12,109,304,25,104,0,0
2772,300,206,402,495,26,13,12,102,289,26,104,0,0
2773,303,204,403,484,26,13,12,100,280,27,104,0,0
2774,300,204,396,476,26,13,12,96,272,28,104,0,0
2775,292,202,386,467,26,13,12,94,265,29,104,0,0
2776,287,199,381,461,26,13,12,94,262,30,104,0,0
2777,287,198,377,451,26,13,12,90,253,31,104,0,0
2778,289,195,376,440,26,13,12,87,245,32,104,0,0
2779,290,194,375,433,26,13,12,85,239,33,104,0,0
2780,285,191,370,432,26,13,12,85,241,34,104,0,0
2781,279,186,364,427,26,13,12,85,241,35,104,0,0
2782,276,185,360,423,26,13,12,84,238,36,104,0,0
2783,274,184,357,417,26,13,12,83,233,37,104,0,0
2784,274,179,354,407,26,13,12,80,228,38,104,0,0
2785,273,177,353,401,26,13,12,80,224,39,104,0,0
2786,270,175,348,399,26,13,12,78,224,40,104,0,0
2787,268,173,343,394,26,13,12,75,221,41,104,0,0
2788,265,173,339,392,26,13,12,74,219,42,104,0,0
2789,264,170,338,390,26,13,12,74,220,43,104,0,0
2790,271,170,340,381,26,13,12,69,211,44,104,0,0
2791,277,170,344,376,26,13,12,67,206,45,104,0,0
2792,278,172,343,373,26,13,12,65,201,46,104,0,0
2793,277,168,340,368,26,13,12,63,200,47,104,0,0
2794,277,165,339,365,26,13,12,62,200,48,104,0,0
2795,280,167,340,362,26,13,12,60,195,49,104,0,0
2796,284,168,343,359,26,13,12,59,191,50,104,0,0
2797,288,165,347,352,26,13,12,59,187,51,104,0,0
2798,292,163,352,345,26,13,12,60,182,52,104,0,0
2799,295,164,354,343,26,13,12,59,179,53,104,0,0
2800,295,162,355,339,26,13,12,60,177,54,104,0,0
2801,296,163,354,336,26,13,12,58,173,55,104,0,0
2802,297,164,353,333,26,13,12,56,169,56,104,0,0
2803,298,157,356,333,26,13,12,58,176,57,104,0,0
2804,299,156,356,330,26,13,12,57,174,58,104,0,0
2805,299,156,355,327,26,13,12,56,171,59,104,0,0
2806,297,153,353,326,26,13,12,56,173,60,104,0,0
2807,295,152,351,324,26,13,12,56,172,61,104,0,0
2808,295,154,349,320,26,13,12,54,166,62,104,0,0
2809,297,154,348,316,26,13,12,51,162,63,104,0,0
2810,297,154,346,310,26,13,12,49,156,64,104,0,0
2811,296,153,345,308,26,13,12,49,155,65,104,0,0
2812,294,154,342,302,26,13,12,48,148,66,104,0,0
2813,293,152,340,299,26,13,12,47,147,67,104,0,0
2814,292,151,339,298,26,13,12,47,147,68,104,0,0
2815,292,151,338,294,26,13,12,46,143,69,104,0,0
2816,291,151,336,291,26,13,12,45,140,70,104,0,0
2817,288,149,333,290,26,13,12,45,141,71,104,0,0
2818,284,147,329,287,26,13,12,45,140,72,104,0,0
2819,283,147,327,284,26,13,12,44,137,73,104,0,0
2820,282,146,326,283,26,13,12,44,137,74,104,0,0
2821,283,146,326,280,26,13,12,43,134,75,104,0,0
2822,284,147,326,278,26,13,12,42,131,76,104,0,0
2823,283,147,325,278,26,13,12,42,131,77,104,0,0
2824,283,147,323,275,26,13,12,40,128,78,104,0,0
2825,283,148,323,271,26,13,12,40,123,79,104,0,0
2826,284,146,323,268,26,13,12,39,122,80,104,0,0
2827,285,145,324,267,26,13,12,39,122,81,104,0,0
2828,286,148,323,264,26,13,12,37,116,82,104,0,0
2829,282,144,321,268,26,13,12,39,124,83,104,0,0
2830,280,139,321,266,26,13,12,41,127,84,104,0,0
2831,279,133,320,264,26,13,12,41,131,85,104,0,0
2832,279,128,321,261,26,13,12,42,133,86,104,0,0
2833,280,124,322,259,26,13,12,42,135,87,104,0,0
2834,281,123,322,257,26,13,12,41,134,88,104,0,0
2835,280,124,321,258,26,13,12,41,134,89,104,0,0
2836,280,121,321,256,26,13,12,41,135,90,104,0,0
2837,280,119,322,255,26,13,12,42,136,91,104,0,0
2838,281,118,322,252,26,13,12,41,134,92,104,0,0
2839,283,121,322,245,26,13,12,39,124,93,104,0,0
2840,284,127,321,245,26,13,12,37,118,94,104,0,0
2841,283,125,321,248,26,13,12,38,123,95,104,0,0
2842,283,124,320,246,26,13,12,37,122,96,104,0,0
2843,282,122,320,245,26,13,12,38,123,97,104,0,0
2844,282,119,321,244,26,13,12,39,125,98,104,0,0
2845,284,117,321,239,26,13,12,37,122,99,104,0,0
2846,285,119,320,233,26,13,12,35,114,100,104,0,0
2847,286,118,321,233,26,13,12,35,115,101,104,0,0
2848,286,117,321,233,26,13,12,35,116,102,104,0,0
2849,286,117,321,233,26,13,12,35,116,103,104,0,0
2850,286,117,321,231,26,13,12,35,114,104,104,1,0
2777,1296,723,1626,1075,27,13,12,330,352,0,0,0,0
2831,1784,878,1919,1074,29,13,12,135,196,0,0,0,0
2832,1611,776,1866,1080,30,13,12,255,304,0,23,0,1
2833,1493,698,1808,1073,30,13,12,315,375,1,23,0,0
2834,1414,650,1773,1075,30,13,12,359,425,2,23,0,0
2835,1380,589,1787,1072,30,13,12,407,483,3,23,0,0
2836,1385,555,1816,1073,30,13,12,431,518,4,23,0,0
2837,1383,537,1823,1075,30,13,12,440,538,5,23,0,0
2838,1384,504,1837,1069,30,13,12,453,565,6,23,0,0
2839,1388,485,1839,1061,30,13,12,451,576,7,23,0,0
2840,1426,463,1846,1015,30,13,12,420,552,8,23,0,0
2841,1460,451,1860,991,30,13,12,400,540,9,23,0,0
2842,1492,442,1863,961,30,13,12,371,519,10,23,0,0
2843,1522,421,1859,906,30,13,12,337,485,11,23,0,0
2844,1541,411,1859,884,30,13,12,318,473,12,23,0,0
2845,1571,405,1862,848,30,13,12,291,443,13,23,0,0
2846,1607,396,1882,829,30,13,12,275,433,14,23,0,0
2847,1633,393,1893,816,30,13,12,260,423,15,23,0,0
2848,1662,386,1896,778,30,13,12,234,392,16,23,0,0
2849,1679,386,1899,763,30,13,12,220,377,17,23,0,0
2850,1702,390,1905,745,30,13,12,203,355,18,23,0,0
2851,1730,382,1920,737,30,13,12,190,355,19,23,0,0
2852,1752,376,1920,727,30,13,12,168,351,20,23,0,0
2853,1772,359,1920,704,30,13,12,148,345,21,23,0,0
2854,1789,392,1920,699,30,13,12,131,307,22,23,0,0
2855,1804,387,1920,683,30,13,12,116,296,23,23,1,0
3075,271,394,919,1060,32,13,12,648,666,0,3,0,0
3076,259,364,878,1026,32,13,12,619,662,1,3,0,0
3077,278,347,842,974,32,13,12,564,627,2,3,0,0
3078,212,305,805,965,32,13,12,593,660,3,3,0,0
3078,466,331,647,862,33,13,12,181,531,0,47,0,1
3079,456,315,635,842,33,13,12,179,527,1,47,0,0
3080,449,289,619,788,33,13,12,170,499,2,47,0,0
3081,457,289,616,752,33,13,12,159,463,3,47,0,0
3082,463,275,606,691,33,13,12,143,416,4,47,0,0
3083,449,254,588,659,33,13,12,139,405,5,47,0,0
3084,440,243,573,632,33,13,12,133,389,6,47,0,0
3085,433,233,560,603,33,13,12,127,370,7,47,0,0
3086,427,230,548,588,33,13,12,121,358,8,47,0,0
3087,426,220,540,554,33,13,12,114,334,9,47,0,0
3088,420,213,531,539,33,13,12,111,326,10,47,0,0
3089,411,206,517,515,33,13,12,106,309,11,47,0,0
3090,403,207,506,505,33,13,12,103,298,12,47,0,0
3091,403,209,498,481,33,13,12,95,272,13,47,0,0
3092,398,200,490,466,33,13,12,92,266,14,47,0,0
3093,395,194,483,454,33,13,12,88,260,15,47,0,0
3094,384,184,472,444,33,13,12,88,260,16,47,0,0
3095,377,184,463,434,33,13,12,86,250,17,47,0,0
3096,376,178,458,419,33,13,12,82,241,18,47,0,0
3097,371,178,449,407,33,13,12,78,229,19,47,0,0
3098,365,179,439,400,33,13,12,74,221,20,47,0,0
3099,359,180,431,393,33,13,12,72,213,21,47,0,0
3100,356,178,426,386,33,13,12,70,208,22,47,0,0
3101,352,182,417,376,33,13,12,65,194,23,47,0,0
3102,348,182,409,367,33,13,12,61,185,24,47,0,0
3103,342,176,404,362,33,13,12,62,186,25,47,0,0
3104,338,175,399,358,33,13,12,61,183,26,47,0,0
3105,338,179,394,347,33,13,12,56,168,27,47,0,0
3106,334,172,391,342,33,13,12,57,170,28,47,0,0
3107,333,181,384,336,33,13,12,51,155,29,47,0,0
3108,330,179,381,331,33,13,12,51,152,30,47,0,0
3109,328,177,378,327,33,13,12,50,150,31,47,0,0
3110,326,167,377,320,33,13,12,51,153,32,47,0,0
3111,323,157,375,317,33,13,12,52,160,33,47,0,0
3112,322,165,371,313,33,13,12,49,148,34,47,0,0
3113,322,166,368,305,33,13,12,46,139,35,47,0,0
3114,322,168,366,301,33,13,12,44,133,36,47,0,0
3115,322,167,365,296,33,13,12,43,129,37,47,0,0
3116,320,163,363,294,33,13,12,43,131,38,47,0,0
3117,319,160,361,291,33,13,12,42,131,39,47,0,0
3118,319,162,359,287,33,13,12,40,125,40,47,0,0
3119,319,155,359,281,33,13,12,40,126,41,47,0,0
3120,319,148,359,276,33,13,12,40,128,42,47,0,0
3121,319,152,357,273,33,13,12,38,121,43,47,0,0
3122,319,149,356,270,33,13,12,37,121,44,47,0,0
3123,319,146,356,268,33,13,12,37,122,45,47,0,0
3124,321,146,357,264,33,13,12,36,118,46,47,0,0
3125,321,146,356,261,33,13,12,35,115,47,47,1,0
3127,318,140,353,254,33,13,12,35,114,0,47,0,0
3130,314,136,349,251,33,13,12,35,115,0,47,0,0
3131,312,132,347,247,33,13,12,35,115,1,47,0,0
3132,310,128,345,245,33,13,12,35,117,2,47,0,0
3515,1867,419,1920,654,37,13,12,53,235,0,40,0,1
3516,1856,392,1917,664,37,13,12,61,272,1,40,0,0
3517,1846,379,1915,683,37,13,12,69,304,2,40,0,0
3518,1842,378,1910,676,37,13,12,68,298,3,40,0,0
3519,1833,366,1910,699,37,13,12,77,333,4,40,0,0
3520,1824,366,1908,726,37,13,12,84,360,5,40,0,0
3521,1819,370,1904,725,37,13,12,85,355,6,40,0,0
3522,1791,372,1884,738,37,13,12,93,366,7,40,0,0
3523,1769,369,1872,755,37,13,12,103,386,8,40,0,0
3524,1761,376,1867,760,37,13,12,106,384,9,40,0,0
3525,1750,381,1870,808,37,13,12,120,427,10,40,0,0
3526,1738,389,1866,831,37,13,12,128,442,11,40,0,0
3527,1728,388,1877,893,37,13,12,149,505,12,40,0,0
3528,1698,392,1843,857,37,13,12,145,465,13,40,0,0
3529,1663,402,1815,866,37,13,12,152,464,14,40,0,0
3530,1646,399,1801,868,37,13,12,155,469,15,40,0,0
3531,1618,401,1789,909,37,13,12,171,508,16,40,0,0
3532,1588,404,1765,926,37,13,12,177,522,17,40,0,0
3533,1574,413,1753,931,37,13,12,179,518,18,40,0,0
3534,1537,406,1726,920,37,13,12,189,514,19,40,0,0
3535,1472,411,1683,965,37,13,12,211,554,20,40,0,0
3536,1434,403,1653,972,37,13,12,219,569,21,40,0,0
3537,1388,405,1621,1006,37,13,12,233,601,22,40,0,0
3538,1339,415,1587,1044,37,13,12,248,629,23,40,0,0
3539,1313,431,1557,1045,37,13,12,244,614,24,40,0,0
3540,1250,433,1498,1042,37,13,12,248,609,25,40,0,0
3541,1170,435,1434,1063,37,13,12,264,628,26,40,0,0
3542,1123,433,1393,1068,37,13,12,270,635,27,40,0,0
3543,1063,431,1331,1044,37,13,12,268,613,28,40,0,0
3544,1000,450,1257,1018,37,13,12,257,568,29,40,0,0
3545,944,460,1213,1047,37,13,12,269,587,30,40,0,0
3546,862,464,1141,1060,37,13,12,279,596,31,40,0,0
3547,724,487,1014,1076,37,13,12,290,589,32,40,0,0
3548,666,496,946,1070,37,13,12,280,574,33,40,0,0
3549,556,501,844,1079,37,13,12,288,578,34,40,0,0
3550,443,539,721,1076,37,13,12,278,537,35,40,0,0
3551,360,557,626,1077,37,13,12,266,520,36,40,0,0
3552,258,579,514,1077,37,13,12,256,498,37,40,0,0
3553,117,608,366,1075,37,13,12,249,467,38,40,0,0
3554,10,620,252,1080,37,13,12,242,460,39,40,0,0
3555,0,635,162,1080,37,13,12,162,445,40,40,1,0
3529,1721,557,1877,910,38,13,12,156,353,0,0,0,0
3543,1167,691,1384,1068,39,13,12,217,377,0,1,0,0
3544,1101,723,1301,1069,39,13,12,200,346,1,1,0,0
4587,322,399,550,1077,46,13,12,228,678,0,33,0,1
4588,316,372,538,1031,46,13,12,222,659,1,33,0,0
4589,317,350,530,982,46,13,12,213,632,2,33,0,0
4590,329,341,524,917,46,13,12,195,576,3,33,0,0
4591,321,319,500,845,46,13,12,179,526,4,33,0,0
4592,321,305,488,795,46,13,12,167,490,5,33,0,0
4593,324,298,460,695,46,13,12,136,397,6,33,0,0
4594,318,279,454,670,46,13,12,136,391,7,33,0,0
4595,317,270,444,631,46,13,12,127,361,8,33,0,0
4596,307,256,428,600,46,13,12,121,344,9,33,0,0
4597,308,243,408,522,46,13,12,100,279,10,33,0,0
4598,319,244,401,472,46,13,12,82,228,11,33,0,0
4599,319,241,407,485,46,13,12,88,244,12,33,0,0
4600,321,233,414,494,46,13,12,93,261,13,33,0,0
4601,324,230,409,468,46,13,12,85,238,14,33,0,0
4602,315,223,400,462,46,13,12,85,239,15,33,0,0
4603,314,220,389,434,46,13,12,75,214,16,33,0,0
4604,318,219,381,397,46,13,12,63,178,17,33,0,0
4605,315,215,385,416,46,13,12,70,201,18,33,0,0
4606,308,208,390,445,46,13,12,82,237,19,33,0,0
4607,301,206,392,469,46,13,12,91,263,20,33,0,0
4608,291,204,386,484,46,13,12,95,280,21,33,0,0
4609,286,199,375,462,46,13,12,89,263,22,33,0,0
4610,286,199,368,444,46,13,12,82,245,23,33,0,0
4611,286,199,366,438,46,13,12,80,239,24,33,0,0
4612,280,192,367,457,46,13,12,87,265,25,33,0,0
4613,281,188,366,450,46,13,12,85,262,26,33,0,0
4614,280,190,359,441,46,13,12,79,251,27,33,0,0
4615,288,184,344,357,46,13,12,56,173,28,33,0,0
4616,291,183,340,330,46,13,12,49,147,29,33,0,0
4617,280,182,354,413,46,13,12,74,231,30,33,0,0
4618,281,182,357,425,46,13,12,76,243,31,33,0,0
4619,282,179,355,415,46,13,12,73,236,32,33,0,0
4620,280,177,355,419,46,13,12,75,242,33,33,1,0
4593,161,449,768,1058,48,13,12,607,609,0,1,0,0
4594,102,368,784,1054,48,13,12,682,686,1,1,0,0
4589,1269,771,1555,1075,49,13,12,286,304,0,81,0,1
4590,1140,705,1486,1074,49,13,12,346,369,1,81,0,0
4591,1017,652,1408,1071,49,13,12,391,419,2,81,0,0
4592,867,598,1304,1071,49,13,12,437,473,3,81,0,0
4593,766,549,1242,1068,49,13,12,476,519,4,81,0,0
4594,702,497,1217,1071,49,13,12,515,574,5,81,0,0
4595,652,455,1188,1070,49,13,12,536,615,6,81,0,0
4596,603,430,1134,1063,49,13,12,531,633,7,81,0,0
4597,552,392,1082,1051,49,13,12,530,659,8,81,0,0
4598,516,376,1030,1038,49,13,12,514,662,9,81,0,0
4599,507,357,986,999,49,13,12,479,642,10,81,0,0
4600,517,336,946,937,49,13,12,429,601,11,81,0,0
4601,509,323,907,906,49,13,12,398,583,12,81,0,0
4602,499,310,856,854,49,13,12,357,544,13,81,0,0
4603,477,296,814,830,49,13,12,337,534,14,81,0,0
4604,473,285,787,802,49,13,12,314,517,15,81,0,0
4605,486,268,768,753,49,13,12,282,485,16,81,0,0
4606,485,263,747,731,49,13,12,262,468,17,81,0,0
4607,477,254,721,706,49,13,12,244,452,18,81,0,0
4608,463,248,689,677,49,13,12,226,429,19,81,0,0
4609,453,245,669,666,49,13,12,216,421,20,81,0,0
4610,456,235,655,633,49,13,12,199,398,21,81,0,0
4611,454,233,636,609,49,13,12,182,376,22,81,0,0
4612,444,229,618,598,49,13,12,174,369,23,81,0,0
4613,423,222,588,580,49,13,12,165,358,24,81,0,0
4614,414,222,572,572,49,13,12,158,350,25,81,0,0
4615,413,213,559,546,49,13,12,146,333,26,81,0,0
4616,412,211,549,532,49,13,12,137,321,27,81,0,0
4617,409,210,537,519,49,13,12,128,309,28,81,0,0
4618,402,206,523,503,49,13,12,121,297,29,81,0,0
4619,397,205,514,495,49,13,12,117,290,30,81,0,0
4620,399,202,510,482,49,13,12,111,280,31,81,0,0
4621,404,196,509,466,49,13,12,105,270,32,81,0,0
4622,401,193,503,459,49,13,12,102,266,33,81,0,0
4623,396,186,495,449,49,13,12,99,263,34,81,0,0
4624,391,183,487,443,49,13,12,96,260,35,81,0,0
4625,392,180,486,434,49,13,12,94,254,36,81,0,0
4626,395,174,486,426,49,13,12,91,252,37,81,0,0
4627,394,175,480,417,49,13,12,86,242,38,81,0,0
4628,390,173,472,408,49,13,12,82,235,39,81,0,0
4629,386,171,467,403,49,13,12,81,232,40,81,0,0
4630,382,170,462,399,49,13,12,80,229,41,81,0,0
4631,384,169,460,389,49,13,12,76,220,42,81,0,0
4632,380,169,453,383,49,13,12,73,214,43,81,0,0
4633,377,167,448,377,49,13,12,71,210,44,81,0,0
4634,371,161,442,370,49,13,12,71,209,45,81,0,0
4635,370,159,439,368,49,13,12,69,209,46,81,0,0
4636,370,154,439,361,49,13,12,69,207,47,81,0,0
4637,372,155,438,356,49,13,12,66,201,48,81,0,0
4638,370,155,434,353,49,13,12,64,198,49,81,0,0
4639,367,153,429,343,49,13,12,62,190,50,81,0,0
4640,365,150,427,338,49,13,12,62,188,51,81,0,0
4641,366,150,426,334,49,13,12,60,184,52,81,0,0
4642,366,151,425,331,49,13,12,59,180,53,81,0,0
4643,363,152,420,329,49,13,12,57,177,54,81,0,0
4644,359,151,414,323,49,13,12,55,172,55,81,0,0
4645,356,150,411,322,49,13,12,55,172,56,81,0,0
4646,356,148,411,318,49,13,12,55,170,57,81,0,0
4647,358,147,411,311,49,13,12,53,164,58,81,0,0
4648,357,148,407,306,49,13,12,50,158,59,81,0,0
4649,353,147,403,302,49,13,12,50,155,60,81,0,0
4650,352,145,401,300,49,13,12,49,155,61,81,0,0
4651,353,145,402,298,49,13,12,49,153,62,81,0,0
4652,354,142,402,295,49,13,12,48,153,63,81,0,0
4653,353,141,401,293,49,13,12,48,152,64,81,0,0
4654,352,137,399,287,49,13,12,47,150,65,81,0,0
4655,352,135,398,283,49,13,12,46,148,66,81,0,0
4656,353,135,398,281,49,13,12,45,146,67,81,0,0
4657,355,135,398,276,49,13,12,43,141,68,81,0,0
4658,354,135,397,274,49,13,12,43,139,69,81,0,0
4659,350,133,393,273,49,13,12,43,140,70,81,0,0
4660,349,132,391,270,49,13,12,42,138,71,81,0,0
4661,349,133,392,269,49,13,12,43,136,72,81,0,0
4662,350,133,391,265,49,13,12,41,132,73,81,0,0
4663,349,136,389,266,49,13,12,40,130,74,81,0,0
4664,347,135,387,266,49,13,12,40,131,75,81,0,0
4665,346,135,385,260,49,13,12,39,125,76,81,0,0
4666,347,130,386,257,49,13,12,39,127,77,81,0,0
4667,347,129,386,256,49,13,12,39,127,78,81,0,0
4668,348,131,386,253,49,13,12,38,122,79,81,0,0
4669,348,135,384,252,49,13,12,36,117,80,81,0,0
4670,346,133,382,248,49,13,12,36,115,81,81,1,0
4672,347,128,383,244,49,13,12,36,116,0,81,0,0
4673,349,127,384,243,49,13,12,35,116,1,81,0,0
4674,346,127,382,244,49,13,12,36,117,2,81,0,0
4675,345,126,380,240,49,13,12,35,114,3,81,0,0
4594,328,546,575,1075,50,13,12,247,529,0,99,0,1
4595,304,506,568,1072,50,13,12,264,566,1,99,0,0
4596,286,474,562,1071,50,13,12,276,597,2,99,0,0
4597,276,447,552,1045,50,13,12,276,598,3,99,0,0
4598,268,421,531,998,50,13,12,263,577,4,99,0,0
4599,269,405,520,967,50,13,12,251,562,5,99,0,0
4600,283,379,518,913,50,13,12,235,534,6,99,0,0
4601,292,364,514,878,50,13,12,222,514,7,99,0,0
4602,292,346,511,865,50,13,12,219,519,8,99,0,0
4603,299,330,501,814,50,13,12,202,484,9,99,0,0
4604,293,287,496,781,50,13,12,203,494,10,99,0,0
4605,297,293,493,780,50,13,12,196,487,11,99,0,0
4606,312,294,482,723,50,13,12,170,429,12,99,0,0
4607,314,287,475,697,50,13,12,161,410,13,99,0,0
4608,317,282,466,667,50,13,12,149,385,14,99,0,0
4609,312,276,454,643,50,13,12,142,367,15,99,0,0
4610,308,273,444,632,50,13,12,136,359,16,99,0,0
4611,305,267,433,606,50,13,12,128,339,17,99,0,0
4612,306,253,430,587,50,13,12,124,334,18,99,0,0
4613,307,250,427,575,50,13,12,120,325,19,99,0,0
4614,305,241,421,551,50,13,12,116,310,20,99,0,0
4615,296,234,410,542,50,13,12,114,308,21,99,0,0
4616,298,232,408,529,50,13,12,110,297,22,99,0,0
4617,305,220,413,510,50,13,12,108,290,23,99,0,0
4618,307,224,407,499,50,13,12,100,275,24,99,0,0
4619,303,215,402,488,50,13,12,99,273,25,99,0,0
4620,298,210,394,475,50,13,12,96,265,26,99,0,0
4621,294,208,388,469,50,13,12,94,261,27,99,0,0
4622,295,202,386,454,50,13,12,91,252,28,99,0,0
4623,294,197,385,446,50,13,12,91,249,29,99,0,0
4624,292,194,379,435,50,13,12,87,241,30,99,0,0
4625,289,188,375,426,50,13,12,86,238,31,99,0,0
4626,282,179,368,425,50,13,12,86,246,32,99,0,0
4627,283,186,364,419,50,13,12,81,233,33,99,0,0
4628,288,189,363,409,50,13,12,75,220,34,99,0,0
4629,287,182,361,405,50,13,12,74,223,35,99,0,0
4630,282,169,357,399,50,13,12,75,230,36,99,0,0
4631,279,164,352,392,50,13,12,73,228,37,99,0,0
4632,278,161,350,390,50,13,12,72,229,38,99,0,0
4633,281,165,348,382,50,13,12,67,217,39,99,0,0
4634,282,164,347,375,50,13,12,65,211,40,99,0,0
4635,283,163,346,371,50,13,12,63,208,41,99,0,0
4636,285,158,346,364,50,13,12,61,206,42,99,0,0
4637,287,153,347,358,50,13,12,60,205,43,99,0,0
4638,291,162,347,354,50,13,12,56,192,44,99,0,0
4639,295,165,348,347,50,13,12,53,182,45,99,0,0
4640,296,167,347,342,50,13,12,51,175,46,99,0,0
4641,294,162,346,339,50,13,12,52,177,47,99,0,0
4642,292,155,344,335,50,13,12,52,180,48,99,0,0
4643,291,151,343,331,50,13,12,52,180,49,99,0,0
4644,292,153,343,328,50,13,12,51,175,50,99,0,0
4645,294,154,343,323,50,13,12,49,169,51,99,0,0
4646,295,157,342,317,50,13,12,47,160,52,99,0,0
4647,294,152,340,313,50,13,12,46,161,53,99,0,0
4648,292,148,338,308,50,13,12,46,160,54,99,0,0
4649,292,148,338,304,50,13,12,46,156,55,99,0,0
4650,292,146,338,301,50,13,12,46,155,56,99,0,0
4651,294,146,338,299,50,13,12,44,153,57,99,0,0
4652,293,148,337,296,50,13,12,44,148,58,99,0,0
4653,290,141,335,293,50,13,12,45,152,59,99,0,0
4654,289,137,334,288,50,13,12,45,151,60,99,0,0
4655,290,139,332,280,50,13,12,42,141,61,99,0,0
4656,289,138,331,279,50,13,12,42,141,62,99,0,0
4657,287,140,329,279,50,13,12,42,139,63,99,0,0
4658,284,136,327,280,50,13,12,43,144,64,99,0,0
4659,282,133,325,278,50,13,12,43,145,65,99,0,0
4660,282,128,326,277,50,13,12,44,149,66,99,0,0
4661,282,129,325,275,50,13,12,43,146,67,99,0,0
4662,282,130,323,273,50,13,12,41,143,68,99,0,0
4663,281,129,322,271,50,13,12,41,142,69,99,0,0
4664,285,124,330,272,50,13,12,45,148,70,99,0,0
4665,282,120,328,269,50,13,12,46,149,71,99,0,0
4666,281,118,326,266,50,13,12,45,148,72,99,0,0
4667,282,117,327,264,50,13,12,45,147,73,99,0,0
4668,283,117,327,260,50,13,12,44,143,74,99,0,0
4669,281,118,323,256,50,13,12,42,138,75,99,0,0
4670,283,119,323,251,50,13,12,40,132,76,99,0,0
4671,285,118,324,246,50,13,12,39,128,77,99,0,0
4672,286,120,324,243,50,13,12,38,123,78,99,0,0
4673,286,121,324,244,50,13,12,38,123,79,99,0,0
4674,288,122,325,243,50,13,12,37,121,80,99,0,0
4675,289,121,326,241,50,13,12,37,120,81,99,0,0
4676,289,121,326,240,50,13,12,37,119,82,99,0,0
4677,291,121,328,237,50,13,12,37,116,83,99,0,0
4678,292,118,330,236,50,13,12,38,118,84,99,0,0
4679,293,117,332,237,50,13,12,39,120,85,99,0,0
4680,292,116,330,234,50,13,12,38,118,86,99,0,0
4681,292,117,329,230,50,13,12,37,113,87,99,0,0
4682,292,116,329,226,50,13,12,37,110,88,99,0,0
4683,293,115,329,226,50,13,12,36,111,89,99,0,0
4684,293,114,330,226,50,13,12,37,112,90,99,0,0
4685,293,114,330,225,50,13,12,37,111,91,99,0,0
4686,292,113,329,221,50,13,12,37,108,92,99,0,0
4687,291,112,327,219,50,13,12,36,107,93,99,0,0
4688,291,112,328,220,50,13,12,37,108,94,99,0,0
4689,292,113,328,217,50,13,12,36,104,95,99,0,0
4690,292,113,327,216,50,13,12,35,103,96,99,0,0
4691,291,112,327,216,50,13,12,36,104,97,99,0,0
4692,290,112,326,214,50,13,12,36,102,98,99,0,0
4693,289,112,325,215,50,13,12,36,103,99,99,1,0
4620,288,181,345,271,51,13,12,57,90,0,5,0,0
4621,278,176,348,287,51,13,12,70,111,1,5,0,0
4622,279,172,346,279,51,13,12,67,107,2,5,0,0
4623,279,171,345,277,51,13,12,66,106,3,5,0,0
4624,281,169,346,274,51,13,12,65,105,4,5,0,0
4625,281,168,346,273,51,13,12,65,105,5,5,0,0
4627,285,163,337,247,51,13,12,52,84,0,5,0,0
4628,288,161,336,237,51,13,12,48,76,1,5,0,0
4629,291,162,335,232,51,13,12,44,70,2,5,0,0
4681,312,118,348,224,53,13,12,36,106,0,1,0,0
4682,323,119,358,223,53,13,12,35,104,1,1,0,0
4830,1840,529,1920,771,59,13,12,80,242,0,26,0,1
4831,1831,535,1915,790,59,13,12,84,255,1,26,0,0
4832,1825,505,1919,791,59,13,12,94,286,2,26,0,0
4833,1805,457,1920,826,59,13,12,115,369,3,26,0,0
4834,1787,437,1920,844,59,13,12,133,407,4,26,0,0
4835,1770,440,1908,852,59,13,12,138,412,5,26,0,0
4836,1736,434,1885,867,59,13,12,149,433,6,26,0,0
4837,1708,439,1863,877,59,13,12,155,438,7,26,0,0
4838,1688,444,1852,901,59,13,12,164,457,8,26,0,0
4839,1653,461,1829,937,59,13,12,176,476,9,26,0,0
4840,1622,472,1805,956,59,13,12,183,484,10,26,0,0
4841,1560,481,1754,969,59,13,12,194,488,11,26,0,0
4842,1510,486,1712,981,59,13,12,202,495,12,26,0,0
4843,1479,482,1690,998,59,13,12,211,516,13,26,0,0
4844,1412,489,1644,1037,59,13,12,232,548,14,26,0,0
4845,1350,494,1593,1057,59,13,12,243,563,15,26,0,0
4846,1267,490,1522,1073,59,13,12,255,583,16,26,0,0
4847,1186,502,1445,1080,59,13,12,259,578,17,26,0,0
4848,1123,499,1382,1080,59,13,12,259,581,18,26,0,0
4849,1053,502,1313,1074,59,13,12,260,572,19,26,0,0
4850,991,523,1252,1076,59,13,12,261,553,20,26,0,0
4851,864,530,1123,1079,59,13,12,259,549,21,26,0,0
4852,728,549,986,1080,59,13,12,258,531,22,26,0,0
4853,589,561,848,1080,59,13,12,259,519,23,26,0,0
4854,492,570,738,1077,59,13,12,246,507,24,26,0,0
4855,417,603,667,1077,59,13,12,250,474,25,26,0,0
4856,344,611,592,1080,59,13,12,248,469,26,26,1,0
4856,186,633,444,1077,60,13,12,258,444,0,0,0,0
4857,16,640,308,1078,61,13,12,292,438,0,0,0,0
5127,0,848,136,1080,62,13,12,136,232,0,0,0,0
5128,0,542,202,1075,63,13,12,202,533,0,79,0,1
5129,56,541,258,1071,63,13,12,202,530,1,79,0,0
5130,122,518,334,1072,63,13,12,212,554,2,79,0,0
5131,196,476,424,1064,63,13,12,228,588,3,79,0,0
5132,256,449,498,1067,63,13,12,242,618,4,79,0,0
5133,286,424,538,1068,63,13,12,252,644,5,79,0,0
5134,315,397,569,1046,63,13,12,254,649,6,79,0,0
5135,351,383,597,1016,63,13,12,246,633,7,79,0,0
5136,384,368,611,953,63,13,12,227,585,8,79,0,0
5137,390,343,614,924,63,13,12,224,581,9,79,0,0
5138,391,331,608,894,63,13,12,217,563,10,79,0,0
5139,393,311,597,845,63,13,12,204,534,11,79,0,0
5140,397,301,589,809,63,13,12,192,508,12,79,0,0
5141,403,293,590,790,63,13,12,187,497,13,79,0,0
5142,406,276,579,739,63,13,12,173,463,14,79,0,0
5143,403,271,570,722,63,13,12,167,451,15,79,0,0
5144,398,262,554,687,63,13,12,156,425,16,79,0,0
5145,391,255,540,661,63,13,12,149,406,17,79,0,0
5146,389,252,535,652,63,13,12,146,400,18,79,0,0
5147,391,245,526,613,63,13,12,135,368,19,79,0,0
5148,386,235,516,595,63,13,12,130,360,20,79,0,0
5149,380,227,505,574,63,13,12,125,347,21,79,0,0
5150,377,221,496,551,63,13,12,119,330,22,79,0,0
5151,377,221,493,543,63,13,12,116,322,23,79,0,0
5152,382,220,492,525,63,13,12,110,305,24,79,0,0
5153,382,223,485,508,63,13,12,103,285,25,79,0,0
5154,378,213,480,499,63,13,12,102,286,26,79,0,0
5155,374,205,475,485,63,13,12,101,280,27,79,0,0
5156,372,201,471,474,63,13,12,99,273,28,79,0,0
5157,374,199,470,466,63,13,12,96,267,29,79,0,0
5158,375,197,466,452,63,13,12,91,255,30,79,0,0
5159,371,193,461,445,63,13,12,90,252,31,79,0,0
5160,365,191,453,435,63,13,12,88,244,32,79,0,0
5161,359,189,445,428,63,13,12,86,239,33,79,0,0
5162,360,191,441,419,63,13,12,81,228,34,79,0,0
5163,361,177,442,407,63,13,12,81,230,35,79,0,0
5164,361,170,442,403,63,13,12,81,233,36,79,0,0
5165,361,173,439,396,63,13,12,78,223,37,79,0,0
5166,358,169,434,389,63,13,12,76,220,38,79,0,0
5167,359,165,435,386,63,13,12,76,221,39,79,0,0
5168,365,163,438,375,63,13,12,73,212,40,79,0,0
5169,369,162,440,367,63,13,12,71,205,41,79,0,0
5170,370,163,439,365,63,13,12,69,202,42,79,0,0
5171,370,158,438,359,63,13,12,68,201,43,79,0,0
5172,371,155,438,354,63,13,12,67,199,44,79,0,0
5173,374,157,438,350,63,13,12,64,193,45,79,0,0
5174,376,150,440,346,63,13,12,64,196,46,79,0,0
5175,377,153,438,339,63,13,12,61,186,47,79,0,0
5176,373,149,434,335,63,13,12,61,186,48,79,0,0
5177,371,147,430,331,63,13,12,59,184,49,79,0,0
5178,370,148,426,328,63,13,12,56,180,50,79,0,0
5179,369,149,423,322,63,13,12,54,173,51,79,0,0
5180,369,150,422,318,63,13,12,53,168,52,79,0,0
5181,366,165,414,314,63,13,12,48,149,53,79,0,0
5182,357,154,407,311,63,13,12,50,157,54,79,0,0
5183,353,151,401,306,63,13,12,48,155,55,79,0,0
5184,351,149,399,303,63,13,12,48,154,56,79,0,0
5185,348,146,396,300,63,13,12,48,154,57,79,0,0
5186,348,153,393,298,63,13,12,45,145,58,79,0,0
5187,346,159,388,294,63,13,12,42,135,59,79,0,0
5188,345,164,383,288,63,13,12,38,124,60,79,0,0
5189,342,167,379,286,63,13,12,37,119,61,79,0,0
5190,340,168,375,281,63,13,12,35,113,62,79,0,0
5191,338,170,373,279,63,13,12,35,109,63,79,0,0
5192,335,167,370,277,63,13,12,35,110,64,79,0,0
5193,333,161,369,276,63,13,12,36,115,65,79,0,0
5194,330,156,367,274,63,13,12,37,118,66,79,0,0
5195,329,155,366,272,63,13,12,37,117,67,79,0,0
5196,328,150,366,271,63,13,12,38,121,68,79,0,0
5197,327,149,365,271,63,13,12,38,122,69,79,0,0
5198,325,149,362,267,63,13,12,37,118,70,79,0,0
5199,322,144,359,264,63,13,12,37,120,71,79,0,0
5200,322,137,360,261,63,13,12,38,124,72,79,0,0
5201,322,131,361,258,63,13,12,39,127,73,79,0,0
5202,324,130,361,255,63,13,12,37,125,74,79,0,0
5203,324,135,360,253,63,13,12,36,118,75,79,0,0
5204,324,133,359,251,63,13,12,35,118,76,79,0,0
5205,324,127,360,251,63,13,12,36,124,77,79,0,0
5206,325,126,361,248,63,13,12,36,122,78,79,0,0
5207,327,126,362,246,63,13,12,35,120,79,79,1,0
5799,323,107,358,177,71,13,12,35,70,0,1,0,0
5800,325,106,360,178,71,13,12,35,72,1,1,0,0
553,547,139,584,264,1,13,13,37,125,0,0,0,0
554,510,140,565,251,2,13,13,55,111,0,10,0,0
555,494,142,548,251,2,13,13,54,109,1,10,0,0
556,472,132,532,255,2,13,13,60,123,2,10,0,0
557,452,138,510,257,2,13,13,58,119,3,10,0,0
558,433,134,492,258,2,13,13,59,124,4,10,0,0
559,411,137,468,255,2,13,13,57,118,5,10,0,0
560,390,134,447,253,2,13,13,57,119,6,10,0,0
561,371,131,428,254,2,13,13,57,123,7,10,0,0
562,348,130,405,252,2,13,13,57,122,8,10,0,0
563,332,135,383,248,2,13,13,51,113,9,10,0,0
564,313,135,364,248,2,13,13,51,113,10,10,0,0
812,296,317,332,677,3,13,13,36,360,0,0,0,0
813,299,283,452,702,4,13,13,153,419,0,233,0,1
814,327,284,482,708,4,13,13,155,424,1,233,0,0
815,360,281,517,713,4,13,13,157,432,2,233,0,0
816,421,289,588,746,4,13,13,167,457,3,233,0,0
817,473,294,643,762,4,13,13,170,468,4,233,0,0
818,548,304,720,776,4,13,13,172,472,5,233,0,0
819,588,317,768,810,4,13,13,180,493,6,233,0,0
820,656,324,846,839,4,13,13,190,515,7,233,0,0
821,688,341,896,893,4,13,13,208,552,8,233,0,0
822,709,347,918,905,4,13,13,209,558,9,233,0,0
823,736,351,947,911,4,13,13,211,560,10,233,0,0
824,735,350,943,913,4,13,13,208,563,11,233,0,0
825,739,345,942,911,4,13,13,203,566,12,233,0,0
826,750,336,939,869,4,13,13,189,533,13,233,0,0
827,760,329,938,833,4,13,13,178,504,14,233,0,0
828,767,323,937,805,4,13,13,170,482,15,233,0,0
829,766,306,931,761,4,13,13,165,455,16,233,0,0
830,749,288,915,737,4,13,13,166,449,17,233,0,0
831,728,276,882,690,4,13,13,154,414,18,233,0,0
832,705,267,854,665,4,13,13,149,398,19,233,0,0
833,698,260,840,637,4,13,13,142,377,20,233,0,0
834,682,246,819,612,4,13,13,137,366,21,233,0,0
835,664,242,797,603,4,13,13,133,361,22,233,0,0
836,646,234,770,576,4,13,13,124,342,23,233,0,0
837,634,233,749,554,4,13,13,115,321,24,233,0,0
838,623,226,735,541,4,13,13,112,315,25,233,0,0
839,612,218,718,519,4,13,13,106,301,26,233,0,0
840,596,212,701,509,4,13,13,105,297,27,233,0,0
841,580,204,683,493,4,13,13,103,289,28,233,0,0
842,574,200,674,479,4,13,13,100,279,29,233,0,0
843,569,198,666,469,4,13,13,97,271,30,233,0,0
844,564,191,656,452,4,13,13,92,261,31,233,0,0
845,553,188,645,446,4,13,13,92,258,32,233,0,0
846,545,185,633,431,4,13,13,88,246,33,233,0,0
847,539,183,624,423,4,13,13,85,240,34,233,0,0
848,537,183,620,416,4,13,13,83,233,35,233,0,0
849,532,181,611,401,4,13,13,79,220,36,233,0,0
850,519,176,598,398,4,13,13,79,222,37,233,0,0
851,510,170,588,389,4,13,13,78,219,38,233,0,0
852,504,168,579,380,4,13,13,75,212,39,233,0,0
853,500,166,576,378,4,13,13,76,212,40,233,0,0
854,498,164,570,368,4,13,13,72,204,41,233,0,0
855,491,163,563,362,4,13,13,72,199,42,233,0,0
856,487,157,560,358,4,13,13,73,201,43,233,0,0
857,483,152,556,352,4,13,13,73,200,44,233,0,0
858,484,152,554,345,4,13,13,70,193,45,233,0,0
859,485,151,553,338,4,13,13,68,187,46,233,0,0
860,486,150,552,334,4,13,13,66,184,47,233,0,0
861,484,150,548,329,4,13,13,64,179,48,233,0,0
862,485,148,548,323,4,13,13,63,175,49,233,0,0
863,486,149,548,320,4,13,13,62,171,50,233,0,0
864,489,147,549,312,4,13,13,60,165,51,233,0,0
865,491,147,551,310,4,13,13,60,163,52,233,0,0
866,492,145,550,304,4,13,13,58,159,53,233,0,0
867,493,143,551,299,4,13,13,58,156,54,233,0,0
868,493,144,550,297,4,13,13,57,153,55,233,0,0
869,493,142,551,295,4,13,13,58,153,56,233,0,0
870,494,141,551,292,4,13,13,57,151,57,233,0,0
871,493,141,550,292,4,13,13,57,151,58,233,0,0
872,496,140,549,283,4,13,13,53,143,59,233,0,0
873,498,141,550,280,4,13,13,52,139,60,233,0,0
874,502,142,554,281,4,13,13,52,139,61,233,0,0
875,507,139,559,281,4,13,13,52,142,62,233,0,0
876,511,139,562,279,4,13,13,51,140,63,233,0,0
877,515,140,564,277,4,13,13,49,137,64,233,0,0
878,519,141,565,271,4,13,13,46,130,65,233,0,0
879,521,140,568,273,4,13,13,47,133,66,233,0,0
880,525,142,572,276,4,13,13,47,134,67,233,0,0
881,527,141,575,278,4,13,13,48,137,68,233,0,0
882,528,139,578,280,4,13,13,50,141,69,233,0,0
883,528,138,579,280,4,13,13,51,142,70,233,0,0
884,528,138,579,281,4,13,13,51,143,71,233,0,0
885,528,138,579,280,4,13,13,51,142,72,233,0,0
886,528,141,577,279,4,13,13,49,138,73,233,0,0
887,527,145,575,279,4,13,13,48,134,74,233,0,0
888,527,143,575,276,4,13,13,48,133,75,233,0,0
889,527,143,575,277,4,13,13,48,134,76,233,0,0
890,527,145,574,279,4,13,13,47,134,77,233,0,0
891,526,144,574,279,4,13,13,48,135,78,233,0,0
892,527,143,575,279,4,13,13,48,136,79,233,0,0
893,526,143,575,280,4,13,13,49,137,80,233,0,0
894,526,143,575,280,4,13,13,49,137,81,233,0,0
895,527,143,575,280,4,13,13,48,137,82,233,0,0
896,527,145,574,279,4,13,13,47,134,83,233,0,0
897,527,146,573,279,4,13,13,46,133,84,233,0,0
898,527,147,573,278,4,13,13,46,131,85,233,0,0
899,527,147,573,278,4,13,13,46,131,86,233,0,0
900,527,148,573,277,4,13,13,46,129,87,233,0,0
901,527,144,574,277,4,13,13,47,133,88,233,0,0
902,527,143,574,277,4,13,13,47,134,89,233,0,0
903,527,143,574,278,4,13,13,47,135,90,233,0,0
904,527,142,574,277,4,13,13,47,135,91,233,0,0
905,527,142,574,277,4,13,13,47,135,92,233,0,0
906,528,142,574,275,4,13,13,46,133,93,233,0,0
907,529,142,574,275,4,13,13,45,133,94,233,0,0
908,529,142,574,274,4,13,13,45,132,95,233,0,0
909,529,142,574,274,4,13,13,45,132,96,233,0,0
910,529,142,574,274,4,13,13,45,132,97,233,0,0
911,527,143,573,278,4,13,13,46,135,98,233,0,0
912,526,143,573,279,4,13,13,47,136,99,233,0,0
913,526,143,573,279,4,13,13,47,136,100,233,0,0
914,526,143,573,280,4,13,13,47,137,101,233,0,0
915,526,144,573,280,4,13,13,47,136,102,233,0,0
916,527,147,572,278,4,13,13,45,131,103,233,0,0
917,527,148,572,277,4,13,13,45,129,104,233,0,0
918,527,149,572,277,4,13,13,45,128,105,233,0,0
919,527,149,572,276,4,13,13,45,127,106,233,0,0
920,527,149,572,276,4,13,13,45,127,107,233,0,0
921,526,147,572,278,4,13,13,46,131,108,233,0,0
922,526,147,573,278,4,13,13,47,131,109,233,0,0
923,526,147,573,278,4,13,13,47,131,110,233,0,0
924,526,147,573,279,4,13,13,47,132,111,233,0,0
925,526,147,573,279,4,13,13,47,132,112,233,0,0
926,527,144,574,278,4,13,13,47,134,113,233,0,0
927,527,143,575,278,4,13,13,48,135,114,233,0,0
928,527,143,575,278,4,13,13,48,135,115,233,0,0
929,527,142,575,278,4,13,13,48,136,116,233,0,0
930,528,144,574,277,4,13,13,46,133,117,233,0,0
931,526,142,574,280,4,13,13,48,138,118,233,0,0
932,526,142,574,281,4,13,13,48,139,119,233,0,0
933,526,141,574,281,4,13,13,48,140,120,233,0,0
934,526,141,574,282,4,13,13,48,141,121,233,0,0
935,526,141,574,282,4,13,13,48,141,122,233,0,0
936,527,147,572,278,4,13,13,45,131,123,233,0,0
937,527,149,572,277,4,13,13,45,128,124,233,0,0
938,527,149,572,277,4,13,13,45,128,125,233,0,0
939,527,150,572,276,4,13,13,45,126,126,233,0,0
940,527,150,572,276,4,13,13,45,126,127,233,0,0
941,528,145,574,278,4,13,13,46,133,128,233,0,0
942,528,143,575,278,4,13,13,47,135,129,233,0,0
943,528,143,575,278,4,13,13,47,135,130,233,0,0
944,528,142,575,278,4,13,13,47,136,131,233,0,0
945,528,141,574,276,4,13,13,46,135,132,233,0,0
946,528,141,573,274,4,13,13,45,133,133,233,0,0
947,528,141,573,274,4,13,13,45,133,134,233,0,0
948,528,141,573,273,4,13,13,45,132,135,233,0,0
949,528,141,574,277,4,13,13,46,136,136,233,0,0
950,527,142,573,277,4,13,13,46,135,137,233,0,0
951,528,142,573,275,4,13,13,45,133,138,233,0,0
952,528,145,572,276,4,13,13,44,131,139,233,0,0
953,528,142,573,275,4,13,13,45,133,140,233,0,0
954,527,145,572,276,4,13,13,45,131,141,233,0,0
955,527,146,572,276,4,13,13,45,130,142,233,0,0
956,527,142,573,278,4,13,13,46,136,143,233,0,0
957,526,140,574,278,4,13,13,48,138,144,233,0,0
958,527,140,574,279,4,13,13,47,139,145,233,0,0
959,527,140,575,279,4,13,13,48,139,146,233,0,0
960,527,140,575,279,4,13,13,48,139,147,233,0,0
961,526,140,574,278,4,13,13,48,138,148,233,0,0
962,526,144,572,277,4,13,13,46,133,149,233,0,0
963,526,140,574,279,4,13,13,48,139,150,233,0,0
964,528,143,574,276,4,13,13,46,133,151,233,0,0
965,528,145,575,278,4,13,13,47,133,152,233,0,0
966,527,146,575,279,4,13,13,48,133,153,233,0,0
967,525,146,574,281,4,13,13,49,135,154,233,0,0
968,522,143,573,281,4,13,13,51,138,155,233,0,0
969,518,140,570,282,4,13,13,52,142,156,233,0,0
970,512,141,563,280,4,13,13,51,139,157,233,0,0
971,506,141,557,281,4,13,13,51,140,158,233,0,0
972,501,141,551,279,4,13,13,50,138,159,233,0,0
973,493,140,543,277,4,13,13,50,137,160,233,0,0
974,483,138,535,277,4,13,13,52,139,161,233,0,0
975,476,138,526,277,4,13,13,50,139,162,233,0,0
976,466,137,516,277,4,13,13,50,140,163,233,0,0
977,456,136,507,279,4,13,13,51,143,164,233,0,0
978,446,140,496,279,4,13,13,50,139,165,233,0,0
979,431,141,483,284,4,13,13,52,143,166,233,0,0
980,425,141,477,281,4,13,13,52,140,167,233,0,0
981,418,140,472,283,4,13,13,54,143,168,233,0,0
982,414,142,469,288,4,13,13,55,146,169,233,0,0
983,410,143,466,291,4,13,13,56,148,170,233,0,0
984,409,143,468,296,4,13,13,59,153,171,233,0,0
985,407,143,467,298,4,13,13,60,155,172,233,0,0
986,405,143,466,301,4,13,13,61,158,173,233,0,0
987,405,143,468,307,4,13,13,63,164,174,233,0,0
988,410,143,472,306,4,13,13,62,163,175,233,0,0
989,415,146,478,312,4,13,13,63,166,176,233,0,0
990,417,146,481,316,4,13,13,64,170,177,233,0,0
991,419,146,484,321,4,13,13,65,175,178,233,0,0
992,422,146,490,329,4,13,13,68,183,179,233,0,0
993,428,149,495,333,4,13,13,67,184,180,233,0,0
994,439,149,506,335,4,13,13,67,186,181,233,0,0
995,447,152,514,344,4,13,13,67,192,182,233,0,0
996,454,154,521,347,4,13,13,67,193,183,233,0,0
997,460,155,528,353,4,13,13,68,198,184,233,0,0
998,468,158,536,358,4,13,13,68,200,185,233,0,0
999,477,156,546,361,4,13,13,69,205,186,233,0,0
1000,484,161,553,369,4,13,13,69,208,187,233,0,0
1001,487,162,556,373,4,13,13,69,211,188,233,0,0
1002,490,164,560,376,4,13,13,70,212,189,233,0,0
1003,493,169,564,385,4,13,13,71,216,190,233,0,0
1004,496,173,569,392,4,13,13,73,219,191,233,0,0
1005,498,174,571,396,4,13,13,73,222,192,233,0,0
1006,495,177,570,403,4,13,13,75,226,193,233,0,0
1007,490,175,568,408,4,13,13,78,233,194,233,0,0
1008,486,179,567,420,4,13,13,81,241,195,233,0,0
1009,485,184,568,430,4,13,13,83,246,196,233,0,0
1010,485,188,570,438,4,13,13,85,250,197,233,0,0
1011,482,192,568,448,4,13,13,86,256,198,233,0,0
1012,479,191,568,458,4,13,13,89,267,199,233,0,0
1013,478,193,572,474,4,13,13,94,281,200,233,0,0
1014,481,199,576,485,4,13,13,95,286,201,233,0,0
1015,485,202,582,493,4,13,13,97,291,202,233,0,0
1016,486,206,585,507,4,13,13,99,301,203,233,0,0
1017,484,205,587,517,4,13,13,103,312,204,233,0,0
1018,481,211,590,536,4,13,13,109,325,205,233,0,0
1019,480,219,593,558,4,13,13,113,339,206,233,0,0
1020,480,222,595,567,4,13,13,115,345,207,233,0,0
1021,477,228,594,585,4,13,13,117,357,208,233,0,0
1022,469,232,592,606,4,13,13,123,374,209,233,0,0
1023,456,232,587,628,4,13,13,131,396,210,233,0,0
1024,450,237,590,657,4,13,13,140,420,211,233,0,0
1025,458,235,603,673,4,13,13,145,438,212,233,0,0
1026,460,247,613,704,4,13,13,153,457,213,233,0,0
1027,460,264,617,734,4,13,13,157,470,214,233,0,0
1028,467,273,624,743,4,13,13,157,470,215,233,0,0
1029,482,282,653,785,4,13,13,171,503,216,233,0,0
1030,512,296,696,809,4,13,13,184,513,217,233,0,0
1031,534,311,739,862,4,13,13,205,551,218,233,0,0
1032,539,327,756,909,4,13,13,217,582,219,233,0,0
1033,556,337,774,933,4,13,13,218,596,220,233,0,0
1034,587,353,813,975,4,13,13,226,622,221,233,0,0
1035,622,376,853,1015,4,13,13,231,639,222,233,0,0
1036,668,398,902,1047,4,13,13,234,649,223,233,0,0
1037,715,424,950,1074,4,13,13,235,650,224,233,0,0
1038,770,440,1000,1072,4,13,13,230,632,225,233,0,0
1039,827,474,1050,1080,4,13,13,223,606,226,233,0,0
1040,918,520,1137,1080,4,13,13,219,560,227,233,0,0
1041,1029,563,1256,1077,4,13,13,227,514,228,233,0,0
1042,1083,616,1328,1079,4,13,13,245,463,229,233,0,0
1043,1181,678,1408,1077,4,13,13,227,399,230,233,0,0
1044,1302,730,1510,1079,4,13,13,208,349,231,233,0,0
1045,1438,807,1607,1071,4,13,13,169,264,232,233,0,0
1046,1520,849,1667,1079,4,13,13,147,230,233,233,1,0
1550,1723,793,1899,1071,7,13,13,176,278,0,0,0,0
1551,1533,736,1787,1067,8,13,13,254,331,0,50,0,1
1552,1412,675,1715,1069,8,13,13,303,394,1,50,0,0
1553,1303,635,1638,1073,8,13,13,335,438,2,50,0,0
1554,1206,580,1578,1068,8,13,13,372,488,3,50,0,0
1555,1118,526,1515,1051,8,13,13,397,525,4,50,0,0
1556,1032,483,1449,1049,8,13,13,417,566,5,50,0,0
1557,953,441,1372,1026,8,13,13,419,585,6,50,0,0
1558,893,404,1294,980,8,13,13,401,576,7,50,0,0
1559,857,387,1215,918,8,13,13,358,531,8,50,0,0
1560,834,355,1173,874,8,13,13,339,519,9,50,0,0
1561,805,329,1116,824,8,13,13,311,495,10,50,0,0
1562,768,309,1053,777,8,13,13,285,468,11,50,0,0
1563,733,296,999,748,8,13,13,266,452,12,50,0,0
1564,717,274,954,693,8,13,13,237,419,13,50,0,0
1565,703,264,925,669,8,13,13,222,405,14,50,0,0
1566,681,251,885,637,8,13,13,204,386,15,50,0,0
1567,655,229,847,606,8,13,13,192,377,16,50,0,0
1568,636,224,817,588,8,13,13,181,364,17,50,0,0
1569,623,218,784,553,8,13,13,161,335,18,50,0,0
1570,610,216,761,538,8,13,13,151,322,19,50,0,0
1571,598,209,738,515,8,13,13,140,306,20,50,0,0
1572,587,202,722,505,8,13,13,135,303,21,50,0,0
1573,580,202,700,473,8,13,13,120,271,22,50,0,0
1574,572,191,690,462,8,13,13,118,271,23,50,0,0
1575,568,190,677,448,8,13,13,109,258,24,50,0,0
1576,565,186,665,426,8,13,13,100,240,25,50,0,0
1577,560,182,655,417,8,13,13,95,235,26,50,0,0
1578,553,181,642,402,8,13,13,89,221,27,50,0,0
1579,549,175,637,395,8,13,13,88,220,28,50,0,0
1580,548,172,634,392,8,13,13,86,220,29,50,0,0
1581,542,171,623,379,8,13,13,81,208,30,50,0,0
1582,536,167,614,372,8,13,13,78,205,31,50,0,0
1583,531,166,605,363,8,13,13,74,197,32,50,0,0
1584,528,157,602,357,8,13,13,74,200,33,50,0,0
1585,529,158,598,349,8,13,13,69,191,34,50,0,0
1586,525,153,592,339,8,13,13,67,186,35,50,0,0
1587,518,148,585,334,8,13,13,67,186,36,50,0,0
1588,513,149,578,328,8,13,13,65,179,37,50,0,0
1589,512,147,574,318,8,13,13,62,171,38,50,0,0
1590,512,147,572,313,8,13,13,60,166,39,50,0,0
1591,508,145,567,303,8,13,13,59,158,40,50,0,0
1592,501,145,558,300,8,13,13,57,155,41,50,0,0
1593,494,144,551,298,8,13,13,57,154,42,50,0,0
1594,491,139,547,292,8,13,13,56,153,43,50,0,0
1595,489,138,545,291,8,13,13,56,153,44,50,0,0
1596,487,135,543,287,8,13,13,56,152,45,50,0,0
1597,486,135,541,284,8,13,13,55,149,46,50,0,0
1598,486,134,541,278,8,13,13,55,144,47,50,0,0
1599,491,132,545,275,8,13,13,54,143,48,50,0,0
1600,498,133,552,274,8,13,13,54,141,49,50,0,0
1601,497,131,550,269,8,13,13,53,138,50,50,1,0
1619,514,144,563,276,8,13,13,49,132,0,50,0,0
1620,519,145,569,278,8,13,13,50,133,1,50,0,0
1621,527,143,579,277,8,13,13,52,134,2,50,0,0
1622,529,144,582,278,8,13,13,53,134,3,50,0,0
1623,534,148,588,281,8,13,13,54,133,4,50,0,0
1624,537,149,590,281,8,13,13,53,132,5,50,0,0
1625,547,126,610,282,8,13,13,63,156,6,50,0,0
1626,550,124,614,282,8,13,13,64,158,7,50,0,0
1617,518,147,572,260,10,13,13,54,113,0,3,0,0
1618,518,150,568,254,10,13,13,50,104,1,3,0,0
1619,527,149,585,271,10,13,13,58,122,2,3,0,0
1620,531,149,592,278,10,13,13,61,129,3,3,0,0
1622,556,146,608,257,10,13,13,52,111,0,3,0,0
1623,564,145,615,257,10,13,13,51,112,1,3,0,0
1658,529,138,587,284,11,13,13,58,146,0,12,0,0
1659,519,141,575,283,11,13,13,56,142,1,12,0,0
1660,502,136,558,277,11,13,13,56,141,2,12,0,0
1661,477,134,536,283,11,13,13,59,149,3,12,0,0
1662,460,136,517,281,11,13,13,57,145,4,12,0,0
1663,438,133,494,277,11,13,13,56,144,5,12,0,0
1664,416,130,475,279,11,13,13,59,149,6,12,0,0
1665,399,130,454,271,11,13,13,55,141,7,12,0,0
1666,383,132,436,267,11,13,13,53,135,8,12,0,0
1667,367,132,419,265,11,13,13,52,133,9,12,0,0
1668,349,129,398,256,11,13,13,49,127,10,12,0,0
1669,336,128,381,248,11,13,13,45,120,11,12,0,0
1670,319,128,363,244,11,13,13,44,116,12,12,0,0
1904,470,162,528,256,13,13,13,58,94,0,8,0,0
1905,449,140,521,258,13,13,13,72,118,1,8,0,0
1906,426,129,504,258,13,13,13,78,129,2,8,0,0
1907,405,134,480,258,13,13,13,75,124,3,8,0,0
1908,382,132,455,257,13,13,13,73,125,4,8,0,0
1909,357,131,429,255,13,13,13,72,124,5,8,0,0
1910,333,128,404,255,13,13,13,71,127,6,8,0,0
1911,320,137,383,253,13,13,13,63,116,7,8,0,0
1912,301,135,365,253,13,13,13,64,118,8,8,0,0
2129,548,136,585,266,14,13,13,37,130,0,0,0,0
2130,523,142,564,228,15,13,13,41,86,0,0,0,0
2131,486,143,538,244,16,13,13,52,101,0,8,0,0
2132,468,141,523,248,16,13,13,55,107,1,8,0,0
2133,445,140,501,250,16,13,13,56,110,2,8,0,0
2134,419,135,477,251,16,13,13,58,116,3,8,0,0
2135,397,132,455,248,16,13,13,58,116,4,8,0,0
2136,372,133,429,246,16,13,13,57,113,5,8,0,0
2137,351,134,405,244,16,13,13,54,110,6,8,0,0
2138,330,130,384,245,16,13,13,54,115,7,8,0,0
2139,310,129,365,245,16,13,13,55,116,8,8,0,0
2574,511,155,552,247,17,13,13,41,92,0,0,0,0
2575,482,143,528,248,18,13,13,46,105,0,6,0,0
2576,463,143,508,246,18,13,13,45,103,1,6,0,0
2577,439,144,486,251,18,13,13,47,107,2,6,0,0
2578,417,142,464,250,18,13,13,47,108,3,6,0,0
2579,390,137,438,249,18,13,13,48,112,4,6,0,0
2580,370,139,416,246,18,13,13,46,107,5,6,0,0
2581,351,138,397,245,18,13,13,46,107,6,6,0,0
3549,533,134,577,273,20,13,13,44,139,0,10,0,0
3550,521,137,559,257,20,13,13,38,120,1,10,0,0
3551,504,137,540,253,20,13,13,36,116,2,10,0,0
3553,472,134,511,257,20,13,13,39,123,0,10,0,0
3554,455,140,495,264,20,13,13,40,124,1,10,0,0
3555,441,141,481,266,20,13,13,40,125,2,10,0,0
3556,421,143,460,262,20,13,13,39,119,3,10,0,0
3557,406,141,447,264,20,13,13,41,123,4,10,0,0
3558,392,137,431,257,20,13,13,39,120,5,10,0,0
3559,373,137,412,257,20,13,13,39,120,6,10,0,0
3560,353,136,394,258,20,13,13,41,122,7,10,0,0
3561,338,133,378,256,20,13,13,40,123,8,10,0,0
3562,330,138,367,256,20,13,13,37,118,9,10,0,0
3563,314,138,352,255,20,13,13,38,117,10,10,0,0
3554,536,139,575,263,23,13,13,39,124,0,0,0,0
3561,242,463,833,1068,24,13,13,591,605,0,3,0,0
3562,237,434,807,1043,24,13,13,570,609,1,3,0,0
3563,208,417,767,1036,24,13,13,559,619,2,3,0,0
3564,165,377,758,1034,24,13,13,593,657,3,3,0,0
3555,515,144,552,243,25,13,13,37,99,0,13,0,0
3556,497,137,538,246,25,13,13,41,109,1,13,0,0
3557,484,150,521,250,25,13,13,37,100,2,13,0,0
3558,467,148,505,249,25,13,13,38,101,3,13,0,0
3559,452,148,489,250,25,13,13,37,102,4,13,0,0
3560,436,143,476,252,25,13,13,40,109,5,13,0,0
3561,419,142,459,251,25,13,13,40,109,6,13,0,0
3562,408,138,448,249,25,13,13,40,111,7,13,0,0
3563,392,135,432,249,25,13,13,40,114,8,13,0,0
3564,377,137,418,249,25,13,13,41,112,9,13,0,0
3565,362,138,400,247,25,13,13,38,109,10,13,0,0
3566,346,137,385,249,25,13,13,39,112,11,13,0,0
3567,333,136,371,244,25,13,13,38,108,12,13,0,0
3568,319,136,357,244,25,13,13,38,108,13,13,0,0
3558,1020,694,1395,1070,27,13,13,375,376,0,104,0,1
3559,902,621,1340,1065,27,13,13,438,444,1,104,0,0
3560,807,574,1281,1063,27,13,13,474,489,2,104,0,0
3561,712,526,1217,1060,27,13,13,505,534,3,104,0,0
3562,655,483,1187,1061,27,13,13,532,578,4,104,0,0
3563,598,461,1137,1066,27,13,13,539,605,5,104,0,0
3564,545,441,1083,1070,27,13,13,538,629,6,104,0,0
3565,496,414,1032,1067,27,13,13,536,653,7,104,0,0
3566,466,403,987,1066,27,13,13,521,663,8,104,0,0
3567,442,392,942,1060,27,13,13,500,668,9,104,0,0
3568,423,380,906,1054,27,13,13,483,674,10,104,0,0
3569,424,377,875,1034,27,13,13,451,657,11,104,0,0
3570,417,378,838,1020,27,13,13,421,642,12,104,0,0
3571,411,371,817,1019,27,13,13,406,648,13,104,0,0
3572,414,363,802,1016,27,13,13,388,653,14,104,0,0
3573,420,354,792,1013,27,13,13,372,659,15,104,0,0
3574,429,344,785,1009,27,13,13,356,665,16,104,0,0
3575,439,330,776,987,27,13,13,337,657,17,104,0,0
3576,455,326,768,956,27,13,13,313,630,18,104,0,0
3577,463,325,759,938,27,13,13,296,613,19,104,0,0
3578,466,324,751,930,27,13,13,285,606,20,104,0,0
3579,471,323,747,928,27,13,13,276,605,21,104,0,0
3580,478,326,743,924,27,13,13,265,598,22,104,0,0
3581,480,325,741,929,27,13,13,261,604,23,104,0,0
3582,486,326,741,936,27,13,13,255,610,24,104,0,0
3583,495,330,744,953,27,13,13,249,623,25,104,0,0
3584,497,328,743,968,27,13,13,246,640,26,104,0,0
3585,500,324,741,973,27,13,13,241,649,27,104,0,0
3586,502,334,734,977,27,13,13,232,643,28,104,0,0
3587,509,335,737,983,27,13,13,228,648,29,104,0,0
3588,514,340,736,986,27,13,13,222,646,30,104,0,0
3589,517,346,733,985,27,13,13,216,639,31,104,0,0
3590,521,345,735,987,27,13,13,214,642,32,104,0,0
3591,541,353,747,986,27,13,13,206,633,33,104,0,0
3592,546,352,749,984,27,13,13,203,632,34,104,0,0
3593,546,349,747,984,27,13,13,201,635,35,104,0,0
3594,549,350,748,983,27,13,13,199,633,36,104,0,0
3595,555,353,754,986,27,13,13,199,633,37,104,0,0
3596,558,353,756,990,27,13,13,198,637,38,104,0,0
3597,566,347,764,988,27,13,13,198,641,39,104,0,0
3598,577,347,772,983,27,13,13,195,636,40,104,0,0
3599,585,346,778,980,27,13,13,193,634,41,104,0,0
3600,591,340,782,969,27,13,13,191,629,42,104,0,0
3601,596,337,784,954,27,13,13,188,617,43,104,0,0
3602,595,337,783,949,27,13,13,188,612,44,104,0,0
3603,595,337,783,947,27,13,13,188,610,45,104,0,0
3604,593,338,782,949,27,13,13,189,611,46,104,0,0
3605,594,342,781,945,27,13,13,187,603,47,104,0,0
3606,597,344,782,946,27,13,13,185,602,48,104,0,0
3607,597,345,782,947,27,13,13,185,602,49,104,0,0
3608,597,345,782,947,27,13,13,185,602,50,104,0,0
3609,598,343,784,949,27,13,13,186,606,51,104,0,0
3610,599,341,786,950,27,13,13,187,609,52,104,0,0
3611,596,339,786,950,27,13,13,190,611,53,104,0,0
3612,601,339,790,948,27,13,13,189,609,54,104,0,0
3613,605,338,795,948,27,13,13,190,610,55,104,0,0
3614,607,337,798,948,27,13,13,191,611,56,104,0,0
3615,605,334,796,946,27,13,13,191,612,57,104,0,0
3616,605,339,794,946,27,13,13,189,607,58,104,0,0
3617,602,338,792,947,27,13,13,190,609,59,104,0,0
3618,604,337,793,946,27,13,13,189,609,60,104,0,0
3619,608,342,793,939,27,13,13,185,597,61,104,0,0
3620,609,342,794,940,27,13,13,185,598,62,104,0,0
3621,609,341,795,944,27,13,13,186,603,63,104,0,0
3622,608,339,795,946,27,13,13,187,607,64,104,0,0
3623,607,338,794,948,27,13,13,187,610,65,104,0,0
3624,606,337,793,948,27,13,13,187,611,66,104,0,0
3625,606,337,792,948,27,13,13,186,611,67,104,0,0
3626,603,341,788,948,27,13,13,185,607,68,104,0,0
3627,602,342,787,948,27,13,13,185,606,69,104,0,0
3628,605,341,789,946,27,13,13,184,605,70,104,0,0
3629,604,342,789,944,27,13,13,185,602,71,104,0,0
3630,609,341,793,942,27,13,13,184,601,72,104,0,0
3631,606,341,791,942,27,13,13,185,601,73,104,0,0
3632,602,341,788,943,27,13,13,186,602,74,104,0,0
3633,596,341,785,946,27,13,13,189,605,75,104,0,0
3634,595,341,785,946,27,13,13,190,605,76,104,0,0
3635,596,341,788,948,27,13,13,192,607,77,104,0,0
3636,603,343,797,956,27,13,13,194,613,78,104,0,0
3637,613,345,810,972,27,13,13,197,627,79,104,0,0
3638,630,350,825,982,27,13,13,195,632,80,104,0,0
3639,651,361,841,983,27,13,13,190,622,81,104,0,0
3640,675,368,862,986,27,13,13,187,618,82,104,0,0
3641,692,377,875,983,27,13,13,183,606,83,104,0,0
3642,700,379,884,983,27,13,13,184,604,84,104,0,0
3643,677,373,870,987,27,13,13,193,614,85,104,0,0
3644,665,369,867,987,27,13,13,202,618,86,104,0,0
3645,662,368,870,987,27,13,13,208,619,87,104,0,0
3646,672,368,883,987,27,13,13,211,619,88,104,0,0
3647,669,365,885,985,27,13,13,216,620,89,104,0,0
3648,670,362,889,987,27,13,13,219,625,90,104,0,0
3649,692,365,908,995,27,13,13,216,630,91,104,0,0
3650,694,368,911,1014,27,13,13,217,646,92,104,0,0
3651,691,380,904,1029,27,13,13,213,649,93,104,0,0
3652,689,385,896,1030,27,13,13,207,645,94,104,0,0
3653,678,392,883,1038,27,13,13,205,646,95,104,0,0
3654,654,399,856,1038,27,13,13,202,639,96,104,0,0
3655,599,399,810,1048,27,13,13,211,649,97,104,0,0
3656,567,410,785,1057,27,13,13,218,647,98,104,0,0
3657,508,418,729,1069,27,13,13,221,651,99,104,0,0
3658,429,414,652,1077,27,13,13,223,663,100,104,0,0
3659,368,416,596,1079,27,13,13,228,663,101,104,0,0
3660,292,411,524,1073,27,13,13,232,662,102,104,0,0
3661,233,468,438,1074,27,13,13,205,606,103,104,0,0
3662,199,476,402,1079,27,13,13,203,603,104,104,1,0
3564,387,415,583,937,28,13,13,196,522,0,65,0,1
3565,378,406,571,919,28,13,13,193,513,1,65,0,0
3566,344,394,542,919,28,13,13,198,525,2,65,0,0
3567,332,375,529,897,28,13,13,197,522,3,65,0,0
3568,331,362,518,852,28,13,13,187,490,4,65,0,0
3569,358,354,536,824,28,13,13,178,470,5,65,0,0
3570,361,345,530,794,28,13,13,169,449,6,65,0,0
3571,329,335,499,780,28,13,13,170,445,7,65,0,0
3572,338,326,506,774,28,13,13,168,448,8,65,0,0
3573,351,325,512,763,28,13,13,161,438,9,65,0,0
3574,357,326,514,758,28,13,13,157,432,10,65,0,0
3575,369,324,520,745,28,13,13,151,421,11,65,0,0
3576,391,327,533,726,28,13,13,142,399,12,65,0,0
3577,414,329,555,728,28,13,13,141,399,13,65,0,0
3578,438,329,575,717,28,13,13,137,388,14,65,0,0
3579,455,331,595,728,28,13,13,140,397,15,65,0,0
3580,466,330,606,735,28,13,13,140,405,16,65,0,0
3581,469,331,611,743,28,13,13,142,412,17,65,0,0
3582,463,328,610,759,28,13,13,147,431,18,65,0,0
3583,462,330,616,785,28,13,13,154,455,19,65,0,0
3584,471,335,619,779,28,13,13,148,444,20,65,0,0
3585,483,336,627,773,28,13,13,144,437,21,65,0,0
3586,490,335,634,772,28,13,13,144,437,22,65,0,0
3587,505,367,636,771,28,13,13,131,404,23,65,0,0
3588,512,370,642,770,28,13,13,130,400,24,65,0,0
3591,509,347,652,793,28,13,13,143,446,0,65,0,1
3592,513,343,656,792,28,13,13,143,449,1,65,0,0
3593,518,346,656,783,28,13,13,138,437,2,65,0,0
3594,522,347,654,764,28,13,13,132,417,3,65,0,0
3595,522,348,655,773,28,13,13,133,425,4,65,0,0
3596,525,348,660,788,28,13,13,135,440,5,65,0,0
3597,524,355,661,802,28,13,13,137,447,6,65,0,0
3598,529,353,667,802,28,13,13,138,449,7,65,0,0
3599,528,349,673,816,28,13,13,145,467,8,65,0,0
3600,528,346,674,811,28,13,13,146,465,9,65,0,0
3601,530,345,675,798,28,13,13,145,453,10,65,0,0
3602,529,346,673,791,28,13,13,144,445,11,65,0,0
3603,529,346,674,789,28,13,13,145,443,12,65,0,0
3604,527,345,675,790,28,13,13,148,445,13,65,0,0
3605,527,345,677,790,28,13,13,150,445,14,65,0,0
3606,528,342,682,795,28,13,13,154,453,15,65,0,0
3607,528,342,685,798,28,13,13,157,456,16,65,0,0
3608,529,342,687,799,28,13,13,158,457,17,65,0,0
3609,529,342,688,798,28,13,13,159,456,18,65,0,0
3610,528,341,688,795,28,13,13,160,454,19,65,0,0
3611,532,343,687,781,28,13,13,155,438,20,65,0,0
3612,529,343,690,794,28,13,13,161,451,21,65,0,0
3613,528,344,691,797,28,13,13,163,453,22,65,0,0
3614,528,344,693,801,28,13,13,165,457,23,65,0,0
3615,528,346,694,804,28,13,13,166,458,24,65,0,0
3616,527,344,692,796,28,13,13,165,452,25,65,0,0
3617,526,348,691,798,28,13,13,165,450,26,65,0,0
3618,526,345,690,792,28,13,13,164,447,27,65,0,0
3619,526,344,690,791,28,13,13,164,447,28,65,0,0
3620,526,346,693,800,28,13,13,167,454,29,65,0,0
3621,527,344,694,795,28,13,13,167,451,30,65,0,0
3622,527,344,695,792,28,13,13,168,448,31,65,0,0
3623,526,344,695,794,28,13,13,169,450,32,65,0,0
3624,526,344,696,793,28,13,13,170,449,33,65,0,0
3625,525,344,696,795,28,13,13,171,451,34,65,0,0
3626,525,346,698,802,28,13,13,173,456,35,65,0,0
3627,525,346,697,801,28,13,13,172,455,36,65,0,0
3628,525,346,700,805,28,13,13,175,459,37,65,0,0
3629,524,346,698,804,28,13,13,174,458,38,65,0,0
3630,523,345,700,807,28,13,13,177,462,39,65,0,0
3631,523,344,697,799,28,13,13,174,455,40,65,0,0
3632,521,342,695,798,28,13,13,174,456,41,65,0,0
3633,519,346,689,789,28,13,13,170,443,42,65,0,0
3634,519,350,689,794,28,13,13,170,444,43,65,0,0
3635,519,350,688,791,28,13,13,169,441,44,65,0,0
3636,523,347,694,794,28,13,13,171,447,45,65,0,0
3637,523,346,695,790,28,13,13,172,444,46,65,0,0
3638,524,346,698,795,28,13,13,174,449,47,65,0,0
3639,527,343,703,797,28,13,13,176,454,48,65,0,0
3640,528,342,705,793,28,13,13,177,451,49,65,0,0
3641,530,344,705,788,28,13,13,175,444,50,65,0,0
3642,529,344,705,786,28,13,13,176,442,51,65,0,0
3643,528,346,704,787,28,13,13,176,441,52,65,0,0
3644,527,347,703,786,28,13,13,176,439,53,65,0,0
3645,526,347,702,788,28,13,13,176,441,54,65,0,0
3646,530,349,710,800,28,13,13,180,451,55,65,0,0
3647,531,352,714,812,28,13,13,183,460,56,65,0,0
3648,532,358,713,817,28,13,13,181,459,57,65,0,0
3649,527,358,711,824,28,13,13,184,466,58,65,0,0
3650,516,364,703,834,28,13,13,187,470,59,65,0,0
3651,506,371,692,839,28,13,13,186,468,60,65,0,0
3652,500,378,687,853,28,13,13,187,475,61,65,0,0
3653,495,383,684,871,28,13,13,189,488,62,65,0,0
3654,506,387,694,881,28,13,13,188,494,63,65,0,0
3655,517,397,686,850,28,13,13,169,453,64,65,0,0
3656,516,401,686,853,28,13,13,170,452,65,65,1,0
3658,513,415,691,905,28,13,13,178,490,0,65,0,0
3659,486,419,669,925,28,13,13,183,506,1,65,0,0
3660,445,427,632,957,28,13,13,187,530,2,65,0,0
3661,400,442,595,999,28,13,13,195,557,3,65,0,0
3662,357,446,553,1013,28,13,13,196,567,4,65,0,0
3663,317,454,517,1037,28,13,13,200,583,5,65,0,0
3664,280,472,478,1043,28,13,13,198,571,6,65,0,0
3665,263,513,448,1042,28,13,13,185,529,7,65,0,0
3666,245,524,430,1055,28,13,13,185,531,8,65,0,0
3565,376,394,525,594,29,13,13,149,200,0,0,0,0
3574,470,142,513,258,30,13,13,43,116,0,4,0,0
3575,463,142,502,248,30,13,13,39,106,1,4,0,0
3576,445,143,486,254,30,13,13,41,111,2,4,0,0
3577,437,144,477,255,30,13,13,40,111,3,4,0,0
3579,400,143,440,252,30,13,13,40,109,0,4,0,0
3580,385,140,423,247,30,13,13,38,107,1,4,0,0
3581,372,139,410,245,30,13,13,38,106,2,4,0,0
3582,353,139,391,246,30,13,13,38,107,3,4,0,0
3583,339,138,376,245,30,13,13,37,107,4,4,0,0
3657,589,412,691,697,31,13,13,102,285,0,0,0,0
3821,548,136,583,272,32,13,13,35,136,0,0,0,0
3822,514,136,565,251,33,13,13,51,115,0,11,0,0
3823,498,139,546,249,33,13,13,48,110,1,11,0,0
3824,486,136,535,248,33,13,13,49,112,2,11,0,0
3825,461,136,512,251,33,13,13,51,115,3,11,0,0
3826,447,133,499,251,33,13,13,52,118,4,11,0,0
3827,425,129,479,252,33,13,13,54,123,5,11,0,0
3828,404,128,460,253,33,13,13,56,125,6,11,0,0
3829,385,129,440,253,33,13,13,55,124,7,11,0,0
3830,362,127,417,253,33,13,13,55,126,8,11,0,0
3831,348,130,400,249,33,13,13,52,119,9,11,0,0
3832,333,127,385,250,33,13,13,52,123,10,11,0,0
3833,316,126,369,250,33,13,13,53,124,11,11,0,0
4859,1083,716,1401,1078,35,13,13,318,362,0,65,0,1
4860,999,689,1336,1074,35,13,13,337,385,1,65,0,0
4861,900,622,1292,1074,35,13,13,392,452,2,65,0,0
4862,801,558,1236,1067,35,13,13,435,509,3,65,0,0
4863,722,521,1183,1070,35,13,13,461,549,4,65,0,0
4864,668,480,1149,1071,35,13,13,481,591,5,65,0,0
4865,621,437,1120,1071,35,13,13,499,634,6,65,0,0
4866,599,417,1086,1061,35,13,13,487,644,7,65,0,0
4867,587,388,1031,997,35,13,13,444,609,8,65,0,0
4868,571,381,974,954,35,13,13,403,573,9,65,0,0
4869,537,351,921,917,35,13,13,384,566,10,65,0,0
4870,528,330,875,860,35,13,13,347,530,11,65,0,0
4871,522,320,845,837,35,13,13,323,517,12,65,0,0
4872,523,304,807,777,35,13,13,284,473,13,65,0,0
4873,512,290,778,749,35,13,13,266,459,14,65,0,0
4874,503,283,752,729,35,13,13,249,446,15,65,0,0
4875,496,270,723,691,35,13,13,227,421,16,65,0,0
4876,488,261,702,674,35,13,13,214,413,17,65,0,0
4877,494,257,685,639,35,13,13,191,382,18,65,0,0
4878,493,245,672,615,35,13,13,179,370,19,65,0,0
4879,489,238,662,604,35,13,13,173,366,20,65,0,0
4880,483,230,643,579,35,13,13,160,349,21,65,0,0
4881,479,220,631,564,35,13,13,152,344,22,65,0,0
4882,478,219,624,556,35,13,13,146,337,23,65,0,0
4883,477,211,616,536,35,13,13,139,325,24,65,0,0
4884,474,208,606,520,35,13,13,132,312,25,65,0,0
4885,473,207,597,503,35,13,13,124,296,26,65,0,0
4886,470,203,590,491,35,13,13,120,288,27,65,0,0
4887,476,203,591,485,35,13,13,115,282,28,65,0,0
4888,484,200,591,467,35,13,13,107,267,29,65,0,0
4889,484,196,589,456,35,13,13,105,260,30,65,0,0
4890,486,194,586,447,35,13,13,100,253,31,65,0,0
4891,482,192,580,436,35,13,13,98,244,32,65,0,0
4892,486,192,579,424,35,13,13,93,232,33,65,0,0
4893,494,192,583,416,35,13,13,89,224,34,65,0,0
4894,496,188,582,405,35,13,13,86,217,35,65,0,0
4895,495,184,579,399,35,13,13,84,215,36,65,0,0
4896,486,177,572,394,35,13,13,86,217,37,65,0,0
4897,484,174,567,383,35,13,13,83,209,38,65,0,0
4898,483,172,566,382,35,13,13,83,210,39,65,0,0
4899,481,169,561,375,35,13,13,80,206,40,65,0,0
4900,475,167,554,370,35,13,13,79,203,41,65,0,0
4901,472,167,550,367,35,13,13,78,200,42,65,0,0
4902,467,162,543,358,35,13,13,76,196,43,65,0,0
4903,468,161,542,353,35,13,13,74,192,44,65,0,0
4904,472,160,545,350,35,13,13,73,190,45,65,0,0
4905,474,155,545,343,35,13,13,71,188,46,65,0,0
4906,479,155,548,338,35,13,13,69,183,47,65,0,0
4907,477,153,547,339,35,13,13,70,186,48,65,0,0
4908,477,152,546,335,35,13,13,69,183,49,65,0,0
4909,485,152,549,325,35,13,13,64,173,50,65,0,0
4910,490,150,553,319,35,13,13,63,169,51,65,0,0
4911,495,148,556,315,35,13,13,61,167,52,65,0,0
4912,499,149,558,312,35,13,13,59,163,53,65,0,0
4913,499,147,556,305,35,13,13,57,158,54,65,0,0
4914,504,150,559,302,35,13,13,55,152,55,65,0,0
4915,510,148,564,298,35,13,13,54,150,56,65,0,0
4916,516,147,569,295,35,13,13,53,148,57,65,0,0
4917,521,147,574,293,35,13,13,53,146,58,65,0,0
4918,525,148,577,291,35,13,13,52,143,59,65,0,0
4919,532,148,582,288,35,13,13,50,140,60,65,0,0
4920,537,151,585,287,35,13,13,48,136,61,65,0,0
4921,545,151,594,287,35,13,13,49,136,62,65,0,0
4922,557,143,608,286,35,13,13,51,143,63,65,0,0
4923,559,136,613,287,35,13,13,54,151,64,65,0,0
4924,564,134,618,285,35,13,13,54,151,65,65,1,0
5099,295,450,351,659,38,13,13,56,209,0,0,0,0
5100,283,291,427,736,39,13,13,144,445,0,23,0,1
5101,294,290,439,738,39,13,13,145,448,1,23,0,0
5102,312,290,459,744,39,13,13,147,454,2,23,0,0
5103,351,298,509,785,39,13,13,158,487,3,23,0,0
5104,388,311,548,799,39,13,13,160,488,4,23,0,0
5105,421,314,580,799,39,13,13,159,485,5,23,0,0
5106,470,322,636,818,39,13,13,166,496,6,23,0,0
5107,502,326,676,839,39,13,13,174,513,7,23,0,0
5108,545,331,730,872,39,13,13,185,541,8,23,0,0
5109,583,351,781,926,39,13,13,198,575,9,23,0,0
5110,613,383,811,951,39,13,13,198,568,10,23,0,0
5111,648,396,850,973,39,13,13,202,577,11,23,0,0
5112,685,413,902,1025,39,13,13,217,612,12,23,0,0
5113,746,428,967,1046,39,13,13,221,618,13,23,0,0
5114,813,459,1037,1070,39,13,13,224,611,14,23,0,0
5115,869,494,1089,1079,39,13,13,220,585,15,23,0,0
5116,927,516,1145,1080,39,13,13,218,564,16,23,0,0
5117,1000,560,1208,1080,39,13,13,208,520,17,23,0,0
5118,1110,609,1308,1080,39,13,13,198,471,18,23,0,0
5119,1208,655,1401,1080,39,13,13,193,425,19,23,0,0
5120,1311,722,1491,1080,39,13,13,180,358,20,23,0,0
5121,1429,771,1602,1079,39,13,13,173,308,21,23,0,0
5122,1562,824,1722,1078,39,13,13,160,254,22,23,0,0
5123,1657,863,1797,1080,39,13,13,140,217,23,23,1,0
5112,572,133,608,283,40,13,13,36,150,0,0,0,0
5113,546,145,590,282,41,13,13,44,137,0,49,0,1
5114,536,151,578,282,41,13,13,42,131,1,49,0,0
5115,529,145,574,284,41,13,13,45,139,2,49,0,0
5116,520,142,567,283,41,13,13,47,141,3,49,0,0
5117,518,143,561,273,41,13,13,43,130,4,49,0,0
5118,514,142,558,273,41,13,13,44,131,5,49,0,0
5119,515,143,558,273,41,13,13,43,130,6,49,0,0
5120,516,145,556,267,41,13,13,40,122,7,49,0,0
5121,517,145,556,265,41,13,13,39,120,8,49,0,0
5122,519,143,558,264,41,13,13,39,121,9,49,0,0
5123,524,139,566,265,41,13,13,42,126,10,49,0,0
5124,526,138,569,265,41,13,13,43,127,11,49,0,0
5125,527,138,568,261,41,13,13,41,123,12,49,0,0
5126,526,137,569,264,41,13,13,43,127,13,49,0,0
5127,526,138,570,266,41,13,13,44,128,14,49,0,0
5128,527,137,571,266,41,13,13,44,129,15,49,0,0
5129,527,137,572,266,41,13,13,45,129,16,49,0,0
5130,527,138,572,266,41,13,13,45,128,17,49,0,0
5131,522,141,566,266,41,13,13,44,125,18,49,0,0
5132,520,143,562,267,41,13,13,42,124,19,49,0,0
5133,520,144,562,267,41,13,13,42,123,20,49,0,0
5134,518,144,560,267,41,13,13,42,123,21,49,0,0
5135,524,141,567,265,41,13,13,43,124,22,49,0,0
5136,525,136,569,263,41,13,13,44,127,23,49,0,0
5137,526,134,572,264,41,13,13,46,130,24,49,0,0
5138,526,134,574,265,41,13,13,48,131,25,49,0,0
5139,526,134,575,267,41,13,13,49,133,26,49,0,0
5140,526,135,575,267,41,13,13,49,132,27,49,0,0
5141,525,135,574,267,41,13,13,49,132,28,49,0,0
5142,525,135,575,267,41,13,13,50,132,29,49,0,0
5143,524,134,575,267,41,13,13,51,133,30,49,0,0
5144,524,133,575,268,41,13,13,51,135,31,49,0,0
5145,523,135,574,267,41,13,13,51,132,32,49,0,0
5146,524,135,575,267,41,13,13,51,132,33,49,0,0
5147,523,134,576,269,41,13,13,53,135,34,49,0,0
5148,523,134,576,270,41,13,13,53,136,35,49,0,0
5149,523,133,576,271,41,13,13,53,138,36,49,0,0
5150,523,134,576,270,41,13,13,53,136,37,49,0,0
5151,521,134,575,272,41,13,13,54,138,38,49,0,0
5152,516,135,571,274,41,13,13,55,139,39,49,0,0
5153,510,143,562,276,41,13,13,52,133,40,49,0,0
5154,511,142,565,278,41,13,13,54,136,41,49,0,0
5155,508,144,560,277,41,13,13,52,133,42,49,0,0
5156,508,146,559,278,41,13,13,51,132,43,49,0,0
5157,513,145,569,283,41,13,13,56,138,44,49,0,0
5158,522,143,579,283,41,13,13,57,140,45,49,0,0
5159,536,140,595,284,41,13,13,59,144,46,49,0,0
5160,548,146,604,286,41,13,13,56,140,47,49,0,0
5161,554,149,611,289,41,13,13,57,140,48,49,0,0
5162,557,149,614,290,41,13,13,57,141,49,49,1,0
5118,541,150,578,274,42,13,13,37,124,0,0,0,0
5153,538,148,574,274,45,13,13,36,126,0,0,0,0
5155,538,146,573,272,46,13,13,35,126,0,0,0,0
5205,522,129,562,255,47,13,13,40,126,0,0,0,0
5206,488,133,538,253,48,13,13,50,120,0,0,0,0
5208,453,135,491,256,49,13,13,38,121,0,0,0,0
5211,382,129,432,254,51,13,13,50,125,0,0,0,0
5213,343,134,384,248,53,13,13,41,114,0,0,0,0
1048,1749,839,1919,1068,1,13,14,170,229,0,0,0,0
1050,1489,702,1856,1080,2,13,14,367,378,0,31,0,1
1051,1376,688,1753,1078,2,13,14,377,390,1,31,0,0
1052,1249,699,1608,1074,2,13,14,359,375,2,31,0,0
1053,1047,693,1412,1075,2,13,14,365,382,3,31,0,0
1054,885,687,1259,1073,2,13,14,374,386,4,31,0,0
1055,785,665,1188,1074,2,13,14,403,409,5,31,0,0
1056,692,640,1109,1068,2,13,14,417,428,6,31,0,0
1057,591,628,1016,1069,2,13,14,425,441,7,31,0,0
1058,490,615,920,1068,2,13,14,430,453,8,31,0,0
1059,392,599,827,1067,2,13,14,435,468,9,31,0,0
1060,303,576,753,1073,2,13,14,450,497,10,31,0,0
1061,228,549,688,1074,2,13,14,460,525,11,31,0,0
1062,176,525,641,1074,2,13,14,465,549,12,31,0,0
1063,146,530,597,1074,2,13,14,451,544,13,31,0,0
1064,106,518,558,1074,2,13,14,452,556,14,31,0,0
1065,72,510,517,1066,2,13,14,445,556,15,31,0,0
1066,54,508,485,1059,2,13,14,431,551,16,31,0,0
1067,50,493,454,1021,2,13,14,404,528,17,31,0,0
1068,37,495,408,991,2,13,14,371,496,18,31,0,0
1069,5,475,360,963,2,13,14,355,488,19,31,0,0
1070,0,470,313,943,2,13,14,313,473,20,31,0,0
1071,0,466,286,928,2,13,14,286,462,21,31,0,0
1072,0,462,259,889,2,13,14,259,427,22,31,0,0
1073,0,452,251,866,2,13,14,251,414,23,31,0,0
1074,0,453,226,841,2,13,14,226,388,24,31,0,0
1075,0,450,197,832,2,13,14,197,382,25,31,0,0
1076,0,451,178,823,2,13,14,178,372,26,31,0,0
1077,0,443,160,797,2,13,14,160,354,27,31,0,0
1078,0,460,144,780,2,13,14,144,320,28,31,0,0
1079,0,487,119,767,2,13,14,119,280,29,31,0,0
1080,0,492,97,752,2,13,14,97,260,30,31,0,0
1081,0,494,71,736,2,13,14,71,242,31,31,1,0
2323,1607,172,1642,286,3,13,14,35,114,0,84,0,0
2325,1607,174,1642,289,3,13,14,35,115,0,84,0,1
2326,1606,176,1642,296,3,13,14,36,120,1,84,0,0
2327,1604,179,1641,300,3,13,14,37,121,2,84,0,0
2328,1602,178,1639,302,3,13,14,37,124,3,84,0,0
2329,1601,179,1639,306,3,13,14,38,127,4,84,0,0
2330,1602,180,1641,307,3,13,14,39,127,5,84,0,0
2331,1601,179,1642,311,3,13,14,41,132,6,84,0,0
2332,1600,180,1642,315,3,13,14,42,135,7,84,0,0
2333,1599,183,1640,316,3,13,14,41,133,8,84,0,0
2334,1599,182,1641,319,3,13,14,42,137,9,84,0,0
2335,1600,182,1642,322,3,13,14,42,140,10,84,0,0
2336,1601,184,1644,323,3,13,14,43,139,11,84,0,0
2337,1600,184,1645,331,3,13,14,45,147,12,84,0,0
2338,1598,185,1644,334,3,13,14,46,149,13,84,0,0
2339,1597,183,1644,336,3,13,14,47,153,14,84,0,0
2340,1596,187,1643,340,3,13,14,47,153,15,84,0,0
2341,1597,188,1644,343,3,13,14,47,155,16,84,0,0
2342,1597,187,1645,346,3,13,14,48,159,17,84,0,0
2343,1596,191,1646,353,3,13,14,50,162,18,84,0,0
2344,1595,192,1644,354,3,13,14,49,162,19,84,0,0
2345,1594,193,1644,360,3,13,14,50,167,20,84,0,0
2346,1596,197,1647,363,3,13,14,51,166,21,84,0,0
2347,1598,194,1651,366,3,13,14,53,172,22,84,0,0
2348,1600,198,1653,373,3,13,14,53,175,23,84,0,0
2349,1597,200,1653,380,3,13,14,56,180,24,84,0,0
2350,1592,201,1650,384,3,13,14,58,183,25,84,0,0
2351,1589,202,1649,391,3,13,14,60,189,26,84,0,0
2352,1591,203,1653,395,3,13,14,62,192,27,84,0,0
2353,1593,204,1656,400,3,13,14,63,196,28,84,0,0
2354,1590,207,1653,406,3,13,14,63,199,29,84,0,0
2355,1583,206,1649,413,3,13,14,66,207,30,84,0,0
2356,1576,207,1645,424,3,13,14,69,217,31,84,0,0
2357,1572,211,1643,431,3,13,14,71,220,32,84,0,0
2358,1573,212,1645,435,3,13,14,72,223,33,84,0,0
2359,1571,219,1643,442,3,13,14,72,223,34,84,0,0
2360,1562,221,1636,451,3,13,14,74,230,35,84,0,0
2361,1550,220,1627,457,3,13,14,77,237,36,84,0,0
2362,1546,223,1626,469,3,13,14,80,246,37,84,0,0
2363,1545,224,1627,475,3,13,14,82,251,38,84,0,0
2364,1544,224,1629,487,3,13,14,85,263,39,84,0,0
2365,1539,232,1625,497,3,13,14,86,265,40,84,0,0
2366,1534,234,1621,501,3,13,14,87,267,41,84,0,0
2367,1531,238,1621,515,3,13,14,90,277,42,84,0,0
2368,1530,243,1621,530,3,13,14,91,287,43,84,0,0
2369,1529,245,1622,533,3,13,14,93,288,44,84,0,0
2370,1525,246,1623,552,3,13,14,98,306,45,84,0,0
2371,1514,251,1618,571,3,13,14,104,320,46,84,0,0
2372,1507,252,1614,586,3,13,14,107,334,47,84,0,0
2373,1503,259,1614,610,3,13,14,111,351,48,84,0,0
2374,1498,266,1612,630,3,13,14,114,364,49,84,0,0
2375,1496,269,1611,637,3,13,14,115,368,50,84,0,0
2376,1486,280,1605,658,3,13,14,119,378,51,84,0,0
2377,1473,286,1595,676,3,13,14,122,390,52,84,0,0
2378,1458,286,1588,706,3,13,14,130,420,53,84,0,0
2379,1448,299,1583,737,3,13,14,135,438,54,84,0,0
2380,1436,303,1574,752,3,13,14,138,449,55,84,0,0
2381,1410,311,1553,771,3,13,14,143,460,56,84,0,0
2382,1382,321,1530,790,3,13,14,148,469,57,84,0,0
2383,1347,332,1498,812,3,13,14,151,480,58,84,0,0
2384,1300,345,1464,867,3,13,14,164,522,59,84,0,0
2385,1259,361,1425,891,3,13,14,166,530,60,84,0,0
2386,1201,363,1370,904,3,13,14,169,541,61,84,0,0
2387,1125,378,1310,934,3,13,14,185,556,62,84,0,0
2388,1057,384,1245,946,3,13,14,188,562,63,84,0,0
2389,956,396,1157,986,3,13,14,201,590,64,84,0,0
2390,892,424,1098,1002,3,13,14,206,578,65,84,0,0
2391,785,433,991,1012,3,13,14,206,579,66,84,0,0
2392,702,449,918,1033,3,13,14,216,584,67,84,0,0
2393,620,465,840,1032,3,13,14,220,567,68,84,0,0
2394,512,463,732,1028,3,13,14,220,565,69,84,0,0
2395,445,481,666,1018,3,13,14,221,537,70,84,0,0
2396,358,485,580,1015,3,13,14,222,530,71,84,0,0
2397,274,476,500,1008,3,13,14,226,532,72,84,0,0
2398,222,484,444,994,3,13,14,222,510,73,84,0,0
2399,153,481,362,964,3,13,14,209,483,74,84,0,0
2400,119,483,325,948,3,13,14,206,465,75,84,0,0
2401,80,481,284,933,3,13,14,204,452,76,84,0,0
2402,29,474,230,920,3,13,14,201,446,77,84,0,0
2403,9,486,199,904,3,13,14,190,418,78,84,0,0
2404,0,484,157,880,3,13,14,157,396,79,84,0,0
2405,0,499,137,862,3,13,14,137,363,80,84,0,0
2406,0,530,122,846,3,13,14,122,316,81,84,0,0
2407,0,526,101,836,3,13,14,101,310,82,84,0,0
2408,0,534,84,830,3,13,14,84,296,83,84,0,0
2409,0,549,63,814,3,13,14,63,265,84,84,1,0
2647,1616,180,1651,282,6,13,14,35,102,0,97,0,1
2648,1616,180,1653,288,6,13,14,37,108,1,97,0,0
2649,1617,182,1655,291,6,13,14,38,109,2,97,0,0
2650,1619,183,1656,289,6,13,14,37,106,3,97,0,0
2651,1619,181,1657,291,6,13,14,38,110,4,97,0,0
2652,1618,181,1657,295,6,13,14,39,114,5,97,0,0
2653,1616,181,1657,300,6,13,14,41,119,6,97,0,0
2654,1615,181,1657,299,6,13,14,42,118,7,97,0,0
2655,1616,180,1657,300,6,13,14,41,120,8,97,0,0
2656,1615,181,1657,305,6,13,14,42,124,9,97,0,0
2657,1615,181,1657,305,6,13,14,42,124,10,97,0,0
2658,1615,184,1656,308,6,13,14,41,124,11,97,0,0
2659,1613,185,1657,315,6,13,14,44,130,12,97,0,0
2660,1613,187,1656,312,6,13,14,43,125,13,97,0,0
2661,1612,185,1655,312,6,13,14,43,127,14,97,0,0
2662,1611,187,1655,318,6,13,14,44,131,15,97,0,0
2663,1609,187,1654,320,6,13,14,45,133,16,97,0,0
2664,1607,187,1652,322,6,13,14,45,135,17,97,0,0
2665,1606,188,1652,325,6,13,14,46,137,18,97,0,0
2666,1606,188,1653,326,6,13,14,47,138,19,97,0,0
2667,1606,186,1653,328,6,13,14,47,142,20,97,0,0
2668,1605,188,1653,331,6,13,14,48,143,21,97,0,0
2669,1603,188,1652,333,6,13,14,49,145,22,97,0,0
2670,1601,189,1650,334,6,13,14,49,145,23,97,0,0
2671,1600,190,1649,338,6,13,14,49,148,24,97,0,0
2672,1602,191,1651,340,6,13,14,49,149,25,97,0,0
2673,1603,192,1654,345,6,13,14,51,153,26,97,0,0
2674,1604,196,1656,351,6,13,14,52,155,27,97,0,0
2675,1605,199,1656,352,6,13,14,51,153,28,97,0,0
2676,1604,196,1657,356,6,13,14,53,160,29,97,0,0
2677,1604,193,1660,361,6,13,14,56,168,30,97,0,0
2678,1607,194,1663,362,6,13,14,56,168,31,97,0,0
2679,1608,192,1666,364,6,13,14,58,172,32,97,0,0
2680,1610,199,1666,368,6,13,14,56,169,33,97,0,0
2681,1609,200,1666,371,6,13,14,57,171,34,97,0,0
2682,1607,201,1666,379,6,13,14,59,178,35,97,0,0
2683,1606,201,1666,385,6,13,14,60,184,36,97,0,0
2684,1607,202,1668,388,6,13,14,61,186,37,97,0,0
2685,1607,203,1668,392,6,13,14,61,189,38,97,0,0
2686,1606,205,1667,395,6,13,14,61,190,39,97,0,0
2687,1604,205,1666,399,6,13,14,62,194,40,97,0,0
2688,1600,203,1665,407,6,13,14,65,204,41,97,0,0
2689,1600,202,1668,414,6,13,14,68,212,42,97,0,0
2690,1600,206,1666,416,6,13,14,66,210,43,97,0,0
2691,1596,208,1663,423,6,13,14,67,215,44,97,0,0
2692,1595,209,1661,426,6,13,14,66,217,45,97,0,0
2693,1591,210,1656,428,6,13,14,65,218,46,97,0,0
2694,1588,214,1653,435,6,13,14,65,221,47,97,0,0
2695,1585,212,1652,441,6,13,14,67,229,48,97,0,0
2696,1578,213,1647,444,6,13,14,69,231,49,97,0,0
2697,1575,213,1645,450,6,13,14,70,237,50,97,0,0
2698,1570,219,1642,455,6,13,14,72,236,51,97,0,0
2699,1566,220,1640,459,6,13,14,74,239,52,97,0,0
2700,1562,223,1639,471,6,13,14,77,248,53,97,0,0
2701,1562,224,1642,482,6,13,14,80,258,54,97,0,0
2702,1563,225,1646,487,6,13,14,83,262,55,97,0,0
2703,1564,231,1649,496,6,13,14,85,265,56,97,0,0
2704,1562,233,1648,502,6,13,14,86,269,57,97,0,0
2705,1557,238,1644,506,6,13,14,87,268,58,97,0,0
2706,1552,243,1642,521,6,13,14,90,278,59,97,0,0
2707,1552,245,1644,530,6,13,14,92,285,60,97,0,0
2708,1554,247,1647,533,6,13,14,93,286,61,97,0,0
2709,1553,246,1651,548,6,13,14,98,302,62,97,0,0
2710,1548,247,1650,563,6,13,14,102,316,63,97,0,0
2711,1544,251,1647,570,6,13,14,103,319,64,97,0,0
2712,1537,254,1646,589,6,13,14,109,335,65,97,0,0
2713,1539,259,1649,596,6,13,14,110,337,66,97,0,0
2714,1538,261,1652,608,6,13,14,114,347,67,97,0,0
2715,1536,268,1654,628,6,13,14,118,360,68,97,0,0
2716,1531,271,1652,639,6,13,14,121,368,69,97,0,0
2717,1525,276,1648,648,6,13,14,123,372,70,97,0,0
2718,1520,283,1649,679,6,13,14,129,396,71,97,0,0
2719,1520,285,1652,689,6,13,14,132,404,72,97,0,0
2720,1521,290,1654,695,6,13,14,133,405,73,97,0,0
2721,1517,300,1656,725,6,13,14,139,425,74,97,0,0
2722,1509,305,1653,740,6,13,14,144,435,75,97,0,0
2723,1501,311,1649,757,6,13,14,148,446,76,97,0,0
2724,1493,323,1647,787,6,13,14,154,464,77,97,0,0
2725,1491,329,1649,807,6,13,14,158,478,78,97,0,0
2726,1489,337,1650,821,6,13,14,161,484,79,97,0,0
2727,1482,351,1651,856,6,13,14,169,505,80,97,0,0
2728,1470,359,1646,885,6,13,14,176,526,81,97,0,0
2729,1455,371,1639,918,6,13,14,184,547,82,97,0,0
2730,1448,390,1634,940,6,13,14,186,550,83,97,0,0
2731,1442,400,1637,970,6,13,14,195,570,84,97,0,0
2732,1434,415,1639,1007,6,13,14,205,592,85,97,0,0
2733,1419,436,1634,1051,6,13,14,215,615,86,97,0,0
2734,1401,448,1621,1067,6,13,14,220,619,87,97,0,0
2735,1387,472,1607,1078,6,13,14,220,606,88,97,0,0
2736,1390,503,1604,1073,6,13,14,214,570,89,97,0,0
2737,1402,536,1613,1072,6,13,14,211,536,90,97,0,0
2738,1397,563,1610,1073,6,13,14,213,510,91,97,0,0
2739,1386,611,1593,1071,6,13,14,207,460,92,97,0,0
2740,1361,658,1566,1073,6,13,14,205,415,93,97,0,0
2741,1330,721,1527,1077,6,13,14,197,356,94,97,0,0
2742,1314,812,1484,1076,6,13,14,170,264,95,97,0,0
2743,1321,888,1450,1072,6,13,14,129,184,96,97,0,0
2744,1321,936,1421,1078,6,13,14,100,142,97,97,1,0
2775,1598,183,1634,303,7,13,14,36,120,0,76,0,1
2776,1597,183,1633,305,7,13,14,36,122,1,76,0,0
2777,1597,185,1635,312,7,13,14,38,127,2,76,0,0
2778,1598,183,1638,314,7,13,14,40,131,3,76,0,0
2779,1599,184,1639,317,7,13,14,40,133,4,76,0,0
2780,1597,184,1639,320,7,13,14,42,136,5,76,0,0
2781,1596,184,1639,323,7,13,14,43,139,6,76,0,0
2782,1595,186,1639,329,7,13,14,44,143,7,76,0,0
2783,1598,188,1642,330,7,13,14,44,142,8,76,0,0
2784,1599,185,1645,335,7,13,14,46,150,9,76,0,0
2785,1599,184,1647,341,7,13,14,48,157,10,76,0,0
2786,1599,184,1648,342,7,13,14,49,158,11,76,0,0
2787,1599,187,1649,347,7,13,14,50,160,12,76,0,0
2788,1601,188,1652,356,7,13,14,51,168,13,76,0,0
2789,1603,189,1653,351,7,13,14,50,162,14,76,0,0
2790,1603,193,1655,359,7,13,14,52,166,15,76,0,0
2791,1600,194,1654,365,7,13,14,54,171,16,76,0,0
2792,1598,196,1653,374,7,13,14,55,178,17,76,0,0
2793,1598,199,1655,383,7,13,14,57,184,18,76,0,0
2794,1598,199,1656,386,7,13,14,58,187,19,76,0,0
2795,1598,200,1657,387,7,13,14,59,187,20,76,0,0
2796,1596,201,1657,396,7,13,14,61,195,21,76,0,0
2797,1593,201,1656,402,7,13,14,63,201,22,76,0,0
2798,1592,206,1658,411,7,13,14,66,205,23,76,0,0
2799,1592,204,1661,416,7,13,14,69,212,24,76,0,0
2800,1589,207,1660,427,7,13,14,71,220,25,76,0,0
2801,1587,211,1660,434,7,13,14,73,223,26,76,0,0
2802,1585,210,1660,438,7,13,14,75,228,27,76,0,0
2803,1578,217,1656,449,7,13,14,78,232,28,76,0,0
2804,1575,219,1657,460,7,13,14,82,241,29,76,0,0
2805,1570,219,1656,468,7,13,14,86,249,30,76,0,0
2806,1560,223,1647,481,7,13,14,87,258,31,76,0,0
2807,1553,223,1643,484,7,13,14,90,261,32,76,0,0
2808,1545,232,1636,496,7,13,14,91,264,33,76,0,0
2809,1540,237,1634,511,7,13,14,94,274,34,76,0,0
2810,1532,236,1630,519,7,13,14,98,283,35,76,0,0
2811,1523,243,1621,527,7,13,14,98,284,36,76,0,0
2812,1514,246,1615,539,7,13,14,101,293,37,76,0,0
2813,1500,245,1608,561,7,13,14,108,316,38,76,0,0
2814,1487,246,1601,584,7,13,14,114,338,39,76,0,0
2815,1481,247,1595,583,7,13,14,114,336,40,76,0,0
2816,1469,257,1584,597,7,13,14,115,340,41,76,0,0
2817,1456,263,1575,614,7,13,14,119,351,42,76,0,0
2818,1438,268,1565,639,7,13,14,127,371,43,76,0,0
2819,1424,280,1556,666,7,13,14,132,386,44,76,0,0
2820,1410,282,1546,678,7,13,14,136,396,45,76,0,0
2821,1385,291,1527,702,7,13,14,142,411,46,76,0,0
2822,1362,302,1508,729,7,13,14,146,427,47,76,0,0
2823,1339,306,1489,748,7,13,14,150,442,48,76,0,0
2824,1310,320,1463,774,7,13,14,153,454,49,76,0,0
2825,1278,334,1438,811,7,13,14,160,477,50,76,0,0
2826,1236,335,1402,831,7,13,14,166,496,51,76,0,0
2827,1182,354,1358,868,7,13,14,176,514,52,76,0,0
2828,1138,364,1313,881,7,13,14,175,517,53,76,0,0
2829,1079,378,1261,920,7,13,14,182,542,54,76,0,0
2830,1015,394,1209,963,7,13,14,194,569,55,76,0,0
2831,937,404,1131,980,7,13,14,194,576,56,76,0,0
2832,862,424,1065,992,7,13,14,203,568,57,76,0,0
2833,783,442,991,997,7,13,14,208,555,58,76,0,0
2834,675,449,888,1010,7,13,14,213,561,59,76,0,0
2835,593,468,815,1019,7,13,14,222,551,60,76,0,0
2836,490,475,711,1021,7,13,14,221,546,61,76,0,0
2837,391,475,621,1018,7,13,14,230,543,62,76,0,0
2838,310,484,537,997,7,13,14,227,513,63,76,0,0
2839,246,476,471,989,7,13,14,225,513,64,76,0,0
2840,208,487,430,977,7,13,14,222,490,65,76,0,0
2841,147,488,365,963,7,13,14,218,475,66,76,0,0
2842,86,482,303,953,7,13,14,217,471,67,76,0,0
2843,49,483,264,937,7,13,14,215,454,68,76,0,0
2844,17,475,221,912,7,13,14,204,437,69,76,0,0
2845,5,494,195,899,7,13,14,190,405,70,76,0,0
2846,0,499,169,878,7,13,14,169,379,71,76,0,0
2847,0,496,135,867,7,13,14,135,371,72,76,0,0
2848,0,471,121,861,7,13,14,121,390,73,76,0,0
2849,0,486,97,841,7,13,14,97,355,74,76,0,0
2850,0,534,80,822,7,13,14,80,288,75,76,0,0
2851,0,563,61,798,7,13,14,61,235,76,76,1,0
2768,275,812,471,1073,10,13,14,196,261,0,0,0,0
2769,401,693,675,1071,11,13,14,274,378,0,46,0,1
2770,517,653,816,1066,11,13,14,299,413,1,46,0,0
2771,593,592,939,1071,11,13,14,346,479,2,46,0,0
2772,656,528,1040,1067,11,13,14,384,539,3,46,0,0
2773,724,486,1130,1068,11,13,14,406,582,4,46,0,0
2774,784,445,1212,1075,11,13,14,428,630,5,46,0,0
2775,846,413,1282,1076,11,13,14,436,663,6,46,0,0
2776,906,384,1325,1043,11,13,14,419,659,7,46,0,0
2777,965,356,1352,987,11,13,14,387,631,8,46,0,0
2778,1026,346,1383,951,11,13,14,357,605,9,46,0,0
2779,1088,329,1400,880,11,13,14,312,551,10,46,0,0
2780,1135,318,1423,844,11,13,14,288,526,11,46,0,0
2781,1169,299,1440,813,11,13,14,271,514,12,46,0,0
2782,1201,282,1447,764,11,13,14,246,482,13,46,0,0
2783,1228,276,1452,733,11,13,14,224,457,14,46,0,0
2784,1257,267,1461,699,11,13,14,204,432,15,46,0,0
2785,1275,264,1468,685,11,13,14,193,421,16,46,0,0
2786,1294,257,1474,664,11,13,14,180,407,17,46,0,0
2787,1313,247,1477,629,11,13,14,164,382,18,46,0,0
2788,1329,245,1480,607,11,13,14,151,362,19,46,0,0
2789,1344,235,1488,588,11,13,14,144,353,20,46,0,0
2790,1359,231,1496,575,11,13,14,137,344,21,46,0,0
2791,1369,230,1498,564,11,13,14,129,334,22,46,0,0
2792,1380,224,1499,540,11,13,14,119,316,23,46,0,0
2793,1389,222,1504,534,11,13,14,115,312,24,46,0,0
2794,1400,215,1508,512,11,13,14,108,297,25,46,0,0
2795,1413,211,1514,494,11,13,14,101,283,26,46,0,0
2796,1422,212,1518,483,11,13,14,96,271,27,46,0,0
2797,1428,206,1521,471,11,13,14,93,265,28,46,0,0
2798,1437,210,1525,463,11,13,14,88,253,29,46,0,0
2799,1445,205,1530,452,11,13,14,85,247,30,46,0,0
2800,1451,202,1534,446,11,13,14,83,244,31,46,0,0
2801,1457,201,1537,438,11,13,14,80,237,32,46,0,0
2802,1460,197,1537,429,11,13,14,77,232,33,46,0,0
2803,1461,198,1537,425,11,13,14,76,227,34,46,0,0
2804,1466,198,1537,414,11,13,14,71,216,35,46,0,0
2805,1472,197,1539,401,11,13,14,67,204,36,46,0,0
2806,1474,196,1539,397,11,13,14,65,201,37,46,0,0
2807,1475,190,1540,393,11,13,14,65,203,38,46,0,0
2808,1479,193,1540,388,11,13,14,61,195,39,46,0,0
2809,1484,186,1545,385,11,13,14,61,199,40,46,0,0
2810,1488,182,1550,384,11,13,14,62,202,41,46,0,0
2811,1493,181,1551,371,11,13,14,58,190,42,46,0,0
2812,1497,181,1550,355,11,13,14,53,174,43,46,0,0
2813,1499,180,1548,338,11,13,14,49,158,44,46,0,0
2814,1503,178,1550,328,11,13,14,47,150,45,46,0,0
2815,1509,179,1550,308,11,13,14,41,129,46,46,1,0
2817,1512,176,1550,288,11,13,14,38,112,0,46,0,0
2818,1509,177,1555,315,11,13,14,46,138,1,46,0,0
2819,1510,173,1560,327,11,13,14,50,154,2,46,0,0
2820,1512,169,1561,326,11,13,14,49,157,3,46,0,0
2821,1516,171,1562,316,11,13,14,46,145,4,46,0,0
2822,1518,169,1565,319,11,13,14,47,150,5,46,0,0
2823,1519,168,1566,319,11,13,14,47,151,6,46,0,0
2824,1523,166,1569,316,11,13,14,46,150,7,46,0,0
2825,1525,164,1571,315,11,13,14,46,151,8,46,0,0
2826,1528,164,1572,309,11,13,14,44,145,9,46,0,0
2827,1529,159,1573,311,11,13,14,44,152,10,46,0,0
2828,1532,162,1573,302,11,13,14,41,140,11,46,0,0
2829,1536,163,1575,298,11,13,14,39,135,12,46,0,0
2830,1538,162,1577,296,11,13,14,39,134,13,46,0,0
2833,1546,161,1583,291,11,13,14,37,130,0,46,0,0
2834,1549,158,1585,288,11,13,14,36,130,1,46,0,0
2835,1550,157,1586,284,11,13,14,36,127,2,46,0,0
2836,1553,156,1588,281,11,13,14,35,125,3,46,0,0
3015,1582,171,1617,294,12,13,14,35,123,0,58,0,1
3016,1579,174,1615,298,12,13,14,36,124,1,58,0,0
3017,1576,176,1612,299,12,13,14,36,123,2,58,0,0
3018,1573,178,1609,303,12,13,14,36,125,3,58,0,0
3019,1572,174,1610,307,12,13,14,38,133,4,58,0,0
3020,1570,181,1607,311,12,13,14,37,130,5,58,0,0
3021,1569,188,1605,313,12,13,14,36,125,6,58,0,0
3022,1566,188,1604,315,12,13,14,38,127,7,58,0,0
3023,1567,192,1605,320,12,13,14,38,128,8,58,0,0
3024,1567,192,1606,322,12,13,14,39,130,9,58,0,0
3025,1565,190,1606,327,12,13,14,41,137,10,58,0,0
3026,1562,189,1604,330,12,13,14,42,141,11,58,0,0
3027,1559,188,1603,336,12,13,14,44,148,12,58,0,0
3028,1559,191,1604,342,12,13,14,45,151,13,58,0,0
3029,1559,192,1605,347,12,13,14,46,155,14,58,0,0
3030,1557,193,1605,352,12,13,14,48,159,15,58,0,0
3031,1555,189,1604,354,12,13,14,49,165,16,58,0,0
3032,1555,192,1604,360,12,13,14,49,168,17,58,0,0
3033,1554,194,1604,362,12,13,14,50,168,18,58,0,0
3034,1553,196,1604,370,12,13,14,51,174,19,58,0,0
3035,1550,198,1601,374,12,13,14,51,176,20,58,0,0
3036,1545,196,1601,384,12,13,14,56,188,21,58,0,0
3037,1545,199,1602,392,12,13,14,57,193,22,58,0,0
3038,1544,198,1603,398,12,13,14,59,200,23,58,0,0
3039,1540,201,1601,405,12,13,14,61,204,24,58,0,0
3040,1535,206,1596,408,12,13,14,61,202,25,58,0,0
3041,1530,209,1592,418,12,13,14,62,209,26,58,0,0
3042,1527,214,1591,427,12,13,14,64,213,27,58,0,0
3043,1518,214,1586,437,12,13,14,68,223,28,58,0,0
3044,1510,215,1581,445,12,13,14,71,230,29,58,0,0
3045,1501,212,1577,459,12,13,14,76,247,30,58,0,0
3046,1497,215,1574,468,12,13,14,77,253,31,58,0,0
3047,1491,216,1570,475,12,13,14,79,259,32,58,0,0
3048,1486,226,1565,484,12,13,14,79,258,33,58,0,0
3049,1472,228,1555,497,12,13,14,83,269,34,58,0,0
3050,1465,232,1551,509,12,13,14,86,277,35,58,0,0
3051,1457,237,1549,533,12,13,14,92,296,36,58,0,0
3052,1449,243,1547,552,12,13,14,98,309,37,58,0,0
3053,1435,243,1541,576,12,13,14,106,333,38,58,0,0
3054,1422,249,1533,594,12,13,14,111,345,39,58,0,0
3055,1411,267,1528,621,12,13,14,117,354,40,58,0,0
3056,1402,271,1525,640,12,13,14,123,369,41,58,0,0
3057,1397,288,1518,651,12,13,14,121,363,42,58,0,0
3058,1381,299,1510,683,12,13,14,129,384,43,58,0,0
3059,1365,316,1501,715,12,13,14,136,399,44,58,0,0
3060,1358,327,1503,752,12,13,14,145,425,45,58,0,0
3061,1340,343,1494,788,12,13,14,154,445,46,58,0,0
3062,1315,359,1480,836,12,13,14,165,477,47,58,0,0
3063,1291,367,1468,874,12,13,14,177,507,48,58,0,0
3064,1274,396,1465,937,12,13,14,191,541,49,58,0,0
3065,1245,413,1448,978,12,13,14,203,565,50,58,0,0
3066,1202,443,1421,1034,12,13,14,219,591,51,58,0,0
3067,1161,466,1393,1070,12,13,14,232,604,52,58,0,0
3068,1134,516,1363,1080,12,13,14,229,564,53,58,0,0
3069,1096,554,1327,1080,12,13,14,231,526,54,58,0,0
3070,1039,612,1268,1080,12,13,14,229,468,55,58,0,0
3071,955,694,1171,1080,12,13,14,216,386,56,58,0,0
3072,872,774,1068,1080,12,13,14,196,306,57,58,0,0
3073,840,810,1024,1080,12,13,14,184,270,58,58,1,0
3512,0,459,62,720,14,13,14,62,261,0,39,0,1
3513,6,466,69,729,14,13,14,63,263,1,39,0,0
3514,24,454,90,724,14,13,14,66,270,2,39,0,0
3515,28,463,92,723,14,13,14,64,260,3,39,0,0
3516,40,453,113,743,14,13,14,73,290,4,39,0,0
3517,54,462,129,748,14,13,14,75,286,5,39,0,0
3518,62,468,142,766,14,13,14,80,298,6,39,0,0
3519,86,471,175,785,14,13,14,89,314,7,39,0,0
3520,106,475,200,792,14,13,14,94,317,8,39,0,0
3521,116,473,217,803,14,13,14,101,330,9,39,0,0
3522,127,476,232,814,14,13,14,105,338,10,39,0,0
3523,137,481,248,831,14,13,14,111,350,11,39,0,0
3524,160,481,282,849,14,13,14,122,368,12,39,0,0
3525,194,489,325,863,14,13,14,131,374,13,39,0,0
3526,212,492,348,867,14,13,14,136,375,14,39,0,0
3527,217,493,364,895,14,13,14,147,402,15,39,0,0
3528,223,499,373,905,14,13,14,150,406,16,39,0,0
3529,231,514,385,931,14,13,14,154,417,17,39,0,0
3530,249,512,411,944,14,13,14,162,432,18,39,0,0
3531,280,512,457,960,14,13,14,177,448,19,39,0,0
3532,306,518,490,975,14,13,14,184,457,20,39,0,0
3533,322,518,516,1004,14,13,14,194,486,21,39,0,0
3534,367,529,573,1038,14,13,14,206,509,22,39,0,0
3535,399,532,608,1054,14,13,14,209,522,23,39,0,0
3536,456,541,670,1062,14,13,14,214,521,24,39,0,0
3537,534,555,756,1073,14,13,14,222,518,25,39,0,0
3538,592,551,820,1077,14,13,14,228,526,26,39,0,0
3539,663,553,893,1080,14,13,14,230,527,27,39,0,0
3540,738,552,969,1080,14,13,14,231,528,28,39,0,0
3541,814,546,1051,1080,14,13,14,237,534,29,39,0,0
3542,908,549,1146,1080,14,13,14,238,531,30,39,0,0
3543,984,556,1221,1080,14,13,14,237,524,31,39,0,0
3544,1101,562,1339,1079,14,13,14,238,517,32,39,0,0
3545,1191,577,1431,1076,14,13,14,240,499,33,39,0,0
3546,1297,575,1545,1071,14,13,14,248,496,34,39,0,0
3547,1382,584,1628,1067,14,13,14,246,483,35,39,0,0
3548,1483,587,1725,1057,14,13,14,242,470,36,39,0,0
3549,1574,585,1824,1069,14,13,14,250,484,37,39,0,0
3550,1664,603,1907,1073,14,13,14,243,470,38,39,0,0
3551,1742,608,1920,1077,14,13,14,178,469,39,39,1,0
3520,2,527,54,838,15,13,14,52,311,0,33,0,1
3521,1,520,55,845,15,13,14,54,325,1,33,0,0
3522,11,516,67,844,15,13,14,56,328,2,33,0,0
3523,36,516,96,848,15,13,14,60,332,3,33,0,0
3524,42,502,109,857,15,13,14,67,355,4,33,0,0
3525,34,475,110,866,15,13,14,76,391,5,33,0,0
3526,44,470,133,898,15,13,14,89,428,6,33,0,0
3527,52,466,153,924,15,13,14,101,458,7,33,0,0
3528,55,469,165,934,15,13,14,110,465,8,33,0,0
3529,80,491,197,940,15,13,14,117,449,9,33,0,0
3530,102,487,234,959,15,13,14,132,472,10,33,0,0
3531,113,481,256,969,15,13,14,143,488,11,33,0,0
3532,119,489,283,1022,15,13,14,164,533,12,33,0,0
3533,138,492,319,1059,15,13,14,181,567,13,33,0,0
3534,150,500,338,1066,15,13,14,188,566,14,33,0,0
3535,196,509,398,1079,15,13,14,202,570,15,33,0,0
3536,230,522,438,1080,15,13,14,208,558,16,33,0,0
3537,252,524,463,1080,15,13,14,211,556,17,33,0,0
3538,286,528,499,1080,15,13,14,213,552,18,33,0,0
3539,340,544,549,1074,15,13,14,209,530,19,33,0,0
3540,399,536,620,1079,15,13,14,221,543,20,33,0,0
3541,472,540,699,1080,15,13,14,227,540,21,33,0,0
3542,557,561,780,1080,15,13,14,223,519,22,33,0,0
3543,650,547,882,1079,15,13,14,232,532,23,33,0,0
3544,736,553,966,1077,15,13,14,230,524,24,33,0,0
3545,845,566,1073,1078,15,13,14,228,512,25,33,0,0
3546,976,570,1202,1078,15,13,14,226,508,26,33,0,0
3547,1102,578,1327,1078,15,13,14,225,500,27,33,0,0
3548,1223,581,1447,1072,15,13,14,224,491,28,33,0,0
3549,1353,581,1575,1068,15,13,14,222,487,29,33,0,0
3550,1472,590,1694,1071,15,13,14,222,481,30,33,0,0
3551,1595,620,1811,1076,15,13,14,216,456,31,33,0,0
3552,1709,638,1915,1076,15,13,14,206,438,32,33,0,0
3553,1792,706,1920,1074,15,13,14,128,368,33,33,1,0
4494,1610,158,1645,262,20,13,14,35,104,0,90,0,1
4495,1609,158,1646,267,20,13,14,37,109,1,90,0,0
4496,1608,161,1645,270,20,13,14,37,109,2,90,0,0
4497,1607,160,1645,271,20,13,14,38,111,3,90,0,0
4498,1606,159,1644,272,20,13,14,38,113,4,90,0,0
4499,1605,160,1644,275,20,13,14,39,115,5,90,0,0
4500,1605,161,1645,277,20,13,14,40,116,6,90,0,0
4501,1605,162,1644,279,20,13,14,39,117,7,90,0,0
4502,1606,164,1644,280,20,13,14,38,116,8,90,0,0
4503,1605,164,1644,283,20,13,14,39,119,9,90,0,0
4504,1604,165,1643,285,20,13,14,39,120,10,90,0,0
4505,1605,166,1644,288,20,13,14,39,122,11,90,0,0
4506,1605,164,1646,291,20,13,14,41,127,12,90,0,0
4507,1606,167,1647,297,20,13,14,41,130,13,90,0,0
4508,1605,168,1647,300,20,13,14,42,132,14,90,0,0
4509,1603,169,1645,301,20,13,14,42,132,15,90,0,0
4510,1603,172,1645,303,20,13,14,42,131,16,90,0,0
4511,1603,175,1644,303,20,13,14,41,128,17,90,0,0
4512,1603,174,1645,305,20,13,14,42,131,18,90,0,0
4513,1603,174,1646,309,20,13,14,43,135,19,90,0,0
4514,1604,175,1646,312,20,13,14,42,137,20,90,0,0
4515,1602,175,1645,314,20,13,14,43,139,21,90,0,0
4516,1602,176,1646,316,20,13,14,44,140,22,90,0,0
4517,1602,177,1646,320,20,13,14,44,143,23,90,0,0
4518,1602,176,1646,320,20,13,14,44,144,24,90,0,0
4519,1602,178,1646,323,20,13,14,44,145,25,90,0,0
4520,1601,181,1644,325,20,13,14,43,144,26,90,0,0
4521,1598,182,1642,327,20,13,14,44,145,27,90,0,0
4522,1596,183,1641,331,20,13,14,45,148,28,90,0,0
4523,1594,184,1639,333,20,13,14,45,149,29,90,0,0
4524,1593,183,1639,333,20,13,14,46,150,30,90,0,0
4525,1591,183,1638,337,20,13,14,47,154,31,90,0,0
4526,1590,185,1638,342,20,13,14,48,157,32,90,0,0
4527,1586,184,1636,344,20,13,14,50,160,33,90,0,0
4528,1582,184,1634,350,20,13,14,52,166,34,90,0,0
4529,1580,184,1634,355,20,13,14,54,171,35,90,0,0
4530,1580,183,1635,357,20,13,14,55,174,36,90,0,0
4531,1580,183,1637,362,20,13,14,57,179,37,90,0,0
4532,1578,189,1634,365,20,13,14,56,176,38,90,0,0
4533,1575,189,1632,368,20,13,14,57,179,39,90,0,0
4534,1573,192,1631,373,20,13,14,58,181,40,90,0,0
4535,1575,196,1634,380,20,13,14,59,184,41,90,0,0
4536,1578,196,1638,384,20,13,14,60,188,42,90,0,0
4537,1578,197,1640,394,20,13,14,62,197,43,90,0,0
4538,1577,197,1641,401,20,13,14,64,204,44,90,0,0
4539,1577,199,1641,403,20,13,14,64,204,45,90,0,0
4540,1577,199,1643,407,20,13,14,66,208,46,90,0,0
4541,1580,201,1647,413,20,13,14,67,212,47,90,0,0
4542,1583,202,1650,415,20,13,14,67,213,48,90,0,0
4543,1583,204,1653,425,20,13,14,70,221,49,90,0,0
4544,1580,207,1652,431,20,13,14,72,224,50,90,0,0
4545,1580,207,1654,434,20,13,14,74,227,51,90,0,0
4546,1577,208,1653,439,20,13,14,76,231,52,90,0,0
4547,1579,213,1656,446,20,13,14,77,233,53,90,0,0
4548,1582,215,1660,455,20,13,14,78,240,54,90,0,0
4549,1585,218,1663,463,20,13,14,78,245,55,90,0,0
4550,1584,224,1662,472,20,13,14,78,248,56,90,0,0
4551,1580,226,1658,478,20,13,14,78,252,57,90,0,0
4552,1578,228,1660,489,20,13,14,82,261,58,90,0,0
4553,1580,232,1665,504,20,13,14,85,272,59,90,0,0
4554,1584,230,1671,512,20,13,14,87,282,60,90,0,0
4555,1583,234,1671,523,20,13,14,88,289,61,90,0,0
4556,1579,242,1666,531,20,13,14,87,289,62,90,0,0
4557,1571,240,1661,541,20,13,14,90,301,63,90,0,0
4558,1560,246,1656,563,20,13,14,96,317,64,90,0,0
4559,1555,250,1656,583,20,13,14,101,333,65,90,0,0
4560,1549,250,1653,593,20,13,14,104,343,66,90,0,0
4561,1537,255,1646,614,20,13,14,109,359,67,90,0,0
4562,1529,257,1641,626,20,13,14,112,369,68,90,0,0
4563,1525,260,1639,637,20,13,14,114,377,69,90,0,0
4564,1521,269,1638,652,20,13,14,117,383,70,90,0,0
4565,1517,273,1643,685,20,13,14,126,412,71,90,0,0
4566,1509,278,1641,705,20,13,14,132,427,72,90,0,0
4567,1496,293,1632,737,20,13,14,136,444,73,90,0,0
4568,1483,301,1621,751,20,13,14,138,450,74,90,0,0
4569,1470,306,1620,797,20,13,14,150,491,75,90,0,0
4570,1463,318,1619,834,20,13,14,156,516,76,90,0,0
4571,1455,322,1616,855,20,13,14,161,533,77,90,0,0
4572,1452,344,1613,867,20,13,14,161,523,78,90,0,0
4573,1440,366,1613,926,20,13,14,173,560,79,90,0,0
4574,1433,374,1611,946,20,13,14,178,572,80,90,0,0
4575,1422,401,1603,970,20,13,14,181,569,81,90,0,0
4576,1416,427,1608,1019,20,13,14,192,592,82,90,0,0
4577,1408,444,1611,1055,20,13,14,203,611,83,90,0,0
4578,1400,477,1602,1068,20,13,14,202,591,84,90,0,0
4579,1377,520,1573,1068,20,13,14,196,548,85,90,0,0
4580,1347,560,1542,1070,20,13,14,195,510,86,90,0,0
4581,1318,619,1510,1077,20,13,14,192,458,87,90,0,0
4582,1306,693,1485,1075,20,13,14,179,382,88,90,0,0
4583,1283,767,1445,1077,20,13,14,162,310,89,90,0,0
4584,1273,805,1423,1080,20,13,14,150,275,90,90,1,0
4509,1553,163,1588,278,21,13,14,35,115,0,87,0,1
4510,1553,163,1588,277,21,13,14,35,114,1,87,0,0
4511,1553,164,1588,280,21,13,14,35,116,2,87,0,0
4512,1551,166,1587,283,21,13,14,36,117,3,87,0,0
4513,1549,167,1585,286,21,13,14,36,119,4,87,0,0
4514,1547,168,1584,287,21,13,14,37,119,5,87,0,0
4515,1546,169,1584,289,21,13,14,38,120,6,87,0,0
4516,1546,169,1585,293,21,13,14,39,124,7,87,0,0
4517,1544,172,1583,295,21,13,14,39,123,8,87,0,0
4518,1542,173,1580,293,21,13,14,38,120,9,87,0,0
4519,1539,173,1578,297,21,13,14,39,124,10,87,0,0
4520,1539,174,1579,302,21,13,14,40,128,11,87,0,0
4521,1538,173,1579,304,21,13,14,41,131,12,87,0,0
4522,1536,174,1578,308,21,13,14,42,134,13,87,0,0
4523,1535,175,1576,308,21,13,14,41,133,14,87,0,0
4524,1532,176,1575,313,21,13,14,43,137,15,87,0,0
4525,1532,176,1576,315,21,13,14,44,139,16,87,0,0
4526,1533,178,1575,314,21,13,14,42,136,17,87,0,0
4527,1531,177,1576,320,21,13,14,45,143,18,87,0,0
4528,1529,177,1574,323,21,13,14,45,146,19,87,0,0
4529,1527,178,1572,325,21,13,14,45,147,20,87,0,0
4530,1527,181,1573,329,21,13,14,46,148,21,87,0,0
4531,1528,179,1574,329,21,13,14,46,150,22,87,0,0
4532,1526,181,1574,336,21,13,14,48,155,23,87,0,0
4533,1524,182,1573,341,21,13,14,49,159,24,87,0,0
4534,1520,181,1570,343,21,13,14,50,162,25,87,0,0
4535,1518,181,1569,350,21,13,14,51,169,26,87,0,0
4536,1519,181,1570,350,21,13,14,51,169,27,87,0,0
4537,1516,182,1567,355,21,13,14,51,173,28,87,0,0
4538,1512,188,1562,358,21,13,14,50,170,29,87,0,0
4539,1506,185,1558,360,21,13,14,52,175,30,87,0,0
4540,1503,189,1556,365,21,13,14,53,176,31,87,0,0
4541,1502,191,1556,369,21,13,14,54,178,32,87,0,0
4542,1500,192,1554,372,21,13,14,54,180,33,87,0,0
4543,1496,196,1552,380,21,13,14,56,184,34,87,0,0
4544,1492,198,1547,382,21,13,14,55,184,35,87,0,0
4545,1488,200,1546,391,21,13,14,58,191,36,87,0,0
4546,1488,201,1547,396,21,13,14,59,195,37,87,0,0
4547,1488,200,1548,398,21,13,14,60,198,38,87,0,0
4548,1487,202,1547,402,21,13,14,60,200,39,87,0,0
4549,1483,204,1543,406,21,13,14,60,202,40,87,0,0
4550,1479,205,1541,414,21,13,14,62,209,41,87,0,0
4551,1479,208,1543,422,21,13,14,64,214,42,87,0,0
4552,1482,209,1547,427,21,13,14,65,218,43,87,0,0
4553,1483,214,1549,433,21,13,14,66,219,44,87,0,0
4554,1479,218,1546,440,21,13,14,67,222,45,87,0,0
4555,1475,220,1543,443,21,13,14,68,223,46,87,0,0
4556,1474,223,1545,454,21,13,14,71,231,47,87,0,0
4557,1475,222,1549,463,21,13,14,74,241,48,87,0,0
4558,1476,225,1551,469,21,13,14,75,244,49,87,0,0
4559,1471,227,1549,480,21,13,14,78,253,50,87,0,0
4560,1467,227,1545,483,21,13,14,78,256,51,87,0,0
4561,1461,231,1542,493,21,13,14,81,262,52,87,0,0
4562,1459,235,1542,504,21,13,14,83,269,53,87,0,0
4563,1457,237,1542,514,21,13,14,85,277,54,87,0,0
4564,1448,241,1537,530,21,13,14,89,289,55,87,0,0
4565,1440,241,1531,539,21,13,14,91,298,56,87,0,0
4566,1429,241,1526,556,21,13,14,97,315,57,87,0,0
4567,1420,244,1523,581,21,13,14,103,337,58,87,0,0
4568,1410,248,1512,581,21,13,14,102,333,59,87,0,0
4569,1400,253,1505,595,21,13,14,105,342,60,87,0,0
4570,1386,259,1493,608,21,13,14,107,349,61,87,0,0
4571,1376,262,1484,614,21,13,14,108,352,62,87,0,0
4572,1368,270,1482,643,21,13,14,114,373,63,87,0,0
4573,1362,274,1478,655,21,13,14,116,381,64,87,0,0
4574,1355,284,1474,675,21,13,14,119,391,65,87,0,0
4575,1342,295,1466,700,21,13,14,124,405,66,87,0,0
4576,1329,295,1456,711,21,13,14,127,416,67,87,0,0
4577,1314,305,1447,739,21,13,14,133,434,68,87,0,0
4578,1298,313,1441,776,21,13,14,143,463,69,87,0,0
4579,1290,323,1433,780,21,13,14,143,457,70,87,0,0
4580,1264,336,1416,822,21,13,14,152,486,71,87,0,0
4581,1240,337,1397,839,21,13,14,157,502,72,87,0,0
4582,1224,346,1382,847,21,13,14,158,501,73,87,0,0
4583,1204,365,1363,854,21,13,14,159,489,74,87,0,0
4584,1174,380,1349,911,21,13,14,175,531,75,87,0,0
4585,1120,403,1316,987,21,13,14,196,584,76,87,0,0
4586,1086,420,1290,1026,21,13,14,204,606,77,87,0,0
4587,1022,439,1236,1060,21,13,14,214,621,78,87,0,0
4588,977,464,1199,1076,21,13,14,222,612,79,87,0,0
4589,952,489,1174,1080,21,13,14,222,591,80,87,0,0
4590,920,520,1133,1080,21,13,14,213,560,81,87,0,0
4591,863,561,1065,1080,21,13,14,202,519,82,87,0,0
4592,772,600,977,1080,21,13,14,205,480,83,87,0,0
4593,699,657,907,1080,21,13,14,208,423,84,87,0,0
4594,633,720,826,1080,21,13,14,193,360,85,87,0,0
4595,536,781,710,1074,21,13,14,174,293,86,87,0,0
4596,489,817,647,1080,21,13,14,158,263,87,87,1,0
4547,1571,242,1615,405,27,13,14,44,163,0,4,0,0
4548,1566,225,1618,421,27,13,14,52,196,1,4,0,0
4549,1563,225,1618,429,27,13,14,55,204,2,4,0,0
4550,1561,232,1613,424,27,13,14,52,192,3,4,0,0
4551,1561,232,1613,428,27,13,14,52,196,4,4,0,0
4553,1564,235,1615,458,28,13,14,51,223,0,23,0,0
4554,1558,238,1610,464,28,13,14,52,226,1,23,0,0
4555,1559,238,1611,465,28,13,14,52,227,2,23,0,0
4556,1559,248,1610,467,28,13,14,51,219,3,23,0,0
4557,1559,251,1609,468,28,13,14,50,217,4,23,0,0
4559,1542,257,1593,483,28,13,14,51,226,0,23,0,0
4560,1538,260,1590,487,28,13,14,52,227,1,23,0,0
4569,1562,297,1630,604,28,13,14,68,307,0,23,0,1
4570,1565,305,1617,509,28,13,14,52,204,1,23,0,0
4571,1567,305,1610,453,28,13,14,43,148,2,23,0,0
4572,1565,315,1608,449,28,13,14,43,134,3,23,0,0
4573,1556,323,1614,495,28,13,14,58,172,4,23,0,0
4574,1548,325,1616,527,28,13,14,68,202,5,23,0,0
4575,1544,341,1615,546,28,13,14,71,205,6,23,0,0
4576,1531,349,1603,538,28,13,14,72,189,7,23,0,0
4577,1527,360,1617,600,28,13,14,90,240,8,23,0,0
4578,1523,376,1625,648,28,13,14,102,272,9,23,0,0
4579,1508,382,1634,722,28,13,14,126,340,10,23,0,0
4580,1489,396,1647,837,28,13,14,158,441,11,23,0,0
4581,1482,411,1643,862,28,13,14,161,451,12,23,0,0
4582,1459,422,1649,963,28,13,14,190,541,13,23,0,0
4583,1454,447,1651,1012,28,13,14,197,565,14,23,0,0
4584,1452,469,1650,1039,28,13,14,198,570,15,23,0,0
4585,1437,490,1642,1067,28,13,14,205,577,16,23,0,0
4586,1423,524,1623,1075,28,13,14,200,551,17,23,0,0
4587,1408,553,1605,1074,28,13,14,197,521,18,23,0,0
4588,1393,596,1582,1072,28,13,14,189,476,19,23,0,0
4589,1384,660,1563,1074,28,13,14,179,414,20,23,0,0
4590,1372,708,1553,1080,28,13,14,181,372,21,23,0,0
4591,1357,797,1517,1080,28,13,14,160,283,22,23,0,0
4592,1351,831,1503,1080,28,13,14,152,249,23,23,1,0
4568,1564,291,1624,426,29,13,14,60,135,0,0,0,0
4823,0,469,60,734,34,13,14,60,265,0,33,0,1
4824,2,466,66,747,34,13,14,64,281,1,33,0,0
4825,20,443,91,751,34,13,14,71,308,2,33,0,0
4826,31,439,107,759,34,13,14,76,320,3,33,0,0
4827,38,438,121,774,34,13,14,83,336,4,33,0,0
4828,54,448,140,781,34,13,14,86,333,5,33,0,0
4829,66,452,158,792,34,13,14,92,340,6,33,0,0
4830,87,455,187,802,34,13,14,100,347,7,33,0,0
4831,106,462,214,820,34,13,14,108,358,8,33,0,0
4832,118,465,233,834,34,13,14,115,369,9,33,0,0
4833,129,468,254,857,34,13,14,125,389,10,33,0,0
4834,143,469,280,884,34,13,14,137,415,11,33,0,0
4835,161,471,303,891,34,13,14,142,420,12,33,0,0
4836,195,478,353,919,34,13,14,158,441,13,33,0,0
4837,219,479,388,939,34,13,14,169,460,14,33,0,0
4838,242,482,428,976,34,13,14,186,494,15,33,0,0
4839,275,498,472,1010,34,13,14,197,512,16,33,0,0
4840,306,510,502,1006,34,13,14,196,496,17,33,0,0
4841,355,516,574,1050,34,13,14,219,534,18,33,0,0
4842,393,518,622,1068,34,13,14,229,550,19,33,0,0
4843,438,519,673,1075,34,13,14,235,556,20,33,0,0
4844,520,540,760,1079,34,13,14,240,539,21,33,0,0
4845,584,550,830,1080,34,13,14,246,530,22,33,0,0
4846,642,553,893,1080,34,13,14,251,527,23,33,0,0
4847,722,568,969,1080,34,13,14,247,512,24,33,0,0
4848,809,569,1051,1080,34,13,14,242,511,25,33,0,0
4849,953,584,1200,1080,34,13,14,247,496,26,33,0,0
4850,1103,611,1355,1077,34,13,14,252,466,27,33,0,0
4851,1189,624,1430,1075,34,13,14,241,451,28,33,0,0
4852,1287,648,1522,1069,34,13,14,235,421,29,33,0,0
4853,1446,662,1673,1069,34,13,14,227,407,30,33,0,0
4854,1587,674,1812,1073,34,13,14,225,399,31,33,0,0
4855,1711,694,1920,1079,34,13,14,209,385,32,33,0,0
4856,1810,707,1920,1080,34,13,14,110,373,33,33,1,0
280,1309,441,1422,592,1,13,15,113,151,0,0,0,0
281,1170,311,1419,896,2,13,15,249,585,0,12,0,0
282,1134,301,1387,896,2,13,15,253,595,1,12,0,0
283,1023,312,1278,906,2,13,15,255,594,2,12,0,0
284,952,324,1213,931,2,13,15,261,607,3,12,0,0
285,841,327,1125,992,2,13,15,284,665,4,12,0,0
286,729,354,1031,1049,2,13,15,302,695,5,12,0,0
287,613,367,920,1077,2,13,15,307,710,6,12,0,0
288,538,394,835,1080,2,13,15,297,686,7,12,0,0
289,448,441,726,1080,2,13,15,278,639,8,12,0,0
290,325,471,591,1080,2,13,15,266,609,9,12,0,0
291,219,527,474,1080,2,13,15,255,553,10,12,0,0
292,89,590,323,1080,2,13,15,234,490,11,12,0,0
293,0,621,219,1080,2,13,15,219,459,12,12,0,0
311,1374,206,1439,499,3,13,15,65,293,0,37,0,1
312,1345,203,1412,502,3,13,15,67,299,1,37,0,0
313,1330,203,1396,489,3,13,15,66,286,2,37,0,0
314,1298,194,1364,477,3,13,15,66,283,3,37,0,0
315,1261,189,1330,476,3,13,15,69,287,4,37,0,0
316,1241,183,1308,456,3,13,15,67,273,5,37,0,0
317,1222,177,1289,442,3,13,15,67,265,6,37,0,0
318,1205,177,1272,436,3,13,15,67,259,7,37,0,0
319,1191,171,1257,421,3,13,15,66,250,8,37,0,0
320,1188,172,1253,413,3,13,15,65,241,9,37,0,0
321,1183,162,1248,399,3,13,15,65,237,10,37,0,0
322,1182,162,1245,388,3,13,15,63,226,11,37,0,0
323,1180,165,1241,373,3,13,15,61,208,12,37,0,0
324,1179,159,1240,367,3,13,15,61,208,13,37,0,0
325,1179,159,1242,369,3,13,15,63,210,14,37,0,0
326,1181,151,1245,359,3,13,15,64,208,15,37,0,0
327,1183,148,1246,350,3,13,15,63,202,16,37,0,0
328,1184,146,1246,343,3,13,15,62,197,17,37,0,0
329,1188,145,1249,337,3,13,15,61,192,18,37,0,0
330,1195,149,1253,330,3,13,15,58,181,19,37,0,0
331,1201,151,1257,324,3,13,15,56,173,20,37,0,0
332,1204,149,1261,321,3,13,15,57,172,21,37,0,0
333,1205,147,1262,314,3,13,15,57,167,22,37,0,0
334,1210,141,1265,304,3,13,15,55,163,23,37,0,0
335,1214,141,1268,299,3,13,15,54,158,24,37,0,0
336,1217,136,1271,295,3,13,15,54,159,25,37,0,0
337,1218,136,1272,291,3,13,15,54,155,26,37,0,0
338,1217,134,1270,287,3,13,15,53,153,27,37,0,0
339,1215,130,1267,279,3,13,15,52,149,28,37,0,0
340,1215,130,1266,278,3,13,15,51,148,29,37,0,0
341,1213,126,1264,271,3,13,15,51,145,30,37,0,0
342,1210,123,1261,270,3,13,15,51,147,31,37,0,0
343,1203,122,1252,261,3,13,15,49,139,32,37,0,0
344,1197,117,1247,259,3,13,15,50,142,33,37,0,0
345,1191,120,1240,259,3,13,15,49,139,34,37,0,0
346,1185,119,1230,244,3,13,15,45,125,35,37,0,0
347,1175,118,1221,248,3,13,15,46,130,36,37,0,0
348,1172,130,1208,236,3,13,15,36,106,37,37,1,0
1345,1319,284,1430,748,4,13,15,111,464,0,13,0,0
1346,1269,298,1393,808,4,13,15,124,510,1,13,0,0
1347,1234,308,1362,826,4,13,15,128,518,2,13,0,0
1348,1164,321,1301,856,4,13,15,137,535,3,13,0,0
1349,1097,339,1245,901,4,13,15,148,562,4,13,0,0
1350,1036,351,1195,937,4,13,15,159,586,5,13,0,0
1351,946,382,1129,1034,4,13,15,183,652,6,13,0,0
1352,878,418,1068,1074,4,13,15,190,656,7,13,0,0
1353,815,445,1005,1080,4,13,15,190,635,8,13,0,0
1354,727,487,912,1080,4,13,15,185,593,9,13,0,0
1355,605,519,791,1080,4,13,15,186,561,10,13,0,0
1356,450,589,635,1080,4,13,15,185,491,11,13,0,0
1357,308,660,482,1080,4,13,15,174,420,12,13,0,0
1358,223,695,392,1080,4,13,15,169,385,13,13,0,0
1677,1323,212,1440,521,5,13,15,117,309,0,36,0,1
1678,1314,205,1435,527,5,13,15,121,322,1,36,0,0
1679,1302,200,1421,517,5,13,15,119,317,2,36,0,0
1680,1290,196,1404,501,5,13,15,114,305,3,36,0,0
1681,1264,187,1374,486,5,13,15,110,299,4,36,0,0
1682,1244,179,1352,474,5,13,15,108,295,5,36,0,0
1683,1238,176,1340,457,5,13,15,102,281,6,36,0,0
1684,1236,167,1336,445,5,13,15,100,278,7,36,0,0
1685,1239,168,1334,435,5,13,15,95,267,8,36,0,0
1686,1240,166,1330,421,5,13,15,90,255,9,36,0,0
1687,1242,168,1328,416,5,13,15,86,248,10,36,0,0
1688,1243,157,1327,401,5,13,15,84,244,11,36,0,0
1689,1245,153,1330,400,5,13,15,85,247,12,36,0,0
1690,1250,150,1331,390,5,13,15,81,240,13,36,0,0
1691,1255,148,1332,378,5,13,15,77,230,14,36,0,0
1692,1258,147,1334,377,5,13,15,76,230,15,36,0,0
1693,1261,144,1332,360,5,13,15,71,216,16,36,0,0
1694,1264,144,1331,351,5,13,15,67,207,17,36,0,0
1695,1268,143,1332,342,5,13,15,64,199,18,36,0,0
1696,1270,144,1331,337,5,13,15,61,193,19,36,0,0
1697,1268,143,1327,329,5,13,15,59,186,20,36,0,0
1698,1267,144,1322,318,5,13,15,55,174,21,36,0,0
1699,1266,145,1319,314,5,13,15,53,169,22,36,0,0
1700,1262,140,1316,311,5,13,15,54,171,23,36,0,0
1701,1258,136,1311,303,5,13,15,53,167,24,36,0,0
1702,1253,134,1305,297,5,13,15,52,163,25,36,0,0
1703,1247,126,1299,292,5,13,15,52,166,26,36,0,0
1704,1244,125,1295,289,5,13,15,51,164,27,36,0,0
1705,1241,122,1293,287,5,13,15,52,165,28,36,0,0
1706,1238,120,1289,283,5,13,15,51,163,29,36,0,0
1707,1233,121,1282,277,5,13,15,49,156,30,36,0,0
1708,1226,122,1272,269,5,13,15,46,147,31,36,0,0
1709,1217,120,1264,267,5,13,15,47,147,32,36,0,0
1710,1206,119,1253,262,5,13,15,47,143,33,36,0,0
1711,1195,117,1243,263,5,13,15,48,146,34,36,0,0
1712,1182,117,1229,257,5,13,15,47,140,35,36,0,0
1713,1176,115,1222,252,5,13,15,46,137,36,36,1,0
1918,1310,202,1438,497,6,13,15,128,295,0,35,0,1
1919,1301,194,1434,500,6,13,15,133,306,1,35,0,0
1920,1269,187,1402,494,6,13,15,133,307,2,35,0,0
1921,1247,184,1375,480,6,13,15,128,296,3,35,0,0
1922,1232,178,1356,466,6,13,15,124,288,4,35,0,0
1923,1220,175,1341,461,6,13,15,121,286,5,35,0,0
1924,1208,170,1321,440,6,13,15,113,270,6,35,0,0
1925,1204,164,1312,425,6,13,15,108,261,7,35,0,0
1926,1204,165,1307,414,6,13,15,103,249,8,35,0,0
1927,1202,157,1301,401,6,13,15,99,244,9,35,0,0
1928,1200,153,1299,400,6,13,15,99,247,10,35,0,0
1929,1199,149,1292,381,6,13,15,93,232,11,35,0,0
1930,1203,144,1292,370,6,13,15,89,226,12,35,0,0
1931,1206,142,1293,368,6,13,15,87,226,13,35,0,0
1932,1210,139,1298,369,6,13,15,88,230,14,35,0,0
1933,1214,139,1298,359,6,13,15,84,220,15,35,0,0
1934,1215,140,1292,344,6,13,15,77,204,16,35,0,0
1935,1218,140,1291,336,6,13,15,73,196,17,35,0,0
1936,1221,140,1291,330,6,13,15,70,190,18,35,0,0
1937,1225,138,1294,324,6,13,15,69,186,19,35,0,0
1938,1229,134,1296,317,6,13,15,67,183,20,35,0,0
1939,1228,136,1293,315,6,13,15,65,179,21,35,0,0
1940,1230,130,1294,307,6,13,15,64,177,22,35,0,0
1941,1233,128,1294,298,6,13,15,61,170,23,35,0,0
1942,1237,126,1294,284,6,13,15,57,158,24,35,0,0
1943,1237,122,1295,285,6,13,15,58,163,25,35,0,0
1944,1236,124,1292,280,6,13,15,56,156,26,35,0,0
1945,1233,123,1283,263,6,13,15,50,140,27,35,0,0
1946,1227,124,1276,259,6,13,15,49,135,28,35,0,0
1947,1221,123,1269,255,6,13,15,48,132,29,35,0,0
1948,1214,120,1261,247,6,13,15,47,127,30,35,0,0
1949,1205,123,1249,238,6,13,15,44,115,31,35,0,0
1950,1191,120,1235,235,6,13,15,44,115,32,35,0,0
1951,1176,120,1224,246,6,13,15,48,126,33,35,0,0
1952,1171,125,1208,228,6,13,15,37,103,34,35,0,0
1953,1165,125,1200,222,6,13,15,35,97,35,35,1,0
2357,1351,316,1429,515,7,13,15,78,199,0,36,0,1
2358,1338,240,1438,496,7,13,15,100,256,1,36,0,0
2359,1316,217,1423,492,7,13,15,107,275,2,36,0,0
2360,1292,209,1402,493,7,13,15,110,284,3,36,0,0
2361,1273,203,1378,477,7,13,15,105,274,4,36,0,0
2362,1256,201,1355,462,7,13,15,99,261,5,36,0,0
2363,1238,199,1336,457,7,13,15,98,258,6,36,0,0
2364,1227,189,1319,434,7,13,15,92,245,7,36,0,0
2365,1216,186,1305,428,7,13,15,89,242,8,36,0,0
2366,1212,184,1295,410,7,13,15,83,226,9,36,0,0
2367,1210,179,1291,401,7,13,15,81,222,10,36,0,0
2368,1207,179,1284,394,7,13,15,77,215,11,36,0,0
2369,1206,174,1278,377,7,13,15,72,203,12,36,0,0
2370,1204,173,1276,380,7,13,15,72,207,13,36,0,0
2371,1205,168,1273,362,7,13,15,68,194,14,36,0,0
2372,1207,165,1274,358,7,13,15,67,193,15,36,0,0
2373,1209,166,1271,345,7,13,15,62,179,16,36,0,0
2374,1207,162,1268,338,7,13,15,61,176,17,36,0,0
2375,1208,165,1268,336,7,13,15,60,171,18,36,0,0
2376,1210,157,1268,324,7,13,15,58,167,19,36,0,0
2377,1212,156,1267,316,7,13,15,55,160,20,36,0,0
2378,1213,153,1266,306,7,13,15,53,153,21,36,0,0
2379,1212,152,1264,304,7,13,15,52,152,22,36,0,0
2380,1210,150,1263,302,7,13,15,53,152,23,36,0,0
2381,1212,148,1262,294,7,13,15,50,146,24,36,0,0
2382,1212,146,1262,291,7,13,15,50,145,25,36,0,0
2383,1212,145,1260,283,7,13,15,48,138,26,36,0,0
2384,1211,142,1259,280,7,13,15,48,138,27,36,0,0
2385,1210,141,1258,276,7,13,15,48,135,28,36,0,0
2386,1210,137,1257,270,7,13,15,47,133,29,36,0,0
2387,1208,134,1257,271,7,13,15,49,137,30,36,0,0
2388,1204,133,1250,262,7,13,15,46,129,31,36,0,0
2389,1199,131,1245,262,7,13,15,46,131,32,36,0,0
2390,1196,132,1239,257,7,13,15,43,125,33,36,0,0
2391,1190,130,1231,252,7,13,15,41,122,34,36,0,0
2392,1183,131,1224,250,7,13,15,41,119,35,36,0,0
2393,1174,136,1211,245,7,13,15,37,109,36,36,1,0
2545,1304,275,1437,813,9,13,15,133,538,0,15,0,0
2546,1246,296,1383,845,9,13,15,137,549,1,15,0,0
2547,1218,303,1358,855,9,13,15,140,552,2,15,0,0
2548,1131,308,1290,923,9,13,15,159,615,3,15,0,0
2549,1052,316,1221,956,9,13,15,169,640,4,15,0,0
2550,988,331,1163,979,9,13,15,175,648,5,15,0,0
2551,909,361,1094,1034,9,13,15,185,673,6,15,0,0
2552,830,375,1024,1072,9,13,15,194,697,7,15,0,0
2553,738,404,932,1080,9,13,15,194,676,8,15,0,0
2554,652,441,843,1080,9,13,15,191,639,9,15,0,0
2555,557,471,746,1080,9,13,15,189,609,10,15,0,0
2556,443,527,623,1080,9,13,15,180,553,11,15,0,0
2557,307,569,483,1080,9,13,15,176,511,12,15,0,0
2558,163,627,330,1080,9,13,15,167,453,13,15,0,0
2559,36,700,179,1079,9,13,15,143,379,14,15,0,0
2560,0,738,73,1080,9,13,15,73,342,15,15,0,0
3053,7,764,236,1079,10,13,15,229,315,0,21,0,1
3054,97,731,351,1079,10,13,15,254,348,1,21,0,0
3055,178,684,465,1080,10,13,15,287,396,2,21,0,0
3056,255,632,575,1077,10,13,15,320,445,3,21,0,0
3057,353,596,693,1074,10,13,15,340,478,4,21,0,0
3058,456,558,810,1063,10,13,15,354,505,5,21,0,0
3059,526,513,909,1072,10,13,15,383,559,6,21,0,0
3060,601,484,993,1070,10,13,15,392,586,7,21,0,0
3061,664,449,1066,1071,10,13,15,402,622,8,21,0,0
3062,735,418,1144,1071,10,13,15,409,653,9,21,0,0
3063,790,403,1192,1069,10,13,15,402,666,10,21,0,0
3064,857,380,1234,1028,10,13,15,377,648,11,21,0,0
3065,912,359,1274,1009,10,13,15,362,650,12,21,0,0
3066,957,347,1302,991,10,13,15,345,644,13,21,0,0
3067,1017,329,1327,932,10,13,15,310,603,14,21,0,0
3068,1068,326,1351,890,10,13,15,283,564,15,21,0,0
3069,1106,320,1374,863,10,13,15,268,543,16,21,0,0
3070,1170,308,1422,840,10,13,15,252,532,17,21,0,0
3071,1212,308,1453,834,10,13,15,241,526,18,21,0,0
3072,1250,298,1478,812,10,13,15,228,514,19,21,0,0
3073,1291,292,1499,790,10,13,15,208,498,20,21,0,0
3074,1341,277,1549,772,10,13,15,208,495,21,21,1,0
3221,1353,218,1429,515,11,13,15,76,297,0,61,0,1
3222,1323,219,1400,516,11,13,15,77,297,1,61,0,0
3223,1320,220,1409,563,11,13,15,89,343,2,61,0,0
3224,1305,213,1399,571,11,13,15,94,358,3,61,0,0
3225,1280,204,1376,571,11,13,15,96,367,4,61,0,0
3226,1263,200,1358,561,11,13,15,95,361,5,61,0,0
3227,1238,199,1332,549,11,13,15,94,350,6,61,0,0
3228,1209,211,1301,549,11,13,15,92,338,7,61,0,0
3229,1191,212,1283,546,11,13,15,92,334,8,61,0,0
3230,1176,210,1265,525,11,13,15,89,315,9,61,0,0
3231,1163,205,1250,511,11,13,15,87,306,10,61,0,0
3232,1147,204,1234,508,11,13,15,87,304,11,61,0,0
3233,1147,203,1228,489,11,13,15,81,286,12,61,0,0
3234,1140,196,1221,483,11,13,15,81,287,13,61,0,0
3235,1136,190,1215,473,11,13,15,79,283,14,61,0,0
3236,1134,192,1210,459,11,13,15,76,267,15,61,0,0
3237,1134,190,1210,455,11,13,15,76,265,16,61,0,0
3238,1132,185,1204,437,11,13,15,72,252,17,61,0,0
3239,1130,185,1199,426,11,13,15,69,241,18,61,0,0
3240,1129,181,1195,413,11,13,15,66,232,19,61,0,0
3241,1129,181,1192,405,11,13,15,63,224,20,61,0,0
3242,1131,177,1195,404,11,13,15,64,227,21,61,0,0
3243,1136,171,1200,396,11,13,15,64,225,22,61,0,0
3244,1142,167,1205,388,11,13,15,63,221,23,61,0,0
3245,1147,170,1207,380,11,13,15,60,210,24,61,0,0
3246,1155,167,1213,374,11,13,15,58,207,25,61,0,0
3247,1162,167,1221,376,11,13,15,59,209,26,61,0,0
3248,1170,165,1227,368,11,13,15,57,203,27,61,0,0
3249,1176,162,1233,364,11,13,15,57,202,28,61,0,0
3250,1180,162,1237,358,11,13,15,57,196,29,61,0,0
3251,1184,160,1239,350,11,13,15,55,190,30,61,0,0
3252,1186,156,1243,350,11,13,15,57,194,31,61,0,0
3253,1189,152,1246,349,11,13,15,57,197,32,61,0,0
3254,1193,152,1248,339,11,13,15,55,187,33,61,0,0
3255,1198,149,1253,334,11,13,15,55,185,34,61,0,0
3256,1201,148,1256,333,11,13,15,55,185,35,61,0,0
3257,1203,145,1257,330,11,13,15,54,185,36,61,0,0
3258,1206,143,1259,327,11,13,15,53,184,37,61,0,0
3259,1210,141,1264,325,11,13,15,54,184,38,61,0,0
3260,1216,143,1266,310,11,13,15,50,167,39,61,0,0
3261,1216,144,1266,311,11,13,15,50,167,40,61,0,0
3262,1214,142,1264,308,11,13,15,50,166,41,61,0,0
3263,1212,141,1263,306,11,13,15,51,165,42,61,0,0
3264,1213,138,1261,298,11,13,15,48,160,43,61,0,0
3265,1213,139,1262,300,11,13,15,49,161,44,61,0,0
3266,1214,139,1263,298,11,13,15,49,159,45,61,0,0
3267,1217,138,1261,283,11,13,15,44,145,46,61,0,0
3268,1216,136,1263,288,11,13,15,47,152,47,61,0,0
3269,1221,131,1268,282,11,13,15,47,151,48,61,0,0
3270,1222,129,1269,280,11,13,15,47,151,49,61,0,0
3271,1220,129,1266,278,11,13,15,46,149,50,61,0,0
3272,1217,128,1265,279,11,13,15,48,151,51,61,0,0
3273,1215,127,1263,282,11,13,15,48,155,52,61,0,0
3274,1216,128,1264,281,11,13,15,48,153,53,61,0,0
3275,1215,128,1258,265,11,13,15,43,137,54,61,0,0
3276,1216,130,1253,246,11,13,15,37,116,55,61,0,0
3277,1213,129,1252,252,11,13,15,39,123,56,61,0,0
3278,1209,125,1248,248,11,13,15,39,123,57,61,0,0
3279,1204,122,1245,249,11,13,15,41,127,58,61,0,0
3280,1195,120,1235,248,11,13,15,40,128,59,61,0,0
3281,1187,118,1222,233,11,13,15,35,115,60,61,0,0
3282,1184,116,1219,228,11,13,15,35,112,61,61,1,0
3225,1386,211,1446,501,12,13,15,60,290,0,59,0,1
3226,1365,204,1434,533,12,13,15,69,329,1,59,0,0
3227,1347,200,1419,543,12,13,15,72,343,2,59,0,0
3228,1331,199,1402,532,12,13,15,71,333,3,59,0,0
3229,1311,195,1383,527,12,13,15,72,332,4,59,0,0
3230,1287,192,1362,520,12,13,15,75,328,5,59,0,0
3231,1260,188,1337,515,12,13,15,77,327,6,59,0,0
3232,1238,181,1315,500,12,13,15,77,319,7,59,0,0
3233,1225,180,1303,494,12,13,15,78,314,8,59,0,0
3234,1220,178,1298,482,12,13,15,78,304,9,59,0,0
3235,1220,175,1298,469,12,13,15,78,294,10,59,0,0
3236,1221,173,1299,461,12,13,15,78,288,11,59,0,0
3237,1220,172,1296,447,12,13,15,76,275,12,59,0,0
3238,1222,165,1299,437,12,13,15,77,272,13,59,0,0
3239,1225,165,1302,431,12,13,15,77,266,14,59,0,0
3240,1232,160,1309,419,12,13,15,77,259,15,59,0,0
3241,1238,158,1315,415,12,13,15,77,257,16,59,0,0
3242,1239,157,1315,409,12,13,15,76,252,17,59,0,0
3243,1237,154,1313,402,12,13,15,76,248,18,59,0,0
3244,1237,151,1313,396,12,13,15,76,245,19,59,0,0
3245,1241,149,1316,389,12,13,15,75,240,20,59,0,0
3246,1246,145,1321,386,12,13,15,75,241,21,59,0,0
3247,1249,142,1323,379,12,13,15,74,237,22,59,0,0
3248,1250,144,1323,374,12,13,15,73,230,23,59,0,0
3249,1247,141,1321,372,12,13,15,74,231,24,59,0,0
3250,1244,138,1318,368,12,13,15,74,230,25,59,0,0
3251,1249,141,1321,363,12,13,15,72,222,26,59,0,0
3252,1255,139,1329,366,12,13,15,74,227,27,59,0,0
3253,1261,140,1331,352,12,13,15,70,212,28,59,0,0
3254,1264,145,1329,344,12,13,15,65,199,29,59,0,0
3255,1262,142,1327,341,12,13,15,65,199,30,59,0,0
3256,1262,138,1326,335,12,13,15,64,197,31,59,0,0
3257,1264,137,1328,332,12,13,15,64,195,32,59,0,0
3258,1264,133,1327,326,12,13,15,63,193,33,59,0,0
3259,1265,130,1328,323,12,13,15,63,193,34,59,0,0
3260,1268,131,1328,320,12,13,15,60,189,35,59,0,0
3261,1267,128,1325,310,12,13,15,58,182,36,59,0,0
3262,1268,124,1325,304,12,13,15,57,180,37,59,0,0
3263,1271,127,1326,301,12,13,15,55,174,38,59,0,0
3264,1273,126,1328,300,12,13,15,55,174,39,59,0,0
3265,1274,127,1328,298,12,13,15,54,171,40,59,0,0
3266,1280,129,1334,299,12,13,15,54,170,41,59,0,0
3267,1283,125,1336,294,12,13,15,53,169,42,59,0,0
3268,1283,122,1338,294,12,13,15,55,172,43,59,0,0
3269,1284,122,1339,291,12,13,15,55,169,44,59,0,0
3270,1286,117,1341,287,12,13,15,55,170,45,59,0,0
3271,1283,117,1339,285,12,13,15,56,168,46,59,0,0
3272,1280,118,1333,276,12,13,15,53,158,47,59,0,0
3273,1273,117,1326,272,12,13,15,53,155,48,59,0,0
3274,1268,118,1320,270,12,13,15,52,152,49,59,0,0
3275,1264,116,1316,269,12,13,15,52,153,50,59,0,0
3276,1258,113,1309,264,12,13,15,51,151,51,59,0,0
3277,1252,115,1301,261,12,13,15,49,146,52,59,0,0
3278,1245,117,1293,259,12,13,15,48,142,53,59,0,0
3279,1236,114,1283,256,12,13,15,47,142,54,59,0,0
3280,1224,114,1271,253,12,13,15,47,139,55,59,0,0
3281,1213,113,1256,243,12,13,15,43,130,56,59,0,0
3282,1195,108,1241,246,12,13,15,46,138,57,59,0,0
3283,1185,110,1229,246,12,13,15,44,136,58,59,0,0
3284,1177,109,1221,243,12,13,15,44,134,59,59,1,0
3228,1275,197,1341,523,13,13,15,66,326,0,1,0,0
3229,1267,199,1325,487,13,13,15,58,288,1,1,0,0
3231,1322,198,1389,473,14,13,15,67,275,0,40,0,1
3232,1318,194,1384,463,14,13,15,66,269,1,40,0,0
3233,1316,192,1380,453,14,13,15,64,261,2,40,0,0
3234,1317,188,1379,440,14,13,15,62,252,3,40,0,0
3235,1318,187,1380,437,14,13,15,62,250,4,40,0,0
3236,1317,185,1379,432,14,13,15,62,247,5,40,0,0
3237,1316,180,1377,419,14,13,15,61,239,6,40,0,0
3238,1316,177,1377,409,14,13,15,61,232,7,40,0,0
3239,1316,174,1377,402,14,13,15,61,228,8,40,0,0
3240,1313,169,1378,415,14,13,15,65,246,9,40,0,0
3241,1314,168,1375,401,14,13,15,61,233,10,40,0,0
3242,1311,166,1373,401,14,13,15,62,235,11,40,0,0
3243,1308,159,1370,390,14,13,15,62,231,12,40,0,0
3244,1308,156,1368,380,14,13,15,60,224,13,40,0,0
3245,1314,161,1371,373,14,13,15,57,212,14,40,0,0
3246,1319,164,1375,366,14,13,15,56,202,15,40,0,0
3247,1322,166,1374,355,14,13,15,52,189,16,40,0,0
3248,1320,163,1374,357,14,13,15,54,194,17,40,0,0
3249,1314,155,1369,351,14,13,15,55,196,18,40,0,0
3250,1313,152,1369,349,14,13,15,56,197,19,40,0,0
3251,1315,150,1373,353,14,13,15,58,203,20,40,0,0
3252,1317,146,1378,359,14,13,15,61,213,21,40,0,0
3253,1323,145,1380,347,14,13,15,57,202,22,40,0,0
3254,1327,149,1380,335,14,13,15,53,186,23,40,0,0
3255,1325,144,1377,326,14,13,15,52,182,24,40,0,0
3256,1323,140,1377,326,14,13,15,54,186,25,40,0,0
3257,1324,141,1376,321,14,13,15,52,180,26,40,0,0
3258,1324,139,1377,319,14,13,15,53,180,27,40,0,0
3259,1325,139,1376,313,14,13,15,51,174,28,40,0,0
3260,1327,141,1377,308,14,13,15,50,167,29,40,0,0
3261,1325,140,1372,294,14,13,15,47,154,30,40,0,0
3262,1323,137,1372,298,14,13,15,49,161,31,40,0,0
3263,1326,137,1374,293,14,13,15,48,156,32,40,0,0
3264,1326,135,1375,295,14,13,15,49,160,33,40,0,0
3265,1326,135,1375,294,14,13,15,49,159,34,40,0,0
3266,1327,136,1373,287,14,13,15,46,151,35,40,0,0
3267,1329,135,1371,273,14,13,15,42,138,36,40,0,0
3268,1330,136,1366,254,14,13,15,36,118,37,40,0,0
3269,1324,134,1363,264,14,13,15,39,130,38,40,0,0
3270,1322,131,1360,260,14,13,15,38,129,39,40,0,0
3271,1321,130,1358,256,14,13,15,37,126,40,40,1,0
3278,1232,118,1270,251,14,13,15,38,133,0,40,0,0
3279,1224,116,1261,249,14,13,15,37,133,1,40,0,0
3237,1277,176,1319,268,16,13,15,42,92,0,0,0,0
3266,1259,133,1300,278,18,13,15,41,145,0,3,0,0
3267,1258,132,1293,255,18,13,15,35,123,1,3,0,0
3268,1252,133,1287,257,18,13,15,35,124,2,3,0,0
3269,1249,134,1284,255,18,13,15,35,121,3,3,0,0
3530,1175,115,1215,254,20,13,15,40,139,0,40,0,1
3531,1182,114,1223,256,20,13,15,41,142,1,40,0,0
3532,1194,113,1238,263,20,13,15,44,150,2,40,0,0
3533,1201,115,1247,269,20,13,15,46,154,3,40,0,0
3534,1209,115,1256,273,20,13,15,47,158,4,40,0,0
3535,1216,119,1263,277,20,13,15,47,158,5,40,0,0
3536,1221,120,1271,285,20,13,15,50,165,6,40,0,0
3537,1223,119,1276,291,20,13,15,53,172,7,40,0,0
3538,1224,123,1277,294,20,13,15,53,171,8,40,0,0
3539,1222,122,1276,295,20,13,15,54,173,9,40,0,0
3540,1221,127,1274,297,20,13,15,53,170,10,40,0,0
3541,1220,130,1274,302,20,13,15,54,172,11,40,0,0
3542,1217,129,1273,307,20,13,15,56,178,12,40,0,0
3543,1211,132,1269,315,20,13,15,58,183,13,40,0,0
3544,1205,131,1264,319,20,13,15,59,188,14,40,0,0
3545,1201,132,1262,325,20,13,15,61,193,15,40,0,0
3546,1197,135,1260,331,20,13,15,63,196,16,40,0,0
3547,1193,135,1257,338,20,13,15,64,203,17,40,0,0
3548,1189,138,1254,345,20,13,15,65,207,18,40,0,0
3549,1182,139,1248,350,20,13,15,66,211,19,40,0,0
3550,1175,138,1243,357,20,13,15,68,219,20,40,0,0
3551,1166,141,1235,366,20,13,15,69,225,21,40,0,0
3552,1153,140,1223,368,20,13,15,70,228,22,40,0,0
3553,1137,144,1209,378,20,13,15,72,234,23,40,0,0
3554,1119,147,1193,385,20,13,15,74,238,24,40,0,0
3555,1105,148,1180,390,20,13,15,75,242,25,40,0,0
3556,1092,153,1170,402,20,13,15,78,249,26,40,0,0
3557,1084,153,1163,405,20,13,15,79,252,27,40,0,0
3558,1076,157,1159,422,20,13,15,83,265,28,40,0,0
3559,1070,160,1157,433,20,13,15,87,273,29,40,0,0
3560,1067,158,1159,441,20,13,15,92,283,30,40,0,0
3561,1072,165,1168,456,20,13,15,96,291,31,40,0,0
3562,1085,168,1183,464,20,13,15,98,296,32,40,0,0
3563,1105,173,1204,473,20,13,15,99,300,33,40,0,0
3564,1126,179,1230,496,20,13,15,104,317,34,40,0,0
3565,1156,172,1265,506,20,13,15,109,334,35,40,0,0
3566,1182,178,1299,528,20,13,15,117,350,36,40,0,0
3567,1214,178,1336,539,20,13,15,122,361,37,40,0,0
3568,1261,189,1381,549,20,13,15,120,360,38,40,0,0
3569,1300,199,1416,540,20,13,15,116,341,39,40,0,0
3570,1313,203,1431,548,20,13,15,118,345,40,40,1,0
3547,1364,173,1454,519,21,13,15,90,346,0,45,0,1
3548,1342,191,1429,524,21,13,15,87,333,1,45,0,0
3549,1309,191,1395,512,21,13,15,86,321,2,45,0,0
3550,1283,193,1367,501,21,13,15,84,308,3,45,0,0
3551,1247,186,1332,496,21,13,15,85,310,4,45,0,0
3552,1215,183,1303,495,21,13,15,88,312,5,45,0,0
3553,1193,182,1278,474,21,13,15,85,292,6,45,0,0
3554,1177,178,1262,468,21,13,15,85,290,7,45,0,0
3555,1168,177,1252,457,21,13,15,84,280,8,45,0,0
3556,1163,170,1244,437,21,13,15,81,267,9,45,0,0
3557,1160,168,1241,431,21,13,15,81,263,10,45,0,0
3558,1164,166,1240,410,21,13,15,76,244,11,45,0,0
3559,1167,159,1244,401,21,13,15,77,242,12,45,0,0
3560,1171,157,1249,401,21,13,15,78,244,13,45,0,0
3561,1175,152,1251,387,21,13,15,76,235,14,45,0,0
3562,1181,148,1255,378,21,13,15,74,230,15,45,0,0
3563,1191,151,1262,372,21,13,15,71,221,16,45,0,0
3564,1206,148,1266,338,21,13,15,60,190,17,45,0,0
3565,1206,146,1263,325,21,13,15,57,179,18,45,0,0
3566,1209,144,1261,301,21,13,15,52,157,19,45,0,0
3567,1209,142,1273,333,21,13,15,64,191,20,45,0,0
3568,1212,139,1278,337,21,13,15,66,198,21,45,0,0
3569,1219,139,1286,336,21,13,15,67,197,22,45,0,0
3570,1228,138,1294,334,21,13,15,66,196,23,45,0,0
3571,1233,138,1298,328,21,13,15,65,190,24,45,0,0
3572,1236,137,1299,319,21,13,15,63,182,25,45,0,0
3573,1239,137,1300,317,21,13,15,61,180,26,45,0,0
3574,1245,138,1305,308,21,13,15,60,170,27,45,0,0
3575,1247,134,1306,302,21,13,15,59,168,28,45,0,0
3576,1249,133,1308,300,21,13,15,59,167,29,45,0,0
3577,1249,127,1308,293,21,13,15,59,166,30,45,0,0
3578,1247,125,1306,290,21,13,15,59,165,31,45,0,0
3579,1248,128,1305,289,21,13,15,57,161,32,45,0,0
3580,1246,123,1304,284,21,13,15,58,161,33,45,0,0
3581,1246,121,1301,277,21,13,15,55,156,34,45,0,0
3582,1244,123,1297,274,21,13,15,53,151,35,45,0,0
3583,1241,121,1293,269,21,13,15,52,148,36,45,0,0
3584,1236,120,1286,263,21,13,15,50,143,37,45,0,0
3585,1232,123,1279,257,21,13,15,47,134,38,45,0,0
3586,1223,121,1271,254,21,13,15,48,133,39,45,0,0
3587,1213,120,1262,256,21,13,15,49,136,40,45,0,0
3588,1201,117,1250,253,21,13,15,49,136,41,45,0,0
3589,1187,117,1235,248,21,13,15,48,131,42,45,0,0
3590,1174,117,1221,248,21,13,15,47,131,43,45,0,0
3591,1167,121,1207,237,21,13,15,40,116,44,45,0,0
3592,1161,121,1199,233,21,13,15,38,112,45,45,1,0
3550,1369,220,1441,496,22,13,15,72,276,0,25,0,0
3551,1348,214,1419,487,22,13,15,71,273,1,25,0,0
3552,1317,206,1394,494,22,13,15,77,288,2,25,0,0
3553,1292,201,1370,490,22,13,15,78,289,3,25,0,0
3554,1278,199,1353,479,22,13,15,75,280,4,25,0,0
3555,1268,202,1340,469,22,13,15,72,267,5,25,0,0
3556,1262,197,1331,454,22,13,15,69,257,6,25,0,0
3557,1257,195,1325,446,22,13,15,68,251,7,25,0,0
3558,1257,190,1323,434,22,13,15,66,244,8,25,0,0
3559,1261,184,1325,415,22,13,15,64,231,9,25,0,0
3560,1267,185,1329,404,22,13,15,62,219,10,25,0,0
3561,1272,180,1334,397,22,13,15,62,217,11,25,0,0
3562,1277,176,1339,394,22,13,15,62,218,12,25,0,0
3563,1280,175,1341,390,22,13,15,61,215,13,25,0,0
3564,1283,173,1343,379,22,13,15,60,206,14,25,0,0
3565,1287,173,1345,374,22,13,15,58,201,15,25,0,0
3566,1294,171,1350,361,22,13,15,56,190,16,25,0,0
3567,1295,168,1349,352,22,13,15,54,184,17,25,0,0
3569,1299,163,1353,350,22,13,15,54,187,0,25,0,1
3570,1303,166,1353,336,22,13,15,50,170,1,25,0,0
3571,1303,165,1355,339,22,13,15,52,174,2,25,0,0
3572,1303,157,1355,331,22,13,15,52,174,3,25,0,0
3573,1304,155,1355,325,22,13,15,51,170,4,25,0,0
3574,1304,153,1353,319,22,13,15,49,166,5,25,0,0
3575,1306,154,1352,309,22,13,15,46,155,6,25,0,0
3576,1305,154,1350,308,22,13,15,45,154,7,25,0,0
3577,1307,155,1349,298,22,13,15,42,143,8,25,0,0
3578,1306,149,1351,296,22,13,15,45,147,9,25,0,0
3579,1305,148,1349,293,22,13,15,44,145,10,25,0,0
3580,1301,141,1346,289,22,13,15,45,148,11,25,0,0
3581,1296,138,1341,287,22,13,15,45,149,12,25,0,0
3582,1292,139,1335,283,22,13,15,43,144,13,25,0,0
3583,1288,134,1332,279,22,13,15,44,145,14,25,0,0
3584,1285,133,1328,278,22,13,15,43,145,15,25,0,0
3585,1279,131,1322,276,22,13,15,43,145,16,25,0,0
3586,1273,129,1315,270,22,13,15,42,141,17,25,0,0
3587,1264,130,1305,267,22,13,15,41,137,18,25,0,0
3588,1258,126,1296,253,22,13,15,38,127,19,25,0,0
3589,1248,126,1286,252,22,13,15,38,126,20,25,0,0
3590,1236,127,1276,254,22,13,15,40,127,21,25,0,0
3591,1219,123,1258,250,22,13,15,39,127,22,25,0,0
3592,1204,125,1242,246,22,13,15,38,121,23,25,0,0
3593,1185,123,1223,247,22,13,15,38,124,24,25,0,0
3594,1176,122,1213,243,22,13,15,37,121,25,25,1,0
3568,1302,162,1352,293,23,13,15,50,131,0,0,0,0
4518,3,747,269,1074,24,13,15,266,327,0,0,0,0
4519,217,689,500,1070,25,13,15,283,381,0,0,0,0
4520,397,602,729,1071,26,13,15,332,469,0,0,0,0
4521,607,567,876,1072,27,13,15,269,505,0,0,0,0
4522,754,495,1055,1074,28,13,15,301,579,0,9,0,0
4523,857,446,1184,1074,28,13,15,327,628,1,9,0,0
4524,909,419,1252,1071,28,13,15,343,652,2,9,0,0
4525,962,370,1327,1071,28,13,15,365,701,3,9,0,0
4526,1018,346,1387,1066,28,13,15,369,720,4,9,0,0
4527,1074,325,1426,1019,28,13,15,352,694,5,9,0,0
4528,1155,304,1468,933,28,13,15,313,629,6,9,0,0
4529,1188,295,1483,899,28,13,15,295,604,7,9,0,0
4530,1242,282,1506,844,28,13,15,264,562,8,9,0,0
4531,1290,262,1550,813,28,13,15,260,551,9,9,0,0
4840,0,732,139,1069,29,13,15,139,337,0,1,0,0
4841,57,666,227,1075,29,13,15,170,409,1,1,0,0
4842,119,584,451,1077,30,13,15,332,493,0,17,0,0
4843,184,538,545,1074,30,13,15,361,536,1,17,0,0
4844,274,520,641,1070,30,13,15,367,550,2,17,0,0
4845,365,480,756,1071,30,13,15,391,591,3,17,0,0
4846,449,447,856,1070,30,13,15,407,623,4,17,0,0
4847,530,426,944,1071,30,13,15,414,645,5,17,0,0
4848,606,396,1021,1062,30,13,15,415,666,6,17,0,0
4849,698,378,1087,1018,30,13,15,389,640,7,17,0,0
4850,756,370,1130,1000,30,13,15,374,630,8,17,0,0
4851,843,347,1184,940,30,13,15,341,593,9,17,0,0
4852,921,326,1254,913,30,13,15,333,587,10,17,0,0
4853,983,317,1304,897,30,13,15,321,580,11,17,0,0
4854,1060,305,1349,845,30,13,15,289,540,12,17,0,0
4855,1119,303,1386,810,30,13,15,267,507,13,17,0,0
4856,1161,308,1421,801,30,13,15,260,493,14,17,0,0
4857,1235,303,1475,776,30,13,15,240,473,15,17,0,0
4858,1272,329,1486,769,30,13,15,214,440,16,17,0,0
4859,1332,322,1540,749,30,13,15,208,427,17,17,0,0
4850,1,816,154,1074,31,13,15,153,258,0,22,0,1
4851,33,751,225,1075,31,13,15,192,324,1,22,0,0
4852,92,710,308,1075,31,13,15,216,365,2,22,0,0
4853,170,647,423,1075,31,13,15,253,428,3,22,0,0
4854,246,594,527,1068,31,13,15,281,474,4,22,0,0
4855,323,557,626,1072,31,13,15,303,515,5,22,0,0
4856,373,508,698,1071,31,13,15,325,563,6,22,0,0
4857,430,501,758,1062,31,13,15,328,561,7,22,0,0
4858,472,516,795,1067,31,13,15,323,551,8,22,0,0
4859,524,462,874,1069,31,13,15,350,607,9,22,0,0
4860,608,471,947,1068,31,13,15,339,597,10,22,0,0
4861,690,441,1043,1070,31,13,15,353,629,11,22,0,0
4862,752,427,1112,1068,31,13,15,360,641,12,22,0,0
4863,798,396,1155,1050,31,13,15,357,654,13,22,0,0
4864,868,380,1199,1004,31,13,15,331,624,14,22,0,0
4865,918,359,1236,969,31,13,15,318,610,15,22,0,0
4866,998,341,1303,939,31,13,15,305,598,16,22,0,0
4867,1064,332,1362,923,31,13,15,298,591,17,22,0,0
4868,1128,325,1400,881,31,13,15,272,556,18,22,0,0
4869,1193,318,1442,842,31,13,15,249,524,19,22,0,0
4870,1226,304,1463,817,31,13,15,237,513,20,22,0,0
4871,1257,301,1463,751,31,13,15,206,450,21,22,0,0
4872,1309,284,1511,726,31,13,15,202,442,22,22,1,0
4853,2,855,102,1076,32,13,15,100,221,0,0,0,0
4861,755,397,906,613,34,13,15,151,216,0,4,0,0
4862,788,368,943,590,34,13,15,155,222,1,4,0,0
4863,842,362,983,565,34,13,15,141,203,2,4,0,0
4864,876,341,1042,583,34,13,15,166,242,3,4,0,0
4865,905,330,1078,581,34,13,15,173,251,4,4,0,0
4866,957,339,1153,776,35,13,15,196,437,0,0,0,0
4867,1088,320,1211,656,36,13,15,123,336,0,1,0,0
4868,1104,339,1250,736,36,13,15,146,397,1,1,0,0
4966,1333,194,1444,514,37,13,15,111,320,0,38,0,1
4967,1331,187,1442,508,37,13,15,111,321,1,38,0,0
4968,1318,187,1426,500,37,13,15,108,313,2,38,0,0
4969,1288,185,1394,490,37,13,15,106,305,3,38,0,0
4970,1272,178,1376,479,37,13,15,104,301,4,38,0,0
4971,1255,174,1358,472,37,13,15,103,298,5,38,0,0
4972,1240,171,1338,453,37,13,15,98,282,6,38,0,0
4973,1229,169,1324,442,37,13,15,95,273,7,38,0,0
4974,1223,163,1313,423,37,13,15,90,260,8,38,0,0
4975,1219,152,1310,414,37,13,15,91,262,9,38,0,0
4976,1217,154,1303,405,37,13,15,86,251,10,38,0,0
4977,1210,149,1295,394,37,13,15,85,245,11,38,0,0
4978,1207,149,1291,393,37,13,15,84,244,12,38,0,0
4979,1206,145,1287,380,37,13,15,81,235,13,38,0,0
4980,1201,142,1290,404,37,13,15,89,262,14,38,0,0
4981,1204,140,1287,386,37,13,15,83,246,15,38,0,0
4982,1207,139,1284,369,37,13,15,77,230,16,38,0,0
4983,1209,139,1283,361,37,13,15,74,222,17,38,0,0
4984,1212,139,1284,353,37,13,15,72,214,18,38,0,0
4985,1213,138,1281,344,37,13,15,68,206,19,38,0,0
4986,1213,139,1278,335,37,13,15,65,196,20,38,0,0
4987,1211,139,1274,327,37,13,15,63,188,21,38,0,0
4988,1212,138,1272,317,37,13,15,60,179,22,38,0,0
4989,1210,135,1269,313,37,13,15,59,178,23,38,0,0
4990,1208,134,1266,309,37,13,15,58,175,24,38,0,0
4991,1206,133,1264,306,37,13,15,58,173,25,38,0,0
4992,1205,129,1263,303,37,13,15,58,174,26,38,0,0
4993,1205,129,1262,301,37,13,15,57,172,27,38,0,0
4994,1203,123,1261,298,37,13,15,58,175,28,38,0,0
4995,1202,122,1259,294,37,13,15,57,172,29,38,0,0
4996,1199,120,1254,290,37,13,15,55,170,30,38,0,0
4997,1198,120,1251,283,37,13,15,53,163,31,38,0,0
4998,1198,119,1250,277,37,13,15,52,158,32,38,0,0
4999,1196,117,1247,273,37,13,15,51,156,33,38,0,0
5000,1195,118,1243,267,37,13,15,48,149,34,38,0,0
5001,1189,118,1236,263,37,13,15,47,145,35,38,0,0
5002,1182,117,1229,259,37,13,15,47,142,36,38,0,0
5003,1175,113,1221,257,37,13,15,46,144,37,38,0,0
5004,1172,112,1217,253,37,13,15,45,141,38,38,1,0
5381,0,853,136,1080,38,13,15,136,227,0,0,0,0
5382,81,781,287,1073,39,13,15,206,292,0,0,0,0
5383,206,736,536,1080,40,13,15,330,344,0,16,0,0
5384,293,708,640,1072,40,13,15,347,364,1,16,0,0
5385,391,655,788,1074,40,13,15,397,419,2,16,0,0
5386,497,608,940,1077,40,13,15,443,469,3,16,0,0
5387,568,566,1043,1076,40,13,15,475,510,4,16,0,0
5388,614,518,1124,1078,40,13,15,510,560,5,16,0,0
5389,671,488,1195,1077,40,13,15,524,589,6,16,0,0
5390,737,453,1272,1074,40,13,15,535,621,7,16,0,0
5391,805,416,1348,1069,40,13,15,543,653,8,16,0,0
5392,861,396,1397,1066,40,13,15,536,670,9,16,0,0
5393,919,368,1419,1020,40,13,15,500,652,10,16,0,0
5394,980,344,1431,955,40,13,15,451,611,11,16,0,0
5395,1032,346,1446,923,40,13,15,414,577,12,16,0,0
5396,1102,331,1490,892,40,13,15,388,561,13,16,0,0
5397,1157,320,1523,874,40,13,15,366,554,14,16,0,0
5398,1207,323,1538,849,40,13,15,331,526,15,16,0,0
5399,1262,301,1597,832,40,13,15,335,531,16,16,0,0
5501,1330,443,1426,562,41,13,15,96,119,0,0,0,0
5502,1282,300,1432,832,42,13,15,150,532,0,17,0,0
5503,1274,296,1423,825,42,13,15,149,529,1,17,0,0
5504,1204,315,1357,846,42,13,15,153,531,2,17,0,0
5505,1150,320,1311,867,42,13,15,161,547,3,17,0,0
5506,1065,318,1247,922,42,13,15,182,604,4,17,0,0
5507,978,339,1178,981,42,13,15,200,642,5,17,0,0
5508,912,353,1121,1011,42,13,15,209,658,6,17,0,0
5509,836,368,1054,1039,42,13,15,218,671,7,17,0,0
5510,787,402,1005,1057,42,13,15,218,655,8,17,0,0
5511,701,415,927,1078,42,13,15,226,663,9,17,0,0
5512,602,442,831,1080,42,13,15,229,638,10,17,0,0
5513,531,485,759,1080,42,13,15,228,595,11,17,0,0
5514,487,512,716,1080,42,13,15,229,568,12,17,0,0
5515,461,548,690,1079,42,13,15,229,531,13,17,0,0
5516,452,596,677,1075,42,13,15,225,479,14,17,0,0
5517,483,630,718,1074,42,13,15,235,444,15,17,0,0
5518,574,682,814,1075,42,13,15,240,393,16,17,0,0
5519,565,713,791,1080,42,13,15,226,367,17,17,0,0
5577,1350,243,1435,496,44,13,15,85,253,0,42,0,1
5578,1345,243,1429,493,44,13,15,84,250,1,42,0,0
5579,1330,235,1418,496,44,13,15,88,261,2,42,0,0
5580,1314,231,1398,483,44,13,15,84,252,3,42,0,0
5581,1294,223,1377,469,44,13,15,83,246,4,42,0,0
5582,1272,216,1359,471,44,13,15,87,255,5,42,0,0
5583,1257,211,1340,455,44,13,15,83,244,6,42,0,0
5584,1246,209,1325,441,44,13,15,79,232,7,42,0,0
5585,1232,204,1310,430,44,13,15,78,226,8,42,0,0
5586,1225,197,1302,419,44,13,15,77,222,9,42,0,0
5587,1219,197,1293,413,44,13,15,74,216,10,42,0,0
5588,1212,193,1284,405,44,13,15,72,212,11,42,0,0
5589,1204,193,1275,397,44,13,15,71,204,12,42,0,0
5590,1203,185,1272,383,44,13,15,69,198,13,42,0,0
5591,1199,181,1269,383,44,13,15,70,202,14,42,0,0
5592,1192,180,1263,388,44,13,15,71,208,15,42,0,0
5593,1190,176,1260,384,44,13,15,70,208,16,42,0,0
5594,1186,176,1254,379,44,13,15,68,203,17,42,0,0
5595,1187,174,1248,356,44,13,15,61,182,18,42,0,0
5596,1186,171,1247,353,44,13,15,61,182,19,42,0,0
5597,1187,170,1243,339,44,13,15,56,169,20,42,0,0
5598,1187,169,1242,331,44,13,15,55,162,21,42,0,0
5599,1190,167,1243,323,44,13,15,53,156,22,42,0,0
5600,1191,162,1244,318,44,13,15,53,156,23,42,0,0
5601,1192,157,1245,315,44,13,15,53,158,24,42,0,0
5602,1192,154,1244,308,44,13,15,52,154,25,42,0,0
5603,1193,153,1243,305,44,13,15,50,152,26,42,0,0
5604,1195,154,1243,299,44,13,15,48,145,27,42,0,0
5605,1196,152,1243,297,44,13,15,47,145,28,42,0,0
5606,1196,152,1242,290,44,13,15,46,138,29,42,0,0
5607,1196,149,1241,286,44,13,15,45,137,30,42,0,0
5608,1197,147,1241,284,44,13,15,44,137,31,42,0,0
5609,1199,145,1242,275,44,13,15,43,130,32,42,0,0
5610,1200,144,1242,274,44,13,15,42,130,33,42,0,0
5611,1199,142,1241,269,44,13,15,42,127,34,42,0,0
5612,1198,141,1240,267,44,13,15,42,126,35,42,0,0
5613,1197,140,1238,265,44,13,15,41,125,36,42,0,0
5614,1195,136,1237,265,44,13,15,42,129,37,42,0,0
5615,1192,136,1233,261,44,13,15,41,125,38,42,0,0
5616,1186,135,1227,259,44,13,15,41,124,39,42,0,0
5617,1179,135,1219,257,44,13,15,40,122,40,42,0,0
5618,1174,135,1211,252,44,13,15,37,117,41,42,0,0
5619,1171,133,1208,248,44,13,15,37,115,42,42,1,0
5584,7,749,235,1075,45,13,15,228,326,0,1,0,0
5585,9,710,262,1073,45,13,15,253,363,1,1,0,0
5586,155,723,390,1073,46,13,15,235,350,0,0,0,0
5587,268,648,519,1076,48,13,15,251,428,0,3,0,0
5588,372,624,635,1071,48,13,15,263,447,1,3,0,0
5589,415,591,679,1043,48,13,15,264,452,2,3,0,0
5590,446,574,713,1031,48,13,15,267,457,3,3,0,0
5589,495,698,870,1078,49,13,15,375,380,0,244,0,1
5590,546,576,1037,1073,49,13,15,491,497,1,244,0,0
5591,627,534,1157,1069,49,13,15,530,535,2,244,0,0
5592,696,514,1243,1065,49,13,15,547,551,3,244,0,0
5593,654,498,1204,1067,49,13,15,550,569,4,244,0,0
5594,661,478,1214,1069,49,13,15,553,591,5,244,0,0
5595,692,451,1250,1072,49,13,15,558,621,6,244,0,0
5596,733,440,1278,1072,49,13,15,545,632,7,244,0,0
5597,787,441,1309,1069,49,13,15,522,628,8,244,0,0
5598,824,438,1326,1068,49,13,15,502,630,9,244,0,0
5599,878,432,1357,1057,49,13,15,479,625,10,244,0,0
5600,921,422,1384,1058,49,13,15,463,636,11,244,0,0
5601,935,417,1377,1059,49,13,15,442,642,12,244,0,0
5602,961,406,1391,1059,49,13,15,430,653,13,244,0,0
5603,973,399,1392,1060,49,13,15,419,661,14,244,0,0
5604,972,398,1370,1058,49,13,15,398,660,15,244,0,0
5605,976,398,1355,1058,49,13,15,379,660,16,244,0,0
5606,985,399,1348,1060,49,13,15,363,661,17,244,0,0
5607,992,400,1339,1060,49,13,15,347,660,18,244,0,0
5608,995,401,1326,1058,49,13,15,331,657,19,244,0,0
5609,999,402,1315,1058,49,13,15,316,656,20,244,0,0
5610,1005,406,1309,1065,49,13,15,304,659,21,244,0,0
5611,1012,406,1303,1058,49,13,15,291,652,22,244,0,0
5612,1016,406,1295,1056,49,13,15,279,650,23,244,0,0
5613,1019,406,1289,1056,49,13,15,270,650,24,244,0,0
5614,1022,404,1286,1059,49,13,15,264,655,25,244,0,0
5615,1027,404,1282,1057,49,13,15,255,653,26,244,0,0
5616,1039,404,1289,1060,49,13,15,250,656,27,244,0,0
5617,1049,405,1294,1060,49,13,15,245,655,28,244,0,0
5618,1051,407,1293,1061,49,13,15,242,654,29,244,0,0
5619,1046,413,1283,1063,49,13,15,237,650,30,244,0,0
5620,1037,418,1267,1057,49,13,15,230,639,31,244,0,0
5621,1022,415,1251,1060,49,13,15,229,645,32,244,0,0
5622,1015,406,1247,1062,49,13,15,232,656,33,244,0,0
5623,1000,397,1234,1062,49,13,15,234,665,34,244,0,0
5624,984,395,1218,1065,49,13,15,234,670,35,244,0,0
5625,979,396,1210,1065,49,13,15,231,669,36,244,0,0
5626,980,388,1213,1066,49,13,15,233,678,37,244,0,0
5627,981,384,1216,1068,49,13,15,235,684,38,244,0,0
5628,980,384,1215,1069,49,13,15,235,685,39,244,0,0
5629,984,381,1221,1069,49,13,15,237,688,40,244,0,0
5630,989,380,1227,1069,49,13,15,238,689,41,244,0,0
5631,993,383,1232,1070,49,13,15,239,687,42,244,0,0
5632,993,381,1234,1070,49,13,15,241,689,43,244,0,0
5633,991,382,1231,1069,49,13,15,240,687,44,244,0,0
5634,986,382,1223,1069,49,13,15,237,687,45,244,0,0
5635,981,386,1213,1068,49,13,15,232,682,46,244,0,0
5636,978,390,1205,1067,49,13,15,227,677,47,244,0,0
5637,978,388,1201,1067,49,13,15,223,679,48,244,0,0
5638,978,390,1197,1067,49,13,15,219,677,49,244,0,0
5639,980,388,1195,1066,49,13,15,215,678,50,244,0,0
5640,981,385,1194,1066,49,13,15,213,681,51,244,0,0
5641,982,384,1192,1066,49,13,15,210,682,52,244,0,0
5642,983,385,1191,1066,49,13,15,208,681,53,244,0,0
5643,984,389,1189,1067,49,13,15,205,678,54,244,0,0
5644,985,391,1188,1068,49,13,15,203,677,55,244,0,0
5645,987,390,1188,1068,49,13,15,201,678,56,244,0,0
5646,987,389,1188,1068,49,13,15,201,679,57,244,0,0
5647,988,388,1187,1067,49,13,15,199,679,58,244,0,0
5648,988,389,1185,1067,49,13,15,197,678,59,244,0,0
5649,988,387,1185,1067,49,13,15,197,680,60,244,0,0
5650,988,387,1184,1067,49,13,15,196,680,61,244,0,0
5651,988,387,1183,1067,49,13,15,195,680,62,244,0,0
5652,989,385,1183,1068,49,13,15,194,683,63,244,0,0
5653,990,385,1184,1068,49,13,15,194,683,64,244,0,0
5654,990,384,1183,1068,49,13,15,193,684,65,244,0,0
5655,990,385,1183,1067,49,13,15,193,682,66,244,0,0
5656,991,386,1183,1067,49,13,15,192,681,67,244,0,0
5657,991,388,1182,1067,49,13,15,191,679,68,244,0,0
5658,991,388,1181,1067,49,13,15,190,679,69,244,0,0
5659,991,388,1181,1068,49,13,15,190,680,70,244,0,0
5660,991,387,1181,1068,49,13,15,190,681,71,244,0,0
5661,991,387,1181,1068,49,13,15,190,681,72,244,0,0
5662,993,387,1182,1067,49,13,15,189,680,73,244,0,0
5663,993,389,1183,1067,49,13,15,190,678,74,244,0,0
5664,994,388,1183,1067,49,13,15,189,679,75,244,0,0
5665,994,388,1184,1067,49,13,15,190,679,76,244,0,0
5666,995,387,1184,1066,49,13,15,189,679,77,244,0,0
5667,993,387,1182,1066,49,13,15,189,679,78,244,0,0
5668,993,387,1181,1065,49,13,15,188,678,79,244,0,0
5669,993,386,1181,1065,49,13,15,188,679,80,244,0,0
5670,993,386,1181,1065,49,13,15,188,679,81,244,0,0
5671,993,387,1180,1066,49,13,15,187,679,82,244,0,0
5672,993,387,1180,1066,49,13,15,187,679,83,244,0,0
5673,993,387,1180,1066,49,13,15,187,679,84,244,0,0
5674,994,387,1181,1066,49,13,15,187,679,85,244,0,0
5675,994,388,1181,1066,49,13,15,187,678,86,244,0,0
5676,995,389,1181,1066,49,13,15,186,677,87,244,0,0
5677,996,388,1184,1066,49,13,15,188,678,88,244,0,0
5678,998,388,1186,1067,49,13,15,188,679,89,244,0,0
5679,996,391,1183,1067,49,13,15,187,676,90,244,0,0
5680,1012,389,1169,939,49,13,15,157,550,91,244,0,0
5681,1001,388,1184,1027,49,13,15,183,639,92,244,0,0
5682,997,388,1187,1053,49,13,15,190,665,93,244,0,0
5683,995,387,1187,1063,49,13,15,192,676,94,244,0,0
5684,994,387,1188,1067,49,13,15,194,680,95,244,0,0
5685,994,386,1187,1067,49,13,15,193,681,96,244,0,0
5686,994,388,1186,1069,49,13,15,192,681,97,244,0,0
5687,993,387,1185,1068,49,13,15,192,681,98,244,0,0
5688,992,387,1183,1068,49,13,15,191,681,99,244,0,0
5689,991,387,1182,1067,49,13,15,191,680,100,244,0,0
5690,991,387,1181,1067,49,13,15,190,680,101,244,0,0
5691,993,389,1182,1067,49,13,15,189,678,102,244,0,0
5692,993,388,1183,1067,49,13,15,190,679,103,244,0,0
5693,993,388,1182,1068,49,13,15,189,680,104,244,0,0
5694,993,388,1182,1068,49,13,15,189,680,105,244,0,0
5695,994,388,1183,1068,49,13,15,189,680,106,244,0,0
5696,993,388,1182,1068,49,13,15,189,680,107,244,0,0
5697,993,388,1181,1068,49,13,15,188,680,108,244,0,0
5698,993,388,1181,1068,49,13,15,188,680,109,244,0,0
5699,993,387,1181,1068,49,13,15,188,681,110,244,0,0
5700,993,388,1181,1068,49,13,15,188,680,111,244,0,0
5701,993,390,1181,1068,49,13,15,188,678,112,244,0,0
5702,994,390,1181,1068,49,13,15,187,678,113,244,0,0
5703,994,391,1182,1068,49,13,15,188,677,114,244,0,0
5704,994,390,1182,1068,49,13,15,188,678,115,244,0,0
5705,993,390,1181,1068,49,13,15,188,678,116,244,0,0
5706,993,388,1181,1068,49,13,15,188,680,117,244,0,0
5707,993,388,1182,1069,49,13,15,189,681,118,244,0,0
5708,993,386,1182,1069,49,13,15,189,683,119,244,0,0
5709,993,388,1182,1069,49,13,15,189,681,120,244,0,0
5710,994,388,1182,1069,49,13,15,188,681,121,244,0,0
5711,993,387,1181,1069,49,13,15,188,682,122,244,0,0
5712,993,386,1181,1069,49,13,15,188,683,123,244,0,0
5713,993,386,1181,1069,49,13,15,188,683,124,244,0,0
5714,993,387,1181,1068,49,13,15,188,681,125,244,0,0
5715,993,387,1181,1068,49,13,15,188,681,126,244,0,0
5716,993,387,1181,1068,49,13,15,188,681,127,244,0,0
5717,992,387,1181,1068,49,13,15,189,681,128,244,0,0
5718,993,387,1181,1068,49,13,15,188,681,129,244,0,0
5719,992,387,1181,1068,49,13,15,189,681,130,244,0,0
5720,993,388,1181,1068,49,13,15,188,680,131,244,0,0
5721,993,386,1181,1068,49,13,15,188,682,132,244,0,0
5722,992,386,1180,1068,49,13,15,188,682,133,244,0,0
5723,992,385,1181,1068,49,13,15,189,683,134,244,0,0
5724,992,385,1180,1068,49,13,15,188,683,135,244,0,0
5725,991,387,1179,1067,49,13,15,188,680,136,244,0,0
5726,992,387,1179,1068,49,13,15,187,681,137,244,0,0
5727,992,386,1180,1068,49,13,15,188,682,138,244,0,0
5728,992,386,1179,1068,49,13,15,187,682,139,244,0,0
5729,992,385,1180,1069,49,13,15,188,684,140,244,0,0
5730,992,385,1180,1069,49,13,15,188,684,141,244,0,0
5731,992,387,1179,1068,49,13,15,187,681,142,244,0,0
5732,993,387,1179,1068,49,13,15,186,681,143,244,0,0
5733,992,388,1178,1068,49,13,15,186,680,144,244,0,0
5734,991,388,1177,1068,49,13,15,186,680,145,244,0,0
5735,990,387,1176,1068,49,13,15,186,681,146,244,0,0
5736,992,387,1178,1069,49,13,15,186,682,147,244,0,0
5737,993,387,1180,1069,49,13,15,187,682,148,244,0,0
5738,992,386,1180,1070,49,13,15,188,684,149,244,0,0
5739,992,386,1179,1069,49,13,15,187,683,150,244,0,0
5740,992,386,1180,1069,49,13,15,188,683,151,244,0,0
5741,993,386,1180,1069,49,13,15,187,683,152,244,0,0
5742,992,386,1180,1069,49,13,15,188,683,153,244,0,0
5743,991,387,1179,1069,49,13,15,188,682,154,244,0,0
5744,990,388,1178,1069,49,13,15,188,681,155,244,0,0
5745,990,389,1178,1069,49,13,15,188,680,156,244,0,0
5746,990,389,1178,1069,49,13,15,188,680,157,244,0,0
5747,991,390,1179,1068,49,13,15,188,678,158,244,0,0
5748,991,391,1179,1068,49,13,15,188,677,159,244,0,0
5749,991,391,1179,1068,49,13,15,188,677,160,244,0,0
5750,991,390,1180,1068,49,13,15,189,678,161,244,0,0
5751,991,390,1180,1068,49,13,15,189,678,162,244,0,0
5752,991,390,1180,1068,49,13,15,189,678,163,244,0,0
5753,992,390,1180,1068,49,13,15,188,678,164,244,0,0
5754,992,390,1180,1067,49,13,15,188,677,165,244,0,0
5755,991,388,1180,1067,49,13,15,189,679,166,244,0,0
5756,991,387,1180,1068,49,13,15,189,681,167,244,0,0
5757,992,387,1181,1068,49,13,15,189,681,168,244,0,0
5758,992,386,1181,1068,49,13,15,189,682,169,244,0,0
5759,993,386,1182,1067,49,13,15,189,681,170,244,0,0
5760,993,387,1181,1067,49,13,15,188,680,171,244,0,0
5761,993,389,1181,1067,49,13,15,188,678,172,244,0,0
5762,993,390,1180,1067,49,13,15,187,677,173,244,0,0
5763,994,392,1180,1067,49,13,15,186,675,174,244,0,0
5764,993,392,1179,1067,49,13,15,186,675,175,244,0,0
5765,993,392,1179,1067,49,13,15,186,675,176,244,0,0
5766,993,391,1179,1067,49,13,15,186,676,177,244,0,0
5767,994,389,1180,1067,49,13,15,186,678,178,244,0,0
5768,993,389,1180,1068,49,13,15,187,679,179,244,0,0
5769,993,389,1181,1068,49,13,15,188,679,180,244,0,0
5770,992,387,1180,1068,49,13,15,188,681,181,244,0,0
5771,992,386,1180,1069,49,13,15,188,683,182,244,0,0
5772,992,384,1180,1069,49,13,15,188,685,183,244,0,0
5773,992,385,1180,1069,49,13,15,188,684,184,244,0,0
5774,992,385,1180,1069,49,13,15,188,684,185,244,0,0
5775,992,384,1180,1069,49,13,15,188,685,186,244,0,0
5776,993,386,1180,1068,49,13,15,187,682,187,244,0,0
5777,993,387,1180,1068,49,13,15,187,681,188,244,0,0
5778,993,387,1180,1068,49,13,15,187,681,189,244,0,0
5779,994,388,1180,1068,49,13,15,186,680,190,244,0,0
5780,993,389,1180,1068,49,13,15,187,679,191,244,0,0
5781,994,389,1180,1068,49,13,15,186,679,192,244,0,0
5782,994,390,1180,1068,49,13,15,186,678,193,244,0,0
5783,994,390,1180,1068,49,13,15,186,678,194,244,0,0
5784,993,390,1179,1067,49,13,15,186,677,195,244,0,0
5785,993,391,1179,1067,49,13,15,186,676,196,244,0,0
5786,993,391,1178,1067,49,13,15,185,676,197,244,0,0
5787,993,391,1178,1067,49,13,15,185,676,198,244,0,0
5788,993,390,1179,1067,49,13,15,186,677,199,244,0,0
5789,993,389,1179,1067,49,13,15,186,678,200,244,0,0
5790,993,388,1179,1067,49,13,15,186,679,201,244,0,0
5791,994,386,1180,1068,49,13,15,186,682,202,244,0,0
5792,993,388,1179,1068,49,13,15,186,680,203,244,0,0
5793,993,386,1179,1068,49,13,15,186,682,204,244,0,0
5794,994,385,1180,1068,49,13,15,186,683,205,244,0,0
5795,993,384,1181,1069,49,13,15,188,685,206,244,0,0
5796,993,386,1180,1069,49,13,15,187,683,207,244,0,0
5797,992,387,1180,1070,49,13,15,188,683,208,244,0,0
5798,992,388,1179,1070,49,13,15,187,682,209,244,0,0
5799,991,388,1179,1070,49,13,15,188,682,210,244,0,0
5800,991,388,1179,1070,49,13,15,188,682,211,244,0,0
5801,991,388,1179,1070,49,13,15,188,682,212,244,0,0
5802,991,388,1179,1070,49,13,15,188,682,213,244,0,0
5803,991,387,1181,1070,49,13,15,190,683,214,244,0,0
5804,991,385,1181,1071,49,13,15,190,686,215,244,0,0
5805,990,387,1180,1070,49,13,15,190,683,216,244,0,0
5806,991,386,1180,1069,49,13,15,189,683,217,244,0,0
5807,989,386,1178,1069,49,13,15,189,683,218,244,0,0
5808,990,386,1180,1069,49,13,15,190,683,219,244,0,0
5809,991,384,1180,1069,49,13,15,189,685,220,244,0,0
5810,991,386,1180,1069,49,13,15,189,683,221,244,0,0
5811,990,386,1180,1069,49,13,15,190,683,222,244,0,0
5812,989,385,1179,1069,49,13,15,190,684,223,244,0,0
5813,989,385,1179,1069,49,13,15,190,684,224,244,0,0
5814,989,385,1179,1070,49,13,15,190,685,225,244,0,0
5815,990,385,1181,1070,49,13,15,191,685,226,244,0,0
5816,989,387,1179,1068,49,13,15,190,681,227,244,0,0
5817,997,384,1171,998,49,13,15,174,614,228,244,0,0
5818,1011,388,1156,881,49,13,15,145,493,229,244,0,0
5819,1000,382,1176,975,49,13,15,176,593,230,244,0,0
5820,997,384,1186,1016,49,13,15,189,632,231,244,0,0
5821,994,388,1171,977,49,13,15,177,589,232,244,0,0
5822,994,388,1188,1035,49,13,15,194,647,233,244,0,0
5823,1005,387,1199,1029,49,13,15,194,642,234,244,0,0
5824,1015,385,1204,998,49,13,15,189,613,235,244,0,0
5825,1032,388,1222,976,49,13,15,190,588,236,244,0,0
5826,979,366,1202,1002,49,13,15,223,636,237,244,0,0
5827,1074,358,1285,956,49,13,15,211,598,238,244,0,0
5828,1129,360,1335,935,49,13,15,206,575,239,244,0,0
5829,1163,351,1370,918,49,13,15,207,567,240,244,0,0
5830,1202,334,1402,890,49,13,15,200,556,241,244,0,0
5831,1226,323,1421,861,49,13,15,195,538,242,244,0,0
5832,1243,309,1436,836,49,13,15,193,527,243,244,0,0
5833,1263,302,1453,822,49,13,15,190,520,244,244,1,0
5678,1350,800,1596,1069,52,13,15,246,269,0,0,0,0
5814,1418,844,1609,1076,59,13,15,191,232,0,12,0,0
5815,1318,780,1558,1071,59,13,15,240,291,1,12,0,0
5816,1193,713,1490,1073,59,13,15,297,360,2,12,0,0
5817,1060,669,1389,1069,59,13,15,329,400,3,12,0,0
5818,897,632,1254,1064,59,13,15,357,432,4,12,0,0
5819,721,585,1129,1071,59,13,15,408,486,5,12,0,0
5820,637,530,1090,1063,59,13,15,453,533,6,12,0,0
5821,624,481,1115,1068,59,13,15,491,587,7,12,0,0
5822,603,447,1114,1067,59,13,15,511,620,8,12,0,0
5823,577,417,1105,1071,59,13,15,528,654,9,12,0,0
5824,595,378,1139,1073,59,13,15,544,695,10,12,0,0
5825,634,350,1185,1076,59,13,15,551,726,11,12,0,0
5826,567,312,1148,1076,59,13,15,581,764,12,12,0,0
5827,800,314,1286,982,60,13,15,486,668,0,11,0,0
5828,827,327,1299,975,60,13,15,472,648,1,11,0,0
5829,830,317,1291,951,60,13,15,461,634,2,11,0,0
5830,880,292,1310,890,60,13,15,430,598,3,11,0,0
5831,928,288,1318,841,60,13,15,390,553,4,11,0,0
5832,963,282,1330,815,60,13,15,367,533,5,11,0,0
5833,1032,268,1372,776,60,13,15,340,508,6,11,0,0
5834,1091,274,1418,771,60,13,15,327,497,7,11,0,0
5835,1143,272,1451,753,60,13,15,308,481,8,11,0,0
5836,1209,260,1498,730,60,13,15,289,470,9,11,0,0
5837,1218,193,1523,709,60,13,15,305,516,10,11,0,0
5838,1255,177,1555,684,60,13,15,300,507,11,11,0,0
5989,1325,265,1433,718,62,13,15,108,453,0,11,0,0
5990,1249,264,1373,777,62,13,15,124,513,1,11,0,0
5991,1210,272,1332,767,62,13,15,122,495,2,11,0,0
5992,1167,272,1288,764,62,13,15,121,492,3,11,0,0
5993,1113,284,1236,776,62,13,15,123,492,4,11,0,0
5994,1056,285,1183,788,62,13,15,127,503,5,11,0,0
5995,973,296,1112,826,62,13,15,139,530,6,11,0,0
5996,919,303,1063,836,62,13,15,144,533,7,11,0,0
5997,854,313,1008,876,62,13,15,154,563,8,11,0,0
5998,796,331,956,909,62,13,15,160,578,9,11,0,0
5999,745,347,905,916,62,13,15,160,569,10,11,0,0
6000,677,369,848,966,62,13,15,171,597,11,11,0,0
5991,1301,334,1429,805,63,13,15,128,471,0,9,0,0
5992,1274,340,1412,847,63,13,15,138,507,1,9,0,0
5993,1218,345,1369,892,63,13,15,151,547,2,9,0,0
5994,1175,354,1330,909,63,13,15,155,555,3,9,0,0
5995,1121,361,1280,921,63,13,15,159,560,4,9,0,0
5996,1054,381,1224,964,63,13,15,170,583,5,9,0,0
5997,1003,395,1180,991,63,13,15,177,596,6,9,0,0
5998,959,408,1146,1026,63,13,15,187,618,7,9,0,0
5999,922,440,1114,1058,63,13,15,192,618,8,9,0,0
6000,865,464,1059,1076,63,13,15,194,612,9,9,0,0
554,945,732,1228,1075,3,13,2,283,343,0,72,0,1
555,842,671,1172,1071,3,13,2,330,400,1,72,0,0
556,721,618,1094,1072,3,13,2,373,454,2,72,0,0
557,596,543,1025,1072,3,13,2,429,529,3,72,0,0
558,518,502,973,1072,3,13,2,455,570,4,72,0,0
559,464,460,942,1077,3,13,2,478,617,5,72,0,0
560,431,431,915,1076,3,13,2,484,645,6,72,0,0
561,407,403,862,1028,3,13,2,455,625,7,72,0,0
562,384,376,810,979,3,13,2,426,603,8,72,0,0
563,373,364,770,949,3,13,2,397,585,9,72,0,0
564,380,349,726,878,3,13,2,346,529,10,72,0,0
565,380,333,697,835,3,13,2,317,502,11,72,0,0
566,370,317,668,804,3,13,2,298,487,12,72,0,0
567,360,297,630,754,3,13,2,270,457,13,72,0,0
568,352,283,609,737,3,13,2,257,454,14,72,0,0
569,353,277,581,692,3,13,2,228,415,15,72,0,0
570,350,270,561,663,3,13,2,211,393,16,72,0,0
571,350,263,545,633,3,13,2,195,370,17,72,0,0
572,346,252,530,609,3,13,2,184,357,18,72,0,0
573,344,246,519,596,3,13,2,175,350,19,72,0,0
574,347,241,508,571,3,13,2,161,330,20,72,0,0
575,350,236,500,547,3,13,2,150,311,21,72,0,0
576,349,231,490,530,3,13,2,141,299,22,72,0,0
577,345,224,482,520,3,13,2,137,296,23,72,0,0
578,341,220,474,511,3,13,2,133,291,24,72,0,0
579,341,216,466,492,3,13,2,125,276,25,72,0,0
580,342,212,461,477,3,13,2,119,265,26,72,0,0
581,340,210,453,464,3,13,2,113,254,27,72,0,0
582,335,201,448,460,3,13,2,113,259,28,72,0,0
583,336,202,444,453,3,13,2,108,251,29,72,0,0
584,337,203,436,431,3,13,2,99,228,30,72,0,0
585,334,197,432,427,3,13,2,98,230,31,72,0,0
586,331,200,424,419,3,13,2,93,219,32,72,0,0
587,330,198,420,413,3,13,2,90,215,33,72,0,0
588,333,204,417,408,3,13,2,84,204,34,72,0,0
589,338,204,416,394,3,13,2,78,190,35,72,0,0
590,339,201,415,386,3,13,2,76,185,36,72,0,0
591,338,197,412,382,3,13,2,74,185,37,72,0,0
592,337,186,413,376,3,13,2,76,190,38,72,0,0
593,340,184,413,370,3,13,2,73,186,39,72,0,0
594,343,181,413,363,3,13,2,70,182,40,72,0,0
595,344,176,413,357,3,13,2,69,181,41,72,0,0
596,344,180,410,355,3,13,2,66,175,42,72,0,0
597,344,176,408,348,3,13,2,64,172,43,72,0,0
598,346,180,405,342,3,13,2,59,162,44,72,0,0
599,347,173,406,334,3,13,2,59,161,45,72,0,0
600,347,173,404,331,3,13,2,57,158,46,72,0,0
601,346,174,402,329,3,13,2,56,155,47,72,0,0
602,344,170,399,327,3,13,2,55,157,48,72,0,0
603,343,174,395,321,3,13,2,52,147,49,72,0,0
604,343,172,393,314,3,13,2,50,142,50,72,0,0
605,344,170,392,310,3,13,2,48,140,51,72,0,0
606,344,173,391,308,3,13,2,47,135,52,72,0,0
607,340,163,388,302,3,13,2,48,139,53,72,0,0
608,338,159,384,296,3,13,2,46,137,54,72,0,0
609,336,155,383,293,3,13,2,47,138,55,72,0,0
610,336,158,381,288,3,13,2,45,130,56,72,0,0
611,335,162,378,288,3,13,2,43,126,57,72,0,0
612,333,158,376,287,3,13,2,43,129,58,72,0,0
613,332,159,373,282,3,13,2,41,123,59,72,0,0
614,331,158,371,277,3,13,2,40,119,60,72,0,0
615,330,155,370,275,3,13,2,40,120,61,72,0,0
616,328,155,368,275,3,13,2,40,120,62,72,0,0
617,325,152,365,274,3,13,2,40,122,63,72,0,0
618,323,150,364,272,3,13,2,41,122,64,72,0,0
619,324,151,362,267,3,13,2,38,116,65,72,0,0
620,325,150,363,266,3,13,2,38,116,66,72,0,0
621,325,147,362,264,3,13,2,37,117,67,72,0,0
622,324,145,362,261,3,13,2,38,116,68,72,0,0
623,324,143,361,259,3,13,2,37,116,69,72,0,0
624,325,143,361,255,3,13,2,36,112,70,72,0,0
625,326,142,362,254,3,13,2,36,112,71,72,0,0
626,326,141,362,253,3,13,2,36,112,72,72,1,0
915,818,352,878,481,6,13,2,60,129,0,0,0,0
947,818,377,875,478,7,13,2,57,101,0,1,0,0
948,813,358,881,480,7,13,2,68,122,1,1,0,0
960,813,401,874,472,8,13,2,61,71,0,0,0,0
964,819,361,876,479,9,13,2,57,118,0,1,0,0
965,819,364,874,478,9,13,2,55,114,1,1,0,0
967,816,356,876,478,10,13,2,60,122,0,29,0,1
968,815,355,876,478,10,13,2,61,123,1,29,0,0
969,815,355,876,478,10,13,2,61,123,2,29,0,0
970,815,356,875,477,10,13,2,60,121,3,29,0,0
971,815,354,877,480,10,13,2,62,126,4,29,0,0
972,816,357,877,481,10,13,2,61,124,5,29,0,0
973,815,355,878,482,10,13,2,63,127,6,29,0,0
974,815,355,878,482,10,13,2,63,127,7,29,0,0
975,816,357,877,481,10,13,2,61,124,8,29,0,0
976,815,352,878,479,10,13,2,63,127,9,29,0,0
977,816,352,878,478,10,13,2,62,126,10,29,0,0
978,816,352,877,478,10,13,2,61,126,11,29,0,0
979,815,351,877,478,10,13,2,62,127,12,29,0,0
980,816,352,877,478,10,13,2,61,126,13,29,0,0
981,818,360,876,479,10,13,2,58,119,14,29,0,0
982,818,362,875,478,10,13,2,57,116,15,29,0,0
983,817,361,876,480,10,13,2,59,119,16,29,0,0
984,818,363,876,480,10,13,2,58,117,17,29,0,0
985,817,364,875,480,10,13,2,58,116,18,29,0,0
986,819,363,877,480,10,13,2,58,117,19,29,0,0
987,818,361,878,480,10,13,2,60,119,20,29,0,0
988,818,362,877,480,10,13,2,59,118,21,29,0,0
989,817,359,878,481,10,13,2,61,122,22,29,0,0
990,816,359,878,481,10,13,2,62,122,23,29,0,0
991,815,361,877,484,10,13,2,62,123,24,29,0,0
992,817,363,877,481,10,13,2,60,118,25,29,0,0
993,816,363,877,483,10,13,2,61,120,26,29,0,0
994,815,362,878,485,10,13,2,63,123,27,29,0,0
995,815,362,879,485,10,13,2,64,123,28,29,0,0
996,815,362,879,486,10,13,2,64,124,29,29,1,0
1006,816,363,877,482,10,13,2,61,119,0,29,0,0
1007,816,363,877,481,10,13,2,61,118,1,29,0,0
1008,815,364,876,481,10,13,2,61,117,2,29,0,0
1009,815,362,878,481,10,13,2,63,119,3,29,0,0
1010,816,360,878,480,10,13,2,62,120,4,29,0,0
1011,816,360,879,480,10,13,2,63,120,5,29,0,0
1021,811,349,880,481,10,13,2,69,132,0,29,0,0
1022,812,351,879,481,10,13,2,67,130,1,29,0,0
1023,812,350,879,481,10,13,2,67,131,2,29,0,0
1024,814,351,880,481,10,13,2,66,130,3,29,0,0
1025,814,350,880,481,10,13,2,66,131,4,29,0,0
1041,813,348,881,483,10,13,2,68,135,0,29,0,0
1042,813,348,881,484,10,13,2,68,136,1,29,0,0
1051,812,348,880,481,10,13,2,68,133,0,29,0,0
1052,812,348,880,482,10,13,2,68,134,1,29,0,0
1053,812,348,880,482,10,13,2,68,134,2,29,0,0
1054,812,348,880,482,10,13,2,68,134,3,29,0,0
1055,812,348,880,481,10,13,2,68,133,4,29,0,0
1056,813,351,880,483,10,13,2,67,132,5,29,0,0
1057,812,352,881,484,10,13,2,69,132,6,29,0,0
1058,813,353,881,484,10,13,2,68,131,7,29,0,0
1059,813,353,881,485,10,13,2,68,132,8,29,0,0
1060,811,351,881,484,10,13,2,70,133,9,29,0,0
1061,811,351,881,484,10,13,2,70,133,10,29,0,0
1069,812,351,880,482,10,13,2,68,131,0,29,0,0
1070,812,349,880,482,10,13,2,68,133,1,29,0,0
1071,812,349,880,481,10,13,2,68,132,2,29,0,0
1076,811,350,879,483,10,13,2,68,133,0,29,0,0
1077,811,348,880,484,10,13,2,69,136,1,29,0,0
1078,811,348,880,484,10,13,2,69,136,2,29,0,0
1085,813,349,880,482,10,13,2,67,133,0,29,0,0
1086,813,349,880,482,10,13,2,67,133,1,29,0,0
1096,812,352,877,481,10,13,2,65,129,0,29,0,0
1097,811,350,878,481,10,13,2,67,131,1,29,0,0
1098,811,349,878,480,10,13,2,67,131,2,29,0,0
1099,810,349,878,480,10,13,2,68,131,3,29,0,0
1100,810,348,879,480,10,13,2,69,132,4,29,0,0
1101,812,354,879,482,10,13,2,67,128,5,29,0,0
1102,814,356,879,482,10,13,2,65,126,6,29,0,0
1103,814,357,879,483,10,13,2,65,126,7,29,0,0
1104,816,360,879,483,10,13,2,63,123,8,29,0,0
1105,814,357,880,483,10,13,2,66,126,9,29,0,0
1106,814,357,880,483,10,13,2,66,126,10,29,0,0
1110,817,371,875,480,10,13,2,58,109,0,29,0,0
1111,815,362,876,479,10,13,2,61,117,1,29,0,0
1112,814,358,877,479,10,13,2,63,121,2,29,0,0
1113,814,357,877,478,10,13,2,63,121,3,29,0,0
1114,815,357,877,478,10,13,2,62,121,4,29,0,0
1115,815,357,877,478,10,13,2,62,121,5,29,0,0
1116,813,353,878,480,10,13,2,65,127,6,29,0,0
1117,812,351,878,481,10,13,2,66,130,7,29,0,0
1118,813,351,878,481,10,13,2,65,130,8,29,0,0
1119,813,351,878,481,10,13,2,65,130,9,29,0,0
1120,813,350,878,481,10,13,2,65,131,10,29,0,0
1121,812,350,878,481,10,13,2,66,131,11,29,0,0
1126,814,352,878,480,10,13,2,64,128,0,29,0,0
1127,814,352,878,480,10,13,2,64,128,1,29,0,0
1136,812,351,877,481,10,13,2,65,130,0,29,0,0
1137,812,352,877,481,10,13,2,65,129,1,29,0,0
1138,813,353,877,480,10,13,2,64,127,2,29,0,0
1139,813,355,876,480,10,13,2,63,125,3,29,0,0
1140,813,358,876,480,10,13,2,63,122,4,29,0,0
1141,814,359,875,479,10,13,2,61,120,5,29,0,0
1160,816,351,886,486,10,13,2,70,135,0,29,0,0
1161,816,350,887,487,10,13,2,71,137,1,29,0,0
1166,812,350,886,493,10,13,2,74,143,0,29,0,0
1167,812,351,887,494,10,13,2,75,143,1,29,0,0
1168,813,353,884,488,10,13,2,71,135,2,29,0,0
1169,812,350,884,487,10,13,2,72,137,3,29,0,0
1170,813,354,883,486,10,13,2,70,132,4,29,0,0
1171,813,354,883,486,10,13,2,70,132,5,29,0,0
1173,812,354,880,483,10,13,2,68,129,0,29,0,0
1174,812,355,879,483,10,13,2,67,128,1,29,0,0
1175,813,355,879,482,10,13,2,66,127,2,29,0,0
1176,813,356,879,481,10,13,2,66,125,3,29,0,0
1201,813,358,879,484,10,13,2,66,126,0,29,0,0
1202,812,357,880,485,10,13,2,68,128,1,29,0,0
1203,812,355,879,485,10,13,2,67,130,2,29,0,0
1204,812,354,880,485,10,13,2,68,131,3,29,0,0
1205,813,355,881,486,10,13,2,68,131,4,29,0,0
1206,813,355,881,486,10,13,2,68,131,5,29,0,0
1636,816,367,880,483,11,13,2,64,116,0,5,0,0
1637,816,367,879,480,11,13,2,63,113,1,5,0,0
1638,816,367,879,479,11,13,2,63,112,2,5,0,0
1639,816,365,879,479,11,13,2,63,114,3,5,0,0
1640,816,366,878,479,11,13,2,62,113,4,5,0,0
1641,816,366,878,479,11,13,2,62,113,5,5,0,0
1656,816,378,871,475,11,13,2,55,97,0,5,0,0
1657,816,379,871,475,11,13,2,55,96,1,5,0,0
1658,815,379,871,475,11,13,2,56,96,2,5,0,0
1659,815,379,871,475,11,13,2,56,96,3,5,0,0
1660,814,374,873,475,11,13,2,59,101,4,5,0,0
1661,814,374,873,475,11,13,2,59,101,5,5,0,0
1663,2,834,230,1067,12,13,2,228,233,0,8,0,0
1664,0,594,361,1064,12,13,2,361,470,1,8,0,0
1665,0,529,419,1071,12,13,2,419,542,2,8,0,0
1666,0,482,504,1070,12,13,2,504,588,3,8,0,0
1667,0,436,578,1071,12,13,2,578,635,4,8,0,0
1668,39,408,626,1073,12,13,2,587,665,5,8,0,0
1669,97,380,665,1046,12,13,2,568,666,6,8,0,0
1670,145,349,666,983,12,13,2,521,634,7,8,0,0
1671,157,302,711,975,12,13,2,554,673,8,8,0,0
1671,318,354,508,913,13,13,2,190,559,0,56,0,1
1672,342,346,513,847,13,13,2,171,501,1,56,0,0
1673,338,327,504,817,13,13,2,166,490,2,56,0,0
1674,336,318,497,792,13,13,2,161,474,3,56,0,0
1675,341,301,493,747,13,13,2,152,446,4,56,0,0
1676,346,294,495,733,13,13,2,149,439,5,56,0,0
1677,348,285,486,689,13,13,2,138,404,6,56,0,0
1678,341,275,473,665,13,13,2,132,390,7,56,0,0
1679,335,270,465,654,13,13,2,130,384,8,56,0,0
1680,327,260,449,619,13,13,2,122,359,9,56,0,0
1681,319,252,441,609,13,13,2,122,357,10,56,0,0
1682,310,247,427,594,13,13,2,117,347,11,56,0,0
1683,301,238,413,575,13,13,2,112,337,12,56,0,0
1684,292,237,399,565,13,13,2,107,328,13,56,0,0
1685,283,235,382,538,13,13,2,99,303,14,56,0,0
1686,280,225,378,527,13,13,2,98,302,15,56,0,0
1687,276,225,372,518,13,13,2,96,293,16,56,0,0
1688,270,220,359,496,13,13,2,89,276,17,56,0,0
1689,267,215,355,489,13,13,2,88,274,18,56,0,0
1690,263,209,348,475,13,13,2,85,266,19,56,0,0
1691,266,204,348,461,13,13,2,82,257,20,56,0,0
1692,266,202,346,450,13,13,2,80,248,21,56,0,0
1693,266,199,342,435,13,13,2,76,236,22,56,0,0
1694,264,196,340,431,13,13,2,76,235,23,56,0,0
1695,263,195,337,423,13,13,2,74,228,24,56,0,0
1696,263,192,333,411,13,13,2,70,219,25,56,0,0
1697,265,195,331,402,13,13,2,66,207,26,56,0,0
1698,267,190,331,393,13,13,2,64,203,27,56,0,0
1699,267,185,332,390,13,13,2,65,205,28,56,0,0
1700,269,183,332,387,13,13,2,63,204,29,56,0,0
1701,272,179,332,374,13,13,2,60,195,30,56,0,0
1702,275,180,332,368,13,13,2,57,188,31,56,0,0
1703,278,178,333,361,13,13,2,55,183,32,56,0,0
1704,281,176,334,356,13,13,2,53,180,33,56,0,0
1705,282,176,335,354,13,13,2,53,178,34,56,0,0
1706,284,170,335,344,13,13,2,51,174,35,56,0,0
1707,286,169,336,340,13,13,2,50,171,36,56,0,0
1708,287,168,336,334,13,13,2,49,166,37,56,0,0
1709,288,166,336,330,13,13,2,48,164,38,56,0,0
1710,287,167,334,327,13,13,2,47,160,39,56,0,0
1711,286,161,333,322,13,13,2,47,161,40,56,0,0
1712,287,160,333,317,13,13,2,46,157,41,56,0,0
1713,289,159,333,309,13,13,2,44,150,42,56,0,0
1714,289,155,333,307,13,13,2,44,152,43,56,0,0
1715,288,157,332,306,13,13,2,44,149,44,56,0,0
1716,287,152,332,304,13,13,2,45,152,45,56,0,0
1717,287,149,332,301,13,13,2,45,152,46,56,0,0
1718,288,149,331,299,13,13,2,43,150,47,56,0,0
1719,286,145,329,295,13,13,2,43,150,48,56,0,0
1720,285,147,327,294,13,13,2,42,147,49,56,0,0
1721,285,145,325,288,13,13,2,40,143,50,56,0,0
1722,285,146,325,285,13,13,2,40,139,51,56,0,0
1723,285,146,323,279,13,13,2,38,133,52,56,0,0
1724,285,147,321,277,13,13,2,36,130,53,56,0,0
1725,284,148,321,279,13,13,2,37,131,54,56,0,0
1726,283,148,319,278,13,13,2,36,130,55,56,0,0
1727,283,147,319,275,13,13,2,36,128,56,56,1,0
1692,812,370,878,479,14,13,2,66,109,0,1,0,0
1693,812,370,877,479,14,13,2,65,109,1,1,0,0
1716,811,362,881,480,15,13,2,70,118,0,15,0,0
1717,810,360,881,480,15,13,2,71,120,1,15,0,0
1718,810,359,882,480,15,13,2,72,121,2,15,0,0
1719,812,361,881,478,15,13,2,69,117,3,15,0,0
1720,811,359,881,479,15,13,2,70,120,4,15,0,0
1721,811,359,882,479,15,13,2,71,120,5,15,0,0
1727,806,351,882,482,15,13,2,76,131,0,15,0,0
1728,805,350,882,483,15,13,2,77,133,1,15,0,0
1738,810,353,883,484,15,13,2,73,131,0,15,0,0
1739,812,356,881,483,15,13,2,69,127,1,15,0,0
1740,812,356,882,483,15,13,2,70,127,2,15,0,0
1742,810,354,881,483,15,13,2,71,129,0,15,0,0
1743,810,354,881,484,15,13,2,71,130,1,15,0,0
1746,808,350,882,486,15,13,2,74,136,0,15,0,0
1747,809,350,882,486,15,13,2,73,136,1,15,0,0
1748,809,351,881,486,15,13,2,72,135,2,15,0,0
1749,808,349,880,485,15,13,2,72,136,3,15,0,0
1750,808,348,880,485,15,13,2,72,137,4,15,0,0
1751,811,354,878,480,15,13,2,67,126,5,15,0,0
1752,814,359,876,477,15,13,2,62,118,6,15,0,0
1753,815,360,876,477,15,13,2,61,117,7,15,0,0
1754,814,358,877,479,15,13,2,63,121,8,15,0,0
1755,814,359,877,479,15,13,2,63,120,9,15,0,0
1771,814,358,877,479,15,13,2,63,121,0,15,0,0
1772,814,358,877,481,15,13,2,63,123,1,15,0,0
1773,814,355,878,481,15,13,2,64,126,2,15,0,0
1774,815,356,878,479,15,13,2,63,123,3,15,0,0
1775,814,356,877,480,15,13,2,63,124,4,15,0,0
1776,816,366,875,480,15,13,2,59,114,5,15,0,0
1777,816,370,874,477,15,13,2,58,107,6,15,0,0
1778,816,373,874,478,15,13,2,58,105,7,15,0,0
1779,815,370,875,478,15,13,2,60,108,8,15,0,0
1780,815,374,874,478,15,13,2,59,104,9,15,0,0
1781,810,356,880,483,15,13,2,70,127,10,15,0,0
1782,808,350,882,485,15,13,2,74,135,11,15,0,0
1783,808,348,883,485,15,13,2,75,137,12,15,0,0
1784,809,349,882,483,15,13,2,73,134,13,15,0,0
1785,809,348,881,482,15,13,2,72,134,14,15,0,0
1786,808,346,882,482,15,13,2,74,136,15,15,0,0
1821,811,382,877,475,16,13,2,66,93,0,25,0,0
1822,810,380,878,475,16,13,2,68,95,1,25,0,0
1823,810,379,879,476,16,13,2,69,97,2,25,0,0
1824,810,378,879,476,16,13,2,69,98,3,25,0,0
1825,809,375,880,476,16,13,2,71,101,4,25,0,0
1826,803,355,890,480,16,13,2,87,125,5,25,0,0
1827,801,351,890,481,16,13,2,89,130,6,25,0,0
1828,801,347,891,481,16,13,2,90,134,7,25,0,0
1829,802,346,891,481,16,13,2,89,135,8,25,0,0
1830,802,347,890,481,16,13,2,88,134,9,25,0,0
1831,801,343,892,482,16,13,2,91,139,10,25,0,0
1841,804,354,882,478,16,13,2,78,124,0,25,0,1
1842,807,359,879,474,16,13,2,72,115,1,25,0,0
1843,806,356,879,477,16,13,2,73,121,2,25,0,0
1844,807,357,879,477,16,13,2,72,120,3,25,0,0
1845,807,357,879,477,16,13,2,72,120,4,25,0,0
1846,807,357,879,478,16,13,2,72,121,5,25,0,0
1847,808,361,878,478,16,13,2,70,117,6,25,0,0
1848,808,359,880,480,16,13,2,72,121,7,25,0,0
1849,808,358,880,480,16,13,2,72,122,8,25,0,0
1850,810,367,877,479,16,13,2,67,112,9,25,0,0
1851,810,356,884,482,16,13,2,74,126,10,25,0,0
1852,809,352,884,482,16,13,2,75,130,11,25,0,0
1853,810,354,882,481,16,13,2,72,127,12,25,0,0
1854,810,353,883,482,16,13,2,73,129,13,25,0,0
1855,811,356,881,481,16,13,2,70,125,14,25,0,0
1856,811,360,879,481,16,13,2,68,121,15,25,0,0
1857,811,361,877,480,16,13,2,66,119,16,25,0,0
1858,812,362,877,480,16,13,2,65,118,17,25,0,0
1859,812,363,876,480,16,13,2,64,117,18,25,0,0
1860,811,364,876,480,16,13,2,65,116,19,25,0,0
1861,811,357,878,479,16,13,2,67,122,20,25,0,0
1862,811,355,879,479,16,13,2,68,124,21,25,0,0
1863,809,350,881,481,16,13,2,72,131,22,25,0,0
1864,809,349,882,481,16,13,2,73,132,23,25,0,0
1865,808,349,880,482,16,13,2,72,133,24,25,0,0
1866,808,348,881,482,16,13,2,73,134,25,25,1,0
1876,811,363,882,492,16,13,2,71,129,0,25,0,0
1877,810,362,881,493,16,13,2,71,131,1,25,0,0
1878,811,364,881,492,16,13,2,70,128,2,25,0,0
1879,812,365,882,493,16,13,2,70,128,3,25,0,0
1880,811,364,882,493,16,13,2,71,129,4,25,0,0
1881,810,353,884,489,16,13,2,74,136,5,25,0,0
1882,810,350,884,488,16,13,2,74,138,6,25,0,0
1883,809,348,883,487,16,13,2,74,139,7,25,0,0
1884,809,348,883,487,16,13,2,74,139,8,25,0,0
1885,809,347,882,487,16,13,2,73,140,9,25,0,0
1886,809,346,883,487,16,13,2,74,141,10,25,0,0
1901,815,362,877,479,16,13,2,62,117,0,25,0,0
1902,815,364,876,478,16,13,2,61,114,1,25,0,0
1903,815,365,877,477,16,13,2,62,112,2,25,0,0
1904,813,363,876,479,16,13,2,63,116,3,25,0,0
1905,813,365,875,478,16,13,2,62,113,4,25,0,0
1906,813,366,875,478,16,13,2,62,112,5,25,0,0
1916,820,390,872,478,16,13,2,52,88,0,25,0,0
1917,820,392,874,478,16,13,2,54,86,1,25,0,0
1918,819,392,875,478,16,13,2,56,86,2,25,0,0
1919,819,392,876,478,16,13,2,57,86,3,25,0,0
1920,817,393,876,478,16,13,2,59,85,4,25,0,0
1921,818,394,875,478,16,13,2,57,84,5,25,0,0
1937,804,353,886,478,16,13,2,82,125,0,25,0,0
1938,803,351,886,479,16,13,2,83,128,1,25,0,0
1961,803,351,885,485,16,13,2,82,134,0,25,0,0
1962,805,351,883,485,16,13,2,78,134,1,25,0,0
1963,806,352,882,485,16,13,2,76,133,2,25,0,0
1964,806,352,882,485,16,13,2,76,133,3,25,0,0
1965,807,353,881,485,16,13,2,74,132,4,25,0,0
1966,807,353,881,485,16,13,2,74,132,5,25,0,0
1986,808,354,882,484,16,13,2,74,130,0,25,0,0
1987,808,354,883,483,16,13,2,75,129,1,25,0,0
1988,807,354,883,483,16,13,2,76,129,2,25,0,0
1989,807,354,883,483,16,13,2,76,129,3,25,0,0
1990,807,354,883,483,16,13,2,76,129,4,25,0,0
1991,807,354,882,483,16,13,2,75,129,5,25,0,0
1910,475,398,668,989,18,13,2,193,591,0,53,0,1
1911,464,391,652,969,18,13,2,188,578,1,53,0,0
1912,431,353,609,895,18,13,2,178,542,2,53,0,0
1913,408,340,584,873,18,13,2,176,533,3,53,0,0
1914,397,321,558,808,18,13,2,161,487,4,53,0,0
1915,383,305,532,760,18,13,2,149,455,5,53,0,0
1916,367,298,512,738,18,13,2,145,440,6,53,0,0
1917,347,281,484,698,18,13,2,137,417,7,53,0,0
1918,333,276,466,678,18,13,2,133,402,8,53,0,0
1919,330,264,451,629,18,13,2,121,365,9,53,0,0
1920,324,254,440,609,18,13,2,116,355,10,53,0,0
1921,316,250,426,587,18,13,2,110,337,11,53,0,0
1922,304,239,412,571,18,13,2,108,332,12,53,0,0
1923,296,236,401,561,18,13,2,105,325,13,53,0,0
1924,299,229,396,531,18,13,2,97,302,14,53,0,0
1925,296,226,388,516,18,13,2,92,290,15,53,0,0
1926,290,225,377,497,18,13,2,87,272,16,53,0,0
1927,283,217,368,486,18,13,2,85,269,17,53,0,0
1928,283,216,364,476,18,13,2,81,260,18,53,0,0
1929,284,209,362,460,18,13,2,78,251,19,53,0,0
1930,282,208,357,449,18,13,2,75,241,20,53,0,0
1931,279,205,351,434,18,13,2,72,229,21,53,0,0
1932,277,201,347,428,18,13,2,70,227,22,53,0,0
1933,275,198,345,423,18,13,2,70,225,23,53,0,0
1934,276,195,343,412,18,13,2,67,217,24,53,0,0
1935,275,195,338,400,18,13,2,63,205,25,53,0,0
1936,272,189,334,390,18,13,2,62,201,26,53,0,0
1937,270,186,331,386,18,13,2,61,200,27,53,0,0
1938,273,183,332,379,18,13,2,59,196,28,53,0,0
1939,275,179,332,370,18,13,2,57,191,29,53,0,0
1940,276,179,331,366,18,13,2,55,187,30,53,0,0
1941,277,176,331,359,18,13,2,54,183,31,53,0,0
1942,277,176,330,355,18,13,2,53,179,32,53,0,0
1943,281,174,332,346,18,13,2,51,172,33,53,0,0
1944,284,174,333,342,18,13,2,49,168,34,53,0,0
1945,284,173,332,336,18,13,2,48,163,35,53,0,0
1946,284,170,331,329,18,13,2,47,159,36,53,0,0
1947,284,171,329,324,18,13,2,45,153,37,53,0,0
1948,286,167,331,320,18,13,2,45,153,38,53,0,0
1949,288,166,331,315,18,13,2,43,149,39,53,0,0
1950,287,165,330,311,18,13,2,43,146,40,53,0,0
1951,284,161,327,308,18,13,2,43,147,41,53,0,0
1952,283,160,326,306,18,13,2,43,146,42,53,0,0
1953,284,157,327,303,18,13,2,43,146,43,53,0,0
1954,285,159,326,301,18,13,2,41,142,44,53,0,0
1955,283,156,323,297,18,13,2,40,141,45,53,0,0
1956,282,151,321,290,18,13,2,39,139,46,53,0,0
1957,281,147,321,290,18,13,2,40,143,47,53,0,0
1958,282,144,321,286,18,13,2,39,142,48,53,0,0
1959,282,148,319,283,18,13,2,37,135,49,53,0,0
1960,280,148,317,280,18,13,2,37,132,50,53,0,0
1961,278,147,314,278,18,13,2,36,131,51,53,0,0
1962,279,146,315,277,18,13,2,36,131,52,53,0,0
1963,281,145,316,273,18,13,2,35,128,53,53,1,0
1916,769,302,869,444,19,13,2,100,142,0,5,0,0
1917,769,302,869,444,19,13,2,100,142,1,5,0,0
1918,769,301,869,442,19,13,2,100,141,2,5,0,0
1919,770,301,869,441,19,13,2,99,140,3,5,0,0
1920,770,301,869,441,19,13,2,99,140,4,5,0,0
1921,770,301,869,441,19,13,2,99,140,5,5,0,0
2023,810,358,882,483,20,13,2,72,125,0,3,0,0
2024,809,357,882,483,20,13,2,73,126,1,3,0,0
2025,809,356,882,483,20,13,2,73,127,2,3,0,0
2026,809,355,882,482,20,13,2,73,127,3,3,0,0
2035,814,390,873,470,21,13,2,59,80,0,0,0,0
2075,809,349,881,484,22,13,2,72,135,0,0,0,0
2086,767,301,874,476,23,13,2,107,175,0,5,0,0
2087,765,300,873,476,23,13,2,108,176,1,5,0,0
2088,769,306,864,461,23,13,2,95,155,2,5,0,0
2089,771,308,860,455,23,13,2,89,147,3,5,0,0
2095,807,360,878,476,23,13,2,71,116,0,5,0,0
2096,812,367,879,477,23,13,2,67,110,1,5,0,0
2101,807,358,881,482,23,13,2,74,124,0,5,0,0
2102,807,358,881,482,23,13,2,74,124,1,5,0,0
2103,807,354,881,482,23,13,2,74,128,2,5,0,0
2104,806,351,881,481,23,13,2,75,130,3,5,0,0
2105,807,354,880,482,23,13,2,73,128,4,5,0,0
2106,808,356,881,482,23,13,2,73,126,5,5,0,0
2133,665,547,1192,1079,26,13,2,527,532,0,59,0,1
2134,552,490,1123,1078,26,13,2,571,588,1,59,0,0
2135,476,453,1066,1077,26,13,2,590,624,2,59,0,0
2136,415,412,1018,1071,26,13,2,603,659,3,59,0,0
2137,388,374,952,1013,26,13,2,564,639,4,59,0,0
2138,379,363,897,972,26,13,2,518,609,5,59,0,0
2139,363,340,821,899,26,13,2,458,559,6,59,0,0
2140,341,322,769,868,26,13,2,428,546,7,59,0,0
2141,339,306,733,831,26,13,2,394,525,8,59,0,0
2142,344,282,692,767,26,13,2,348,485,9,59,0,0
2143,343,279,654,733,26,13,2,311,454,10,59,0,0
2144,340,265,615,681,26,13,2,275,416,11,59,0,0
2145,335,254,592,661,26,13,2,257,407,12,59,0,0
2146,340,251,577,643,26,13,2,237,392,13,59,0,0
2147,339,233,553,602,26,13,2,214,369,14,59,0,0
2148,337,232,534,585,26,13,2,197,353,15,59,0,0
2149,332,228,511,560,26,13,2,179,332,16,59,0,0
2150,329,221,495,542,26,13,2,166,321,17,59,0,0
2151,332,218,487,529,26,13,2,155,311,18,59,0,0
2152,334,209,476,504,26,13,2,142,295,19,59,0,0
2153,333,208,468,495,26,13,2,135,287,20,59,0,0
2154,328,205,454,479,26,13,2,126,274,21,59,0,0
2155,329,200,447,463,26,13,2,118,263,22,59,0,0
2156,332,199,445,456,26,13,2,113,257,23,59,0,0
2157,336,195,440,437,26,13,2,104,242,24,59,0,0
2158,335,192,434,428,26,13,2,99,236,25,59,0,0
2159,331,193,425,420,26,13,2,94,227,26,59,0,0
2160,331,193,418,409,26,13,2,87,216,27,59,0,0
2161,332,191,416,402,26,13,2,84,211,28,59,0,0
2162,333,184,415,392,26,13,2,82,208,29,59,0,0
2163,330,176,411,385,26,13,2,81,209,30,59,0,0
2164,327,176,406,382,26,13,2,79,206,31,59,0,0
2165,324,174,398,369,26,13,2,74,195,32,59,0,0
2166,324,176,394,364,26,13,2,70,188,33,59,0,0
2167,324,177,389,352,26,13,2,65,175,34,59,0,0
2168,320,177,384,350,26,13,2,64,173,35,59,0,0
2169,317,177,379,347,26,13,2,62,170,36,59,0,0
2170,316,175,374,337,26,13,2,58,162,37,59,0,0
2171,316,177,371,333,26,13,2,55,156,38,59,0,0
2172,320,176,371,322,26,13,2,51,146,39,59,0,0
2173,321,175,372,323,26,13,2,51,148,40,59,0,0
2174,322,175,373,322,26,13,2,51,147,41,59,0,0
2175,322,169,373,318,26,13,2,51,149,42,59,0,0
2176,325,173,372,311,26,13,2,47,138,43,59,0,0
2177,329,174,372,303,26,13,2,43,129,44,59,0,0
2178,329,161,376,299,26,13,2,47,138,45,59,0,0
2179,330,166,374,296,26,13,2,44,130,46,59,0,0
2180,329,167,372,295,26,13,2,43,128,47,59,0,0
2181,327,157,372,293,26,13,2,45,136,48,59,0,0
2182,327,157,371,290,26,13,2,44,133,49,59,0,0
2183,328,151,371,284,26,13,2,43,133,50,59,0,0
2184,329,154,369,277,26,13,2,40,123,51,59,0,0
2185,329,157,367,276,26,13,2,38,119,52,59,0,0
2186,325,152,365,275,26,13,2,40,123,53,59,0,0
2187,325,152,363,272,26,13,2,38,120,54,59,0,0
2188,323,148,361,268,26,13,2,38,120,55,59,0,0
2189,321,148,358,265,26,13,2,37,117,56,59,0,0
2190,318,150,355,265,26,13,2,37,115,57,59,0,0
2191,315,147,352,264,26,13,2,37,117,58,59,0,0
2192,313,148,348,261,26,13,2,35,113,59,59,1,0
2256,814,355,877,482,27,13,2,63,127,0,5,0,0
2257,814,355,877,482,27,13,2,63,127,1,5,0,0
2258,814,355,877,482,27,13,2,63,127,2,5,0,0
2259,813,354,877,482,27,13,2,64,128,3,5,0,0
2260,814,354,877,481,27,13,2,63,127,4,5,0,0
2261,814,354,877,481,27,13,2,63,127,5,5,0,0
2266,811,348,880,487,27,13,2,69,139,0,5,0,0
2267,814,353,878,483,27,13,2,64,130,1,5,0,0
2268,814,353,878,481,27,13,2,64,128,2,5,0,0
2269,815,355,878,480,27,13,2,63,125,3,5,0,0
2270,814,353,878,482,27,13,2,64,129,4,5,0,0
2271,814,353,879,482,27,13,2,65,129,5,5,0,0
2286,811,348,879,482,27,13,2,68,134,0,5,0,0
2287,811,347,880,481,27,13,2,69,134,1,5,0,0
2288,810,347,881,482,27,13,2,71,135,2,5,0,0
2289,811,347,881,482,27,13,2,70,135,3,5,0,0
2290,811,347,881,482,27,13,2,70,135,4,5,0,0
2291,811,347,882,482,27,13,2,71,135,5,5,0,0
2321,815,347,879,484,28,13,2,64,137,0,10,0,0
2322,815,347,879,484,28,13,2,64,137,1,10,0,0
2323,815,350,877,483,28,13,2,62,133,2,10,0,0
2324,815,348,878,482,28,13,2,63,134,3,10,0,0
2325,816,349,877,481,28,13,2,61,132,4,10,0,0
2326,817,354,878,484,28,13,2,61,130,5,10,0,0
2327,817,355,880,485,28,13,2,63,130,6,10,0,0
2328,817,354,881,486,28,13,2,64,132,7,10,0,0
2329,818,355,884,491,28,13,2,66,136,8,10,0,0
2330,816,356,881,486,28,13,2,65,130,9,10,0,0
2331,817,357,881,487,28,13,2,64,130,10,10,0,0
2416,767,312,876,480,29,13,2,109,168,0,0,0,0
2418,769,312,876,481,30,13,2,107,169,0,0,0,0
2420,768,311,875,481,31,13,2,107,170,0,0,0,0
2506,809,356,879,483,32,13,2,70,127,0,5,0,0
2507,809,356,879,483,32,13,2,70,127,1,5,0,0
2508,808,353,879,483,32,13,2,71,130,2,5,0,0
2509,808,353,879,482,32,13,2,71,129,3,5,0,0
2510,808,354,879,482,32,13,2,71,128,4,5,0,0
2511,808,354,879,482,32,13,2,71,128,5,5,0,0
2526,813,351,882,481,32,13,2,69,130,0,5,0,0
2527,814,351,882,483,32,13,2,68,132,1,5,0,0
2528,814,351,881,483,32,13,2,67,132,2,5,0,0
2529,815,351,881,484,32,13,2,66,133,3,5,0,0
2530,815,350,880,484,32,13,2,65,134,4,5,0,0
2531,815,350,880,485,32,13,2,65,135,5,5,0,0
2578,488,540,1014,1076,35,13,2,526,536,0,3,0,0
2579,440,503,985,1073,35,13,2,545,570,1,3,0,0
2580,410,460,952,1048,35,13,2,542,588,2,3,0,0
2581,357,419,934,1045,35,13,2,577,626,3,3,0,0
2581,562,437,750,988,36,13,2,188,551,0,42,0,1
2582,536,400,712,916,36,13,2,176,516,1,42,0,0
2583,502,374,678,887,36,13,2,176,513,2,42,0,0
2584,486,353,656,852,36,13,2,170,499,3,42,0,0
2585,471,327,625,783,36,13,2,154,456,4,42,0,0
2586,449,323,594,753,36,13,2,145,430,5,42,0,0
2587,432,299,568,704,36,13,2,136,405,6,42,0,0
2588,414,287,546,683,36,13,2,132,396,7,42,0,0
2589,404,278,526,647,36,13,2,122,369,8,42,0,0
2590,393,263,508,611,36,13,2,115,348,9,42,0,0
2591,385,257,494,589,36,13,2,109,332,10,42,0,0
2592,375,247,480,566,36,13,2,105,319,11,42,0,0
2593,364,243,466,556,36,13,2,102,313,12,42,0,0
2594,360,236,454,524,36,13,2,94,288,13,42,0,0
2595,351,234,442,512,36,13,2,91,278,14,42,0,0
2596,345,229,430,492,36,13,2,85,263,15,42,0,0
2597,340,228,420,474,36,13,2,80,246,16,42,0,0
2598,339,228,414,462,36,13,2,75,234,17,42,0,0
2599,338,222,411,452,36,13,2,73,230,18,42,0,0
2600,336,220,408,446,36,13,2,72,226,19,42,0,0
2601,335,212,404,430,36,13,2,69,218,20,42,0,0
2602,335,216,400,420,36,13,2,65,204,21,42,0,0
2603,338,217,398,408,36,13,2,60,191,22,42,0,0
2604,338,213,396,399,36,13,2,58,186,23,42,0,0
2605,336,210,394,393,36,13,2,58,183,24,42,0,0
2606,335,210,389,381,36,13,2,54,171,25,42,0,0
2607,333,209,385,377,36,13,2,52,168,26,42,0,0
2608,332,209,380,364,36,13,2,48,155,27,42,0,0
2609,330,211,377,360,36,13,2,47,149,28,42,0,0
2610,326,206,373,355,36,13,2,47,149,29,42,0,0
2611,322,197,370,350,36,13,2,48,153,30,42,0,0
2612,322,194,367,337,36,13,2,45,143,31,42,0,0
2613,321,190,366,334,36,13,2,45,144,32,42,0,0
2614,318,189,362,332,36,13,2,44,143,33,42,0,0
2615,315,186,359,326,36,13,2,44,140,34,42,0,0
2616,315,186,358,323,36,13,2,43,137,35,42,0,0
2617,316,188,356,317,36,13,2,40,129,36,42,0,0
2618,317,186,356,314,36,13,2,39,128,37,42,0,0
2619,317,183,356,310,36,13,2,39,127,38,42,0,0
2620,317,181,354,304,36,13,2,37,123,39,42,0,0
2621,316,179,353,302,36,13,2,37,123,40,42,0,0
2622,317,179,352,293,36,13,2,35,114,41,42,0,0
2623,316,179,351,292,36,13,2,35,113,42,42,1,0
2609,810,362,876,479,37,13,2,66,117,0,12,0,0
2610,810,364,874,478,37,13,2,64,114,1,12,0,0
2611,813,367,876,479,37,13,2,63,112,2,12,0,0
2612,812,365,876,480,37,13,2,64,115,3,12,0,0
2613,813,368,876,480,37,13,2,63,112,4,12,0,0
2614,814,367,877,479,37,13,2,63,112,5,12,0,0
2615,813,369,876,479,37,13,2,63,110,6,12,0,0
2616,815,385,868,477,37,13,2,53,92,7,12,0,0
2617,817,392,865,473,37,13,2,48,81,8,12,0,0
2618,815,393,865,475,37,13,2,50,82,9,12,0,0
2619,815,394,864,472,37,13,2,49,78,10,12,0,0
2620,815,393,865,471,37,13,2,50,78,11,12,0,0
2621,816,395,863,471,37,13,2,47,76,12,12,0,0
2626,815,359,878,484,38,13,2,63,125,0,5,0,0
2627,815,361,875,480,38,13,2,60,119,1,5,0,0
2628,814,356,878,483,38,13,2,64,127,2,5,0,0
2629,814,358,876,482,38,13,2,62,124,3,5,0,0
2630,813,361,876,484,38,13,2,63,123,4,5,0,0
2631,813,361,876,485,38,13,2,63,124,5,5,0,0
2654,820,396,863,471,38,13,2,43,75,0,5,0,0
2655,819,392,867,472,38,13,2,48,80,1,5,0,0
2656,819,393,866,472,38,13,2,47,79,2,5,0,0
2661,812,368,874,471,38,13,2,62,103,0,5,0,0
2662,811,366,874,473,38,13,2,63,107,1,5,0,0
2663,811,366,874,472,38,13,2,63,106,2,5,0,0
2664,814,372,873,471,38,13,2,59,99,3,5,0,0
2665,813,369,874,472,38,13,2,61,103,4,5,0,0
2666,812,367,875,472,38,13,2,63,105,5,5,0,0
2676,808,352,880,477,38,13,2,72,125,0,5,0,0
2677,809,355,879,479,38,13,2,70,124,1,5,0,0
2678,808,353,879,481,38,13,2,71,128,2,5,0,0
2679,809,352,879,481,38,13,2,70,129,3,5,0,0
2680,809,352,878,482,38,13,2,69,130,4,5,0,0
2681,808,351,879,482,38,13,2,71,131,5,5,0,0
2653,813,394,874,472,39,13,2,61,78,0,0,0,0
2696,811,399,870,469,40,13,2,59,70,0,1,0,0
2700,810,399,869,469,40,13,2,59,70,0,1,0,0
2701,810,399,869,469,40,13,2,59,70,1,1,0,0
2816,813,385,875,477,41,13,2,62,92,0,0,0,0
2818,812,382,876,478,42,13,2,64,96,0,0,0,0
2821,811,391,867,467,43,13,2,56,76,0,0,0,0
2875,814,377,871,473,44,13,2,57,96,0,0,0,0
2901,814,387,873,471,45,13,2,59,84,0,4,0,0
2902,812,383,874,471,45,13,2,62,88,1,4,0,0
2903,812,382,874,471,45,13,2,62,89,2,4,0,0
2904,811,381,874,471,45,13,2,63,90,3,4,0,0
2905,810,380,875,472,45,13,2,65,92,4,4,0,0
3087,814,392,876,475,46,13,2,62,83,0,0,0,0
3089,815,387,873,474,47,13,2,58,87,0,1,0,0
3090,816,388,872,472,47,13,2,56,84,1,1,0,0
3338,813,400,873,472,48,13,2,60,72,0,0,0,0
3341,814,399,872,470,49,13,2,58,71,0,0,0,0
3466,811,364,873,474,50,13,2,62,110,0,0,0,0
3553,455,849,629,1074,52,13,2,174,225,0,50,0,1
3554,402,781,627,1070,52,13,2,225,289,1,50,0,0
3555,339,730,603,1068,52,13,2,264,338,2,50,0,0
3556,268,663,582,1065,52,13,2,314,402,3,50,0,0
3557,215,593,583,1065,52,13,2,368,472,4,50,0,0
3558,195,557,589,1067,52,13,2,394,510,5,50,0,0
3559,168,511,593,1071,52,13,2,425,560,6,50,0,0
3560,149,476,589,1074,52,13,2,440,598,7,50,0,0
3561,144,455,582,1071,52,13,2,438,616,8,50,0,0
3562,152,431,572,1044,52,13,2,420,613,9,50,0,0
3563,163,410,562,1012,52,13,2,399,602,10,50,0,0
3564,183,399,564,999,52,13,2,381,600,11,50,0,0
3565,220,384,565,952,52,13,2,345,568,12,50,0,0
3566,243,374,564,924,52,13,2,321,550,13,50,0,0
3567,251,368,561,920,52,13,2,310,552,14,50,0,0
3568,254,365,551,909,52,13,2,297,544,15,50,0,0
3569,261,346,534,862,52,13,2,273,516,16,50,0,0
3570,267,336,522,835,52,13,2,255,499,17,50,0,0
3571,272,330,513,823,52,13,2,241,493,18,50,0,0
3572,284,318,509,790,52,13,2,225,472,19,50,0,0
3573,296,307,505,755,52,13,2,209,448,20,50,0,0
3574,302,299,501,740,52,13,2,199,441,21,50,0,0
3575,302,292,489,718,52,13,2,187,426,22,50,0,0
3576,295,284,471,696,52,13,2,176,412,23,50,0,0
3577,287,281,456,688,52,13,2,169,407,24,50,0,0
3578,293,275,449,661,52,13,2,156,386,25,50,0,0
3579,297,272,444,645,52,13,2,147,373,26,50,0,0
3580,298,271,437,634,52,13,2,139,363,27,50,0,0
3581,293,267,421,605,52,13,2,128,338,28,50,0,0
3582,291,259,414,589,52,13,2,123,330,29,50,0,0
3583,290,255,409,581,52,13,2,119,326,30,50,0,0
3584,290,255,404,575,52,13,2,114,320,31,50,0,0
3585,291,250,401,562,52,13,2,110,312,32,50,0,0
3586,292,244,404,556,52,13,2,112,312,33,50,0,0
3587,300,241,409,549,52,13,2,109,308,34,50,0,0
3588,313,237,414,526,52,13,2,101,289,35,50,0,0
3589,328,242,413,487,52,13,2,85,245,36,50,0,0
3590,355,233,416,403,52,13,2,61,170,37,50,0,0
3591,359,220,428,406,52,13,2,69,186,38,50,0,0
3592,366,217,432,388,52,13,2,66,171,39,50,0,0
3593,369,217,440,398,52,13,2,71,181,40,50,0,0
3594,366,219,449,434,52,13,2,83,215,41,50,0,0
3595,362,216,451,448,52,13,2,89,232,42,50,0,0
3596,363,214,451,448,52,13,2,88,234,43,50,0,0
3597,363,209,448,440,52,13,2,85,231,44,50,0,0
3598,362,207,447,440,52,13,2,85,233,45,50,0,0
3599,359,205,443,439,52,13,2,84,234,46,50,0,0
3600,352,202,434,428,52,13,2,82,226,47,50,0,0
3601,351,203,423,402,52,13,2,72,199,48,50,0,0
3602,353,205,410,361,52,13,2,57,156,49,50,0,0
3603,354,202,408,350,52,13,2,54,148,50,50,1,0
3620,279,176,329,329,52,13,2,50,153,0,50,0,0
3621,274,175,325,327,52,13,2,51,152,1,50,0,0
3567,571,443,786,1004,56,13,2,215,561,0,74,0,1
3568,547,429,759,984,56,13,2,212,555,1,74,0,0
3569,534,412,739,947,56,13,2,205,535,2,74,0,0
3570,511,392,710,908,56,13,2,199,516,3,74,0,0
3571,491,381,689,894,56,13,2,198,513,4,74,0,0
3572,485,358,675,854,56,13,2,190,496,5,74,0,0
3573,480,344,659,810,56,13,2,179,466,6,74,0,0
3574,473,336,645,783,56,13,2,172,447,7,74,0,0
3575,465,325,628,751,56,13,2,163,426,8,74,0,0
3576,463,317,620,728,56,13,2,157,411,9,74,0,0
3577,464,316,617,719,56,13,2,153,403,10,74,0,0
3578,468,306,620,707,56,13,2,152,401,11,74,0,0
3579,476,291,617,669,56,13,2,141,378,12,74,0,0
3580,476,287,613,653,56,13,2,137,366,13,74,0,0
3581,476,279,604,618,56,13,2,128,339,14,74,0,0
3582,475,273,599,604,56,13,2,124,331,15,74,0,0
3583,475,264,597,592,56,13,2,122,328,16,74,0,0
3584,473,255,590,570,56,13,2,117,315,17,74,0,0
3585,500,250,601,520,56,13,2,101,270,18,74,0,0
3586,504,244,605,513,56,13,2,101,269,19,74,0,0
3587,492,245,604,546,56,13,2,112,301,20,74,0,0
3588,485,240,594,538,56,13,2,109,298,21,74,0,0
3589,475,239,582,533,56,13,2,107,294,22,74,0,0
3590,473,241,575,524,56,13,2,102,283,23,74,0,0
3591,473,233,569,505,56,13,2,96,272,24,74,0,0
3592,471,228,565,496,56,13,2,94,268,25,74,0,0
3593,466,227,557,489,56,13,2,91,262,26,74,0,0
3594,457,224,545,477,56,13,2,88,253,27,74,0,0
3595,449,222,532,463,56,13,2,83,241,28,74,0,0
3596,445,220,528,459,56,13,2,83,239,29,74,0,0
3597,441,216,523,455,56,13,2,82,239,30,74,0,0
3598,437,211,519,449,56,13,2,82,238,31,74,0,0
3599,432,210,512,447,56,13,2,80,237,32,74,0,0
3600,426,203,506,441,56,13,2,80,238,33,74,0,0
3601,423,198,502,432,56,13,2,79,234,34,74,0,0
3602,421,200,497,424,56,13,2,76,224,35,74,0,0
3603,420,199,494,418,56,13,2,74,219,36,74,0,0
3604,420,198,493,414,56,13,2,73,216,37,74,0,0
3605,416,195,487,408,56,13,2,71,213,38,74,0,0
3606,412,199,480,400,56,13,2,68,201,39,74,0,0
3607,407,197,473,394,56,13,2,66,197,40,74,0,0
3608,406,197,470,389,56,13,2,64,192,41,74,0,0
3609,406,197,468,385,56,13,2,62,188,42,74,0,0
3610,404,193,467,384,56,13,2,63,191,43,74,0,0
3611,399,192,460,376,56,13,2,61,184,44,74,0,0
3612,394,190,453,370,56,13,2,59,180,45,74,0,0
3613,390,184,449,365,56,13,2,59,181,46,74,0,0
3614,387,183,444,360,56,13,2,57,177,47,74,0,0
3615,386,181,444,359,56,13,2,58,178,48,74,0,0
3616,387,181,444,357,56,13,2,57,176,49,74,0,0
3617,386,181,441,352,56,13,2,55,171,50,74,0,0
3618,382,181,437,349,56,13,2,55,168,51,74,0,0
3619,379,178,433,344,56,13,2,54,166,52,74,0,0
3620,377,178,430,342,56,13,2,53,164,53,74,0,0
3621,378,178,429,339,56,13,2,51,161,54,74,0,0
3622,376,174,427,335,56,13,2,51,161,55,74,0,0
3623,372,173,422,330,56,13,2,50,157,56,74,0,0
3624,367,172,417,328,56,13,2,50,156,57,74,0,0
3625,363,171,412,325,56,13,2,49,154,58,74,0,0
3626,361,172,407,312,56,13,2,46,140,59,74,0,0
3627,359,173,404,309,56,13,2,45,136,60,74,0,0
3628,357,174,402,311,56,13,2,45,137,61,74,0,0
3629,356,176,399,307,56,13,2,43,131,62,74,0,0
3630,353,177,396,308,56,13,2,43,131,63,74,0,0
3631,351,173,395,305,56,13,2,44,132,64,74,0,0
3632,351,172,394,302,56,13,2,43,130,65,74,0,0
3633,352,171,395,302,56,13,2,43,131,66,74,0,0
3634,354,168,396,297,56,13,2,42,129,67,74,0,0
3635,355,169,396,295,56,13,2,41,126,68,74,0,0
3636,355,166,397,294,56,13,2,42,128,69,74,0,0
3637,353,165,394,293,56,13,2,41,128,70,74,0,0
3638,353,162,395,290,56,13,2,42,128,71,74,0,0
3639,354,163,395,289,56,13,2,41,126,72,74,0,0
3640,356,159,399,292,56,13,2,43,133,73,74,0,0
3641,355,158,398,290,56,13,2,43,132,74,74,1,0
3643,358,155,400,283,56,13,2,42,128,0,74,0,0
3644,358,154,399,278,56,13,2,41,124,1,74,0,0
3645,358,155,398,276,56,13,2,40,121,2,74,0,0
3646,358,153,399,278,56,13,2,41,125,3,74,0,0
3647,360,155,399,274,56,13,2,39,119,4,74,0,0
3648,359,154,398,272,56,13,2,39,118,5,74,0,0
3649,358,153,396,269,56,13,2,38,116,6,74,0,0
3650,355,150,393,265,56,13,2,38,115,7,74,0,0
3651,355,151,391,262,56,13,2,36,111,8,74,0,0
3652,354,150,390,257,56,13,2,36,107,9,74,0,0
3653,351,150,389,262,56,13,2,38,112,10,74,0,0
3654,349,151,387,261,56,13,2,38,110,11,74,0,0
3655,347,151,384,259,56,13,2,37,108,12,74,0,0
3656,345,152,380,254,56,13,2,35,102,13,74,0,0
3583,502,452,720,1031,58,13,2,218,579,0,59,0,1
3584,448,279,723,1014,58,13,2,275,735,1,59,0,0
3585,428,343,660,966,58,13,2,232,623,2,59,0,0
3586,409,382,617,942,58,13,2,208,560,3,59,0,0
3587,384,390,566,882,58,13,2,182,492,4,59,0,0
3588,366,387,538,853,58,13,2,172,466,5,59,0,0
3589,351,379,521,840,58,13,2,170,461,6,59,0,0
3590,320,315,497,802,58,13,2,177,487,7,59,0,0
3591,303,309,474,789,58,13,2,171,480,8,59,0,0
3592,296,314,457,774,58,13,2,161,460,9,59,0,0
3593,298,301,447,735,58,13,2,149,434,10,59,0,0
3594,295,314,434,722,58,13,2,139,408,11,59,0,0
3595,288,308,417,690,58,13,2,129,382,12,59,0,0
3596,280,296,405,669,58,13,2,125,373,13,59,0,0
3597,278,290,402,664,58,13,2,124,374,14,59,0,0
3598,289,286,402,627,58,13,2,113,341,15,59,0,0
3599,292,279,401,608,58,13,2,109,329,16,59,0,0
3600,297,269,405,598,58,13,2,108,329,17,59,0,0
3601,301,271,399,572,58,13,2,98,301,18,59,0,0
3602,300,261,401,572,58,13,2,101,311,19,59,0,0
3603,304,217,410,551,58,13,2,106,334,20,59,0,0
3604,306,198,412,541,58,13,2,106,343,21,59,0,0
3605,305,188,412,541,58,13,2,107,353,22,59,0,0
3606,306,180,406,520,58,13,2,100,340,23,59,0,0
3607,306,176,404,517,58,13,2,98,341,24,59,0,0
3608,312,185,402,505,58,13,2,90,320,25,59,0,0
3609,311,180,398,495,58,13,2,87,315,26,59,0,0
3610,317,201,395,483,58,13,2,78,282,27,59,0,0
3611,316,214,386,465,58,13,2,70,251,28,59,0,0
3612,307,199,380,456,58,13,2,73,257,29,59,0,0
3613,300,184,377,457,58,13,2,77,273,30,59,0,0
3614,300,187,372,440,58,13,2,72,253,31,59,0,0
3615,300,185,370,434,58,13,2,70,249,32,59,0,0
3616,305,194,371,427,58,13,2,66,233,33,59,0,0
3617,308,202,368,415,58,13,2,60,213,34,59,0,0
3618,305,195,366,412,58,13,2,61,217,35,59,0,0
3619,312,190,369,394,58,13,2,57,204,36,59,0,0
3620,312,192,369,396,58,13,2,57,204,37,59,0,0
3621,302,184,362,398,58,13,2,60,214,38,59,0,0
3622,295,184,352,389,58,13,2,57,205,39,59,0,0
3623,289,181,344,378,58,13,2,55,197,40,59,0,0
3624,288,178,341,373,58,13,2,53,195,41,59,0,0
3625,286,175,338,372,58,13,2,52,197,42,59,0,0
3626,286,176,338,372,58,13,2,52,196,43,59,0,0
3627,285,180,335,365,58,13,2,50,185,44,59,0,0
3628,286,175,336,365,58,13,2,50,190,45,59,0,0
3629,291,183,338,361,58,13,2,47,178,46,59,0,0
3630,292,182,339,357,58,13,2,47,175,47,59,0,0
3631,294,181,340,354,58,13,2,46,173,48,59,0,0
3632,294,179,339,346,58,13,2,45,167,49,59,0,0
3633,293,178,337,341,58,13,2,44,163,50,59,0,0
3634,294,178,337,337,58,13,2,43,159,51,59,0,0
3635,296,177,338,334,58,13,2,42,157,52,59,0,0
3636,296,176,338,333,58,13,2,42,157,53,59,0,0
3637,296,176,337,328,58,13,2,41,152,54,59,0,0
3638,299,187,337,325,58,13,2,38,138,55,59,0,0
3639,300,177,339,322,58,13,2,39,145,56,59,0,0
3640,297,167,338,317,58,13,2,41,150,57,59,0,0
3641,299,169,338,313,58,13,2,39,144,58,59,0,0
3642,299,168,337,309,58,13,2,38,141,59,59,1,0
3648,301,164,336,295,58,13,2,35,131,0,59,0,0
3657,304,149,339,273,58,13,2,35,124,0,59,0,0
3658,304,148,339,272,58,13,2,35,124,1,59,0,0
3606,810,396,872,470,59,13,2,62,74,0,5,0,0
3607,811,400,872,473,59,13,2,61,73,1,5,0,0
3608,809,395,873,472,59,13,2,64,77,2,5,0,0
3609,809,394,873,471,59,13,2,64,77,3,5,0,0
3610,810,399,872,473,59,13,2,62,74,4,5,0,0
3611,810,399,873,473,59,13,2,63,74,5,5,0,0
3619,288,177,324,335,60,13,2,36,158,0,0,0,0
3639,276,155,311,292,62,13,2,35,137,0,3,0,0
3640,276,154,314,301,62,13,2,38,147,1,3,0,0
3641,277,158,313,299,62,13,2,36,141,2,3,0,0
3642,278,160,313,299,62,13,2,35,139,3,3,0,0
3667,278,114,317,260,62,13,2,39,146,0,3,0,0
3668,285,125,321,257,62,13,2,36,132,1,3,0,0
3669,286,123,322,257,62,13,2,36,134,2,3,0,0
3671,817,392,874,472,64,13,2,57,80,0,5,0,0
3672,817,392,873,471,64,13,2,56,79,1,5,0,0
3673,817,393,873,470,64,13,2,56,77,2,5,0,0
3674,816,390,874,471,64,13,2,58,81,3,5,0,0
3675,817,391,873,471,64,13,2,56,80,4,5,0,0
3676,816,391,874,471,64,13,2,58,80,5,5,0,0
3824,1087,816,1292,1070,67,13,2,205,254,0,0,0,0
3825,861,695,1224,1076,68,13,2,363,381,0,73,0,1
3826,753,645,1163,1076,68,13,2,410,431,1,73,0,0
3827,665,592,1119,1070,68,13,2,454,478,2,73,0,0
3828,554,530,1056,1064,68,13,2,502,534,3,73,0,0
3829,479,488,1004,1059,68,13,2,525,571,4,73,0,0
3830,438,452,986,1064,68,13,2,548,612,5,73,0,0
3831,407,419,967,1067,68,13,2,560,648,6,73,0,0
3832,392,401,927,1044,68,13,2,535,643,7,73,0,0
3833,377,370,880,999,68,13,2,503,629,8,73,0,0
3834,368,361,843,981,68,13,2,475,620,9,73,0,0
3835,373,344,799,926,68,13,2,426,582,10,73,0,0
3836,374,328,755,870,68,13,2,381,542,11,73,0,0
3837,376,311,722,822,68,13,2,346,511,12,73,0,0
3838,367,297,682,785,68,13,2,315,488,13,73,0,0
3839,360,285,658,764,68,13,2,298,479,14,73,0,0
3840,349,276,629,746,68,13,2,280,470,15,73,0,0
3841,347,266,598,700,68,13,2,251,434,16,73,0,0
3842,336,261,565,671,68,13,2,229,410,17,73,0,0
3843,329,252,541,644,68,13,2,212,392,18,73,0,0
3844,321,244,522,626,68,13,2,201,382,19,73,0,0
3845,316,236,509,616,68,13,2,193,380,20,73,0,0
3846,314,229,491,588,68,13,2,177,359,21,73,0,0
3847,312,228,478,572,68,13,2,166,344,22,73,0,0
3848,312,223,466,548,68,13,2,154,325,23,73,0,0
3849,308,220,453,531,68,13,2,145,311,24,73,0,0
3850,305,222,443,527,68,13,2,138,305,25,73,0,0
3851,306,215,435,506,68,13,2,129,291,26,73,0,0
3852,306,212,428,491,68,13,2,122,279,27,73,0,0
3853,302,211,418,479,68,13,2,116,268,28,73,0,0
3854,297,204,407,465,68,13,2,110,261,29,73,0,0
3855,297,205,403,457,68,13,2,106,252,30,73,0,0
3856,301,204,405,447,68,13,2,104,243,31,73,0,0
3857,302,197,406,436,68,13,2,104,239,32,73,0,0
3858,297,196,398,431,68,13,2,101,235,33,73,0,0
3859,292,195,387,419,68,13,2,95,224,34,73,0,0
3860,286,191,377,415,68,13,2,91,224,35,73,0,0
3861,286,192,372,407,68,13,2,86,215,36,73,0,0
3862,286,185,371,401,68,13,2,85,216,37,73,0,0
3863,282,183,364,394,68,13,2,82,211,38,73,0,0
3864,277,179,355,387,68,13,2,78,208,39,73,0,0
3865,274,177,351,379,68,13,2,77,202,40,73,0,0
3866,276,176,351,376,68,13,2,75,200,41,73,0,0
3867,275,174,346,366,68,13,2,71,192,42,73,0,0
3868,273,173,342,362,68,13,2,69,189,43,73,0,0
3869,272,174,339,359,68,13,2,67,185,44,73,0,0
3870,272,174,336,354,68,13,2,64,180,45,73,0,0
3871,271,174,334,351,68,13,2,63,177,46,73,0,0
3872,273,174,334,343,68,13,2,61,169,47,73,0,0
3873,275,169,334,336,68,13,2,59,167,48,73,0,0
3874,276,167,334,334,68,13,2,58,167,49,73,0,0
3875,276,162,334,329,68,13,2,58,167,50,73,0,0
3876,276,163,333,326,68,13,2,57,163,51,73,0,0
3877,280,163,335,322,68,13,2,55,159,52,73,0,0
3878,283,160,337,319,68,13,2,54,159,53,73,0,0
3879,285,162,338,315,68,13,2,53,153,54,73,0,0
3880,287,160,338,308,68,13,2,51,148,55,73,0,0
3881,288,157,339,305,68,13,2,51,148,56,73,0,0
3882,289,158,339,304,68,13,2,50,146,57,73,0,0
3883,291,157,339,301,68,13,2,48,144,58,73,0,0
3884,292,158,339,297,68,13,2,47,139,59,73,0,0
3885,292,157,338,294,68,13,2,46,137,60,73,0,0
3886,291,153,337,291,68,13,2,46,138,61,73,0,0
3887,290,153,334,288,68,13,2,44,135,62,73,0,0
3888,290,150,334,285,68,13,2,44,135,63,73,0,0
3889,289,149,332,282,68,13,2,43,133,64,73,0,0
3890,289,151,332,281,68,13,2,43,130,65,73,0,0
3891,287,150,330,277,68,13,2,43,127,66,73,0,0
3892,286,149,327,276,68,13,2,41,127,67,73,0,0
3893,285,149,326,273,68,13,2,41,124,68,73,0,0
3894,286,149,326,271,68,13,2,40,122,69,73,0,0
3895,286,150,325,269,68,13,2,39,119,70,73,0,0
3896,286,150,323,266,68,13,2,37,116,71,73,0,0
3897,286,150,322,265,68,13,2,36,115,72,73,0,0
3898,285,150,320,262,68,13,2,35,112,73,73,1,0
3829,780,585,1263,1074,70,13,2,483,489,0,4,0,0
3830,703,544,1208,1069,70,13,2,505,525,1,4,0,0
3831,638,492,1178,1073,70,13,2,540,581,2,4,0,0
3832,596,461,1144,1071,70,13,2,548,610,3,4,0,0
3833,523,423,1106,1071,70,13,2,583,648,4,4,0,0
3833,737,420,940,976,71,13,2,203,556,0,55,0,1
3834,703,413,894,936,71,13,2,191,523,1,55,0,0
3835,680,404,865,915,71,13,2,185,511,2,55,0,0
3836,657,379,825,846,71,13,2,168,467,3,55,0,0
3837,635,360,805,827,71,13,2,170,467,4,55,0,0
3838,613,338,777,792,71,13,2,164,454,5,55,0,0
3839,596,319,749,744,71,13,2,153,425,6,55,0,0
3840,580,315,727,730,71,13,2,147,415,7,55,0,0
3841,560,300,700,697,71,13,2,140,397,8,55,0,0
3842,549,287,683,669,71,13,2,134,382,9,55,0,0
3843,530,286,661,660,71,13,2,131,374,10,55,0,0
3844,520,270,641,618,71,13,2,121,348,11,55,0,0
3845,506,265,622,600,71,13,2,116,335,12,55,0,0
3846,494,263,606,588,71,13,2,112,325,13,55,0,0
3847,474,254,580,566,71,13,2,106,312,14,55,0,0
3848,460,251,563,555,71,13,2,103,304,15,55,0,0
3849,444,242,541,531,71,13,2,97,289,16,55,0,0
3850,438,241,529,512,71,13,2,91,271,17,55,0,0
3851,432,243,518,499,71,13,2,86,256,18,55,0,0
3852,423,231,507,488,71,13,2,84,257,19,55,0,0
3853,418,230,499,476,71,13,2,81,246,20,55,0,0
3854,417,231,491,456,71,13,2,74,225,21,55,0,0
3855,414,222,488,448,71,13,2,74,226,22,55,0,0
3856,411,218,484,445,71,13,2,73,227,23,55,0,0
3857,406,216,477,433,71,13,2,71,217,24,55,0,0
3858,406,209,476,427,71,13,2,70,218,25,55,0,0
3859,407,206,475,422,71,13,2,68,216,26,55,0,0
3860,409,199,475,411,71,13,2,66,212,27,55,0,0
3861,405,199,468,401,71,13,2,63,202,28,55,0,0
3862,397,197,461,397,71,13,2,64,200,29,55,0,0
3863,392,195,454,388,71,13,2,62,193,30,55,0,0
3864,390,195,451,385,71,13,2,61,190,31,55,0,0
3865,389,199,446,378,71,13,2,57,179,32,55,0,0
3866,386,196,440,370,71,13,2,54,174,33,55,0,0
3867,382,196,435,365,71,13,2,53,169,34,55,0,0
3868,377,189,432,361,71,13,2,55,172,35,55,0,0
3869,375,183,429,357,71,13,2,54,174,36,55,0,0
3870,372,180,425,354,71,13,2,53,174,37,55,0,0
3871,371,177,422,344,71,13,2,51,167,38,55,0,0
3872,370,177,419,339,71,13,2,49,162,39,55,0,0
3873,368,177,416,336,71,13,2,48,159,40,55,0,0
3874,363,171,412,332,71,13,2,49,161,41,55,0,0
3875,361,176,407,328,71,13,2,46,152,42,55,0,0
3876,360,176,405,322,71,13,2,45,146,43,55,0,0
3877,357,174,401,319,71,13,2,44,145,44,55,0,0
3878,356,180,397,318,71,13,2,41,138,45,55,0,0
3879,353,174,394,313,71,13,2,41,139,46,55,0,0
3880,351,172,392,310,71,13,2,41,138,47,55,0,0
3881,351,173,390,306,71,13,2,39,133,48,55,0,0
3882,350,166,390,300,71,13,2,40,134,49,55,0,0
3883,350,166,390,297,71,13,2,40,131,50,55,0,0
3884,348,166,387,295,71,13,2,39,129,51,55,0,0
3885,346,164,385,294,71,13,2,39,130,52,55,0,0
3886,345,164,383,291,71,13,2,38,127,53,55,0,0
3887,345,162,381,287,71,13,2,36,125,54,55,0,0
3888,345,162,381,283,71,13,2,36,121,55,55,1,0
3890,344,160,379,279,71,13,2,35,119,0,55,0,0
3893,341,158,376,272,71,13,2,35,114,0,55,0,0
4771,769,305,876,473,77,13,2,107,168,0,0,0,0
4773,769,302,876,478,78,13,2,107,176,0,0,0,0
5207,988,831,1180,1070,80,13,2,192,239,0,0,0,0
5208,791,721,1122,1075,81,13,2,331,354,0,8,0,0
5209,711,633,1120,1069,81,13,2,409,436,1,8,0,0
5210,643,582,1098,1069,81,13,2,455,487,2,8,0,0
5211,531,512,1040,1066,81,13,2,509,554,3,8,0,0
5212,452,461,995,1069,81,13,2,543,608,4,8,0,0
5213,395,428,951,1069,81,13,2,556,641,5,8,0,0
5214,346,388,914,1068,81,13,2,568,680,6,8,0,0
5215,333,367,877,1043,81,13,2,544,676,7,8,0,0
5216,276,328,849,1039,81,13,2,573,711,8,8,0,0
5211,816,398,878,475,82,13,2,62,77,0,0,0,0
5216,484,353,668,937,83,13,2,184,584,0,56,0,1
5217,470,346,649,916,83,13,2,179,570,1,56,0,0
5218,456,323,623,853,83,13,2,167,530,2,56,0,0
5219,456,311,618,819,83,13,2,162,508,3,56,0,0
5220,456,300,617,793,83,13,2,161,493,4,56,0,0
5221,417,281,568,742,83,13,2,151,461,5,56,0,0
5222,401,276,544,715,83,13,2,143,439,6,56,0,0
5223,381,262,515,676,83,13,2,134,414,7,56,0,0
5224,382,258,515,654,83,13,2,133,396,8,56,0,0
5225,381,250,513,627,83,13,2,132,377,9,56,0,0
5226,348,235,474,603,83,13,2,126,368,10,56,0,0
5227,332,233,452,584,83,13,2,120,351,11,56,0,0
5228,320,227,433,559,83,13,2,113,332,12,56,0,0
5229,312,226,423,552,83,13,2,111,326,13,56,0,0
5230,305,221,406,527,83,13,2,101,306,14,56,0,0
5231,296,217,393,511,83,13,2,97,294,15,56,0,0
5232,290,215,382,499,83,13,2,92,284,16,56,0,0
5233,285,210,374,486,83,13,2,89,276,17,56,0,0
5234,286,209,374,480,83,13,2,88,271,18,56,0,0
5235,284,202,367,463,83,13,2,83,261,19,56,0,0
5236,281,199,361,453,83,13,2,80,254,20,56,0,0
5237,278,197,355,439,83,13,2,77,242,21,56,0,0
5238,278,192,355,433,83,13,2,77,241,22,56,0,0
5239,282,188,358,426,83,13,2,76,238,23,56,0,0
5240,276,188,349,416,83,13,2,73,228,24,56,0,0
5241,272,188,341,407,83,13,2,69,219,25,56,0,0
5242,266,181,335,397,83,13,2,69,216,26,56,0,0
5243,265,178,333,394,83,13,2,68,216,27,56,0,0
5244,266,176,333,387,83,13,2,67,211,28,56,0,0
5245,266,174,330,379,83,13,2,64,205,29,56,0,0
5246,265,175,327,375,83,13,2,62,200,30,56,0,0
5247,265,174,324,367,83,13,2,59,193,31,56,0,0
5248,270,172,328,360,83,13,2,58,188,32,56,0,0
5249,272,170,328,356,83,13,2,56,186,33,56,0,0
5250,274,168,329,351,83,13,2,55,183,34,56,0,0
5251,273,170,326,349,83,13,2,53,179,35,56,0,0
5252,272,158,327,341,83,13,2,55,183,36,56,0,0
5253,275,148,331,336,83,13,2,56,188,37,56,0,0
5254,277,152,329,331,83,13,2,52,179,38,56,0,0
5255,279,155,328,327,83,13,2,49,172,39,56,0,0
5256,280,154,328,325,83,13,2,48,171,40,56,0,0
5257,282,149,330,318,83,13,2,48,169,41,56,0,0
5258,286,152,331,313,83,13,2,45,161,42,56,0,0
5259,287,149,332,309,83,13,2,45,160,43,56,0,0
5260,287,149,331,305,83,13,2,44,156,44,56,0,0
5261,289,148,331,300,83,13,2,42,152,45,56,0,0
5262,288,147,330,299,83,13,2,42,152,46,56,0,0
5263,291,148,332,297,83,13,2,41,149,47,56,0,0
5264,289,146,330,291,83,13,2,41,145,48,56,0,0
5265,290,146,329,289,83,13,2,39,143,49,56,0,0
5266,288,144,327,286,83,13,2,39,142,50,56,0,0
5267,288,142,327,284,83,13,2,39,142,51,56,0,0
5268,289,142,328,283,83,13,2,39,141,52,56,0,0
5269,288,143,326,281,83,13,2,38,138,53,56,0,0
5270,287,142,324,279,83,13,2,37,137,54,56,0,0
5271,287,144,322,276,83,13,2,35,132,55,56,0,0
5272,289,142,324,271,83,13,2,35,129,56,56,1,0
813,568,163,610,362,2,13,3,42,199,0,63,0,1
814,543,171,584,362,2,13,3,41,191,1,63,0,0
815,522,172,565,368,2,13,3,43,196,2,63,0,0
816,503,173,546,364,2,13,3,43,191,3,63,0,0
817,475,173,520,368,2,13,3,45,195,4,63,0,0
818,456,172,500,361,2,13,3,44,189,5,63,0,0
819,429,173,474,357,2,13,3,45,184,6,63,0,0
820,411,172,457,356,2,13,3,46,184,7,63,0,0
821,397,167,445,350,2,13,3,48,183,8,63,0,0
822,393,168,442,349,2,13,3,49,181,9,63,0,0
823,390,165,439,342,2,13,3,49,177,10,63,0,0
824,385,164,434,340,2,13,3,49,176,11,63,0,0
825,382,166,431,344,2,13,3,49,178,12,63,0,0
826,379,168,427,343,2,13,3,48,175,13,63,0,0
827,371,169,420,346,2,13,3,49,177,14,63,0,0
828,363,173,414,353,2,13,3,51,180,15,63,0,0
829,356,175,408,358,2,13,3,52,183,16,63,0,0
830,350,177,405,365,2,13,3,55,188,17,63,0,0
831,349,176,407,370,2,13,3,58,194,18,63,0,0
832,351,176,412,376,2,13,3,61,200,19,63,0,0
833,352,179,415,388,2,13,3,63,209,20,63,0,0
834,345,179,412,396,2,13,3,67,217,21,63,0,0
835,349,180,418,401,2,13,3,69,221,22,63,0,0
836,354,182,425,414,2,13,3,71,232,23,63,0,0
837,359,185,430,418,2,13,3,71,233,24,63,0,0
838,361,190,434,430,2,13,3,73,240,25,63,0,0
839,363,193,436,437,2,13,3,73,244,26,63,0,0
840,368,192,444,443,2,13,3,76,251,27,63,0,0
841,374,199,454,456,2,13,3,80,257,28,63,0,0
842,380,196,462,460,2,13,3,82,264,29,63,0,0
843,385,198,470,471,2,13,3,85,273,30,63,0,0
844,388,204,475,483,2,13,3,87,279,31,63,0,0
845,393,207,483,495,2,13,3,90,288,32,63,0,0
846,398,212,493,515,2,13,3,95,303,33,63,0,0
847,409,218,504,523,2,13,3,95,305,34,63,0,0
848,417,230,517,548,2,13,3,100,318,35,63,0,0
849,420,239,520,555,2,13,3,100,316,36,63,0,0
850,429,241,533,567,2,13,3,104,326,37,63,0,0
851,443,241,552,586,2,13,3,109,345,38,63,0,0
852,460,239,573,596,2,13,3,113,357,39,63,0,0
853,474,245,591,618,2,13,3,117,373,40,63,0,0
854,483,255,603,636,2,13,3,120,381,41,63,0,0
855,493,259,618,654,2,13,3,125,395,42,63,0,0
856,503,271,634,686,2,13,3,131,415,43,63,0,0
857,514,277,650,703,2,13,3,136,426,44,63,0,0
858,524,285,674,751,2,13,3,150,466,45,63,0,0
859,531,300,686,777,2,13,3,155,477,46,63,0,0
860,536,311,696,799,2,13,3,160,488,47,63,0,0
861,546,326,715,848,2,13,3,169,522,48,63,0,0
862,563,342,736,872,2,13,3,173,530,49,63,0,0
863,568,362,756,936,2,13,3,188,574,50,63,0,0
864,575,385,769,977,2,13,3,194,592,51,63,0,0
865,578,394,782,1015,2,13,3,204,621,52,63,0,0
866,594,421,807,1060,2,13,3,213,639,53,63,0,0
867,618,442,835,1080,2,13,3,217,638,54,63,0,0
868,640,472,858,1080,2,13,3,218,608,55,63,0,0
869,662,510,876,1080,2,13,3,214,570,56,63,0,0
870,692,543,901,1080,2,13,3,209,537,57,63,0,0
871,740,600,939,1080,2,13,3,199,480,58,63,0,0
872,796,653,990,1080,2,13,3,194,427,59,63,0,0
873,839,711,1028,1079,2,13,3,189,368,60,63,0,0
874,871,794,1040,1080,2,13,3,169,286,61,63,0,0
875,925,879,1053,1079,2,13,3,128,200,62,63,0,0
876,980,981,1060,1078,2,13,3,80,97,63,63,1,0
989,890,410,1073,990,6,13,3,183,580,0,85,0,1
990,850,399,1033,979,6,13,3,183,580,1,85,0,0
991,812,383,988,939,6,13,3,176,556,2,85,0,0
992,774,362,939,881,6,13,3,165,519,3,85,0,0
993,725,358,885,857,6,13,3,160,499,4,85,0,0
994,686,342,839,815,6,13,3,153,473,5,85,0,0
995,647,327,798,796,6,13,3,151,469,6,85,0,0
996,615,316,765,782,6,13,3,150,466,7,85,0,0
997,593,305,735,743,6,13,3,142,438,8,85,0,0
998,561,293,701,723,6,13,3,140,430,9,85,0,0
999,537,284,673,699,6,13,3,136,415,10,85,0,0
1000,513,271,646,681,6,13,3,133,410,11,85,0,0
1001,499,267,629,670,6,13,3,130,403,12,85,0,0
1002,494,259,618,644,6,13,3,124,385,13,85,0,0
1003,490,251,610,624,6,13,3,120,373,14,85,0,0
1004,489,253,606,613,6,13,3,117,360,15,85,0,0
1005,482,243,595,589,6,13,3,113,346,16,85,0,0
1006,479,236,590,575,6,13,3,111,339,17,85,0,0
1007,481,230,588,556,6,13,3,107,326,18,85,0,0
1008,484,222,589,542,6,13,3,105,320,19,85,0,0
1009,485,221,587,529,6,13,3,102,308,20,85,0,0
1010,482,214,580,512,6,13,3,98,298,21,85,0,0
1011,479,211,575,500,6,13,3,96,289,22,85,0,0
1012,479,209,572,494,6,13,3,93,285,23,85,0,0
1013,481,206,571,475,6,13,3,90,269,24,85,0,0
1014,478,202,566,463,6,13,3,88,261,25,85,0,0
1015,471,201,555,452,6,13,3,84,251,26,85,0,0
1016,468,198,551,446,6,13,3,83,248,27,85,0,0
1017,468,196,548,437,6,13,3,80,241,28,85,0,0
1018,468,190,547,428,6,13,3,79,238,29,85,0,0
1019,467,190,545,424,6,13,3,78,234,30,85,0,0
1020,465,188,541,416,6,13,3,76,228,31,85,0,0
1021,464,185,538,407,6,13,3,74,222,32,85,0,0
1022,463,185,536,406,6,13,3,73,221,33,85,0,0
1023,466,178,539,397,6,13,3,73,219,34,85,0,0
1024,468,175,540,393,6,13,3,72,218,35,85,0,0
1025,466,174,536,386,6,13,3,70,212,36,85,0,0
1026,465,173,532,376,6,13,3,67,203,37,85,0,0
1027,463,175,528,370,6,13,3,65,195,38,85,0,0
1028,461,175,526,367,6,13,3,65,192,39,85,0,0
1029,458,173,521,361,6,13,3,63,188,40,85,0,0
1030,446,173,510,359,6,13,3,64,186,41,85,0,0
1031,434,171,501,356,6,13,3,67,185,42,85,0,0
1032,427,170,494,351,6,13,3,67,181,43,85,0,0
1033,427,170,493,345,6,13,3,66,175,44,85,0,0
1034,423,168,486,336,6,13,3,63,168,45,85,0,0
1035,416,168,477,332,6,13,3,61,164,46,85,0,0
1036,408,167,470,332,6,13,3,62,165,47,85,0,0
1037,402,163,463,327,6,13,3,61,164,48,85,0,0
1038,397,164,457,325,6,13,3,60,161,49,85,0,0
1039,391,159,450,321,6,13,3,59,162,50,85,0,0
1040,386,157,445,319,6,13,3,59,162,51,85,0,0
1041,381,158,439,317,6,13,3,58,159,52,85,0,0
1042,376,157,434,311,6,13,3,58,154,53,85,0,0
1043,376,159,436,308,6,13,3,60,149,54,85,0,0
1044,372,156,432,303,6,13,3,60,147,55,85,0,0
1045,364,153,424,301,6,13,3,60,148,56,85,0,0
1046,357,156,414,298,6,13,3,57,142,57,85,0,0
1047,352,153,407,293,6,13,3,55,140,58,85,0,0
1048,347,151,401,291,6,13,3,54,140,59,85,0,0
1049,346,149,398,290,6,13,3,52,141,60,85,0,0
1050,344,151,394,289,6,13,3,50,138,61,85,0,0
1051,341,150,391,287,6,13,3,50,137,62,85,0,0
1052,337,151,386,284,6,13,3,49,133,63,85,0,0
1053,333,149,380,279,6,13,3,47,130,64,85,0,0
1054,331,147,376,274,6,13,3,45,127,65,85,0,0
1055,329,146,373,272,6,13,3,44,126,66,85,0,0
1056,329,148,371,271,6,13,3,42,123,67,85,0,0
1057,328,147,370,267,6,13,3,42,120,68,85,0,0
1058,328,148,369,266,6,13,3,41,118,69,85,0,0
1059,326,145,367,264,6,13,3,41,119,70,85,0,0
1060,328,146,368,263,6,13,3,40,117,71,85,0,0
1061,331,146,370,263,6,13,3,39,117,72,85,0,0
1062,333,144,372,262,6,13,3,39,118,73,85,0,0
1063,334,146,373,260,6,13,3,39,114,74,85,0,0
1064,336,143,374,256,6,13,3,38,113,75,85,0,0
1065,336,142,374,254,6,13,3,38,112,76,85,0,0
1066,336,141,374,253,6,13,3,38,112,77,85,0,0
1067,336,140,376,254,6,13,3,40,114,78,85,0,0
1068,336,141,374,249,6,13,3,38,108,79,85,0,0
1069,336,140,374,247,6,13,3,38,107,80,85,0,0
1070,336,139,374,247,6,13,3,38,108,81,85,0,0
1071,336,138,374,246,6,13,3,38,108,82,85,0,0
1072,339,137,376,244,6,13,3,37,107,83,85,0,0
1073,342,137,377,239,6,13,3,35,102,84,85,0,0
1074,342,138,377,236,6,13,3,35,98,85,85,1,0
1547,278,152,314,267,10,13,3,36,115,0,51,0,1
1548,288,153,330,285,10,13,3,42,132,1,51,0,0
1549,299,154,343,294,10,13,3,44,140,2,51,0,0
1550,310,149,354,290,10,13,3,44,141,3,51,0,0
1551,315,149,364,305,10,13,3,49,156,4,51,0,0
1552,320,152,367,303,10,13,3,47,151,5,51,0,0
1553,321,154,370,314,10,13,3,49,160,6,51,0,0
1554,322,160,371,319,10,13,3,49,159,7,51,0,0
1555,323,163,371,317,10,13,3,48,154,8,51,0,0
1556,319,167,370,328,10,13,3,51,161,9,51,0,0
1557,317,169,368,332,10,13,3,51,163,10,51,0,0
1558,316,169,368,335,10,13,3,52,166,11,51,0,0
1559,316,172,368,337,10,13,3,52,165,12,51,0,0
1560,315,172,369,340,10,13,3,54,168,13,51,0,0
1561,312,173,370,354,10,13,3,58,181,14,51,0,0
1562,313,174,371,358,10,13,3,58,184,15,51,0,0
1563,316,175,377,366,10,13,3,61,191,16,51,0,0
1564,320,177,384,378,10,13,3,64,201,17,51,0,0
1565,323,180,387,382,10,13,3,64,202,18,51,0,0
1566,325,183,391,393,10,13,3,66,210,19,51,0,0
1567,333,187,398,391,10,13,3,65,204,20,51,0,0
1568,339,188,409,408,10,13,3,70,220,21,51,0,0
1569,347,192,420,420,10,13,3,73,228,22,51,0,0
1570,351,193,427,431,10,13,3,76,238,23,51,0,0
1571,354,199,432,444,10,13,3,78,245,24,51,0,0
1572,359,200,438,448,10,13,3,79,248,25,51,0,0
1573,363,204,446,458,10,13,3,83,254,26,51,0,0
1574,368,205,456,478,10,13,3,88,273,27,51,0,0
1575,367,210,461,499,10,13,3,94,289,28,51,0,0
1576,366,219,463,517,10,13,3,97,298,29,51,0,0
1577,372,221,472,529,10,13,3,100,308,30,51,0,0
1578,379,233,483,552,10,13,3,104,319,31,51,0,0
1579,382,235,494,579,10,13,3,112,344,32,51,0,0
1580,382,238,498,597,10,13,3,116,359,33,51,0,0
1581,386,252,505,619,10,13,3,119,367,34,51,0,0
1582,395,258,519,640,10,13,3,124,382,35,51,0,0
1583,400,271,531,678,10,13,3,131,407,36,51,0,0
1584,409,278,546,706,10,13,3,137,428,37,51,0,0
1585,410,289,561,755,10,13,3,151,466,38,51,0,0
1586,417,309,574,796,10,13,3,157,487,39,51,0,0
1587,431,316,599,834,10,13,3,168,518,40,51,0,0
1588,448,340,628,897,10,13,3,180,557,41,51,0,0
1589,469,358,655,930,10,13,3,186,572,42,51,0,0
1590,482,390,689,1017,10,13,3,207,627,43,51,0,0
1591,514,426,727,1062,10,13,3,213,636,44,51,0,0
1592,552,450,767,1078,10,13,3,215,628,45,51,0,0
1593,609,500,816,1080,10,13,3,207,580,46,51,0,0
1594,678,542,882,1080,10,13,3,204,538,47,51,0,0
1595,740,618,940,1080,10,13,3,200,462,48,51,0,0
1596,826,703,1010,1080,10,13,3,184,377,49,51,0,0
1597,921,791,1086,1080,10,13,3,165,289,50,51,0,0
1598,969,832,1120,1080,10,13,3,151,248,51,51,1,0
2739,387,149,422,282,22,13,3,35,133,0,8,0,0
2740,372,149,409,284,22,13,3,37,135,1,8,0,0
2741,359,149,395,278,22,13,3,36,129,2,8,0,0
2742,343,150,380,281,22,13,3,37,131,3,8,0,0
2743,328,149,367,283,22,13,3,39,134,4,8,0,0
2744,314,148,351,278,22,13,3,37,130,5,8,0,0
2745,298,152,336,281,22,13,3,38,129,6,8,0,0
2746,288,156,323,276,22,13,3,35,120,7,8,0,0
2747,275,156,310,275,22,13,3,35,119,8,8,0,0
2774,379,142,415,256,26,13,3,36,114,0,0,0,0
2830,469,145,506,266,29,13,3,37,121,0,2,0,0
2831,459,148,495,266,29,13,3,36,118,1,2,0,0
2832,445,143,481,261,29,13,3,36,118,2,2,0,0
2834,418,146,454,260,29,13,3,36,114,0,2,0,0
2837,382,146,417,255,29,13,3,35,109,0,2,0,0
2838,372,143,407,256,29,13,3,35,113,1,2,0,0
2839,364,143,399,251,29,13,3,35,108,2,2,0,0
3066,467,146,505,273,31,13,3,38,127,0,9,0,0
3067,447,147,486,273,31,13,3,39,126,1,9,0,0
3068,429,147,466,271,31,13,3,37,124,2,9,0,0
3069,404,148,442,272,31,13,3,38,124,3,9,0,0
3070,385,149,424,274,31,13,3,39,125,4,9,0,0
3071,362,148,401,274,31,13,3,39,126,5,9,0,0
3072,342,149,379,270,31,13,3,37,121,6,9,0,0
3073,320,145,358,271,31,13,3,38,126,7,9,0,0
3074,300,151,337,270,31,13,3,37,119,8,9,0,0
3075,281,151,317,270,31,13,3,36,119,9,9,0,0
3516,315,127,351,219,33,13,3,36,92,0,71,0,1
3517,315,127,352,224,33,13,3,37,97,1,71,0,0
3518,315,127,353,226,33,13,3,38,99,2,71,0,0
3519,316,129,354,231,33,13,3,38,102,3,71,0,0
3520,318,131,356,231,33,13,3,38,100,4,71,0,0
3521,320,132,357,231,33,13,3,37,99,5,71,0,0
3522,320,133,358,236,33,13,3,38,103,6,71,0,0
3523,320,134,357,235,33,13,3,37,101,7,71,0,0
3524,321,135,357,231,33,13,3,36,96,8,71,0,0
3525,323,135,358,231,33,13,3,35,96,9,71,0,0
3526,325,135,360,231,33,13,3,35,96,10,71,0,0
3527,326,135,361,231,33,13,3,35,96,11,71,0,0
3528,328,136,363,234,33,13,3,35,98,12,71,0,0
3529,326,135,363,240,33,13,3,37,105,13,71,0,0
3530,326,135,365,246,33,13,3,39,111,14,71,0,0
3531,326,135,366,249,33,13,3,40,114,15,71,0,0
3532,328,137,368,251,33,13,3,40,114,16,71,0,0
3533,328,138,368,253,33,13,3,40,115,17,71,0,0
3534,328,140,368,256,33,13,3,40,116,18,71,0,0
3535,326,139,367,258,33,13,3,41,119,19,71,0,0
3536,326,141,367,259,33,13,3,41,118,20,71,0,0
3537,327,141,367,259,33,13,3,40,118,21,71,0,0
3538,329,143,369,259,33,13,3,40,116,22,71,0,0
3539,331,143,371,259,33,13,3,40,116,23,71,0,0
3540,332,143,373,261,33,13,3,41,118,24,71,0,0
3541,332,145,372,261,33,13,3,40,116,25,71,0,0
3542,333,145,374,263,33,13,3,41,118,26,71,0,0
3543,336,145,377,264,33,13,3,41,119,27,71,0,0
3544,341,145,384,266,33,13,3,43,121,28,71,0,0
3545,344,146,387,267,33,13,3,43,121,29,71,0,0
3546,346,148,389,268,33,13,3,43,120,30,71,0,0
3547,348,148,391,270,33,13,3,43,122,31,71,0,0
3548,350,147,394,272,33,13,3,44,125,32,71,0,0
3549,355,148,399,273,33,13,3,44,125,33,71,0,0
3550,359,152,402,275,33,13,3,43,123,34,71,0,0
3551,362,149,407,278,33,13,3,45,129,35,71,0,0
3552,364,149,409,282,33,13,3,45,133,36,71,0,0
3553,364,152,409,281,33,13,3,45,129,37,71,0,0
3554,364,151,410,285,33,13,3,46,134,38,71,0,0
3555,364,150,413,293,33,13,3,49,143,39,71,0,0
3556,366,150,417,301,33,13,3,51,151,40,71,0,0
3557,369,150,421,302,33,13,3,52,152,41,71,0,0
3558,372,151,425,305,33,13,3,53,154,42,71,0,0
3559,375,151,429,308,33,13,3,54,157,43,71,0,0
3560,377,151,432,310,33,13,3,55,159,44,71,0,0
3561,382,153,436,311,33,13,3,54,158,45,71,0,0
3562,386,153,441,318,33,13,3,55,165,46,71,0,0
3563,391,152,445,315,33,13,3,54,163,47,71,0,0
3564,396,154,450,318,33,13,3,54,164,48,71,0,0
3565,399,155,455,321,33,13,3,56,166,49,71,0,0
3566,405,156,461,324,33,13,3,56,168,50,71,0,0
3567,412,155,467,327,33,13,3,55,172,51,71,0,0
3568,417,156,471,328,33,13,3,54,172,52,71,0,0
3569,423,159,477,330,33,13,3,54,171,53,71,0,0
3570,429,160,482,331,33,13,3,53,171,54,71,0,0
3571,433,161,487,332,33,13,3,54,171,55,71,0,0
3572,437,166,492,334,33,13,3,55,168,56,71,0,0
3573,442,164,497,333,33,13,3,55,169,57,71,0,0
3574,445,166,498,333,33,13,3,53,167,58,71,0,0
3575,445,164,498,335,33,13,3,53,171,59,71,0,0
3576,443,162,498,340,33,13,3,55,178,60,71,0,0
3577,443,162,496,339,33,13,3,53,177,61,71,0,0
3578,442,165,494,337,33,13,3,52,172,62,71,0,0
3579,441,165,494,338,33,13,3,53,173,63,71,0,0
3580,439,166,492,342,33,13,3,53,176,64,71,0,0
3581,438,167,490,339,33,13,3,52,172,65,71,0,0
3582,439,167,489,337,33,13,3,50,170,66,71,0,0
3583,439,165,489,335,33,13,3,50,170,67,71,0,0
3584,439,168,487,335,33,13,3,48,167,68,71,0,0
3585,440,169,487,338,33,13,3,47,169,69,71,0,0
3586,440,168,487,340,33,13,3,47,172,70,71,0,0
3587,440,168,488,341,33,13,3,48,173,71,71,1,0
3602,416,171,461,345,33,13,3,45,174,0,71,0,0
3603,415,170,459,346,33,13,3,44,176,1,71,0,0
3604,415,170,457,346,33,13,3,42,176,2,71,0,0
3605,416,170,456,346,33,13,3,40,176,3,71,0,0
3606,416,172,455,345,33,13,3,39,173,4,71,0,0
3607,418,172,456,341,33,13,3,38,169,5,71,0,0
3608,418,172,455,344,33,13,3,37,172,6,71,0,0
3609,418,172,455,346,33,13,3,37,174,7,71,0,0
3610,418,172,455,346,33,13,3,37,174,8,71,0,0
3611,419,171,455,346,33,13,3,36,175,9,71,0,0
3612,418,171,454,346,33,13,3,36,175,10,71,0,0
3613,419,169,454,340,33,13,3,35,171,11,71,0,0
3644,407,166,442,336,33,13,3,35,170,0,71,0,0
3645,405,162,441,333,33,13,3,36,171,1,71,0,0
3646,402,162,438,335,33,13,3,36,173,2,71,0,0
3647,400,163,436,333,33,13,3,36,170,3,71,0,0
3648,399,165,435,332,33,13,3,36,167,4,71,0,0
3649,398,166,435,331,33,13,3,37,165,5,71,0,0
3650,398,164,435,331,33,13,3,37,167,6,71,0,0
3651,399,165,437,334,33,13,3,38,169,7,71,0,0
3652,402,168,439,332,33,13,3,37,164,8,71,0,0
3653,403,166,441,332,33,13,3,38,166,9,71,0,0
3654,405,166,443,332,33,13,3,38,166,10,71,0,0
3655,409,166,448,330,33,13,3,39,164,11,71,0,0
3656,416,167,455,331,33,13,3,39,164,12,71,0,0
3657,421,165,460,329,33,13,3,39,164,13,71,0,0
3658,423,164,462,329,33,13,3,39,165,14,71,0,0
3662,500,166,535,310,33,13,3,35,144,0,71,0,0
3663,517,162,554,319,33,13,3,37,157,1,71,0,0
3664,528,165,565,320,33,13,3,37,155,2,71,0,0
3665,537,165,574,320,33,13,3,37,155,3,71,0,0
3540,380,151,416,262,35,13,3,36,111,0,126,0,0
3543,394,153,429,260,35,13,3,35,107,0,126,0,1
3544,397,154,435,266,35,13,3,38,112,1,126,0,0
3545,401,152,441,269,35,13,3,40,117,2,126,0,0
3546,404,154,445,273,35,13,3,41,119,3,126,0,0
3547,406,158,445,274,35,13,3,39,116,4,126,0,0
3548,406,157,446,278,35,13,3,40,121,5,126,0,0
3549,408,160,449,282,35,13,3,41,122,6,126,0,0
3550,413,158,454,282,35,13,3,41,124,7,126,0,0
3551,418,159,460,286,35,13,3,42,127,8,126,0,0
3552,422,164,463,285,35,13,3,41,121,9,126,0,0
3553,425,164,467,288,35,13,3,42,124,10,126,0,0
3554,426,165,472,300,35,13,3,46,135,11,126,0,0
3555,431,166,478,306,35,13,3,47,140,12,126,0,0
3556,439,166,486,304,35,13,3,47,138,13,126,0,0
3557,443,170,491,310,35,13,3,48,140,14,126,0,0
3558,447,171,493,308,35,13,3,46,137,15,126,0,0
3559,449,171,497,313,35,13,3,48,142,16,126,0,0
3560,452,174,501,320,35,13,3,49,146,17,126,0,0
3561,458,173,507,319,35,13,3,49,146,18,126,0,0
3562,463,174,513,323,35,13,3,50,149,19,126,0,0
3563,464,175,514,326,35,13,3,50,151,20,126,0,0
3564,465,175,516,330,35,13,3,51,155,21,126,0,0
3565,468,176,522,334,35,13,3,54,158,22,126,0,0
3566,474,177,529,337,35,13,3,55,160,23,126,0,0
3567,481,177,538,340,35,13,3,57,163,24,126,0,0
3568,485,178,543,345,35,13,3,58,167,25,126,0,0
3569,486,179,545,350,35,13,3,59,171,26,126,0,0
3570,486,180,546,351,35,13,3,60,171,27,126,0,0
3571,487,179,548,354,35,13,3,61,175,28,126,0,0
3572,490,182,550,356,35,13,3,60,174,29,126,0,0
3573,496,184,555,357,35,13,3,59,173,30,126,0,0
3574,500,184,560,359,35,13,3,60,175,31,126,0,0
3575,502,186,561,362,35,13,3,59,176,32,126,0,0
3576,501,186,560,363,35,13,3,59,177,33,126,0,0
3577,499,185,558,364,35,13,3,59,179,34,126,0,0
3578,494,186,553,367,35,13,3,59,181,35,126,0,0
3579,487,186,548,373,35,13,3,61,187,36,126,0,0
3580,482,190,541,373,35,13,3,59,183,37,126,0,0
3581,473,189,531,368,35,13,3,58,179,38,126,0,0
3582,469,188,526,365,35,13,3,57,177,39,126,0,0
3583,465,186,522,362,35,13,3,57,176,40,126,0,0
3584,466,188,521,360,35,13,3,55,172,41,126,0,0
3585,466,188,521,361,35,13,3,55,173,42,126,0,0
3586,462,187,519,363,35,13,3,57,176,43,126,0,0
3587,452,179,512,363,35,13,3,60,184,44,126,0,0
3588,444,171,506,363,35,13,3,62,192,45,126,0,0
3589,438,168,501,363,35,13,3,63,195,46,126,0,0
3590,436,167,497,362,35,13,3,61,195,47,126,0,0
3591,435,166,497,361,35,13,3,62,195,48,126,0,0
3592,436,168,496,361,35,13,3,60,193,49,126,0,0
3593,435,169,495,362,35,13,3,60,193,50,126,0,0
3594,435,168,494,362,35,13,3,59,194,51,126,0,0
3595,434,165,494,362,35,13,3,60,197,52,126,0,0
3596,434,166,495,362,35,13,3,61,196,53,126,0,0
3597,436,170,495,363,35,13,3,59,193,54,126,0,0
3598,436,173,495,363,35,13,3,59,190,55,126,0,0
3599,434,171,493,362,35,13,3,59,191,56,126,0,0
3600,435,175,492,361,35,13,3,57,186,57,126,0,0
3601,438,179,493,361,35,13,3,55,182,58,126,0,0
3602,440,184,494,362,35,13,3,54,178,59,126,0,0
3603,441,186,494,362,35,13,3,53,176,60,126,0,0
3604,441,187,494,362,35,13,3,53,175,61,126,0,0
3605,441,188,494,362,35,13,3,53,174,62,126,0,0
3606,442,188,495,361,35,13,3,53,173,63,126,0,0
3607,443,188,495,361,35,13,3,52,173,64,126,0,0
3608,443,188,495,361,35,13,3,52,173,65,126,0,0
3609,442,187,495,360,35,13,3,53,173,66,126,0,0
3610,442,187,494,360,35,13,3,52,173,67,126,0,0
3611,443,188,495,360,35,13,3,52,172,68,126,0,0
3612,443,188,495,360,35,13,3,52,172,69,126,0,0
3613,443,188,494,360,35,13,3,51,172,70,126,0,0
3614,443,188,494,360,35,13,3,51,172,71,126,0,0
3615,443,188,494,360,35,13,3,51,172,72,126,0,0
3616,443,188,494,361,35,13,3,51,173,73,126,0,0
3617,443,188,494,361,35,13,3,51,173,74,126,0,0
3618,443,188,494,361,35,13,3,51,173,75,126,0,0
3619,444,189,494,362,35,13,3,50,173,76,126,0,0
3620,444,189,494,362,35,13,3,50,173,77,126,0,0
3621,444,189,494,361,35,13,3,50,172,78,126,0,0
3622,444,189,494,361,35,13,3,50,172,79,126,0,0
3623,444,189,494,361,35,13,3,50,172,80,126,0,0
3624,444,190,494,361,35,13,3,50,171,81,126,0,0
3625,443,190,494,362,35,13,3,51,172,82,126,0,0
3626,443,188,494,362,35,13,3,51,174,83,126,0,0
3627,443,188,494,362,35,13,3,51,174,84,126,0,0
3628,443,188,494,362,35,13,3,51,174,85,126,0,0
3629,443,188,494,362,35,13,3,51,174,86,126,0,0
3630,443,187,494,362,35,13,3,51,175,87,126,0,0
3631,443,187,494,362,35,13,3,51,175,88,126,0,0
3632,443,187,494,362,35,13,3,51,175,89,126,0,0
3633,443,188,494,362,35,13,3,51,174,90,126,0,0
3634,443,188,494,362,35,13,3,51,174,91,126,0,0
3635,443,188,494,362,35,13,3,51,174,92,126,0,0
3636,443,188,494,361,35,13,3,51,173,93,126,0,0
3637,443,189,494,361,35,13,3,51,172,94,126,0,0
3638,443,190,494,362,35,13,3,51,172,95,126,0,0
3639,442,191,493,362,35,13,3,51,171,96,126,0,0
3640,443,192,493,362,35,13,3,50,170,97,126,0,0
3641,442,192,493,362,35,13,3,51,170,98,126,0,0
3642,441,190,494,364,35,13,3,53,174,99,126,0,0
3643,441,191,493,364,35,13,3,52,173,100,126,0,0
3644,440,189,493,364,35,13,3,53,175,101,126,0,0
3645,440,189,493,364,35,13,3,53,175,102,126,0,0
3646,440,188,493,363,35,13,3,53,175,103,126,0,0
3647,440,187,494,362,35,13,3,54,175,104,126,0,0
3648,439,187,493,362,35,13,3,54,175,105,126,0,0
3649,438,187,492,360,35,13,3,54,173,106,126,0,0
3650,439,187,493,360,35,13,3,54,173,107,126,0,0
3651,443,189,497,358,35,13,3,54,169,108,126,0,0
3652,445,187,499,358,35,13,3,54,171,109,126,0,0
3653,448,184,502,354,35,13,3,54,170,110,126,0,0
3654,449,184,503,351,35,13,3,54,167,111,126,0,0
3655,450,183,504,349,35,13,3,54,166,112,126,0,0
3656,449,182,502,347,35,13,3,53,165,113,126,0,0
3657,442,173,498,345,35,13,3,56,172,114,126,0,0
3658,436,170,493,344,35,13,3,57,174,115,126,0,0
3659,438,168,496,345,35,13,3,58,177,116,126,0,0
3660,446,171,503,343,35,13,3,57,172,117,126,0,0
3661,454,172,512,340,35,13,3,58,168,118,126,0,0
3662,463,175,518,339,35,13,3,55,164,119,126,0,0
3663,470,177,524,338,35,13,3,54,161,120,126,0,0
3664,479,177,531,334,35,13,3,52,157,121,126,0,0
3665,490,176,541,328,35,13,3,51,152,122,126,0,0
3666,501,173,553,326,35,13,3,52,153,123,126,0,0
3667,508,169,560,328,35,13,3,52,159,124,126,0,0
3668,518,164,568,321,35,13,3,50,157,125,126,0,0
3669,523,163,573,319,35,13,3,50,156,126,126,1,0
3601,426,182,461,341,39,13,3,35,159,0,0,0,0
4577,465,146,507,283,40,13,3,42,137,0,11,0,0
4578,446,146,488,282,40,13,3,42,136,1,11,0,0
4579,431,142,474,282,40,13,3,43,140,2,11,0,0
4580,414,143,459,284,40,13,3,45,141,3,11,0,0
4581,405,147,449,285,40,13,3,44,138,4,11,0,0
4582,379,144,425,285,40,13,3,46,141,5,11,0,0
4583,357,146,402,283,40,13,3,45,137,6,11,0,0
4584,343,148,388,284,40,13,3,45,136,7,11,0,0
4585,324,144,369,283,40,13,3,45,139,8,11,0,0
4586,305,144,351,283,40,13,3,46,139,9,11,0,0
4587,292,149,336,282,40,13,3,44,133,10,11,0,0
4588,276,149,320,282,40,13,3,44,133,11,11,0,0
4588,439,150,474,275,41,13,3,35,125,0,9,0,0
4590,406,151,441,275,41,13,3,35,124,0,9,0,0
4591,382,151,419,278,41,13,3,37,127,1,9,0,0
4592,368,150,406,277,41,13,3,38,127,2,9,0,0
4593,360,153,395,276,41,13,3,35,123,3,9,0,0
4594,334,158,369,277,41,13,3,35,119,4,9,0,0
4595,321,154,358,279,41,13,3,37,125,5,9,0,0
4596,313,153,351,277,41,13,3,38,124,6,9,0,0
4597,297,152,335,277,41,13,3,38,125,7,9,0,0
4598,287,152,323,270,41,13,3,36,118,8,9,0,0
4599,273,152,309,269,41,13,3,36,117,9,9,0,0
4587,432,164,468,276,42,13,3,36,112,0,0,0,0
4591,398,149,440,275,43,13,3,42,126,0,0,0,0
4593,341,157,380,279,44,13,3,39,122,0,1,0,0
4594,348,152,385,271,44,13,3,37,119,1,1,0,0
4833,356,139,392,239,48,13,3,36,100,0,90,0,1
4834,356,138,393,239,48,13,3,37,101,1,90,0,0
4835,355,138,393,243,48,13,3,38,105,2,90,0,0
4836,355,140,393,245,48,13,3,38,105,3,90,0,0
4837,355,140,393,245,48,13,3,38,105,4,90,0,0
4838,354,141,393,251,48,13,3,39,110,5,90,0,0
4839,355,141,394,251,48,13,3,39,110,6,90,0,0
4840,356,141,395,250,48,13,3,39,109,7,90,0,0
4841,356,143,395,255,48,13,3,39,112,8,90,0,0
4842,356,145,394,253,48,13,3,38,108,9,90,0,0
4843,355,145,393,251,48,13,3,38,106,10,90,0,0
4844,354,145,393,258,48,13,3,39,113,11,90,0,0
4845,355,146,395,261,48,13,3,40,115,12,90,0,0
4846,354,147,394,263,48,13,3,40,116,13,90,0,0
4847,353,150,392,262,48,13,3,39,112,14,90,0,0
4848,353,149,394,265,48,13,3,41,116,15,90,0,0
4849,353,150,395,268,48,13,3,42,118,16,90,0,0
4850,356,149,398,270,48,13,3,42,121,17,90,0,0
4851,358,151,400,272,48,13,3,42,121,18,90,0,0
4852,358,152,401,276,48,13,3,43,124,19,90,0,0
4853,358,151,402,276,48,13,3,44,125,20,90,0,0
4854,359,151,403,279,48,13,3,44,128,21,90,0,0
4855,360,151,405,282,48,13,3,45,131,22,90,0,0
4856,364,151,410,284,48,13,3,46,133,23,90,0,0
4857,365,151,412,288,48,13,3,47,137,24,90,0,0
4858,366,153,412,290,48,13,3,46,137,25,90,0,0
4859,367,153,416,296,48,13,3,49,143,26,90,0,0
4860,369,155,418,301,48,13,3,49,146,27,90,0,0
4861,374,155,423,303,48,13,3,49,148,28,90,0,0
4862,378,156,429,308,48,13,3,51,152,29,90,0,0
4863,380,160,431,312,48,13,3,51,152,30,90,0,0
4864,383,160,433,309,48,13,3,50,149,31,90,0,0
4865,383,162,436,318,48,13,3,53,156,32,90,0,0
4866,386,166,438,323,48,13,3,52,157,33,90,0,0
4867,390,168,442,323,48,13,3,52,155,34,90,0,0
4868,393,170,445,326,48,13,3,52,156,35,90,0,0
4869,393,171,446,331,48,13,3,53,160,36,90,0,0
4870,396,171,450,334,48,13,3,54,163,37,90,0,0
4871,397,174,452,339,48,13,3,55,165,38,90,0,0
4872,401,176,458,343,48,13,3,57,167,39,90,0,0
4873,407,176,465,346,48,13,3,58,170,40,90,0,0
4874,407,178,469,360,48,13,3,62,182,41,90,0,0
4875,412,179,473,361,48,13,3,61,182,42,90,0,0
4876,416,180,480,370,48,13,3,64,190,43,90,0,0
4877,421,181,488,379,48,13,3,67,198,44,90,0,0
4878,429,182,495,375,48,13,3,66,193,45,90,0,0
4879,431,189,499,388,48,13,3,68,199,46,90,0,0
4880,434,192,501,391,48,13,3,67,199,47,90,0,0
4881,436,194,504,393,48,13,3,68,199,48,90,0,0
4882,440,197,510,399,48,13,3,70,202,49,90,0,0
4883,446,195,518,404,48,13,3,72,209,50,90,0,0
4884,451,197,525,413,48,13,3,74,216,51,90,0,0
4885,452,198,529,424,48,13,3,77,226,52,90,0,0
4886,456,197,536,428,48,13,3,80,231,53,90,0,0
4887,456,199,539,438,48,13,3,83,239,54,90,0,0
4888,460,202,545,446,48,13,3,85,244,55,90,0,0
4889,461,203,549,456,48,13,3,88,253,56,90,0,0
4890,459,210,549,469,48,13,3,90,259,57,90,0,0
4891,459,215,549,475,48,13,3,90,260,58,90,0,0
4892,459,215,554,489,48,13,3,95,274,59,90,0,0
4893,461,223,558,499,48,13,3,97,276,60,90,0,0
4894,469,228,569,509,48,13,3,100,281,61,90,0,0
4895,470,234,575,524,48,13,3,105,290,62,90,0,0
4896,468,240,575,536,48,13,3,107,296,63,90,0,0
4897,467,242,579,552,48,13,3,112,310,64,90,0,0
4898,467,247,585,574,48,13,3,118,327,65,90,0,0
4899,479,250,601,588,48,13,3,122,338,66,90,0,0
4900,491,255,619,605,48,13,3,128,350,67,90,0,0
4901,495,263,628,632,48,13,3,133,369,68,90,0,0
4902,505,267,642,646,48,13,3,137,379,69,90,0,0
4903,514,272,655,667,48,13,3,141,395,70,90,0,0
4904,528,280,670,682,48,13,3,142,402,71,90,0,0
4905,546,289,693,701,48,13,3,147,412,72,90,0,0
4906,549,299,710,744,48,13,3,161,445,73,90,0,0
4907,553,305,722,773,48,13,3,169,468,74,90,0,0
4908,557,315,728,786,48,13,3,171,471,75,90,0,0
4909,553,335,732,832,48,13,3,179,497,76,90,0,0
4910,565,345,751,861,48,13,3,186,516,77,90,0,0
4911,575,361,775,908,48,13,3,200,547,78,90,0,0
4912,569,381,777,951,48,13,3,208,570,79,90,0,0
4913,566,393,778,976,48,13,3,212,583,80,90,0,0
4914,547,418,776,1045,48,13,3,229,627,81,90,0,0
4915,558,448,786,1069,48,13,3,228,621,82,90,0,0
4916,582,475,812,1078,48,13,3,230,603,83,90,0,0
4917,585,508,812,1080,48,13,3,227,572,84,90,0,0
4918,579,543,800,1080,48,13,3,221,537,85,90,0,0
4919,573,583,790,1080,48,13,3,217,497,86,90,0,0
4920,571,647,778,1080,48,13,3,207,433,87,90,0,0
4921,573,709,766,1080,48,13,3,193,371,88,90,0,0
4922,540,771,712,1079,48,13,3,172,308,89,90,0,0
4923,541,806,700,1080,48,13,3,159,274,90,90,1,0
5102,569,171,613,364,52,13,3,44,193,0,31,0,1
5103,559,177,603,366,52,13,3,44,189,1,31,0,0
5104,554,180,595,356,52,13,3,41,176,2,31,0,0
5105,536,171,581,362,52,13,3,45,191,3,31,0,0
5106,513,171,560,364,52,13,3,47,193,4,31,0,0
5107,495,173,542,360,52,13,3,47,187,5,31,0,0
5108,481,172,530,363,52,13,3,49,191,6,31,0,0
5109,464,174,514,360,52,13,3,50,186,7,31,0,0
5110,448,173,499,355,52,13,3,51,182,8,31,0,0
5111,435,171,485,347,52,13,3,50,176,9,31,0,0
5112,426,172,477,346,52,13,3,51,174,10,31,0,0
5113,417,170,469,344,52,13,3,52,174,11,31,0,0
5114,409,168,460,339,52,13,3,51,171,12,31,0,0
5115,399,167,451,337,52,13,3,52,170,13,31,0,0
5116,390,166,442,329,52,13,3,52,163,14,31,0,0
5117,382,164,434,326,52,13,3,52,162,15,31,0,0
5118,376,160,429,324,52,13,3,53,164,16,31,0,0
5119,373,158,425,320,52,13,3,52,162,17,31,0,0
5120,366,158,418,316,52,13,3,52,158,18,31,0,0
5121,357,161,407,312,52,13,3,50,151,19,31,0,0
5122,350,158,400,311,52,13,3,50,153,20,31,0,0
5123,343,158,393,310,52,13,3,50,152,21,31,0,0
5124,340,156,389,305,52,13,3,49,149,22,31,0,0
5125,337,155,385,301,52,13,3,48,146,23,31,0,0
5126,332,158,379,300,52,13,3,47,142,24,31,0,0
5127,324,154,370,296,52,13,3,46,142,25,31,0,0
5128,319,153,364,290,52,13,3,45,137,26,31,0,0
5129,314,152,358,287,52,13,3,44,135,27,31,0,0
5130,307,149,353,286,52,13,3,46,137,28,31,0,0
5131,301,155,346,289,52,13,3,45,134,29,31,0,0
5132,291,152,337,288,52,13,3,46,136,30,31,0,0
5133,285,152,329,286,52,13,3,44,134,31,31,1,0
154,1139,276,1271,414,2,13,4,132,138,0,1,0,0
155,1142,277,1273,415,2,13,4,131,138,1,1,0,0
196,1153,277,1269,418,3,13,4,116,141,0,0,0,0
276,1143,272,1267,417,4,13,4,124,145,0,1,0,0
277,1142,273,1264,416,4,13,4,122,143,1,1,0,0
495,1577,144,1613,266,6,13,4,36,122,0,65,0,1
496,1574,144,1613,271,6,13,4,39,127,1,65,0,0
497,1575,150,1613,273,6,13,4,38,123,2,65,0,0
498,1574,150,1612,275,6,13,4,38,125,3,65,0,0
499,1575,153,1613,274,6,13,4,38,121,4,65,0,0
500,1573,147,1614,278,6,13,4,41,131,5,65,0,0
501,1572,146,1614,284,6,13,4,42,138,6,65,0,0
502,1572,147,1615,286,6,13,4,43,139,7,65,0,0
503,1571,152,1614,288,6,13,4,43,136,8,65,0,0
504,1571,161,1612,292,6,13,4,41,131,9,65,0,0
505,1569,159,1612,294,6,13,4,43,135,10,65,0,0
506,1567,156,1613,298,6,13,4,46,142,11,65,0,0
507,1567,157,1613,300,6,13,4,46,143,12,65,0,0
508,1568,163,1613,303,6,13,4,45,140,13,65,0,0
509,1567,169,1612,306,6,13,4,45,137,14,65,0,0
510,1564,167,1611,308,6,13,4,47,141,15,65,0,0
511,1563,170,1611,313,6,13,4,48,143,16,65,0,0
512,1562,170,1612,320,6,13,4,50,150,17,65,0,0
513,1560,171,1612,324,6,13,4,52,153,18,65,0,0
514,1558,182,1608,329,6,13,4,50,147,19,65,0,0
515,1556,178,1608,331,6,13,4,52,153,20,65,0,0
516,1555,183,1608,339,6,13,4,53,156,21,65,0,0
517,1554,187,1608,344,6,13,4,54,157,22,65,0,0
518,1553,189,1607,346,6,13,4,54,157,23,65,0,0
519,1547,188,1604,356,6,13,4,57,168,24,65,0,0
520,1540,188,1599,360,6,13,4,59,172,25,65,0,0
521,1535,187,1596,368,6,13,4,61,181,26,65,0,0
522,1532,192,1595,376,6,13,4,63,184,27,65,0,0
523,1530,193,1594,381,6,13,4,64,188,28,65,0,0
524,1524,196,1591,390,6,13,4,67,194,29,65,0,0
525,1519,197,1586,394,6,13,4,67,197,30,65,0,0
526,1514,196,1584,403,6,13,4,70,207,31,65,0,0
527,1511,197,1585,412,6,13,4,74,215,32,65,0,0
528,1506,196,1582,415,6,13,4,76,219,33,65,0,0
529,1498,200,1576,428,6,13,4,78,228,34,65,0,0
530,1491,203,1571,435,6,13,4,80,232,35,65,0,0
531,1488,204,1570,446,6,13,4,82,242,36,65,0,0
532,1485,208,1569,459,6,13,4,84,251,37,65,0,0
533,1483,208,1569,465,6,13,4,86,257,38,65,0,0
534,1473,212,1564,483,6,13,4,91,271,39,65,0,0
535,1469,213,1563,490,6,13,4,94,277,40,65,0,0
536,1465,217,1562,506,6,13,4,97,289,41,65,0,0
537,1463,227,1561,520,6,13,4,98,293,42,65,0,0
538,1459,231,1558,529,6,13,4,99,298,43,65,0,0
539,1448,240,1552,550,6,13,4,104,310,44,65,0,0
540,1437,245,1543,562,6,13,4,106,317,45,65,0,0
541,1425,248,1540,592,6,13,4,115,344,46,65,0,0
542,1417,262,1536,613,6,13,4,119,351,47,65,0,0
543,1404,262,1526,622,6,13,4,122,360,48,65,0,0
544,1385,277,1514,655,6,13,4,129,378,49,65,0,0
545,1369,286,1500,673,6,13,4,131,387,50,65,0,0
546,1351,289,1497,715,6,13,4,146,426,51,65,0,0
547,1338,304,1490,751,6,13,4,152,447,52,65,0,0
548,1320,315,1476,768,6,13,4,156,453,53,65,0,0
549,1298,333,1464,814,6,13,4,166,481,54,65,0,0
550,1280,348,1451,845,6,13,4,171,497,55,65,0,0
551,1260,369,1448,909,6,13,4,188,540,56,65,0,0
552,1247,392,1448,964,6,13,4,201,572,57,65,0,0
553,1218,421,1421,989,6,13,4,203,568,58,65,0,0
554,1176,448,1390,1042,6,13,4,214,594,59,65,0,0
555,1135,483,1347,1062,6,13,4,212,579,60,65,0,0
556,1100,509,1318,1074,6,13,4,218,565,61,65,0,0
557,1065,560,1282,1080,6,13,4,217,520,62,65,0,0
558,998,611,1205,1079,6,13,4,207,468,63,65,0,0
559,922,694,1109,1080,6,13,4,187,386,64,65,0,0
560,893,723,1075,1080,6,13,4,182,357,65,65,1,0
878,1740,654,1916,1063,9,13,4,176,409,0,88,0,1
879,1747,654,1920,1069,9,13,4,173,415,1,88,0,0
880,1732,655,1913,1076,9,13,4,181,421,2,88,0,0
881,1772,673,1920,1080,9,13,4,148,407,3,88,0,0
882,1788,685,1920,1080,9,13,4,132,395,4,88,0,0
883,1793,686,1920,1080,9,13,4,127,394,5,88,0,0
884,1797,684,1920,1080,9,13,4,123,396,6,88,0,0
885,1800,687,1920,1080,9,13,4,120,393,7,88,0,0
886,1799,685,1920,1078,9,13,4,121,393,8,88,0,0
887,1800,682,1920,1079,9,13,4,120,397,9,88,0,0
888,1801,682,1920,1078,9,13,4,119,396,10,88,0,0
889,1803,685,1920,1078,9,13,4,117,393,11,88,0,0
890,1805,683,1920,1078,9,13,4,115,395,12,88,0,0
891,1807,686,1920,1079,9,13,4,113,393,13,88,0,0
892,1809,688,1920,1080,9,13,4,111,392,14,88,0,0
893,1811,687,1920,1080,9,13,4,109,393,15,88,0,0
894,1811,686,1920,1080,9,13,4,109,394,16,88,0,0
895,1812,686,1920,1080,9,13,4,108,394,17,88,0,0
896,1814,686,1920,1079,9,13,4,106,393,18,88,0,0
897,1814,686,1920,1078,9,13,4,106,392,19,88,0,0
898,1815,685,1920,1078,9,13,4,105,393,20,88,0,0
899,1815,686,1920,1078,9,13,4,105,392,21,88,0,0
900,1816,686,1920,1078,9,13,4,104,392,22,88,0,0
901,1818,688,1920,1079,9,13,4,102,391,23,88,0,0
902,1819,692,1920,1079,9,13,4,101,387,24,88,0,0
903,1820,694,1920,1080,9,13,4,100,386,25,88,0,0
904,1821,695,1920,1080,9,13,4,99,385,26,88,0,0
905,1821,694,1920,1080,9,13,4,99,386,27,88,0,0
906,1820,690,1920,1080,9,13,4,100,390,28,88,0,0
907,1819,688,1920,1080,9,13,4,101,392,29,88,0,0
908,1819,687,1920,1080,9,13,4,101,393,30,88,0,0
909,1819,684,1920,1080,9,13,4,101,396,31,88,0,0
910,1819,684,1920,1080,9,13,4,101,396,32,88,0,0
911,1820,687,1920,1080,9,13,4,100,393,33,88,0,0
912,1821,689,1920,1080,9,13,4,99,391,34,88,0,0
913,1822,692,1920,1080,9,13,4,98,388,35,88,0,0
914,1823,695,1920,1080,9,13,4,97,385,36,88,0,0
915,1823,695,1920,1080,9,13,4,97,385,37,88,0,0
916,1824,693,1920,1080,9,13,4,96,387,38,88,0,0
917,1824,692,1920,1080,9,13,4,96,388,39,88,0,0
918,1824,692,1920,1080,9,13,4,96,388,40,88,0,0
919,1825,693,1920,1080,9,13,4,95,387,41,88,0,0
920,1825,693,1920,1080,9,13,4,95,387,42,88,0,0
921,1824,689,1920,1080,9,13,4,96,391,43,88,0,0
922,1824,688,1920,1080,9,13,4,96,392,44,88,0,0
923,1824,688,1920,1080,9,13,4,96,392,45,88,0,0
924,1823,686,1920,1080,9,13,4,97,394,46,88,0,0
925,1823,688,1920,1080,9,13,4,97,392,47,88,0,0
926,1824,691,1920,1080,9,13,4,96,389,48,88,0,0
927,1824,693,1920,1080,9,13,4,96,387,49,88,0,0
928,1824,693,1920,1080,9,13,4,96,387,50,88,0,0
929,1825,693,1920,1080,9,13,4,95,387,51,88,0,0
930,1825,693,1920,1080,9,13,4,95,387,52,88,0,0
931,1824,689,1920,1080,9,13,4,96,391,53,88,0,0
932,1824,687,1920,1080,9,13,4,96,393,54,88,0,0
933,1824,687,1920,1080,9,13,4,96,393,55,88,0,0
934,1824,686,1920,1080,9,13,4,96,394,56,88,0,0
935,1824,688,1920,1080,9,13,4,96,392,57,88,0,0
936,1825,692,1920,1080,9,13,4,95,388,58,88,0,0
937,1826,694,1920,1080,9,13,4,94,386,59,88,0,0
938,1825,694,1919,1080,9,13,4,94,386,60,88,0,0
939,1825,694,1919,1080,9,13,4,94,386,61,88,0,0
940,1825,694,1920,1080,9,13,4,95,386,62,88,0,0
941,1827,697,1920,1080,9,13,4,93,383,63,88,0,0
942,1828,699,1920,1080,9,13,4,92,381,64,88,0,0
943,1828,700,1920,1080,9,13,4,92,380,65,88,0,0
944,1828,700,1920,1080,9,13,4,92,380,66,88,0,0
945,1826,691,1920,1080,9,13,4,94,389,67,88,0,0
946,1825,686,1920,1080,9,13,4,95,394,68,88,0,0
947,1826,684,1920,1080,9,13,4,94,396,69,88,0,0
948,1826,680,1920,1080,9,13,4,94,400,70,88,0,0
949,1826,679,1920,1080,9,13,4,94,401,71,88,0,0
950,1826,680,1920,1080,9,13,4,94,400,72,88,0,0
951,1826,686,1920,1080,9,13,4,94,394,73,88,0,0
952,1827,688,1920,1080,9,13,4,93,392,74,88,0,0
953,1827,689,1920,1080,9,13,4,93,391,75,88,0,0
954,1827,689,1920,1080,9,13,4,93,391,76,88,0,0
955,1827,689,1920,1080,9,13,4,93,391,77,88,0,0
956,1828,688,1920,1080,9,13,4,92,392,78,88,0,0
957,1826,687,1919,1079,9,13,4,93,392,79,88,0,0
958,1827,693,1919,1079,9,13,4,92,386,80,88,0,0
959,1826,689,1919,1079,9,13,4,93,390,81,88,0,0
960,1827,685,1920,1079,9,13,4,93,394,82,88,0,0
961,1819,673,1916,1079,9,13,4,97,406,83,88,0,0
962,1824,696,1916,1078,9,13,4,92,382,84,88,0,0
963,1815,693,1910,1075,9,13,4,95,382,85,88,0,0
964,1809,684,1909,1078,9,13,4,100,394,86,88,0,0
965,1814,672,1916,1076,9,13,4,102,404,87,88,0,0
966,1813,670,1916,1075,9,13,4,103,405,88,88,1,0
972,1852,829,1917,1079,9,13,4,65,250,0,88,0,0
973,1840,834,1907,1075,9,13,4,67,241,1,88,0,0
974,1841,845,1905,1075,9,13,4,64,230,2,88,0,0
1198,1150,279,1268,415,10,13,4,118,136,0,1,0,0
1199,1151,278,1272,416,10,13,4,121,138,1,1,0,0
1251,1156,271,1277,414,11,13,4,121,143,0,1,0,0
1252,1158,271,1277,413,11,13,4,119,142,1,1,0,0
1254,1153,269,1272,416,12,13,4,119,147,0,0,0,0
1599,1713,724,1920,1080,13,13,4,207,356,0,20,0,1
1600,1654,557,1920,1076,13,13,4,266,519,1,20,0,0
1601,1633,522,1920,1070,13,13,4,287,548,2,20,0,0
1602,1614,515,1920,1068,13,13,4,306,553,3,20,0,0
1603,1605,519,1920,1072,13,13,4,315,553,4,20,0,0
1604,1603,529,1916,1075,13,13,4,313,546,5,20,0,0
1605,1608,541,1913,1072,13,13,4,305,531,6,20,0,0
1606,1613,561,1908,1072,13,13,4,295,511,7,20,0,0
1607,1615,577,1905,1076,13,13,4,290,499,8,20,0,0
1608,1614,583,1904,1078,13,13,4,290,495,9,20,0,0
1609,1613,587,1904,1079,13,13,4,291,492,10,20,0,0
1610,1613,590,1903,1075,13,13,4,290,485,11,20,0,0
1611,1611,593,1900,1073,13,13,4,289,480,12,20,0,0
1612,1610,588,1904,1074,13,13,4,294,486,13,20,0,0
1613,1609,587,1906,1075,13,13,4,297,488,14,20,0,0
1614,1609,587,1907,1075,13,13,4,298,488,15,20,0,0
1615,1610,584,1912,1076,13,13,4,302,492,16,20,0,0
1616,1611,579,1916,1077,13,13,4,305,498,17,20,0,0
1617,1614,582,1917,1079,13,13,4,303,497,18,20,0,0
1618,1647,616,1920,1074,13,13,4,273,458,19,20,0,0
1619,1650,618,1920,1074,13,13,4,270,456,20,20,1,0
1619,1793,778,1920,1080,14,13,4,127,302,0,0,0,0
1662,1852,951,1920,1077,15,13,4,68,126,0,0,0,0
1851,1625,153,1660,273,17,13,4,35,120,0,58,0,1
1852,1625,158,1660,276,17,13,4,35,118,1,58,0,0
1853,1624,156,1661,280,17,13,4,37,124,2,58,0,0
1854,1624,154,1662,284,17,13,4,38,130,3,58,0,0
1855,1623,154,1663,288,17,13,4,40,134,4,58,0,0
1856,1623,154,1664,293,17,13,4,41,139,5,58,0,0
1857,1622,153,1663,294,17,13,4,41,141,6,58,0,0
1858,1623,155,1665,299,17,13,4,42,144,7,58,0,0
1859,1622,155,1666,302,17,13,4,44,147,8,58,0,0
1860,1620,156,1664,306,17,13,4,44,150,9,58,0,0
1861,1618,160,1662,309,17,13,4,44,149,10,58,0,0
1862,1616,162,1662,310,17,13,4,46,148,11,58,0,0
1863,1615,164,1661,315,17,13,4,46,151,12,58,0,0
1864,1613,165,1661,318,17,13,4,48,153,13,58,0,0
1865,1610,166,1661,328,17,13,4,51,162,14,58,0,0
1866,1608,167,1660,332,17,13,4,52,165,15,58,0,0
1867,1607,169,1660,336,17,13,4,53,167,16,58,0,0
1868,1609,175,1662,340,17,13,4,53,165,17,58,0,0
1869,1609,175,1664,346,17,13,4,55,171,18,58,0,0
1870,1607,177,1664,354,17,13,4,57,177,19,58,0,0
1871,1606,178,1664,360,17,13,4,58,182,20,58,0,0
1872,1605,177,1665,368,17,13,4,60,191,21,58,0,0
1873,1606,180,1667,376,17,13,4,61,196,22,58,0,0
1874,1604,179,1668,384,17,13,4,64,205,23,58,0,0
1875,1603,184,1667,392,17,13,4,64,208,24,58,0,0
1876,1598,189,1663,397,17,13,4,65,208,25,58,0,0
1877,1598,191,1664,408,17,13,4,66,217,26,58,0,0
1878,1597,193,1665,414,17,13,4,68,221,27,58,0,0
1879,1594,194,1665,426,17,13,4,71,232,28,58,0,0
1880,1591,202,1663,434,17,13,4,72,232,29,58,0,0
1881,1588,205,1661,443,17,13,4,73,238,30,58,0,0
1882,1587,210,1663,457,17,13,4,76,247,31,58,0,0
1883,1587,214,1664,468,17,13,4,77,254,32,58,0,0
1884,1586,221,1666,483,17,13,4,80,262,33,58,0,0
1885,1583,229,1665,500,17,13,4,82,271,34,58,0,0
1886,1578,232,1662,508,17,13,4,84,276,35,58,0,0
1887,1571,239,1661,536,17,13,4,90,297,36,58,0,0
1888,1570,242,1662,545,17,13,4,92,303,37,58,0,0
1889,1565,250,1663,568,17,13,4,98,318,38,58,0,0
1890,1554,253,1658,588,17,13,4,104,335,39,58,0,0
1891,1540,257,1652,618,17,13,4,112,361,40,58,0,0
1892,1530,270,1649,648,17,13,4,119,378,41,58,0,0
1893,1525,275,1646,658,17,13,4,121,383,42,58,0,0
1894,1514,286,1643,697,17,13,4,129,411,43,58,0,0
1895,1499,298,1631,715,17,13,4,132,417,44,58,0,0
1896,1472,306,1620,768,17,13,4,148,462,45,58,0,0
1897,1455,320,1613,806,17,13,4,158,486,46,58,0,0
1898,1446,335,1607,826,17,13,4,161,491,47,58,0,0
1899,1422,363,1593,880,17,13,4,171,517,48,58,0,0
1900,1388,379,1567,914,17,13,4,179,535,49,58,0,0
1901,1342,404,1548,1009,17,13,4,206,605,50,58,0,0
1902,1307,438,1523,1056,17,13,4,216,618,51,58,0,0
1903,1277,472,1494,1078,17,13,4,217,606,52,58,0,0
1904,1242,525,1447,1077,17,13,4,205,552,53,58,0,0
1905,1162,566,1366,1078,17,13,4,204,512,54,58,0,0
1906,1072,645,1273,1080,17,13,4,201,435,55,58,0,0
1907,1019,738,1199,1079,17,13,4,180,341,56,58,0,0
1908,930,859,1071,1080,17,13,4,141,221,57,58,0,0
1909,894,909,1014,1080,17,13,4,120,171,58,58,1,0
2071,1601,145,1636,249,18,13,4,35,104,0,60,0,0
2073,1602,148,1637,252,18,13,4,35,104,0,60,0,0
2076,1600,152,1636,259,18,13,4,36,107,0,60,0,1
2077,1599,152,1634,260,18,13,4,35,108,1,60,0,0
2078,1599,151,1635,263,18,13,4,36,112,2,60,0,0
2079,1600,153,1637,265,18,13,4,37,112,3,60,0,0
2080,1600,154,1637,267,18,13,4,37,113,4,60,0,0
2081,1598,155,1636,271,18,13,4,38,116,5,60,0,0
2082,1597,155,1635,273,18,13,4,38,118,6,60,0,0
2083,1596,154,1633,273,18,13,4,37,119,7,60,0,0
2084,1595,154,1633,275,18,13,4,38,121,8,60,0,0
2085,1593,156,1633,281,18,13,4,40,125,9,60,0,0
2086,1589,153,1632,289,18,13,4,43,136,10,60,0,0
2087,1589,155,1631,291,18,13,4,42,136,11,60,0,0
2088,1588,158,1631,296,18,13,4,43,138,12,60,0,0
2089,1586,157,1631,301,18,13,4,45,144,13,60,0,0
2090,1585,160,1629,304,18,13,4,44,144,14,60,0,0
2091,1582,165,1626,307,18,13,4,44,142,15,60,0,0
2092,1578,166,1623,311,18,13,4,45,145,16,60,0,0
2093,1576,161,1623,315,18,13,4,47,154,17,60,0,0
2094,1572,160,1622,322,18,13,4,50,162,18,60,0,0
2095,1570,169,1620,329,18,13,4,50,160,19,60,0,0
2096,1566,159,1620,333,18,13,4,54,174,20,60,0,0
2097,1563,157,1619,339,18,13,4,56,182,21,60,0,0
2098,1562,165,1619,349,18,13,4,57,184,22,60,0,0
2099,1560,162,1619,354,18,13,4,59,192,23,60,0,0
2100,1559,168,1618,360,18,13,4,59,192,24,60,0,0
2101,1555,173,1614,365,18,13,4,59,192,25,60,0,0
2102,1550,174,1610,369,18,13,4,60,195,26,60,0,0
2103,1547,173,1610,381,18,13,4,63,208,27,60,0,0
2104,1543,173,1609,387,18,13,4,66,214,28,60,0,0
2105,1539,178,1606,395,18,13,4,67,217,29,60,0,0
2106,1533,185,1599,398,18,13,4,66,213,30,60,0,0
2107,1525,186,1596,411,18,13,4,71,225,31,60,0,0
2108,1522,191,1595,422,18,13,4,73,231,32,60,0,0
2109,1516,193,1591,429,18,13,4,75,236,33,60,0,0
2110,1509,199,1586,443,18,13,4,77,244,34,60,0,0
2111,1500,201,1580,453,18,13,4,80,252,35,60,0,0
2112,1489,195,1575,464,18,13,4,86,269,36,60,0,0
2113,1479,204,1572,488,18,13,4,93,284,37,60,0,0
2114,1471,206,1567,498,18,13,4,96,292,38,60,0,0
2115,1464,213,1562,510,18,13,4,98,297,39,60,0,0
2116,1452,218,1554,528,18,13,4,102,310,40,60,0,0
2117,1441,217,1550,547,18,13,4,109,330,41,60,0,0
2118,1426,227,1546,580,18,13,4,120,353,42,60,0,0
2119,1418,230,1542,593,18,13,4,124,363,43,60,0,0
2120,1410,242,1535,606,18,13,4,125,364,44,60,0,0
2121,1397,253,1529,637,18,13,4,132,384,45,60,0,0
2122,1382,259,1522,665,18,13,4,140,406,46,60,0,0
2123,1369,278,1522,714,18,13,4,153,436,47,60,0,0
2124,1352,285,1512,744,18,13,4,160,459,48,60,0,0
2125,1325,302,1495,784,18,13,4,170,482,49,60,0,0
2126,1297,329,1474,832,18,13,4,177,503,50,60,0,0
2127,1264,337,1451,867,18,13,4,187,530,51,60,0,0
2128,1225,366,1436,946,18,13,4,211,580,52,60,0,0
2129,1181,377,1410,999,18,13,4,229,622,53,60,0,0
2130,1125,403,1366,1053,18,13,4,241,650,54,60,0,0
2131,1076,435,1318,1076,18,13,4,242,641,55,60,0,0
2132,998,467,1239,1080,18,13,4,241,613,56,60,0,0
2133,928,536,1168,1080,18,13,4,240,544,57,60,0,0
2134,842,604,1070,1080,18,13,4,228,476,58,60,0,0
2135,752,683,964,1080,18,13,4,212,397,59,60,0,0
2136,713,713,919,1080,18,13,4,206,367,60,60,1,0
2146,1164,278,1270,418,24,13,4,106,140,0,5,0,0
2147,1163,277,1263,409,24,13,4,100,132,1,5,0,0
2148,1163,275,1264,408,24,13,4,101,133,2,5,0,0
2149,1163,275,1264,407,24,13,4,101,132,3,5,0,0
2150,1163,276,1263,407,24,13,4,100,131,4,5,0,0
2151,1163,276,1262,406,24,13,4,99,130,5,5,0,0
2526,1606,153,1642,276,28,13,4,36,123,0,48,0,0
2527,1605,158,1640,277,28,13,4,35,119,1,48,0,0
2528,1603,159,1640,283,28,13,4,37,124,2,48,0,0
2529,1602,160,1639,286,28,13,4,37,126,3,48,0,0
2531,1599,160,1639,297,28,13,4,40,137,0,48,0,1
2532,1598,164,1638,302,28,13,4,40,138,1,48,0,0
2533,1598,167,1637,304,28,13,4,39,137,2,48,0,0
2534,1597,169,1636,309,28,13,4,39,140,3,48,0,0
2535,1596,170,1638,317,28,13,4,42,147,4,48,0,0
2536,1597,174,1637,318,28,13,4,40,144,5,48,0,0
2537,1596,181,1637,325,28,13,4,41,144,6,48,0,0
2538,1595,181,1638,331,28,13,4,43,150,7,48,0,0
2539,1594,181,1638,334,28,13,4,44,153,8,48,0,0
2540,1594,182,1639,338,28,13,4,45,156,9,48,0,0
2541,1594,179,1641,345,28,13,4,47,166,10,48,0,0
2542,1592,181,1641,353,28,13,4,49,172,11,48,0,0
2543,1592,184,1642,359,28,13,4,50,175,12,48,0,0
2544,1592,191,1641,364,28,13,4,49,173,13,48,0,0
2545,1592,192,1642,369,28,13,4,50,177,14,48,0,0
2546,1590,196,1642,379,28,13,4,52,183,15,48,0,0
2547,1586,198,1640,388,28,13,4,54,190,16,48,0,0
2548,1582,202,1637,396,28,13,4,55,194,17,48,0,0
2549,1579,205,1637,409,28,13,4,58,204,18,48,0,0
2550,1577,204,1637,417,28,13,4,60,213,19,48,0,0
2551,1575,211,1635,423,28,13,4,60,212,20,48,0,0
2552,1569,213,1632,434,28,13,4,63,221,21,48,0,0
2553,1565,217,1630,444,28,13,4,65,227,22,48,0,0
2554,1562,219,1630,460,28,13,4,68,241,23,48,0,0
2555,1559,222,1630,469,28,13,4,71,247,24,48,0,0
2556,1553,231,1627,487,28,13,4,74,256,25,48,0,0
2557,1548,230,1625,498,28,13,4,77,268,26,48,0,0
2558,1545,241,1624,516,28,13,4,79,275,27,48,0,0
2559,1542,241,1625,529,28,13,4,83,288,28,48,0,0
2560,1531,246,1618,546,28,13,4,87,300,29,48,0,0
2561,1520,255,1612,568,28,13,4,92,313,30,48,0,0
2562,1508,259,1607,594,28,13,4,99,335,31,48,0,0
2563,1497,272,1601,625,28,13,4,104,353,32,48,0,0
2564,1487,281,1593,633,28,13,4,106,352,33,48,0,0
2565,1468,296,1581,668,28,13,4,113,372,34,48,0,0
2566,1454,303,1573,693,28,13,4,119,390,35,48,0,0
2567,1435,317,1565,741,28,13,4,130,424,36,48,0,0
2568,1417,330,1556,783,28,13,4,139,453,37,48,0,0
2569,1397,345,1544,823,28,13,4,147,478,38,48,0,0
2570,1374,367,1532,877,28,13,4,158,510,39,48,0,0
2571,1356,384,1520,905,28,13,4,164,521,40,48,0,0
2572,1323,414,1506,994,28,13,4,183,580,41,48,0,0
2573,1289,440,1484,1049,28,13,4,195,609,42,48,0,0
2574,1247,483,1444,1076,28,13,4,197,593,43,48,0,0
2575,1201,533,1390,1080,28,13,4,189,547,44,48,0,0
2576,1139,581,1325,1080,28,13,4,186,499,45,48,0,0
2577,1052,666,1225,1080,28,13,4,173,414,46,48,0,0
2578,948,745,1111,1080,28,13,4,163,335,47,48,0,0
2579,912,778,1069,1080,28,13,4,157,302,48,48,1,0
3460,1551,145,1586,251,31,13,4,35,106,0,84,0,0
3461,1551,144,1586,252,31,13,4,35,108,1,84,0,0
3463,1548,148,1583,254,31,13,4,35,106,0,84,0,0
3465,1551,150,1586,258,31,13,4,35,108,0,84,0,0
3466,1551,148,1587,259,31,13,4,36,111,1,84,0,0
3467,1551,149,1587,260,31,13,4,36,111,2,84,0,0
3468,1549,149,1585,263,31,13,4,36,114,3,84,0,0
3469,1546,150,1581,260,31,13,4,35,110,4,84,0,0
3471,1542,151,1577,264,31,13,4,35,113,0,84,0,0
3473,1536,154,1572,267,31,13,4,36,113,0,84,0,1
3474,1533,152,1571,270,31,13,4,38,118,1,84,0,0
3475,1530,152,1567,263,31,13,4,37,111,2,84,0,0
3476,1526,154,1564,270,31,13,4,38,116,3,84,0,0
3477,1521,152,1562,273,31,13,4,41,121,4,84,0,0
3478,1516,147,1559,277,31,13,4,43,130,5,84,0,0
3479,1513,145,1557,279,31,13,4,44,134,6,84,0,0
3480,1510,145,1556,280,31,13,4,46,135,7,84,0,0
3481,1510,150,1556,286,31,13,4,46,136,8,84,0,0
3482,1510,154,1556,290,31,13,4,46,136,9,84,0,0
3483,1510,151,1558,290,31,13,4,48,139,10,84,0,0
3484,1509,148,1559,294,31,13,4,50,146,11,84,0,0
3485,1508,147,1559,294,31,13,4,51,147,12,84,0,0
3486,1505,147,1557,297,31,13,4,52,150,13,84,0,0
3487,1502,149,1554,302,31,13,4,52,153,14,84,0,0
3488,1501,149,1552,301,31,13,4,51,152,15,84,0,0
3489,1499,149,1551,303,31,13,4,52,154,16,84,0,0
3490,1499,153,1551,308,31,13,4,52,155,17,84,0,0
3491,1496,158,1547,312,31,13,4,51,154,18,84,0,0
3492,1494,161,1546,317,31,13,4,52,156,19,84,0,0
3493,1492,167,1543,324,31,13,4,51,157,20,84,0,0
3494,1490,168,1542,328,31,13,4,52,160,21,84,0,0
3495,1487,168,1540,332,31,13,4,53,164,22,84,0,0
3496,1486,172,1538,334,31,13,4,52,162,23,84,0,0
3497,1483,172,1536,337,31,13,4,53,165,24,84,0,0
3498,1478,171,1535,345,31,13,4,57,174,25,84,0,0
3499,1475,168,1535,351,31,13,4,60,183,26,84,0,0
3500,1474,167,1535,355,31,13,4,61,188,27,84,0,0
3501,1474,167,1536,357,31,13,4,62,190,28,84,0,0
3502,1470,164,1534,362,31,13,4,64,198,29,84,0,0
3503,1467,166,1531,364,31,13,4,64,198,30,84,0,0
3504,1464,168,1529,371,31,13,4,65,203,31,84,0,0
3505,1463,168,1529,377,31,13,4,66,209,32,84,0,0
3506,1462,166,1530,378,31,13,4,68,212,33,84,0,0
3507,1460,171,1527,386,31,13,4,67,215,34,84,0,0
3508,1458,182,1524,392,31,13,4,66,210,35,84,0,0
3509,1455,191,1519,396,31,13,4,64,205,36,84,0,0
3510,1454,196,1520,405,31,13,4,66,209,37,84,0,0
3511,1454,196,1521,413,31,13,4,67,217,38,84,0,0
3512,1454,195,1522,417,31,13,4,68,222,39,84,0,0
3513,1454,201,1522,424,31,13,4,68,223,40,84,0,0
3514,1448,198,1519,432,31,13,4,71,234,41,84,0,0
3515,1442,198,1514,435,31,13,4,72,237,42,84,0,0
3516,1434,196,1511,448,31,13,4,77,252,43,84,0,0
3517,1430,198,1509,457,31,13,4,79,259,44,84,0,0
3518,1427,197,1507,460,31,13,4,80,263,45,84,0,0
3519,1426,207,1505,469,31,13,4,79,262,46,84,0,0
3520,1420,212,1501,478,31,13,4,81,266,47,84,0,0
3521,1416,215,1498,486,31,13,4,82,271,48,84,0,0
3522,1412,224,1496,502,31,13,4,84,278,49,84,0,0
3523,1412,235,1496,512,31,13,4,84,277,50,84,0,0
3524,1414,237,1501,523,31,13,4,87,286,51,84,0,0
3525,1417,244,1508,544,31,13,4,91,300,52,84,0,0
3526,1414,245,1511,559,31,13,4,97,314,53,84,0,0
3527,1415,240,1517,572,31,13,4,102,332,54,84,0,0
3528,1418,238,1528,595,31,13,4,110,357,55,84,0,0
3529,1425,241,1535,601,31,13,4,110,360,56,84,0,0
3530,1434,250,1546,612,31,13,4,112,362,57,84,0,0
3531,1439,257,1556,637,31,13,4,117,380,58,84,0,0
3532,1434,254,1557,651,31,13,4,123,397,59,84,0,0
3533,1435,257,1560,668,31,13,4,125,411,60,84,0,0
3534,1438,270,1567,695,31,13,4,129,425,61,84,0,0
3535,1444,281,1575,715,31,13,4,131,434,62,84,0,0
3536,1446,287,1579,722,31,13,4,133,435,63,84,0,0
3537,1441,299,1580,751,31,13,4,139,452,64,84,0,0
3538,1434,305,1578,773,31,13,4,144,468,65,84,0,0
3539,1429,312,1576,787,31,13,4,147,475,66,84,0,0
3540,1422,321,1578,823,31,13,4,156,502,67,84,0,0
3541,1422,335,1580,852,31,13,4,158,517,68,84,0,0
3542,1419,343,1578,862,31,13,4,159,519,69,84,0,0
3543,1410,354,1571,877,31,13,4,161,523,70,84,0,0
3544,1385,357,1556,898,31,13,4,171,541,71,84,0,0
3545,1366,350,1548,922,31,13,4,182,572,72,84,0,0
3546,1389,375,1579,937,31,13,4,190,562,73,84,0,0
3547,1371,404,1577,1001,31,13,4,206,597,74,84,0,0
3548,1356,431,1568,1047,31,13,4,212,616,75,84,0,0
3549,1370,447,1582,1048,31,13,4,212,601,76,84,0,0
3550,1405,468,1630,1067,31,13,4,225,599,77,84,0,0
3551,1409,510,1635,1078,31,13,4,226,568,78,84,0,0
3552,1412,538,1636,1077,31,13,4,224,539,79,84,0,0
3553,1423,581,1638,1080,31,13,4,215,499,80,84,0,0
3554,1438,649,1637,1079,31,13,4,199,430,81,84,0,0
3555,1446,704,1638,1079,31,13,4,192,375,82,84,0,0
3556,1444,785,1615,1077,31,13,4,171,292,83,84,0,0
3557,1453,824,1608,1080,31,13,4,155,256,84,84,1,0
3442,1603,139,1638,227,36,13,4,35,88,0,56,0,0
3445,1604,140,1639,229,36,13,4,35,89,0,56,0,0
3446,1606,140,1641,232,36,13,4,35,92,1,56,0,0
3447,1606,141,1641,233,36,13,4,35,92,2,56,0,0
3451,1613,145,1649,241,36,13,4,36,96,0,56,0,0
3452,1614,148,1650,245,36,13,4,36,97,1,56,0,0
3456,1615,148,1652,250,36,13,4,37,102,0,56,0,0
3457,1615,146,1653,253,36,13,4,38,107,1,56,0,0
3458,1613,148,1650,253,36,13,4,37,105,2,56,0,0
3459,1613,148,1650,254,36,13,4,37,106,3,56,0,0
3460,1612,148,1650,254,36,13,4,38,106,4,56,0,0
3461,1613,146,1651,258,36,13,4,38,112,5,56,0,0
3462,1612,148,1650,260,36,13,4,38,112,6,56,0,0
3463,1612,150,1650,260,36,13,4,38,110,7,56,0,0
3464,1610,152,1646,260,36,13,4,36,108,8,56,0,0
3465,1609,152,1645,261,36,13,4,36,109,9,56,0,0
3466,1608,151,1644,261,36,13,4,36,110,10,56,0,0
3467,1607,152,1644,262,36,13,4,37,110,11,56,0,0
3469,1598,157,1633,260,36,13,4,35,103,0,56,0,0
3471,1597,155,1632,264,36,13,4,35,109,0,56,0,1
3472,1596,156,1631,265,36,13,4,35,109,1,56,0,0
3473,1595,157,1631,270,36,13,4,36,113,2,56,0,0
3474,1593,158,1629,271,36,13,4,36,113,3,56,0,0
3475,1593,161,1629,273,36,13,4,36,112,4,56,0,0
3476,1594,162,1629,275,36,13,4,35,113,5,56,0,0
3477,1594,159,1631,275,36,13,4,37,116,6,56,0,0
3478,1595,163,1631,279,36,13,4,36,116,7,56,0,0
3479,1593,160,1631,283,36,13,4,38,123,8,56,0,0
3480,1592,167,1627,282,36,13,4,35,115,9,56,0,0
3481,1588,166,1625,285,36,13,4,37,119,10,56,0,0
3482,1584,165,1624,290,36,13,4,40,125,11,56,0,0
3483,1579,167,1618,291,36,13,4,39,124,12,56,0,0
3484,1577,165,1617,293,36,13,4,40,128,13,56,0,0
3485,1573,166,1613,294,36,13,4,40,128,14,56,0,0
3486,1566,158,1610,293,36,13,4,44,135,15,56,0,0
3487,1561,166,1603,296,36,13,4,42,130,16,56,0,0
3488,1558,165,1602,299,36,13,4,44,134,17,56,0,0
3489,1556,167,1601,299,36,13,4,45,132,18,56,0,0
3490,1555,167,1600,301,36,13,4,45,134,19,56,0,0
3491,1555,170,1602,306,36,13,4,47,136,20,56,0,0
3492,1554,170,1601,307,36,13,4,47,137,21,56,0,0
3493,1552,169,1602,311,36,13,4,50,142,22,56,0,0
3494,1553,172,1603,315,36,13,4,50,143,23,56,0,0
3495,1554,172,1604,318,36,13,4,50,146,24,56,0,0
3496,1554,174,1605,322,36,13,4,51,148,25,56,0,0
3497,1555,175,1607,325,36,13,4,52,150,26,56,0,0
3498,1550,175,1604,327,36,13,4,54,152,27,56,0,0
3499,1546,177,1599,329,36,13,4,53,152,28,56,0,0
3500,1544,183,1597,335,36,13,4,53,152,29,56,0,0
3501,1542,182,1596,338,36,13,4,54,156,30,56,0,0
3502,1542,184,1596,342,36,13,4,54,158,31,56,0,0
3503,1539,185,1596,348,36,13,4,57,163,32,56,0,0
3504,1533,187,1590,350,36,13,4,57,163,33,56,0,0
3505,1526,183,1585,354,36,13,4,59,171,34,56,0,0
3506,1522,182,1583,357,36,13,4,61,175,35,56,0,0
3507,1522,185,1582,358,36,13,4,60,173,36,56,0,0
3508,1518,185,1578,358,36,13,4,60,173,37,56,0,0
3509,1516,189,1575,361,36,13,4,59,172,38,56,0,0
3510,1511,196,1570,368,36,13,4,59,172,39,56,0,0
3511,1508,197,1568,375,36,13,4,60,178,40,56,0,0
3512,1507,198,1570,386,36,13,4,63,188,41,56,0,0
3513,1510,201,1576,393,36,13,4,66,192,42,56,0,0
3514,1513,199,1579,394,36,13,4,66,195,43,56,0,0
3515,1516,201,1581,393,36,13,4,65,192,44,56,0,0
3516,1515,202,1581,399,36,13,4,66,197,45,56,0,0
3517,1511,202,1578,400,36,13,4,67,198,46,56,0,0
3518,1506,203,1575,406,36,13,4,69,203,47,56,0,0
3519,1502,204,1572,417,36,13,4,70,213,48,56,0,0
3520,1497,203,1569,421,36,13,4,72,218,49,56,0,0
3521,1494,206,1565,423,36,13,4,71,217,50,56,0,0
3522,1488,215,1557,425,36,13,4,69,210,51,56,0,0
3523,1479,212,1549,431,36,13,4,70,219,52,56,0,0
3524,1474,217,1544,440,36,13,4,70,223,53,56,0,0
3525,1472,215,1537,427,36,13,4,65,212,54,56,0,0
3526,1471,215,1530,408,36,13,4,59,193,55,56,0,0
3527,1468,217,1527,409,36,13,4,59,192,56,56,1,0
3529,1439,222,1494,395,36,13,4,55,173,0,56,0,1
3530,1419,229,1484,430,36,13,4,65,201,1,56,0,0
3531,1417,236,1489,459,36,13,4,72,223,2,56,0,0
3532,1419,240,1493,471,36,13,4,74,231,3,56,0,0
3533,1418,246,1498,502,36,13,4,80,256,4,56,0,0
3534,1416,253,1500,531,36,13,4,84,278,5,56,0,0
3535,1411,248,1501,550,36,13,4,90,302,6,56,0,0
3536,1408,251,1499,554,36,13,4,91,303,7,56,0,0
3537,1407,260,1497,559,36,13,4,90,299,8,56,0,0
3538,1406,261,1500,570,36,13,4,94,309,9,56,0,0
3539,1403,264,1503,598,36,13,4,100,334,10,56,0,0
3540,1395,278,1499,632,36,13,4,104,354,11,56,0,0
3541,1384,281,1494,654,36,13,4,110,373,12,56,0,0
3542,1370,289,1483,664,36,13,4,113,375,13,56,0,0
3543,1360,299,1481,706,36,13,4,121,407,14,56,0,0
3544,1359,301,1467,646,36,13,4,108,345,15,56,0,0
3545,1353,306,1463,657,36,13,4,110,351,16,56,0,0
3546,1333,320,1463,746,36,13,4,130,426,17,56,0,0
3547,1321,330,1444,733,36,13,4,123,403,18,56,0,0
3548,1293,351,1423,758,36,13,4,130,407,19,56,0,0
3549,1273,362,1427,837,36,13,4,154,475,20,56,0,0
3550,1255,374,1420,870,36,13,4,165,496,21,56,0,0
3551,1237,395,1408,901,36,13,4,171,506,22,56,0,0
3552,1204,411,1387,945,36,13,4,183,534,23,56,0,0
3553,1173,428,1362,976,36,13,4,189,548,24,56,0,0
3554,1131,443,1340,1041,36,13,4,209,598,25,56,0,0
3555,1082,474,1300,1070,36,13,4,218,596,26,56,0,0
3556,1076,497,1295,1077,36,13,4,219,580,27,56,0,0
3557,1073,525,1289,1079,36,13,4,216,554,28,56,0,0
3558,1045,567,1252,1080,36,13,4,207,513,29,56,0,0
3559,981,594,1192,1080,36,13,4,211,486,30,56,0,0
3560,900,646,1110,1080,36,13,4,210,434,31,56,0,0
3561,864,703,1071,1080,36,13,4,207,377,32,56,0,0
3562,846,757,1036,1073,36,13,4,190,316,33,56,0,0
3563,770,838,933,1078,36,13,4,163,240,34,56,0,0
3564,740,878,883,1080,36,13,4,143,202,35,56,0,0
3470,1602,136,1659,270,39,13,4,57,134,0,0,0,0
3486,1536,159,1571,288,40,13,4,35,129,0,1,0,0
3487,1535,163,1570,293,40,13,4,35,130,1,1,0,0
3514,1596,174,1631,316,44,13,4,35,142,0,66,0,1
3515,1598,176,1633,321,44,13,4,35,145,1,66,0,0
3516,1599,178,1635,326,44,13,4,36,148,2,66,0,0
3517,1600,177,1637,327,44,13,4,37,150,3,66,0,0
3518,1602,179,1639,331,44,13,4,37,152,4,66,0,0
3519,1603,180,1641,333,44,13,4,38,153,5,66,0,0
3520,1605,181,1643,337,44,13,4,38,156,6,66,0,0
3521,1605,184,1645,341,44,13,4,40,157,7,66,0,0
3522,1604,182,1645,344,44,13,4,41,162,8,66,0,0
3523,1604,184,1646,350,44,13,4,42,166,9,66,0,0
3524,1604,188,1647,354,44,13,4,43,166,10,66,0,0
3525,1604,186,1648,359,44,13,4,44,173,11,66,0,0
3526,1605,190,1650,364,44,13,4,45,174,12,66,0,0
3527,1605,192,1651,367,44,13,4,46,175,13,66,0,0
3528,1604,193,1651,371,44,13,4,47,178,14,66,0,0
3529,1606,196,1654,380,44,13,4,48,184,15,66,0,0
3530,1608,200,1656,384,44,13,4,48,184,16,66,0,0
3531,1610,200,1659,387,44,13,4,49,187,17,66,0,0
3532,1609,200,1660,393,44,13,4,51,193,18,66,0,0
3533,1609,201,1660,397,44,13,4,51,196,19,66,0,0
3534,1611,206,1664,410,44,13,4,53,204,20,66,0,0
3535,1612,207,1667,415,44,13,4,55,208,21,66,0,0
3536,1612,213,1667,424,44,13,4,55,211,22,66,0,0
3537,1611,215,1668,430,44,13,4,57,215,23,66,0,0
3538,1608,217,1665,431,44,13,4,57,214,24,66,0,0
3539,1608,221,1666,442,44,13,4,58,221,25,66,0,0
3540,1608,225,1668,450,44,13,4,60,225,26,66,0,0
3541,1607,226,1668,454,44,13,4,61,228,27,66,0,0
3542,1600,232,1663,467,44,13,4,63,235,28,66,0,0
3543,1595,233,1660,470,44,13,4,65,237,29,66,0,0
3544,1591,236,1658,479,44,13,4,67,243,30,66,0,0
3545,1589,239,1660,495,44,13,4,71,256,31,66,0,0
3546,1587,236,1661,502,44,13,4,74,266,32,66,0,0
3547,1585,245,1661,514,44,13,4,76,269,33,66,0,0
3548,1580,248,1658,523,44,13,4,78,275,34,66,0,0
3549,1576,252,1656,532,44,13,4,80,280,35,66,0,0
3550,1573,258,1657,552,44,13,4,84,294,36,66,0,0
3551,1571,260,1656,553,44,13,4,85,293,37,66,0,0
3552,1565,263,1654,569,44,13,4,89,306,38,66,0,0
3553,1557,266,1648,578,44,13,4,91,312,39,66,0,0
3554,1549,267,1641,584,44,13,4,92,317,40,66,0,0
3555,1542,275,1638,608,44,13,4,96,333,41,66,0,0
3556,1536,282,1637,627,44,13,4,101,345,42,66,0,0
3557,1525,284,1629,638,44,13,4,104,354,43,66,0,0
3558,1515,295,1625,665,44,13,4,110,370,44,66,0,0
3559,1506,303,1620,681,44,13,4,114,378,45,66,0,0
3560,1498,307,1620,706,44,13,4,122,399,46,66,0,0
3561,1492,323,1620,739,44,13,4,128,416,47,66,0,0
3562,1486,327,1618,753,44,13,4,132,426,48,66,0,0
3563,1476,337,1617,787,44,13,4,141,450,49,66,0,0
3564,1465,350,1611,817,44,13,4,146,467,50,66,0,0
3565,1454,358,1602,830,44,13,4,148,472,51,66,0,0
3566,1439,369,1601,885,44,13,4,162,516,52,66,0,0
3567,1430,387,1597,915,44,13,4,167,528,53,66,0,0
3568,1412,402,1590,954,44,13,4,178,552,54,66,0,0
3569,1392,425,1579,1001,44,13,4,187,576,55,66,0,0
3570,1375,445,1566,1024,44,13,4,191,579,56,66,0,0
3571,1356,468,1553,1054,44,13,4,197,586,57,66,0,0
3572,1333,496,1531,1074,44,13,4,198,578,58,66,0,0
3573,1298,528,1495,1078,44,13,4,197,550,59,66,0,0
3574,1246,571,1437,1080,44,13,4,191,509,60,66,0,0
3575,1189,604,1379,1080,44,13,4,190,476,61,66,0,0
3576,1132,652,1316,1076,44,13,4,184,424,62,66,0,0
3577,1067,711,1244,1077,44,13,4,177,366,63,66,0,0
3578,992,762,1164,1077,44,13,4,172,315,64,66,0,0
3579,911,853,1052,1079,44,13,4,141,226,65,66,0,0
3580,871,896,992,1080,44,13,4,121,184,66,66,1,0
3528,1440,237,1488,319,45,13,4,48,82,0,0,0,0
3733,1595,131,1631,228,55,13,4,36,97,0,95,0,1
3734,1596,133,1632,229,55,13,4,36,96,1,95,0,0
3735,1596,133,1631,229,55,13,4,35,96,2,95,0,0
3736,1593,133,1630,232,55,13,4,37,99,3,95,0,0
3737,1591,133,1629,233,55,13,4,38,100,4,95,0,0
3738,1591,134,1629,232,55,13,4,38,98,5,95,0,0
3739,1589,134,1628,235,55,13,4,39,101,6,95,0,0
3740,1588,134,1628,236,55,13,4,40,102,7,95,0,0
3741,1588,134,1628,239,55,13,4,40,105,8,95,0,0
3742,1586,134,1627,242,55,13,4,41,108,9,95,0,0
3743,1585,132,1626,244,55,13,4,41,112,10,95,0,0
3744,1583,133,1624,244,55,13,4,41,111,11,95,0,0
3745,1580,133,1621,246,55,13,4,41,113,12,95,0,0
3746,1578,134,1619,246,55,13,4,41,112,13,95,0,0
3747,1577,134,1618,248,55,13,4,41,114,14,95,0,0
3748,1575,135,1617,251,55,13,4,42,116,15,95,0,0
3749,1574,134,1618,254,55,13,4,44,120,16,95,0,0
3750,1573,134,1617,255,55,13,4,44,121,17,95,0,0
3751,1574,134,1617,255,55,13,4,43,121,18,95,0,0
3752,1576,136,1619,256,55,13,4,43,120,19,95,0,0
3753,1576,136,1620,256,55,13,4,44,120,20,95,0,0
3754,1578,135,1622,259,55,13,4,44,124,21,95,0,0
3755,1582,139,1626,261,55,13,4,44,122,22,95,0,0
3756,1585,141,1628,264,55,13,4,43,123,23,95,0,0
3757,1586,145,1629,268,55,13,4,43,123,24,95,0,0
3758,1586,146,1629,270,55,13,4,43,124,25,95,0,0
3759,1580,143,1624,273,55,13,4,44,130,26,95,0,0
3760,1577,142,1622,275,55,13,4,45,133,27,95,0,0
3761,1572,140,1619,276,55,13,4,47,136,28,95,0,0
3762,1571,138,1618,277,55,13,4,47,139,29,95,0,0
3763,1569,140,1617,280,55,13,4,48,140,30,95,0,0
3764,1566,137,1615,282,55,13,4,49,145,31,95,0,0
3765,1564,135,1615,286,55,13,4,51,151,32,95,0,0
3766,1560,136,1611,289,55,13,4,51,153,33,95,0,0
3767,1556,136,1608,290,55,13,4,52,154,34,95,0,0
3768,1550,145,1598,289,55,13,4,48,144,35,95,0,0
3769,1553,155,1597,291,55,13,4,44,136,36,95,0,0
3770,1548,156,1593,295,55,13,4,45,139,37,95,0,0
3771,1544,156,1590,297,55,13,4,46,141,38,95,0,0
3772,1541,149,1590,300,55,13,4,49,151,39,95,0,0
3773,1542,145,1594,305,55,13,4,52,160,40,95,0,0
3774,1543,143,1598,311,55,13,4,55,168,41,95,0,0
3775,1541,150,1596,313,55,13,4,55,163,42,95,0,0
3776,1539,147,1596,319,55,13,4,57,172,43,95,0,0
3777,1539,144,1600,324,55,13,4,61,180,44,95,0,0
3778,1542,147,1603,327,55,13,4,61,180,45,95,0,0
3779,1542,152,1604,335,55,13,4,62,183,46,95,0,0
3780,1542,153,1604,340,55,13,4,62,187,47,95,0,0
3781,1541,155,1605,345,55,13,4,64,190,48,95,0,0
3782,1538,153,1605,352,55,13,4,67,199,49,95,0,0
3783,1538,159,1604,356,55,13,4,66,197,50,95,0,0
3784,1541,166,1607,362,55,13,4,66,196,51,95,0,0
3785,1543,171,1609,368,55,13,4,66,197,52,95,0,0
3786,1543,174,1608,370,55,13,4,65,196,53,95,0,0
3787,1541,176,1608,376,55,13,4,67,200,54,95,0,0
3788,1541,176,1611,386,55,13,4,70,210,55,95,0,0
3789,1542,176,1613,390,55,13,4,71,214,56,95,0,0
3790,1543,184,1614,397,55,13,4,71,213,57,95,0,0
3791,1541,188,1612,402,55,13,4,71,214,58,95,0,0
3792,1540,188,1614,413,55,13,4,74,225,59,95,0,0
3793,1540,192,1615,422,55,13,4,75,230,60,95,0,0
3794,1540,193,1617,426,55,13,4,77,233,61,95,0,0
3795,1540,197,1619,435,55,13,4,79,238,62,95,0,0
3796,1541,203,1621,443,55,13,4,80,240,63,95,0,0
3797,1539,199,1625,454,55,13,4,86,255,64,95,0,0
3798,1544,206,1633,467,55,13,4,89,261,65,95,0,0
3799,1546,213,1635,474,55,13,4,89,261,66,95,0,0
3800,1550,216,1642,486,55,13,4,92,270,67,95,0,0
3801,1541,218,1640,501,55,13,4,99,283,68,95,0,0
3802,1540,219,1644,510,55,13,4,104,291,69,95,0,0
3803,1540,221,1650,524,55,13,4,110,303,70,95,0,0
3804,1538,226,1653,540,55,13,4,115,314,71,95,0,0
3805,1538,229,1654,546,55,13,4,116,317,72,95,0,0
3806,1531,238,1649,563,55,13,4,118,325,73,95,0,0
3807,1517,241,1639,579,55,13,4,122,338,74,95,0,0
3808,1492,236,1623,596,55,13,4,131,360,75,95,0,0
3809,1470,247,1607,623,55,13,4,137,376,76,95,0,0
3810,1461,249,1601,637,55,13,4,140,388,77,95,0,0
3811,1447,257,1587,650,55,13,4,140,393,78,95,0,0
3812,1431,272,1573,668,55,13,4,142,396,79,95,0,0
3813,1412,279,1557,684,55,13,4,145,405,80,95,0,0
3814,1388,289,1544,727,55,13,4,156,438,81,95,0,0
3815,1369,295,1533,758,55,13,4,164,463,82,95,0,0
3816,1356,306,1525,782,55,13,4,169,476,83,95,0,0
3817,1338,333,1517,833,55,13,4,179,500,84,95,0,0
3818,1310,356,1492,857,55,13,4,182,501,85,95,0,0
3819,1269,361,1475,919,55,13,4,206,558,86,95,0,0
3820,1240,381,1460,973,55,13,4,220,592,87,95,0,0
3821,1225,399,1447,994,55,13,4,222,595,88,95,0,0
3822,1190,428,1424,1047,55,13,4,234,619,89,95,0,0
3823,1161,455,1398,1072,55,13,4,237,617,90,95,0,0
3824,1109,475,1351,1078,55,13,4,242,603,91,95,0,0
3825,1085,515,1321,1080,55,13,4,236,565,92,95,0,0
3826,1034,550,1268,1080,55,13,4,234,530,93,95,0,0
3827,975,614,1193,1080,55,13,4,218,466,94,95,0,0
3828,949,637,1165,1080,55,13,4,216,443,95,95,1,0
3765,1538,151,1573,279,66,13,4,35,128,0,65,0,1
3766,1535,153,1571,282,66,13,4,36,129,1,65,0,0
3767,1533,157,1569,285,66,13,4,36,128,2,65,0,0
3768,1529,156,1566,287,66,13,4,37,131,3,65,0,0
3769,1527,155,1566,292,66,13,4,39,137,4,65,0,0
3770,1523,157,1561,295,66,13,4,38,138,5,65,0,0
3771,1519,155,1559,297,66,13,4,40,142,6,65,0,0
3772,1511,154,1552,298,66,13,4,41,144,7,65,0,0
3773,1508,154,1550,301,66,13,4,42,147,8,65,0,0
3774,1505,155,1547,302,66,13,4,42,147,9,65,0,0
3775,1505,156,1547,304,66,13,4,42,148,10,65,0,0
3776,1503,159,1546,309,66,13,4,43,150,11,65,0,0
3777,1501,164,1545,317,66,13,4,44,153,12,65,0,0
3778,1500,163,1545,318,66,13,4,45,155,13,65,0,0
3779,1501,172,1546,325,66,13,4,45,153,14,65,0,0
3780,1499,171,1546,329,66,13,4,47,158,15,65,0,0
3781,1498,167,1548,336,66,13,4,50,169,16,65,0,0
3782,1499,171,1550,344,66,13,4,51,173,17,65,0,0
3783,1499,170,1551,344,66,13,4,52,174,18,65,0,0
3784,1502,175,1553,349,66,13,4,51,174,19,65,0,0
3785,1503,180,1554,355,66,13,4,51,175,20,65,0,0
3786,1503,183,1554,359,66,13,4,51,176,21,65,0,0
3787,1503,190,1553,365,66,13,4,50,175,22,65,0,0
3788,1502,191,1553,373,66,13,4,51,182,23,65,0,0
3789,1501,188,1555,380,66,13,4,54,192,24,65,0,0
3790,1501,196,1554,386,66,13,4,53,190,25,65,0,0
3791,1500,200,1553,390,66,13,4,53,190,26,65,0,0
3792,1498,200,1553,400,66,13,4,55,200,27,65,0,0
3793,1496,203,1553,410,66,13,4,57,207,28,65,0,0
3794,1492,202,1550,415,66,13,4,58,213,29,65,0,0
3795,1490,202,1550,422,66,13,4,60,220,30,65,0,0
3796,1492,206,1554,428,66,13,4,62,222,31,65,0,0
3797,1488,208,1551,432,66,13,4,63,224,32,65,0,0
3798,1486,214,1551,445,66,13,4,65,231,33,65,0,0
3799,1480,220,1547,456,66,13,4,67,236,34,65,0,0
3800,1476,221,1545,460,66,13,4,69,239,35,65,0,0
3801,1472,225,1544,474,66,13,4,72,249,36,65,0,0
3802,1466,225,1540,479,66,13,4,74,254,37,65,0,0
3803,1457,226,1536,491,66,13,4,79,265,38,65,0,0
3804,1453,241,1534,509,66,13,4,81,268,39,65,0,0
3805,1452,245,1538,519,66,13,4,86,274,40,65,0,0
3806,1433,248,1525,539,66,13,4,92,291,41,65,0,0
3807,1425,251,1522,557,66,13,4,97,306,42,65,0,0
3808,1414,252,1512,563,66,13,4,98,311,43,65,0,0
3809,1398,264,1499,581,66,13,4,101,317,44,65,0,0
3810,1383,271,1487,598,66,13,4,104,327,45,65,0,0
3811,1363,277,1474,622,66,13,4,111,345,46,65,0,0
3812,1346,287,1462,650,66,13,4,116,363,47,65,0,0
3813,1335,296,1450,661,66,13,4,115,365,48,65,0,0
3814,1313,310,1434,694,66,13,4,121,384,49,65,0,0
3815,1298,324,1420,722,66,13,4,122,398,50,65,0,0
3816,1281,327,1406,740,66,13,4,125,413,51,65,0,0
3817,1253,349,1384,785,66,13,4,131,436,52,65,0,0
3818,1235,376,1356,779,66,13,4,121,403,53,65,0,0
3819,1209,375,1341,823,66,13,4,132,448,54,65,0,0
3820,1172,394,1317,891,66,13,4,145,497,55,65,0,0
3821,1140,400,1289,915,66,13,4,149,515,56,65,0,0
3822,1069,428,1241,1006,66,13,4,172,578,57,65,0,0
3823,1002,461,1186,1054,66,13,4,184,593,58,65,0,0
3824,964,480,1147,1073,66,13,4,183,593,59,65,0,0
3825,931,532,1107,1080,66,13,4,176,548,60,65,0,0
3826,858,568,1027,1080,66,13,4,169,512,61,65,0,0
3827,772,608,942,1080,66,13,4,170,472,62,65,0,0
3828,816,694,976,1080,66,13,4,160,386,63,65,0,0
3829,736,760,894,1080,66,13,4,158,320,64,65,0,0
3830,706,793,856,1080,66,13,4,150,287,65,65,1,0
3828,539,706,836,1074,69,13,4,297,368,0,3,0,0
3829,495,750,752,1070,69,13,4,257,320,1,3,0,0
3830,514,872,678,1074,69,13,4,164,202,2,3,0,0
3831,517,933,634,1076,69,13,4,117,143,3,3,0,0
3830,392,854,557,1070,70,13,4,165,216,0,0,0,0
4781,1157,277,1271,409,72,13,4,114,132,0,5,0,0
4782,1157,277,1271,409,72,13,4,114,132,1,5,0,0
4783,1156,276,1271,409,72,13,4,115,133,2,5,0,0
4784,1156,275,1271,409,72,13,4,115,134,3,5,0,0
4785,1154,274,1271,409,72,13,4,117,135,4,5,0,0
4786,1153,273,1271,410,72,13,4,118,137,5,5,0,0
5118,1778,525,1916,1050,73,13,4,138,525,0,37,0,1
5119,1724,512,1871,1062,73,13,4,147,550,1,37,0,0
5120,1707,492,1863,1066,73,13,4,156,574,2,37,0,0
5121,1693,482,1855,1070,73,13,4,162,588,3,37,0,0
5122,1688,480,1853,1070,73,13,4,165,590,4,37,0,0
5123,1684,481,1853,1070,73,13,4,169,589,5,37,0,0
5124,1681,483,1854,1069,73,13,4,173,586,6,37,0,0
5125,1682,484,1858,1069,73,13,4,176,585,7,37,0,0
5126,1679,482,1859,1069,73,13,4,180,587,8,37,0,0
5127,1676,483,1861,1070,73,13,4,185,587,9,37,0,0
5128,1675,484,1864,1072,73,13,4,189,588,10,37,0,0
5129,1673,483,1866,1073,73,13,4,193,590,11,37,0,0
5130,1672,483,1868,1072,73,13,4,196,589,12,37,0,0
5131,1673,482,1872,1071,73,13,4,199,589,13,37,0,0
5132,1672,482,1875,1071,73,13,4,203,589,14,37,0,0
5133,1675,481,1883,1072,73,13,4,208,591,15,37,0,0
5134,1676,481,1888,1071,73,13,4,212,590,16,37,0,0
5135,1677,482,1892,1070,73,13,4,215,588,17,37,0,0
5136,1670,485,1889,1073,73,13,4,219,588,18,37,0,0
5137,1670,487,1892,1076,73,13,4,222,589,19,37,0,0
5138,1668,484,1892,1075,73,13,4,224,591,20,37,0,0
5139,1666,482,1893,1073,73,13,4,227,591,21,37,0,0
5140,1665,485,1894,1074,73,13,4,229,589,22,37,0,0
5141,1668,486,1898,1071,73,13,4,230,585,23,37,0,0
5142,1667,484,1899,1071,73,13,4,232,587,24,37,0,0
5143,1666,488,1900,1071,73,13,4,234,583,25,37,0,0
5144,1666,490,1900,1068,73,13,4,234,578,26,37,0,0
5145,1670,492,1905,1067,73,13,4,235,575,27,37,0,0
5146,1672,492,1909,1071,73,13,4,237,579,28,37,0,0
5147,1672,490,1908,1069,73,13,4,236,579,29,37,0,0
5148,1672,488,1909,1070,73,13,4,237,582,30,37,0,0
5149,1671,487,1907,1072,73,13,4,236,585,31,37,0,0
5150,1672,485,1906,1070,73,13,4,234,585,32,37,0,0
5151,1670,489,1907,1074,73,13,4,237,585,33,37,0,0
5152,1676,493,1911,1076,73,13,4,235,583,34,37,0,0
5153,1715,512,1920,1069,73,13,4,205,557,35,37,0,0
5154,1761,603,1920,1050,73,13,4,159,447,36,37,0,0
5155,1770,615,1920,1048,73,13,4,150,433,37,37,1,0
5157,1621,159,1664,303,74,13,4,43,144,0,55,0,1
5158,1622,169,1662,305,74,13,4,40,136,1,55,0,0
5159,1618,170,1658,303,74,13,4,40,133,2,55,0,0
5160,1611,165,1655,311,74,13,4,44,146,3,55,0,0
5161,1607,164,1651,312,74,13,4,44,148,4,55,0,0
5162,1602,163,1648,316,74,13,4,46,153,5,55,0,0
5163,1602,165,1649,321,74,13,4,47,156,6,55,0,0
5164,1600,164,1648,325,74,13,4,48,161,7,55,0,0
5165,1595,170,1643,330,74,13,4,48,160,8,55,0,0
5166,1593,175,1641,333,74,13,4,48,158,9,55,0,0
5167,1590,174,1639,339,74,13,4,49,165,10,55,0,0
5168,1590,174,1640,343,74,13,4,50,169,11,55,0,0
5169,1588,175,1639,348,74,13,4,51,173,12,55,0,0
5170,1585,178,1637,354,74,13,4,52,176,13,55,0,0
5171,1583,180,1636,360,74,13,4,53,180,14,55,0,0
5172,1580,179,1635,368,74,13,4,55,189,15,55,0,0
5173,1579,179,1636,374,74,13,4,57,195,16,55,0,0
5174,1577,178,1636,380,74,13,4,59,202,17,55,0,0
5175,1572,179,1633,389,74,13,4,61,210,18,55,0,0
5176,1568,178,1631,394,74,13,4,63,216,19,55,0,0
5177,1566,181,1631,405,74,13,4,65,224,20,55,0,0
5178,1564,185,1629,411,74,13,4,65,226,21,55,0,0
5179,1558,184,1627,424,74,13,4,69,240,22,55,0,0
5180,1553,190,1623,431,74,13,4,70,241,23,55,0,0
5181,1552,191,1625,446,74,13,4,73,255,24,55,0,0
5182,1553,199,1627,456,74,13,4,74,257,25,55,0,0
5183,1551,200,1626,462,74,13,4,75,262,26,55,0,0
5184,1545,203,1623,475,74,13,4,78,272,27,55,0,0
5185,1540,205,1621,483,74,13,4,81,278,28,55,0,0
5186,1540,208,1625,497,74,13,4,85,289,29,55,0,0
5187,1540,216,1626,511,74,13,4,86,295,30,55,0,0
5188,1534,217,1624,520,74,13,4,90,303,31,55,0,0
5189,1525,221,1620,541,74,13,4,95,320,32,55,0,0
5190,1521,227,1619,554,74,13,4,98,327,33,55,0,0
5191,1520,233,1625,581,74,13,4,105,348,34,55,0,0
5192,1518,243,1625,598,74,13,4,107,355,35,55,0,0
5193,1512,247,1622,606,74,13,4,110,359,36,55,0,0
5194,1500,257,1618,639,74,13,4,118,382,37,55,0,0
5195,1491,260,1615,661,74,13,4,124,401,38,55,0,0
5196,1483,270,1617,704,74,13,4,134,434,39,55,0,0
5197,1476,280,1615,726,74,13,4,139,446,40,55,0,0
5198,1460,285,1608,754,74,13,4,148,469,41,55,0,0
5199,1438,301,1594,792,74,13,4,156,491,42,55,0,0
5200,1413,297,1579,821,74,13,4,166,524,43,55,0,0
5201,1394,323,1575,885,74,13,4,181,562,44,55,0,0
5202,1368,342,1555,919,74,13,4,187,577,45,55,0,0
5203,1330,369,1529,972,74,13,4,199,603,46,55,0,0
5204,1290,394,1498,1022,74,13,4,208,628,47,55,0,0
5205,1239,413,1460,1063,74,13,4,221,650,48,55,0,0
5206,1185,447,1414,1079,74,13,4,229,632,49,55,0,0
5207,1120,477,1354,1080,74,13,4,234,603,50,55,0,0
5208,1019,529,1259,1080,74,13,4,240,551,51,55,0,0
5209,943,579,1180,1080,74,13,4,237,501,52,55,0,0
5210,902,647,1123,1080,74,13,4,221,433,53,55,0,0
5211,792,761,980,1080,74,13,4,188,319,54,55,0,0
5212,750,801,924,1080,74,13,4,174,279,55,55,1,0
5181,1159,274,1268,408,75,13,4,109,134,0,0,0,0
5183,1160,273,1267,407,76,13,4,107,134,0,0,0,0
5649,1166,270,1269,398,78,13,4,103,128,0,12,0,0
5650,1156,269,1269,410,78,13,4,113,141,1,12,0,0
5651,1155,270,1268,410,78,13,4,113,140,2,12,0,0
5652,1157,270,1268,408,78,13,4,111,138,3,12,0,0
5653,1157,270,1269,409,78,13,4,112,139,4,12,0,0
5654,1157,268,1270,409,78,13,4,113,141,5,12,0,0
5655,1155,268,1270,409,78,13,4,115,141,6,12,0,0
5656,1158,271,1267,405,78,13,4,109,134,7,12,0,0
5657,1157,274,1266,406,78,13,4,109,132,8,12,0,0
5658,1157,272,1267,406,78,13,4,110,134,9,12,0,0
5659,1156,270,1267,405,78,13,4,111,135,10,12,0,0
5660,1158,273,1267,404,78,13,4,109,131,11,12,0,0
5661,1158,274,1266,404,78,13,4,108,130,12,12,0,0
5663,1154,273,1266,408,78,13,4,112,135,0,12,0,0
5664,1154,273,1265,408,78,13,4,111,135,1,12,0,0
5665,1154,274,1265,408,78,13,4,111,134,2,12,0,0
5671,1155,273,1270,410,78,13,4,115,137,0,12,0,0
5672,1155,271,1272,411,78,13,4,117,140,1,12,0,0
5673,1155,270,1272,410,78,13,4,117,140,2,12,0,0
5674,1155,270,1273,410,78,13,4,118,140,3,12,0,0
5686,1153,270,1270,411,78,13,4,117,141,0,12,0,0
5687,1153,270,1270,411,78,13,4,117,141,1,12,0,0
5688,1152,270,1269,412,78,13,4,117,142,2,12,0,0
5689,1152,269,1269,410,78,13,4,117,141,3,12,0,0
5690,1153,270,1269,411,78,13,4,116,141,4,12,0,0
5691,1158,272,1269,406,78,13,4,111,134,5,12,0,0
5692,1160,272,1269,404,78,13,4,109,132,6,12,0,0
5693,1163,276,1268,402,78,13,4,105,126,7,12,0,0
5694,1164,277,1268,402,78,13,4,104,125,8,12,0,0
5695,1164,278,1268,402,78,13,4,104,124,9,12,0,0
5696,1165,278,1268,402,78,13,4,103,124,10,12,0,0
5751,1161,273,1270,412,79,13,4,109,139,0,5,0,0
5752,1161,272,1269,410,79,13,4,108,138,1,5,0,0
5753,1161,271,1269,409,79,13,4,108,138,2,5,0,0
5754,1161,270,1269,409,79,13,4,108,139,3,5,0,0
5755,1162,271,1269,409,79,13,4,107,138,4,5,0,0
5756,1162,271,1269,408,79,13,4,107,137,5,5,0,0
5761,1151,270,1268,418,79,13,4,117,148,0,5,0,0
5762,1151,269,1269,417,79,13,4,118,148,1,5,0,0
5763,1151,268,1269,418,79,13,4,118,150,2,5,0,0
5764,1150,269,1269,418,79,13,4,119,149,3,5,0,0
5765,1150,269,1269,418,79,13,4,119,149,4,5,0,0
5766,1149,269,1269,419,79,13,4,120,150,5,5,0,0
5796,1148,278,1269,417,80,13,4,121,139,0,0,0,0
5799,1150,277,1269,417,81,13,4,119,140,0,0,0,0
736,3,861,118,1080,1,13,5,115,219,0,0,0,0
737,1,605,201,1074,2,13,5,200,469,0,83,0,1
738,0,413,281,1078,2,13,5,281,665,1,83,0,0
739,11,338,310,1043,2,13,5,299,705,2,83,0,0
740,104,301,402,998,2,13,5,298,697,3,83,0,0
741,187,291,473,956,2,13,5,286,665,4,83,0,0
742,248,267,522,907,2,13,5,274,640,5,83,0,0
743,299,254,569,887,2,13,5,270,633,6,83,0,0
744,318,226,585,859,2,13,5,267,633,7,83,0,0
745,337,211,579,791,2,13,5,242,580,8,83,0,0
746,343,195,579,770,2,13,5,236,575,9,83,0,0
747,372,193,588,721,2,13,5,216,528,10,83,0,0
748,370,167,574,674,2,13,5,204,507,11,83,0,0
749,364,162,558,650,2,13,5,194,488,12,83,0,0
750,353,151,535,612,2,13,5,182,461,13,83,0,0
751,340,140,517,591,2,13,5,177,451,14,83,0,0
752,331,137,507,586,2,13,5,176,449,15,83,0,0
753,326,128,485,542,2,13,5,159,414,16,83,0,0
754,317,122,467,521,2,13,5,150,399,17,83,0,0
755,312,120,454,504,2,13,5,142,384,18,83,0,0
756,312,113,445,475,2,13,5,133,362,19,83,0,0
757,314,107,447,470,2,13,5,133,363,20,83,0,0
758,326,103,456,465,2,13,5,130,362,21,83,0,0
759,341,97,464,441,2,13,5,123,344,22,83,0,0
760,351,92,471,433,2,13,5,120,341,23,83,0,0
761,360,89,477,425,2,13,5,117,336,24,83,0,0
762,369,83,481,407,2,13,5,112,324,25,83,0,0
763,379,80,488,397,2,13,5,109,317,26,83,0,0
764,391,83,494,382,2,13,5,103,299,27,83,0,0
765,402,75,502,363,2,13,5,100,288,28,83,0,0
766,407,76,504,355,2,13,5,97,279,29,83,0,0
767,407,75,503,350,2,13,5,96,275,30,83,0,0
768,405,73,498,336,2,13,5,93,263,31,83,0,0
769,404,73,495,332,2,13,5,91,259,32,83,0,0
770,409,72,496,317,2,13,5,87,245,33,83,0,0
771,409,72,493,305,2,13,5,84,233,34,83,0,0
772,409,75,489,298,2,13,5,80,223,35,83,0,0
773,403,74,479,286,2,13,5,76,212,36,83,0,0
774,396,69,473,283,2,13,5,77,214,37,83,0,0
775,391,67,466,276,2,13,5,75,209,38,83,0,0
776,385,62,460,269,2,13,5,75,207,39,83,0,0
777,377,64,449,264,2,13,5,72,200,40,83,0,0
778,370,67,440,262,2,13,5,70,195,41,83,0,0
779,364,63,434,256,2,13,5,70,193,42,83,0,0
780,362,64,428,249,2,13,5,66,185,43,83,0,0
781,362,67,425,244,2,13,5,63,177,44,83,0,0
782,361,58,424,238,2,13,5,63,180,45,83,0,0
783,363,57,424,233,2,13,5,61,176,46,83,0,0
784,364,57,423,230,2,13,5,59,173,47,83,0,0
785,364,43,425,220,2,13,5,61,177,48,83,0,0
786,369,49,427,216,2,13,5,58,167,49,83,0,0
787,376,51,432,211,2,13,5,56,160,50,83,0,0
788,382,51,436,205,2,13,5,54,154,51,83,0,0
789,384,48,437,202,2,13,5,53,154,52,83,0,0
790,384,44,436,196,2,13,5,52,152,53,83,0,0
791,384,41,436,193,2,13,5,52,152,54,83,0,0
792,383,39,435,189,2,13,5,52,150,55,83,0,0
793,382,32,434,183,2,13,5,52,151,56,83,0,0
794,382,31,432,180,2,13,5,50,149,57,83,0,0
795,380,35,429,177,2,13,5,49,142,58,83,0,0
796,374,31,423,174,2,13,5,49,143,59,83,0,0
797,372,31,419,170,2,13,5,47,139,60,83,0,0
798,371,32,416,166,2,13,5,45,134,61,83,0,0
799,371,26,416,161,2,13,5,45,135,62,83,0,0
800,371,31,413,156,2,13,5,42,125,63,83,0,0
801,367,25,411,154,2,13,5,44,129,64,83,0,0
802,364,21,408,152,2,13,5,44,131,65,83,0,0
803,363,21,406,149,2,13,5,43,128,66,83,0,0
804,362,21,404,146,2,13,5,42,125,67,83,0,0
805,361,17,403,144,2,13,5,42,127,68,83,0,0
806,359,14,401,141,2,13,5,42,127,69,83,0,0
807,356,10,399,140,2,13,5,43,130,70,83,0,0
808,353,10,396,138,2,13,5,43,128,71,83,0,0
809,353,12,393,136,2,13,5,40,124,72,83,0,0
810,354,12,393,132,2,13,5,39,120,73,83,0,0
811,353,9,393,131,2,13,5,40,122,74,83,0,0
812,352,7,392,129,2,13,5,40,122,75,83,0,0
813,350,5,390,128,2,13,5,40,123,76,83,0,0
814,349,7,388,125,2,13,5,39,118,77,83,0,0
815,348,7,386,122,2,13,5,38,115,78,83,0,0
816,347,6,385,121,2,13,5,38,115,79,83,0,0
817,346,5,383,118,2,13,5,37,113,80,83,0,0
818,344,8,379,117,2,13,5,35,109,81,83,0,0
819,342,8,377,115,2,13,5,35,107,82,83,0,0
820,343,8,378,117,2,13,5,35,109,83,83,1,0
745,1803,938,1920,1080,3,13,5,117,142,0,0,0,0
746,1692,820,1909,1066,4,13,5,217,246,0,0,0,0
754,1329,394,1902,975,5,13,5,573,581,0,12,0,0
755,1393,376,1893,903,5,13,5,500,527,1,12,0,0
756,1446,350,1902,849,5,13,5,456,499,2,12,0,0
757,1483,354,1898,825,5,13,5,415,471,3,12,0,0
758,1546,333,1920,773,5,13,5,374,440,4,12,0,0
759,1591,329,1920,754,5,13,5,329,425,5,12,0,0
760,1628,322,1920,737,5,13,5,292,415,6,12,0,0
761,1675,313,1920,695,5,13,5,245,382,7,12,0,0
762,1692,322,1920,693,5,13,5,228,371,8,12,0,0
763,1728,322,1920,675,5,13,5,192,353,9,12,0,0
764,1766,355,1920,670,5,13,5,154,315,10,12,0,0
765,1796,368,1920,654,5,13,5,124,286,11,12,0,0
766,1820,366,1920,635,5,13,5,100,269,12,12,0,0
766,1871,378,1919,637,6,13,5,48,259,0,0,0,0
1541,342,10,386,120,8,13,5,44,110,0,81,0,1
1542,345,9,388,119,8,13,5,43,110,1,81,0,0
1543,345,11,389,120,8,13,5,44,109,2,81,0,0
1544,346,15,389,124,8,13,5,43,109,3,81,0,0
1545,347,13,391,127,8,13,5,44,114,4,81,0,0
1546,350,13,394,128,8,13,5,44,115,5,81,0,0
1547,353,11,398,130,8,13,5,45,119,6,81,0,0
1548,355,9,401,131,8,13,5,46,122,7,81,0,0
1549,356,10,402,133,8,13,5,46,123,8,81,0,0
1550,358,8,403,133,8,13,5,45,125,9,81,0,0
1551,358,7,404,135,8,13,5,46,128,10,81,0,0
1552,359,9,405,139,8,13,5,46,130,11,81,0,0
1553,360,11,406,142,8,13,5,46,131,12,81,0,0
1554,361,11,407,143,8,13,5,46,132,13,81,0,0
1555,362,14,408,146,8,13,5,46,132,14,81,0,0
1556,363,18,408,150,8,13,5,45,132,15,81,0,0
1557,363,23,407,150,8,13,5,44,127,16,81,0,0
1558,362,23,407,156,8,13,5,45,133,17,81,0,0
1559,362,28,406,159,8,13,5,44,131,18,81,0,0
1560,362,28,407,159,8,13,5,45,131,19,81,0,0
1561,362,37,405,163,8,13,5,43,126,20,81,0,0
1562,361,38,404,167,8,13,5,43,129,21,81,0,0
1563,361,36,404,169,8,13,5,43,133,22,81,0,0
1564,361,39,405,175,8,13,5,44,136,23,81,0,0
1565,362,45,406,180,8,13,5,44,135,24,81,0,0
1566,364,46,409,185,8,13,5,45,139,25,81,0,0
1567,364,50,409,189,8,13,5,45,139,26,81,0,0
1568,363,47,410,190,8,13,5,47,143,27,81,0,0
1569,362,48,409,192,8,13,5,47,144,28,81,0,0
1570,363,50,410,196,8,13,5,47,146,29,81,0,0
1571,365,48,414,199,8,13,5,49,151,30,81,0,0
1572,365,46,416,203,8,13,5,51,157,31,81,0,0
1573,364,39,419,210,8,13,5,55,171,32,81,0,0
1574,365,40,421,211,8,13,5,56,171,33,81,0,0
1575,364,40,421,217,8,13,5,57,177,34,81,0,0
1576,366,55,420,222,8,13,5,54,167,35,81,0,0
1577,368,60,422,223,8,13,5,54,163,36,81,0,0
1578,366,58,424,233,8,13,5,58,175,37,81,0,0
1579,365,66,423,241,8,13,5,58,175,38,81,0,0
1580,364,67,422,242,8,13,5,58,175,39,81,0,0
1581,364,76,423,253,8,13,5,59,177,40,81,0,0
1582,366,69,430,260,8,13,5,64,191,41,81,0,0
1583,368,67,434,264,8,13,5,66,197,42,81,0,0
1584,368,68,438,272,8,13,5,70,204,43,81,0,0
1585,367,73,439,281,8,13,5,72,208,44,81,0,0
1586,367,76,439,287,8,13,5,72,211,45,81,0,0
1587,368,73,443,295,8,13,5,75,222,46,81,0,0
1588,371,70,449,302,8,13,5,78,232,47,81,0,0
1589,372,71,453,308,8,13,5,81,237,48,81,0,0
1590,373,71,458,323,8,13,5,85,252,49,81,0,0
1591,375,71,462,328,8,13,5,87,257,50,81,0,0
1592,379,74,470,341,8,13,5,91,267,51,81,0,0
1593,383,81,475,353,8,13,5,92,272,52,81,0,0
1594,389,76,486,362,8,13,5,97,286,53,81,0,0
1595,388,75,492,378,8,13,5,104,303,54,81,0,0
1596,387,80,494,391,8,13,5,107,311,55,81,0,0
1597,393,78,505,400,8,13,5,112,322,56,81,0,0
1598,401,79,520,421,8,13,5,119,342,57,81,0,0
1599,406,89,525,438,8,13,5,119,349,58,81,0,0
1600,410,92,531,445,8,13,5,121,353,59,81,0,0
1601,410,94,543,477,8,13,5,133,383,60,81,0,0
1602,403,94,542,494,8,13,5,139,400,61,81,0,0
1603,399,100,540,507,8,13,5,141,407,62,81,0,0
1604,399,118,543,542,8,13,5,144,424,63,81,0,0
1605,401,127,546,558,8,13,5,145,431,64,81,0,0
1606,396,134,548,581,8,13,5,152,447,65,81,0,0
1607,388,149,548,616,8,13,5,160,467,66,81,0,0
1608,384,155,549,635,8,13,5,165,480,67,81,0,0
1609,381,173,551,664,8,13,5,170,491,68,81,0,0
1610,383,190,562,707,8,13,5,179,517,69,81,0,0
1611,382,190,571,734,8,13,5,189,544,70,81,0,0
1612,378,204,580,785,8,13,5,202,581,71,81,0,0
1613,362,222,575,833,8,13,5,213,611,72,81,0,0
1614,336,237,552,856,8,13,5,216,619,73,81,0,0
1615,296,263,528,930,8,13,5,232,667,74,81,0,0
1616,254,289,497,988,8,13,5,243,699,75,81,0,0
1617,212,306,456,1009,8,13,5,244,703,76,81,0,0
1618,156,339,412,1041,8,13,5,256,702,77,81,0,0
1619,85,370,346,1057,8,13,5,261,687,78,81,0,0
1620,12,406,263,1080,8,13,5,251,674,79,81,0,0
1621,23,653,197,1080,8,13,5,174,427,80,81,0,0
1622,3,692,171,1080,8,13,5,168,388,81,81,1,0
1847,683,826,909,1069,9,13,5,226,243,0,7,0,0
1848,575,677,934,1062,9,13,5,359,385,1,7,0,0
1849,481,569,937,1063,9,13,5,456,494,2,7,0,0
1850,382,475,917,1064,9,13,5,535,589,3,7,0,0
1851,295,391,895,1067,9,13,5,600,676,4,7,0,0
1852,247,326,889,1069,9,13,5,642,743,5,7,0,0
1853,224,279,851,1031,9,13,5,627,752,6,7,0,0
1854,168,215,846,1027,9,13,5,678,812,7,7,0,0
1854,389,248,594,896,10,13,5,205,648,0,50,0,1
1855,368,233,572,877,10,13,5,204,644,1,50,0,0
1856,358,205,545,796,10,13,5,187,591,2,50,0,0
1857,354,193,533,752,10,13,5,179,559,3,50,0,0
1858,353,180,517,689,10,13,5,164,509,4,50,0,0
1859,338,155,493,638,10,13,5,155,483,5,50,0,0
1860,330,145,480,614,10,13,5,150,469,6,50,0,0
1861,327,134,464,558,10,13,5,137,424,7,50,0,0
1862,325,123,459,532,10,13,5,134,409,8,50,0,0
1863,320,117,445,501,10,13,5,125,384,9,50,0,0
1864,317,108,433,465,10,13,5,116,357,10,50,0,0
1865,316,103,429,452,10,13,5,113,349,11,50,0,0
1866,312,90,421,426,10,13,5,109,336,12,50,0,0
1867,314,84,419,412,10,13,5,105,328,13,50,0,0
1868,315,82,413,386,10,13,5,98,304,14,50,0,0
1869,311,78,404,367,10,13,5,93,289,15,50,0,0
1870,310,78,398,356,10,13,5,88,278,16,50,0,0
1871,311,76,394,335,10,13,5,83,259,17,50,0,0
1872,309,73,391,326,10,13,5,82,253,18,50,0,0
1873,309,73,389,316,10,13,5,80,243,19,50,0,0
1874,305,64,383,302,10,13,5,78,238,20,50,0,0
1875,303,71,377,295,10,13,5,74,224,21,50,0,0
1876,300,63,371,280,10,13,5,71,217,22,50,0,0
1877,298,58,369,274,10,13,5,71,216,23,50,0,0
1878,298,58,368,269,10,13,5,70,211,24,50,0,0
1879,299,55,366,257,10,13,5,67,202,25,50,0,0
1880,300,58,362,245,10,13,5,62,187,26,50,0,0
1881,300,46,364,240,10,13,5,64,194,27,50,0,0
1882,299,35,364,234,10,13,5,65,199,28,50,0,0
1883,303,47,361,223,10,13,5,58,176,29,50,0,0
1884,303,39,361,217,10,13,5,58,178,30,50,0,0
1885,304,36,361,214,10,13,5,57,178,31,50,0,0
1886,306,33,361,207,10,13,5,55,174,32,50,0,0
1887,307,27,362,202,10,13,5,55,175,33,50,0,0
1888,310,23,364,198,10,13,5,54,175,34,50,0,0
1889,313,21,366,193,10,13,5,53,172,35,50,0,0
1890,315,17,368,191,10,13,5,53,174,36,50,0,0
1891,317,17,368,181,10,13,5,51,164,37,50,0,0
1892,319,15,369,176,10,13,5,50,161,38,50,0,0
1893,322,15,371,171,10,13,5,49,156,39,50,0,0
1894,324,11,373,168,10,13,5,49,157,40,50,0,0
1895,324,9,373,163,10,13,5,49,154,41,50,0,0
1896,324,11,370,157,10,13,5,46,146,42,50,0,0
1897,323,10,370,156,10,13,5,47,146,43,50,0,0
1898,324,7,371,154,10,13,5,47,147,44,50,0,0
1899,323,6,371,153,10,13,5,48,147,45,50,0,0
1900,323,8,370,152,10,13,5,47,144,46,50,0,0
1901,323,8,368,144,10,13,5,45,136,47,50,0,0
1902,323,8,367,142,10,13,5,44,134,48,50,0,0
1903,324,11,366,137,10,13,5,42,126,49,50,0,0
1904,325,11,365,132,10,13,5,40,121,50,50,1,0
2016,1863,437,1919,707,11,13,5,56,270,0,52,0,1
2017,1861,429,1919,710,11,13,5,58,281,1,52,0,0
2018,1848,407,1920,752,11,13,5,72,345,2,52,0,0
2019,1841,403,1918,775,11,13,5,77,372,3,52,0,0
2020,1825,382,1909,781,11,13,5,84,399,4,52,0,0
2021,1795,386,1886,789,11,13,5,91,403,5,52,0,0
2022,1782,376,1880,793,11,13,5,98,417,6,52,0,0
2023,1767,367,1878,821,11,13,5,111,454,7,52,0,0
2024,1735,376,1857,844,11,13,5,122,468,8,52,0,0
2025,1710,376,1842,857,11,13,5,132,481,9,52,0,0
2026,1654,380,1797,861,11,13,5,143,481,10,52,0,0
2027,1601,382,1757,867,11,13,5,156,485,11,52,0,0
2028,1563,375,1732,882,11,13,5,169,507,12,52,0,0
2029,1506,374,1691,903,11,13,5,185,529,13,52,0,0
2030,1455,380,1650,915,11,13,5,195,535,14,52,0,0
2031,1413,366,1618,923,11,13,5,205,557,15,52,0,0
2032,1330,369,1546,928,11,13,5,216,559,16,52,0,0
2033,1264,363,1487,928,11,13,5,223,565,17,52,0,0
2034,1217,349,1449,939,11,13,5,232,590,18,52,0,0
2035,1119,351,1358,938,11,13,5,239,587,19,52,0,0
2036,1044,350,1287,939,11,13,5,243,589,20,52,0,0
2037,993,342,1236,945,11,13,5,243,603,21,52,0,0
2038,913,331,1160,941,11,13,5,247,610,22,52,0,0
2039,863,310,1110,927,11,13,5,247,617,23,52,0,0
2040,807,302,1043,906,11,13,5,236,604,24,52,0,0
2041,731,294,970,888,11,13,5,239,594,25,52,0,0
2042,681,292,913,874,11,13,5,232,582,26,52,0,0
2043,633,287,860,874,11,13,5,227,587,27,52,0,0
2044,583,279,812,870,11,13,5,229,591,28,52,0,0
2045,555,267,786,867,11,13,5,231,600,29,52,0,0
2046,518,268,740,862,11,13,5,222,594,30,52,0,0
2047,494,270,711,868,11,13,5,217,598,31,52,0,0
2048,483,265,699,875,11,13,5,216,610,32,52,0,0
2049,481,276,690,877,11,13,5,209,601,33,52,0,0
2050,481,279,685,876,11,13,5,204,597,34,52,0,0
2051,483,290,679,874,11,13,5,196,584,35,52,0,0
2052,479,301,668,870,11,13,5,189,569,36,52,0,0
2053,461,314,652,882,11,13,5,191,568,37,52,0,0
2054,449,322,649,910,11,13,5,200,588,38,52,0,0
2055,428,323,637,926,11,13,5,209,603,39,52,0,0
2056,396,330,606,933,11,13,5,210,603,40,52,0,0
2057,370,344,590,973,11,13,5,220,629,41,52,0,0
2058,351,364,586,1034,11,13,5,235,670,42,52,0,0
2059,349,383,588,1061,11,13,5,239,678,43,52,0,0
2060,355,397,595,1070,11,13,5,240,673,44,52,0,0
2061,358,420,596,1075,11,13,5,238,655,45,52,0,0
2062,357,450,592,1076,11,13,5,235,626,46,52,0,0
2063,358,481,589,1072,11,13,5,231,591,47,52,0,0
2064,377,511,606,1073,11,13,5,229,562,48,52,0,0
2065,439,559,658,1071,11,13,5,219,512,49,52,0,0
2066,524,590,740,1071,11,13,5,216,481,50,52,0,0
2067,615,632,822,1074,11,13,5,207,442,51,52,0,0
2068,641,657,840,1080,11,13,5,199,423,52,52,1,0
2091,1560,364,1801,863,11,13,5,241,499,0,52,0,0
2092,1593,352,1834,855,11,13,5,241,503,1,52,0,0
2093,1622,327,1851,818,11,13,5,229,491,2,52,0,0
2094,1645,315,1854,765,11,13,5,209,450,3,52,0,0
2095,1661,302,1867,744,11,13,5,206,442,4,52,0,0
2096,1695,293,1887,704,11,13,5,192,411,5,52,0,0
2097,1722,290,1904,688,11,13,5,182,398,6,52,0,0
2098,1748,286,1915,659,11,13,5,167,373,7,52,0,0
2099,1764,285,1919,631,11,13,5,155,346,8,52,0,0
2100,1776,289,1920,613,11,13,5,144,324,9,52,0,0
2101,1799,291,1920,602,11,13,5,121,311,10,52,0,0
2102,1816,291,1920,593,11,13,5,104,302,11,52,0,0
2103,1833,290,1920,568,11,13,5,87,278,12,52,0,0
2104,1839,288,1920,553,11,13,5,81,265,13,52,0,0
2105,1856,350,1920,540,11,13,5,64,190,14,52,0,0
2106,1877,356,1920,524,11,13,5,43,168,15,52,0,0
2068,734,721,1021,1071,12,13,5,287,350,0,0,0,0
2069,902,758,1181,1072,13,13,5,279,314,0,0,0,0
2088,1312,445,1920,1067,17,13,5,608,622,0,3,0,0
2089,1331,400,1920,1013,17,13,5,589,613,1,3,0,0
2090,1350,376,1918,978,17,13,5,568,602,2,3,0,0
2091,1324,330,1920,969,17,13,5,596,639,3,3,0,0
2142,540,384,1215,1067,19,13,5,675,683,0,1,0,0
2143,451,338,1172,1067,19,13,5,721,729,1,1,0,0
2143,728,364,963,999,20,13,5,235,635,0,137,0,1
2144,696,331,934,976,20,13,5,238,645,1,137,0,0
2145,669,322,903,958,20,13,5,234,636,2,137,0,0
2146,644,284,865,888,20,13,5,221,604,3,137,0,0
2147,622,261,834,842,20,13,5,212,581,4,137,0,0
2148,596,252,803,820,20,13,5,207,568,5,137,0,0
2149,568,235,764,775,20,13,5,196,540,6,137,0,0
2150,536,219,728,753,20,13,5,192,534,7,137,0,0
2151,517,204,706,734,20,13,5,189,530,8,137,0,0
2152,512,192,686,687,20,13,5,174,495,9,137,0,0
2153,510,180,677,654,20,13,5,167,474,10,137,0,0
2154,499,179,659,638,20,13,5,160,459,11,137,0,0
2155,482,164,638,613,20,13,5,156,449,12,137,0,0
2156,471,158,620,590,20,13,5,149,432,13,137,0,0
2157,466,153,609,573,20,13,5,143,420,14,137,0,0
2158,465,137,602,542,20,13,5,137,405,15,137,0,0
2159,463,137,594,523,20,13,5,131,386,16,137,0,0
2160,453,129,581,508,20,13,5,128,379,17,137,0,0
2161,440,113,565,483,20,13,5,125,370,18,137,0,0
2162,432,114,554,474,20,13,5,122,360,19,137,0,0
2163,429,109,543,446,20,13,5,114,337,20,137,0,0
2164,425,103,535,430,20,13,5,110,327,21,137,0,0
2165,418,103,526,424,20,13,5,108,321,22,137,0,0
2166,406,97,512,412,20,13,5,106,315,23,137,0,0
2167,393,94,497,402,20,13,5,104,308,24,137,0,0
2168,385,95,485,398,20,13,5,100,303,25,137,0,0
2169,381,90,477,381,20,13,5,96,291,26,137,0,0
2170,377,88,470,372,20,13,5,93,284,27,137,0,0
2171,370,90,458,358,20,13,5,88,268,28,137,0,0
2172,359,86,445,345,20,13,5,86,259,29,137,0,0
2173,354,85,439,340,20,13,5,85,255,30,137,0,0
2174,354,81,435,325,20,13,5,81,244,31,137,0,0
2175,353,79,433,319,20,13,5,80,240,32,137,0,0
2176,349,73,429,317,20,13,5,80,244,33,137,0,0
2177,341,74,418,305,20,13,5,77,231,34,137,0,0
2178,337,74,412,298,20,13,5,75,224,35,137,0,0
2179,335,74,410,292,20,13,5,75,218,36,137,0,0
2180,334,69,408,283,20,13,5,74,214,37,137,0,0
2181,332,66,405,274,20,13,5,73,208,38,137,0,0
2182,327,65,400,273,20,13,5,73,208,39,137,0,0
2183,322,60,395,264,20,13,5,73,204,40,137,0,0
2184,319,60,391,260,20,13,5,72,200,41,137,0,0
2185,320,56,390,249,20,13,5,70,193,42,137,0,0
2186,324,55,394,246,20,13,5,70,191,43,137,0,0
2187,325,55,394,245,20,13,5,69,190,44,137,0,0
2188,318,53,387,239,20,13,5,69,186,45,137,0,0
2189,315,52,382,232,20,13,5,67,180,46,137,0,0
2190,314,49,380,226,20,13,5,66,177,47,137,0,0
2191,316,46,381,219,20,13,5,65,173,48,137,0,0
2192,316,46,381,217,20,13,5,65,171,49,137,0,0
2193,314,44,380,218,20,13,5,66,174,50,137,0,0
2194,312,43,378,219,20,13,5,66,176,51,137,0,0
2195,311,43,377,221,20,13,5,66,178,52,137,0,0
2196,311,42,375,220,20,13,5,64,178,53,137,0,0
2197,311,46,373,220,20,13,5,62,174,54,137,0,0
2198,315,49,374,219,20,13,5,59,170,55,137,0,0
2199,318,48,378,218,20,13,5,60,170,56,137,0,0
2200,325,52,384,218,20,13,5,59,166,57,137,0,0
2201,332,54,392,223,20,13,5,60,169,58,137,0,0
2202,338,53,401,226,20,13,5,63,173,59,137,0,0
2203,339,55,405,233,20,13,5,66,178,60,137,0,0
2204,336,56,405,239,20,13,5,69,183,61,137,0,0
2205,332,56,404,246,20,13,5,72,190,62,137,0,0
2206,329,58,403,256,20,13,5,74,198,63,137,0,0
2207,331,59,406,258,20,13,5,75,199,64,137,0,0
2208,332,63,407,259,20,13,5,75,196,65,137,0,0
2209,327,65,406,269,20,13,5,79,204,66,137,0,0
2210,322,66,403,276,20,13,5,81,210,67,137,0,0
2211,318,68,401,285,20,13,5,83,217,68,137,0,0
2212,321,72,403,290,20,13,5,82,218,69,137,0,0
2213,326,72,411,294,20,13,5,85,222,70,137,0,0
2214,332,72,418,299,20,13,5,86,227,71,137,0,0
2215,329,70,414,302,20,13,5,85,232,72,137,0,0
2216,324,72,409,308,20,13,5,85,236,73,137,0,0
2217,321,75,406,309,20,13,5,85,234,74,137,0,0
2218,320,76,403,310,20,13,5,83,234,75,137,0,0
2219,320,77,400,310,20,13,5,80,233,76,137,0,0
2220,320,75,398,311,20,13,5,78,236,77,137,0,0
2221,321,76,398,314,20,13,5,77,238,78,137,0,0
2222,323,77,398,311,20,13,5,75,234,79,137,0,0
2223,324,79,397,311,20,13,5,73,232,80,137,0,0
2224,324,80,396,311,20,13,5,72,231,81,137,0,0
2225,323,79,394,311,20,13,5,71,232,82,137,0,0
2226,321,79,390,307,20,13,5,69,228,83,137,0,0
2227,322,78,391,303,20,13,5,69,225,84,137,0,0
2228,324,79,391,295,20,13,5,67,216,85,137,0,0
2229,327,81,394,293,20,13,5,67,212,86,137,0,0
2230,329,75,396,284,20,13,5,67,209,87,137,0,0
2231,330,71,399,284,20,13,5,69,213,88,137,0,0
2232,329,68,400,282,20,13,5,71,214,89,137,0,0
2233,326,70,395,280,20,13,5,69,210,90,137,0,0
2234,322,74,390,280,20,13,5,68,206,91,137,0,0
2235,320,78,385,278,20,13,5,65,200,92,137,0,0
2236,319,76,385,279,20,13,5,66,203,93,137,0,0
2237,319,78,383,280,20,13,5,64,202,94,137,0,0
2238,318,78,382,282,20,13,5,64,204,95,137,0,0
2239,317,79,381,283,20,13,5,64,204,96,137,0,0
2240,317,78,381,283,20,13,5,64,205,97,137,0,0
2241,318,82,379,277,20,13,5,61,195,98,137,0,0
2242,318,83,379,276,20,13,5,61,193,99,137,0,0
2243,317,79,381,278,20,13,5,64,199,100,137,0,0
2244,319,75,384,276,20,13,5,65,201,101,137,0,0
2245,323,73,388,275,20,13,5,65,202,102,137,0,0
2246,329,65,397,273,20,13,5,68,208,103,137,0,0
2247,337,61,407,270,20,13,5,70,209,104,137,0,0
2248,342,62,411,267,20,13,5,69,205,105,137,0,0
2249,342,61,412,263,20,13,5,70,202,106,137,0,0
2250,341,59,409,254,20,13,5,68,195,107,137,0,0
2251,345,64,409,245,20,13,5,64,181,108,137,0,0
2252,347,58,412,239,20,13,5,65,181,109,137,0,0
2253,350,59,414,237,20,13,5,64,178,110,137,0,0
2254,349,57,414,234,20,13,5,65,177,111,137,0,0
2255,345,50,409,224,20,13,5,64,174,112,137,0,0
2256,342,48,406,219,20,13,5,64,171,113,137,0,0
2257,343,48,405,214,20,13,5,62,166,114,137,0,0
2258,345,48,407,210,20,13,5,62,162,115,137,0,0
2259,346,48,406,208,20,13,5,60,160,116,137,0,0
2260,343,41,404,204,20,13,5,61,163,117,137,0,0
2261,340,38,401,200,20,13,5,61,162,118,137,0,0
2262,339,37,399,196,20,13,5,60,159,119,137,0,0
2263,343,39,400,189,20,13,5,57,150,120,137,0,0
2264,347,41,401,185,20,13,5,54,144,121,137,0,0
2265,344,36,400,184,20,13,5,56,148,122,137,0,0
2266,340,32,396,180,20,13,5,56,148,123,137,0,0
2267,337,30,393,178,20,13,5,56,148,124,137,0,0
2268,337,26,393,173,20,13,5,56,147,125,137,0,0
2269,337,26,393,172,20,13,5,56,146,126,137,0,0
2270,335,20,392,171,20,13,5,57,151,127,137,0,0
2271,333,19,388,167,20,13,5,55,148,128,137,0,0
2272,334,22,386,162,20,13,5,52,140,129,137,0,0
2273,335,21,387,159,20,13,5,52,138,130,137,0,0
2274,340,25,389,159,20,13,5,49,134,131,137,0,0
2275,344,23,393,157,20,13,5,49,134,132,137,0,0
2276,349,30,394,154,20,13,5,45,124,133,137,0,0
2277,354,39,395,151,20,13,5,41,112,134,137,0,0
2278,359,30,402,148,20,13,5,43,118,135,137,0,0
2279,364,37,403,143,20,13,5,39,106,136,137,0,0
2280,366,38,404,139,20,13,5,38,101,137,137,1,0
2282,370,29,411,141,20,13,5,41,112,0,137,0,0
2283,372,28,413,139,20,13,5,41,111,1,137,0,0
2293,355,10,394,119,20,13,5,39,109,0,137,0,0
2294,354,9,394,120,20,13,5,40,111,1,137,0,0
2295,354,8,393,118,20,13,5,39,110,2,137,0,0
2180,1830,437,1920,738,21,13,5,90,301,0,51,0,1
2181,1825,410,1920,738,21,13,5,95,328,1,51,0,0
2182,1819,392,1920,758,21,13,5,101,366,2,51,0,0
2183,1807,361,1920,778,21,13,5,113,417,3,51,0,0
2184,1804,348,1920,780,21,13,5,116,432,4,51,0,0
2185,1796,340,1920,781,21,13,5,124,441,5,51,0,0
2186,1775,337,1909,787,21,13,5,134,450,6,51,0,0
2187,1756,335,1895,787,21,13,5,139,452,7,51,0,0
2188,1749,339,1890,784,21,13,5,141,445,8,51,0,0
2189,1741,335,1887,785,21,13,5,146,450,9,51,0,0
2190,1730,330,1886,804,21,13,5,156,474,10,51,0,0
2191,1713,339,1876,823,21,13,5,163,484,11,51,0,0
2192,1696,348,1863,832,21,13,5,167,484,12,51,0,0
2193,1685,351,1854,833,21,13,5,169,482,13,51,0,0
2194,1651,355,1828,834,21,13,5,177,479,14,51,0,0
2195,1624,355,1810,837,21,13,5,186,482,15,51,0,0
2196,1599,351,1797,847,21,13,5,198,496,16,51,0,0
2197,1579,353,1784,858,21,13,5,205,505,17,51,0,0
2198,1565,347,1784,885,21,13,5,219,538,18,51,0,0
2199,1547,350,1774,908,21,13,5,227,558,19,51,0,0
2200,1536,355,1767,922,21,13,5,231,567,20,51,0,0
2201,1516,360,1753,928,21,13,5,237,568,21,51,0,0
2202,1481,369,1728,937,21,13,5,247,568,22,51,0,0
2203,1451,374,1708,949,21,13,5,257,575,23,51,0,0
2204,1427,378,1689,959,21,13,5,262,581,24,51,0,0
2205,1410,377,1679,971,21,13,5,269,594,25,51,0,0
2206,1384,375,1666,996,21,13,5,282,621,26,51,0,0
2207,1352,387,1640,1017,21,13,5,288,630,27,51,0,0
2208,1324,393,1617,1035,21,13,5,293,642,28,51,0,0
2209,1299,391,1597,1043,21,13,5,298,652,29,51,0,0
2210,1238,395,1544,1051,21,13,5,306,656,30,51,0,0
2211,1159,396,1481,1068,21,13,5,322,672,31,51,0,0
2212,1109,396,1436,1074,21,13,5,327,678,32,51,0,0
2213,1068,399,1396,1078,21,13,5,328,679,33,51,0,0
2214,1025,413,1348,1078,21,13,5,323,665,34,51,0,0
2215,984,416,1306,1078,21,13,5,322,662,35,51,0,0
2216,939,423,1260,1076,21,13,5,321,653,36,51,0,0
2217,889,442,1206,1075,21,13,5,317,633,37,51,0,0
2218,834,457,1149,1074,21,13,5,315,617,38,51,0,0
2219,761,463,1082,1075,21,13,5,321,612,39,51,0,0
2220,679,469,1007,1078,21,13,5,328,609,40,51,0,0
2221,615,491,940,1076,21,13,5,325,585,41,51,0,0
2222,554,512,876,1072,21,13,5,322,560,42,51,0,0
2223,475,526,796,1074,21,13,5,321,548,43,51,0,0
2224,410,538,727,1075,21,13,5,317,537,44,51,0,0
2225,332,555,640,1073,21,13,5,308,518,45,51,0,0
2226,249,569,551,1071,21,13,5,302,502,46,51,0,0
2227,152,578,451,1073,21,13,5,299,495,47,51,0,0
2228,73,584,373,1075,21,13,5,300,491,48,51,0,0
2229,2,597,294,1079,21,13,5,292,482,49,51,0,0
2230,0,628,222,1080,21,13,5,222,452,50,51,0,0
2231,0,641,151,1080,21,13,5,151,439,51,51,1,0
2307,1748,860,1919,1077,22,13,5,171,217,0,0,0,0
2312,1314,456,1920,1068,23,13,5,606,612,0,12,0,0
2313,1323,421,1920,1057,23,13,5,597,636,1,12,0,0
2314,1357,390,1920,1003,23,13,5,563,613,2,12,0,0
2315,1402,381,1920,960,23,13,5,518,579,3,12,0,0
2316,1462,361,1920,898,23,13,5,458,537,4,12,0,0
2317,1515,346,1920,875,23,13,5,405,529,5,12,0,0
2318,1560,335,1920,845,23,13,5,360,510,6,12,0,0
2319,1614,318,1920,794,23,13,5,306,476,7,12,0,0
2320,1643,319,1920,769,23,13,5,277,450,8,12,0,0
2321,1677,328,1920,736,23,13,5,243,408,9,12,0,0
2322,1718,335,1920,718,23,13,5,202,383,10,12,0,0
2323,1744,345,1920,707,23,13,5,176,362,11,12,0,0
2324,1764,334,1920,684,23,13,5,156,350,12,12,0,0
2324,1846,329,1918,660,24,13,5,72,331,0,3,0,0
2325,1850,340,1917,648,24,13,5,67,308,1,3,0,0
2326,1853,377,1910,637,24,13,5,57,260,2,3,0,0
2327,1855,395,1907,631,24,13,5,52,236,3,3,0,0
2523,1864,432,1917,652,26,13,5,53,220,0,30,0,1
2524,1862,427,1917,658,26,13,5,55,231,1,30,0,0
2525,1853,381,1920,687,26,13,5,67,306,2,30,0,0
2526,1840,366,1920,709,26,13,5,80,343,3,30,0,0
2527,1835,358,1920,714,26,13,5,85,356,4,30,0,0
2528,1806,354,1899,726,26,13,5,93,372,5,30,0,0
2529,1786,340,1889,734,26,13,5,103,394,6,30,0,0
2530,1773,328,1887,752,26,13,5,114,424,7,30,0,0
2531,1744,327,1873,781,26,13,5,129,454,8,30,0,0
2532,1721,331,1859,799,26,13,5,138,468,9,30,0,0
2533,1671,338,1820,803,26,13,5,149,465,10,30,0,0
2534,1623,348,1784,822,26,13,5,161,474,11,30,0,0
2535,1588,337,1763,834,26,13,5,175,497,12,30,0,0
2536,1546,345,1738,873,26,13,5,192,528,13,30,0,0
2537,1501,354,1706,900,26,13,5,205,546,14,30,0,0
2538,1454,356,1670,912,26,13,5,216,556,15,30,0,0
2539,1375,372,1609,941,26,13,5,234,569,16,30,0,0
2540,1322,373,1568,958,26,13,5,246,585,17,30,0,0
2541,1270,381,1540,1022,26,13,5,270,641,18,30,0,0
2542,1198,404,1480,1062,26,13,5,282,658,19,30,0,0
2543,1143,416,1428,1079,26,13,5,285,663,20,30,0,0
2544,1042,432,1332,1080,26,13,5,290,648,21,30,0,0
2545,960,449,1243,1078,26,13,5,283,629,22,30,0,0
2546,859,456,1140,1080,26,13,5,281,624,23,30,0,0
2547,745,496,1014,1080,26,13,5,269,584,24,30,0,0
2548,606,518,867,1080,26,13,5,261,562,25,30,0,0
2549,441,531,704,1080,26,13,5,263,549,26,30,0,0
2550,277,555,540,1080,26,13,5,263,525,27,30,0,0
2551,104,558,373,1076,26,13,5,269,518,28,30,0,0
2552,4,599,254,1080,26,13,5,250,481,29,30,0,0
2553,0,613,152,1080,26,13,5,152,467,30,30,1,0
2747,1675,803,1920,1076,27,13,5,245,273,0,16,0,0
2748,1556,730,1869,1079,27,13,5,313,349,1,16,0,0
2749,1441,644,1824,1070,27,13,5,383,426,2,16,0,0
2750,1382,571,1828,1069,27,13,5,446,498,3,16,0,0
2751,1361,521,1847,1069,27,13,5,486,548,4,16,0,0
2752,1389,468,1881,1034,27,13,5,492,566,5,16,0,0
2753,1416,436,1906,1010,27,13,5,490,574,6,16,0,0
2754,1482,403,1919,929,27,13,5,437,526,7,16,0,0
2755,1525,387,1920,884,27,13,5,395,497,8,16,0,0
2756,1571,377,1920,836,27,13,5,349,459,9,16,0,0
2757,1618,358,1920,800,27,13,5,302,442,10,16,0,0
2758,1645,355,1920,790,27,13,5,275,435,11,16,0,0
2759,1696,339,1920,730,27,13,5,224,391,12,16,0,0
2760,1718,335,1920,706,27,13,5,202,371,13,16,0,0
2761,1758,355,1920,673,27,13,5,162,318,14,16,0,0
2762,1781,355,1920,658,27,13,5,139,303,15,16,0,0
2763,1795,339,1920,632,27,13,5,125,293,16,16,0,0
2765,1870,439,1919,617,28,13,5,49,178,0,0,0,0
3182,1,720,120,1080,29,13,5,119,360,0,1,0,0
3183,61,680,195,1079,29,13,5,134,399,1,1,0,0
3184,111,663,415,1072,30,13,5,304,409,0,0,0,0
3185,327,650,606,1073,31,13,5,279,423,0,30,0,1
3186,443,614,745,1072,31,13,5,302,458,1,30,0,0
3187,591,612,895,1071,31,13,5,304,459,2,30,0,0
3188,740,584,1064,1069,31,13,5,324,485,3,30,0,0
3189,839,539,1192,1071,31,13,5,353,532,4,30,0,0
3190,937,520,1295,1067,31,13,5,358,547,5,30,0,0
3191,1037,487,1410,1066,31,13,5,373,579,6,30,0,0
3192,1112,469,1495,1068,31,13,5,383,599,7,30,0,0
3193,1162,473,1547,1074,31,13,5,385,601,8,30,0,0
3194,1232,470,1619,1074,31,13,5,387,604,9,30,0,0
3195,1324,454,1709,1068,31,13,5,385,614,10,30,0,0
3196,1369,458,1747,1064,31,13,5,378,606,11,30,0,0
3197,1439,437,1788,1006,31,13,5,349,569,12,30,0,0
3198,1475,419,1809,970,31,13,5,334,551,13,30,0,0
3199,1497,416,1824,955,31,13,5,327,539,14,30,0,0
3200,1548,409,1851,907,31,13,5,303,498,15,30,0,0
3201,1597,389,1893,887,31,13,5,296,498,16,30,0,0
3202,1622,390,1909,877,31,13,5,287,487,17,30,0,0
3203,1658,378,1920,842,31,13,5,262,464,18,30,0,0
3204,1679,364,1920,808,31,13,5,241,444,19,30,0,0
3205,1690,372,1920,798,31,13,5,230,426,20,30,0,0
3206,1710,358,1920,768,31,13,5,210,410,21,30,0,0
3207,1741,366,1920,745,31,13,5,179,379,22,30,0,0
3208,1754,368,1920,741,31,13,5,166,373,23,30,0,0
3209,1774,351,1920,704,31,13,5,146,353,24,30,0,0
3210,1783,350,1920,684,31,13,5,137,334,25,30,0,0
3211,1787,353,1920,675,31,13,5,133,322,26,30,0,0
3212,1799,348,1920,659,31,13,5,121,311,27,30,0,0
3213,1821,347,1920,650,31,13,5,99,303,28,30,0,0
3214,1830,360,1920,651,31,13,5,90,291,29,30,0,0
3215,1849,358,1920,637,31,13,5,71,279,30,30,1,0
3813,1136,861,1344,1074,32,13,5,208,213,0,36,0,1
3814,986,759,1294,1072,32,13,5,308,313,1,36,0,0
3815,936,671,1327,1069,32,13,5,391,398,2,36,0,0
3816,902,582,1374,1068,32,13,5,472,486,3,36,0,0
3817,885,517,1411,1068,32,13,5,526,551,4,36,0,0
3818,889,451,1463,1068,32,13,5,574,617,5,36,0,0
3819,910,408,1503,1066,32,13,5,593,658,6,36,0,0
3820,941,378,1542,1067,32,13,5,601,689,7,36,0,0
3821,999,346,1603,1063,32,13,5,604,717,8,36,0,0
3822,1044,327,1642,1065,32,13,5,598,738,9,36,0,0
3823,1083,311,1666,1060,32,13,5,583,749,10,36,0,0
3824,1152,333,1681,1038,32,13,5,529,705,11,36,0,0
3825,1200,342,1693,1027,32,13,5,493,685,12,36,0,0
3826,1256,304,1722,979,32,13,5,466,675,13,36,0,0
3827,1317,302,1729,921,32,13,5,412,619,14,36,0,0
3828,1362,278,1729,850,32,13,5,367,572,15,36,0,0
3829,1439,298,1771,832,32,13,5,332,534,16,36,0,0
3830,1495,334,1791,822,32,13,5,296,488,17,36,0,0
3831,1554,341,1818,790,32,13,5,264,449,18,36,0,0
3832,1592,345,1838,771,32,13,5,246,426,19,36,0,0
3833,1600,286,1816,671,32,13,5,216,385,20,36,0,0
3834,1611,268,1808,628,32,13,5,197,360,21,36,0,0
3835,1632,252,1810,587,32,13,5,178,335,22,36,0,0
3836,1647,248,1814,569,32,13,5,167,321,23,36,0,0
3837,1662,252,1820,556,32,13,5,158,304,24,36,0,0
3838,1692,249,1844,550,32,13,5,152,301,25,36,0,0
3839,1719,248,1864,539,32,13,5,145,291,26,36,0,0
3840,1731,245,1877,542,32,13,5,146,297,27,36,0,0
3841,1759,246,1891,524,32,13,5,132,278,28,36,0,0
3842,1771,248,1901,526,32,13,5,130,278,29,36,0,0
3843,1783,255,1909,525,32,13,5,126,270,30,36,0,0
3844,1805,258,1920,517,32,13,5,115,259,31,36,0,0
3845,1823,261,1920,510,32,13,5,97,249,32,36,0,0
3846,1836,257,1920,505,32,13,5,84,248,33,36,0,0
3847,1846,257,1920,500,32,13,5,74,243,34,36,0,0
3848,1852,262,1920,500,32,13,5,68,238,35,36,0,0
3849,1866,261,1920,491,32,13,5,54,230,36,36,1,0
3823,1430,551,1920,1066,33,13,5,490,515,0,8,0,0
3824,1474,535,1920,1054,33,13,5,446,519,1,8,0,0
3825,1487,497,1920,1056,33,13,5,433,559,2,8,0,0
3826,1503,478,1920,1055,33,13,5,417,577,3,8,0,0
3827,1519,476,1920,1053,33,13,5,401,577,4,8,0,0
3828,1547,467,1920,1025,33,13,5,373,558,5,8,0,0
3829,1594,444,1920,983,33,13,5,326,539,6,8,0,0
3830,1625,435,1920,965,33,13,5,295,530,7,8,0,0
3831,1618,408,1920,956,33,13,5,302,548,8,8,0,0
3831,1521,285,1719,648,35,13,5,198,363,0,0,0,0
3831,1795,427,1919,908,36,13,5,124,481,0,6,0,0
3832,1803,456,1909,863,36,13,5,106,407,1,6,0,0
3833,1800,466,1901,850,36,13,5,101,384,2,6,0,0
3834,1821,461,1911,801,36,13,5,90,340,3,6,0,0
3835,1843,502,1915,773,36,13,5,72,271,4,6,0,0
3836,1850,515,1918,771,36,13,5,68,256,5,6,0,0
3837,1861,530,1920,753,36,13,5,59,223,6,6,0,0
3834,1711,354,1884,749,37,13,5,173,395,0,10,0,0
3835,1733,352,1897,725,37,13,5,164,373,1,10,0,0
3836,1760,340,1914,694,37,13,5,154,354,2,10,0,0
3837,1771,339,1920,692,37,13,5,149,353,3,10,0,0
3838,1784,342,1920,677,37,13,5,136,335,4,10,0,0
3839,1799,353,1920,662,37,13,5,121,309,5,10,0,0
3840,1816,358,1920,647,37,13,5,104,289,6,10,0,0
3841,1825,354,1920,636,37,13,5,95,282,7,10,0,0
3842,1841,373,1920,621,37,13,5,79,248,8,10,0,0
3843,1853,390,1920,600,37,13,5,67,210,9,10,0,0
3844,1865,397,1920,585,37,13,5,55,188,10,10,0,0
4041,1273,300,1844,887,39,13,5,571,587,0,15,0,0
4042,1354,285,1861,830,39,13,5,507,545,1,15,0,0
4043,1405,280,1859,788,39,13,5,454,508,2,15,0,0
4044,1451,283,1868,765,39,13,5,417,482,3,15,0,0
4045,1512,279,1891,737,39,13,5,379,458,4,15,0,0
4046,1557,272,1920,729,39,13,5,363,457,5,15,0,0
4047,1605,264,1920,705,39,13,5,315,441,6,15,0,0
4048,1638,261,1920,672,39,13,5,282,411,7,15,0,0
4049,1666,273,1920,655,39,13,5,254,382,8,15,0,0
4050,1703,273,1920,636,39,13,5,217,363,9,15,0,0
4051,1739,298,1920,626,39,13,5,181,328,10,15,0,0
4052,1761,305,1920,612,39,13,5,159,307,11,15,0,0
4053,1786,296,1920,590,39,13,5,134,294,12,15,0,0
4054,1798,302,1920,583,39,13,5,122,281,13,15,0,0
4055,1814,315,1920,569,39,13,5,106,254,14,15,0,0
4056,1834,315,1920,552,39,13,5,86,237,15,15,0,0
4031,1790,894,1920,1076,40,13,5,130,182,0,0,0,0
4036,1458,576,1920,1074,41,13,5,462,498,0,6,0,0
4037,1463,525,1920,1071,41,13,5,457,546,1,6,0,0
4038,1467,495,1920,1064,41,13,5,453,569,2,6,0,0
4039,1495,481,1920,1042,41,13,5,425,561,3,6,0,0
4040,1554,455,1920,981,41,13,5,366,526,4,6,0,0
4041,1591,442,1920,963,41,13,5,329,521,5,6,0,0
4042,1589,411,1920,953,41,13,5,331,542,6,6,0,0
4042,1771,485,1920,918,42,13,5,149,433,0,4,0,0
4043,1785,478,1920,875,42,13,5,135,397,1,4,0,0
4044,1793,457,1920,856,42,13,5,127,399,2,4,0,0
4045,1822,501,1920,810,42,13,5,98,309,3,4,0,0
4046,1836,512,1920,784,42,13,5,84,272,4,4,0,0
4056,1860,334,1920,561,42,13,5,60,227,0,4,0,0
4057,1870,345,1920,546,42,13,5,50,201,1,4,0,0
4058,1874,333,1920,524,42,13,5,46,191,2,4,0,0
4046,1872,644,1919,801,43,13,5,47,157,0,0,0,0
4475,1,993,72,1080,44,13,5,71,87,0,0,0,0
4476,0,797,116,1080,45,13,5,116,283,0,59,0,1
4477,13,635,192,1072,45,13,5,179,437,1,59,0,0
4478,25,443,282,1068,45,13,5,257,625,2,59,0,0
4479,54,332,350,1054,45,13,5,296,722,3,59,0,0
4480,135,273,440,1013,45,13,5,305,740,4,59,0,0
4481,209,239,506,960,45,13,5,297,721,5,59,0,0
4482,260,209,543,902,45,13,5,283,693,6,59,0,0
4483,306,189,587,879,45,13,5,281,690,7,59,0,0
4484,335,168,598,820,45,13,5,263,652,8,59,0,0
4485,349,156,588,758,45,13,5,239,602,9,59,0,0
4486,355,149,582,729,45,13,5,227,580,10,59,0,0
4487,366,138,571,670,45,13,5,205,532,11,59,0,0
4488,364,129,557,639,45,13,5,193,510,12,59,0,0
4489,359,127,541,618,45,13,5,182,491,13,59,0,0
4490,351,115,519,578,45,13,5,168,463,14,59,0,0
4491,349,113,508,560,45,13,5,159,447,15,59,0,0
4492,351,105,498,529,45,13,5,147,424,16,59,0,0
4493,354,95,492,499,45,13,5,138,404,17,59,0,0
4494,355,94,486,486,45,13,5,131,392,18,59,0,0
4495,352,87,473,454,45,13,5,121,367,19,59,0,0
4496,349,84,464,440,45,13,5,115,356,20,59,0,0
4497,350,80,461,431,45,13,5,111,351,21,59,0,0
4498,355,75,459,408,45,13,5,104,333,22,59,0,0
4499,360,75,459,393,45,13,5,99,318,23,59,0,0
4500,362,76,454,374,45,13,5,92,298,24,59,0,0
4501,367,79,453,359,45,13,5,86,280,25,59,0,0
4502,370,75,454,352,45,13,5,84,277,26,59,0,0
4503,379,68,459,327,45,13,5,80,259,27,59,0,0
4504,383,68,460,317,45,13,5,77,249,28,59,0,0
4505,382,68,458,310,45,13,5,76,242,29,59,0,0
4506,381,69,455,302,45,13,5,74,233,30,59,0,0
4507,378,69,451,298,45,13,5,73,229,31,59,0,0
4508,380,74,447,287,45,13,5,67,213,32,59,0,0
4509,379,69,446,281,45,13,5,67,212,33,59,0,0
4510,373,58,441,274,45,13,5,68,216,34,59,0,0
4511,364,43,433,264,45,13,5,69,221,35,59,0,0
4512,361,51,424,256,45,13,5,63,205,36,59,0,0
4513,357,54,417,250,45,13,5,60,196,37,59,0,0
4514,353,50,412,244,45,13,5,59,194,38,59,0,0
4515,351,53,406,239,45,13,5,55,186,39,59,0,0
4516,345,40,401,229,45,13,5,56,189,40,59,0,0
4517,340,28,397,223,45,13,5,57,195,41,59,0,0
4518,337,23,393,214,45,13,5,56,191,42,59,0,0
4519,334,19,391,217,45,13,5,57,198,43,59,0,0
4520,336,21,390,211,45,13,5,54,190,44,59,0,0
4521,336,20,389,207,45,13,5,53,187,45,59,0,0
4522,334,18,386,200,45,13,5,52,182,46,59,0,0
4523,332,15,383,194,45,13,5,51,179,47,59,0,0
4524,333,12,383,190,45,13,5,50,178,48,59,0,0
4525,336,10,384,186,45,13,5,48,176,49,59,0,0
4526,336,17,383,184,45,13,5,47,167,50,59,0,0
4527,332,14,378,181,45,13,5,46,167,51,59,0,0
4528,329,12,375,178,45,13,5,46,166,52,59,0,0
4529,329,12,373,172,45,13,5,44,160,53,59,0,0
4530,328,10,372,167,45,13,5,44,157,54,59,0,0
4531,327,13,370,165,45,13,5,43,152,55,59,0,0
4532,328,14,370,160,45,13,5,42,146,56,59,0,0
4533,326,13,368,159,45,13,5,42,146,57,59,0,0
4534,326,12,368,158,45,13,5,42,146,58,59,0,0
4535,325,11,366,154,45,13,5,41,143,59,59,1,0
4543,321,5,358,132,45,13,5,37,127,0,59,0,0
4544,321,5,356,129,45,13,5,35,124,1,59,0,0
4612,927,167,1024,365,46,13,5,97,198,0,0,0,0
4615,927,167,1023,363,47,13,5,96,196,0,0,0,0
5401,1620,790,1825,1077,49,13,5,205,287,0,0,0,0
5407,1280,416,1896,1046,50,13,5,616,630,0,13,0,0
5408,1327,397,1905,1001,50,13,5,578,604,1,13,0,0
5409,1404,366,1920,951,50,13,5,516,585,2,13,0,0
5410,1451,352,1920,925,50,13,5,469,573,3,13,0,0
5411,1509,332,1920,870,50,13,5,411,538,4,13,0,0
5412,1548,332,1920,835,50,13,5,372,503,5,13,0,0
5413,1596,334,1920,796,50,13,5,324,462,6,13,0,0
5414,1642,318,1920,776,50,13,5,278,458,7,13,0,0
5415,1669,310,1920,766,50,13,5,251,456,8,13,0,0
5416,1705,305,1920,731,50,13,5,215,426,9,13,0,0
5417,1731,331,1920,706,50,13,5,189,375,10,13,0,0
5418,1760,343,1920,679,50,13,5,160,336,11,13,0,0
5419,1785,344,1920,667,50,13,5,135,323,12,13,0,0
5420,1808,338,1920,644,50,13,5,112,306,13,13,0,0
5420,1865,346,1920,654,51,13,5,55,308,0,0,0,0
5528,320,6,360,125,52,13,5,40,119,0,36,0,1
5529,321,5,360,123,52,13,5,39,118,1,36,0,0
5530,321,6,362,127,52,13,5,41,121,2,36,0,0
5531,321,4,363,129,52,13,5,42,125,3,36,0,0
5532,321,4,363,131,52,13,5,42,127,4,36,0,0
5533,322,9,364,134,52,13,5,42,125,5,36,0,0
5534,322,8,366,139,52,13,5,44,131,6,36,0,0
5535,321,11,366,145,52,13,5,45,134,7,36,0,0
5536,321,11,366,147,52,13,5,45,136,8,36,0,0
5537,321,14,367,152,52,13,5,46,138,9,36,0,0
5538,320,12,368,155,52,13,5,48,143,10,36,0,0
5539,320,12,368,158,52,13,5,48,146,11,36,0,0
5540,319,15,367,162,52,13,5,48,147,12,36,0,0
5541,316,13,367,165,52,13,5,51,152,13,36,0,0
5542,316,12,366,168,52,13,5,50,156,14,36,0,0
5543,315,13,366,173,52,13,5,51,160,15,36,0,0
5544,314,15,365,178,52,13,5,51,163,16,36,0,0
5545,313,20,363,182,52,13,5,50,162,17,36,0,0
5546,312,15,364,186,52,13,5,52,171,18,36,0,0
5547,310,13,365,194,52,13,5,55,181,19,36,0,0
5548,310,18,364,198,52,13,5,54,180,20,36,0,0
5549,311,20,365,204,52,13,5,54,184,21,36,0,0
5550,310,21,365,208,52,13,5,55,187,22,36,0,0
5552,304,32,359,223,52,13,5,55,191,0,36,0,1
5553,303,41,356,228,52,13,5,53,187,1,36,0,0
5554,300,35,357,234,52,13,5,57,199,2,36,0,0
5555,300,51,354,242,52,13,5,54,191,3,36,0,0
5556,299,54,354,247,52,13,5,55,193,4,36,0,0
5557,298,57,355,259,52,13,5,57,202,5,36,0,0
5558,297,54,357,267,52,13,5,60,213,6,36,0,0
5559,299,62,358,276,52,13,5,59,214,7,36,0,0
5560,299,63,362,286,52,13,5,63,223,8,36,0,0
5561,300,66,364,289,52,13,5,64,223,9,36,0,0
5562,304,68,371,298,52,13,5,67,230,10,36,0,0
5563,307,64,378,308,52,13,5,71,244,11,36,0,0
5564,307,58,384,320,52,13,5,77,262,12,36,0,0
5565,311,56,393,334,52,13,5,82,278,13,36,0,0
5566,318,63,400,341,52,13,5,82,278,14,36,0,0
5567,325,69,412,361,52,13,5,87,292,15,36,0,0
5568,336,72,423,370,52,13,5,87,298,16,36,0,0
5569,342,76,434,390,52,13,5,92,314,17,36,0,0
5570,346,79,442,412,52,13,5,96,333,18,36,0,0
5571,350,80,450,422,52,13,5,100,342,19,36,0,0
5572,353,88,457,452,52,13,5,104,364,20,36,0,0
5573,356,91,464,469,52,13,5,108,378,21,36,0,0
5574,356,98,472,508,52,13,5,116,410,22,36,0,0
5575,357,110,477,535,52,13,5,120,425,23,36,0,0
5576,357,114,480,548,52,13,5,123,434,24,36,0,0
5577,355,130,486,593,52,13,5,131,463,25,36,0,0
5578,354,139,490,621,52,13,5,136,482,26,36,0,0
5579,353,150,499,668,52,13,5,146,518,27,36,0,0
5580,348,174,502,712,52,13,5,154,538,28,36,0,0
5581,334,185,499,756,52,13,5,165,571,29,36,0,0
5582,318,217,502,852,52,13,5,184,635,30,36,0,0
5583,297,236,489,894,52,13,5,192,658,31,36,0,0
5584,265,275,475,974,52,13,5,210,699,32,36,0,0
5585,210,315,438,1034,52,13,5,228,719,33,36,0,0
5586,121,346,360,1074,52,13,5,239,728,34,36,0,0
5587,77,428,307,1080,52,13,5,230,652,35,36,0,0
5588,62,448,296,1080,52,13,5,234,632,36,36,1,0
5990,1849,673,1918,796,53,13,5,69,123,0,5,0,0
5991,1809,564,1920,817,53,13,5,111,253,1,5,0,0
5992,1794,512,1920,826,53,13,5,126,314,2,5,0,0
5993,1764,466,1920,871,53,13,5,156,405,3,5,0,0
5994,1747,451,1920,894,53,13,5,173,443,4,5,0,0
5995,1726,456,1920,904,53,13,5,194,448,5,5,0,0
713,243,204,296,547,1,13,6,53,343,0,25,0,1
714,247,191,300,537,1,13,6,53,346,1,25,0,0
715,261,201,318,559,1,13,6,57,358,2,25,0,0
716,282,209,342,577,1,13,6,60,368,3,25,0,0
717,317,214,380,586,1,13,6,63,372,4,25,0,0
718,357,223,429,611,1,13,6,72,388,5,25,0,0
719,385,217,461,616,1,13,6,76,399,6,25,0,0
720,406,223,491,644,1,13,6,85,421,7,25,0,0
721,430,231,523,671,1,13,6,93,440,8,25,0,0
722,468,235,564,680,1,13,6,96,445,9,25,0,0
723,514,248,620,709,1,13,6,106,461,10,25,0,0
724,540,257,653,730,1,13,6,113,473,11,25,0,0
725,569,261,691,749,1,13,6,122,488,12,25,0,0
726,594,279,730,797,1,13,6,136,518,13,25,0,0
727,639,294,781,826,1,13,6,142,532,14,25,0,0
728,692,303,841,851,1,13,6,149,548,15,25,0,0
729,736,325,902,906,1,13,6,166,581,16,25,0,0
730,778,336,951,929,1,13,6,173,593,17,25,0,0
731,805,363,1002,1010,1,13,6,197,647,18,25,0,0
732,866,397,1077,1064,1,13,6,211,667,19,25,0,0
733,962,417,1175,1080,1,13,6,213,663,20,25,0,0
734,1037,454,1254,1080,1,13,6,217,626,21,25,0,0
735,1102,496,1323,1080,1,13,6,221,584,22,25,0,0
736,1209,528,1432,1080,1,13,6,223,552,23,25,0,0
737,1305,587,1524,1080,1,13,6,219,493,24,25,0,0
738,1365,611,1583,1080,1,13,6,218,469,25,25,1,0
738,1483,651,1758,1073,2,13,6,275,422,0,3,0,0
739,1586,681,1844,1076,2,13,6,258,395,1,3,0,0
740,1693,737,1911,1071,2,13,6,218,334,2,3,0,0
741,1753,766,1920,1069,2,13,6,167,303,3,3,0,0
1621,1808,902,1912,1072,4,13,6,104,170,0,0,0,0
1622,1671,765,1920,1074,5,13,6,249,309,0,32,0,1
1623,1574,736,1839,1065,5,13,6,265,329,1,32,0,0
1624,1452,696,1755,1071,5,13,6,303,375,2,32,0,0
1625,1325,636,1675,1073,5,13,6,350,437,3,32,0,0
1626,1213,597,1591,1073,5,13,6,378,476,4,32,0,0
1627,1094,554,1493,1063,5,13,6,399,509,5,32,0,0
1628,975,502,1409,1067,5,13,6,434,565,6,32,0,0
1629,859,474,1307,1069,5,13,6,448,595,7,32,0,0
1630,788,430,1246,1057,5,13,6,458,627,8,32,0,0
1631,739,391,1209,1055,5,13,6,470,664,9,32,0,0
1632,699,371,1158,1041,5,13,6,459,670,10,32,0,0
1633,668,340,1079,967,5,13,6,411,627,11,32,0,0
1634,627,323,1009,926,5,13,6,382,603,12,32,0,0
1635,607,311,954,880,5,13,6,347,569,13,32,0,0
1636,591,293,901,822,5,13,6,310,529,14,32,0,0
1637,573,276,872,802,5,13,6,299,526,15,32,0,0
1638,548,256,832,777,5,13,6,284,521,16,32,0,0
1639,527,243,784,735,5,13,6,257,492,17,32,0,0
1640,496,242,737,718,5,13,6,241,476,18,32,0,0
1641,479,234,701,685,5,13,6,222,451,19,32,0,0
1642,451,226,660,664,5,13,6,209,438,20,32,0,0
1643,433,225,631,650,5,13,6,198,425,21,32,0,0
1644,414,215,596,621,5,13,6,182,406,22,32,0,0
1645,395,207,564,595,5,13,6,169,388,23,32,0,0
1646,377,209,539,585,5,13,6,162,376,24,32,0,0
1647,353,202,502,558,5,13,6,149,356,25,32,0,0
1648,332,196,479,552,5,13,6,147,356,26,32,0,0
1649,308,194,448,541,5,13,6,140,347,27,32,0,0
1650,271,188,404,527,5,13,6,133,339,28,32,0,0
1651,242,188,372,525,5,13,6,130,337,29,32,0,0
1652,228,184,357,520,5,13,6,129,336,30,32,0,0
1653,210,188,324,503,5,13,6,114,315,31,32,0,0
1654,181,182,293,488,5,13,6,112,306,32,32,1,0
2138,246,152,301,400,8,13,6,55,248,0,33,0,1
2139,258,153,311,391,8,13,6,53,238,1,33,0,0
2140,273,149,327,385,8,13,6,54,236,2,33,0,0
2141,292,147,344,374,8,13,6,52,227,3,33,0,0
2142,301,146,354,373,8,13,6,53,227,4,33,0,0
2143,311,142,362,360,8,13,6,51,218,5,33,0,0
2144,319,140,370,353,8,13,6,51,213,6,33,0,0
2145,328,138,379,351,8,13,6,51,213,7,33,0,0
2146,337,135,387,340,8,13,6,50,205,8,33,0,0
2147,342,135,392,333,8,13,6,50,198,9,33,0,0
2148,342,131,395,338,8,13,6,53,207,10,33,0,0
2149,344,124,397,327,8,13,6,53,203,11,33,0,0
2150,347,127,397,316,8,13,6,50,189,12,33,0,0
2151,352,125,402,307,8,13,6,50,182,13,33,0,0
2152,353,122,403,303,8,13,6,50,181,14,33,0,0
2153,353,122,403,300,8,13,6,50,178,15,33,0,0
2154,351,118,401,294,8,13,6,50,176,16,33,0,0
2155,349,117,399,292,8,13,6,50,175,17,33,0,0
2156,350,118,398,287,8,13,6,48,169,18,33,0,0
2157,350,116,396,277,8,13,6,46,161,19,33,0,0
2158,348,116,394,275,8,13,6,46,159,20,33,0,0
2159,344,117,390,272,8,13,6,46,155,21,33,0,0
2160,340,115,385,267,8,13,6,45,152,22,33,0,0
2161,336,116,381,266,8,13,6,45,150,23,33,0,0
2162,333,116,378,262,8,13,6,45,146,24,33,0,0
2163,327,114,372,260,8,13,6,45,146,25,33,0,0
2164,322,114,365,256,8,13,6,43,142,26,33,0,0
2165,315,112,357,250,8,13,6,42,138,27,33,0,0
2166,308,110,351,251,8,13,6,43,141,28,33,0,0
2167,305,111,347,247,8,13,6,42,136,29,33,0,0
2168,300,111,341,246,8,13,6,41,135,30,33,0,0
2169,296,111,335,241,8,13,6,39,130,31,33,0,0
2170,289,111,329,240,8,13,6,40,129,32,33,0,0
2171,275,111,321,264,8,13,6,46,153,33,33,1,0
2251,582,418,1206,1070,13,13,6,624,652,0,46,0,1
2252,590,406,1189,1066,13,13,6,599,660,1,46,0,0
2253,609,389,1176,1054,13,13,6,567,665,2,46,0,0
2254,623,375,1142,1016,13,13,6,519,641,3,46,0,0
2255,619,366,1103,992,13,13,6,484,626,4,46,0,0
2256,605,350,1064,972,13,13,6,459,622,5,46,0,0
2257,594,333,1023,942,13,13,6,429,609,6,46,0,0
2258,596,334,991,922,13,13,6,395,588,7,46,0,0
2259,598,327,972,913,13,13,6,374,586,8,46,0,0
2260,600,317,953,896,13,13,6,353,579,9,46,0,0
2261,609,303,930,855,13,13,6,321,552,10,46,0,0
2262,609,296,907,825,13,13,6,298,529,11,46,0,0
2263,606,296,882,808,13,13,6,276,512,12,46,0,0
2264,602,294,863,797,13,13,6,261,503,13,46,0,0
2265,611,286,851,765,13,13,6,240,479,14,46,0,0
2266,611,278,842,758,13,13,6,231,480,15,46,0,0
2267,605,282,826,754,13,13,6,221,472,16,46,0,0
2268,597,265,799,707,13,13,6,202,442,17,46,0,0
2269,582,254,781,698,13,13,6,199,444,18,46,0,0
2270,566,252,758,688,13,13,6,192,436,19,46,0,0
2271,549,245,735,675,13,13,6,186,430,20,46,0,0
2272,531,237,715,667,13,13,6,184,430,21,46,0,0
2273,521,233,699,661,13,13,6,178,428,22,46,0,0
2274,510,235,684,659,13,13,6,174,424,23,46,0,0
2275,503,231,664,631,13,13,6,161,400,24,46,0,0
2276,496,224,653,621,13,13,6,157,397,25,46,0,0
2277,478,223,631,609,13,13,6,153,386,26,46,0,0
2278,465,219,614,602,13,13,6,149,383,27,46,0,0
2279,446,215,591,589,13,13,6,145,374,28,46,0,0
2280,428,213,570,586,13,13,6,142,373,29,46,0,0
2281,416,210,554,575,13,13,6,138,365,30,46,0,0
2282,401,207,536,572,13,13,6,135,365,31,46,0,0
2283,387,202,516,556,13,13,6,129,354,32,46,0,0
2284,367,203,493,549,13,13,6,126,346,33,46,0,0
2285,351,200,477,551,13,13,6,126,351,34,46,0,0
2286,336,197,459,541,13,13,6,123,344,35,46,0,0
2287,319,193,440,535,13,13,6,121,342,36,46,0,0
2288,306,193,423,527,13,13,6,117,334,37,46,0,0
2289,295,190,408,523,13,13,6,113,333,38,46,0,0
2290,284,187,396,523,13,13,6,112,336,39,46,0,0
2291,271,187,380,520,13,13,6,109,333,40,46,0,0
2292,258,189,367,519,13,13,6,109,330,41,46,0,0
2293,250,188,358,516,13,13,6,108,328,42,46,0,0
2294,231,184,336,509,13,13,6,105,325,43,46,0,0
2295,222,184,322,504,13,13,6,100,320,44,46,0,0
2296,216,185,313,510,13,13,6,97,325,45,46,0,0
2297,203,183,299,506,13,13,6,96,323,46,46,1,0
2387,245,163,292,396,14,13,6,47,233,0,43,0,1
2388,246,158,295,398,14,13,6,49,240,1,43,0,0
2389,248,162,297,405,14,13,6,49,243,2,43,0,0
2390,256,156,306,401,14,13,6,50,245,3,43,0,0
2391,271,149,321,384,14,13,6,50,235,4,43,0,0
2392,281,147,333,380,14,13,6,52,233,5,43,0,0
2393,285,141,338,375,14,13,6,53,234,6,43,0,0
2394,288,140,340,359,14,13,6,52,219,7,43,0,0
2395,297,141,349,357,14,13,6,52,216,8,43,0,0
2396,305,138,358,349,14,13,6,53,211,9,43,0,0
2397,313,135,367,343,14,13,6,54,208,10,43,0,0
2398,316,135,371,339,14,13,6,55,204,11,43,0,0
2399,314,134,369,336,14,13,6,55,202,12,43,0,0
2400,314,131,370,333,14,13,6,56,202,13,43,0,0
2401,316,133,372,328,14,13,6,56,195,14,43,0,0
2402,321,128,377,323,14,13,6,56,195,15,43,0,0
2403,325,124,381,314,14,13,6,56,190,16,43,0,0
2404,325,126,380,308,14,13,6,55,182,17,43,0,0
2405,322,122,378,307,14,13,6,56,185,18,43,0,0
2406,320,118,376,301,14,13,6,56,183,19,43,0,0
2407,320,120,376,300,14,13,6,56,180,20,43,0,0
2408,321,119,377,296,14,13,6,56,177,21,43,0,0
2409,322,116,377,289,14,13,6,55,173,22,43,0,0
2410,321,116,376,290,14,13,6,55,174,23,43,0,0
2411,320,116,374,286,14,13,6,54,170,24,43,0,0
2412,321,118,372,277,14,13,6,51,159,25,43,0,0
2413,323,120,372,271,14,13,6,49,151,26,43,0,0
2414,326,118,371,252,14,13,6,45,134,27,43,0,0
2415,324,116,374,262,14,13,6,50,146,28,43,0,0
2416,325,115,372,252,14,13,6,47,137,29,43,0,0
2417,324,115,371,251,14,13,6,47,136,30,43,0,0
2418,324,116,369,245,14,13,6,45,129,31,43,0,0
2419,324,114,372,251,14,13,6,48,137,32,43,0,0
2420,324,113,372,250,14,13,6,48,137,33,43,0,0
2421,322,114,371,251,14,13,6,49,137,34,43,0,0
2422,319,111,367,250,14,13,6,48,139,35,43,0,0
2423,314,109,363,249,14,13,6,49,140,36,43,0,0
2424,312,109,361,249,14,13,6,49,140,37,43,0,0
2425,311,108,359,245,14,13,6,48,137,38,43,0,0
2426,309,110,355,241,14,13,6,46,131,39,43,0,0
2427,304,111,348,237,14,13,6,44,126,40,43,0,0
2428,296,110,339,232,14,13,6,43,122,41,43,0,0
2429,288,111,331,234,14,13,6,43,123,42,43,0,0
2430,285,111,328,232,14,13,6,43,121,43,43,1,0
2498,256,137,304,336,15,13,6,48,199,0,127,0,1
2499,269,137,317,334,15,13,6,48,197,1,127,0,0
2500,277,137,326,333,15,13,6,49,196,2,127,0,0
2501,297,136,346,330,15,13,6,49,194,3,127,0,0
2502,311,140,361,339,15,13,6,50,199,4,127,0,0
2503,322,141,372,340,15,13,6,50,199,5,127,0,0
2504,336,139,387,337,15,13,6,51,198,6,127,0,0
2505,347,139,401,342,15,13,6,54,203,7,127,0,0
2506,358,142,412,346,15,13,6,54,204,8,127,0,0
2507,373,142,430,349,15,13,6,57,207,9,127,0,0
2508,389,143,450,356,15,13,6,61,213,10,127,0,0
2509,398,146,461,359,15,13,6,63,213,11,127,0,0
2510,399,146,464,362,15,13,6,65,216,12,127,0,0
2511,402,149,470,372,15,13,6,68,223,13,127,0,0
2512,412,153,481,376,15,13,6,69,223,14,127,0,0
2513,422,155,491,378,15,13,6,69,223,15,127,0,0
2514,431,157,504,389,15,13,6,73,232,16,127,0,0
2515,433,161,509,395,15,13,6,76,234,17,127,0,0
2516,434,160,511,395,15,13,6,77,235,18,127,0,0
2517,434,160,515,405,15,13,6,81,245,19,127,0,0
2518,443,173,526,421,15,13,6,83,248,20,127,0,0
2519,453,179,538,427,15,13,6,85,248,21,127,0,0
2520,462,180,552,440,15,13,6,90,260,22,127,0,0
2521,467,185,559,447,15,13,6,92,262,23,127,0,0
2522,468,185,563,452,15,13,6,95,267,24,127,0,0
2523,469,184,569,466,15,13,6,100,282,25,127,0,0
2524,477,190,580,483,15,13,6,103,293,26,127,0,0
2525,490,192,596,490,15,13,6,106,298,27,127,0,0
2526,506,193,617,502,15,13,6,111,309,28,127,0,0
2527,516,204,635,532,15,13,6,119,328,29,127,0,0
2528,520,204,641,538,15,13,6,121,334,30,127,0,0
2529,525,205,648,547,15,13,6,123,342,31,127,0,0
2530,538,214,663,566,15,13,6,125,352,32,127,0,0
2531,560,219,688,574,15,13,6,128,355,33,127,0,0
2532,583,224,717,597,15,13,6,134,373,34,127,0,0
2533,599,231,738,620,15,13,6,139,389,35,127,0,0
2534,615,238,758,638,15,13,6,143,400,36,127,0,0
2535,638,249,783,658,15,13,6,145,409,37,127,0,0
2536,667,263,816,677,15,13,6,149,414,38,127,0,0
2537,706,276,855,686,15,13,6,149,410,39,127,0,0
2538,752,284,912,722,15,13,6,160,438,40,127,0,0
2539,783,295,956,760,15,13,6,173,465,41,127,0,0
2540,821,307,990,768,15,13,6,169,461,42,127,0,0
2541,863,314,1034,783,15,13,6,171,469,43,127,0,0
2542,895,332,1075,814,15,13,6,180,482,44,127,0,0
2543,947,343,1130,825,15,13,6,183,482,45,127,0,0
2544,1008,349,1211,873,15,13,6,203,524,46,127,0,0
2545,1047,366,1258,903,15,13,6,211,537,47,127,0,0
2546,1069,370,1283,917,15,13,6,214,547,48,127,0,0
2547,1091,383,1311,941,15,13,6,220,558,49,127,0,0
2548,1109,396,1332,945,15,13,6,223,549,50,127,0,0
2549,1113,398,1342,945,15,13,6,229,547,51,127,0,0
2550,1118,397,1350,948,15,13,6,232,551,52,127,0,0
2551,1129,398,1355,945,15,13,6,226,547,53,127,0,0
2552,1123,390,1346,942,15,13,6,223,552,54,127,0,0
2553,1109,374,1326,925,15,13,6,217,551,55,127,0,0
2554,1077,368,1289,902,15,13,6,212,534,56,127,0,0
2555,1029,364,1237,876,15,13,6,208,512,57,127,0,0
2556,1000,351,1209,866,15,13,6,209,515,58,127,0,0
2557,972,339,1174,840,15,13,6,202,501,59,127,0,0
2558,927,325,1132,833,15,13,6,205,508,60,127,0,0
2559,898,318,1102,832,15,13,6,204,514,61,127,0,0
2560,878,303,1070,792,15,13,6,192,489,62,127,0,0
2561,845,289,1030,762,15,13,6,185,473,63,127,0,0
2562,819,281,992,719,15,13,6,173,438,64,127,0,0
2563,804,272,955,647,15,13,6,151,375,65,127,0,0
2564,790,261,917,563,15,13,6,127,302,66,127,0,0
2565,778,257,891,514,15,13,6,113,257,67,127,0,0
2566,788,249,893,486,15,13,6,105,237,68,127,0,0
2567,744,238,910,619,15,13,6,166,381,69,127,0,0
2568,720,233,890,630,15,13,6,170,397,70,127,0,0
2569,699,241,862,628,15,13,6,163,387,71,127,0,0
2570,692,244,840,596,15,13,6,148,352,72,127,0,0
2571,678,224,826,580,15,13,6,148,356,73,127,0,0
2572,676,208,824,569,15,13,6,148,361,74,127,0,0
2573,677,214,813,550,15,13,6,136,336,75,127,0,0
2574,676,215,804,536,15,13,6,128,321,76,127,0,0
2575,673,224,793,527,15,13,6,120,303,77,127,0,0
2576,667,217,786,515,15,13,6,119,298,78,127,0,0
2577,663,208,781,506,15,13,6,118,298,79,127,0,0
2578,670,201,789,501,15,13,6,119,300,80,127,0,0
2579,676,194,798,501,15,13,6,122,307,81,127,0,0
2580,680,191,802,499,15,13,6,122,308,82,127,0,0
2581,684,191,806,500,15,13,6,122,309,83,127,0,0
2582,689,191,809,503,15,13,6,120,312,84,127,0,0
2583,697,194,815,510,15,13,6,118,316,85,127,0,0
2584,705,197,820,513,15,13,6,115,316,86,127,0,0
2585,710,202,822,522,15,13,6,112,320,87,127,0,0
2586,710,207,820,526,15,13,6,110,319,88,127,0,0
2587,699,213,810,530,15,13,6,111,317,89,127,0,0
2588,685,217,800,535,15,13,6,115,318,90,127,0,0
2589,672,220,789,541,15,13,6,117,321,91,127,0,0
2590,654,216,773,545,15,13,6,119,329,92,127,0,0
2591,639,215,762,556,15,13,6,123,341,93,127,0,0
2592,624,220,751,579,15,13,6,127,359,94,127,0,0
2593,608,222,738,590,15,13,6,130,368,95,127,0,0
2594,589,223,723,599,15,13,6,134,376,96,127,0,0
2595,563,228,700,612,15,13,6,137,384,97,127,0,0
2596,541,233,679,618,15,13,6,138,385,98,127,0,0
2597,520,237,656,626,15,13,6,136,389,99,127,0,0
2598,498,244,637,645,15,13,6,139,401,100,127,0,0
2599,484,250,625,662,15,13,6,141,412,101,127,0,0
2600,470,251,613,672,15,13,6,143,421,102,127,0,0
2601,453,249,597,676,15,13,6,144,427,103,127,0,0
2602,432,252,580,687,15,13,6,148,435,104,127,0,0
2603,415,258,565,698,15,13,6,150,440,105,127,0,0
2604,370,255,530,703,15,13,6,160,448,106,127,0,0
2605,320,257,496,710,15,13,6,176,453,107,127,0,0
2606,297,257,486,713,15,13,6,189,456,108,127,0,0
2607,286,257,488,716,15,13,6,202,459,109,127,0,0
2608,277,257,485,716,15,13,6,208,459,110,127,0,0
2609,281,267,488,715,15,13,6,207,448,111,127,0,0
2610,300,273,506,721,15,13,6,206,448,112,127,0,0
2611,321,273,521,722,15,13,6,200,449,113,127,0,0
2612,341,277,535,731,15,13,6,194,454,114,127,0,0
2613,347,276,533,733,15,13,6,186,457,115,127,0,0
2614,338,272,521,730,15,13,6,183,458,116,127,0,0
2615,329,273,508,727,15,13,6,179,454,117,127,0,0
2616,316,271,497,733,15,13,6,181,462,118,127,0,0
2617,292,265,473,725,15,13,6,181,460,119,127,0,0
2618,265,268,445,727,15,13,6,180,459,120,127,0,0
2619,253,280,430,723,15,13,6,177,443,121,127,0,0
2620,232,284,408,722,15,13,6,176,438,122,127,0,0
2621,212,286,381,721,15,13,6,169,435,123,127,0,0
2622,196,284,359,722,15,13,6,163,438,124,127,0,0
2623,187,282,344,725,15,13,6,157,443,125,127,0,0
2624,184,279,333,719,15,13,6,149,440,126,127,0,0
2625,171,279,320,719,15,13,6,149,440,127,127,1,0
2558,1250,738,1533,1075,20,13,6,283,337,0,0,0,0
2559,1071,655,1402,1073,21,13,6,331,418,0,52,0,1
2560,941,578,1335,1078,21,13,6,394,500,1,52,0,0
2561,843,539,1265,1077,21,13,6,422,538,2,52,0,0
2562,742,503,1188,1078,21,13,6,446,575,3,52,0,0
2563,661,454,1129,1069,21,13,6,468,615,4,52,0,0
2564,590,423,1072,1072,21,13,6,482,649,5,52,0,0
2565,561,385,1024,1028,21,13,6,463,643,6,52,0,0
2566,538,338,988,986,21,13,6,450,648,7,52,0,0
2567,518,325,928,936,21,13,6,410,611,8,52,0,0
2568,482,289,862,880,21,13,6,380,591,9,52,0,0
2569,448,279,805,851,21,13,6,357,572,10,52,0,0
2570,430,259,760,806,21,13,6,330,547,11,52,0,0
2571,441,242,740,758,21,13,6,299,516,12,52,0,0
2572,443,241,710,723,21,13,6,267,482,13,52,0,0
2573,425,226,669,683,21,13,6,244,457,14,52,0,0
2574,407,220,640,669,21,13,6,233,449,15,52,0,0
2575,399,216,612,640,21,13,6,213,424,16,52,0,0
2576,405,205,595,593,21,13,6,190,388,17,52,0,0
2577,407,204,582,574,21,13,6,175,370,18,52,0,0
2578,394,193,558,552,21,13,6,164,359,19,52,0,0
2579,377,185,535,537,21,13,6,158,352,20,52,0,0
2580,369,183,518,525,21,13,6,149,342,21,52,0,0
2581,366,177,508,510,21,13,6,142,333,22,52,0,0
2582,366,176,500,498,21,13,6,134,322,23,52,0,0
2583,361,175,487,486,21,13,6,126,311,24,52,0,0
2584,356,167,476,466,21,13,6,120,299,25,52,0,0
2585,353,166,467,458,21,13,6,114,292,26,52,0,0
2586,353,162,463,446,21,13,6,110,284,27,52,0,0
2587,358,156,461,428,21,13,6,103,272,28,52,0,0
2588,358,156,454,415,21,13,6,96,259,29,52,0,0
2589,350,151,442,402,21,13,6,92,251,30,52,0,0
2590,341,148,431,397,21,13,6,90,249,31,52,0,0
2591,336,148,427,399,21,13,6,91,251,32,52,0,0
2592,337,141,423,385,21,13,6,86,244,33,52,0,0
2593,338,141,421,378,21,13,6,83,237,34,52,0,0
2594,333,139,413,372,21,13,6,80,233,35,52,0,0
2595,327,137,404,360,21,13,6,77,223,36,52,0,0
2596,326,138,400,355,21,13,6,74,217,37,52,0,0
2597,327,135,399,343,21,13,6,72,208,38,52,0,0
2598,329,132,399,338,21,13,6,70,206,39,52,0,0
2599,327,133,395,334,21,13,6,68,201,40,52,0,0
2600,321,128,388,326,21,13,6,67,198,41,52,0,0
2601,318,128,384,324,21,13,6,66,196,42,52,0,0
2602,317,125,383,323,21,13,6,66,198,43,52,0,0
2603,318,122,383,318,21,13,6,65,196,44,52,0,0
2604,318,121,381,311,21,13,6,63,190,45,52,0,0
2605,315,119,376,307,21,13,6,61,188,46,52,0,0
2606,313,117,373,301,21,13,6,60,184,47,52,0,0
2607,314,117,373,300,21,13,6,59,183,48,52,0,0
2608,313,116,369,293,21,13,6,56,177,49,52,0,0
2609,314,115,368,284,21,13,6,54,169,50,52,0,0
2610,317,120,366,276,21,13,6,49,156,51,52,0,0
2611,316,119,363,270,21,13,6,47,151,52,52,1,0
2870,262,139,302,322,30,13,6,40,183,0,14,0,0
2871,273,135,312,312,30,13,6,39,177,1,14,0,0
2872,294,127,334,302,30,13,6,40,175,2,14,0,0
2873,303,123,343,296,30,13,6,40,173,3,14,0,0
2874,310,115,351,291,30,13,6,41,176,4,14,0,0
2875,318,117,358,286,30,13,6,40,169,5,14,0,0
2876,325,116,364,278,30,13,6,39,162,6,14,0,0
2877,326,116,366,274,30,13,6,40,158,7,14,0,0
2878,324,114,363,266,30,13,6,39,152,8,14,0,0
2879,324,117,361,258,30,13,6,37,141,9,14,0,0
2880,327,115,362,243,30,13,6,35,128,10,14,0,0
2881,323,113,360,245,30,13,6,37,132,11,14,0,0
2882,317,111,355,242,30,13,6,38,131,12,14,0,0
2883,308,110,348,243,30,13,6,40,133,13,14,0,0
2884,309,109,348,238,30,13,6,39,129,14,14,0,0
2969,325,99,360,242,33,13,6,35,143,0,24,0,1
2970,335,103,371,246,33,13,6,36,143,1,24,0,0
2971,345,103,381,246,33,13,6,36,143,2,24,0,0
2972,352,108,389,251,33,13,6,37,143,3,24,0,0
2973,359,106,397,254,33,13,6,38,148,4,24,0,0
2974,364,107,406,261,33,13,6,42,154,5,24,0,0
2975,367,109,411,266,33,13,6,44,157,6,24,0,0
2976,368,106,413,268,33,13,6,45,162,7,24,0,0
2977,371,109,417,274,33,13,6,46,165,8,24,0,0
2978,374,109,422,277,33,13,6,48,168,9,24,0,0
2979,375,109,426,285,33,13,6,51,176,10,24,0,0
2980,376,111,429,294,33,13,6,53,183,11,24,0,0
2981,375,110,429,298,33,13,6,54,188,12,24,0,0
2982,373,113,428,306,33,13,6,55,193,13,24,0,0
2983,371,113,429,313,33,13,6,58,200,14,24,0,0
2984,370,118,427,312,33,13,6,57,194,15,24,0,0
2985,362,118,422,325,33,13,6,60,207,16,24,0,0
2986,353,117,415,333,33,13,6,62,216,17,24,0,0
2987,343,125,404,332,33,13,6,61,207,18,24,0,0
2988,329,129,392,344,33,13,6,63,215,19,24,0,0
2989,311,131,376,353,33,13,6,65,222,20,24,0,0
2990,287,135,358,370,33,13,6,71,235,21,24,0,0
2991,265,137,336,375,33,13,6,71,238,22,24,0,0
2992,245,140,317,387,33,13,6,72,247,23,24,0,0
2993,237,142,311,394,33,13,6,74,252,24,24,1,0
3160,228,282,365,673,36,13,6,137,391,0,22,0,1
3161,230,278,373,686,36,13,6,143,408,1,22,0,0
3162,240,277,391,708,36,13,6,151,431,2,22,0,0
3163,252,291,406,724,36,13,6,154,433,3,22,0,0
3164,281,290,440,737,36,13,6,159,447,4,22,0,0
3165,315,290,483,762,36,13,6,168,472,5,22,0,0
3166,361,302,524,757,36,13,6,163,455,6,22,0,0
3167,416,307,576,757,36,13,6,160,450,7,22,0,0
3168,460,302,629,782,36,13,6,169,480,8,22,0,0
3169,517,309,701,823,36,13,6,184,514,9,22,0,0
3170,560,328,750,855,36,13,6,190,527,10,22,0,0
3171,601,333,795,873,36,13,6,194,540,11,22,0,0
3172,630,362,835,939,36,13,6,205,577,12,22,0,0
3173,648,411,855,988,36,13,6,207,577,13,22,0,0
3174,674,448,877,1002,36,13,6,203,554,14,22,0,0
3175,700,474,914,1047,36,13,6,214,573,15,22,0,0
3176,747,501,964,1067,36,13,6,217,566,16,22,0,0
3177,796,529,1014,1076,36,13,6,218,547,17,22,0,0
3178,829,560,1042,1069,36,13,6,213,509,18,22,0,0
3179,859,611,1065,1079,36,13,6,206,468,19,22,0,0
3180,894,663,1092,1079,36,13,6,198,416,20,22,0,0
3181,946,714,1138,1080,36,13,6,192,366,21,22,0,0
3182,987,744,1170,1080,36,13,6,183,336,22,22,1,0
4320,270,134,314,329,56,13,6,44,195,0,38,0,1
4321,282,132,327,328,56,13,6,45,196,1,38,0,0
4322,301,125,345,316,56,13,6,44,191,2,38,0,0
4323,334,119,379,307,56,13,6,45,188,3,38,0,0
4324,353,118,399,303,56,13,6,46,185,4,38,0,0
4325,363,118,411,302,56,13,6,48,184,5,38,0,0
4326,369,114,419,305,56,13,6,50,191,6,38,0,0
4327,377,111,425,298,56,13,6,48,187,7,38,0,0
4328,386,114,434,294,56,13,6,48,180,8,38,0,0
4329,398,112,446,289,56,13,6,48,177,9,38,0,0
4330,401,112,450,287,56,13,6,49,175,10,38,0,0
4331,400,112,448,283,56,13,6,48,171,11,38,0,0
4332,399,112,445,275,56,13,6,46,163,12,38,0,0
4333,398,113,444,273,56,13,6,46,160,13,38,0,0
4334,396,113,443,271,56,13,6,47,158,14,38,0,0
4335,390,109,437,268,56,13,6,47,159,15,38,0,0
4336,383,109,429,262,56,13,6,46,153,16,38,0,0
4337,374,109,419,261,56,13,6,45,152,17,38,0,0
4338,368,109,412,256,56,13,6,44,147,18,38,0,0
4339,352,110,404,281,56,13,6,52,171,19,38,0,0
4340,349,113,401,284,56,13,6,52,171,20,38,0,0
4341,354,115,407,284,56,13,6,53,169,21,38,0,0
4342,358,116,411,281,56,13,6,53,165,22,38,0,0
4343,358,114,411,276,56,13,6,53,162,23,38,0,0
4344,360,116,411,272,56,13,6,51,156,24,38,0,0
4345,362,114,413,268,56,13,6,51,154,25,38,0,0
4346,364,112,416,265,56,13,6,52,153,26,38,0,0
4347,362,111,413,263,56,13,6,51,152,27,38,0,0
4348,357,111,407,258,56,13,6,50,147,28,38,0,0
4349,353,111,403,256,56,13,6,50,145,29,38,0,0
4350,351,111,399,249,56,13,6,48,138,30,38,0,0
4351,347,111,394,246,56,13,6,47,135,31,38,0,0
4352,341,110,387,243,56,13,6,46,133,32,38,0,0
4353,332,110,377,240,56,13,6,45,130,33,38,0,0
4354,321,109,366,235,56,13,6,45,126,34,38,0,0
4355,314,108,359,234,56,13,6,45,126,35,38,0,0
4356,305,107,349,231,56,13,6,44,124,36,38,0,0
4357,297,108,338,224,56,13,6,41,116,37,38,0,0
4358,292,108,331,220,56,13,6,39,112,38,38,1,0
4329,260,127,297,304,57,13,6,37,177,0,18,0,0
4330,261,138,297,312,57,13,6,36,174,1,18,0,0
4331,268,140,303,305,57,13,6,35,165,2,18,0,0
4332,279,138,314,301,57,13,6,35,163,3,18,0,0
4333,293,134,329,299,57,13,6,36,165,4,18,0,0
4334,299,130,339,306,57,13,6,40,176,5,18,0,0
4335,302,126,344,305,57,13,6,42,179,6,18,0,0
4336,308,125,353,307,57,13,6,45,182,7,18,0,0
4337,315,127,360,305,57,13,6,45,178,8,18,0,0
4338,324,121,370,302,57,13,6,46,181,9,18,0,0
4339,310,121,354,293,57,13,6,44,172,10,18,0,0
4340,305,119,348,285,57,13,6,43,166,11,18,0,0
4341,304,121,344,270,57,13,6,40,149,12,18,0,0
4342,301,120,340,268,57,13,6,39,148,13,18,0,0
4343,303,115,341,253,57,13,6,38,138,14,18,0,0
4344,302,108,341,250,57,13,6,39,142,15,18,0,0
4345,298,109,337,253,57,13,6,39,144,16,18,0,0
4346,295,113,332,246,57,13,6,37,133,17,18,0,0
4347,291,116,326,244,57,13,6,35,128,18,18,0,0
4333,259,135,300,324,58,13,6,41,189,0,1,0,0
4334,268,141,306,316,58,13,6,38,175,1,1,0,0
4338,297,128,335,286,59,13,6,38,158,0,0,0,0
4452,242,172,316,491,62,13,6,74,319,0,25,0,1
4453,267,172,345,507,62,13,6,78,335,1,25,0,0
4454,296,161,377,506,62,13,6,81,345,2,25,0,0
4455,337,171,418,508,62,13,6,81,337,3,25,0,0
4456,362,177,445,521,62,13,6,83,344,4,25,0,0
4457,395,179,478,523,62,13,6,83,344,5,25,0,0
4458,424,184,513,547,62,13,6,89,363,6,25,0,0
4459,450,184,543,563,62,13,6,93,379,7,25,0,0
4460,477,190,573,576,62,13,6,96,386,8,25,0,0
4461,502,203,602,595,62,13,6,100,392,9,25,0,0
4462,528,201,632,610,62,13,6,104,409,10,25,0,0
4463,551,212,660,639,62,13,6,109,427,11,25,0,0
4464,573,222,686,663,62,13,6,113,441,12,25,0,0
4465,595,226,713,686,62,13,6,118,460,13,25,0,0
4466,618,242,744,734,62,13,6,126,492,14,25,0,0
4467,646,253,777,759,62,13,6,131,506,15,25,0,0
4468,671,265,811,814,62,13,6,140,549,16,25,0,0
4469,692,285,840,867,62,13,6,148,582,17,25,0,0
4470,720,292,870,883,62,13,6,150,591,18,25,0,0
4471,750,321,913,949,62,13,6,163,628,19,25,0,0
4472,785,340,958,993,62,13,6,173,653,20,25,0,0
4473,845,362,1029,1047,62,13,6,184,685,21,25,0,0
4474,893,403,1077,1061,62,13,6,184,658,22,25,0,0
4475,988,429,1175,1077,62,13,6,187,648,23,25,0,0
4476,1066,472,1259,1080,62,13,6,193,608,24,25,0,0
4477,1107,489,1303,1080,62,13,6,196,591,25,25,1,0
4477,1207,543,1463,1067,63,13,6,256,524,0,4,0,0
4478,1305,579,1548,1073,63,13,6,243,494,1,4,0,0
4479,1424,651,1636,1075,63,13,6,212,424,2,4,0,0
4480,1592,698,1783,1069,63,13,6,191,371,3,4,0,0
4481,1699,738,1868,1068,63,13,6,169,330,4,4,0,0
5591,1725,789,1919,1074,84,13,6,194,285,0,0,0,0
5592,1548,710,1805,1074,85,13,6,257,364,0,0,0,0
5593,1374,654,1649,1079,86,13,6,275,425,0,0,0,0
5594,1110,602,1480,1072,87,13,6,370,470,0,8,0,0
5595,992,534,1417,1077,87,13,6,425,543,1,8,0,0
5596,875,498,1322,1075,87,13,6,447,577,2,8,0,0
5597,781,446,1258,1073,87,13,6,477,627,3,8,0,0
5598,674,392,1179,1070,87,13,6,505,678,4,8,0,0
5599,590,359,1106,1068,87,13,6,516,709,5,8,0,0
5600,570,321,1036,982,87,13,6,466,661,6,8,0,0
5601,543,305,970,934,87,13,6,427,629,7,8,0,0
5602,474,271,911,915,87,13,6,437,644,8,8,0,0
5602,650,293,800,834,88,13,6,150,541,0,16,0,0
5603,609,263,762,811,88,13,6,153,548,1,16,0,0
5604,568,259,711,772,88,13,6,143,513,2,16,0,0
5605,536,235,673,723,88,13,6,137,488,3,16,0,0
5606,512,238,642,699,88,13,6,130,461,4,16,0,0
5607,484,230,604,656,88,13,6,120,426,5,16,0,0
5608,444,217,562,634,88,13,6,118,417,6,16,0,0
5609,411,216,527,623,88,13,6,116,407,7,16,0,0
5610,393,198,499,573,88,13,6,106,375,8,16,0,0
5611,369,189,478,568,88,13,6,109,379,9,16,0,0
5612,351,187,455,547,88,13,6,104,360,10,16,0,0
5613,325,178,428,536,88,13,6,103,358,11,16,0,0
5614,298,179,396,521,88,13,6,98,342,12,16,0,0
5615,270,173,363,498,88,13,6,93,325,13,16,0,0
5616,249,170,343,498,88,13,6,94,328,14,16,0,0
5617,233,168,330,505,88,13,6,97,337,15,16,0,0
5618,209,162,303,490,88,13,6,94,328,16,16,0,0
5606,564,237,629,394,89,13,6,65,157,0,0,0,0
5959,262,124,309,343,91,13,6,47,219,0,41,0,1
5960,267,124,315,343,91,13,6,48,219,1,41,0,0
5961,272,124,319,342,91,13,6,47,218,2,41,0,0
5962,289,129,338,349,91,13,6,49,220,3,41,0,0
5963,304,128,353,346,91,13,6,49,218,4,41,0,0
5964,322,126,374,345,91,13,6,52,219,5,41,0,0
5965,334,132,390,357,91,13,6,56,225,6,41,0,0
5966,343,132,402,360,91,13,6,59,228,7,41,0,0
5967,355,137,417,373,91,13,6,62,236,8,41,0,0
5968,366,144,431,383,91,13,6,65,239,9,41,0,0
5969,383,144,452,386,91,13,6,69,242,10,41,0,0
5970,397,148,472,399,91,13,6,75,251,11,41,0,0
5971,402,150,482,408,91,13,6,80,258,12,41,0,0
5972,405,151,489,416,91,13,6,84,265,13,41,0,0
5973,412,157,499,430,91,13,6,87,273,14,41,0,0
5974,425,160,516,437,91,13,6,91,277,15,41,0,0
5975,435,164,533,452,91,13,6,98,288,16,41,0,0
5976,442,171,542,460,91,13,6,100,289,17,41,0,0
5977,442,172,547,472,91,13,6,105,300,18,41,0,0
5978,445,180,558,500,91,13,6,113,320,19,41,0,0
5979,456,185,573,512,91,13,6,117,327,20,41,0,0
5980,471,188,594,528,91,13,6,123,340,21,41,0,0
5981,486,200,611,539,91,13,6,125,339,22,41,0,0
5982,498,207,628,556,91,13,6,130,349,23,41,0,0
5983,504,214,642,581,91,13,6,138,367,24,41,0,0
5984,521,225,661,596,91,13,6,140,371,25,41,0,0
5985,546,228,697,624,91,13,6,151,396,26,41,0,0
5986,569,235,734,660,91,13,6,165,425,27,41,0,0
5987,591,250,761,683,91,13,6,170,433,28,41,0,0
5988,599,256,780,716,91,13,6,181,460,29,41,0,0
5989,618,276,806,750,91,13,6,188,474,30,41,0,0
5990,653,290,847,776,91,13,6,194,486,31,41,0,0
5991,688,306,909,856,91,13,6,221,550,32,41,0,0
5992,721,336,948,887,91,13,6,227,551,33,41,0,0
5993,746,351,979,914,91,13,6,233,563,34,41,0,0
5994,762,379,1021,1000,91,13,6,259,621,35,41,0,0
5995,815,413,1082,1042,91,13,6,267,629,36,41,0,0
5996,873,441,1148,1071,91,13,6,275,630,37,41,0,0
5997,950,493,1223,1080,91,13,6,273,587,38,41,0,0
5998,1029,544,1296,1080,91,13,6,267,536,39,41,0,0
5999,1130,596,1395,1080,91,13,6,265,484,40,41,0,0
6000,1285,687,1529,1080,91,13,6,244,393,41,41,1,0
5962,261,162,310,353,92,13,6,49,191,0,0,0,0
682,1611,76,1646,178,1,13,7,35,102,0,85,0,0
684,1608,75,1645,184,1,13,7,37,109,0,85,0,1
685,1608,80,1644,186,1,13,7,36,106,1,85,0,0
686,1608,81,1645,188,1,13,7,37,107,2,85,0,0
687,1607,79,1645,189,1,13,7,38,110,3,85,0,0
688,1607,85,1643,191,1,13,7,36,106,4,85,0,0
689,1604,81,1643,192,1,13,7,39,111,5,85,0,0
690,1605,81,1644,196,1,13,7,39,115,6,85,0,0
691,1606,84,1645,197,1,13,7,39,113,7,85,0,0
692,1605,82,1644,196,1,13,7,39,114,8,85,0,0
693,1604,86,1643,199,1,13,7,39,113,9,85,0,0
694,1600,73,1644,204,1,13,7,44,131,10,85,0,0
695,1599,82,1641,207,1,13,7,42,125,11,85,0,0
696,1598,91,1639,208,1,13,7,41,117,12,85,0,0
697,1598,90,1639,208,1,13,7,41,118,13,85,0,0
698,1593,95,1636,216,1,13,7,43,121,14,85,0,0
699,1591,92,1636,219,1,13,7,45,127,15,85,0,0
700,1589,93,1637,226,1,13,7,48,133,16,85,0,0
701,1589,96,1636,225,1,13,7,47,129,17,85,0,0
702,1588,97,1635,228,1,13,7,47,131,18,85,0,0
703,1587,104,1633,232,1,13,7,46,128,19,85,0,0
704,1585,99,1634,236,1,13,7,49,137,20,85,0,0
705,1585,103,1636,241,1,13,7,51,138,21,85,0,0
706,1584,106,1635,245,1,13,7,51,139,22,85,0,0
707,1582,106,1634,248,1,13,7,52,142,23,85,0,0
708,1579,106,1633,252,1,13,7,54,146,24,85,0,0
709,1577,105,1633,259,1,13,7,56,154,25,85,0,0
710,1579,110,1636,265,1,13,7,57,155,26,85,0,0
711,1579,111,1637,268,1,13,7,58,157,27,85,0,0
712,1577,110,1637,275,1,13,7,60,165,28,85,0,0
713,1574,116,1634,280,1,13,7,60,164,29,85,0,0
714,1572,115,1633,284,1,13,7,61,169,30,85,0,0
715,1569,117,1634,294,1,13,7,65,177,31,85,0,0
716,1568,116,1634,297,1,13,7,66,181,32,85,0,0
717,1563,117,1632,305,1,13,7,69,188,33,85,0,0
718,1558,117,1628,311,1,13,7,70,194,34,85,0,0
719,1554,114,1627,318,1,13,7,73,204,35,85,0,0
720,1549,114,1626,330,1,13,7,77,216,36,85,0,0
721,1544,116,1623,335,1,13,7,79,219,37,85,0,0
722,1538,119,1618,342,1,13,7,80,223,38,85,0,0
723,1531,127,1608,344,1,13,7,77,217,39,85,0,0
724,1524,124,1605,354,1,13,7,81,230,40,85,0,0
725,1520,128,1604,369,1,13,7,84,241,41,85,0,0
726,1511,129,1599,377,1,13,7,88,248,42,85,0,0
727,1500,137,1588,386,1,13,7,88,249,43,85,0,0
728,1489,139,1579,396,1,13,7,90,257,44,85,0,0
729,1483,137,1577,407,1,13,7,94,270,45,85,0,0
730,1481,144,1579,427,1,13,7,98,283,46,85,0,0
731,1471,148,1571,435,1,13,7,100,287,47,85,0,0
732,1457,153,1562,454,1,13,7,105,301,48,85,0,0
733,1445,160,1552,467,1,13,7,107,307,49,85,0,0
734,1436,161,1548,482,1,13,7,112,321,50,85,0,0
735,1432,171,1548,506,1,13,7,116,335,51,85,0,0
736,1416,173,1539,522,1,13,7,123,349,52,85,0,0
737,1397,180,1524,545,1,13,7,127,365,53,85,0,0
738,1379,193,1506,560,1,13,7,127,367,54,85,0,0
739,1363,190,1501,589,1,13,7,138,399,55,85,0,0
740,1344,204,1492,631,1,13,7,148,427,56,85,0,0
741,1320,202,1475,651,1,13,7,155,449,57,85,0,0
742,1285,215,1445,683,1,13,7,160,468,58,85,0,0
743,1256,232,1417,706,1,13,7,161,474,59,85,0,0
744,1224,240,1400,757,1,13,7,176,517,60,85,0,0
745,1192,261,1380,807,1,13,7,188,546,61,85,0,0
746,1138,267,1330,834,1,13,7,192,567,62,85,0,0
747,1060,288,1261,860,1,13,7,201,572,63,85,0,0
748,1004,301,1212,880,1,13,7,208,579,64,85,0,0
749,905,313,1120,908,1,13,7,215,595,65,85,0,0
750,812,336,1036,918,1,13,7,224,582,66,85,0,0
751,704,348,935,935,1,13,7,231,587,67,85,0,0
752,584,350,823,932,1,13,7,239,582,68,85,0,0
753,490,353,740,931,1,13,7,250,578,69,85,0,0
754,386,348,634,921,1,13,7,248,573,70,85,0,0
755,320,361,561,896,1,13,7,241,535,71,85,0,0
756,243,360,479,876,1,13,7,236,516,72,85,0,0
757,162,359,395,863,1,13,7,233,504,73,85,0,0
758,107,363,334,845,1,13,7,227,482,74,85,0,0
759,76,371,279,810,1,13,7,203,439,75,85,0,0
760,47,361,242,781,1,13,7,195,420,76,85,0,0
761,18,363,201,756,1,13,7,183,393,77,85,0,0
762,0,356,162,736,1,13,7,162,380,78,85,0,0
763,0,354,145,730,1,13,7,145,376,79,85,0,0
764,0,339,122,694,1,13,7,122,355,80,85,0,0
765,0,343,111,673,1,13,7,111,330,81,85,0,0
766,0,359,92,647,1,13,7,92,288,82,85,0,0
767,0,360,79,634,1,13,7,79,274,83,85,0,0
768,0,362,68,627,1,13,7,68,265,84,85,0,0
769,0,364,41,612,1,13,7,41,248,85,85,1,0
761,22,356,83,624,5,13,7,61,268,0,0,0,0
1792,1671,85,1706,201,6,13,7,35,116,0,62,0,1
1793,1670,87,1706,204,6,13,7,36,117,1,62,0,0
1794,1669,84,1707,207,6,13,7,38,123,2,62,0,0
1795,1670,86,1707,211,6,13,7,37,125,3,62,0,0
1796,1669,84,1708,215,6,13,7,39,131,4,62,0,0
1797,1669,88,1707,217,6,13,7,38,129,5,62,0,0
1798,1669,90,1707,216,6,13,7,38,126,6,62,0,0
1799,1668,90,1706,217,6,13,7,38,127,7,62,0,0
1800,1666,92,1705,223,6,13,7,39,131,8,62,0,0
1801,1663,89,1704,227,6,13,7,41,138,9,62,0,0
1802,1658,86,1703,232,6,13,7,45,146,10,62,0,0
1803,1654,85,1699,233,6,13,7,45,148,11,62,0,0
1804,1651,85,1696,236,6,13,7,45,151,12,62,0,0
1805,1650,85,1696,239,6,13,7,46,154,13,62,0,0
1806,1649,87,1695,243,6,13,7,46,156,14,62,0,0
1807,1647,88,1696,246,6,13,7,49,158,15,62,0,0
1808,1648,95,1695,250,6,13,7,47,155,16,62,0,0
1809,1647,96,1695,253,6,13,7,48,157,17,62,0,0
1810,1648,99,1697,259,6,13,7,49,160,18,62,0,0
1811,1647,101,1698,267,6,13,7,51,166,19,62,0,0
1812,1645,101,1697,271,6,13,7,52,170,20,62,0,0
1813,1645,108,1696,274,6,13,7,51,166,21,62,0,0
1814,1645,109,1696,278,6,13,7,51,169,22,62,0,0
1815,1645,113,1698,286,6,13,7,53,173,23,62,0,0
1816,1646,116,1700,295,6,13,7,54,179,24,62,0,0
1817,1645,114,1701,301,6,13,7,56,187,25,62,0,0
1818,1645,119,1701,303,6,13,7,56,184,26,62,0,0
1819,1643,118,1700,309,6,13,7,57,191,27,62,0,0
1820,1642,119,1704,327,6,13,7,62,208,28,62,0,0
1821,1645,122,1708,336,6,13,7,63,214,29,62,0,0
1822,1646,120,1711,340,6,13,7,65,220,30,62,0,0
1823,1647,129,1711,346,6,13,7,64,217,31,62,0,0
1824,1645,131,1712,360,6,13,7,67,229,32,62,0,0
1825,1645,134,1714,368,6,13,7,69,234,33,62,0,0
1826,1645,139,1717,385,6,13,7,72,246,34,62,0,0
1827,1644,138,1716,388,6,13,7,72,250,35,62,0,0
1828,1639,143,1713,400,6,13,7,74,257,36,62,0,0
1829,1635,149,1711,410,6,13,7,76,261,37,62,0,0
1830,1629,151,1709,430,6,13,7,80,279,38,62,0,0
1831,1626,160,1709,450,6,13,7,83,290,39,62,0,0
1832,1618,160,1703,452,6,13,7,85,292,40,62,0,0
1833,1604,164,1697,478,6,13,7,93,314,41,62,0,0
1834,1592,167,1691,501,6,13,7,99,334,42,62,0,0
1835,1585,171,1689,521,6,13,7,104,350,43,62,0,0
1836,1578,181,1686,547,6,13,7,108,366,44,62,0,0
1837,1568,182,1680,554,6,13,7,112,372,45,62,0,0
1838,1555,194,1671,577,6,13,7,116,383,46,62,0,0
1839,1540,204,1663,609,6,13,7,123,405,47,62,0,0
1840,1535,212,1668,651,6,13,7,133,439,48,62,0,0
1841,1530,228,1670,688,6,13,7,140,460,49,62,0,0
1842,1515,236,1660,708,6,13,7,145,472,50,62,0,0
1843,1498,252,1655,751,6,13,7,157,499,51,62,0,0
1844,1478,269,1648,801,6,13,7,170,532,52,62,0,0
1845,1456,279,1645,870,6,13,7,189,591,53,62,0,0
1846,1434,311,1636,939,6,13,7,202,628,54,62,0,0
1847,1404,330,1614,969,6,13,7,210,639,55,62,0,0
1848,1364,366,1591,1039,6,13,7,227,673,56,62,0,0
1849,1332,407,1561,1066,6,13,7,229,659,57,62,0,0
1850,1291,455,1520,1077,6,13,7,229,622,58,62,0,0
1851,1243,545,1463,1079,6,13,7,220,534,59,62,0,0
1852,1185,635,1396,1076,6,13,7,211,441,60,62,0,0
1853,1144,805,1306,1080,6,13,7,162,275,61,62,0,0
1854,1124,856,1268,1080,6,13,7,144,224,62,62,1,0
2028,1663,81,1698,202,10,13,7,35,121,0,71,0,1
2029,1659,81,1695,204,10,13,7,36,123,1,71,0,0
2030,1658,82,1694,206,10,13,7,36,124,2,71,0,0
2031,1658,86,1693,206,10,13,7,35,120,3,71,0,0
2032,1658,85,1694,209,10,13,7,36,124,4,71,0,0
2033,1655,87,1692,215,10,13,7,37,128,5,71,0,0
2034,1653,90,1689,215,10,13,7,36,125,6,71,0,0
2035,1651,91,1688,218,10,13,7,37,127,7,71,0,0
2036,1651,93,1688,222,10,13,7,37,129,8,71,0,0
2037,1649,91,1689,226,10,13,7,40,135,9,71,0,0
2038,1648,94,1687,230,10,13,7,39,136,10,71,0,0
2039,1647,93,1687,231,10,13,7,40,138,11,71,0,0
2040,1646,96,1686,234,10,13,7,40,138,12,71,0,0
2041,1647,97,1687,238,10,13,7,40,141,13,71,0,0
2042,1646,97,1688,243,10,13,7,42,146,14,71,0,0
2043,1645,102,1687,247,10,13,7,42,145,15,71,0,0
2044,1643,102,1686,250,10,13,7,43,148,16,71,0,0
2045,1643,105,1687,255,10,13,7,44,150,17,71,0,0
2046,1643,106,1688,256,10,13,7,45,150,18,71,0,0
2047,1642,104,1690,265,10,13,7,48,161,19,71,0,0
2048,1641,107,1689,271,10,13,7,48,164,20,71,0,0
2049,1640,108,1690,276,10,13,7,50,168,21,71,0,0
2050,1641,113,1692,284,10,13,7,51,171,22,71,0,0
2051,1644,115,1696,289,10,13,7,52,174,23,71,0,0
2052,1645,114,1700,298,10,13,7,55,184,24,71,0,0
2053,1646,120,1700,303,10,13,7,54,183,25,71,0,0
2054,1643,118,1700,310,10,13,7,57,192,26,71,0,0
2055,1644,121,1702,319,10,13,7,58,198,27,71,0,0
2056,1645,123,1706,326,10,13,7,61,203,28,71,0,0
2057,1645,128,1707,333,10,13,7,62,205,29,71,0,0
2058,1642,129,1706,342,10,13,7,64,213,30,71,0,0
2059,1637,133,1703,351,10,13,7,66,218,31,71,0,0
2060,1635,137,1703,361,10,13,7,68,224,32,71,0,0
2061,1632,137,1702,369,10,13,7,70,232,33,71,0,0
2062,1629,140,1703,381,10,13,7,74,241,34,71,0,0
2063,1625,142,1699,384,10,13,7,74,242,35,71,0,0
2064,1617,143,1695,396,10,13,7,78,253,36,71,0,0
2065,1610,150,1693,415,10,13,7,83,265,37,71,0,0
2066,1607,151,1695,426,10,13,7,88,275,38,71,0,0
2067,1601,159,1692,441,10,13,7,91,282,39,71,0,0
2068,1592,162,1685,448,10,13,7,93,286,40,71,0,0
2069,1576,164,1678,475,10,13,7,102,311,41,71,0,0
2070,1568,168,1674,487,10,13,7,106,319,42,71,0,0
2071,1558,169,1672,503,10,13,7,114,334,43,71,0,0
2072,1549,180,1666,525,10,13,7,117,345,44,71,0,0
2073,1537,180,1660,538,10,13,7,123,358,45,71,0,0
2074,1526,188,1659,577,10,13,7,133,389,46,71,0,0
2075,1521,200,1661,605,10,13,7,140,405,47,71,0,0
2076,1521,208,1668,631,10,13,7,147,423,48,71,0,0
2077,1511,222,1663,666,10,13,7,152,444,49,71,0,0
2078,1487,227,1647,690,10,13,7,160,463,50,71,0,0
2079,1447,233,1629,761,10,13,7,182,528,51,71,0,0
2080,1410,250,1594,779,10,13,7,184,529,52,71,0,0
2081,1337,259,1532,806,10,13,7,195,547,53,71,0,0
2082,1274,254,1480,827,10,13,7,206,573,54,71,0,0
2083,1185,261,1400,865,10,13,7,215,604,55,71,0,0
2084,1086,281,1310,887,10,13,7,224,606,56,71,0,0
2085,967,294,1188,902,10,13,7,221,608,57,71,0,0
2086,855,308,1081,898,10,13,7,226,590,58,71,0,0
2087,734,314,962,896,10,13,7,228,582,59,71,0,0
2088,619,322,852,900,10,13,7,233,578,60,71,0,0
2089,513,343,748,904,10,13,7,235,561,61,71,0,0
2090,385,346,618,896,10,13,7,233,550,62,71,0,0
2091,286,354,523,884,10,13,7,237,530,63,71,0,0
2092,194,350,421,861,10,13,7,227,511,64,71,0,0
2093,139,347,365,844,10,13,7,226,497,65,71,0,0
2094,73,349,291,827,10,13,7,218,478,66,71,0,0
2095,12,355,221,814,10,13,7,209,459,67,71,0,0
2096,0,352,179,794,10,13,7,179,442,68,71,0,0
2097,0,355,138,762,10,13,7,138,407,69,71,0,0
2098,0,389,118,743,10,13,7,118,354,70,71,0,0
2099,0,418,86,716,10,13,7,86,298,71,71,1,0
2011,25,286,63,593,11,13,7,38,307,0,34,0,1
2012,30,289,73,601,11,13,7,43,312,1,34,0,0
2013,42,291,91,606,11,13,7,49,315,2,34,0,0
2014,56,293,111,611,11,13,7,55,318,3,34,0,0
2015,64,293,127,613,11,13,7,63,320,4,34,0,0
2016,70,292,142,639,11,13,7,72,347,5,34,0,0
2017,78,295,155,651,11,13,7,77,356,6,34,0,0
2018,89,299,171,653,11,13,7,82,354,7,34,0,0
2019,110,296,204,670,11,13,7,94,374,8,34,0,0
2020,127,298,228,675,11,13,7,101,377,9,34,0,0
2021,132,296,243,701,11,13,7,111,405,10,34,0,0
2022,147,308,266,734,11,13,7,119,426,11,34,0,0
2023,155,309,281,748,11,13,7,126,439,12,34,0,0
2024,178,314,313,759,11,13,7,135,445,13,34,0,0
2025,198,320,344,781,11,13,7,146,461,14,34,0,0
2026,210,324,363,794,11,13,7,153,470,15,34,0,0
2027,215,335,380,840,11,13,7,165,505,16,34,0,0
2028,225,350,396,866,11,13,7,171,516,17,34,0,0
2029,244,362,422,886,11,13,7,178,524,18,34,0,0
2030,273,377,464,912,11,13,7,191,535,19,34,0,0
2031,295,396,494,938,11,13,7,199,542,20,34,0,0
2032,298,406,511,978,11,13,7,213,572,21,34,0,0
2033,302,428,531,1043,11,13,7,229,615,22,34,0,0
2034,309,450,541,1067,11,13,7,232,617,23,34,0,0
2035,330,471,568,1077,11,13,7,238,606,24,34,0,0
2036,346,506,579,1080,11,13,7,233,574,25,34,0,0
2037,367,529,599,1080,11,13,7,232,551,26,34,0,0
2038,384,557,614,1080,11,13,7,230,523,27,34,0,0
2039,395,612,614,1080,11,13,7,219,468,28,34,0,0
2040,392,654,606,1079,11,13,7,214,425,29,34,0,0
2041,383,705,591,1080,11,13,7,208,375,30,34,0,0
2042,405,775,593,1080,11,13,7,188,305,31,34,0,0
2043,436,834,604,1079,11,13,7,168,245,32,34,0,0
2044,455,902,592,1079,11,13,7,137,177,33,34,0,0
2045,457,999,534,1080,11,13,7,77,81,34,34,1,0
2068,1225,451,1504,1064,13,13,7,279,613,0,79,0,1
2069,1200,437,1487,1070,13,13,7,287,633,1,79,0,0
2070,1178,401,1471,1051,13,13,7,293,650,2,79,0,0
2071,1142,372,1445,1048,13,13,7,303,676,3,79,0,0
2072,1124,362,1405,995,13,13,7,281,633,4,79,0,0
2073,1111,338,1369,923,13,13,7,258,585,5,79,0,0
2074,1108,327,1357,898,13,13,7,249,571,6,79,0,0
2075,1108,300,1346,853,13,13,7,238,553,7,79,0,0
2076,1112,270,1337,800,13,13,7,225,530,8,79,0,0
2077,1115,258,1334,781,13,13,7,219,523,9,79,0,0
2078,1122,248,1325,742,13,13,7,203,494,10,79,0,0
2079,1130,232,1325,710,13,13,7,195,478,11,79,0,0
2080,1142,225,1331,692,13,13,7,189,467,12,79,0,0
2081,1166,226,1340,660,13,13,7,174,434,13,79,0,0
2082,1182,223,1354,663,13,13,7,172,440,14,79,0,0
2083,1186,211,1352,636,13,13,7,166,425,15,79,0,0
2084,1223,209,1384,629,13,13,7,161,420,16,79,0,0
2085,1240,198,1393,605,13,13,7,153,407,17,79,0,0
2086,1256,196,1404,591,13,13,7,148,395,18,79,0,0
2087,1275,191,1415,570,13,13,7,140,379,19,79,0,0
2088,1295,183,1432,557,13,13,7,137,374,20,79,0,0
2089,1309,178,1443,550,13,13,7,134,372,21,79,0,0
2090,1321,174,1451,545,13,13,7,130,371,22,79,0,0
2091,1330,171,1452,523,13,13,7,122,352,23,79,0,0
2092,1339,166,1454,503,13,13,7,115,337,24,79,0,0
2093,1348,165,1460,495,13,13,7,112,330,25,79,0,0
2094,1358,163,1468,487,13,13,7,110,324,26,79,0,0
2095,1367,164,1474,480,13,13,7,107,316,27,79,0,0
2096,1371,160,1477,479,13,13,7,106,319,28,79,0,0
2097,1373,158,1478,475,13,13,7,105,317,29,79,0,0
2098,1369,152,1475,474,13,13,7,106,322,30,79,0,0
2099,1368,151,1471,467,13,13,7,103,316,31,79,0,0
2100,1365,149,1468,467,13,13,7,103,318,32,79,0,0
2101,1366,149,1468,466,13,13,7,102,317,33,79,0,0
2102,1367,149,1468,467,13,13,7,101,318,34,79,0,0
2103,1369,148,1469,468,13,13,7,100,320,35,79,0,0
2104,1370,149,1469,467,13,13,7,99,318,36,79,0,0
2105,1370,149,1469,467,13,13,7,99,318,37,79,0,0
2106,1370,149,1468,466,13,13,7,98,317,38,79,0,0
2107,1370,149,1467,465,13,13,7,97,316,39,79,0,0
2108,1371,149,1467,464,13,13,7,96,315,40,79,0,0
2109,1375,152,1470,465,13,13,7,95,313,41,79,0,0
2110,1377,153,1472,465,13,13,7,95,312,42,79,0,0
2111,1381,154,1476,472,13,13,7,95,318,43,79,0,0
2112,1387,163,1479,478,13,13,7,92,315,44,79,0,0
2113,1393,165,1484,481,13,13,7,91,316,45,79,0,0
2114,1394,168,1485,480,13,13,7,91,312,46,79,0,0
2115,1386,172,1480,485,13,13,7,94,313,47,79,0,0
2116,1378,174,1474,491,13,13,7,96,317,48,79,0,0
2117,1368,173,1467,498,13,13,7,99,325,49,79,0,0
2118,1354,171,1458,505,13,13,7,104,334,50,79,0,0
2119,1342,173,1452,522,13,13,7,110,349,51,79,0,0
2120,1333,181,1451,549,13,13,7,118,368,52,79,0,0
2121,1331,184,1453,562,13,13,7,122,378,53,79,0,0
2122,1325,190,1450,574,13,13,7,125,384,54,79,0,0
2123,1318,200,1446,590,13,13,7,128,390,55,79,0,0
2124,1305,201,1436,602,13,13,7,131,401,56,79,0,0
2125,1295,208,1435,631,13,13,7,140,423,57,79,0,0
2126,1286,221,1433,664,13,13,7,147,443,58,79,0,0
2127,1282,229,1433,681,13,13,7,151,452,59,79,0,0
2128,1271,240,1430,703,13,13,7,159,463,60,79,0,0
2129,1256,257,1420,730,13,13,7,164,473,61,79,0,0
2130,1240,268,1410,751,13,13,7,170,483,62,79,0,0
2131,1213,287,1395,794,13,13,7,182,507,63,79,0,0
2132,1186,301,1385,840,13,13,7,199,539,64,79,0,0
2133,1162,313,1372,864,13,13,7,210,551,65,79,0,0
2134,1131,327,1356,908,13,13,7,225,581,66,79,0,0
2135,1086,343,1325,945,13,13,7,239,602,67,79,0,0
2136,1046,358,1297,967,13,13,7,251,609,68,79,0,0
2137,1015,386,1287,1042,13,13,7,272,656,69,79,0,0
2138,999,416,1273,1075,13,13,7,274,659,70,79,0,0
2139,975,442,1242,1080,13,13,7,267,638,71,79,0,0
2140,939,477,1194,1080,13,13,7,255,603,72,79,0,0
2141,876,507,1123,1080,13,13,7,247,573,73,79,0,0
2142,812,546,1051,1080,13,13,7,239,534,74,79,0,0
2143,758,614,981,1080,13,13,7,223,466,75,79,0,0
2144,691,683,897,1080,13,13,7,206,397,76,79,0,0
2145,616,760,799,1080,13,13,7,183,320,77,79,0,0
2146,497,858,649,1080,13,13,7,152,222,78,79,0,0
2147,447,910,571,1080,13,13,7,124,170,79,79,1,0
2083,1263,219,1370,469,14,13,7,107,250,0,0,0,0
2161,11,310,48,572,17,13,7,37,262,0,71,0,1
2162,10,301,50,577,17,13,7,40,276,1,71,0,0
2163,9,293,52,584,17,13,7,43,291,2,71,0,0
2164,11,280,58,584,17,13,7,47,304,3,71,0,0
2165,14,274,64,585,17,13,7,50,311,4,71,0,0
2166,18,278,72,588,17,13,7,54,310,5,71,0,0
2167,25,280,85,588,17,13,7,60,308,6,71,0,0
2168,40,280,108,591,17,13,7,68,311,7,71,0,0
2169,44,282,118,591,17,13,7,74,309,8,71,0,0
2170,47,277,126,591,17,13,7,79,314,9,71,0,0
2171,46,272,132,599,17,13,7,86,327,10,71,0,0
2172,49,269,140,602,17,13,7,91,333,11,71,0,0
2173,52,268,147,604,17,13,7,95,336,12,71,0,0
2174,59,270,158,611,17,13,7,99,341,13,71,0,0
2175,66,270,171,614,17,13,7,105,344,14,71,0,0
2176,75,280,183,616,17,13,7,108,336,15,71,0,0
2177,77,287,189,624,17,13,7,112,337,16,71,0,0
2178,76,286,192,626,17,13,7,116,340,17,71,0,0
2179,75,281,198,639,17,13,7,123,358,18,71,0,0
2180,75,286,205,661,17,13,7,130,375,19,71,0,0
2181,75,290,207,669,17,13,7,132,379,20,71,0,0
2182,77,294,213,675,17,13,7,136,381,21,71,0,0
2183,84,296,226,685,17,13,7,142,389,22,71,0,0
2184,93,298,244,696,17,13,7,151,398,23,71,0,0
2185,98,301,253,702,17,13,7,155,401,24,71,0,0
2186,102,301,261,710,17,13,7,159,409,25,71,0,0
2187,100,300,268,737,17,13,7,168,437,26,71,0,0
2188,101,304,274,759,17,13,7,173,455,27,71,0,0
2189,103,312,277,767,17,13,7,174,455,28,71,0,0
2190,108,316,282,770,17,13,7,174,454,29,71,0,0
2191,124,321,302,771,17,13,7,178,450,30,71,0,0
2192,138,330,323,782,17,13,7,185,452,31,71,0,0
2193,143,328,333,787,17,13,7,190,459,32,71,0,0
2194,148,322,347,803,17,13,7,199,481,33,71,0,0
2195,150,320,360,831,17,13,7,210,511,34,71,0,0
2196,162,332,373,846,17,13,7,211,514,35,71,0,0
2197,172,343,384,859,17,13,7,212,516,36,71,0,0
2198,183,345,396,862,17,13,7,213,517,37,71,0,0
2199,216,347,436,869,17,13,7,220,522,38,71,0,0
2200,243,353,471,881,17,13,7,228,528,39,71,0,0
2201,261,349,493,882,17,13,7,232,533,40,71,0,0
2202,273,348,513,904,17,13,7,240,556,41,71,0,0
2203,291,353,540,931,17,13,7,249,578,42,71,0,0
2204,314,360,567,944,17,13,7,253,584,43,71,0,0
2205,331,368,581,947,17,13,7,250,579,44,71,0,0
2206,350,371,604,955,17,13,7,254,584,45,71,0,0
2207,389,379,649,965,17,13,7,260,586,46,71,0,0
2208,420,389,686,979,17,13,7,266,590,47,71,0,0
2209,440,384,709,985,17,13,7,269,601,48,71,0,0
2210,456,380,740,1022,17,13,7,284,642,49,71,0,0
2211,486,385,776,1051,17,13,7,290,666,50,71,0,0
2212,529,401,818,1066,17,13,7,289,665,51,71,0,0
2213,569,401,859,1074,17,13,7,290,673,52,71,0,0
2214,635,412,923,1074,17,13,7,288,662,53,71,0,0
2215,702,436,983,1080,17,13,7,281,644,54,71,0,0
2216,751,431,1033,1078,17,13,7,282,647,55,71,0,0
2217,822,434,1100,1076,17,13,7,278,642,56,71,0,0
2218,878,440,1151,1075,17,13,7,273,635,57,71,0,0
2219,930,462,1194,1075,17,13,7,264,613,58,71,0,0
2220,999,466,1270,1078,17,13,7,271,612,59,71,0,0
2221,1084,481,1355,1077,17,13,7,271,596,60,71,0,0
2222,1148,497,1418,1072,17,13,7,270,575,61,71,0,0
2223,1207,507,1482,1075,17,13,7,275,568,62,71,0,0
2224,1290,505,1564,1060,17,13,7,274,555,63,71,0,0
2225,1365,512,1629,1030,17,13,7,264,518,64,71,0,0
2226,1415,533,1679,1044,17,13,7,264,511,65,71,0,0
2227,1477,553,1746,1056,17,13,7,269,503,66,71,0,0
2228,1543,570,1814,1064,17,13,7,271,494,67,71,0,0
2229,1604,587,1875,1067,17,13,7,271,480,68,71,0,0
2230,1633,624,1891,1073,17,13,7,258,449,69,71,0,0
2231,1684,642,1920,1071,17,13,7,236,429,70,71,0,0
2232,1740,658,1920,1073,17,13,7,180,415,71,71,1,0
2255,1624,91,1659,198,18,13,7,35,107,0,72,0,1
2256,1623,94,1659,202,18,13,7,36,108,1,72,0,0
2257,1622,93,1659,204,18,13,7,37,111,2,72,0,0
2258,1621,95,1658,206,18,13,7,37,111,3,72,0,0
2259,1620,96,1657,207,18,13,7,37,111,4,72,0,0
2260,1616,90,1656,212,18,13,7,40,122,5,72,0,0
2261,1615,96,1655,216,18,13,7,40,120,6,72,0,0
2262,1614,95,1655,219,18,13,7,41,124,7,72,0,0
2263,1612,94,1655,225,18,13,7,43,131,8,72,0,0
2264,1609,98,1652,229,18,13,7,43,131,9,72,0,0
2265,1605,89,1651,232,18,13,7,46,143,10,72,0,0
2266,1604,95,1651,236,18,13,7,47,141,11,72,0,0
2267,1606,99,1652,239,18,13,7,46,140,12,72,0,0
2268,1605,98,1653,243,18,13,7,48,145,13,72,0,0
2269,1605,104,1653,251,18,13,7,48,147,14,72,0,0
2270,1601,99,1651,254,18,13,7,50,155,15,72,0,0
2271,1599,98,1652,259,18,13,7,53,161,16,72,0,0
2272,1600,102,1655,265,18,13,7,55,163,17,72,0,0
2273,1597,101,1653,267,18,13,7,56,166,18,72,0,0
2274,1596,106,1652,273,18,13,7,56,167,19,72,0,0
2275,1593,105,1650,277,18,13,7,57,172,20,72,0,0
2276,1591,107,1651,287,18,13,7,60,180,21,72,0,0
2277,1589,108,1651,294,18,13,7,62,186,22,72,0,0
2278,1588,106,1651,297,18,13,7,63,191,23,72,0,0
2279,1584,106,1650,305,18,13,7,66,199,24,72,0,0
2280,1578,108,1646,311,18,13,7,68,203,25,72,0,0
2281,1574,111,1643,319,18,13,7,69,208,26,72,0,0
2282,1572,110,1645,331,18,13,7,73,221,27,72,0,0
2283,1569,110,1644,335,18,13,7,75,225,28,72,0,0
2284,1563,113,1641,345,18,13,7,78,232,29,72,0,0
2285,1556,116,1636,356,18,13,7,80,240,30,72,0,0
2286,1552,115,1634,360,18,13,7,82,245,31,72,0,0
2287,1551,120,1636,372,18,13,7,85,252,32,72,0,0
2288,1549,125,1636,384,18,13,7,87,259,33,72,0,0
2289,1545,122,1636,394,18,13,7,91,272,34,72,0,0
2290,1542,130,1634,407,18,13,7,92,277,35,72,0,0
2291,1534,133,1629,417,18,13,7,95,284,36,72,0,0
2292,1529,135,1631,440,18,13,7,102,305,37,72,0,0
2293,1526,144,1632,457,18,13,7,106,313,38,72,0,0
2294,1517,144,1627,469,18,13,7,110,325,39,72,0,0
2295,1503,155,1616,490,18,13,7,113,335,40,72,0,0
2296,1490,155,1608,500,18,13,7,118,345,41,72,0,0
2297,1478,160,1604,524,18,13,7,126,364,42,72,0,0
2298,1470,170,1604,553,18,13,7,134,383,43,72,0,0
2299,1460,171,1598,566,18,13,7,138,395,44,72,0,0
2300,1440,186,1585,603,18,13,7,145,417,45,72,0,0
2301,1418,196,1567,625,18,13,7,149,429,46,72,0,0
2302,1394,200,1558,663,18,13,7,164,463,47,72,0,0
2303,1366,215,1542,704,18,13,7,176,489,48,72,0,0
2304,1324,211,1506,722,18,13,7,182,511,49,72,0,0
2305,1262,227,1456,761,18,13,7,194,534,50,72,0,0
2306,1219,237,1418,783,18,13,7,199,546,51,72,0,0
2307,1147,238,1364,832,18,13,7,217,594,52,72,0,0
2308,1066,260,1296,881,18,13,7,230,621,53,72,0,0
2309,987,271,1219,898,18,13,7,232,627,54,72,0,0
2310,874,276,1118,907,18,13,7,244,631,55,72,0,0
2311,782,287,1032,903,18,13,7,250,616,56,72,0,0
2312,679,286,932,922,18,13,7,253,636,57,72,0,0
2313,593,300,843,908,18,13,7,250,608,58,72,0,0
2314,492,315,737,898,18,13,7,245,583,59,72,0,0
2315,368,315,616,889,18,13,7,248,574,60,72,0,0
2316,291,324,539,878,18,13,7,248,554,61,72,0,0
2317,217,311,451,845,18,13,7,234,534,62,72,0,0
2318,180,316,401,817,18,13,7,221,501,63,72,0,0
2319,143,322,353,791,18,13,7,210,469,64,72,0,0
2320,79,306,284,770,18,13,7,205,464,65,72,0,0
2321,49,311,245,757,18,13,7,196,446,66,72,0,0
2322,17,309,197,724,18,13,7,180,415,67,72,0,0
2323,1,309,170,697,18,13,7,169,388,68,72,0,0
2324,0,339,146,679,18,13,7,146,340,69,72,0,0
2325,0,343,110,665,18,13,7,110,322,70,72,0,0
2326,0,358,89,661,18,13,7,89,303,71,72,0,0
2327,0,366,48,650,18,13,7,48,284,72,72,1,0
2230,1819,615,1920,948,19,13,7,101,333,0,0,0,0
2322,24,369,73,538,20,13,7,49,169,0,0,0,0
2522,15,284,55,596,22,13,7,40,312,0,31,0,1
2523,15,276,59,616,22,13,7,44,340,1,31,0,0
2524,16,282,64,638,22,13,7,48,356,2,31,0,0
2525,21,283,73,646,22,13,7,52,363,3,31,0,0
2526,39,287,100,655,22,13,7,61,368,4,31,0,0
2527,49,294,117,666,22,13,7,68,372,5,31,0,0
2528,53,290,130,682,22,13,7,77,392,6,31,0,0
2529,62,301,149,713,22,13,7,87,412,7,31,0,0
2530,71,305,166,733,22,13,7,95,428,8,31,0,0
2531,93,307,198,743,22,13,7,105,436,9,31,0,0
2532,116,315,234,764,22,13,7,118,449,10,31,0,0
2533,129,317,257,778,22,13,7,128,461,11,31,0,0
2534,140,328,283,829,22,13,7,143,501,12,31,0,0
2535,159,339,311,856,22,13,7,152,517,13,31,0,0
2536,180,342,342,872,22,13,7,162,530,14,31,0,0
2537,227,350,405,895,22,13,7,178,545,15,31,0,0
2538,261,353,454,919,22,13,7,193,566,16,31,0,0
2539,282,362,488,960,22,13,7,206,598,17,31,0,0
2540,332,380,559,1016,22,13,7,227,636,18,31,0,0
2541,370,393,603,1039,22,13,7,233,646,19,31,0,0
2542,450,393,702,1057,22,13,7,252,664,20,31,0,0
2543,530,404,795,1072,22,13,7,265,668,21,31,0,0
2544,587,412,854,1079,22,13,7,267,667,22,31,0,0
2545,674,436,937,1080,22,13,7,263,644,23,31,0,0
2546,785,461,1043,1080,22,13,7,258,619,24,31,0,0
2547,910,475,1169,1080,22,13,7,259,605,25,31,0,0
2548,1051,510,1301,1079,22,13,7,250,569,26,31,0,0
2549,1202,517,1456,1078,22,13,7,254,561,27,31,0,0
2550,1342,534,1598,1074,22,13,7,256,540,28,31,0,0
2551,1488,573,1744,1079,22,13,7,256,506,29,31,0,0
2552,1634,610,1873,1078,22,13,7,239,468,30,31,0,0
2553,1734,628,1920,1080,22,13,7,186,452,31,31,1,0
2706,1625,108,1660,225,24,13,7,35,117,0,59,0,1
2707,1624,110,1660,234,24,13,7,36,124,1,59,0,0
2708,1623,112,1659,237,24,13,7,36,125,2,59,0,0
2709,1618,110,1658,244,24,13,7,40,134,3,59,0,0
2710,1615,109,1655,245,24,13,7,40,136,4,59,0,0
2711,1611,110,1653,254,24,13,7,42,144,5,59,0,0
2712,1608,110,1651,256,24,13,7,43,146,6,59,0,0
2713,1606,109,1649,258,24,13,7,43,149,7,59,0,0
2714,1604,117,1646,259,24,13,7,42,142,8,59,0,0
2715,1601,120,1644,261,24,13,7,43,141,9,59,0,0
2716,1597,122,1642,270,24,13,7,45,148,10,59,0,0
2717,1594,124,1641,273,24,13,7,47,149,11,59,0,0
2718,1590,125,1639,282,24,13,7,49,157,12,59,0,0
2719,1585,125,1637,292,24,13,7,52,167,13,59,0,0
2720,1580,124,1635,298,24,13,7,55,174,14,59,0,0
2721,1576,124,1635,312,24,13,7,59,188,15,59,0,0
2722,1572,122,1633,316,24,13,7,61,194,16,59,0,0
2723,1568,127,1630,324,24,13,7,62,197,17,59,0,0
2724,1563,131,1626,333,24,13,7,63,202,18,59,0,0
2725,1560,136,1624,341,24,13,7,64,205,19,59,0,0
2726,1557,140,1624,351,24,13,7,67,211,20,59,0,0
2727,1554,139,1624,358,24,13,7,70,219,21,59,0,0
2728,1549,143,1622,373,24,13,7,73,230,22,59,0,0
2729,1543,146,1619,385,24,13,7,76,239,23,59,0,0
2730,1535,148,1616,405,24,13,7,81,257,24,59,0,0
2731,1528,148,1612,417,24,13,7,84,269,25,59,0,0
2732,1519,153,1606,427,24,13,7,87,274,26,59,0,0
2733,1510,160,1600,443,24,13,7,90,283,27,59,0,0
2734,1504,164,1597,456,24,13,7,93,292,28,59,0,0
2735,1496,171,1594,478,24,13,7,98,307,29,59,0,0
2736,1489,175,1589,490,24,13,7,100,315,30,59,0,0
2737,1471,185,1578,517,24,13,7,107,332,31,59,0,0
2738,1456,189,1569,532,24,13,7,113,343,32,59,0,0
2739,1438,194,1559,559,24,13,7,121,365,33,59,0,0
2740,1418,208,1543,590,24,13,7,125,382,34,59,0,0
2741,1391,216,1520,607,24,13,7,129,391,35,59,0,0
2742,1353,230,1493,646,24,13,7,140,416,36,59,0,0
2743,1316,238,1465,677,24,13,7,149,439,37,59,0,0
2744,1274,256,1435,725,24,13,7,161,469,38,59,0,0
2745,1235,267,1404,762,24,13,7,169,495,39,59,0,0
2746,1167,276,1349,797,24,13,7,182,521,40,59,0,0
2747,1087,296,1282,842,24,13,7,195,546,41,59,0,0
2748,1005,299,1208,869,24,13,7,203,570,42,59,0,0
2749,893,320,1099,889,24,13,7,206,569,43,59,0,0
2750,781,327,985,890,24,13,7,204,563,44,59,0,0
2751,688,340,892,895,24,13,7,204,555,45,59,0,0
2752,592,342,798,883,24,13,7,206,541,46,59,0,0
2753,475,342,675,875,24,13,7,200,533,47,59,0,0
2754,402,359,599,861,24,13,7,197,502,48,59,0,0
2755,303,352,489,829,24,13,7,186,477,49,59,0,0
2756,231,348,411,809,24,13,7,180,461,50,59,0,0
2757,168,339,339,782,24,13,7,171,443,51,59,0,0
2758,121,327,287,759,24,13,7,166,432,52,59,0,0
2759,86,337,243,739,24,13,7,157,402,53,59,0,0
2760,41,342,184,710,24,13,7,143,368,54,59,0,0
2761,10,338,149,697,24,13,7,139,359,55,59,0,0
2762,0,331,115,679,24,13,7,115,348,56,59,0,0
2763,0,334,99,663,24,13,7,99,329,57,59,0,0
2764,0,356,73,635,24,13,7,73,279,58,59,0,0
2765,0,369,56,631,24,13,7,56,262,59,59,1,0
3183,1748,569,1920,1068,25,13,7,172,499,0,1,0,0
3184,1697,550,1865,1035,25,13,7,168,485,1,1,0,0
3185,1554,562,1773,1065,26,13,7,219,503,0,31,0,1
3186,1460,546,1685,1061,26,13,7,225,515,1,31,0,0
3187,1352,523,1590,1067,26,13,7,238,544,2,31,0,0
3188,1213,498,1465,1074,26,13,7,252,576,3,31,0,0
3189,1088,469,1353,1079,26,13,7,265,610,4,31,0,0
3190,971,437,1250,1080,26,13,7,279,643,5,31,0,0
3191,871,423,1159,1075,26,13,7,288,652,6,31,0,0
3192,776,406,1072,1073,26,13,7,296,667,7,31,0,0
3193,665,401,963,1067,26,13,7,298,666,8,31,0,0
3194,595,390,906,1070,26,13,7,311,680,9,31,0,0
3195,528,374,819,1011,26,13,7,291,637,10,31,0,0
3196,478,365,754,966,26,13,7,276,601,11,31,0,0
3197,442,379,708,942,26,13,7,266,563,12,31,0,0
3198,369,378,624,912,26,13,7,255,534,13,31,0,0
3199,313,372,565,899,26,13,7,252,527,14,31,0,0
3200,283,369,535,890,26,13,7,252,521,15,31,0,0
3201,228,351,463,846,26,13,7,235,495,16,31,0,0
3202,199,348,422,818,26,13,7,223,470,17,31,0,0
3203,174,344,398,808,26,13,7,224,464,18,31,0,0
3204,128,344,342,784,26,13,7,214,440,19,31,0,0
3205,92,340,302,775,26,13,7,210,435,20,31,0,0
3206,74,339,284,775,26,13,7,210,436,21,31,0,0
3207,48,334,243,747,26,13,7,195,413,22,31,0,0
3208,39,341,218,721,26,13,7,179,380,23,31,0,0
3209,28,352,200,713,26,13,7,172,361,24,31,0,0
3210,0,344,165,697,26,13,7,165,353,25,31,0,0
3211,0,355,134,690,26,13,7,134,335,26,31,0,0
3212,0,356,126,692,26,13,7,126,336,27,31,0,0
3213,0,344,104,669,26,13,7,104,325,28,31,0,0
3214,0,314,97,652,26,13,7,97,338,29,31,0,0
3215,0,304,96,652,26,13,7,96,348,30,31,0,0
3216,0,297,71,639,26,13,7,71,342,31,31,1,0
3216,0,378,50,627,27,13,7,50,249,0,0,0,0
3735,1604,82,1639,175,33,13,7,35,93,0,77,0,0
3737,1605,80,1640,179,33,13,7,35,99,0,77,0,0
3746,1589,92,1624,191,33,13,7,35,99,0,77,0,1
3747,1586,91,1623,195,33,13,7,37,104,1,77,0,0
3748,1586,90,1623,194,33,13,7,37,104,2,77,0,0
3749,1585,90,1623,199,33,13,7,38,109,3,77,0,0
3750,1583,90,1622,201,33,13,7,39,111,4,77,0,0
3751,1580,87,1622,206,33,13,7,42,119,5,77,0,0
3752,1579,87,1621,208,33,13,7,42,121,6,77,0,0
3753,1579,88,1619,204,33,13,7,40,116,7,77,0,0
3754,1577,87,1620,213,33,13,7,43,126,8,77,0,0
3755,1577,89,1619,215,33,13,7,42,126,9,77,0,0
3756,1576,89,1618,215,33,13,7,42,126,10,77,0,0
3757,1574,90,1617,220,33,13,7,43,130,11,77,0,0
3758,1572,91,1616,222,33,13,7,44,131,12,77,0,0
3759,1571,91,1615,223,33,13,7,44,132,13,77,0,0
3760,1571,93,1614,225,33,13,7,43,132,14,77,0,0
3761,1570,94,1614,226,33,13,7,44,132,15,77,0,0
3762,1567,95,1611,228,33,13,7,44,133,16,77,0,0
3763,1565,98,1610,234,33,13,7,45,136,17,77,0,0
3764,1566,100,1610,231,33,13,7,44,131,18,77,0,0
3765,1565,99,1610,232,33,13,7,45,133,19,77,0,0
3766,1562,95,1612,243,33,13,7,50,148,20,77,0,0
3767,1558,97,1608,246,33,13,7,50,149,21,77,0,0
3768,1554,97,1605,247,33,13,7,51,150,22,77,0,0
3769,1550,98,1603,255,33,13,7,53,157,23,77,0,0
3770,1550,99,1603,257,33,13,7,53,158,24,77,0,0
3771,1550,105,1603,263,33,13,7,53,158,25,77,0,0
3772,1548,109,1601,264,33,13,7,53,155,26,77,0,0
3773,1543,108,1596,267,33,13,7,53,159,27,77,0,0
3774,1540,110,1593,270,33,13,7,53,160,28,77,0,0
3775,1538,113,1591,269,33,13,7,53,156,29,77,0,0
3776,1536,112,1591,275,33,13,7,55,163,30,77,0,0
3777,1532,115,1589,286,33,13,7,57,171,31,77,0,0
3778,1527,115,1587,291,33,13,7,60,176,32,77,0,0
3779,1523,113,1586,296,33,13,7,63,183,33,77,0,0
3780,1519,114,1583,303,33,13,7,64,189,34,77,0,0
3781,1517,114,1582,305,33,13,7,65,191,35,77,0,0
3782,1515,115,1584,314,33,13,7,69,199,36,77,0,0
3783,1512,119,1581,322,33,13,7,69,203,37,77,0,0
3784,1504,118,1576,328,33,13,7,72,210,38,77,0,0
3785,1499,118,1571,332,33,13,7,72,214,39,77,0,0
3786,1495,119,1568,336,33,13,7,73,217,40,77,0,0
3787,1492,121,1566,340,33,13,7,74,219,41,77,0,0
3788,1489,127,1566,354,33,13,7,77,227,42,77,0,0
3789,1484,129,1561,357,33,13,7,77,228,43,77,0,0
3790,1476,130,1555,364,33,13,7,79,234,44,77,0,0
3791,1473,137,1550,364,33,13,7,77,227,45,77,0,0
3792,1467,139,1549,378,33,13,7,82,239,46,77,0,0
3793,1466,142,1550,388,33,13,7,84,246,47,77,0,0
3794,1461,146,1547,399,33,13,7,86,253,48,77,0,0
3795,1453,144,1542,408,33,13,7,89,264,49,77,0,0
3796,1448,152,1540,421,33,13,7,92,269,50,77,0,0
3797,1443,154,1537,430,33,13,7,94,276,51,77,0,0
3798,1441,159,1537,439,33,13,7,96,280,52,77,0,0
3799,1435,171,1535,460,33,13,7,100,289,53,77,0,0
3800,1426,172,1529,470,33,13,7,103,298,54,77,0,0
3801,1413,171,1520,482,33,13,7,107,311,55,77,0,0
3802,1404,180,1515,502,33,13,7,111,322,56,77,0,0
3803,1399,183,1512,514,33,13,7,113,331,57,77,0,0
3804,1385,190,1501,526,33,13,7,116,336,58,77,0,0
3805,1361,199,1481,548,33,13,7,120,349,59,77,0,0
3806,1341,192,1468,561,33,13,7,127,369,60,77,0,0
3807,1311,199,1448,592,33,13,7,137,393,61,77,0,0
3808,1294,209,1436,617,33,13,7,142,408,62,77,0,0
3809,1282,215,1426,632,33,13,7,144,417,63,77,0,0
3810,1254,228,1406,660,33,13,7,152,432,64,77,0,0
3811,1232,240,1385,679,33,13,7,153,439,65,77,0,0
3812,1196,247,1357,706,33,13,7,161,459,66,77,0,0
3813,1155,266,1331,756,33,13,7,176,490,67,77,0,0
3814,1138,282,1316,778,33,13,7,178,496,68,77,0,0
3815,1105,307,1280,799,33,13,7,175,492,69,77,0,0
3816,1112,310,1240,653,33,13,7,128,343,70,77,0,0
3817,1040,316,1229,831,33,13,7,189,515,71,77,0,0
3818,978,311,1184,877,33,13,7,206,566,72,77,0,0
3819,913,324,1124,905,33,13,7,211,581,73,77,0,0
3820,868,339,1070,908,33,13,7,202,569,74,77,0,0
3821,805,355,992,888,33,13,7,187,533,75,77,0,0
3822,737,358,912,872,33,13,7,175,514,76,77,0,0
3823,699,366,878,891,33,13,7,179,525,77,77,1,0
3825,604,338,794,876,33,13,7,190,538,0,77,0,1
3826,556,333,737,831,33,13,7,181,498,1,77,0,0
3827,489,327,667,812,33,13,7,178,485,2,77,0,0
3828,447,326,628,805,33,13,7,181,479,3,77,0,0
3829,394,313,571,775,33,13,7,177,462,4,77,0,0
3830,348,308,522,756,33,13,7,174,448,5,77,0,0
3831,316,320,488,739,33,13,7,172,419,6,77,0,0
3832,262,309,439,728,33,13,7,177,419,7,77,0,0
3833,211,303,386,715,33,13,7,175,412,8,77,0,0
3834,182,310,356,710,33,13,7,174,400,9,77,0,0
3835,137,310,303,697,33,13,7,166,387,10,77,0,0
3836,109,303,273,690,33,13,7,164,387,11,77,0,0
3837,90,306,251,676,33,13,7,161,370,12,77,0,0
3838,57,299,213,661,33,13,7,156,362,13,77,0,0
3839,32,299,186,656,33,13,7,154,357,14,77,0,0
3840,19,293,168,642,33,13,7,149,349,15,77,0,0
3841,5,289,145,625,33,13,7,140,336,16,77,0,0
3842,4,300,132,604,33,13,7,128,304,17,77,0,0
3843,0,296,117,587,33,13,7,117,291,18,77,0,0
3844,0,293,100,573,33,13,7,100,280,19,77,0,0
3845,0,292,91,568,33,13,7,91,276,20,77,0,0
3846,0,276,80,547,33,13,7,80,271,21,77,0,0
3847,0,295,68,534,33,13,7,68,239,22,77,0,0
3848,0,295,47,521,33,13,7,47,226,23,77,0,0
3849,0,310,49,518,33,13,7,49,208,24,77,0,0
3695,1671,51,1706,145,39,13,7,35,94,0,51,0,0
3715,1665,60,1700,162,39,13,7,35,102,0,51,0,0
3716,1665,60,1700,163,39,13,7,35,103,1,51,0,0
3722,1663,68,1698,167,39,13,7,35,99,0,51,0,0
3723,1664,72,1699,168,39,13,7,35,96,1,51,0,0
3725,1662,65,1701,172,39,13,7,39,107,0,51,0,0
3726,1664,70,1703,175,39,13,7,39,105,1,51,0,0
3727,1661,72,1700,174,39,13,7,39,102,2,51,0,0
3728,1667,77,1704,177,39,13,7,37,100,3,51,0,0
3729,1668,75,1707,179,39,13,7,39,104,4,51,0,0
3730,1672,77,1709,180,39,13,7,37,103,5,51,0,0
3731,1664,74,1702,180,39,13,7,38,106,6,51,0,0
3733,1659,78,1696,180,39,13,7,37,102,0,51,0,0
3758,1619,111,1655,225,39,13,7,36,114,0,51,0,1
3759,1621,111,1656,225,39,13,7,35,114,1,51,0,0
3760,1622,110,1659,227,39,13,7,37,117,2,51,0,0
3761,1623,109,1660,228,39,13,7,37,119,3,51,0,0
3762,1622,110,1659,229,39,13,7,37,119,4,51,0,0
3763,1620,111,1658,230,39,13,7,38,119,5,51,0,0
3764,1619,115,1657,232,39,13,7,38,117,6,51,0,0
3765,1614,114,1655,240,39,13,7,41,126,7,51,0,0
3766,1612,110,1655,244,39,13,7,43,134,8,51,0,0
3767,1611,114,1653,245,39,13,7,42,131,9,51,0,0
3768,1612,120,1654,248,39,13,7,42,128,10,51,0,0
3769,1613,115,1657,255,39,13,7,44,140,11,51,0,0
3770,1613,116,1660,263,39,13,7,47,147,12,51,0,0
3771,1613,117,1661,266,39,13,7,48,149,13,51,0,0
3772,1613,117,1661,268,39,13,7,48,151,14,51,0,0
3773,1614,119,1662,271,39,13,7,48,152,15,51,0,0
3774,1614,120,1663,275,39,13,7,49,155,16,51,0,0
3775,1612,119,1664,283,39,13,7,52,164,17,51,0,0
3776,1605,121,1660,292,39,13,7,55,171,18,51,0,0
3777,1599,118,1656,295,39,13,7,57,177,19,51,0,0
3778,1597,120,1651,293,39,13,7,54,173,20,51,0,0
3779,1595,126,1647,291,39,13,7,52,165,21,51,0,0
3780,1590,126,1647,300,39,13,7,57,174,22,51,0,0
3781,1586,124,1648,314,39,13,7,62,190,23,51,0,0
3782,1583,128,1646,322,39,13,7,63,194,24,51,0,0
3783,1582,128,1646,326,39,13,7,64,198,25,51,0,0
3784,1580,131,1646,337,39,13,7,66,206,26,51,0,0
3785,1582,134,1646,336,39,13,7,64,202,27,51,0,0
3786,1580,141,1645,343,39,13,7,65,202,28,51,0,0
3787,1575,141,1643,353,39,13,7,68,212,29,51,0,0
3788,1571,139,1641,360,39,13,7,70,221,30,51,0,0
3789,1569,142,1641,367,39,13,7,72,225,31,51,0,0
3790,1567,147,1639,373,39,13,7,72,226,32,51,0,0
3791,1562,149,1636,383,39,13,7,74,234,33,51,0,0
3792,1556,156,1632,395,39,13,7,76,239,34,51,0,0
3793,1551,158,1627,398,39,13,7,76,240,35,51,0,0
3794,1547,160,1625,405,39,13,7,78,245,36,51,0,0
3795,1547,164,1627,419,39,13,7,80,255,37,51,0,0
3796,1548,166,1628,421,39,13,7,80,255,38,51,0,0
3797,1545,171,1628,435,39,13,7,83,264,39,51,0,0
3798,1540,174,1628,454,39,13,7,88,280,40,51,0,0
3799,1537,179,1627,465,39,13,7,90,286,41,51,0,0
3800,1533,181,1628,489,39,13,7,95,308,42,51,0,0
3801,1534,185,1629,493,39,13,7,95,308,43,51,0,0
3802,1530,191,1627,504,39,13,7,97,313,44,51,0,0
3803,1521,197,1623,527,39,13,7,102,330,45,51,0,0
3804,1514,200,1619,539,39,13,7,105,339,46,51,0,0
3805,1506,213,1615,568,39,13,7,109,355,47,51,0,0
3806,1497,218,1610,584,39,13,7,113,366,48,51,0,0
3807,1483,220,1604,612,39,13,7,121,392,49,51,0,0
3808,1469,232,1594,638,39,13,7,125,406,50,51,0,0
3809,1463,237,1592,653,39,13,7,129,416,51,51,1,0
3754,1673,91,1708,235,44,13,7,35,144,0,65,0,1
3755,1671,92,1707,240,44,13,7,36,148,1,65,0,0
3756,1671,98,1706,240,44,13,7,35,142,2,65,0,0
3757,1670,99,1706,243,44,13,7,36,144,3,65,0,0
3758,1669,98,1705,243,44,13,7,36,145,4,65,0,0
3759,1666,100,1703,243,44,13,7,37,143,5,65,0,0
3760,1663,95,1702,244,44,13,7,39,149,6,65,0,0
3761,1660,98,1699,245,44,13,7,39,147,7,65,0,0
3762,1660,100,1700,247,44,13,7,40,147,8,65,0,0
3763,1661,99,1702,249,44,13,7,41,150,9,65,0,0
3764,1663,100,1704,251,44,13,7,41,151,10,65,0,0
3765,1662,101,1705,257,44,13,7,43,156,11,65,0,0
3766,1662,101,1706,261,44,13,7,44,160,12,65,0,0
3767,1663,108,1707,266,44,13,7,44,158,13,65,0,0
3768,1664,111,1709,271,44,13,7,45,160,14,65,0,0
3769,1665,111,1710,273,44,13,7,45,162,15,65,0,0
3770,1664,114,1709,272,44,13,7,45,158,16,65,0,0
3771,1661,113,1708,279,44,13,7,47,166,17,65,0,0
3772,1659,112,1709,288,44,13,7,50,176,18,65,0,0
3773,1658,115,1710,295,44,13,7,52,180,19,65,0,0
3774,1659,117,1712,301,44,13,7,53,184,20,65,0,0
3775,1660,116,1714,303,44,13,7,54,187,21,65,0,0
3776,1658,119,1713,308,44,13,7,55,189,22,65,0,0
3777,1656,119,1712,311,44,13,7,56,192,23,65,0,0
3778,1654,123,1712,319,44,13,7,58,196,24,65,0,0
3779,1653,128,1712,329,44,13,7,59,201,25,65,0,0
3780,1651,128,1711,333,44,13,7,60,205,26,65,0,0
3781,1649,130,1710,337,44,13,7,61,207,27,65,0,0
3782,1647,134,1708,342,44,13,7,61,208,28,65,0,0
3783,1644,133,1707,346,44,13,7,63,213,29,65,0,0
3784,1642,135,1708,357,44,13,7,66,222,30,65,0,0
3785,1641,138,1710,368,44,13,7,69,230,31,65,0,0
3786,1644,139,1714,371,44,13,7,70,232,32,65,0,0
3787,1646,144,1717,380,44,13,7,71,236,33,65,0,0
3788,1646,144,1719,394,44,13,7,73,250,34,65,0,0
3789,1646,144,1720,400,44,13,7,74,256,35,65,0,0
3790,1645,152,1720,412,44,13,7,75,260,36,65,0,0
3791,1647,160,1721,421,44,13,7,74,261,37,65,0,0
3792,1646,164,1721,432,44,13,7,75,268,38,65,0,0
3793,1643,171,1719,447,44,13,7,76,276,39,65,0,0
3794,1639,171,1717,456,44,13,7,78,285,40,65,0,0
3795,1632,172,1713,473,44,13,7,81,301,41,65,0,0
3796,1624,177,1709,492,44,13,7,85,315,42,65,0,0
3797,1619,177,1707,500,44,13,7,88,323,43,65,0,0
3798,1611,183,1703,515,44,13,7,92,332,44,65,0,0
3799,1603,187,1700,534,44,13,7,97,347,45,65,0,0
3800,1598,186,1699,545,44,13,7,101,359,46,65,0,0
3801,1587,197,1696,578,44,13,7,109,381,47,65,0,0
3802,1582,205,1696,601,44,13,7,114,396,48,65,0,0
3803,1579,210,1696,613,44,13,7,117,403,49,65,0,0
3804,1573,220,1698,650,44,13,7,125,430,50,65,0,0
3805,1566,226,1695,667,44,13,7,129,441,51,65,0,0
3806,1553,235,1691,705,44,13,7,138,470,52,65,0,0
3807,1543,255,1687,747,44,13,7,144,492,53,65,0,0
3808,1532,262,1681,768,44,13,7,149,506,54,65,0,0
3809,1497,269,1662,804,44,13,7,165,535,55,65,0,0
3810,1463,277,1640,842,44,13,7,177,565,56,65,0,0
3811,1428,282,1613,867,44,13,7,185,585,57,65,0,0
3812,1367,311,1570,934,44,13,7,203,623,58,65,0,0
3813,1310,337,1523,977,44,13,7,213,640,59,65,0,0
3814,1250,352,1466,993,44,13,7,216,641,60,65,0,0
3815,1139,357,1378,1042,44,13,7,239,685,61,65,0,0
3816,1058,362,1304,1066,44,13,7,246,704,62,65,0,0
3817,955,398,1198,1080,44,13,7,243,682,63,65,0,0
3818,852,442,1085,1079,44,13,7,233,637,64,65,0,0
3819,808,456,1044,1080,44,13,7,236,624,65,65,1,0
3810,1432,263,1561,571,48,13,7,129,308,0,0,0,0
3812,1479,272,1562,435,49,13,7,83,163,0,0,0,0
3813,1446,296,1535,598,50,13,7,89,302,0,12,0,0
3814,1393,299,1525,748,50,13,7,132,449,1,12,0,0
3815,1351,319,1506,843,50,13,7,155,524,2,12,0,0
3816,1304,346,1470,901,50,13,7,166,555,3,12,0,0
3817,1243,349,1416,927,50,13,7,173,578,4,12,0,0
3818,1160,356,1346,964,50,13,7,186,608,5,12,0,0
3819,1103,369,1291,970,50,13,7,188,601,6,12,0,0
3820,1014,376,1213,1014,50,13,7,199,638,7,12,0,0
3821,924,380,1133,1032,50,13,7,209,652,8,12,0,0
3822,825,388,1036,1044,50,13,7,211,656,9,12,0,0
3823,705,379,931,1057,50,13,7,226,678,10,12,0,0
3824,611,343,849,1037,50,13,7,238,694,11,12,0,0
3825,545,346,791,1066,50,13,7,246,720,12,12,0,0
3819,669,457,887,1074,51,13,7,218,617,0,13,0,0
3820,587,456,810,1077,51,13,7,223,621,1,13,0,0
3821,503,451,728,1071,51,13,7,225,620,2,13,0,0
3822,381,444,609,1070,51,13,7,228,626,3,13,0,0
3823,315,456,544,1067,51,13,7,229,611,4,13,0,0
3824,237,456,464,1047,51,13,7,227,591,5,13,0,0
3825,136,449,364,1035,51,13,7,228,586,6,13,0,0
3826,78,453,305,1024,51,13,7,227,571,7,13,0,0
3827,16,442,234,990,51,13,7,218,548,8,13,0,0
3828,0,441,189,952,51,13,7,189,511,9,13,0,0
3829,0,503,165,930,51,13,7,165,427,10,13,0,0
3830,0,500,125,887,51,13,7,125,387,11,13,0,0
3831,0,501,101,872,51,13,7,101,371,12,13,0,0
3832,0,507,50,851,51,13,7,50,344,13,13,0,0
3826,419,446,697,986,53,13,7,278,540,0,16,0,0
3827,325,421,605,967,53,13,7,280,546,1,16,0,0
3828,246,412,522,949,53,13,7,276,537,2,16,0,0
3829,189,417,448,922,53,13,7,259,505,3,16,0,0
3830,143,396,393,886,53,13,7,250,490,4,16,0,0
3831,118,387,363,868,53,13,7,245,481,5,16,0,0
3832,81,385,308,834,53,13,7,227,449,6,16,0,0
3833,47,373,265,813,53,13,7,218,440,7,16,0,0
3834,28,365,242,804,53,13,7,214,439,8,16,0,0
3835,15,351,211,759,53,13,7,196,408,9,16,0,0
3836,10,345,198,736,53,13,7,188,391,10,16,0,0
3837,0,346,165,714,53,13,7,165,368,11,16,0,0
3838,0,346,133,690,53,13,7,133,344,12,16,0,0
3839,0,340,120,684,53,13,7,120,344,13,16,0,0
3840,0,341,100,668,53,13,7,100,327,14,16,0,0
3841,0,391,87,657,53,13,7,87,266,15,16,0,0
3842,0,395,61,638,53,13,7,61,243,16,16,0,0
3956,1644,68,1680,178,56,13,7,36,110,0,91,0,0
3957,1644,69,1681,179,56,13,7,37,110,1,91,0,0
3958,1645,70,1681,180,56,13,7,36,110,2,91,0,0
3960,1645,73,1681,183,56,13,7,36,110,0,91,0,1
3961,1643,73,1680,187,56,13,7,37,114,1,91,0,0
3962,1642,72,1680,189,56,13,7,38,117,2,91,0,0
3963,1643,73,1681,191,56,13,7,38,118,3,91,0,0
3964,1645,81,1681,192,56,13,7,36,111,4,91,0,0
3965,1644,83,1680,194,56,13,7,36,111,5,91,0,0
3966,1644,84,1681,196,56,13,7,37,112,6,91,0,0
3967,1646,89,1682,199,56,13,7,36,110,7,91,0,0
3968,1647,86,1685,203,56,13,7,38,117,8,91,0,0
3969,1647,86,1686,206,56,13,7,39,120,9,91,0,0
3970,1647,89,1685,206,56,13,7,38,117,10,91,0,0
3971,1644,89,1684,210,56,13,7,40,121,11,91,0,0
3972,1642,90,1683,214,56,13,7,41,124,12,91,0,0
3973,1642,92,1683,214,56,13,7,41,122,13,91,0,0
3974,1642,91,1684,217,56,13,7,42,126,14,91,0,0
3975,1641,94,1683,219,56,13,7,42,125,15,91,0,0
3976,1639,94,1681,222,56,13,7,42,128,16,91,0,0
3977,1636,93,1681,228,56,13,7,45,135,17,91,0,0
3978,1635,95,1680,231,56,13,7,45,136,18,91,0,0
3979,1634,94,1679,231,56,13,7,45,137,19,91,0,0
3980,1634,97,1679,233,56,13,7,45,136,20,91,0,0
3981,1632,96,1677,233,56,13,7,45,137,21,91,0,0
3982,1628,94,1677,239,56,13,7,49,145,22,91,0,0
3983,1627,94,1677,242,56,13,7,50,148,23,91,0,0
3984,1627,94,1677,242,56,13,7,50,148,24,91,0,0
3985,1630,97,1680,246,56,13,7,50,149,25,91,0,0
3986,1629,99,1680,253,56,13,7,51,154,26,91,0,0
3987,1628,97,1683,257,56,13,7,55,160,27,91,0,0
3988,1627,98,1685,266,56,13,7,58,168,28,91,0,0
3989,1627,98,1688,271,56,13,7,61,173,29,91,0,0
3990,1630,98,1692,275,56,13,7,62,177,30,91,0,0
3991,1634,104,1695,279,56,13,7,61,175,31,91,0,0
3992,1634,106,1694,280,56,13,7,60,174,32,91,0,0
3993,1632,107,1695,286,56,13,7,63,179,33,91,0,0
3994,1632,111,1696,294,56,13,7,64,183,34,91,0,0
3995,1633,111,1699,298,56,13,7,66,187,35,91,0,0
3996,1635,113,1702,305,56,13,7,67,192,36,91,0,0
3997,1634,114,1701,310,56,13,7,67,196,37,91,0,0
3998,1630,112,1700,317,56,13,7,70,205,38,91,0,0
3999,1626,112,1700,328,56,13,7,74,216,39,91,0,0
4000,1626,113,1701,330,56,13,7,75,217,40,91,0,0
4001,1628,116,1704,338,56,13,7,76,222,41,91,0,0
4002,1632,122,1707,344,56,13,7,75,222,42,91,0,0
4003,1628,122,1706,349,56,13,7,78,227,43,91,0,0
4004,1626,127,1707,360,56,13,7,81,233,44,91,0,0
4005,1626,130,1709,370,56,13,7,83,240,45,91,0,0
4006,1626,131,1711,380,56,13,7,85,249,46,91,0,0
4007,1628,136,1715,396,56,13,7,87,260,47,91,0,0
4008,1625,138,1714,405,56,13,7,89,267,48,91,0,0
4009,1620,142,1711,417,56,13,7,91,275,49,91,0,0
4010,1613,147,1706,425,56,13,7,93,278,50,91,0,0
4011,1608,147,1703,430,56,13,7,95,283,51,91,0,0
4012,1601,153,1700,446,56,13,7,99,293,52,91,0,0
4013,1590,154,1692,459,56,13,7,102,305,53,91,0,0
4014,1572,151,1679,470,56,13,7,107,319,54,91,0,0
4015,1553,155,1665,486,56,13,7,112,331,55,91,0,0
4016,1542,153,1657,497,56,13,7,115,344,56,91,0,0
4017,1525,159,1642,506,56,13,7,117,347,57,91,0,0
4018,1505,164,1627,524,56,13,7,122,360,58,91,0,0
4019,1491,167,1615,531,56,13,7,124,364,59,91,0,0
4020,1470,172,1606,563,56,13,7,136,391,60,91,0,0
4021,1460,176,1604,588,56,13,7,144,412,61,91,0,0
4022,1453,186,1599,600,56,13,7,146,414,62,91,0,0
4023,1441,207,1590,624,56,13,7,149,417,63,91,0,0
4024,1425,214,1584,657,56,13,7,159,443,64,91,0,0
4025,1394,220,1566,694,56,13,7,172,474,65,91,0,0
4026,1373,230,1557,739,56,13,7,184,509,66,91,0,0
4027,1351,239,1538,760,56,13,7,187,521,67,91,0,0
4028,1298,256,1494,791,56,13,7,196,535,68,91,0,0
4029,1255,266,1459,824,56,13,7,204,558,69,91,0,0
4030,1209,265,1428,868,56,13,7,219,603,70,91,0,0
4031,1188,272,1413,891,56,13,7,225,619,71,91,0,0
4032,1085,288,1320,939,56,13,7,235,651,72,91,0,0
4033,997,301,1236,949,56,13,7,239,648,73,91,0,0
4034,913,306,1174,978,56,13,7,261,672,74,91,0,0
4035,816,321,1074,992,56,13,7,258,671,75,91,0,0
4036,701,334,971,1016,56,13,7,270,682,76,91,0,0
4037,610,332,887,1018,56,13,7,277,686,77,91,0,0
4038,493,341,769,1031,56,13,7,276,690,78,91,0,0
4039,411,356,689,1035,56,13,7,278,679,79,91,0,0
4040,310,378,563,994,56,13,7,253,616,80,91,0,0
4041,228,360,480,969,56,13,7,252,609,81,91,0,0
4042,175,362,423,947,56,13,7,248,585,82,91,0,0
4043,100,362,336,913,56,13,7,236,551,83,91,0,0
4044,63,378,288,894,56,13,7,225,516,84,91,0,0
4045,25,368,246,872,56,13,7,221,504,85,91,0,0
4046,0,353,193,824,56,13,7,193,471,86,91,0,0
4047,0,353,175,800,56,13,7,175,447,87,91,0,0
4048,0,377,142,769,56,13,7,142,392,88,91,0,0
4049,0,372,116,748,56,13,7,116,376,89,91,0,0
4050,0,373,99,739,56,13,7,99,366,90,91,0,0
4051,0,388,69,705,56,13,7,69,317,91,91,1,0
3963,1625,74,1660,187,57,13,7,35,113,0,3,0,0
3964,1625,78,1660,190,57,13,7,35,112,1,3,0,0
3965,1624,78,1660,191,57,13,7,36,113,2,3,0,0
3974,1598,93,1633,208,57,13,7,35,115,0,3,0,0
3975,1595,97,1631,212,57,13,7,36,115,1,3,0,0
3976,1594,100,1629,214,57,13,7,35,114,2,3,0,0
3977,1590,107,1626,220,57,13,7,36,113,3,3,0,0
3979,1591,96,1626,222,58,13,7,35,126,0,56,0,1
3980,1588,94,1625,225,58,13,7,37,131,1,56,0,0
3981,1586,90,1625,230,58,13,7,39,140,2,56,0,0
3982,1581,92,1620,231,58,13,7,39,139,3,56,0,0
3983,1580,93,1621,235,58,13,7,41,142,4,56,0,0
3984,1578,93,1620,237,58,13,7,42,144,5,56,0,0
3985,1575,96,1618,243,58,13,7,43,147,6,56,0,0
3986,1574,97,1617,246,58,13,7,43,149,7,56,0,0
3987,1571,97,1615,250,58,13,7,44,153,8,56,0,0
3988,1569,104,1614,255,58,13,7,45,151,9,56,0,0
3989,1568,103,1614,259,58,13,7,46,156,10,56,0,0
3990,1565,101,1613,264,58,13,7,48,163,11,56,0,0
3991,1564,106,1611,266,58,13,7,47,160,12,56,0,0
3992,1563,110,1609,268,58,13,7,46,158,13,56,0,0
3993,1560,111,1608,274,58,13,7,48,163,14,56,0,0
3994,1559,113,1609,281,58,13,7,50,168,15,56,0,0
3995,1558,112,1609,282,58,13,7,51,170,16,56,0,0
3996,1557,118,1609,291,58,13,7,52,173,17,56,0,0
3997,1554,120,1606,294,58,13,7,52,174,18,56,0,0
3998,1552,119,1606,300,58,13,7,54,181,19,56,0,0
3999,1552,123,1607,307,58,13,7,55,184,20,56,0,0
4000,1552,124,1609,314,58,13,7,57,190,21,56,0,0
4001,1552,122,1613,323,58,13,7,61,201,22,56,0,0
4002,1553,122,1615,331,58,13,7,62,209,23,56,0,0
4003,1552,126,1614,334,58,13,7,62,208,24,56,0,0
4004,1552,132,1616,346,58,13,7,64,214,25,56,0,0
4005,1553,133,1618,351,58,13,7,65,218,26,56,0,0
4006,1552,135,1618,358,58,13,7,66,223,27,56,0,0
4007,1549,141,1617,369,58,13,7,68,228,28,56,0,0
4008,1544,138,1613,375,58,13,7,69,237,29,56,0,0
4009,1538,141,1609,386,58,13,7,71,245,30,56,0,0
4010,1531,144,1605,398,58,13,7,74,254,31,56,0,0
4011,1521,146,1597,402,58,13,7,76,256,32,56,0,0
4012,1506,157,1585,418,58,13,7,79,261,33,56,0,0
4013,1496,160,1576,423,58,13,7,80,263,34,56,0,0
4014,1486,158,1569,436,58,13,7,83,278,35,56,0,0
4015,1475,165,1563,459,58,13,7,88,294,36,56,0,0
4016,1467,164,1557,468,58,13,7,90,304,37,56,0,0
4017,1450,171,1546,484,58,13,7,96,313,38,56,0,0
4018,1438,179,1536,501,58,13,7,98,322,39,56,0,0
4019,1430,182,1528,506,58,13,7,98,324,40,56,0,0
4020,1415,187,1519,529,58,13,7,104,342,41,56,0,0
4021,1404,197,1510,546,58,13,7,106,349,42,56,0,0
4022,1388,204,1496,560,58,13,7,108,356,43,56,0,0
4023,1360,219,1475,591,58,13,7,115,372,44,56,0,0
4024,1340,221,1458,609,58,13,7,118,388,45,56,0,0
4025,1316,222,1443,635,58,13,7,127,413,46,56,0,0
4026,1280,237,1416,679,58,13,7,136,442,47,56,0,0
4027,1254,244,1394,695,58,13,7,140,451,48,56,0,0
4028,1203,263,1354,734,58,13,7,151,471,49,56,0,0
4029,1166,274,1320,761,58,13,7,154,487,50,56,0,0
4030,1135,276,1289,774,58,13,7,154,498,51,56,0,0
4031,1071,288,1247,844,58,13,7,176,556,52,56,0,0
4032,1004,307,1179,856,58,13,7,175,549,53,56,0,0
4033,933,325,1096,843,58,13,7,163,518,54,56,0,0
4034,846,337,1009,862,58,13,7,163,525,55,56,0,0
4035,810,346,976,881,58,13,7,166,535,56,56,1,0
4040,440,323,605,831,58,13,7,165,508,0,56,0,1
4041,374,309,530,789,58,13,7,156,480,1,56,0,0
4042,336,324,486,758,58,13,7,150,434,2,56,0,0
4043,285,303,440,736,58,13,7,155,433,3,56,0,0
4044,220,299,373,715,58,13,7,153,416,4,56,0,0
4045,191,301,345,700,58,13,7,154,399,5,56,0,0
4046,138,286,295,685,58,13,7,157,399,6,56,0,0
4047,125,293,275,664,58,13,7,150,371,7,56,0,0
4048,104,296,250,647,58,13,7,146,351,8,56,0,0
4049,77,295,212,625,58,13,7,135,330,9,56,0,0
4050,62,293,200,623,58,13,7,138,330,10,56,0,0
4051,43,289,172,599,58,13,7,129,310,11,56,0,0
4052,26,286,148,584,58,13,7,122,298,12,56,0,0
4053,15,287,134,573,58,13,7,119,286,13,56,0,0
4054,0,286,112,563,58,13,7,112,277,14,56,0,0
4055,0,286,101,562,58,13,7,101,276,15,56,0,0
4056,0,286,90,553,58,13,7,90,267,16,56,0,0
4057,0,281,81,535,58,13,7,81,254,17,56,0,0
4058,0,276,79,529,58,13,7,79,253,18,56,0,0
4059,0,281,72,517,58,13,7,72,236,19,56,0,0
4060,0,294,59,515,58,13,7,59,221,20,56,0,0
4061,0,299,51,508,58,13,7,51,209,21,56,0,0
4062,0,300,36,499,58,13,7,36,199,22,56,0,0
4038,543,331,682,655,60,13,7,139,324,0,0,0,0
5341,1673,76,1708,205,62,13,7,35,129,0,64,0,1
5342,1673,74,1708,205,62,13,7,35,131,1,64,0,0
5343,1672,73,1708,208,62,13,7,36,135,2,64,0,0
5344,1672,76,1708,212,62,13,7,36,136,3,64,0,0
5345,1673,77,1709,213,62,13,7,36,136,4,64,0,0
5346,1672,76,1709,215,62,13,7,37,139,5,64,0,0
5347,1671,76,1708,220,62,13,7,37,144,6,64,0,0
5348,1672,75,1710,222,62,13,7,38,147,7,64,0,0
5349,1672,78,1709,225,62,13,7,37,147,8,64,0,0
5350,1671,76,1710,231,62,13,7,39,155,9,64,0,0
5351,1669,82,1707,233,62,13,7,38,151,10,64,0,0
5352,1668,86,1706,236,62,13,7,38,150,11,64,0,0
5353,1667,89,1705,237,62,13,7,38,148,12,64,0,0
5354,1665,90,1703,237,62,13,7,38,147,13,64,0,0
5355,1662,89,1702,241,62,13,7,40,152,14,64,0,0
5356,1658,86,1700,245,62,13,7,42,159,15,64,0,0
5357,1656,84,1699,248,62,13,7,43,164,16,64,0,0
5358,1655,86,1698,251,62,13,7,43,165,17,64,0,0
5359,1656,88,1700,253,62,13,7,44,165,18,64,0,0
5360,1657,93,1701,258,62,13,7,44,165,19,64,0,0
5361,1656,93,1702,264,62,13,7,46,171,20,64,0,0
5362,1657,92,1704,270,62,13,7,47,178,21,64,0,0
5363,1658,97,1706,275,62,13,7,48,178,22,64,0,0
5364,1659,97,1707,281,62,13,7,48,184,23,64,0,0
5365,1656,102,1706,288,62,13,7,50,186,24,64,0,0
5366,1653,104,1704,292,62,13,7,51,188,25,64,0,0
5367,1651,103,1704,298,62,13,7,53,195,26,64,0,0
5368,1651,106,1704,302,62,13,7,53,196,27,64,0,0
5369,1650,106,1706,306,62,13,7,56,200,28,64,0,0
5370,1649,111,1705,314,62,13,7,56,203,29,64,0,0
5371,1646,111,1704,319,62,13,7,58,208,30,64,0,0
5372,1645,116,1705,329,62,13,7,60,213,31,64,0,0
5373,1646,121,1707,335,62,13,7,61,214,32,64,0,0
5374,1645,121,1708,344,62,13,7,63,223,33,64,0,0
5375,1642,126,1707,349,62,13,7,65,223,34,64,0,0
5376,1637,126,1704,357,62,13,7,67,231,35,64,0,0
5377,1638,129,1708,373,62,13,7,70,244,36,64,0,0
5378,1638,131,1709,381,62,13,7,71,250,37,64,0,0
5379,1633,132,1708,390,62,13,7,75,258,38,64,0,0
5380,1629,135,1706,400,62,13,7,77,265,39,64,0,0
5381,1626,136,1706,407,62,13,7,80,271,40,64,0,0
5382,1625,143,1706,421,62,13,7,81,278,41,64,0,0
5383,1623,145,1706,433,62,13,7,83,288,42,64,0,0
5384,1613,145,1702,448,62,13,7,89,303,43,64,0,0
5385,1601,146,1695,463,62,13,7,94,317,44,64,0,0
5386,1594,148,1691,478,62,13,7,97,330,45,64,0,0
5387,1591,161,1690,493,62,13,7,99,332,46,64,0,0
5388,1579,164,1680,502,62,13,7,101,338,47,64,0,0
5389,1564,171,1667,512,62,13,7,103,341,48,64,0,0
5390,1545,174,1654,532,62,13,7,109,358,49,64,0,0
5391,1533,179,1651,564,62,13,7,118,385,50,64,0,0
5392,1522,187,1646,594,62,13,7,124,407,51,64,0,0
5393,1508,193,1636,612,62,13,7,128,419,52,64,0,0
5394,1487,203,1622,642,62,13,7,135,439,53,64,0,0
5395,1467,207,1607,658,62,13,7,140,451,54,64,0,0
5396,1447,214,1598,697,62,13,7,151,483,55,64,0,0
5397,1418,222,1579,734,62,13,7,161,512,56,64,0,0
5398,1376,233,1541,755,62,13,7,165,522,57,64,0,0
5399,1314,250,1489,784,62,13,7,175,534,58,64,0,0
5400,1260,253,1442,809,62,13,7,182,556,59,64,0,0
5401,1183,264,1384,865,62,13,7,201,601,60,64,0,0
5402,1106,280,1313,904,62,13,7,207,624,61,64,0,0
5403,1008,288,1220,913,62,13,7,212,625,62,64,0,0
5404,928,297,1147,914,62,13,7,219,617,63,64,0,0
5405,890,304,1114,936,62,13,7,224,632,64,64,1,0
5405,742,297,956,948,63,13,7,214,651,0,18,0,0
5406,682,311,888,930,63,13,7,206,619,1,18,0,0
5407,576,310,782,923,63,13,7,206,613,2,18,0,0
5408,457,315,661,911,63,13,7,204,596,3,18,0,0
5409,376,310,575,881,63,13,7,199,571,4,18,0,0
5410,315,305,508,855,63,13,7,193,550,5,18,0,0
5411,268,301,459,831,63,13,7,191,530,6,18,0,0
5412,192,297,378,812,63,13,7,186,515,7,18,0,0
5413,144,298,329,803,63,13,7,185,505,8,18,0,0
5414,99,297,273,774,63,13,7,174,477,9,18,0,0
5415,78,291,246,745,63,13,7,168,454,10,18,0,0
5416,56,299,217,723,63,13,7,161,424,11,18,0,0
5417,17,297,170,703,63,13,7,153,406,12,18,0,0
5418,0,307,145,697,63,13,7,145,390,13,18,0,0
5419,0,299,118,679,63,13,7,118,380,14,18,0,0
5420,0,307,105,663,63,13,7,105,356,15,18,0,0
5421,0,318,90,647,63,13,7,90,329,16,18,0,0
5422,0,325,69,632,63,13,7,69,307,17,18,0,0
5423,0,358,54,615,63,13,7,54,257,18,18,0,0
5415,301,304,393,495,64,13,7,92,191,0,0,0,0
5975,0,297,35,515,65,13,7,35,218,0,25,0,1
5976,2,299,40,521,65,13,7,38,222,1,25,0,0
5977,17,299,59,525,65,13,7,42,226,2,25,0,0
5978,20,273,68,529,65,13,7,48,256,3,25,0,0
5979,22,259,76,532,65,13,7,54,273,4,25,0,0
5980,24,257,84,545,65,13,7,60,288,5,25,0,0
5981,27,255,93,558,65,13,7,66,303,6,25,0,0
5982,34,255,105,559,65,13,7,71,304,7,25,0,0
5983,52,256,131,565,65,13,7,79,309,8,25,0,0
5984,64,260,148,570,65,13,7,84,310,9,25,0,0
5985,72,259,162,579,65,13,7,90,320,10,25,0,0
5986,82,257,182,601,65,13,7,100,344,11,25,0,0
5987,92,256,198,609,65,13,7,106,353,12,25,0,0
5988,119,259,233,618,65,13,7,114,359,13,25,0,0
5989,139,257,262,628,65,13,7,123,371,14,25,0,0
5990,151,254,279,635,65,13,7,128,381,15,25,0,0
5991,165,253,309,663,65,13,7,144,410,16,25,0,0
5992,181,261,332,679,65,13,7,151,418,17,25,0,0
5993,198,265,352,688,65,13,7,154,423,18,25,0,0
5994,236,270,399,701,65,13,7,163,431,19,25,0,0
5995,260,276,427,713,65,13,7,167,437,20,25,0,0
5996,277,278,458,742,65,13,7,181,464,21,25,0,0
5997,304,286,502,781,65,13,7,198,495,22,25,0,0
5998,327,290,528,797,65,13,7,201,507,23,25,0,0
5999,384,294,595,810,65,13,7,211,516,24,25,0,0
6000,435,300,653,825,65,13,7,218,525,25,25,1,0
6000,1670,596,1899,1070,66,13,7,229,474,0,0,0,0
983,1560,113,1595,253,1,13,8,35,140,0,11,0,0
984,1547,115,1584,256,1,13,8,37,141,1,11,0,0
985,1529,116,1567,258,1,13,8,38,142,2,11,0,0
986,1500,114,1542,261,1,13,8,42,147,3,11,0,0
987,1490,116,1533,263,1,13,8,43,147,4,11,0,0
988,1473,116,1518,264,1,13,8,45,148,5,11,0,0
989,1458,114,1504,268,1,13,8,46,154,6,11,0,0
990,1446,117,1493,269,1,13,8,47,152,7,11,0,0
991,1435,119,1483,272,1,13,8,48,153,8,11,0,0
992,1420,123,1469,278,1,13,8,49,155,9,11,0,0
993,1413,127,1462,279,1,13,8,49,152,10,11,0,0
994,1399,128,1449,281,1,13,8,50,153,11,11,0,0
1348,1423,119,1472,279,2,13,8,49,160,0,19,0,1
1349,1437,119,1484,274,2,13,8,47,155,1,19,0,0
1350,1449,118,1495,267,2,13,8,46,149,2,19,0,0
1351,1468,115,1513,262,2,13,8,45,147,3,19,0,0
1352,1484,115,1531,263,2,13,8,47,148,4,19,0,0
1353,1498,117,1543,259,2,13,8,45,142,5,19,0,0
1354,1509,114,1555,258,2,13,8,46,144,6,19,0,0
1355,1522,115,1569,258,2,13,8,47,143,7,19,0,0
1356,1537,111,1583,251,2,13,8,46,140,8,19,0,0
1357,1552,110,1600,252,2,13,8,48,142,9,19,0,0
1358,1562,111,1609,249,2,13,8,47,138,10,19,0,0
1359,1571,113,1617,246,2,13,8,46,133,11,19,0,0
1360,1575,112,1621,244,2,13,8,46,132,12,19,0,0
1361,1578,110,1625,248,2,13,8,47,138,13,19,0,0
1362,1583,109,1630,246,2,13,8,47,137,14,19,0,0
1363,1588,108,1633,239,2,13,8,45,131,15,19,0,0
1364,1598,106,1640,228,2,13,8,42,122,16,19,0,0
1365,1606,106,1650,235,2,13,8,44,129,17,19,0,0
1366,1613,106,1655,235,2,13,8,42,129,18,19,0,0
1367,1622,105,1663,233,2,13,8,41,128,19,19,0,0
2483,1557,118,1593,261,3,13,8,36,143,0,90,0,1
2484,1549,118,1587,266,3,13,8,38,148,1,90,0,0
2485,1540,120,1579,266,3,13,8,39,146,2,90,0,0
2486,1530,121,1573,271,3,13,8,43,150,3,90,0,0
2487,1529,122,1572,271,3,13,8,43,149,4,90,0,0
2488,1529,122,1575,275,3,13,8,46,153,5,90,0,0
2489,1529,123,1575,277,3,13,8,46,154,6,90,0,0
2490,1526,124,1574,278,3,13,8,48,154,7,90,0,0
2491,1523,127,1574,286,3,13,8,51,159,8,90,0,0
2492,1524,128,1576,290,3,13,8,52,162,9,90,0,0
2493,1528,125,1582,293,3,13,8,54,168,10,90,0,0
2494,1532,130,1587,296,3,13,8,55,166,11,90,0,0
2495,1532,135,1586,297,3,13,8,54,162,12,90,0,0
2496,1529,140,1584,301,3,13,8,55,161,13,90,0,0
2497,1528,143,1584,308,3,13,8,56,165,14,90,0,0
2498,1532,144,1589,309,3,13,8,57,165,15,90,0,0
2499,1533,144,1593,316,3,13,8,60,172,16,90,0,0
2500,1534,146,1595,320,3,13,8,61,174,17,90,0,0
2501,1528,146,1592,326,3,13,8,64,180,18,90,0,0
2502,1523,148,1591,333,3,13,8,68,185,19,90,0,0
2503,1525,148,1593,335,3,13,8,68,187,20,90,0,0
2504,1531,146,1602,339,3,13,8,71,193,21,90,0,0
2505,1532,147,1605,351,3,13,8,73,204,22,90,0,0
2506,1527,149,1602,360,3,13,8,75,211,23,90,0,0
2507,1519,150,1596,364,3,13,8,77,214,24,90,0,0
2508,1512,154,1591,369,3,13,8,79,215,25,90,0,0
2509,1512,153,1592,369,3,13,8,80,216,26,90,0,0
2510,1513,158,1596,382,3,13,8,83,224,27,90,0,0
2511,1510,164,1594,394,3,13,8,84,230,28,90,0,0
2512,1502,165,1589,400,3,13,8,87,235,29,90,0,0
2513,1497,168,1585,405,3,13,8,88,237,30,90,0,0
2514,1496,172,1588,416,3,13,8,92,244,31,90,0,0
2515,1498,171,1594,427,3,13,8,96,256,32,90,0,0
2516,1502,179,1598,436,3,13,8,96,257,33,90,0,0
2517,1497,180,1597,448,3,13,8,100,268,34,90,0,0
2518,1491,184,1595,459,3,13,8,104,275,35,90,0,0
2519,1491,187,1597,469,3,13,8,106,282,36,90,0,0
2520,1496,187,1605,475,3,13,8,109,288,37,90,0,0
2521,1500,191,1612,490,3,13,8,112,299,38,90,0,0
2522,1497,195,1613,507,3,13,8,116,312,39,90,0,0
2523,1491,197,1611,519,3,13,8,120,322,40,90,0,0
2524,1486,203,1609,532,3,13,8,123,329,41,90,0,0
2525,1489,208,1616,548,3,13,8,127,340,42,90,0,0
2526,1495,214,1624,562,3,13,8,129,348,43,90,0,0
2527,1493,225,1625,581,3,13,8,132,356,44,90,0,0
2528,1482,228,1617,594,3,13,8,135,366,45,90,0,0
2529,1464,236,1606,621,3,13,8,142,385,46,90,0,0
2530,1450,242,1600,648,3,13,8,150,406,47,90,0,0
2531,1449,247,1600,659,3,13,8,151,412,48,90,0,0
2532,1441,259,1594,677,3,13,8,153,418,49,90,0,0
2533,1425,264,1581,698,3,13,8,156,434,50,90,0,0
2534,1398,265,1565,728,3,13,8,167,463,51,90,0,0
2535,1367,277,1546,772,3,13,8,179,495,52,90,0,0
2536,1351,282,1535,789,3,13,8,184,507,53,90,0,0
2537,1336,297,1521,812,3,13,8,185,515,54,90,0,0
2538,1312,315,1501,846,3,13,8,189,531,55,90,0,0
2539,1278,329,1469,866,3,13,8,191,537,56,90,0,0
2540,1221,346,1429,926,3,13,8,208,580,57,90,0,0
2541,1173,367,1390,960,3,13,8,217,593,58,90,0,0
2542,1129,382,1341,969,3,13,8,212,587,59,90,0,0
2543,1068,404,1288,997,3,13,8,220,593,60,90,0,0
2544,1013,416,1241,1019,3,13,8,228,603,61,90,0,0
2545,933,429,1168,1061,3,13,8,235,632,62,90,0,0
2546,884,456,1121,1079,3,13,8,237,623,63,90,0,0
2547,808,481,1043,1080,3,13,8,235,599,64,90,0,0
2548,714,501,951,1080,3,13,8,237,579,65,90,0,0
2549,639,521,887,1080,3,13,8,248,559,66,90,0,0
2550,567,532,832,1080,3,13,8,265,548,67,90,0,0
2551,498,537,766,1080,3,13,8,268,543,68,90,0,0
2552,471,547,738,1080,3,13,8,267,533,69,90,0,0
2553,463,556,730,1080,3,13,8,267,524,70,90,0,0
2554,455,568,717,1080,3,13,8,262,512,71,90,0,0
2555,437,574,698,1080,3,13,8,261,506,72,90,0,0
2556,423,584,684,1080,3,13,8,261,496,73,90,0,0
2557,413,579,678,1077,3,13,8,265,498,74,90,0,0
2558,416,590,682,1074,3,13,8,266,484,75,90,0,0
2559,427,602,695,1075,3,13,8,268,473,76,90,0,0
2560,446,610,717,1077,3,13,8,271,467,77,90,0,0
2561,455,614,731,1080,3,13,8,276,466,78,90,0,0
2562,446,628,719,1078,3,13,8,273,450,79,90,0,0
2563,439,638,712,1078,3,13,8,273,440,80,90,0,0
2564,431,633,711,1078,3,13,8,280,445,81,90,0,0
2565,424,620,713,1079,3,13,8,289,459,82,90,0,0
2566,417,610,716,1079,3,13,8,299,469,83,90,0,0
2567,410,590,719,1073,3,13,8,309,483,84,90,0,0
2568,405,580,720,1075,3,13,8,315,495,85,90,0,0
2569,391,554,720,1077,3,13,8,329,523,86,90,0,0
2570,382,539,714,1072,3,13,8,332,533,87,90,0,0
2571,368,533,698,1066,3,13,8,330,533,88,90,0,0
2572,369,569,655,1040,3,13,8,286,471,89,90,0,0
2573,360,568,646,1038,3,13,8,286,470,90,90,1,0
4717,1546,107,1581,253,4,13,8,35,146,0,11,0,0
4718,1527,108,1563,255,4,13,8,36,147,1,11,0,0
4719,1507,99,1547,258,4,13,8,40,159,2,11,0,0
4720,1495,106,1537,263,4,13,8,42,157,3,11,0,0
4721,1481,108,1523,264,4,13,8,42,156,4,11,0,0
4722,1466,110,1507,260,4,13,8,41,150,5,11,0,0
4723,1454,112,1496,261,4,13,8,42,149,6,11,0,0
4724,1445,117,1489,268,4,13,8,44,151,7,11,0,0
4725,1436,121,1481,270,4,13,8,45,149,8,11,0,0
4726,1432,125,1478,274,4,13,8,46,149,9,11,0,0
4727,1427,125,1476,277,4,13,8,49,152,10,11,0,0
4728,1416,126,1466,280,4,13,8,50,154,11,11,0,0
5374,1418,114,1469,283,5,13,8,51,169,0,9,0,0
5375,1440,116,1487,271,5,13,8,47,155,1,9,0,0
5376,1453,114,1498,261,5,13,8,45,147,2,9,0,0
5377,1468,109,1514,260,5,13,8,46,151,3,9,0,0
5378,1486,104,1534,258,5,13,8,48,154,4,9,0,0
5379,1504,103,1549,249,5,13,8,45,146,5,9,0,0
5380,1523,95,1570,249,5,13,8,47,154,6,9,0,0
5381,1545,99,1591,247,5,13,8,46,148,7,9,0,0
5382,1564,100,1605,233,5,13,8,41,133,8,9,0,0
5383,1584,104,1623,231,5,13,8,39,127,9,9,0,0
1951,1836,942,1884,1031,1,13,9,48,89,0,1,0,0
1952,1826,952,1878,1049,1,13,9,52,97,1,1,0,0
1954,1811,954,1864,1045,2,13,9,53,91,0,1,0,0
1955,1808,964,1849,1035,2,13,9,41,71,1,1,0,0
2163,1,886,92,1080,3,13,9,91,194,0,87,0,1
2164,0,713,154,1080,3,13,9,154,367,1,87,0,0
2165,0,558,233,1080,3,13,9,233,522,2,87,0,0
2166,21,478,299,1080,3,13,9,278,602,3,87,0,0
2167,87,428,387,1078,3,13,9,300,650,4,87,0,0
2168,181,406,489,1073,3,13,9,308,667,5,87,0,0
2169,243,373,561,1070,3,13,9,318,697,6,87,0,0
2170,332,352,649,1047,3,13,9,317,695,7,87,0,0
2171,394,343,705,1026,3,13,9,311,683,8,87,0,0
2172,451,320,746,972,3,13,9,295,652,9,87,0,0
2173,484,308,774,956,3,13,9,290,648,10,87,0,0
2174,502,295,769,906,3,13,9,267,611,11,87,0,0
2175,514,281,756,844,3,13,9,242,563,12,87,0,0
2176,521,270,755,823,3,13,9,234,553,13,87,0,0
2177,532,263,748,781,3,13,9,216,518,14,87,0,0
2178,535,245,734,737,3,13,9,199,492,15,87,0,0
2179,529,237,718,717,3,13,9,189,480,16,87,0,0
2180,520,227,693,671,3,13,9,173,444,17,87,0,0
2181,509,219,675,649,3,13,9,166,430,18,87,0,0
2182,505,216,666,638,3,13,9,161,422,19,87,0,0
2183,499,207,644,594,3,13,9,145,387,20,87,0,0
2184,488,204,626,580,3,13,9,138,376,21,87,0,0
2185,480,204,609,559,3,13,9,129,355,22,87,0,0
2186,471,193,594,534,3,13,9,123,341,23,87,0,0
2187,475,193,598,526,3,13,9,123,333,24,87,0,0
2188,471,188,587,502,3,13,9,116,314,25,87,0,0
2189,465,180,577,488,3,13,9,112,308,26,87,0,0
2190,458,183,563,478,3,13,9,105,295,27,87,0,0
2191,452,176,552,459,3,13,9,100,283,28,87,0,0
2192,449,170,548,450,3,13,9,99,280,29,87,0,0
2193,448,172,545,446,3,13,9,97,274,30,87,0,0
2194,444,165,534,423,3,13,9,90,258,31,87,0,0
2195,437,165,524,416,3,13,9,87,251,32,87,0,0
2196,430,163,514,404,3,13,9,84,241,33,87,0,0
2197,424,158,505,396,3,13,9,81,238,34,87,0,0
2198,421,159,500,393,3,13,9,79,234,35,87,0,0
2199,422,157,496,380,3,13,9,74,223,36,87,0,0
2200,420,150,494,374,3,13,9,74,224,37,87,0,0
2201,418,149,491,369,3,13,9,73,220,38,87,0,0
2202,416,146,486,360,3,13,9,70,214,39,87,0,0
2203,416,144,485,354,3,13,9,69,210,40,87,0,0
2204,420,145,486,346,3,13,9,66,201,41,87,0,0
2205,424,141,488,338,3,13,9,64,197,42,87,0,0
2206,427,142,490,337,3,13,9,63,195,43,87,0,0
2207,426,140,488,333,3,13,9,62,193,44,87,0,0
2208,426,133,487,325,3,13,9,61,192,45,87,0,0
2209,428,134,486,319,3,13,9,58,185,46,87,0,0
2210,431,134,488,312,3,13,9,57,178,47,87,0,0
2211,432,126,490,307,3,13,9,58,181,48,87,0,0
2212,433,127,489,305,3,13,9,56,178,49,87,0,0
2213,431,121,488,299,3,13,9,57,178,50,87,0,0
2214,430,118,487,297,3,13,9,57,179,51,87,0,0
2215,430,121,485,293,3,13,9,55,172,52,87,0,0
2216,432,116,488,289,3,13,9,56,173,53,87,0,0
2217,433,116,487,285,3,13,9,54,169,54,87,0,0
2218,432,118,484,280,3,13,9,52,162,55,87,0,0
2219,432,116,482,274,3,13,9,50,158,56,87,0,0
2220,432,116,482,272,3,13,9,50,156,57,87,0,0
2221,435,115,484,269,3,13,9,49,154,58,87,0,0
2222,435,112,484,264,3,13,9,49,152,59,87,0,0
2223,436,112,483,261,3,13,9,47,149,60,87,0,0
2224,434,109,481,258,3,13,9,47,149,61,87,0,0
2225,433,108,480,256,3,13,9,47,148,62,87,0,0
2226,433,104,480,254,3,13,9,47,150,63,87,0,0
2227,433,104,480,252,3,13,9,47,148,64,87,0,0
2228,433,104,480,250,3,13,9,47,146,65,87,0,0
2229,433,104,479,249,3,13,9,46,145,66,87,0,0
2230,432,104,477,245,3,13,9,45,141,67,87,0,0
2231,431,101,477,247,3,13,9,46,146,68,87,0,0
2232,432,103,476,242,3,13,9,44,139,69,87,0,0
2233,431,102,474,241,3,13,9,43,139,70,87,0,0
2234,431,102,473,238,3,13,9,42,136,71,87,0,0
2235,432,98,471,231,3,13,9,39,133,72,87,0,0
2236,431,93,471,229,3,13,9,40,136,73,87,0,0
2237,432,95,471,227,3,13,9,39,132,74,87,0,0
2238,433,89,473,226,3,13,9,40,137,75,87,0,0
2239,434,87,473,225,3,13,9,39,138,76,87,0,0
2240,435,83,475,223,3,13,9,40,140,77,87,0,0
2241,435,86,474,221,3,13,9,39,135,78,87,0,0
2242,434,87,472,219,3,13,9,38,132,79,87,0,0
2243,435,88,472,217,3,13,9,37,129,80,87,0,0
2244,434,87,471,214,3,13,9,37,127,81,87,0,0
2245,435,85,472,213,3,13,9,37,128,82,87,0,0
2246,435,85,471,211,3,13,9,36,126,83,87,0,0
2247,434,85,471,211,3,13,9,37,126,84,87,0,0
2248,434,84,471,209,3,13,9,37,125,85,87,0,0
2249,435,84,471,206,3,13,9,36,122,86,87,0,0
2250,436,83,471,204,3,13,9,35,121,87,87,1,0
2421,2,760,131,1080,6,13,9,129,320,0,113,0,1
2422,0,541,199,1080,6,13,9,199,539,1,113,0,0
2423,0,489,229,1080,6,13,9,229,591,2,113,0,0
2424,38,461,286,1076,6,13,9,248,615,3,113,0,0
2425,123,443,381,1071,6,13,9,258,628,4,113,0,0
2426,178,420,447,1071,6,13,9,269,651,5,113,0,0
2427,237,401,513,1069,6,13,9,276,668,6,113,0,0
2428,308,388,592,1069,6,13,9,284,681,7,113,0,0
2429,355,373,633,1044,6,13,9,278,671,8,113,0,0
2430,408,359,680,1021,6,13,9,272,662,9,113,0,0
2431,443,349,713,1013,6,13,9,270,664,10,113,0,0
2432,475,336,734,982,6,13,9,259,646,11,113,0,0
2433,507,326,750,937,6,13,9,243,611,12,113,0,0
2434,538,324,770,916,6,13,9,232,592,13,113,0,0
2435,568,310,786,873,6,13,9,218,563,14,113,0,0
2436,588,302,796,846,6,13,9,208,544,15,113,0,0
2437,597,298,798,834,6,13,9,201,536,16,113,0,0
2438,601,285,789,790,6,13,9,188,505,17,113,0,0
2439,612,275,790,763,6,13,9,178,488,18,113,0,0
2440,615,270,788,752,6,13,9,173,482,19,113,0,0
2441,627,261,790,718,6,13,9,163,457,20,113,0,0
2442,638,252,796,694,6,13,9,158,442,21,113,0,0
2443,648,248,806,678,6,13,9,158,430,22,113,0,0
2444,635,236,795,662,6,13,9,160,426,23,113,0,0
2445,622,229,778,637,6,13,9,156,408,24,113,0,0
2446,610,224,766,628,6,13,9,156,404,25,113,0,0
2447,595,219,747,613,6,13,9,152,394,26,113,0,0
2448,584,211,729,592,6,13,9,145,381,27,113,0,0
2449,573,210,711,579,6,13,9,138,369,28,113,0,0
2450,561,205,695,565,6,13,9,134,360,29,113,0,0
2451,552,202,680,550,6,13,9,128,348,30,113,0,0
2452,535,199,664,547,6,13,9,129,348,31,113,0,0
2453,541,193,665,532,6,13,9,124,339,32,113,0,0
2454,546,189,662,512,6,13,9,116,323,33,113,0,0
2455,542,190,653,505,6,13,9,111,315,34,113,0,0
2456,530,184,640,496,6,13,9,110,312,35,113,0,0
2457,520,181,626,482,6,13,9,106,301,36,113,0,0
2458,512,178,618,479,6,13,9,106,301,37,113,0,0
2459,505,173,610,474,6,13,9,105,301,38,113,0,0
2460,505,171,604,456,6,13,9,99,285,39,113,0,0
2461,499,168,598,453,6,13,9,99,285,40,113,0,0
2462,491,168,587,448,6,13,9,96,280,41,113,0,0
2463,482,164,574,433,6,13,9,92,269,42,113,0,0
2464,478,163,566,424,6,13,9,88,261,43,113,0,0
2465,478,162,564,419,6,13,9,86,257,44,113,0,0
2466,478,161,561,408,6,13,9,83,247,45,113,0,0
2467,477,159,559,400,6,13,9,82,241,46,113,0,0
2468,474,156,556,401,6,13,9,82,245,47,113,0,0
2469,472,154,551,393,6,13,9,79,239,48,113,0,0
2470,471,154,549,389,6,13,9,78,235,49,113,0,0
2471,473,153,549,381,6,13,9,76,228,50,113,0,0
2472,474,152,547,374,6,13,9,73,222,51,113,0,0
2473,470,150,543,368,6,13,9,73,218,52,113,0,0
2474,462,148,535,366,6,13,9,73,218,53,113,0,0
2475,456,146,527,361,6,13,9,71,215,54,113,0,0
2476,450,148,517,350,6,13,9,67,202,55,113,0,0
2477,447,144,517,353,6,13,9,70,209,56,113,0,0
2478,447,148,513,345,6,13,9,66,197,57,113,0,0
2479,449,146,514,341,6,13,9,65,195,58,113,0,0
2480,445,143,510,339,6,13,9,65,196,59,113,0,0
2481,442,142,506,333,6,13,9,64,191,60,113,0,0
2482,440,141,505,331,6,13,9,65,190,61,113,0,0
2483,442,143,504,327,6,13,9,62,184,62,113,0,0
2484,443,141,505,321,6,13,9,62,180,63,113,0,0
2485,443,139,504,318,6,13,9,61,179,64,113,0,0
2486,438,135,500,317,6,13,9,62,182,65,113,0,0
2487,434,127,498,312,6,13,9,64,185,66,113,0,0
2488,433,127,496,306,6,13,9,63,179,67,113,0,0
2489,434,130,494,303,6,13,9,60,173,68,113,0,0
2490,433,124,495,301,6,13,9,62,177,69,113,0,0
2491,433,120,496,301,6,13,9,63,181,70,113,0,0
2492,431,120,494,300,6,13,9,63,180,71,113,0,0
2493,428,118,489,299,6,13,9,61,181,72,113,0,0
2494,425,118,485,295,6,13,9,60,177,73,113,0,0
2495,425,118,483,293,6,13,9,58,175,74,113,0,0
2496,426,117,484,293,6,13,9,58,176,75,113,0,0
2497,429,121,484,284,6,13,9,55,163,76,113,0,0
2498,431,123,484,279,6,13,9,53,156,77,113,0,0
2499,429,122,482,279,6,13,9,53,157,78,113,0,0
2500,429,121,480,274,6,13,9,51,153,79,113,0,0
2501,431,121,481,270,6,13,9,50,149,80,113,0,0
2502,433,113,484,268,6,13,9,51,155,81,113,0,0
2503,438,114,487,266,6,13,9,49,152,82,113,0,0
2504,441,117,489,264,6,13,9,48,147,83,113,0,0
2505,441,113,490,265,6,13,9,49,152,84,113,0,0
2506,439,108,488,262,6,13,9,49,154,85,113,0,0
2507,441,116,487,259,6,13,9,46,143,86,113,0,0
2508,444,122,488,257,6,13,9,44,135,87,113,0,0
2509,445,109,490,254,6,13,9,45,145,88,113,0,0
2510,443,100,492,254,6,13,9,49,154,89,113,0,0
2511,442,101,490,252,6,13,9,48,151,90,113,0,0
2512,441,98,488,248,6,13,9,47,150,91,113,0,0
2513,440,98,487,247,6,13,9,47,149,92,113,0,0
2514,441,98,487,245,6,13,9,46,147,93,113,0,0
2515,442,100,487,243,6,13,9,45,143,94,113,0,0
2516,439,97,485,243,6,13,9,46,146,95,113,0,0
2517,437,93,483,241,6,13,9,46,148,96,113,0,0
2518,435,93,482,242,6,13,9,47,149,97,113,0,0
2519,436,101,479,238,6,13,9,43,137,98,113,0,0
2520,437,104,476,232,6,13,9,39,128,99,113,0,0
2521,436,98,476,228,6,13,9,40,130,100,113,0,0
2522,435,94,477,232,6,13,9,42,138,101,113,0,0
2523,433,93,475,232,6,13,9,42,139,102,113,0,0
2524,432,94,473,230,6,13,9,41,136,103,113,0,0
2525,431,93,472,229,6,13,9,41,136,104,113,0,0
2526,432,92,472,225,6,13,9,40,133,105,113,0,0
2527,433,90,472,221,6,13,9,39,131,106,113,0,0
2528,433,91,471,219,6,13,9,38,128,107,113,0,0
2529,431,94,469,221,6,13,9,38,127,108,113,0,0
2530,430,96,467,222,6,13,9,37,126,109,113,0,0
2531,431,96,467,218,6,13,9,36,122,110,113,0,0
2532,430,92,467,220,6,13,9,37,128,111,113,0,0
2533,431,92,467,216,6,13,9,36,124,112,113,0,0
2534,431,90,467,215,6,13,9,36,125,113,113,1,0
2615,0,651,156,960,7,13,9,156,309,0,77,0,1
2616,0,476,236,957,7,13,9,236,481,1,77,0,0
2617,20,428,319,1026,7,13,9,299,598,2,77,0,0
2618,117,401,436,1040,7,13,9,319,639,3,77,0,0
2619,192,386,524,1061,7,13,9,332,675,4,77,0,0
2620,273,363,606,1052,7,13,9,333,689,5,77,0,0
2621,357,358,686,1041,7,13,9,329,683,6,77,0,0
2622,413,338,723,991,7,13,9,310,653,7,77,0,0
2623,440,321,743,966,7,13,9,303,645,8,77,0,0
2624,461,309,757,941,7,13,9,296,632,9,77,0,0
2625,496,286,764,866,7,13,9,268,580,10,77,0,0
2626,520,279,769,830,7,13,9,249,551,11,77,0,0
2627,544,266,772,780,7,13,9,228,514,12,77,0,0
2628,558,254,770,741,7,13,9,212,487,13,77,0,0
2629,564,248,766,722,7,13,9,202,474,14,77,0,0
2630,565,233,751,678,7,13,9,186,445,15,77,0,0
2631,560,223,736,651,7,13,9,176,428,16,77,0,0
2632,556,219,724,637,7,13,9,168,418,17,77,0,0
2633,558,211,711,598,7,13,9,153,387,18,77,0,0
2634,555,206,699,576,7,13,9,144,370,19,77,0,0
2635,545,199,678,545,7,13,9,133,346,20,77,0,0
2636,530,187,662,534,7,13,9,132,347,21,77,0,0
2637,521,186,649,527,7,13,9,128,341,22,77,0,0
2638,518,182,640,508,7,13,9,122,326,23,77,0,0
2639,518,179,633,491,7,13,9,115,312,24,77,0,0
2640,515,177,624,476,7,13,9,109,299,25,77,0,0
2641,508,170,615,462,7,13,9,107,292,26,77,0,0
2642,502,168,606,457,7,13,9,104,289,27,77,0,0
2643,502,166,602,445,7,13,9,100,279,28,77,0,0
2644,507,163,602,429,7,13,9,95,266,29,77,0,0
2645,509,162,600,419,7,13,9,91,257,30,77,0,0
2646,506,158,592,403,7,13,9,86,245,31,77,0,0
2647,502,156,586,394,7,13,9,84,238,32,77,0,0
2648,496,154,579,387,7,13,9,83,233,33,77,0,0
2649,500,155,578,375,7,13,9,78,220,34,77,0,0
2650,502,154,579,371,7,13,9,77,217,35,77,0,0
2651,498,156,570,361,7,13,9,72,205,36,77,0,0
2652,491,148,564,355,7,13,9,73,207,37,77,0,0
2653,488,141,561,348,7,13,9,73,207,38,77,0,0
2654,489,145,558,338,7,13,9,69,193,39,77,0,0
2655,489,143,556,334,7,13,9,67,191,40,77,0,0
2656,486,144,552,331,7,13,9,66,187,41,77,0,0
2657,484,142,546,320,7,13,9,62,178,42,77,0,0
2658,483,143,544,318,7,13,9,61,175,43,77,0,0
2659,485,144,543,310,7,13,9,58,166,44,77,0,0
2660,485,138,542,304,7,13,9,57,166,45,77,0,0
2661,483,138,539,301,7,13,9,56,163,46,77,0,0
2662,479,132,536,295,7,13,9,57,163,47,77,0,0
2663,479,129,535,293,7,13,9,56,164,48,77,0,0
2664,479,128,534,289,7,13,9,55,161,49,77,0,0
2665,480,124,535,285,7,13,9,55,161,50,77,0,0
2666,481,124,533,281,7,13,9,52,157,51,77,0,0
2667,479,124,530,274,7,13,9,51,150,52,77,0,0
2668,478,125,527,270,7,13,9,49,145,53,77,0,0
2669,479,127,526,266,7,13,9,47,139,54,77,0,0
2670,480,124,526,261,7,13,9,46,137,55,77,0,0
2671,480,123,526,260,7,13,9,46,137,56,77,0,0
2672,479,122,523,256,7,13,9,44,134,57,77,0,0
2673,477,119,521,253,7,13,9,44,134,58,77,0,0
2674,479,120,521,252,7,13,9,42,132,59,77,0,0
2675,481,121,522,248,7,13,9,41,127,60,77,0,0
2676,482,115,524,247,7,13,9,42,132,61,77,0,0
2677,482,117,524,246,7,13,9,42,129,62,77,0,0
2678,482,114,523,245,7,13,9,41,131,63,77,0,0
2679,482,114,522,240,7,13,9,40,126,64,77,0,0
2680,483,109,522,234,7,13,9,39,125,65,77,0,0
2681,483,104,522,232,7,13,9,39,128,66,77,0,0
2682,480,99,520,229,7,13,9,40,130,67,77,0,0
2683,478,99,517,228,7,13,9,39,129,68,77,0,0
2684,476,98,514,227,7,13,9,38,129,69,77,0,0
2685,476,100,512,222,7,13,9,36,122,70,77,0,0
2686,475,100,511,221,7,13,9,36,121,71,77,0,0
2687,474,101,509,220,7,13,9,35,119,72,77,0,0
2688,472,97,508,219,7,13,9,36,122,73,77,0,0
2689,471,94,507,218,7,13,9,36,124,74,77,0,0
2690,471,94,507,215,7,13,9,36,121,75,77,0,0
2691,472,92,507,212,7,13,9,35,120,76,77,0,0
2692,472,92,507,211,7,13,9,35,119,77,77,1,0
2915,523,108,559,247,10,13,9,36,139,0,51,0,1
2916,526,104,563,248,10,13,9,37,144,1,51,0,0
2917,529,105,567,251,10,13,9,38,146,2,51,0,0
2918,531,105,568,249,10,13,9,37,144,3,51,0,0
2919,531,105,570,255,10,13,9,39,150,4,51,0,0
2920,533,107,573,259,10,13,9,40,152,5,51,0,0
2921,537,107,576,260,10,13,9,39,153,6,51,0,0
2922,539,110,580,268,10,13,9,41,158,7,51,0,0
2923,541,111,582,269,10,13,9,41,158,8,51,0,0
2924,543,113,585,274,10,13,9,42,161,9,51,0,0
2925,547,115,589,281,10,13,9,42,166,10,51,0,0
2926,550,114,594,282,10,13,9,44,168,11,51,0,0
2927,555,116,600,291,10,13,9,45,175,12,51,0,0
2928,556,115,603,296,10,13,9,47,181,13,51,0,0
2929,560,116,608,303,10,13,9,48,187,14,51,0,0
2930,564,120,612,308,10,13,9,48,188,15,51,0,0
2931,569,118,618,310,10,13,9,49,192,16,51,0,0
2932,571,121,622,322,10,13,9,51,201,17,51,0,0
2933,573,118,626,327,10,13,9,53,209,18,51,0,0
2934,576,123,631,337,10,13,9,55,214,19,51,0,0
2935,580,129,635,347,10,13,9,55,218,20,51,0,0
2936,584,133,638,348,10,13,9,54,215,21,51,0,0
2937,585,136,643,363,10,13,9,58,227,22,51,0,0
2938,588,137,648,370,10,13,9,60,233,23,51,0,0
2939,593,138,656,382,10,13,9,63,244,24,51,0,0
2940,601,142,665,395,10,13,9,64,253,25,51,0,0
2941,607,142,672,395,10,13,9,65,253,26,51,0,0
2942,611,151,678,411,10,13,9,67,260,27,51,0,0
2943,613,148,684,422,10,13,9,71,274,28,51,0,0
2944,621,154,694,435,10,13,9,73,281,29,51,0,0
2945,629,160,704,452,10,13,9,75,292,30,51,0,0
2946,636,163,714,462,10,13,9,78,299,31,51,0,0
2947,639,170,724,490,10,13,9,85,320,32,51,0,0
2948,644,173,732,500,10,13,9,88,327,33,51,0,0
2949,651,175,746,525,10,13,9,95,350,34,51,0,0
2950,656,185,754,544,10,13,9,98,359,35,51,0,0
2951,665,191,767,558,10,13,9,102,367,36,51,0,0
2952,669,201,780,599,10,13,9,111,398,37,51,0,0
2953,673,205,789,618,10,13,9,116,413,38,51,0,0
2954,678,216,800,646,10,13,9,122,430,39,51,0,0
2955,680,231,809,684,10,13,9,129,453,40,51,0,0
2956,680,235,817,718,10,13,9,137,483,41,51,0,0
2957,676,255,826,774,10,13,9,150,519,42,51,0,0
2958,668,273,823,802,10,13,9,155,529,43,51,0,0
2959,642,281,817,874,10,13,9,175,593,44,51,0,0
2960,617,301,802,926,10,13,9,185,625,45,51,0,0
2961,589,316,783,960,10,13,9,194,644,46,51,0,0
2962,547,340,757,1037,10,13,9,210,697,47,51,0,0
2963,488,361,703,1071,10,13,9,215,710,48,51,0,0
2964,415,384,634,1080,10,13,9,219,696,49,51,0,0
2965,333,420,555,1080,10,13,9,222,660,50,51,0,0
2966,314,433,541,1080,10,13,9,227,647,51,51,1,0
2879,1,836,123,1080,11,13,9,122,244,0,0,0,0
2880,0,491,172,1080,12,13,9,172,589,0,61,0,1
2881,93,469,274,1078,12,13,9,181,609,1,61,0,0
2882,177,450,365,1077,12,13,9,188,627,2,61,0,0
2883,290,418,490,1067,12,13,9,200,649,3,61,0,0
2884,389,395,600,1066,12,13,9,211,671,4,61,0,0
2885,449,361,657,1016,12,13,9,208,655,5,61,0,0
2886,503,350,706,981,12,13,9,203,631,6,61,0,0
2887,554,332,743,909,12,13,9,189,577,7,61,0,0
2888,574,307,762,877,12,13,9,188,570,8,61,0,0
2889,577,285,753,817,12,13,9,176,532,9,61,0,0
2890,571,260,742,773,12,13,9,171,513,10,61,0,0
2891,572,254,731,733,12,13,9,159,479,11,61,0,0
2892,569,237,719,688,12,13,9,150,451,12,61,0,0
2893,552,227,701,675,12,13,9,149,448,13,61,0,0
2894,538,219,674,626,12,13,9,136,407,14,61,0,0
2895,518,211,647,601,12,13,9,129,390,15,61,0,0
2896,510,206,630,564,12,13,9,120,358,16,61,0,0
2897,498,196,617,550,12,13,9,119,354,17,61,0,0
2898,480,193,594,533,12,13,9,114,340,18,61,0,0
2899,469,183,581,516,12,13,9,112,333,19,61,0,0
2900,454,179,564,509,12,13,9,110,330,20,61,0,0
2901,450,180,550,480,12,13,9,100,300,21,61,0,0
2902,442,180,538,467,12,13,9,96,287,22,61,0,0
2903,433,175,526,451,12,13,9,93,276,23,61,0,0
2904,429,172,519,439,12,13,9,90,267,24,61,0,0
2905,431,168,516,421,12,13,9,85,253,25,61,0,0
2906,434,160,518,411,12,13,9,84,251,26,61,0,0
2907,433,161,513,404,12,13,9,80,243,27,61,0,0
2908,434,156,511,392,12,13,9,77,236,28,61,0,0
2909,434,158,507,381,12,13,9,73,223,29,61,0,0
2910,439,160,507,366,12,13,9,68,206,30,61,0,0
2911,440,154,507,362,12,13,9,67,208,31,61,0,0
2912,439,147,506,354,12,13,9,67,207,32,61,0,0
2913,438,145,503,342,12,13,9,65,197,33,61,0,0
2914,437,143,501,336,12,13,9,64,193,34,61,0,0
2915,438,139,501,330,12,13,9,63,191,35,61,0,0
2916,438,139,500,328,12,13,9,62,189,36,61,0,0
2917,436,134,497,319,12,13,9,61,185,37,61,0,0
2918,435,134,494,314,12,13,9,59,180,38,61,0,0
2919,436,129,493,304,12,13,9,57,175,39,61,0,0
2920,438,128,494,300,12,13,9,56,172,40,61,0,0
2921,438,129,494,297,12,13,9,56,168,41,61,0,0
2922,438,127,493,293,12,13,9,55,166,42,61,0,0
2923,437,126,491,288,12,13,9,54,162,43,61,0,0
2924,443,126,493,278,12,13,9,50,152,44,61,0,0
2925,444,129,493,275,12,13,9,49,146,45,61,0,0
2926,444,130,490,270,12,13,9,46,140,46,61,0,0
2927,442,126,488,265,12,13,9,46,139,47,61,0,0
2928,443,121,489,261,12,13,9,46,140,48,61,0,0
2929,446,127,490,260,12,13,9,44,133,49,61,0,0
2930,446,128,489,259,12,13,9,43,131,50,61,0,0
2931,445,123,489,255,12,13,9,44,132,51,61,0,0
2932,444,118,489,253,12,13,9,45,135,52,61,0,0
2933,447,120,488,244,12,13,9,41,124,53,61,0,0
2934,449,121,489,239,12,13,9,40,118,54,61,0,0
2935,448,121,487,239,12,13,9,39,118,55,61,0,0
2936,447,115,487,235,12,13,9,40,120,56,61,0,0
2937,449,120,487,233,12,13,9,38,113,57,61,0,0
2938,451,118,488,229,12,13,9,37,111,58,61,0,0
2939,452,119,488,226,12,13,9,36,107,59,61,0,0
2940,451,115,487,224,12,13,9,36,109,60,61,0,0
2941,451,114,486,220,12,13,9,35,106,61,61,1,0
2944,453,107,488,214,12,13,9,35,107,0,61,0,0
2945,450,98,488,212,12,13,9,38,114,1,61,0,0
2947,457,99,492,204,12,13,9,35,105,0,61,0,0
2966,103,444,397,1077,13,13,9,294,633,0,1,0,0
2967,21,485,291,1065,13,13,9,270,580,1,1,0,0
3602,1863,920,1907,990,14,13,9,44,70,0,0,0,0
3604,1854,923,1898,993,14,13,9,44,70,0,0,0,0
4049,1825,954,1868,1036,16,13,9,43,82,0,3,0,0
4050,1821,952,1868,1042,16,13,9,47,90,1,3,0,0
4051,1819,954,1863,1038,16,13,9,44,84,2,3,0,0
4052,1813,954,1856,1034,16,13,9,43,80,3,3,0,0
4051,1869,912,1906,993,17,13,9,37,81,0,4,0,0
4052,1864,914,1900,993,17,13,9,36,79,1,4,0,0
4053,1860,917,1896,994,17,13,9,36,77,2,4,0,0
4054,1858,918,1893,995,17,13,9,35,77,3,4,0,0
4056,1843,931,1878,1007,17,13,9,35,76,0,4,0,0
4059,1826,941,1863,1019,17,13,9,37,78,0,4,0,0
4060,1820,944,1859,1025,17,13,9,39,81,1,4,0,0
4061,1812,947,1851,1026,17,13,9,39,79,2,4,0,0
4062,1803,950,1840,1024,17,13,9,37,74,3,4,0,0
4063,1797,954,1832,1024,17,13,9,35,70,4,4,0,0
4338,4,779,161,1080,22,13,9,157,301,0,0,0,0
4339,9,489,330,1067,23,13,9,321,578,0,30,0,0
4340,72,469,404,1067,23,13,9,332,598,1,30,0,0
4341,117,431,466,1063,23,13,9,349,632,2,30,0,0
4342,211,410,571,1064,23,13,9,360,654,3,30,0,0
4343,268,390,634,1062,23,13,9,366,672,4,30,0,0
4344,330,357,693,1031,23,13,9,363,674,5,30,0,0
4345,369,337,728,1016,23,13,9,359,679,6,30,0,0
4346,402,314,746,980,23,13,9,344,666,7,30,0,0
4347,437,292,753,918,23,13,9,316,626,8,30,0,0
4348,462,287,760,887,23,13,9,298,600,9,30,0,0
4349,484,273,751,824,23,13,9,267,551,10,30,0,0
4350,487,252,738,785,23,13,9,251,533,11,30,0,0
4351,490,245,723,756,23,13,9,233,511,12,30,0,0
4352,516,228,743,727,23,13,9,227,499,13,30,0,0
4354,469,221,649,631,23,13,9,180,410,0,30,0,1
4355,491,212,609,475,23,13,9,118,263,1,30,0,0
4356,477,209,605,501,23,13,9,128,292,2,30,0,0
4357,459,203,600,534,23,13,9,141,331,3,30,0,0
4358,448,190,594,545,23,13,9,146,355,4,30,0,0
4359,443,184,586,548,23,13,9,143,364,5,30,0,0
4360,443,181,580,545,23,13,9,137,364,6,30,0,0
4361,445,177,572,525,23,13,9,127,348,7,30,0,0
4362,449,178,559,487,23,13,9,110,309,8,30,0,0
4363,446,183,548,475,23,13,9,102,292,9,30,0,0
4364,445,177,543,460,23,13,9,98,283,10,30,0,0
4365,455,172,532,390,23,13,9,77,218,11,30,0,0
4366,455,170,535,399,23,13,9,80,229,12,30,0,0
4367,459,163,531,366,23,13,9,72,203,13,30,0,0
4368,469,158,525,303,23,13,9,56,145,14,30,0,0
4369,465,155,512,267,23,13,9,47,112,15,30,0,0
4370,460,148,513,268,23,13,9,53,120,16,30,0,0
4371,442,148,515,320,23,13,9,73,172,17,30,0,0
4372,431,148,519,363,23,13,9,88,215,18,30,0,0
4373,427,143,521,381,23,13,9,94,238,19,30,0,0
4374,423,142,514,379,23,13,9,91,237,20,30,0,0
4375,419,139,509,383,23,13,9,90,244,21,30,0,0
4376,412,136,501,381,23,13,9,89,245,22,30,0,0
4377,409,137,494,373,23,13,9,85,236,23,30,0,0
4378,410,137,491,368,23,13,9,81,231,24,30,0,0
4379,411,134,489,365,23,13,9,78,231,25,30,0,0
4380,411,129,484,352,23,13,9,73,223,26,30,0,0
4381,408,128,483,361,23,13,9,75,233,27,30,0,0
4382,412,126,479,338,23,13,9,67,212,28,30,0,0
4383,419,121,478,309,23,13,9,59,188,29,30,0,0
4384,417,118,476,304,23,13,9,59,186,30,30,1,0
4397,464,124,508,272,23,13,9,44,148,0,30,0,0
4398,467,124,510,269,23,13,9,43,145,1,30,0,0
4341,0,942,86,1080,24,13,9,86,138,0,16,0,0
4342,0,817,133,1080,24,13,9,133,263,1,16,0,0
4343,0,666,189,1073,24,13,9,189,407,2,16,0,0
4344,0,548,270,1075,24,13,9,270,527,3,16,0,0
4345,0,483,334,1072,24,13,9,334,589,4,16,0,0
4346,38,441,406,1074,24,13,9,368,633,5,16,0,0
4347,125,422,486,1046,24,13,9,361,624,6,16,0,0
4348,193,413,551,1037,24,13,9,358,624,7,16,0,0
4349,268,400,620,1019,24,13,9,352,619,8,16,0,0
4350,316,386,664,1014,24,13,9,348,628,9,16,0,0
4351,361,369,704,1011,24,13,9,343,642,10,16,0,0
4352,426,344,748,959,24,13,9,322,615,11,16,0,0
4353,472,332,772,918,24,13,9,300,586,12,16,0,0
4354,517,327,786,865,24,13,9,269,538,13,16,0,0
4355,538,312,786,823,24,13,9,248,511,14,16,0,0
4356,569,311,767,731,24,13,9,198,420,15,16,0,0
4357,595,279,795,703,24,13,9,200,424,16,16,0,0
4349,3,580,217,1080,28,13,9,214,500,0,85,0,1
4350,42,545,272,1080,28,13,9,230,535,1,85,0,0
4351,136,519,379,1080,28,13,9,243,561,2,85,0,0
4352,227,501,477,1077,28,13,9,250,576,3,85,0,0
4353,309,468,574,1073,28,13,9,265,605,4,85,0,0
4354,389,448,664,1065,28,13,9,275,617,5,85,0,0
4355,420,415,712,1072,28,13,9,292,657,6,85,0,0
4356,462,393,748,1042,28,13,9,286,649,7,85,0,0
4357,512,373,793,1018,28,13,9,281,645,8,85,0,0
4358,560,350,824,955,28,13,9,264,605,9,85,0,0
4359,586,330,843,925,28,13,9,257,595,10,85,0,0
4360,592,314,836,885,28,13,9,244,571,11,85,0,0
4361,588,291,812,822,28,13,9,224,531,12,85,0,0
4362,587,281,802,798,28,13,9,215,517,13,85,0,0
4363,604,272,798,745,28,13,9,194,473,14,85,0,0
4364,609,264,793,718,28,13,9,184,454,15,85,0,0
4365,602,258,777,697,28,13,9,175,439,16,85,0,0
4366,594,240,758,658,28,13,9,164,418,17,85,0,0
4367,587,234,748,645,28,13,9,161,411,18,85,0,0
4368,598,223,748,608,28,13,9,150,385,19,85,0,0
4369,603,217,746,589,28,13,9,143,372,20,85,0,0
4370,594,213,730,568,28,13,9,136,355,21,85,0,0
4371,584,202,714,547,28,13,9,130,345,22,85,0,0
4372,579,199,706,539,28,13,9,127,340,23,85,0,0
4373,580,192,702,519,28,13,9,122,327,24,85,0,0
4374,580,188,696,501,28,13,9,116,313,25,85,0,0
4375,575,186,687,492,28,13,9,112,306,26,85,0,0
4376,567,178,674,475,28,13,9,107,297,27,85,0,0
4377,557,181,660,464,28,13,9,103,283,28,85,0,0
4378,552,174,655,459,28,13,9,103,285,29,85,0,0
4379,554,170,650,438,28,13,9,96,268,30,85,0,0
4380,551,166,644,433,28,13,9,93,267,31,85,0,0
4381,543,160,632,416,28,13,9,89,256,32,85,0,0
4382,536,161,621,407,28,13,9,85,246,33,85,0,0
4383,535,160,619,400,28,13,9,84,240,34,85,0,0
4384,537,156,620,391,28,13,9,83,235,35,85,0,0
4385,534,155,614,386,28,13,9,80,231,36,85,0,0
4386,528,150,606,376,28,13,9,78,226,37,85,0,0
4387,524,148,598,366,28,13,9,74,218,38,85,0,0
4388,523,147,597,363,28,13,9,74,216,39,85,0,0
4389,527,143,598,355,28,13,9,71,212,40,85,0,0
4390,527,141,597,352,28,13,9,70,211,41,85,0,0
4391,524,143,590,343,28,13,9,66,200,42,85,0,0
4392,519,140,585,338,28,13,9,66,198,43,85,0,0
4393,517,140,581,331,28,13,9,64,191,44,85,0,0
4394,517,137,579,327,28,13,9,62,190,45,85,0,0
4395,516,136,577,324,28,13,9,61,188,46,85,0,0
4396,511,138,572,322,28,13,9,61,184,47,85,0,0
4397,508,132,566,313,28,13,9,58,181,48,85,0,0
4398,506,129,564,308,28,13,9,58,179,49,85,0,0
4399,507,123,564,303,28,13,9,57,180,50,85,0,0
4400,507,120,564,301,28,13,9,57,181,51,85,0,0
4401,504,121,560,299,28,13,9,56,178,52,85,0,0
4402,501,119,556,293,28,13,9,55,174,53,85,0,0
4403,499,116,553,290,28,13,9,54,174,54,85,0,0
4404,500,116,553,285,28,13,9,53,169,55,85,0,0
4405,501,116,552,279,28,13,9,51,163,56,85,0,0
4406,499,115,550,278,28,13,9,51,163,57,85,0,0
4407,498,113,548,272,28,13,9,50,159,58,85,0,0
4408,498,111,547,269,28,13,9,49,158,59,85,0,0
4409,499,112,546,263,28,13,9,47,151,60,85,0,0
4410,500,112,546,259,28,13,9,46,147,61,85,0,0
4411,497,110,544,259,28,13,9,47,149,62,85,0,0
4412,497,108,542,255,28,13,9,45,147,63,85,0,0
4413,496,107,541,253,28,13,9,45,146,64,85,0,0
4414,497,106,541,249,28,13,9,44,143,65,85,0,0
4415,499,107,543,247,28,13,9,44,140,66,85,0,0
4416,500,109,543,244,28,13,9,43,135,67,85,0,0
4417,498,107,541,241,28,13,9,43,134,68,85,0,0
4418,498,106,540,238,28,13,9,42,132,69,85,0,0
4419,497,106,539,236,28,13,9,42,130,70,85,0,0
4420,495,103,537,237,28,13,9,42,134,71,85,0,0
4421,491,102,533,234,28,13,9,42,132,72,85,0,0
4422,488,97,529,230,28,13,9,41,133,73,85,0,0
4423,486,100,525,225,28,13,9,39,125,74,85,0,0
4424,486,99,524,223,28,13,9,38,124,75,85,0,0
4425,485,99,523,222,28,13,9,38,123,76,85,0,0
4426,484,103,521,221,28,13,9,37,118,77,85,0,0
4427,484,101,521,219,28,13,9,37,118,78,85,0,0
4428,485,99,521,217,28,13,9,36,118,79,85,0,0
4429,486,96,522,215,28,13,9,36,119,80,85,0,0
4430,488,96,523,212,28,13,9,35,116,81,85,0,0
4431,488,94,523,211,28,13,9,35,117,82,85,0,0
4432,487,92,522,210,28,13,9,35,118,83,85,0,0
4433,486,91,521,208,28,13,9,35,117,84,85,0,0
4434,487,90,522,205,28,13,9,35,115,85,85,1,0
4352,491,237,642,486,29,13,9,151,249,0,1,0,0
4353,477,229,627,477,29,13,9,150,248,1,1,0,0
4357,558,304,696,499,30,13,9,138,195,0,86,0,1
4358,494,290,691,571,30,13,9,197,281,1,86,0,0
4359,456,284,718,665,30,13,9,262,381,2,86,0,0
4360,443,275,723,692,30,13,9,280,417,3,86,0,0
4361,435,259,715,685,30,13,9,280,426,4,86,0,0
4362,425,251,702,685,30,13,9,277,434,5,86,0,0
4363,421,243,676,653,30,13,9,255,410,6,86,0,0
4364,405,211,661,637,30,13,9,256,426,7,86,0,0
4365,404,213,647,629,30,13,9,243,416,8,86,0,0
4366,414,210,628,588,30,13,9,214,378,9,86,0,0
4367,418,209,615,568,30,13,9,197,359,10,86,0,0
4368,415,198,600,550,30,13,9,185,352,11,86,0,0
4369,419,203,588,536,30,13,9,169,333,12,86,0,0
4370,424,207,584,535,30,13,9,160,328,13,86,0,0
4371,435,204,577,502,30,13,9,142,298,14,86,0,0
4372,439,194,577,491,30,13,9,138,297,15,86,0,0
4373,445,195,576,486,30,13,9,131,291,16,86,0,0
4374,447,194,568,467,30,13,9,121,273,17,86,0,0
4375,449,192,563,456,30,13,9,114,264,18,86,0,0
4376,455,190,564,452,30,13,9,109,262,19,86,0,0
4377,458,183,561,434,30,13,9,103,251,20,86,0,0
4378,454,181,553,425,30,13,9,99,244,21,86,0,0
4379,448,180,544,421,30,13,9,96,241,22,86,0,0
4380,441,176,532,406,30,13,9,91,230,23,86,0,0
4381,437,174,525,403,30,13,9,88,229,24,86,0,0
4382,436,173,519,390,30,13,9,83,217,25,86,0,0
4383,433,165,516,384,30,13,9,83,219,26,86,0,0
4384,430,165,510,381,30,13,9,80,216,27,86,0,0
4385,429,158,506,371,30,13,9,77,213,28,86,0,0
4386,426,140,506,365,30,13,9,80,225,29,86,0,0
4387,425,134,505,361,30,13,9,80,227,30,86,0,0
4388,434,142,508,350,30,13,9,74,208,31,86,0,0
4389,435,140,506,344,30,13,9,71,204,32,86,0,0
4390,432,130,505,342,30,13,9,73,212,33,86,0,0
4391,431,128,502,337,30,13,9,71,209,34,86,0,0
4392,428,134,496,334,30,13,9,68,200,35,86,0,0
4393,433,142,494,324,30,13,9,61,182,36,86,0,0
4394,438,143,495,317,30,13,9,57,174,37,86,0,0
4395,439,142,494,312,30,13,9,55,170,38,86,0,0
4396,439,138,494,306,30,13,9,55,168,39,86,0,0
4397,439,134,493,303,30,13,9,54,169,40,86,0,0
4398,440,132,494,302,30,13,9,54,170,41,86,0,0
4399,441,128,495,299,30,13,9,54,171,42,86,0,0
4400,442,125,496,296,30,13,9,54,171,43,86,0,0
4401,444,126,496,292,30,13,9,52,166,44,86,0,0
4402,445,125,494,281,30,13,9,49,156,45,86,0,0
4403,445,124,494,278,30,13,9,49,154,46,86,0,0
4404,447,122,494,272,30,13,9,47,150,47,86,0,0
4405,444,117,493,271,30,13,9,49,154,48,86,0,0
4406,444,115,493,271,30,13,9,49,156,49,86,0,0
4407,442,110,492,270,30,13,9,50,160,50,86,0,0
4408,440,101,491,268,30,13,9,51,167,51,86,0,0
4409,439,99,491,266,30,13,9,52,167,52,86,0,0
4410,439,95,491,263,30,13,9,52,168,53,86,0,0
4411,441,100,490,260,30,13,9,49,160,54,86,0,0
4412,437,94,488,258,30,13,9,51,164,55,86,0,0
4413,436,96,485,255,30,13,9,49,159,56,86,0,0
4414,436,94,485,253,30,13,9,49,159,57,86,0,0
4415,436,89,486,251,30,13,9,50,162,58,86,0,0
4416,436,92,485,248,30,13,9,49,156,59,86,0,0
4417,434,93,482,246,30,13,9,48,153,60,86,0,0
4418,433,92,480,240,30,13,9,47,148,61,86,0,0
4419,434,92,479,237,30,13,9,45,145,62,86,0,0
4420,434,88,480,233,30,13,9,46,145,63,86,0,0
4421,435,85,481,232,30,13,9,46,147,64,86,0,0
4422,435,82,481,229,30,13,9,46,147,65,86,0,0
4423,435,84,480,225,30,13,9,45,141,66,86,0,0
4424,435,86,477,221,30,13,9,42,135,67,86,0,0
4425,433,88,476,222,30,13,9,43,134,68,86,0,0
4426,432,93,474,223,30,13,9,42,130,69,86,0,0
4427,431,89,474,223,30,13,9,43,134,70,86,0,0
4428,433,86,476,219,30,13,9,43,133,71,86,0,0
4429,434,90,474,214,30,13,9,40,124,72,86,0,0
4430,435,88,474,213,30,13,9,39,125,73,86,0,0
4431,435,90,473,209,30,13,9,38,119,74,86,0,0
4432,435,86,475,207,30,13,9,40,121,75,86,0,0
4433,436,86,474,204,30,13,9,38,118,76,86,0,0
4434,437,85,476,202,30,13,9,39,117,77,86,0,0
4435,435,86,473,200,30,13,9,38,114,78,86,0,0
4436,434,86,472,200,30,13,9,38,114,79,86,0,0
4437,434,84,472,198,30,13,9,38,114,80,86,0,0
4438,435,83,472,196,30,13,9,37,113,81,86,0,0
4439,435,83,472,194,30,13,9,37,111,82,86,0,0
4440,435,85,471,193,30,13,9,36,108,83,86,0,0
4441,435,84,470,191,30,13,9,35,107,84,86,0,0
4442,451,84,487,192,30,13,9,36,108,85,86,0,0
4443,458,84,493,191,30,13,9,35,107,86,86,1,0
124,1259,191,1308,419,1,15,1,49,228,0,35,0,1
125,1268,192,1316,415,1,15,1,48,223,1,35,0,0
126,1281,193,1330,413,1,15,1,49,220,2,35,0,0
127,1307,195,1361,427,1,15,1,54,232,3,35,0,0
128,1330,195,1386,431,1,15,1,56,236,4,35,0,0
129,1354,201,1415,448,1,15,1,61,247,5,35,0,0
130,1370,204,1436,458,1,15,1,66,254,6,35,0,0
131,1387,207,1454,463,1,15,1,67,256,7,35,0,0
132,1400,215,1472,478,1,15,1,72,263,8,35,0,0
133,1409,218,1487,490,1,15,1,78,272,9,35,0,0
134,1423,223,1505,498,1,15,1,82,275,10,35,0,0
135,1428,230,1516,520,1,15,1,88,290,11,35,0,0
136,1430,233,1523,532,1,15,1,93,299,12,35,0,0
137,1428,242,1528,552,1,15,1,100,310,13,35,0,0
138,1427,246,1534,568,1,15,1,107,322,14,35,0,0
139,1426,253,1544,592,1,15,1,118,339,15,35,0,0
140,1420,264,1545,614,1,15,1,125,350,16,35,0,0
141,1413,271,1545,630,1,15,1,132,359,17,35,0,0
142,1408,286,1550,667,1,15,1,142,381,18,35,0,0
143,1401,294,1552,687,1,15,1,151,393,19,35,0,0
144,1393,303,1557,718,1,15,1,164,415,20,35,0,0
145,1377,316,1551,746,1,15,1,174,430,21,35,0,0
146,1361,324,1548,775,1,15,1,187,451,22,35,0,0
147,1342,340,1551,837,1,15,1,209,497,23,35,0,0
148,1328,352,1549,869,1,15,1,221,517,24,35,0,0
149,1306,377,1546,931,1,15,1,240,554,25,35,0,0
150,1274,403,1530,982,1,15,1,256,579,26,35,0,0
151,1236,423,1512,1038,1,15,1,276,615,27,35,0,0
152,1202,460,1483,1068,1,15,1,281,608,28,35,0,0
153,1165,489,1452,1080,1,15,1,287,591,29,35,0,0
154,1130,535,1415,1080,1,15,1,285,545,30,35,0,0
155,1078,584,1358,1080,1,15,1,280,496,31,35,0,0
156,1022,634,1295,1080,1,15,1,273,446,32,35,0,0
157,1006,731,1247,1080,1,15,1,241,349,33,35,0,0
158,1009,839,1202,1080,1,15,1,193,241,34,35,0,0
159,1000,885,1169,1080,1,15,1,169,195,35,35,1,0
950,1262,180,1307,384,2,15,1,45,204,0,20,0,1
951,1270,186,1310,369,2,15,1,40,183,1,20,0,0
952,1297,178,1341,369,2,15,1,44,191,2,20,0,0
953,1317,171,1363,358,2,15,1,46,187,3,20,0,0
954,1338,164,1388,363,2,15,1,50,199,4,20,0,0
955,1360,163,1413,366,2,15,1,53,203,5,20,0,0
956,1383,159,1437,365,2,15,1,54,206,6,20,0,0
957,1404,159,1460,364,2,15,1,56,205,7,20,0,0
958,1423,157,1480,361,2,15,1,57,204,8,20,0,0
959,1443,154,1497,347,2,15,1,54,193,9,20,0,0
960,1459,158,1514,351,2,15,1,55,193,10,20,0,0
961,1472,157,1527,350,2,15,1,55,193,11,20,0,0
962,1483,153,1537,340,2,15,1,54,187,12,20,0,0
963,1490,154,1544,337,2,15,1,54,183,13,20,0,0
964,1495,152,1549,330,2,15,1,54,178,14,20,0,0
965,1496,153,1550,328,2,15,1,54,175,15,20,0,0
966,1498,153,1551,327,2,15,1,53,174,16,20,0,0
967,1501,149,1553,317,2,15,1,52,168,17,20,0,0
968,1501,148,1552,314,2,15,1,51,166,18,20,0,0
969,1497,147,1549,315,2,15,1,52,168,19,20,0,0
970,1505,146,1556,312,2,15,1,51,166,20,20,1,0
957,1261,154,1321,346,3,15,1,60,192,0,27,0,1
958,1279,155,1339,346,3,15,1,60,191,1,27,0,0
959,1299,157,1356,338,3,15,1,57,181,2,27,0,0
960,1319,153,1379,343,3,15,1,60,190,3,27,0,0
961,1344,152,1402,338,3,15,1,58,186,4,27,0,0
962,1366,151,1424,335,3,15,1,58,184,5,27,0,0
963,1386,150,1446,340,3,15,1,60,190,6,27,0,0
964,1402,154,1461,337,3,15,1,59,183,7,27,0,0
965,1415,149,1475,337,3,15,1,60,188,8,27,0,0
966,1423,147,1485,333,3,15,1,62,186,9,27,0,0
967,1435,146,1493,323,3,15,1,58,177,10,27,0,0
968,1443,143,1504,327,3,15,1,61,184,11,27,0,0
969,1452,145,1510,325,3,15,1,58,180,12,27,0,0
970,1465,144,1525,324,3,15,1,60,180,13,27,0,0
971,1471,145,1529,315,3,15,1,58,170,14,27,0,0
972,1468,144,1528,309,3,15,1,60,165,15,27,0,0
973,1475,146,1532,305,3,15,1,57,159,16,27,0,0
974,1477,145,1533,303,3,15,1,56,158,17,27,0,0
975,1477,147,1531,298,3,15,1,54,151,18,27,0,0
976,1478,147,1529,291,3,15,1,51,144,19,27,0,0
977,1475,145,1527,294,3,15,1,52,149,20,27,0,0
978,1471,143,1523,295,3,15,1,52,152,21,27,0,0
979,1466,141,1518,296,3,15,1,52,155,22,27,0,0
980,1458,141,1509,294,3,15,1,51,153,23,27,0,0
981,1447,140,1497,295,3,15,1,50,155,24,27,0,0
982,1439,138,1490,293,3,15,1,51,155,25,27,0,0
983,1434,141,1483,291,3,15,1,49,150,26,27,0,0
984,1432,140,1481,289,3,15,1,49,149,27,27,1,0
973,1443,144,1489,288,4,15,1,46,144,0,4,0,0
974,1440,144,1486,290,4,15,1,46,146,1,4,0,0
975,1430,144,1476,288,4,15,1,46,144,2,4,0,0
976,1420,150,1462,282,4,15,1,42,132,3,4,0,0
977,1414,152,1454,280,4,15,1,40,128,4,4,0,0
1104,1561,139,1596,285,6,15,1,35,146,0,30,0,1
1105,1551,137,1588,287,6,15,1,37,150,1,30,0,0
1106,1542,138,1579,286,6,15,1,37,148,2,30,0,0
1107,1535,141,1572,279,6,15,1,37,138,3,30,0,0
1108,1527,142,1568,291,6,15,1,41,149,4,30,0,0
1109,1522,144,1564,298,6,15,1,42,154,5,30,0,0
1110,1515,146,1559,301,6,15,1,44,155,6,30,0,0
1111,1508,145,1553,301,6,15,1,45,156,7,30,0,0
1112,1499,146,1545,305,6,15,1,46,159,8,30,0,0
1113,1491,148,1537,308,6,15,1,46,160,9,30,0,0
1114,1483,149,1530,307,6,15,1,47,158,10,30,0,0
1115,1477,148,1526,311,6,15,1,49,163,11,30,0,0
1116,1470,151,1521,317,6,15,1,51,166,12,30,0,0
1117,1460,149,1513,320,6,15,1,53,171,13,30,0,0
1118,1451,147,1505,322,6,15,1,54,175,14,30,0,0
1119,1442,149,1496,322,6,15,1,54,173,15,30,0,0
1120,1435,149,1489,327,6,15,1,54,178,16,30,0,0
1121,1428,149,1482,328,6,15,1,54,179,17,30,0,0
1122,1422,150,1476,328,6,15,1,54,178,18,30,0,0
1123,1412,152,1466,333,6,15,1,54,181,19,30,0,0
1124,1400,151,1456,336,6,15,1,56,185,20,30,0,0
1125,1389,149,1445,340,6,15,1,56,191,21,30,0,0
1126,1378,151,1434,340,6,15,1,56,189,22,30,0,0
1127,1366,152,1421,341,6,15,1,55,189,23,30,0,0
1128,1351,151,1406,341,6,15,1,55,190,24,30,0,0
1129,1336,153,1392,342,6,15,1,56,189,25,30,0,0
1130,1323,155,1380,340,6,15,1,57,185,26,30,0,0
1131,1299,154,1357,342,6,15,1,58,188,27,30,0,0
1132,1279,154,1338,345,6,15,1,59,191,28,30,0,0
1133,1266,155,1327,346,6,15,1,61,191,29,30,0,0
1134,1253,155,1315,348,6,15,1,62,193,30,30,1,0
1445,1432,139,1467,286,7,15,1,35,147,0,42,0,1
1446,1438,134,1476,289,7,15,1,38,155,1,42,0,0
1447,1448,139,1486,295,7,15,1,38,156,2,42,0,0
1448,1457,141,1496,298,7,15,1,39,157,3,42,0,0
1449,1469,142,1509,299,7,15,1,40,157,4,42,0,0
1450,1478,143,1518,300,7,15,1,40,157,5,42,0,0
1451,1483,142,1525,302,7,15,1,42,160,6,42,0,0
1452,1488,144,1532,305,7,15,1,44,161,7,42,0,0
1453,1498,146,1542,304,7,15,1,44,158,8,42,0,0
1454,1508,150,1554,300,7,15,1,46,150,9,42,0,0
1455,1505,147,1553,302,7,15,1,48,155,10,42,0,0
1456,1501,149,1551,307,7,15,1,50,158,11,42,0,0
1457,1493,147,1547,308,7,15,1,54,161,12,42,0,0
1458,1500,151,1554,310,7,15,1,54,159,13,42,0,0
1459,1503,154,1556,312,7,15,1,53,158,14,42,0,0
1460,1501,156,1554,312,7,15,1,53,156,15,42,0,0
1461,1498,153,1554,317,7,15,1,56,164,16,42,0,0
1462,1493,151,1551,323,7,15,1,58,172,17,42,0,0
1463,1488,148,1547,325,7,15,1,59,177,18,42,0,0
1464,1482,146,1541,326,7,15,1,59,180,19,42,0,0
1465,1478,149,1539,333,7,15,1,61,184,20,42,0,0
1466,1470,149,1533,334,7,15,1,63,185,21,42,0,0
1467,1464,150,1527,337,7,15,1,63,187,22,42,0,0
1468,1459,150,1522,338,7,15,1,63,188,23,42,0,0
1469,1449,150,1513,342,7,15,1,64,192,24,42,0,0
1470,1442,150,1507,347,7,15,1,65,197,25,42,0,0
1471,1432,150,1496,344,7,15,1,64,194,26,42,0,0
1472,1426,150,1489,343,7,15,1,63,193,27,42,0,0
1473,1415,152,1479,343,7,15,1,64,191,28,42,0,0
1474,1401,150,1467,352,7,15,1,66,202,29,42,0,0
1475,1389,150,1456,355,7,15,1,67,205,30,42,0,0
1476,1377,152,1445,358,7,15,1,68,206,31,42,0,0
1477,1366,152,1435,359,7,15,1,69,207,32,42,0,0
1478,1353,151,1420,356,7,15,1,67,205,33,42,0,0
1479,1341,153,1408,358,7,15,1,67,205,34,42,0,0
1480,1332,156,1398,360,7,15,1,66,204,35,42,0,0
1481,1318,158,1382,360,7,15,1,64,202,36,42,0,0
1482,1305,157,1368,362,7,15,1,63,205,37,42,0,0
1483,1294,163,1357,364,7,15,1,63,201,38,42,0,0
1484,1282,164,1346,365,7,15,1,64,201,39,42,0,0
1485,1264,165,1327,364,7,15,1,63,199,40,42,0,0
1486,1253,165,1314,364,7,15,1,61,199,41,42,0,0
1487,1242,166,1303,365,7,15,1,61,199,42,42,1,0
1710,1259,165,1316,334,8,15,1,57,169,0,36,0,1
1711,1272,161,1332,337,8,15,1,60,176,1,36,0,0
1712,1289,163,1348,335,8,15,1,59,172,2,36,0,0
1713,1311,161,1369,332,8,15,1,58,171,3,36,0,0
1714,1338,160,1399,335,8,15,1,61,175,4,36,0,0
1715,1360,161,1420,335,8,15,1,60,174,5,36,0,0
1716,1376,158,1438,336,8,15,1,62,178,6,36,0,0
1717,1391,158,1454,337,8,15,1,63,179,7,36,0,0
1718,1404,159,1465,335,8,15,1,61,176,8,36,0,0
1719,1417,154,1480,331,8,15,1,63,177,9,36,0,0
1720,1425,156,1485,321,8,15,1,60,165,10,36,0,0
1721,1425,153,1486,322,8,15,1,61,169,11,36,0,0
1722,1431,152,1491,318,8,15,1,60,166,12,36,0,0
1723,1435,151,1495,313,8,15,1,60,162,13,36,0,0
1724,1437,150,1498,311,8,15,1,61,161,14,36,0,0
1725,1436,151,1500,314,8,15,1,64,163,15,36,0,0
1726,1440,150,1506,313,8,15,1,66,163,16,36,0,0
1727,1443,149,1510,307,8,15,1,67,158,17,36,0,0
1728,1445,148,1515,304,8,15,1,70,156,18,36,0,0
1729,1445,148,1515,302,8,15,1,70,154,19,36,0,0
1730,1452,147,1522,305,8,15,1,70,158,20,36,0,0
1731,1458,147,1526,308,8,15,1,68,161,21,36,0,0
1732,1461,147,1527,309,8,15,1,66,162,22,36,0,0
1733,1464,146,1527,306,8,15,1,63,160,23,36,0,0
1734,1465,147,1525,305,8,15,1,60,158,24,36,0,0
1735,1463,148,1522,304,8,15,1,59,156,25,36,0,0
1736,1460,147,1518,301,8,15,1,58,154,26,36,0,0
1737,1453,146,1510,300,8,15,1,57,154,27,36,0,0
1738,1442,145,1500,298,8,15,1,58,153,28,36,0,0
1739,1437,142,1495,296,8,15,1,58,154,29,36,0,0
1740,1434,140,1492,298,8,15,1,58,158,30,36,0,0
1741,1433,141,1489,297,8,15,1,56,156,31,36,0,0
1742,1431,142,1484,294,8,15,1,53,152,32,36,0,0
1743,1427,143,1480,296,8,15,1,53,153,33,36,0,0
1744,1423,144,1476,296,8,15,1,53,152,34,36,0,0
1745,1421,155,1467,290,8,15,1,46,135,35,36,0,0
1746,1419,156,1464,289,8,15,1,45,133,36,36,1,0
2271,1425,148,1472,291,9,15,1,47,143,0,25,0,1
2272,1429,145,1477,291,9,15,1,48,146,1,25,0,0
2273,1435,141,1486,294,9,15,1,51,153,2,25,0,0
2274,1443,142,1495,298,9,15,1,52,156,3,25,0,0
2275,1452,147,1503,300,9,15,1,51,153,4,25,0,0
2276,1463,147,1513,300,9,15,1,50,153,5,25,0,0
2277,1471,149,1522,303,9,15,1,51,154,6,25,0,0
2278,1476,150,1528,306,9,15,1,52,156,7,25,0,0
2279,1480,154,1533,307,9,15,1,53,153,8,25,0,0
2280,1483,155,1538,315,9,15,1,55,160,9,25,0,0
2281,1482,156,1539,320,9,15,1,57,164,10,25,0,0
2282,1480,156,1537,320,9,15,1,57,164,11,25,0,0
2283,1473,157,1534,328,9,15,1,61,171,12,25,0,0
2284,1464,156,1526,331,9,15,1,62,175,13,25,0,0
2285,1455,155,1518,333,9,15,1,63,178,14,25,0,0
2286,1444,156,1509,338,9,15,1,65,182,15,25,0,0
2287,1434,155,1498,338,9,15,1,64,183,16,25,0,0
2288,1414,158,1477,341,9,15,1,63,183,17,25,0,0
2289,1395,156,1460,341,9,15,1,65,185,18,25,0,0
2290,1372,157,1435,340,9,15,1,63,183,19,25,0,0
2291,1349,163,1413,340,9,15,1,64,177,20,25,0,0
2292,1329,161,1394,337,9,15,1,65,176,21,25,0,0
2293,1303,158,1368,338,9,15,1,65,180,22,25,0,0
2294,1284,159,1349,337,9,15,1,65,178,23,25,0,0
2295,1266,162,1334,344,9,15,1,68,182,24,25,0,0
2296,1254,163,1321,346,9,15,1,67,183,25,25,1,0
2648,1420,143,1456,285,10,15,1,36,142,0,19,0,1
2649,1430,141,1468,288,10,15,1,38,147,1,19,0,0
2650,1446,141,1485,292,10,15,1,39,151,2,19,0,0
2651,1464,144,1502,293,10,15,1,38,149,3,19,0,0
2652,1476,141,1517,298,10,15,1,41,157,4,19,0,0
2653,1490,147,1531,302,10,15,1,41,155,5,19,0,0
2654,1501,148,1544,307,10,15,1,43,159,6,19,0,0
2655,1511,149,1556,312,10,15,1,45,163,7,19,0,0
2656,1521,152,1566,316,10,15,1,45,164,8,19,0,0
2657,1527,151,1574,317,10,15,1,47,166,9,19,0,0
2658,1528,153,1577,326,10,15,1,49,173,10,19,0,0
2659,1523,154,1574,332,10,15,1,51,178,11,19,0,0
2660,1512,151,1566,336,10,15,1,54,185,12,19,0,0
2661,1504,157,1558,338,10,15,1,54,181,13,19,0,0
2662,1489,157,1543,335,10,15,1,54,178,14,19,0,0
2663,1466,154,1524,343,10,15,1,58,189,15,19,0,0
2664,1451,157,1512,348,10,15,1,61,191,16,19,0,0
2665,1429,154,1490,348,10,15,1,61,194,17,19,0,0
2666,1406,155,1467,349,10,15,1,61,194,18,19,0,0
2667,1400,156,1462,353,10,15,1,62,197,19,19,0,0
2667,1370,163,1422,349,11,15,1,52,186,0,6,0,0
2668,1349,156,1401,342,11,15,1,52,186,1,6,0,0
2669,1325,161,1378,345,11,15,1,53,184,2,6,0,0
2670,1296,160,1347,341,11,15,1,51,181,3,6,0,0
2671,1268,159,1321,346,11,15,1,53,187,4,6,0,0
2672,1260,172,1311,352,11,15,1,51,180,5,6,0,0
2673,1241,175,1292,353,11,15,1,51,178,6,6,0,0
2842,507,843,711,1075,13,15,1,204,232,0,10,0,0
2843,552,788,809,1079,13,15,1,257,291,1,10,0,0
2844,574,704,906,1080,13,15,1,332,376,2,10,0,0
2845,615,633,1004,1075,13,15,1,389,442,3,10,0,0
2846,673,575,1102,1072,13,15,1,429,497,4,10,0,0
2847,719,513,1193,1071,13,15,1,474,558,5,10,0,0
2848,766,476,1260,1074,13,15,1,494,598,6,10,0,0
2849,795,432,1306,1072,13,15,1,511,640,7,10,0,0
2850,842,401,1343,1054,13,15,1,501,653,8,10,0,0
2851,894,380,1379,1037,13,15,1,485,657,9,10,0,0
2852,928,336,1442,1034,13,15,1,514,698,10,10,0,0
2852,1081,376,1280,899,14,15,1,199,523,0,23,0,1
2853,1105,361,1302,879,14,15,1,197,518,1,23,0,0
2854,1125,332,1311,821,14,15,1,186,489,2,23,0,0
2855,1154,318,1328,776,14,15,1,174,458,3,23,0,0
2856,1185,309,1350,743,14,15,1,165,434,4,23,0,0
2857,1220,293,1373,697,14,15,1,153,404,5,23,0,0
2858,1237,288,1389,685,14,15,1,152,397,6,23,0,0
2859,1246,274,1390,651,14,15,1,144,377,7,23,0,0
2860,1264,260,1399,613,14,15,1,135,353,8,23,0,0
2861,1279,251,1412,598,14,15,1,133,347,9,23,0,0
2862,1294,239,1423,578,14,15,1,129,339,10,23,0,0
2863,1306,236,1434,573,14,15,1,128,337,11,23,0,0
2864,1308,229,1429,546,14,15,1,121,317,12,23,0,0
2865,1309,222,1425,527,14,15,1,116,305,13,23,0,0
2866,1315,218,1428,516,14,15,1,113,298,14,23,0,0
2867,1320,210,1428,497,14,15,1,108,287,15,23,0,0
2868,1316,209,1419,483,14,15,1,103,274,16,23,0,0
2869,1307,205,1407,468,14,15,1,100,263,17,23,0,0
2870,1295,201,1391,453,14,15,1,96,252,18,23,0,0
2871,1288,200,1382,445,14,15,1,94,245,19,23,0,0
2872,1274,192,1364,430,14,15,1,90,238,20,23,0,0
2873,1264,194,1352,426,14,15,1,88,232,21,23,0,0
2874,1261,196,1345,418,14,15,1,84,222,22,23,0,0
2875,1259,193,1339,404,14,15,1,80,211,23,23,1,0
3328,892,393,1353,870,17,15,1,461,477,0,26,0,1
3329,947,377,1352,813,17,15,1,405,436,1,26,0,0
3330,993,368,1361,781,17,15,1,368,413,2,26,0,0
3331,1034,351,1371,743,17,15,1,337,392,3,26,0,0
3332,1053,341,1369,723,17,15,1,316,382,4,26,0,0
3333,1066,331,1366,715,17,15,1,300,384,5,26,0,0
3334,1094,314,1365,675,17,15,1,271,361,6,26,0,0
3335,1121,308,1371,656,17,15,1,250,348,7,26,0,0
3336,1142,296,1373,630,17,15,1,231,334,8,26,0,0
3337,1161,292,1376,615,17,15,1,215,323,9,26,0,0
3338,1169,287,1377,612,17,15,1,208,325,10,26,0,0
3339,1186,277,1377,586,17,15,1,191,309,11,26,0,0
3340,1205,274,1385,571,17,15,1,180,297,12,26,0,0
3341,1221,266,1391,551,17,15,1,170,285,13,26,0,0
3342,1237,258,1401,537,17,15,1,164,279,14,26,0,0
3343,1247,254,1406,531,17,15,1,159,277,15,26,0,0
3344,1256,248,1406,515,17,15,1,150,267,16,26,0,0
3345,1266,245,1410,504,17,15,1,144,259,17,26,0,0
3346,1276,240,1413,493,17,15,1,137,253,18,26,0,0
3347,1284,236,1415,478,17,15,1,131,242,19,26,0,0
3348,1286,235,1412,467,17,15,1,126,232,20,26,0,0
3349,1282,230,1405,457,17,15,1,123,227,21,26,0,0
3350,1281,230,1401,452,17,15,1,120,222,22,26,0,0
3351,1273,226,1387,436,17,15,1,114,210,23,26,0,0
3352,1261,221,1374,433,17,15,1,113,212,24,26,0,0
3353,1252,216,1362,432,17,15,1,110,216,25,26,0,0
3354,1252,211,1360,422,17,15,1,108,211,26,26,1,0
3354,1268,250,1313,398,18,15,1,45,148,0,0,0,0
3423,1615,142,1661,271,19,15,1,46,129,0,23,0,1
3424,1608,144,1653,271,19,15,1,45,127,1,23,0,0
3425,1588,139,1638,281,19,15,1,50,142,2,23,0,0
3426,1563,142,1614,285,19,15,1,51,143,3,23,0,0
3427,1542,143,1595,289,19,15,1,53,146,4,23,0,0
3428,1523,141,1576,288,19,15,1,53,147,5,23,0,0
3429,1507,140,1562,292,19,15,1,55,152,6,23,0,0
3430,1487,135,1545,295,19,15,1,58,160,7,23,0,0
3431,1472,136,1532,301,19,15,1,60,165,8,23,0,0
3432,1462,138,1520,305,19,15,1,58,167,9,23,0,0
3433,1450,136,1510,308,19,15,1,60,172,10,23,0,0
3434,1441,136,1501,312,19,15,1,60,176,11,23,0,0
3435,1431,136,1491,314,19,15,1,60,178,12,23,0,0
3436,1423,138,1483,317,19,15,1,60,179,13,23,0,0
3437,1412,136,1475,327,19,15,1,63,191,14,23,0,0
3438,1404,139,1467,330,19,15,1,63,191,15,23,0,0
3439,1393,142,1456,335,19,15,1,63,193,16,23,0,0
3440,1377,141,1442,339,19,15,1,65,198,17,23,0,0
3441,1361,141,1428,344,19,15,1,67,203,18,23,0,0
3442,1342,142,1408,343,19,15,1,66,201,19,23,0,0
3443,1320,141,1386,341,19,15,1,66,200,20,23,0,0
3444,1296,152,1363,339,19,15,1,67,187,21,23,0,0
3445,1262,150,1330,346,19,15,1,68,196,22,23,0,0
3446,1245,151,1314,349,19,15,1,69,198,23,23,1,0
4480,1260,173,1328,398,20,15,1,68,225,0,39,0,1
4481,1274,174,1341,398,20,15,1,67,224,1,39,0,0
4482,1295,174,1362,395,20,15,1,67,221,2,39,0,0
4483,1327,180,1399,414,20,15,1,72,234,3,39,0,0
4484,1349,182,1423,423,20,15,1,74,241,4,39,0,0
4485,1372,180,1449,428,20,15,1,77,248,5,39,0,0
4486,1392,187,1471,440,20,15,1,79,253,6,39,0,0
4487,1405,189,1486,446,20,15,1,81,257,7,39,0,0
4488,1426,198,1512,458,20,15,1,86,260,8,39,0,0
4489,1437,200,1528,469,20,15,1,91,269,9,39,0,0
4490,1435,200,1528,477,20,15,1,93,277,10,39,0,0
4491,1437,206,1532,494,20,15,1,95,288,11,39,0,0
4492,1446,210,1545,509,20,15,1,99,299,12,39,0,0
4493,1454,213,1558,525,20,15,1,104,312,13,39,0,0
4494,1456,223,1566,548,20,15,1,110,325,14,39,0,0
4495,1456,225,1567,554,20,15,1,111,329,15,39,0,0
4496,1458,234,1570,572,20,15,1,112,338,16,39,0,0
4497,1462,240,1579,593,20,15,1,117,353,17,39,0,0
4498,1456,245,1580,613,20,15,1,124,368,18,39,0,0
4499,1442,254,1571,637,20,15,1,129,383,19,39,0,0
4500,1436,261,1565,645,20,15,1,129,384,20,39,0,0
4501,1427,274,1564,682,20,15,1,137,408,21,39,0,0
4502,1419,281,1564,714,20,15,1,145,433,22,39,0,0
4503,1407,282,1558,732,20,15,1,151,450,23,39,0,0
4504,1391,298,1550,777,20,15,1,159,479,24,39,0,0
4505,1380,304,1543,796,20,15,1,163,492,25,39,0,0
4506,1376,315,1548,829,20,15,1,172,514,26,39,0,0
4507,1361,333,1549,893,20,15,1,188,560,27,39,0,0
4508,1344,342,1540,924,20,15,1,196,582,28,39,0,0
4509,1320,365,1530,986,20,15,1,210,621,29,39,0,0
4510,1300,390,1519,1035,20,15,1,219,645,30,39,0,0
4511,1285,402,1514,1066,20,15,1,229,664,31,39,0,0
4512,1277,444,1500,1079,20,15,1,223,635,32,39,0,0
4513,1246,475,1468,1080,20,15,1,222,605,33,39,0,0
4514,1215,512,1436,1080,20,15,1,221,568,34,39,0,0
4515,1180,577,1390,1080,20,15,1,210,503,35,39,0,0
4516,1135,629,1341,1080,20,15,1,206,451,36,39,0,0
4517,1102,716,1292,1080,20,15,1,190,364,37,39,0,0
4518,1084,842,1221,1079,20,15,1,137,237,38,39,0,0
4519,1069,975,1151,1080,20,15,1,82,105,39,39,1,0
4483,1262,201,1309,421,21,15,1,47,220,0,35,0,1
4484,1281,206,1331,437,21,15,1,50,231,1,35,0,0
4485,1290,208,1342,444,21,15,1,52,236,2,35,0,0
4486,1302,208,1357,450,21,15,1,55,242,3,35,0,0
4487,1320,214,1378,457,21,15,1,58,243,4,35,0,0
4488,1326,214,1387,465,21,15,1,61,251,5,35,0,0
4489,1331,216,1396,475,21,15,1,65,259,6,35,0,0
4490,1337,224,1405,494,21,15,1,68,270,7,35,0,0
4491,1343,225,1414,498,21,15,1,71,273,8,35,0,0
4492,1349,231,1427,519,21,15,1,78,288,9,35,0,0
4493,1347,236,1431,536,21,15,1,84,300,10,35,0,0
4494,1335,239,1423,546,21,15,1,88,307,11,35,0,0
4495,1326,245,1420,566,21,15,1,94,321,12,35,0,0
4496,1325,251,1423,582,21,15,1,98,331,13,35,0,0
4497,1318,254,1422,597,21,15,1,104,343,14,35,0,0
4498,1307,266,1416,617,21,15,1,109,351,15,35,0,0
4499,1291,272,1407,640,21,15,1,116,368,16,35,0,0
4500,1272,281,1395,661,21,15,1,123,380,17,35,0,0
4501,1256,293,1389,696,21,15,1,133,403,18,35,0,0
4502,1251,300,1387,709,21,15,1,136,409,19,35,0,0
4503,1240,323,1380,737,21,15,1,140,414,20,35,0,0
4504,1217,329,1365,763,21,15,1,148,434,21,35,0,0
4505,1191,341,1352,801,21,15,1,161,460,22,35,0,0
4506,1163,359,1338,848,21,15,1,175,489,23,35,0,0
4507,1144,373,1326,879,21,15,1,182,506,24,35,0,0
4508,1115,399,1307,926,21,15,1,192,527,25,35,0,0
4509,1079,421,1282,978,21,15,1,203,557,26,35,0,0
4510,1035,444,1248,1025,21,15,1,213,581,27,35,0,0
4511,992,477,1213,1070,21,15,1,221,593,28,35,0,0
4512,960,508,1178,1080,21,15,1,218,572,29,35,0,0
4513,921,548,1130,1080,21,15,1,209,532,30,35,0,0
4514,867,603,1064,1080,21,15,1,197,477,31,35,0,0
4515,795,649,987,1080,21,15,1,192,431,32,35,0,0
4516,739,733,911,1080,21,15,1,172,347,33,35,0,0
4517,664,830,807,1076,21,15,1,143,246,34,35,0,0
4518,629,872,756,1080,21,15,1,127,208,35,35,1,0
5619,1279,185,1317,406,24,15,1,38,221,0,51,0,1
5620,1291,184,1331,415,24,15,1,40,231,1,51,0,0
5621,1305,188,1345,406,24,15,1,40,218,2,51,0,0
5622,1326,188,1367,407,24,15,1,41,219,3,51,0,0
5623,1345,188,1388,414,24,15,1,43,226,4,51,0,0
5624,1358,183,1405,419,24,15,1,47,236,5,51,0,0
5625,1376,182,1428,428,24,15,1,52,246,6,51,0,0
5626,1391,187,1449,443,24,15,1,58,256,7,51,0,0
5627,1397,188,1460,453,24,15,1,63,265,8,51,0,0
5628,1403,188,1467,449,24,15,1,64,261,9,51,0,0
5629,1408,193,1476,461,24,15,1,68,268,10,51,0,0
5630,1416,197,1488,471,24,15,1,72,274,11,51,0,0
5631,1428,199,1504,477,24,15,1,76,278,12,51,0,0
5632,1438,205,1516,487,24,15,1,78,282,13,51,0,0
5633,1438,208,1519,495,24,15,1,81,287,14,51,0,0
5634,1440,209,1524,503,24,15,1,84,294,15,51,0,0
5635,1440,213,1529,519,24,15,1,89,306,16,51,0,0
5636,1442,218,1536,537,24,15,1,94,319,17,51,0,0
5637,1444,218,1541,544,24,15,1,97,326,18,51,0,0
5638,1447,227,1545,555,24,15,1,98,328,19,51,0,0
5639,1442,233,1544,574,24,15,1,102,341,20,51,0,0
5640,1433,234,1539,583,24,15,1,106,349,21,51,0,0
5641,1424,240,1534,600,24,15,1,110,360,22,51,0,0
5642,1418,247,1533,627,24,15,1,115,380,23,51,0,0
5643,1414,247,1533,641,24,15,1,119,394,24,51,0,0
5644,1411,252,1532,654,24,15,1,121,402,25,51,0,0
5645,1401,263,1526,677,24,15,1,125,414,26,51,0,0
5646,1389,265,1517,687,24,15,1,128,422,27,51,0,0
5647,1377,272,1512,708,24,15,1,135,436,28,51,0,0
5648,1374,284,1521,748,24,15,1,147,464,29,51,0,0
5649,1369,286,1525,769,24,15,1,156,483,30,51,0,0
5650,1365,291,1524,779,24,15,1,159,488,31,51,0,0
5651,1343,305,1513,818,24,15,1,170,513,32,51,0,0
5652,1315,315,1494,842,24,15,1,179,527,33,51,0,0
5653,1306,328,1492,856,24,15,1,186,528,34,51,0,0
5654,1295,340,1500,912,24,15,1,205,572,35,51,0,0
5655,1289,360,1502,951,24,15,1,213,591,36,51,0,0
5656,1266,368,1485,976,24,15,1,219,608,37,51,0,0
5657,1223,382,1455,1019,24,15,1,232,637,38,51,0,0
5658,1176,405,1417,1058,24,15,1,241,653,39,51,0,0
5659,1144,417,1389,1080,24,15,1,245,663,40,51,0,0
5660,1133,434,1379,1080,24,15,1,246,646,41,51,0,0
5661,1112,463,1357,1080,24,15,1,245,617,42,51,0,0
5662,1085,489,1325,1080,24,15,1,240,591,43,51,0,0
5663,1070,515,1305,1080,24,15,1,235,565,44,51,0,0
5664,1048,554,1275,1080,24,15,1,227,526,45,51,0,0
5665,1009,605,1226,1080,24,15,1,217,475,46,51,0,0
5666,984,661,1201,1080,24,15,1,217,419,47,51,0,0
5667,947,726,1156,1080,24,15,1,209,354,48,51,0,0
5668,930,807,1117,1080,24,15,1,187,273,49,51,0,0
5669,918,862,1091,1080,24,15,1,173,218,50,51,0,0
5670,860,954,975,1080,24,15,1,115,126,51,51,1,0
5621,1263,190,1329,426,25,15,1,66,236,0,47,0,1
5622,1272,192,1339,431,25,15,1,67,239,1,47,0,0
5623,1280,192,1349,438,25,15,1,69,246,2,47,0,0
5624,1289,193,1360,445,25,15,1,71,252,3,47,0,0
5625,1293,195,1365,448,25,15,1,72,253,4,47,0,0
5626,1300,198,1374,457,25,15,1,74,259,5,47,0,0
5627,1309,200,1385,461,25,15,1,76,261,6,47,0,0
5628,1315,203,1393,471,25,15,1,78,268,7,47,0,0
5629,1318,209,1398,483,25,15,1,80,274,8,47,0,0
5630,1318,211,1399,484,25,15,1,81,273,9,47,0,0
5631,1313,212,1398,496,25,15,1,85,284,10,47,0,0
5632,1308,218,1396,504,25,15,1,88,286,11,47,0,0
5633,1300,218,1393,517,25,15,1,93,299,12,47,0,0
5634,1292,221,1389,532,25,15,1,97,311,13,47,0,0
5635,1284,230,1381,542,25,15,1,97,312,14,47,0,0
5636,1274,234,1374,552,25,15,1,100,318,15,47,0,0
5637,1263,237,1368,567,25,15,1,105,330,16,47,0,0
5638,1251,240,1362,588,25,15,1,111,348,17,47,0,0
5639,1240,244,1353,599,25,15,1,113,355,18,47,0,0
5640,1232,247,1348,610,25,15,1,116,363,19,47,0,0
5641,1222,254,1344,631,25,15,1,122,377,20,47,0,0
5642,1218,257,1343,644,25,15,1,125,387,21,47,0,0
5643,1214,262,1344,666,25,15,1,130,404,22,47,0,0
5644,1211,274,1342,683,25,15,1,131,409,23,47,0,0
5645,1190,278,1326,697,25,15,1,136,419,24,47,0,0
5646,1172,283,1316,722,25,15,1,144,439,25,47,0,0
5647,1160,293,1310,747,25,15,1,150,454,26,47,0,0
5648,1153,299,1305,754,25,15,1,152,455,27,47,0,0
5649,1149,311,1307,786,25,15,1,158,475,28,47,0,0
5650,1136,327,1296,810,25,15,1,160,483,29,47,0,0
5651,1108,337,1269,816,25,15,1,161,479,30,47,0,0
5652,1079,348,1257,867,25,15,1,178,519,31,47,0,0
5653,1058,364,1245,907,25,15,1,187,543,32,47,0,0
5654,1044,374,1235,926,25,15,1,191,552,33,47,0,0
5655,1033,393,1229,956,25,15,1,196,563,34,47,0,0
5656,1007,407,1212,1001,25,15,1,205,594,35,47,0,0
5657,964,423,1174,1032,25,15,1,210,609,36,47,0,0
5658,911,440,1131,1065,25,15,1,220,625,37,47,0,0
5659,888,460,1110,1080,25,15,1,222,620,38,47,0,0
5660,871,484,1090,1080,25,15,1,219,596,39,47,0,0
5661,855,515,1069,1080,25,15,1,214,565,40,47,0,0
5662,822,551,1032,1080,25,15,1,210,529,41,47,0,0
5663,759,581,970,1080,25,15,1,211,499,42,47,0,0
5664,699,624,909,1080,25,15,1,210,456,43,47,0,0
5665,645,680,844,1080,25,15,1,199,400,44,47,0,0
5666,591,731,779,1080,25,15,1,188,349,45,47,0,0
5667,523,807,690,1079,25,15,1,167,272,46,47,0,0
5668,488,845,636,1080,25,15,1,148,235,47,47,1,0
5830,1260,155,1298,353,28,15,1,38,198,0,37,0,1
5831,1279,144,1319,350,28,15,1,40,206,1,37,0,0
5832,1288,151,1328,347,28,15,1,40,196,2,37,0,0
5833,1311,153,1351,347,28,15,1,40,194,3,37,0,0
5834,1304,151,1344,337,28,15,1,40,186,4,37,0,0
5835,1314,149,1355,334,28,15,1,41,185,5,37,0,0
5836,1349,151,1392,339,28,15,1,43,188,6,37,0,0
5837,1353,151,1396,331,28,15,1,43,180,7,37,0,0
5838,1366,150,1411,333,28,15,1,45,183,8,37,0,0
5839,1385,148,1433,333,28,15,1,48,185,9,37,0,0
5840,1398,146,1448,335,28,15,1,50,189,10,37,0,0
5841,1410,145,1460,333,28,15,1,50,188,11,37,0,0
5842,1422,142,1473,329,28,15,1,51,187,12,37,0,0
5843,1433,141,1484,327,28,15,1,51,186,13,37,0,0
5844,1442,141,1494,325,28,15,1,52,184,14,37,0,0
5845,1450,140,1501,319,28,15,1,51,179,15,37,0,0
5846,1456,142,1505,313,28,15,1,49,171,16,37,0,0
5847,1460,142,1509,309,28,15,1,49,167,17,37,0,0
5848,1465,141,1514,303,28,15,1,49,162,18,37,0,0
5849,1469,140,1518,302,28,15,1,49,162,19,37,0,0
5850,1475,140,1523,299,28,15,1,48,159,20,37,0,0
5851,1481,140,1528,296,28,15,1,47,156,21,37,0,0
5852,1485,140,1532,294,28,15,1,47,154,22,37,0,0
5853,1491,141,1537,292,28,15,1,46,151,23,37,0,0
5854,1497,139,1542,285,28,15,1,45,146,24,37,0,0
5855,1504,140,1548,285,28,15,1,44,145,25,37,0,0
5856,1510,139,1554,284,28,15,1,44,145,26,37,0,0
5857,1517,139,1561,283,28,15,1,44,144,27,37,0,0
5858,1524,136,1568,279,28,15,1,44,143,28,37,0,0
5859,1532,137,1576,279,28,15,1,44,142,29,37,0,0
5860,1541,138,1584,276,28,15,1,43,138,30,37,0,0
5861,1552,140,1591,270,28,15,1,39,130,31,37,0,0
5862,1561,140,1602,271,28,15,1,41,131,32,37,0,0
5863,1575,143,1614,269,28,15,1,39,126,33,37,0,0
5864,1597,143,1637,271,28,15,1,40,128,34,37,0,0
5865,1606,144,1647,272,28,15,1,41,128,35,37,0,0
5866,1616,142,1656,267,28,15,1,40,125,36,37,0,0
5867,1626,143,1666,265,28,15,1,40,122,37,37,1,0
5833,1269,147,1329,332,29,15,1,60,185,0,0,0,0
5834,1329,151,1389,348,30,15,1,60,197,0,1,0,0
5835,1347,152,1404,339,30,15,1,57,187,1,1,0,0
5837,1389,154,1448,337,31,15,1,59,183,0,27,0,1
5838,1406,158,1462,331,31,15,1,56,173,1,27,0,0
5839,1424,159,1481,335,31,15,1,57,176,2,27,0,0
5840,1435,153,1495,341,31,15,1,60,188,3,27,0,0
5841,1446,154,1506,341,31,15,1,60,187,4,27,0,0
5842,1462,154,1519,335,31,15,1,57,181,5,27,0,0
5843,1475,153,1533,335,31,15,1,58,182,6,27,0,0
5844,1490,155,1546,333,31,15,1,56,178,7,27,0,0
5845,1500,153,1557,332,31,15,1,57,179,8,27,0,0
5846,1509,152,1564,325,31,15,1,55,173,9,27,0,0
5847,1514,153,1566,321,31,15,1,52,168,10,27,0,0
5848,1517,153,1568,317,31,15,1,51,164,11,27,0,0
5849,1519,155,1569,315,31,15,1,50,160,12,27,0,0
5850,1522,152,1571,313,31,15,1,49,161,13,27,0,0
5851,1526,149,1573,304,31,15,1,47,155,14,27,0,0
5852,1529,150,1575,302,31,15,1,46,152,15,27,0,0
5853,1533,149,1578,298,31,15,1,45,149,16,27,0,0
5854,1537,145,1581,291,31,15,1,44,146,17,27,0,0
5855,1542,144,1586,291,31,15,1,44,147,18,27,0,0
5856,1549,145,1592,290,31,15,1,43,145,19,27,0,0
5857,1555,143,1598,288,31,15,1,43,145,20,27,0,0
5858,1560,142,1603,288,31,15,1,43,146,21,27,0,0
5859,1567,141,1609,281,31,15,1,42,140,22,27,0,0
5860,1575,141,1617,282,31,15,1,42,141,23,27,0,0
5861,1584,140,1625,279,31,15,1,41,139,24,27,0,0
5862,1593,140,1634,276,31,15,1,41,136,25,27,0,0
5863,1604,143,1642,274,31,15,1,38,131,26,27,0,0
5864,1612,143,1649,271,31,15,1,37,128,27,27,1,0
84,152,192,187,292,2,15,10,35,100,0,136,0,1
85,151,192,186,293,2,15,10,35,101,1,136,0,0
86,149,193,184,295,2,15,10,35,102,2,136,0,0
87,147,193,183,297,2,15,10,36,104,3,136,0,0
88,145,195,180,298,2,15,10,35,103,4,136,0,0
89,140,196,176,298,2,15,10,36,102,5,136,0,0
90,137,196,174,300,2,15,10,37,104,6,136,0,0
91,134,197,171,303,2,15,10,37,106,7,136,0,0
92,132,196,170,303,2,15,10,38,107,8,136,0,0
93,130,198,167,304,2,15,10,37,106,9,136,0,0
94,127,202,164,307,2,15,10,37,105,10,136,0,0
95,126,204,161,307,2,15,10,35,103,11,136,0,0
96,125,205,161,310,2,15,10,36,105,12,136,0,0
97,126,206,163,315,2,15,10,37,109,13,136,0,0
98,128,205,166,316,2,15,10,38,111,14,136,0,0
99,130,205,169,319,2,15,10,39,114,15,136,0,0
100,131,207,170,323,2,15,10,39,116,16,136,0,0
101,132,207,172,327,2,15,10,40,120,17,136,0,0
102,134,212,175,334,2,15,10,41,122,18,136,0,0
103,136,213,178,335,2,15,10,42,122,19,136,0,0
104,139,213,182,338,2,15,10,43,125,20,136,0,0
105,141,214,185,343,2,15,10,44,129,21,136,0,0
106,142,213,186,342,2,15,10,44,129,22,136,0,0
107,145,215,189,348,2,15,10,44,133,23,136,0,0
108,149,216,195,354,2,15,10,46,138,24,136,0,0
109,152,215,199,353,2,15,10,47,138,25,136,0,0
110,155,218,201,352,2,15,10,46,134,26,136,0,0
111,155,219,202,357,2,15,10,47,138,27,136,0,0
112,154,219,203,363,2,15,10,49,144,28,136,0,0
113,154,220,204,368,2,15,10,50,148,29,136,0,0
114,156,219,207,371,2,15,10,51,152,30,136,0,0
115,158,218,210,372,2,15,10,52,154,31,136,0,0
116,159,222,211,377,2,15,10,52,155,32,136,0,0
117,158,223,211,380,2,15,10,53,157,33,136,0,0
118,158,224,212,385,2,15,10,54,161,34,136,0,0
119,159,228,214,393,2,15,10,55,165,35,136,0,0
120,161,228,217,397,2,15,10,56,169,36,136,0,0
121,164,229,222,402,2,15,10,58,173,37,136,0,0
122,167,231,226,404,2,15,10,59,173,38,136,0,0
123,168,232,227,410,2,15,10,59,178,39,136,0,0
124,170,231,232,419,2,15,10,62,188,40,136,0,0
125,176,236,239,427,2,15,10,63,191,41,136,0,0
126,185,235,249,430,2,15,10,64,195,42,136,0,0
127,194,234,259,429,2,15,10,65,195,43,136,0,0
128,200,239,263,428,2,15,10,63,189,44,136,0,0
129,207,239,271,436,2,15,10,64,197,45,136,0,0
130,214,241,278,437,2,15,10,64,196,46,136,0,0
131,223,248,286,443,2,15,10,63,195,47,136,0,0
132,237,248,300,445,2,15,10,63,197,48,136,0,0
133,250,246,319,454,2,15,10,69,208,49,136,0,0
134,261,250,332,467,2,15,10,71,217,50,136,0,0
135,278,252,334,420,2,15,10,56,168,51,136,0,0
136,290,249,340,400,2,15,10,50,151,52,136,0,0
137,297,250,359,439,2,15,10,62,189,53,136,0,0
138,311,254,377,462,2,15,10,66,208,54,136,0,0
139,326,255,393,466,2,15,10,67,211,55,136,0,0
140,335,256,403,477,2,15,10,68,221,56,136,0,0
141,340,260,407,484,2,15,10,67,224,57,136,0,0
142,343,260,413,491,2,15,10,70,231,58,136,0,0
143,344,261,415,493,2,15,10,71,232,59,136,0,0
144,345,262,415,492,2,15,10,70,230,60,136,0,0
145,346,268,415,495,2,15,10,69,227,61,136,0,0
146,349,267,418,494,2,15,10,69,227,62,136,0,0
147,353,266,421,493,2,15,10,68,227,63,136,0,0
148,358,266,428,489,2,15,10,70,223,64,136,0,0
149,363,269,434,489,2,15,10,71,220,65,136,0,0
150,386,266,453,480,2,15,10,67,214,66,136,0,0
151,404,265,473,488,2,15,10,69,223,67,136,0,0
152,414,267,483,488,2,15,10,69,221,68,136,0,0
153,417,265,487,488,2,15,10,70,223,69,136,0,0
154,407,261,481,486,2,15,10,74,225,70,136,0,0
155,399,262,474,483,2,15,10,75,221,71,136,0,0
156,392,262,468,484,2,15,10,76,222,72,136,0,0
157,380,261,457,483,2,15,10,77,222,73,136,0,0
158,359,258,437,485,2,15,10,78,227,74,136,0,0
159,344,259,422,486,2,15,10,78,227,75,136,0,0
160,330,257,405,472,2,15,10,75,215,76,136,0,0
161,318,254,392,463,2,15,10,74,209,77,136,0,0
162,304,252,377,457,2,15,10,73,205,78,136,0,0
163,294,252,368,460,2,15,10,74,208,79,136,0,0
164,282,247,356,456,2,15,10,74,209,80,136,0,0
165,274,244,347,452,2,15,10,73,208,81,136,0,0
166,265,246,337,453,2,15,10,72,207,82,136,0,0
167,256,242,328,449,2,15,10,72,207,83,136,0,0
168,248,240,316,435,2,15,10,68,195,84,136,0,0
169,238,237,305,430,2,15,10,67,193,85,136,0,0
170,231,240,294,424,2,15,10,63,184,86,136,0,0
171,223,238,288,426,2,15,10,65,188,87,136,0,0
172,218,239,279,417,2,15,10,61,178,88,136,0,0
173,212,238,272,411,2,15,10,60,173,89,136,0,0
174,202,234,265,418,2,15,10,63,184,90,136,0,0
175,194,235,257,416,2,15,10,63,181,91,136,0,0
176,185,234,249,417,2,15,10,64,183,92,136,0,0
177,181,233,243,413,2,15,10,62,180,93,136,0,0
178,176,233,235,404,2,15,10,59,171,94,136,0,0
179,171,229,228,397,2,15,10,57,168,95,136,0,0
180,166,228,222,393,2,15,10,56,165,96,136,0,0
181,159,228,216,394,2,15,10,57,166,97,136,0,0
182,151,227,208,392,2,15,10,57,165,98,136,0,0
183,145,228,201,391,2,15,10,56,163,99,136,0,0
184,139,224,195,388,2,15,10,56,164,100,136,0,0
185,135,223,190,387,2,15,10,55,164,101,136,0,0
186,131,221,186,386,2,15,10,55,165,102,136,0,0
187,128,219,184,384,2,15,10,56,165,103,136,0,0
188,127,220,182,384,2,15,10,55,164,104,136,0,0
189,128,222,180,379,2,15,10,52,157,105,136,0,0
190,128,219,180,377,2,15,10,52,158,106,136,0,0
191,130,219,181,372,2,15,10,51,153,107,136,0,0
192,130,220,181,373,2,15,10,51,153,108,136,0,0
193,132,221,180,366,2,15,10,48,145,109,136,0,0
194,131,219,180,366,2,15,10,49,147,110,136,0,0
195,131,222,179,369,2,15,10,48,147,111,136,0,0
196,130,220,176,362,2,15,10,46,142,112,136,0,0
197,128,219,173,358,2,15,10,45,139,113,136,0,0
198,127,219,170,353,2,15,10,43,134,114,136,0,0
199,127,221,167,343,2,15,10,40,122,115,136,0,0
200,125,220,164,343,2,15,10,39,123,116,136,0,0
201,122,219,162,345,2,15,10,40,126,117,136,0,0
202,118,220,157,342,2,15,10,39,122,118,136,0,0
203,115,221,152,339,2,15,10,37,118,119,136,0,0
204,111,217,150,338,2,15,10,39,121,120,136,0,0
205,111,214,149,338,2,15,10,38,124,121,136,0,0
206,112,213,150,337,2,15,10,38,124,122,136,0,0
207,113,209,150,336,2,15,10,37,127,123,136,0,0
208,111,201,150,338,2,15,10,39,137,124,136,0,0
209,111,205,149,339,2,15,10,38,134,125,136,0,0
210,110,206,148,340,2,15,10,38,134,126,136,0,0
211,112,210,148,336,2,15,10,36,126,127,136,0,0
212,113,208,149,336,2,15,10,36,128,128,136,0,0
213,113,201,151,337,2,15,10,38,136,129,136,0,0
214,113,198,152,338,2,15,10,39,140,130,136,0,0
215,114,201,152,337,2,15,10,38,136,131,136,0,0
216,113,202,151,337,2,15,10,38,135,132,136,0,0
217,114,203,151,336,2,15,10,37,133,133,136,0,0
218,114,204,150,337,2,15,10,36,133,134,136,0,0
219,113,207,149,337,2,15,10,36,130,135,136,0,0
220,112,211,147,338,2,15,10,35,127,136,136,1,0
232,144,211,179,336,2,15,10,35,125,0,136,0,0
233,146,213,181,335,2,15,10,35,122,1,136,0,0
234,147,212,184,335,2,15,10,37,123,2,136,0,0
235,154,210,189,329,2,15,10,35,119,3,136,0,0
236,159,209,195,328,2,15,10,36,119,4,136,0,0
237,163,209,199,327,2,15,10,36,118,5,136,0,0
238,165,208,201,326,2,15,10,36,118,6,136,0,0
239,166,207,203,323,2,15,10,37,116,7,136,0,0
240,166,207,203,322,2,15,10,37,115,8,136,0,0
241,166,206,203,318,2,15,10,37,112,9,136,0,0
242,166,206,202,316,2,15,10,36,110,10,136,0,0
243,164,205,201,314,2,15,10,37,109,11,136,0,0
244,164,204,201,311,2,15,10,37,107,12,136,0,0
245,164,203,201,309,2,15,10,37,106,13,136,0,0
246,162,202,198,307,2,15,10,36,105,14,136,0,0
247,159,199,195,302,2,15,10,36,103,15,136,0,0
248,157,198,192,299,2,15,10,35,101,16,136,0,0
251,150,194,185,294,2,15,10,35,100,0,136,0,0
129,25,307,131,641,3,15,10,106,334,0,20,0,1
130,35,311,139,640,3,15,10,104,329,1,20,0,0
131,67,316,171,647,3,15,10,104,331,2,20,0,0
132,105,323,213,663,3,15,10,108,340,3,20,0,0
133,150,322,262,677,3,15,10,112,355,4,20,0,0
134,191,324,312,706,3,15,10,121,382,5,20,0,0
135,223,315,352,724,3,15,10,129,409,6,20,0,0
136,273,336,410,760,3,15,10,137,424,7,20,0,0
137,309,348,450,776,3,15,10,141,428,8,20,0,0
138,341,362,488,806,3,15,10,147,444,9,20,0,0
139,369,374,521,836,3,15,10,152,462,10,20,0,0
140,411,388,574,880,3,15,10,163,492,11,20,0,0
141,461,411,640,939,3,15,10,179,528,12,20,0,0
142,493,426,674,964,3,15,10,181,538,13,20,0,0
143,539,461,732,1036,3,15,10,193,575,14,20,0,0
144,589,479,783,1061,3,15,10,194,582,15,20,0,0
145,672,511,869,1079,3,15,10,197,568,16,20,0,0
146,758,555,949,1080,3,15,10,191,525,17,20,0,0
147,837,600,1016,1074,3,15,10,179,474,18,20,0,0
148,949,654,1117,1073,3,15,10,168,419,19,20,0,0
149,1006,678,1173,1080,3,15,10,167,402,20,20,1,0
149,1072,721,1344,1076,4,15,10,272,355,0,0,0,0
150,1254,805,1504,1076,5,15,10,250,271,0,0,0,0
231,1298,808,1535,1075,10,15,10,237,267,0,0,0,0
232,1150,752,1406,1071,11,15,10,256,319,0,110,0,1
233,1036,694,1336,1070,11,15,10,300,376,1,110,0,0
234,920,647,1255,1069,11,15,10,335,422,2,110,0,0
235,802,603,1169,1072,11,15,10,367,469,3,110,0,0
236,693,558,1095,1076,11,15,10,402,518,4,110,0,0
237,615,528,1029,1075,11,15,10,414,547,5,110,0,0
238,567,493,995,1076,11,15,10,428,583,6,110,0,0
239,549,477,966,1064,11,15,10,417,587,7,110,0,0
240,553,455,933,1004,11,15,10,380,549,8,110,0,0
241,575,446,932,980,11,15,10,357,534,9,110,0,0
242,610,448,950,965,11,15,10,340,517,10,110,0,0
243,651,448,975,939,11,15,10,324,491,11,110,0,0
244,657,441,978,925,11,15,10,321,484,12,110,0,0
245,667,441,979,909,11,15,10,312,468,13,110,0,0
246,662,438,968,896,11,15,10,306,458,14,110,0,0
247,659,431,968,893,11,15,10,309,462,15,110,0,0
248,657,428,967,891,11,15,10,310,463,16,110,0,0
249,660,447,961,892,11,15,10,301,445,17,110,0,0
250,669,459,967,893,11,15,10,298,434,18,110,0,0
251,664,451,965,891,11,15,10,301,440,19,110,0,0
252,624,445,917,887,11,15,10,293,442,20,110,0,0
253,603,435,892,887,11,15,10,289,452,21,110,0,0
254,595,427,876,885,11,15,10,281,458,22,110,0,0
255,596,425,868,884,11,15,10,272,459,23,110,0,0
256,597,422,863,884,11,15,10,266,462,24,110,0,0
257,593,413,859,886,11,15,10,266,473,25,110,0,0
258,586,407,849,886,11,15,10,263,479,26,110,0,0
259,579,397,837,883,11,15,10,258,486,27,110,0,0
260,576,390,826,875,11,15,10,250,485,28,110,0,0
261,581,389,820,868,11,15,10,239,479,29,110,0,0
262,583,386,816,865,11,15,10,233,479,30,110,0,0
263,585,382,812,863,11,15,10,227,481,31,110,0,0
264,584,383,806,863,11,15,10,222,480,32,110,0,0
265,586,384,802,864,11,15,10,216,480,33,110,0,0
266,587,390,796,863,11,15,10,209,473,34,110,0,0
267,587,391,792,864,11,15,10,205,473,35,110,0,0
268,585,394,786,862,11,15,10,201,468,36,110,0,0
269,585,397,782,862,11,15,10,197,465,37,110,0,0
270,588,396,783,863,11,15,10,195,467,38,110,0,0
271,588,397,781,864,11,15,10,193,467,39,110,0,0
272,591,393,784,864,11,15,10,193,471,40,110,0,0
273,594,390,786,864,11,15,10,192,474,41,110,0,0
274,595,390,786,867,11,15,10,191,477,42,110,0,0
275,596,391,784,867,11,15,10,188,476,43,110,0,0
276,597,394,782,863,11,15,10,185,469,44,110,0,0
277,599,395,782,862,11,15,10,183,467,45,110,0,0
278,600,397,782,865,11,15,10,182,468,46,110,0,0
279,599,398,780,866,11,15,10,181,468,47,110,0,0
280,599,398,779,866,11,15,10,180,468,48,110,0,0
281,596,394,775,864,11,15,10,179,470,49,110,0,0
282,597,392,776,863,11,15,10,179,471,50,110,0,0
283,596,392,775,864,11,15,10,179,472,51,110,0,0
284,596,395,775,864,11,15,10,179,469,52,110,0,0
285,597,396,775,863,11,15,10,178,467,53,110,0,0
286,595,394,775,865,11,15,10,180,471,54,110,0,0
287,596,389,778,867,11,15,10,182,478,55,110,0,0
288,598,393,777,865,11,15,10,179,472,56,110,0,0
289,598,392,776,865,11,15,10,178,473,57,110,0,0
290,598,390,776,864,11,15,10,178,474,58,110,0,0
291,601,392,777,864,11,15,10,176,472,59,110,0,0
292,602,393,776,864,11,15,10,174,471,60,110,0,0
293,604,396,775,864,11,15,10,171,468,61,110,0,0
294,606,398,775,863,11,15,10,169,465,62,110,0,0
295,606,399,775,864,11,15,10,169,465,63,110,0,0
296,607,399,774,864,11,15,10,167,465,64,110,0,0
297,608,400,773,864,11,15,10,165,464,65,110,0,0
298,608,401,773,863,11,15,10,165,462,66,110,0,0
299,608,401,772,863,11,15,10,164,462,67,110,0,0
300,608,400,772,863,11,15,10,164,463,68,110,0,0
301,609,400,772,863,11,15,10,163,463,69,110,0,0
302,610,400,772,863,11,15,10,162,463,70,110,0,0
303,611,400,772,863,11,15,10,161,463,71,110,0,0
304,611,399,773,863,11,15,10,162,464,72,110,0,0
305,610,402,770,863,11,15,10,160,461,73,110,0,0
306,604,402,767,864,11,15,10,163,462,74,110,0,0
307,598,397,763,865,11,15,10,165,468,75,110,0,0
308,602,394,768,865,11,15,10,166,471,76,110,0,0
309,602,393,769,866,11,15,10,167,473,77,110,0,0
310,602,392,769,866,11,15,10,167,474,78,110,0,0
311,603,391,770,864,11,15,10,167,473,79,110,0,0
312,601,389,770,864,11,15,10,169,475,80,110,0,0
313,600,388,771,866,11,15,10,171,478,81,110,0,0
314,602,391,771,864,11,15,10,169,473,82,110,0,0
315,601,392,771,864,11,15,10,170,472,83,110,0,0
316,602,391,773,865,11,15,10,171,474,84,110,0,0
317,602,394,773,864,11,15,10,171,470,85,110,0,0
318,599,394,770,864,11,15,10,171,470,86,110,0,0
319,598,391,771,866,11,15,10,173,475,87,110,0,0
320,596,390,770,864,11,15,10,174,474,88,110,0,0
321,595,391,768,864,11,15,10,173,473,89,110,0,0
322,592,391,766,865,11,15,10,174,474,90,110,0,0
323,591,391,766,865,11,15,10,175,474,91,110,0,0
324,594,391,768,863,11,15,10,174,472,92,110,0,0
325,601,390,774,863,11,15,10,173,473,93,110,0,0
326,605,388,779,865,11,15,10,174,477,94,110,0,0
327,608,386,780,861,11,15,10,172,475,95,110,0,0
328,612,386,778,849,11,15,10,166,463,96,110,0,0
329,619,390,779,836,11,15,10,160,446,97,110,0,0
330,624,395,781,829,11,15,10,157,434,98,110,0,0
331,649,392,805,815,11,15,10,156,423,99,110,0,0
332,689,392,841,805,11,15,10,152,413,100,110,0,0
333,719,394,867,797,11,15,10,148,403,101,110,0,0
334,731,389,881,793,11,15,10,150,404,102,110,0,0
335,742,385,895,791,11,15,10,153,406,103,110,0,0
336,746,381,900,791,11,15,10,154,410,104,110,0,0
337,755,380,907,785,11,15,10,152,405,105,110,0,0
338,767,377,918,783,11,15,10,151,406,106,110,0,0
339,777,377,930,781,11,15,10,153,404,107,110,0,0
340,790,390,943,781,11,15,10,153,391,108,110,0,0
341,829,421,961,757,11,15,10,132,336,109,110,0,0
342,844,425,972,751,11,15,10,128,326,110,110,1,0
261,32,268,103,505,12,15,10,71,237,0,22,0,1
262,54,271,123,502,12,15,10,69,231,1,22,0,0
263,82,252,153,490,12,15,10,71,238,2,22,0,0
264,119,266,183,477,12,15,10,64,211,3,22,0,0
265,139,267,202,470,12,15,10,63,203,4,22,0,0
266,154,264,215,459,12,15,10,61,195,5,22,0,0
267,172,264,231,454,12,15,10,59,190,6,22,0,0
268,193,261,252,447,12,15,10,59,186,7,22,0,0
269,204,247,265,443,12,15,10,61,196,8,22,0,0
270,218,254,273,436,12,15,10,55,182,9,22,0,0
271,230,250,284,430,12,15,10,54,180,10,22,0,0
272,239,249,293,428,12,15,10,54,179,11,22,0,0
273,251,243,305,421,12,15,10,54,178,12,22,0,0
274,261,244,314,415,12,15,10,53,171,13,22,0,0
275,267,245,316,402,12,15,10,49,157,14,22,0,0
276,274,244,321,393,12,15,10,47,149,15,22,0,0
277,282,243,329,391,12,15,10,47,148,16,22,0,0
278,294,243,341,388,12,15,10,47,145,17,22,0,0
279,301,241,348,387,12,15,10,47,146,18,22,0,0
280,306,239,355,392,12,15,10,49,153,19,22,0,0
281,312,241,359,390,12,15,10,47,149,20,22,0,0
282,316,238,363,394,12,15,10,47,156,21,22,0,0
283,325,237,372,391,12,15,10,47,154,22,22,1,0
406,108,197,143,305,13,15,10,35,108,0,78,0,1
407,109,198,145,308,13,15,10,36,110,1,78,0,0
408,110,199,146,312,13,15,10,36,113,2,78,0,0
409,111,201,147,314,13,15,10,36,113,3,78,0,0
410,112,198,149,312,13,15,10,37,114,4,78,0,0
411,113,195,151,313,13,15,10,38,118,5,78,0,0
412,113,199,151,317,13,15,10,38,118,6,78,0,0
413,112,199,151,318,13,15,10,39,119,7,78,0,0
414,112,201,150,321,13,15,10,38,120,8,78,0,0
415,112,201,150,323,13,15,10,38,122,9,78,0,0
416,111,203,149,324,13,15,10,38,121,10,78,0,0
417,109,202,148,328,13,15,10,39,126,11,78,0,0
418,107,204,147,331,13,15,10,40,127,12,78,0,0
419,104,204,144,331,13,15,10,40,127,13,78,0,0
420,102,205,142,332,13,15,10,40,127,14,78,0,0
421,100,205,142,336,13,15,10,42,131,15,78,0,0
422,99,207,140,334,13,15,10,41,127,16,78,0,0
423,95,209,136,336,13,15,10,41,127,17,78,0,0
424,91,213,132,341,13,15,10,41,128,18,78,0,0
425,86,213,128,343,13,15,10,42,130,19,78,0,0
426,82,214,124,342,13,15,10,42,128,20,78,0,0
427,80,215,122,343,13,15,10,42,128,21,78,0,0
428,80,218,122,347,13,15,10,42,129,22,78,0,0
429,80,218,122,347,13,15,10,42,129,23,78,0,0
430,79,218,122,349,13,15,10,43,131,24,78,0,0
431,78,221,121,353,13,15,10,43,132,25,78,0,0
432,77,222,121,355,13,15,10,44,133,26,78,0,0
433,75,221,120,357,13,15,10,45,136,27,78,0,0
434,73,220,119,362,13,15,10,46,142,28,78,0,0
435,73,221,120,366,13,15,10,47,145,29,78,0,0
436,75,221,122,367,13,15,10,47,146,30,78,0,0
437,76,222,124,368,13,15,10,48,146,31,78,0,0
438,78,223,127,370,13,15,10,49,147,32,78,0,0
439,79,224,128,374,13,15,10,49,150,33,78,0,0
440,81,225,129,374,13,15,10,48,149,34,78,0,0
441,83,226,133,381,13,15,10,50,155,35,78,0,0
442,90,231,137,380,13,15,10,47,149,36,78,0,0
443,97,230,146,386,13,15,10,49,156,37,78,0,0
444,106,233,154,388,13,15,10,48,155,38,78,0,0
445,112,236,159,388,13,15,10,47,152,39,78,0,0
446,117,234,164,391,13,15,10,47,157,40,78,0,0
447,122,230,171,396,13,15,10,49,166,41,78,0,0
448,129,234,179,402,13,15,10,50,168,42,78,0,0
449,137,233,188,402,13,15,10,51,169,43,78,0,0
450,142,233,196,408,13,15,10,54,175,44,78,0,0
451,141,234,200,416,13,15,10,59,182,45,78,0,0
452,138,234,199,422,13,15,10,61,188,46,78,0,0
453,135,232,197,429,13,15,10,62,197,47,78,0,0
454,134,239,194,432,13,15,10,60,193,48,78,0,0
455,132,238,195,437,13,15,10,63,199,49,78,0,0
456,128,237,194,442,13,15,10,66,205,50,78,0,0
457,125,242,193,453,13,15,10,68,211,51,78,0,0
458,125,244,192,454,13,15,10,67,210,52,78,0,0
459,126,245,194,457,13,15,10,68,212,53,78,0,0
460,132,251,199,461,13,15,10,67,210,54,78,0,0
461,142,251,210,466,13,15,10,68,215,55,78,0,0
462,156,249,226,466,13,15,10,70,217,56,78,0,0
463,169,253,240,473,13,15,10,71,220,57,78,0,0
464,182,253,253,473,13,15,10,71,220,58,78,0,0
465,204,255,274,475,13,15,10,70,220,59,78,0,0
466,221,255,296,483,13,15,10,75,228,60,78,0,0
467,240,260,316,484,13,15,10,76,224,61,78,0,0
468,270,256,346,486,13,15,10,76,230,62,78,0,0
469,297,257,376,489,13,15,10,79,232,63,78,0,0
470,312,259,393,489,13,15,10,81,230,64,78,0,0
471,344,260,423,490,13,15,10,79,230,65,78,0,0
472,376,261,454,485,13,15,10,78,224,66,78,0,0
473,392,264,474,490,13,15,10,82,226,67,78,0,0
474,424,270,501,490,13,15,10,77,220,68,78,0,0
475,454,268,529,488,13,15,10,75,220,69,78,0,0
476,473,265,554,492,13,15,10,81,227,70,78,0,0
477,489,270,570,491,13,15,10,81,221,71,78,0,0
478,519,266,598,489,13,15,10,79,223,72,78,0,0
479,536,267,614,492,13,15,10,78,225,73,78,0,0
480,548,270,625,492,13,15,10,77,222,74,78,0,0
481,568,272,642,491,13,15,10,74,219,75,78,0,0
482,580,272,651,492,13,15,10,71,220,76,78,0,0
483,588,276,655,491,13,15,10,67,215,77,78,0,0
484,605,277,672,492,13,15,10,67,215,78,78,1,0
380,581,300,630,500,14,15,10,49,200,0,49,0,1
381,565,298,625,542,14,15,10,60,244,1,49,0,0
382,556,300,619,552,14,15,10,63,252,2,49,0,0
383,536,292,602,556,14,15,10,66,264,3,49,0,0
384,503,303,570,559,14,15,10,67,256,4,49,0,0
385,482,305,552,562,14,15,10,70,257,5,49,0,0
386,464,304,536,568,14,15,10,72,264,6,49,0,0
387,443,305,517,576,14,15,10,74,271,7,49,0,0
388,429,308,504,577,14,15,10,75,269,8,49,0,0
389,409,307,487,582,14,15,10,78,275,9,49,0,0
390,384,306,468,595,14,15,10,84,289,10,49,0,0
391,364,308,451,605,14,15,10,87,297,11,49,0,0
392,349,311,437,612,14,15,10,88,301,12,49,0,0
393,337,314,430,633,14,15,10,93,319,13,49,0,0
394,329,316,426,644,14,15,10,97,328,14,49,0,0
395,322,317,421,650,14,15,10,99,333,15,49,0,0
396,313,323,415,665,14,15,10,102,342,16,49,0,0
397,301,326,408,680,14,15,10,107,354,17,49,0,0
398,289,332,397,686,14,15,10,108,354,18,49,0,0
399,284,340,396,707,14,15,10,112,367,19,49,0,0
400,293,349,407,721,14,15,10,114,372,20,49,0,0
401,308,351,425,728,14,15,10,117,377,21,49,0,0
402,319,357,442,754,14,15,10,123,397,22,49,0,0
403,323,366,450,774,14,15,10,127,408,23,49,0,0
404,327,372,454,782,14,15,10,127,410,24,49,0,0
405,338,386,470,807,14,15,10,132,421,25,49,0,0
406,351,397,486,827,14,15,10,135,430,26,49,0,0
407,372,404,508,836,14,15,10,136,432,27,49,0,0
408,390,416,535,873,14,15,10,145,457,28,49,0,0
409,399,431,550,905,14,15,10,151,474,29,49,0,0
410,404,438,558,919,14,15,10,154,481,30,49,0,0
411,410,453,570,948,14,15,10,160,495,31,49,0,0
412,415,466,582,971,14,15,10,167,505,32,49,0,0
413,443,475,615,990,14,15,10,172,515,33,49,0,0
414,475,488,661,1044,14,15,10,186,556,34,49,0,0
415,502,509,692,1071,14,15,10,190,562,35,49,0,0
416,514,520,708,1080,14,15,10,194,560,36,49,0,0
417,532,543,720,1080,14,15,10,188,537,37,49,0,0
418,562,571,744,1080,14,15,10,182,509,38,49,0,0
419,611,587,792,1080,14,15,10,181,493,39,49,0,0
420,670,604,851,1080,14,15,10,181,476,40,49,0,0
421,724,642,903,1080,14,15,10,179,438,41,49,0,0
422,761,677,934,1080,14,15,10,173,403,42,49,0,0
423,800,701,969,1075,14,15,10,169,374,43,49,0,0
424,862,746,1021,1077,14,15,10,159,331,44,49,0,0
425,946,781,1099,1076,14,15,10,153,295,45,49,0,0
426,1028,812,1175,1071,14,15,10,147,259,46,49,0,0
427,1102,853,1242,1073,14,15,10,140,220,47,49,0,0
428,1181,900,1308,1077,14,15,10,127,177,48,49,0,0
429,1249,933,1354,1080,14,15,10,105,147,49,49,1,0
528,558,267,632,478,16,15,10,74,211,0,206,0,1
529,540,267,615,481,16,15,10,75,214,1,206,0,0
530,519,267,592,475,16,15,10,73,208,2,206,0,0
531,492,266,565,474,16,15,10,73,208,3,206,0,0
532,459,265,534,475,16,15,10,75,210,4,206,0,0
533,443,268,516,470,16,15,10,73,202,5,206,0,0
534,410,263,483,466,16,15,10,73,203,6,206,0,0
535,378,262,453,468,16,15,10,75,206,7,206,0,0
536,351,259,432,480,16,15,10,81,221,8,206,0,0
537,321,255,403,485,16,15,10,82,230,9,206,0,0
538,287,257,374,492,16,15,10,87,235,10,206,0,0
539,267,258,354,492,16,15,10,87,234,11,206,0,0
540,245,257,333,496,16,15,10,88,239,12,206,0,0
541,219,258,308,498,16,15,10,89,240,13,206,0,0
542,204,261,294,507,16,15,10,90,246,14,206,0,0
543,190,261,281,513,16,15,10,91,252,15,206,0,0
544,173,262,263,513,16,15,10,90,251,16,206,0,0
545,160,268,248,517,16,15,10,88,249,17,206,0,0
546,147,267,237,529,16,15,10,90,262,18,206,0,0
547,137,268,225,529,16,15,10,88,261,19,206,0,0
548,128,268,215,534,16,15,10,87,266,20,206,0,0
549,112,269,201,539,16,15,10,89,270,21,206,0,0
550,107,270,196,539,16,15,10,89,269,22,206,0,0
551,105,273,194,537,16,15,10,89,264,23,206,0,0
552,109,267,198,537,16,15,10,89,270,24,206,0,0
553,114,266,207,541,16,15,10,93,275,25,206,0,0
554,113,267,202,533,16,15,10,89,266,26,206,0,0
555,116,268,201,526,16,15,10,85,258,27,206,0,0
556,116,267,199,524,16,15,10,83,257,28,206,0,0
557,115,263,196,519,16,15,10,81,256,29,206,0,0
558,112,261,193,517,16,15,10,81,256,30,206,0,0
559,111,262,191,515,16,15,10,80,253,31,206,0,0
560,115,262,194,510,16,15,10,79,248,32,206,0,0
561,116,259,193,503,16,15,10,77,244,33,206,0,0
562,113,256,185,492,16,15,10,72,236,34,206,0,0
563,107,258,176,486,16,15,10,69,228,35,206,0,0
564,97,255,163,474,16,15,10,66,219,36,206,0,0
565,86,254,151,468,16,15,10,65,214,37,206,0,0
566,80,255,144,461,16,15,10,64,206,38,206,0,0
567,80,252,141,453,16,15,10,61,201,39,206,0,0
568,75,247,136,452,16,15,10,61,205,40,206,0,0
569,69,247,130,451,16,15,10,61,204,41,206,0,0
570,62,241,123,441,16,15,10,61,200,42,206,0,0
571,60,240,119,432,16,15,10,59,192,43,206,0,0
572,61,240,118,427,16,15,10,57,187,44,206,0,0
573,62,238,120,428,16,15,10,58,190,45,206,0,0
574,65,237,121,420,16,15,10,56,183,46,206,0,0
575,68,238,122,413,16,15,10,54,175,47,206,0,0
576,70,235,123,410,16,15,10,53,175,48,206,0,0
577,74,236,125,404,16,15,10,51,168,49,206,0,0
578,80,239,129,399,16,15,10,49,160,50,206,0,0
579,86,235,135,394,16,15,10,49,159,51,206,0,0
580,92,238,139,392,16,15,10,47,154,52,206,0,0
581,96,235,144,387,16,15,10,48,152,53,206,0,0
582,99,232,146,384,16,15,10,47,152,54,206,0,0
583,103,233,147,381,16,15,10,44,148,55,206,0,0
584,106,227,152,380,16,15,10,46,153,56,206,0,0
585,112,223,156,372,16,15,10,44,149,57,206,0,0
586,114,221,159,373,16,15,10,45,152,58,206,0,0
587,115,218,159,369,16,15,10,44,151,59,206,0,0
588,116,218,159,365,16,15,10,43,147,60,206,0,0
589,119,225,159,360,16,15,10,40,135,61,206,0,0
590,122,223,162,359,16,15,10,40,136,62,206,0,0
591,124,217,165,357,16,15,10,41,140,63,206,0,0
592,126,216,166,353,16,15,10,40,137,64,206,0,0
593,126,215,166,348,16,15,10,40,133,65,206,0,0
594,127,212,166,347,16,15,10,39,135,66,206,0,0
595,127,212,166,346,16,15,10,39,134,67,206,0,0
596,129,214,167,343,16,15,10,38,129,68,206,0,0
597,131,215,168,340,16,15,10,37,125,69,206,0,0
598,132,213,169,338,16,15,10,37,125,70,206,0,0
599,132,212,170,339,16,15,10,38,127,71,206,0,0
600,135,212,172,335,16,15,10,37,123,72,206,0,0
601,136,211,174,338,16,15,10,38,127,73,206,0,0
602,136,211,175,338,16,15,10,39,127,74,206,0,0
603,137,212,175,339,16,15,10,38,127,75,206,0,0
604,136,211,175,339,16,15,10,39,128,76,206,0,0
605,137,212,176,339,16,15,10,39,127,77,206,0,0
606,137,212,176,338,16,15,10,39,126,78,206,0,0
607,136,211,176,339,16,15,10,40,128,79,206,0,0
608,137,212,176,338,16,15,10,39,126,80,206,0,0
609,137,213,176,337,16,15,10,39,124,81,206,0,0
610,138,214,177,338,16,15,10,39,124,82,206,0,0
611,140,212,180,338,16,15,10,40,126,83,206,0,0
612,143,212,184,338,16,15,10,41,126,84,206,0,0
613,147,210,188,338,16,15,10,41,128,85,206,0,0
614,150,210,192,338,16,15,10,42,128,86,206,0,0
615,149,211,191,338,16,15,10,42,127,87,206,0,0
616,152,211,192,337,16,15,10,40,126,88,206,0,0
617,155,208,194,333,16,15,10,39,125,89,206,0,0
618,157,208,196,333,16,15,10,39,125,90,206,0,0
619,160,208,198,332,16,15,10,38,124,91,206,0,0
620,162,208,200,334,16,15,10,38,126,92,206,0,0
621,166,207,205,336,16,15,10,39,129,93,206,0,0
622,168,209,207,336,16,15,10,39,127,94,206,0,0
623,170,210,209,335,16,15,10,39,125,95,206,0,0
624,171,210,210,335,16,15,10,39,125,96,206,0,0
625,172,211,210,334,16,15,10,38,123,97,206,0,0
626,174,210,213,335,16,15,10,39,125,98,206,0,0
627,175,209,214,335,16,15,10,39,126,99,206,0,0
628,174,209,213,335,16,15,10,39,126,100,206,0,0
629,173,209,212,335,16,15,10,39,126,101,206,0,0
630,172,209,211,335,16,15,10,39,126,102,206,0,0
631,172,210,210,335,16,15,10,38,125,103,206,0,0
632,172,210,210,335,16,15,10,38,125,104,206,0,0
633,172,208,211,335,16,15,10,39,127,105,206,0,0
634,172,208,211,336,16,15,10,39,128,106,206,0,0
635,172,209,210,336,16,15,10,38,127,107,206,0,0
636,171,210,209,335,16,15,10,38,125,108,206,0,0
637,171,210,210,335,16,15,10,39,125,109,206,0,0
638,171,210,210,334,16,15,10,39,124,110,206,0,0
639,171,209,210,334,16,15,10,39,125,111,206,0,0
640,172,209,211,334,16,15,10,39,125,112,206,0,0
641,172,209,211,335,16,15,10,39,126,113,206,0,0
642,171,210,210,335,16,15,10,39,125,114,206,0,0
643,171,210,210,335,16,15,10,39,125,115,206,0,0
644,170,209,210,336,16,15,10,40,127,116,206,0,0
645,170,209,210,336,16,15,10,40,127,117,206,0,0
646,171,209,212,336,16,15,10,41,127,118,206,0,0
647,171,209,212,336,16,15,10,41,127,119,206,0,0
648,170,209,211,336,16,15,10,41,127,120,206,0,0
649,170,209,210,336,16,15,10,40,127,121,206,0,0
650,169,209,210,337,16,15,10,41,128,122,206,0,0
651,170,211,211,337,16,15,10,41,126,123,206,0,0
652,171,211,211,336,16,15,10,40,125,124,206,0,0
653,171,212,211,335,16,15,10,40,123,125,206,0,0
654,170,212,211,335,16,15,10,41,123,126,206,0,0
655,170,212,210,335,16,15,10,40,123,127,206,0,0
656,170,212,211,335,16,15,10,41,123,128,206,0,0
657,170,212,211,335,16,15,10,41,123,129,206,0,0
658,170,210,211,335,16,15,10,41,125,130,206,0,0
659,170,209,211,335,16,15,10,41,126,131,206,0,0
660,170,209,211,335,16,15,10,41,126,132,206,0,0
661,170,210,210,335,16,15,10,40,125,133,206,0,0
662,169,210,210,335,16,15,10,41,125,134,206,0,0
663,170,210,210,335,16,15,10,40,125,135,206,0,0
664,170,210,210,335,16,15,10,40,125,136,206,0,0
665,170,211,210,335,16,15,10,40,124,137,206,0,0
666,170,211,210,335,16,15,10,40,124,138,206,0,0
667,169,211,210,335,16,15,10,41,124,139,206,0,0
668,170,211,211,335,16,15,10,41,124,140,206,0,0
669,170,210,210,335,16,15,10,40,125,141,206,0,0
670,169,210,209,335,16,15,10,40,125,142,206,0,0
671,169,211,207,333,16,15,10,38,122,143,206,0,0
672,168,211,206,333,16,15,10,38,122,144,206,0,0
673,167,211,204,335,16,15,10,37,124,145,206,0,0
674,168,211,205,337,16,15,10,37,126,146,206,0,0
675,173,213,211,343,16,15,10,38,130,147,206,0,0
676,170,212,209,344,16,15,10,39,132,148,206,0,0
677,172,211,211,346,16,15,10,39,135,149,206,0,0
678,175,211,215,347,16,15,10,40,136,150,206,0,0
679,174,213,215,348,16,15,10,41,135,151,206,0,0
680,172,213,212,347,16,15,10,40,134,152,206,0,0
681,169,214,211,348,16,15,10,42,134,153,206,0,0
682,167,215,209,349,16,15,10,42,134,154,206,0,0
683,166,216,209,348,16,15,10,43,132,155,206,0,0
684,167,215,211,346,16,15,10,44,131,156,206,0,0
685,167,214,212,345,16,15,10,45,131,157,206,0,0
686,167,213,212,345,16,15,10,45,132,158,206,0,0
687,168,211,214,344,16,15,10,46,133,159,206,0,0
688,168,212,215,344,16,15,10,47,132,160,206,0,0
689,168,213,215,343,16,15,10,47,130,161,206,0,0
690,168,215,216,342,16,15,10,48,127,162,206,0,0
691,169,215,217,343,16,15,10,48,128,163,206,0,0
692,165,218,212,345,16,15,10,47,127,164,206,0,0
693,162,218,211,349,16,15,10,49,131,165,206,0,0
694,162,219,209,349,16,15,10,47,130,166,206,0,0
695,161,219,209,349,16,15,10,48,130,167,206,0,0
696,160,219,208,349,16,15,10,48,130,168,206,0,0
697,158,219,207,349,16,15,10,49,130,169,206,0,0
698,158,219,208,349,16,15,10,50,130,170,206,0,0
699,159,216,211,348,16,15,10,52,132,171,206,0,0
700,158,213,210,346,16,15,10,52,133,172,206,0,0
701,156,211,208,342,16,15,10,52,131,173,206,0,0
702,156,213,206,337,16,15,10,50,124,174,206,0,0
703,157,210,208,334,16,15,10,51,124,175,206,0,0
704,154,211,204,331,16,15,10,50,120,176,206,0,0
705,157,210,207,328,16,15,10,50,118,177,206,0,0
706,155,210,204,324,16,15,10,49,114,178,206,0,0
707,156,210,204,321,16,15,10,48,111,179,206,0,0
708,155,208,202,319,16,15,10,47,111,180,206,0,0
709,154,208,201,316,16,15,10,47,108,181,206,0,0
710,154,208,200,312,16,15,10,46,104,182,206,0,0
711,152,208,198,310,16,15,10,46,102,183,206,0,0
712,150,206,196,307,16,15,10,46,101,184,206,0,0
713,150,204,197,307,16,15,10,47,103,185,206,0,0
714,147,205,193,303,16,15,10,46,98,186,206,0,0
715,148,202,194,301,16,15,10,46,99,187,206,0,0
716,146,203,191,298,16,15,10,45,95,188,206,0,0
717,144,201,188,296,16,15,10,44,95,189,206,0,0
718,142,198,187,295,16,15,10,45,97,190,206,0,0
719,140,199,185,293,16,15,10,45,94,191,206,0,0
720,139,197,183,291,16,15,10,44,94,192,206,0,0
721,138,194,183,288,16,15,10,45,94,193,206,0,0
722,138,193,182,287,16,15,10,44,94,194,206,0,0
723,137,192,181,285,16,15,10,44,93,195,206,0,0
724,137,192,179,284,16,15,10,42,92,196,206,0,0
725,136,191,178,281,16,15,10,42,90,197,206,0,0
726,136,192,176,279,16,15,10,40,87,198,206,0,0
727,135,193,174,277,16,15,10,39,84,199,206,0,0
728,134,192,173,277,16,15,10,39,85,200,206,0,0
729,132,192,170,275,16,15,10,38,83,201,206,0,0
730,132,191,170,273,16,15,10,38,82,202,206,0,0
731,130,191,167,271,16,15,10,37,80,203,206,0,0
732,127,190,164,269,16,15,10,37,79,204,206,0,0
733,125,190,161,269,16,15,10,36,79,205,206,0,0
734,123,192,158,267,16,15,10,35,75,206,206,1,0
737,118,188,153,262,16,15,10,35,74,0,206,0,0
738,115,186,151,262,16,15,10,36,76,1,206,0,0
739,114,185,149,260,16,15,10,35,75,2,206,0,0
740,113,185,148,259,16,15,10,35,74,3,206,0,0
742,112,182,147,254,16,15,10,35,72,0,206,0,0
743,112,181,147,255,16,15,10,35,74,1,206,0,0
744,111,180,146,254,16,15,10,35,74,2,206,0,0
745,111,179,146,252,16,15,10,35,73,3,206,0,0
746,110,180,145,252,16,15,10,35,72,4,206,0,0
544,319,245,354,404,17,15,10,35,159,0,9,0,0
545,314,242,349,398,17,15,10,35,156,1,9,0,0
546,302,245,340,413,17,15,10,38,168,2,9,0,0
547,292,246,329,407,17,15,10,37,161,3,9,0,0
548,278,247,316,412,17,15,10,38,165,4,9,0,0
549,261,249,300,416,17,15,10,39,167,5,9,0,0
550,243,257,283,425,17,15,10,40,168,6,9,0,0
551,220,260,261,429,17,15,10,41,169,7,9,0,0
552,198,260,242,444,17,15,10,44,184,8,9,0,0
553,182,262,228,450,17,15,10,46,188,9,9,0,0
555,88,265,138,507,18,15,10,50,242,0,0,0,0
556,49,273,101,507,19,15,10,52,234,0,0,0,0
666,252,227,289,344,20,15,10,37,117,0,11,0,0
667,249,224,286,342,20,15,10,37,118,1,11,0,0
668,247,227,282,338,20,15,10,35,111,2,11,0,0
669,231,217,270,339,20,15,10,39,122,3,11,0,0
670,214,221,254,343,20,15,10,40,122,4,11,0,0
671,206,220,247,343,20,15,10,41,123,5,11,0,0
672,201,221,241,342,20,15,10,40,121,6,11,0,0
673,196,221,236,341,20,15,10,40,120,7,11,0,0
674,194,218,233,336,20,15,10,39,118,8,11,0,0
675,200,218,238,334,20,15,10,38,116,9,11,0,0
676,190,218,228,337,20,15,10,38,119,10,11,0,0
677,184,217,223,337,20,15,10,39,120,11,11,0,0
692,194,211,235,336,20,15,10,41,125,0,11,0,0
693,201,218,237,331,20,15,10,36,113,1,11,0,0
694,212,221,250,335,20,15,10,38,114,2,11,0,0
695,219,218,259,335,20,15,10,40,117,3,11,0,0
696,225,222,266,335,20,15,10,41,113,4,11,0,0
697,245,226,283,333,20,15,10,38,107,5,11,0,0
698,251,227,287,332,20,15,10,36,105,6,11,0,0
676,208,225,243,332,21,15,10,35,107,0,0,0,0
693,224,229,261,331,22,15,10,37,102,0,0,0,0
815,888,389,968,695,23,15,10,80,306,0,20,0,1
816,852,389,953,772,23,15,10,101,383,1,20,0,0
817,822,385,927,783,23,15,10,105,398,2,20,0,0
818,768,379,879,797,23,15,10,111,418,3,20,0,0
819,712,378,829,803,23,15,10,117,425,4,20,0,0
820,657,365,778,805,23,15,10,121,440,5,20,0,0
821,588,361,713,805,23,15,10,125,444,6,20,0,0
822,539,359,664,794,23,15,10,125,435,7,20,0,0
823,484,350,610,784,23,15,10,126,434,8,20,0,0
824,427,349,555,772,23,15,10,128,423,9,20,0,0
825,386,342,507,748,23,15,10,121,406,10,20,0,0
826,340,334,460,735,23,15,10,120,401,11,20,0,0
827,304,326,419,715,23,15,10,115,389,12,20,0,0
828,271,314,383,691,23,15,10,112,377,13,20,0,0
829,244,318,356,683,23,15,10,112,365,14,20,0,0
830,193,315,299,662,23,15,10,106,347,15,20,0,0
831,150,314,260,663,23,15,10,110,349,16,20,0,0
832,108,314,211,641,23,15,10,103,327,17,20,0,0
833,59,311,162,641,23,15,10,103,330,18,20,0,0
834,27,311,130,639,23,15,10,103,328,19,20,0,0
835,0,308,87,631,23,15,10,87,323,20,20,1,0
820,906,423,1005,778,24,15,10,99,355,0,26,0,1
821,864,430,966,791,24,15,10,102,361,1,26,0,0
822,823,431,929,800,24,15,10,106,369,2,26,0,0
823,791,403,905,796,24,15,10,114,393,3,26,0,0
824,741,417,852,798,24,15,10,111,381,4,26,0,0
825,697,405,814,796,24,15,10,117,391,5,26,0,0
826,653,385,772,783,24,15,10,119,398,6,26,0,0
827,597,379,718,770,24,15,10,121,391,7,26,0,0
828,554,373,680,766,24,15,10,126,393,8,26,0,0
829,529,363,653,743,24,15,10,124,380,9,26,0,0
830,491,356,616,735,24,15,10,125,379,10,26,0,0
831,456,353,583,732,24,15,10,127,379,11,26,0,0
832,416,344,537,713,24,15,10,121,369,12,26,0,0
833,367,345,490,702,24,15,10,123,357,13,26,0,0
834,345,345,466,689,24,15,10,121,344,14,26,0,0
835,303,337,421,678,24,15,10,118,341,15,26,0,0
836,275,340,392,673,24,15,10,117,333,16,26,0,0
837,245,332,362,671,24,15,10,117,339,17,26,0,0
838,206,319,323,661,24,15,10,117,342,18,26,0,0
839,173,318,292,657,24,15,10,119,339,19,26,0,0
840,149,319,268,649,24,15,10,119,330,20,26,0,0
841,110,317,227,650,24,15,10,117,333,21,26,0,0
842,84,321,201,648,24,15,10,117,327,22,26,0,0
843,56,318,166,635,24,15,10,110,317,23,26,0,0
844,29,315,138,635,24,15,10,109,320,24,26,0,0
845,16,312,125,635,24,15,10,109,323,25,26,0,0
846,0,309,94,630,24,15,10,94,321,26,26,1,0
1138,33,334,92,658,25,15,10,59,324,0,166,0,1
1139,67,330,130,667,25,15,10,63,337,1,166,0,0
1140,93,333,157,666,25,15,10,64,333,2,166,0,0
1141,122,335,190,677,25,15,10,68,342,3,166,0,0
1142,156,344,228,700,25,15,10,72,356,4,166,0,0
1143,188,345,264,709,25,15,10,76,364,5,166,0,0
1144,236,351,316,712,25,15,10,80,361,6,166,0,0
1145,267,358,354,724,25,15,10,87,366,7,166,0,0
1146,298,356,390,734,25,15,10,92,378,8,166,0,0
1147,334,361,432,760,25,15,10,98,399,9,166,0,0
1148,371,368,471,766,25,15,10,100,398,10,166,0,0
1149,416,376,521,777,25,15,10,105,401,11,166,0,0
1150,453,386,568,797,25,15,10,115,411,12,166,0,0
1151,500,388,619,804,25,15,10,119,416,13,166,0,0
1152,540,398,668,834,25,15,10,128,436,14,166,0,0
1153,573,411,705,848,25,15,10,132,437,15,166,0,0
1154,621,418,754,853,25,15,10,133,435,16,166,0,0
1155,654,427,793,862,25,15,10,139,435,17,166,0,0
1156,688,434,835,872,25,15,10,147,438,18,166,0,0
1157,753,441,911,896,25,15,10,158,455,19,166,0,0
1158,797,444,967,912,25,15,10,170,468,20,166,0,0
1159,814,452,990,916,25,15,10,176,464,21,166,0,0
1160,808,459,987,917,25,15,10,179,458,22,166,0,0
1161,796,464,974,920,25,15,10,178,456,23,166,0,0
1162,787,467,965,919,25,15,10,178,452,24,166,0,0
1163,782,468,963,920,25,15,10,181,452,25,166,0,0
1164,781,472,961,917,25,15,10,180,445,26,166,0,0
1165,779,473,959,916,25,15,10,180,443,27,166,0,0
1166,778,475,959,916,25,15,10,181,441,28,166,0,0
1167,776,475,959,915,25,15,10,183,440,29,166,0,0
1168,773,471,960,918,25,15,10,187,447,30,166,0,0
1169,769,469,957,917,25,15,10,188,448,31,166,0,0
1170,767,468,956,917,25,15,10,189,449,32,166,0,0
1171,766,470,955,917,25,15,10,189,447,33,166,0,0
1172,766,468,956,916,25,15,10,190,448,34,166,0,0
1173,766,468,955,915,25,15,10,189,447,35,166,0,0
1174,765,468,955,916,25,15,10,190,448,36,166,0,0
1175,765,467,954,912,25,15,10,189,445,37,166,0,0
1176,764,468,953,914,25,15,10,189,446,38,166,0,0
1177,763,471,950,913,25,15,10,187,442,39,166,0,0
1178,764,472,950,912,25,15,10,186,440,40,166,0,0
1179,763,471,950,912,25,15,10,187,441,41,166,0,0
1180,762,471,949,914,25,15,10,187,443,42,166,0,0
1181,762,471,949,913,25,15,10,187,442,43,166,0,0
1182,762,470,950,912,25,15,10,188,442,44,166,0,0
1183,762,469,950,913,25,15,10,188,444,45,166,0,0
1184,762,469,950,913,25,15,10,188,444,46,166,0,0
1185,762,468,950,913,25,15,10,188,445,47,166,0,0
1186,761,470,950,914,25,15,10,189,444,48,166,0,0
1187,760,470,949,914,25,15,10,189,444,49,166,0,0
1188,761,471,949,913,25,15,10,188,442,50,166,0,0
1189,761,472,949,913,25,15,10,188,441,51,166,0,0
1190,761,472,948,913,25,15,10,187,441,52,166,0,0
1191,761,474,948,913,25,15,10,187,439,53,166,0,0
1192,761,474,948,913,25,15,10,187,439,54,166,0,0
1193,761,474,948,913,25,15,10,187,439,55,166,0,0
1194,760,473,947,913,25,15,10,187,440,56,166,0,0
1195,760,474,948,913,25,15,10,188,439,57,166,0,0
1196,760,472,948,913,25,15,10,188,441,58,166,0,0
1197,760,472,948,913,25,15,10,188,441,59,166,0,0
1198,760,472,948,913,25,15,10,188,441,60,166,0,0
1199,760,472,947,913,25,15,10,187,441,61,166,0,0
1200,760,472,947,913,25,15,10,187,441,62,166,0,0
1201,759,472,946,913,25,15,10,187,441,63,166,0,0
1202,759,472,945,913,25,15,10,186,441,64,166,0,0
1203,759,473,945,913,25,15,10,186,440,65,166,0,0
1204,759,475,944,913,25,15,10,185,438,66,166,0,0
1205,759,474,944,913,25,15,10,185,439,67,166,0,0
1206,759,474,944,913,25,15,10,185,439,68,166,0,0
1207,759,475,944,913,25,15,10,185,438,69,166,0,0
1208,759,475,944,914,25,15,10,185,439,70,166,0,0
1209,760,475,944,914,25,15,10,184,439,71,166,0,0
1210,760,475,944,914,25,15,10,184,439,72,166,0,0
1211,760,475,945,913,25,15,10,185,438,73,166,0,0
1212,760,473,945,913,25,15,10,185,440,74,166,0,0
1213,760,473,945,913,25,15,10,185,440,75,166,0,0
1214,760,472,945,913,25,15,10,185,441,76,166,0,0
1215,760,472,945,912,25,15,10,185,440,77,166,0,0
1216,761,468,947,911,25,15,10,186,443,78,166,0,0
1217,761,467,948,911,25,15,10,187,444,79,166,0,0
1218,760,470,946,912,25,15,10,186,442,80,166,0,0
1219,760,471,945,912,25,15,10,185,441,81,166,0,0
1220,760,469,947,912,25,15,10,187,443,82,166,0,0
1221,760,472,945,912,25,15,10,185,440,83,166,0,0
1222,759,474,944,912,25,15,10,185,438,84,166,0,0
1223,760,470,946,912,25,15,10,186,442,85,166,0,0
1224,758,471,943,912,25,15,10,185,441,86,166,0,0
1225,760,470,946,912,25,15,10,186,442,87,166,0,0
1226,760,473,945,912,25,15,10,185,439,88,166,0,0
1227,760,473,944,912,25,15,10,184,439,89,166,0,0
1228,760,474,944,912,25,15,10,184,438,90,166,0,0
1229,760,472,944,913,25,15,10,184,441,91,166,0,0
1230,759,472,944,913,25,15,10,185,441,92,166,0,0
1231,760,472,945,913,25,15,10,185,441,93,166,0,0
1232,760,472,944,913,25,15,10,184,441,94,166,0,0
1233,762,467,947,911,25,15,10,185,444,95,166,0,0
1234,761,471,945,912,25,15,10,184,441,96,166,0,0
1235,761,475,944,911,25,15,10,183,436,97,166,0,0
1236,760,468,946,911,25,15,10,186,443,98,166,0,0
1237,760,472,944,911,25,15,10,184,439,99,166,0,0
1238,760,474,943,911,25,15,10,183,437,100,166,0,0
1239,760,474,942,911,25,15,10,182,437,101,166,0,0
1240,760,474,943,911,25,15,10,183,437,102,166,0,0
1241,759,473,942,912,25,15,10,183,439,103,166,0,0
1242,759,474,942,912,25,15,10,183,438,104,166,0,0
1243,760,470,944,911,25,15,10,184,441,105,166,0,0
1244,759,470,943,912,25,15,10,184,442,106,166,0,0
1245,759,471,943,912,25,15,10,184,441,107,166,0,0
1246,761,467,945,910,25,15,10,184,443,108,166,0,0
1247,765,463,948,909,25,15,10,183,446,109,166,0,0
1248,763,462,946,913,25,15,10,183,451,110,166,0,0
1249,764,454,946,911,25,15,10,182,457,111,166,0,0
1250,760,450,938,905,25,15,10,178,455,112,166,0,0
1251,759,441,930,881,25,15,10,171,440,113,166,0,0
1252,767,440,928,858,25,15,10,161,418,114,166,0,0
1253,776,450,934,857,25,15,10,158,407,115,166,0,0
1254,795,440,949,836,25,15,10,154,396,116,166,0,0
1255,830,436,976,809,25,15,10,146,373,117,166,0,0
1256,847,424,996,808,25,15,10,149,384,118,166,0,0
1257,856,418,1005,807,25,15,10,149,389,119,166,0,0
1258,868,413,1010,785,25,15,10,142,372,120,166,0,0
1259,875,407,1011,767,25,15,10,136,360,121,166,0,0
1260,881,405,1013,754,25,15,10,132,349,122,166,0,0
1261,884,398,1012,738,25,15,10,128,340,123,166,0,0
1262,884,392,1011,727,25,15,10,127,335,124,166,0,0
1263,883,391,1008,719,25,15,10,125,328,125,166,0,0
1264,883,389,1008,717,25,15,10,125,328,126,166,0,0
1265,877,387,1001,716,25,15,10,124,329,127,166,0,0
1266,869,385,992,716,25,15,10,123,331,128,166,0,0
1267,868,382,992,716,25,15,10,124,334,129,166,0,0
1268,864,382,987,716,25,15,10,123,334,130,166,0,0
1269,862,381,984,716,25,15,10,122,335,131,166,0,0
1270,854,379,979,717,25,15,10,125,338,132,166,0,0
1271,852,380,977,716,25,15,10,125,336,133,166,0,0
1272,853,379,978,716,25,15,10,125,337,134,166,0,0
1273,852,379,978,716,25,15,10,126,337,135,166,0,0
1274,849,381,977,716,25,15,10,128,335,136,166,0,0
1275,858,381,983,716,25,15,10,125,335,137,166,0,0
1276,861,382,986,718,25,15,10,125,336,138,166,0,0
1277,863,382,986,717,25,15,10,123,335,139,166,0,0
1278,860,381,984,718,25,15,10,124,337,140,166,0,0
1279,859,380,983,718,25,15,10,124,338,141,166,0,0
1280,856,380,981,719,25,15,10,125,339,142,166,0,0
1281,856,381,982,718,25,15,10,126,337,143,166,0,0
1282,856,381,982,718,25,15,10,126,337,144,166,0,0
1283,858,382,984,718,25,15,10,126,336,145,166,0,0
1284,864,383,987,719,25,15,10,123,336,146,166,0,0
1285,860,383,984,718,25,15,10,124,335,147,166,0,0
1286,857,384,982,718,25,15,10,125,334,148,166,0,0
1287,856,384,981,718,25,15,10,125,334,149,166,0,0
1288,865,385,988,718,25,15,10,123,333,150,166,0,0
1289,866,385,988,718,25,15,10,122,333,151,166,0,0
1290,864,384,986,718,25,15,10,122,334,152,166,0,0
1291,865,383,986,718,25,15,10,121,335,153,166,0,0
1292,868,382,989,718,25,15,10,121,336,154,166,0,0
1293,870,380,991,718,25,15,10,121,338,155,166,0,0
1294,872,378,993,718,25,15,10,121,340,156,166,0,0
1295,874,379,994,718,25,15,10,120,339,157,166,0,0
1296,878,381,997,718,25,15,10,119,337,158,166,0,0
1297,880,382,998,717,25,15,10,118,335,159,166,0,0
1298,880,382,995,715,25,15,10,115,333,160,166,0,0
1299,879,382,992,713,25,15,10,113,331,161,166,0,0
1300,877,381,988,712,25,15,10,111,331,162,166,0,0
1301,877,384,983,704,25,15,10,106,320,163,166,0,0
1302,879,382,979,690,25,15,10,100,308,164,166,0,0
1303,881,390,975,691,25,15,10,94,301,165,166,0,0
1304,881,391,974,689,25,15,10,93,298,166,166,1,0
1304,903,451,939,660,26,15,10,36,209,0,0,0,0
1798,234,223,285,330,27,15,10,51,107,0,27,0,1
1799,230,220,276,317,27,15,10,46,97,1,27,0,0
1800,208,222,260,330,27,15,10,52,108,2,27,0,0
1801,194,217,250,334,27,15,10,56,117,3,27,0,0
1802,183,214,237,329,27,15,10,54,115,4,27,0,0
1803,168,209,224,331,27,15,10,56,122,5,27,0,0
1804,158,207,215,331,27,15,10,57,124,6,27,0,0
1805,148,206,204,328,27,15,10,56,122,7,27,0,0
1806,137,210,192,327,27,15,10,55,117,8,27,0,0
1807,133,208,186,324,27,15,10,53,116,9,27,0,0
1808,129,206,180,319,27,15,10,51,113,10,27,0,0
1809,125,206,174,317,27,15,10,49,111,11,27,0,0
1810,120,205,168,314,27,15,10,48,109,12,27,0,0
1811,116,200,163,309,27,15,10,47,109,13,27,0,0
1812,113,196,160,308,27,15,10,47,112,14,27,0,0
1813,112,196,157,304,27,15,10,45,108,15,27,0,0
1814,110,195,153,303,27,15,10,43,108,16,27,0,0
1815,108,197,149,302,27,15,10,41,105,17,27,0,0
1816,106,193,146,297,27,15,10,40,104,18,27,0,0
1817,105,194,145,295,27,15,10,40,101,19,27,0,0
1818,105,194,143,290,27,15,10,38,96,20,27,0,0
1819,104,192,142,291,27,15,10,38,99,21,27,0,0
1820,102,189,141,291,27,15,10,39,102,22,27,0,0
1821,100,192,137,287,27,15,10,37,95,23,27,0,0
1822,100,193,135,284,27,15,10,35,91,24,27,0,0
1823,100,192,135,282,27,15,10,35,90,25,27,0,0
1824,100,189,136,281,27,15,10,36,92,26,27,0,0
1825,100,189,136,280,27,15,10,36,91,27,27,1,0
1869,32,273,78,505,28,15,10,46,232,0,23,0,1
1870,57,266,104,501,28,15,10,47,235,1,23,0,0
1871,70,264,119,502,28,15,10,49,238,2,23,0,0
1872,92,264,138,493,28,15,10,46,229,3,23,0,0
1873,108,259,157,492,28,15,10,49,233,4,23,0,0
1874,129,258,177,483,28,15,10,48,225,5,23,0,0
1875,147,256,195,474,28,15,10,48,218,6,23,0,0
1876,160,256,208,469,28,15,10,48,213,7,23,0,0
1877,174,254,222,466,28,15,10,48,212,8,23,0,0
1878,193,251,241,459,28,15,10,48,208,9,23,0,0
1879,205,251,255,458,28,15,10,50,207,10,23,0,0
1880,224,256,269,445,28,15,10,45,189,11,23,0,0
1881,240,254,287,443,28,15,10,47,189,12,23,0,0
1882,249,255,297,443,28,15,10,48,188,13,23,0,0
1883,258,251,307,435,28,15,10,49,184,14,23,0,0
1884,268,246,319,431,28,15,10,51,185,15,23,0,0
1885,280,245,333,426,28,15,10,53,181,16,23,0,0
1886,285,241,344,429,28,15,10,59,188,17,23,0,0
1887,283,241,343,428,28,15,10,60,187,18,23,0,0
1888,281,239,343,426,28,15,10,62,187,19,23,0,0
1889,291,238,352,422,28,15,10,61,184,20,23,0,0
1890,281,236,329,386,28,15,10,48,150,21,23,0,0
1891,283,239,326,375,28,15,10,43,136,22,23,0,0
1892,290,238,331,367,28,15,10,41,129,23,23,1,0
1889,280,241,315,381,29,15,10,35,140,0,0,0,0
2245,249,242,294,420,30,15,10,45,178,0,28,0,1
2246,244,243,289,420,30,15,10,45,177,1,28,0,0
2247,238,244,284,424,30,15,10,46,180,2,28,0,0
2248,230,244,277,425,30,15,10,47,181,3,28,0,0
2249,226,244,275,430,30,15,10,49,186,4,28,0,0
2250,219,250,271,444,30,15,10,52,194,5,28,0,0
2251,216,254,268,447,30,15,10,52,193,6,28,0,0
2252,216,254,270,451,30,15,10,54,197,7,28,0,0
2253,215,253,272,456,30,15,10,57,203,8,28,0,0
2254,208,255,266,460,30,15,10,58,205,9,28,0,0
2255,201,252,261,464,30,15,10,60,212,10,28,0,0
2256,196,252,260,476,30,15,10,64,224,11,28,0,0
2257,191,254,257,484,30,15,10,66,230,12,28,0,0
2258,185,256,252,486,30,15,10,67,230,13,28,0,0
2259,177,260,246,495,30,15,10,69,235,14,28,0,0
2260,166,263,237,507,30,15,10,71,244,15,28,0,0
2261,157,262,230,515,30,15,10,73,253,16,28,0,0
2262,150,265,224,518,30,15,10,74,253,17,28,0,0
2263,141,270,218,526,30,15,10,77,256,18,28,0,0
2264,129,271,206,528,30,15,10,77,257,19,28,0,0
2265,116,274,195,536,30,15,10,79,262,20,28,0,0
2266,104,278,185,550,30,15,10,81,272,21,28,0,0
2267,90,280,170,554,30,15,10,80,274,22,28,0,0
2268,77,281,159,566,30,15,10,82,285,23,28,0,0
2269,62,286,145,578,30,15,10,83,292,24,28,0,0
2270,48,286,131,582,30,15,10,83,296,25,28,0,0
2271,31,290,113,585,30,15,10,82,295,26,28,0,0
2272,26,302,104,586,30,15,10,78,284,27,28,0,0
2273,15,305,95,593,30,15,10,80,288,28,28,1,0
2410,135,198,170,297,32,15,10,35,99,0,21,0,1
2411,134,199,170,300,32,15,10,36,101,1,21,0,0
2412,135,200,171,302,32,15,10,36,102,2,21,0,0
2413,135,201,172,306,32,15,10,37,105,3,21,0,0
2414,135,204,172,308,32,15,10,37,104,4,21,0,0
2415,137,207,173,310,32,15,10,36,103,5,21,0,0
2416,140,210,176,312,32,15,10,36,102,6,21,0,0
2417,142,210,179,314,32,15,10,37,104,7,21,0,0
2418,144,210,183,319,32,15,10,39,109,8,21,0,0
2419,146,210,186,321,32,15,10,40,111,9,21,0,0
2420,150,212,191,323,32,15,10,41,111,10,21,0,0
2421,156,212,199,325,32,15,10,43,113,11,21,0,0
2422,162,210,207,329,32,15,10,45,119,12,21,0,0
2423,166,213,212,333,32,15,10,46,120,13,21,0,0
2424,176,213,220,332,32,15,10,44,119,14,21,0,0
2425,184,216,229,334,32,15,10,45,118,15,21,0,0
2426,193,217,241,336,32,15,10,48,119,16,21,0,0
2427,210,220,257,336,32,15,10,47,116,17,21,0,0
2428,224,216,273,337,32,15,10,49,121,18,21,0,0
2429,230,217,280,339,32,15,10,50,122,19,21,0,0
2430,245,219,293,340,32,15,10,48,121,20,21,0,0
2431,252,220,300,342,32,15,10,48,122,21,21,1,0
2707,135,191,174,263,37,15,10,39,72,0,50,0,0
2713,143,198,178,268,37,15,10,35,70,0,50,0,1
2714,144,197,180,269,37,15,10,36,72,1,50,0,0
2715,144,198,181,271,37,15,10,37,73,2,50,0,0
2716,144,198,180,271,37,15,10,36,73,3,50,0,0
2717,144,197,181,272,37,15,10,37,75,4,50,0,0
2718,145,197,182,274,37,15,10,37,77,5,50,0,0
2719,145,197,183,275,37,15,10,38,78,6,50,0,0
2720,145,199,182,276,37,15,10,37,77,7,50,0,0
2721,144,200,180,275,37,15,10,36,75,8,50,0,0
2722,144,201,180,277,37,15,10,36,76,9,50,0,0
2723,145,201,181,278,37,15,10,36,77,10,50,0,0
2724,145,202,182,280,37,15,10,37,78,11,50,0,0
2725,145,204,181,281,37,15,10,36,77,12,50,0,0
2726,144,202,182,283,37,15,10,38,81,13,50,0,0
2727,144,200,183,285,37,15,10,39,85,14,50,0,0
2728,146,201,183,283,37,15,10,37,82,15,50,0,0
2729,146,201,186,287,37,15,10,40,86,16,50,0,0
2730,146,203,185,289,37,15,10,39,86,17,50,0,0
2731,148,204,186,290,37,15,10,38,86,18,50,0,0
2732,150,207,187,290,37,15,10,37,83,19,50,0,0
2733,152,207,189,290,37,15,10,37,83,20,50,0,0
2734,153,208,191,293,37,15,10,38,85,21,50,0,0
2735,152,210,189,294,37,15,10,37,84,22,50,0,0
2736,152,210,189,294,37,15,10,37,84,23,50,0,0
2737,154,211,191,295,37,15,10,37,84,24,50,0,0
2738,156,213,193,296,37,15,10,37,83,25,50,0,0
2739,156,213,196,302,37,15,10,40,89,26,50,0,0
2740,157,212,197,302,37,15,10,40,90,27,50,0,0
2741,159,212,200,306,37,15,10,41,94,28,50,0,0
2742,161,213,202,308,37,15,10,41,95,29,50,0,0
2743,162,211,204,310,37,15,10,42,99,30,50,0,0
2744,163,211,206,313,37,15,10,43,102,31,50,0,0
2745,164,210,207,314,37,15,10,43,104,32,50,0,0
2746,165,211,209,315,37,15,10,44,104,33,50,0,0
2747,168,214,210,316,37,15,10,42,102,34,50,0,0
2748,170,212,214,319,37,15,10,44,107,35,50,0,0
2749,171,214,216,324,37,15,10,45,110,36,50,0,0
2750,171,214,216,324,37,15,10,45,110,37,50,0,0
2751,173,216,218,326,37,15,10,45,110,38,50,0,0
2752,178,224,220,327,37,15,10,42,103,39,50,0,0
2753,181,224,225,329,37,15,10,44,105,40,50,0,0
2754,183,225,227,332,37,15,10,44,107,41,50,0,0
2755,190,229,232,330,37,15,10,42,101,42,50,0,0
2756,196,233,237,332,37,15,10,41,99,43,50,0,0
2757,204,233,246,333,37,15,10,42,100,44,50,0,0
2758,214,234,256,333,37,15,10,42,99,45,50,0,0
2759,223,239,264,333,37,15,10,41,94,46,50,0,0
2760,238,237,277,329,37,15,10,39,92,47,50,0,0
2761,245,237,285,332,37,15,10,40,95,48,50,0,0
2762,250,243,288,335,37,15,10,38,92,49,50,0,0
2763,256,245,294,336,37,15,10,38,91,50,50,1,0
2971,564,277,631,506,38,15,10,67,229,0,26,0,1
2972,541,268,612,511,38,15,10,71,243,1,26,0,0
2973,513,275,583,510,38,15,10,70,235,2,26,0,0
2974,489,279,557,505,38,15,10,68,226,3,26,0,0
2975,466,275,532,495,38,15,10,66,220,4,26,0,0
2976,433,270,502,493,38,15,10,69,223,5,26,0,0
2977,415,268,484,488,38,15,10,69,220,6,26,0,0
2978,398,265,465,481,38,15,10,67,216,7,26,0,0
2979,377,267,444,480,38,15,10,67,213,8,26,0,0
2980,361,264,424,465,38,15,10,63,201,9,26,0,0
2981,346,260,408,459,38,15,10,62,199,10,26,0,0
2982,322,257,389,462,38,15,10,67,205,11,26,0,0
2983,313,257,381,465,38,15,10,68,208,12,26,0,0
2984,309,256,376,460,38,15,10,67,204,13,26,0,0
2985,305,256,372,459,38,15,10,67,203,14,26,0,0
2986,306,257,373,455,38,15,10,67,198,15,26,0,0
2987,309,251,375,444,38,15,10,66,193,16,26,0,0
2988,308,249,373,438,38,15,10,65,189,17,26,0,0
2989,304,250,367,434,38,15,10,63,184,18,26,0,0
2990,298,244,361,428,38,15,10,63,184,19,26,0,0
2991,293,243,356,425,38,15,10,63,182,20,26,0,0
2992,289,243,351,423,38,15,10,62,180,21,26,0,0
2993,284,240,348,423,38,15,10,64,183,22,26,0,0
2994,281,239,345,423,38,15,10,64,184,23,26,0,0
2995,275,239,337,423,38,15,10,62,184,24,26,0,0
2996,275,240,336,424,38,15,10,61,184,25,26,0,0
2997,269,239,329,421,38,15,10,60,182,26,26,1,0
3350,578,394,625,483,39,15,10,47,89,0,0,0,0
3353,541,307,629,608,40,15,10,88,301,0,47,0,1
3354,544,307,638,629,40,15,10,94,322,1,47,0,0
3355,530,314,625,640,40,15,10,95,326,2,47,0,0
3356,511,309,611,645,40,15,10,100,336,3,47,0,0
3357,485,317,591,662,40,15,10,106,345,4,47,0,0
3358,466,318,578,673,40,15,10,112,355,5,47,0,0
3359,457,322,576,693,40,15,10,119,371,6,47,0,0
3360,457,331,585,718,40,15,10,128,387,7,47,0,0
3361,468,336,602,730,40,15,10,134,394,8,47,0,0
3362,475,348,621,767,40,15,10,146,419,9,47,0,0
3363,489,358,640,786,40,15,10,151,428,10,47,0,0
3364,509,365,664,806,40,15,10,155,441,11,47,0,0
3365,533,385,692,839,40,15,10,159,454,12,47,0,0
3366,561,393,719,848,40,15,10,158,455,13,47,0,0
3367,599,395,766,879,40,15,10,167,484,14,47,0,0
3368,624,410,797,906,40,15,10,173,496,15,47,0,0
3369,676,421,845,913,40,15,10,169,492,16,47,0,0
3370,715,438,885,929,40,15,10,170,491,17,47,0,0
3371,753,461,924,943,40,15,10,171,482,18,47,0,0
3372,797,480,982,999,40,15,10,185,519,19,47,0,0
3373,836,516,1026,1031,40,15,10,190,515,20,47,0,0
3374,847,557,1041,1045,40,15,10,194,488,21,47,0,0
3375,837,593,1037,1047,40,15,10,200,454,22,47,0,0
3376,817,618,1024,1047,40,15,10,207,429,23,47,0,0
3377,811,628,1031,1046,40,15,10,220,418,24,47,0,0
3378,799,624,1036,1042,40,15,10,237,418,25,47,0,0
3379,781,608,1041,1045,40,15,10,260,437,26,47,0,0
3380,752,571,1040,1047,40,15,10,288,476,27,47,0,0
3381,709,521,1019,1045,40,15,10,310,524,28,47,0,0
3382,675,469,978,1001,40,15,10,303,532,29,47,0,0
3383,648,449,938,975,40,15,10,290,526,30,47,0,0
3384,625,430,906,954,40,15,10,281,524,31,47,0,0
3385,601,403,858,897,40,15,10,257,494,32,47,0,0
3386,560,383,803,862,40,15,10,243,479,33,47,0,0
3387,539,377,765,832,40,15,10,226,455,34,47,0,0
3388,512,363,721,794,40,15,10,209,431,35,47,0,0
3389,493,354,697,776,40,15,10,204,422,36,47,0,0
3390,473,344,665,749,40,15,10,192,405,37,47,0,0
3391,457,331,638,725,40,15,10,181,394,38,47,0,0
3392,441,329,613,709,40,15,10,172,380,39,47,0,0
3393,433,320,591,676,40,15,10,158,356,40,47,0,0
3394,434,317,585,661,40,15,10,151,344,41,47,0,0
3395,444,313,589,646,40,15,10,145,333,42,47,0,0
3396,467,305,605,627,40,15,10,138,322,43,47,0,0
3397,485,306,618,620,40,15,10,133,314,44,47,0,0
3398,513,302,635,600,40,15,10,122,298,45,47,0,0
3399,532,307,645,592,40,15,10,113,285,46,47,0,0
3400,536,302,644,576,40,15,10,108,274,47,47,1,0
3376,969,675,1112,1022,42,15,10,143,347,0,0,0,0
3400,567,498,622,592,44,15,10,55,94,0,0,0,0
3435,260,244,307,420,45,15,10,47,176,0,24,0,1
3436,246,244,295,426,45,15,10,49,182,1,24,0,0
3437,243,248,291,424,45,15,10,48,176,2,24,0,0
3438,228,239,280,431,45,15,10,52,192,3,24,0,0
3439,223,239,277,429,45,15,10,54,190,4,24,0,0
3440,224,237,279,433,45,15,10,55,196,5,24,0,0
3441,228,240,286,445,45,15,10,58,205,6,24,0,0
3442,235,243,294,448,45,15,10,59,205,7,24,0,0
3443,242,249,303,457,45,15,10,61,208,8,24,0,0
3444,250,251,311,460,45,15,10,61,209,9,24,0,0
3445,260,254,325,470,45,15,10,65,216,10,24,0,0
3446,270,257,337,475,45,15,10,67,218,11,24,0,0
3447,294,256,361,471,45,15,10,67,215,12,24,0,0
3448,318,257,385,473,45,15,10,67,216,13,24,0,0
3449,333,259,404,481,45,15,10,71,222,14,24,0,0
3450,364,262,433,482,45,15,10,69,220,15,24,0,0
3451,389,266,458,482,45,15,10,69,216,16,24,0,0
3452,412,270,484,485,45,15,10,72,215,17,24,0,0
3453,439,274,510,486,45,15,10,71,212,18,24,0,0
3454,471,277,543,493,45,15,10,72,216,19,24,0,0
3455,494,283,570,500,45,15,10,76,217,20,24,0,0
3456,522,284,598,502,45,15,10,76,218,21,24,0,0
3457,554,284,629,502,45,15,10,75,218,22,24,0,0
3458,573,308,639,502,45,15,10,66,194,23,24,0,0
3459,593,313,659,505,45,15,10,66,192,24,24,1,0
4729,28,262,120,511,46,15,10,92,249,0,19,0,1
4730,42,265,131,509,46,15,10,89,244,1,19,0,0
4731,63,263,152,507,46,15,10,89,244,2,19,0,0
4732,90,259,179,502,46,15,10,89,243,3,19,0,0
4733,116,259,201,490,46,15,10,85,231,4,19,0,0
4734,127,255,212,490,46,15,10,85,235,5,19,0,0
4735,143,253,227,489,46,15,10,84,236,6,19,0,0
4736,162,253,242,478,46,15,10,80,225,7,19,0,0
4737,178,250,256,469,46,15,10,78,219,8,19,0,0
4738,184,245,264,465,46,15,10,80,220,9,19,0,0
4739,205,244,273,434,46,15,10,68,190,10,19,0,0
4740,223,247,283,415,46,15,10,60,168,11,19,0,0
4741,236,252,297,417,46,15,10,61,165,12,19,0,0
4742,254,244,320,420,46,15,10,66,176,13,19,0,0
4743,255,240,326,422,46,15,10,71,182,14,19,0,0
4744,256,240,328,422,46,15,10,72,182,15,19,0,0
4745,260,239,332,419,46,15,10,72,180,16,19,0,0
4746,275,239,330,378,46,15,10,55,139,17,19,0,0
4747,281,240,334,375,46,15,10,53,135,18,19,0,0
4748,292,239,342,367,46,15,10,50,128,19,19,0,0
5022,247,224,288,345,47,15,10,41,121,0,15,0,0
5023,244,218,285,339,47,15,10,41,121,1,15,0,0
5024,232,217,273,336,47,15,10,41,119,2,15,0,0
5025,214,224,254,338,47,15,10,40,114,3,15,0,0
5026,205,220,246,339,47,15,10,41,119,4,15,0,0
5027,190,218,233,339,47,15,10,43,121,5,15,0,0
5028,170,217,211,334,47,15,10,41,117,6,15,0,0
5029,153,216,195,334,47,15,10,42,118,7,15,0,0
5030,141,215,184,335,47,15,10,43,120,8,15,0,0
5031,133,216,174,331,47,15,10,41,115,9,15,0,0
5032,126,213,166,328,47,15,10,40,115,10,15,0,0
5033,120,213,159,328,47,15,10,39,115,11,15,0,0
5034,112,210,151,327,47,15,10,39,117,12,15,0,0
5035,108,209,146,323,47,15,10,38,114,13,15,0,0
5036,105,211,141,320,47,15,10,36,109,14,15,0,0
5037,104,209,139,317,47,15,10,35,108,15,15,0,0
5027,217,227,255,331,48,15,10,38,104,0,0,0,0
5029,188,223,223,334,49,15,10,35,111,0,15,0,0
5030,182,219,218,332,49,15,10,36,113,1,15,0,0
5031,174,215,210,332,49,15,10,36,117,2,15,0,0
5032,167,214,205,332,49,15,10,38,118,3,15,0,0
5033,161,213,197,328,49,15,10,36,115,4,15,0,0
5034,154,213,190,327,49,15,10,36,114,5,15,0,0
5035,151,212,187,324,49,15,10,36,112,6,15,0,0
5036,148,212,185,322,49,15,10,37,110,7,15,0,0
5037,145,211,181,318,49,15,10,36,107,8,15,0,0
5038,142,212,177,315,49,15,10,35,103,9,15,0,0
5039,138,211,173,313,49,15,10,35,102,10,15,0,0
5040,135,210,170,313,49,15,10,35,103,11,15,0,0
5041,133,208,169,311,49,15,10,36,103,12,15,0,0
5042,133,207,168,309,49,15,10,35,102,13,15,0,0
5043,133,207,168,308,49,15,10,35,101,14,15,0,0
5044,130,205,165,305,49,15,10,35,100,15,15,0,0
5041,255,237,297,409,50,15,10,42,172,0,18,0,0
5042,247,236,294,427,50,15,10,47,191,1,18,0,0
5043,244,239,293,433,50,15,10,49,194,2,18,0,0
5044,246,249,296,446,50,15,10,50,197,3,18,0,0
5045,251,253,303,451,50,15,10,52,198,4,18,0,0
5046,262,256,316,457,50,15,10,54,201,5,18,0,0
5047,279,255,336,465,50,15,10,57,210,6,18,0,0
5048,295,256,354,469,50,15,10,59,213,7,18,0,0
5049,317,260,377,471,50,15,10,60,211,8,18,0,0
5050,335,262,399,482,50,15,10,64,220,9,18,0,0
5051,364,263,428,484,50,15,10,64,221,10,18,0,0
5052,388,268,457,485,50,15,10,69,217,11,18,0,0
5053,424,264,495,485,50,15,10,71,221,12,18,0,0
5054,461,266,532,488,50,15,10,71,222,13,18,0,0
5055,489,272,562,486,50,15,10,73,214,14,18,0,0
5056,520,269,592,483,50,15,10,72,214,15,18,0,0
5057,556,270,627,482,50,15,10,71,212,16,18,0,0
5058,572,284,639,484,50,15,10,67,200,17,18,0,0
5059,591,287,659,489,50,15,10,68,202,18,18,0,0
5099,570,287,630,532,52,15,10,60,245,0,16,0,0
5100,549,280,611,531,52,15,10,62,251,1,16,0,0
5101,519,290,582,538,52,15,10,63,248,2,16,0,0
5102,495,297,560,541,52,15,10,65,244,3,16,0,0
5103,468,288,538,550,52,15,10,70,262,4,16,0,0
5104,425,289,500,561,52,15,10,75,272,5,16,0,0
5105,394,290,469,561,52,15,10,75,271,6,16,0,0
5106,339,288,421,574,52,15,10,82,286,7,16,0,0
5107,301,294,389,583,52,15,10,88,289,8,16,0,0
5108,260,285,350,582,52,15,10,90,297,9,16,0,0
5109,209,289,304,589,52,15,10,95,300,10,16,0,0
5110,176,290,274,594,52,15,10,98,304,11,16,0,0
5111,127,290,223,595,52,15,10,96,305,12,16,0,0
5112,76,296,178,604,52,15,10,102,308,13,16,0,0
5113,38,297,142,612,52,15,10,104,315,14,16,0,0
5114,11,337,100,617,52,15,10,89,280,15,16,0,0
5115,0,342,64,623,52,15,10,64,281,16,16,0,0
5488,29,282,81,575,53,15,10,52,293,0,51,0,1
5489,36,282,91,588,53,15,10,55,306,1,51,0,0
5490,52,283,108,592,53,15,10,56,309,2,51,0,0
5491,69,286,126,594,53,15,10,57,308,3,51,0,0
5492,96,290,156,596,53,15,10,60,306,4,51,0,0
5493,109,290,170,597,53,15,10,61,307,5,51,0,0
5494,132,290,196,601,53,15,10,64,311,6,51,0,0
5495,149,294,218,616,53,15,10,69,322,7,51,0,0
5496,166,294,238,627,53,15,10,72,333,8,51,0,0
5497,185,296,258,624,53,15,10,73,328,9,51,0,0
5498,212,298,292,636,53,15,10,80,338,10,51,0,0
5499,229,296,314,643,53,15,10,85,347,11,51,0,0
5500,257,297,347,653,53,15,10,90,356,12,51,0,0
5501,272,302,371,676,53,15,10,99,374,13,51,0,0
5502,284,304,385,678,53,15,10,101,374,14,51,0,0
5503,297,307,398,676,53,15,10,101,369,15,51,0,0
5504,315,316,421,693,53,15,10,106,377,16,51,0,0
5505,334,318,443,695,53,15,10,109,377,17,51,0,0
5506,347,322,459,713,53,15,10,112,391,18,51,0,0
5507,362,334,476,732,53,15,10,114,398,19,51,0,0
5508,376,336,492,740,53,15,10,116,404,20,51,0,0
5509,404,338,526,746,53,15,10,122,408,21,51,0,0
5510,420,343,545,754,53,15,10,125,411,22,51,0,0
5511,443,351,570,763,53,15,10,127,412,23,51,0,0
5512,468,359,601,794,53,15,10,133,435,24,51,0,0
5513,484,369,621,818,53,15,10,137,449,25,51,0,0
5514,502,373,638,823,53,15,10,136,450,26,51,0,0
5515,524,380,666,840,53,15,10,142,460,27,51,0,0
5516,540,387,688,863,53,15,10,148,476,28,51,0,0
5517,562,391,711,866,53,15,10,149,475,29,51,0,0
5518,589,405,747,910,53,15,10,158,505,30,51,0,0
5519,609,412,778,948,53,15,10,169,536,31,51,0,0
5520,633,420,807,958,53,15,10,174,538,32,51,0,0
5521,657,437,840,990,53,15,10,183,553,33,51,0,0
5522,678,450,874,1017,53,15,10,196,567,34,51,0,0
5523,716,460,922,1037,53,15,10,206,577,35,51,0,0
5524,753,475,967,1065,53,15,10,214,590,36,51,0,0
5525,791,489,1006,1075,53,15,10,215,586,37,51,0,0
5526,821,505,1032,1080,53,15,10,211,575,38,51,0,0
5527,851,533,1060,1080,53,15,10,209,547,39,51,0,0
5528,920,553,1124,1078,53,15,10,204,525,40,51,0,0
5529,1002,568,1206,1074,53,15,10,204,506,41,51,0,0
5530,1062,592,1265,1076,53,15,10,203,484,42,51,0,0
5531,1129,617,1331,1080,53,15,10,202,463,43,51,0,0
5532,1195,645,1393,1074,53,15,10,198,429,44,51,0,0
5533,1238,680,1443,1078,53,15,10,205,398,45,51,0,0
5534,1322,697,1534,1077,53,15,10,212,380,46,51,0,0
5535,1403,725,1615,1076,53,15,10,212,351,47,51,0,0
5536,1493,773,1695,1078,53,15,10,202,305,48,51,0,0
5537,1629,804,1813,1074,53,15,10,184,270,49,51,0,0
5538,1714,833,1887,1079,53,15,10,173,246,50,51,0,0
5539,1796,860,1920,1080,53,15,10,124,220,51,51,1,0
5496,32,296,89,597,54,15,10,57,301,0,37,0,1
5497,43,302,103,611,54,15,10,60,309,1,37,0,0
5498,54,308,114,618,54,15,10,60,310,2,37,0,0
5499,61,311,125,630,54,15,10,64,319,3,37,0,0
5500,65,310,135,643,54,15,10,70,333,4,37,0,0
5501,76,313,149,650,54,15,10,73,337,5,37,0,0
5502,90,318,167,658,54,15,10,77,340,6,37,0,0
5503,108,317,189,668,54,15,10,81,351,7,37,0,0
5504,122,318,208,675,54,15,10,86,357,8,37,0,0
5505,132,321,221,680,54,15,10,89,359,9,37,0,0
5506,142,330,235,696,54,15,10,93,366,10,37,0,0
5507,154,329,251,695,54,15,10,97,366,11,37,0,0
5508,165,333,267,708,54,15,10,102,375,12,37,0,0
5509,177,347,285,727,54,15,10,108,380,13,37,0,0
5510,183,353,300,753,54,15,10,117,400,14,37,0,0
5511,194,351,319,769,54,15,10,125,418,15,37,0,0
5512,203,354,337,791,54,15,10,134,437,16,37,0,0
5513,214,380,352,812,54,15,10,138,432,17,37,0,0
5514,213,392,359,834,54,15,10,146,442,18,37,0,0
5515,208,407,358,854,54,15,10,150,447,19,37,0,0
5516,206,426,364,892,54,15,10,158,466,20,37,0,0
5517,209,439,375,922,54,15,10,166,483,21,37,0,0
5518,220,448,392,939,54,15,10,172,491,22,37,0,0
5519,234,469,414,963,54,15,10,180,494,23,37,0,0
5520,248,489,446,1017,54,15,10,198,528,24,37,0,0
5521,253,505,448,1011,54,15,10,195,506,25,37,0,0
5522,265,525,476,1055,54,15,10,211,530,26,37,0,0
5523,289,550,503,1074,54,15,10,214,524,27,37,0,0
5524,335,561,554,1079,54,15,10,219,518,28,37,0,0
5525,408,586,635,1080,54,15,10,227,494,29,37,0,0
5526,461,628,692,1080,54,15,10,231,452,30,37,0,0
5527,490,655,723,1080,54,15,10,233,425,31,37,0,0
5528,537,673,774,1080,54,15,10,237,407,32,37,0,0
5529,605,707,841,1080,54,15,10,236,373,33,37,0,0
5530,697,733,936,1080,54,15,10,239,347,34,37,0,0
5531,795,771,1029,1078,54,15,10,234,307,35,37,0,0
5532,933,830,1149,1073,54,15,10,216,243,36,37,0,0
5533,1009,859,1203,1078,54,15,10,194,219,37,37,1,0
5621,1816,872,1920,1076,56,15,10,104,204,0,3,0,0
5622,1790,841,1910,1075,56,15,10,120,234,1,3,0,0
5623,1734,824,1862,1074,56,15,10,128,250,2,3,0,0
5624,1709,813,1843,1073,56,15,10,134,260,3,3,0,0
5624,1496,773,1771,1078,57,15,10,275,305,0,133,0,1
5625,1400,734,1705,1072,57,15,10,305,338,1,133,0,0
5626,1302,714,1626,1074,57,15,10,324,360,2,133,0,0
5627,1192,676,1544,1072,57,15,10,352,396,3,133,0,0
5628,1105,640,1467,1056,57,15,10,362,416,4,133,0,0
5629,1038,739,1325,1064,57,15,10,287,325,5,133,0,0
5630,903,723,1208,1068,57,15,10,305,345,6,133,0,0
5631,752,691,1085,1070,57,15,10,333,379,7,133,0,0
5632,621,637,997,1071,57,15,10,376,434,8,133,0,0
5633,521,594,926,1073,57,15,10,405,479,9,133,0,0
5634,448,553,875,1072,57,15,10,427,519,10,133,0,0
5635,399,510,843,1070,57,15,10,444,560,11,133,0,0
5636,361,482,805,1069,57,15,10,444,587,12,133,0,0
5637,334,462,774,1071,57,15,10,440,609,13,133,0,0
5638,317,434,755,1071,57,15,10,438,637,14,133,0,0
5639,307,421,736,1074,57,15,10,429,653,15,133,0,0
5640,309,407,723,1069,57,15,10,414,662,16,133,0,0
5641,328,397,704,1025,57,15,10,376,628,17,133,0,0
5642,334,395,681,991,57,15,10,347,596,18,133,0,0
5643,339,390,671,979,57,15,10,332,589,19,133,0,0
5644,354,387,671,971,57,15,10,317,584,20,133,0,0
5645,366,385,669,969,57,15,10,303,584,21,133,0,0
5646,377,382,667,966,57,15,10,290,584,22,133,0,0
5647,387,380,660,955,57,15,10,273,575,23,133,0,0
5648,394,375,659,957,57,15,10,265,582,24,133,0,0
5649,401,374,655,957,57,15,10,254,583,25,133,0,0
5650,407,371,653,958,57,15,10,246,587,26,133,0,0
5651,413,370,651,960,57,15,10,238,590,27,133,0,0
5652,420,371,649,959,57,15,10,229,588,28,133,0,0
5653,425,372,645,957,57,15,10,220,585,29,133,0,0
5654,429,375,641,955,57,15,10,212,580,30,133,0,0
5655,433,375,639,956,57,15,10,206,581,31,133,0,0
5656,436,377,637,957,57,15,10,201,580,32,133,0,0
5657,440,380,634,956,57,15,10,194,576,33,133,0,0
5658,442,379,632,957,57,15,10,190,578,34,133,0,0
5659,444,379,631,957,57,15,10,187,578,35,133,0,0
5660,446,381,629,958,57,15,10,183,577,36,133,0,0
5661,447,379,626,956,57,15,10,179,577,37,133,0,0
5662,447,377,624,956,57,15,10,177,579,38,133,0,0
5663,450,375,624,954,57,15,10,174,579,39,133,0,0
5664,453,375,626,955,57,15,10,173,580,40,133,0,0
5665,453,375,625,955,57,15,10,172,580,41,133,0,0
5666,457,373,628,955,57,15,10,171,582,42,133,0,0
5667,456,374,626,958,57,15,10,170,584,43,133,0,0
5668,456,372,624,958,57,15,10,168,586,44,133,0,0
5669,451,373,616,954,57,15,10,165,581,45,133,0,0
5670,449,370,610,941,57,15,10,161,571,46,133,0,0
5671,440,375,595,922,57,15,10,155,547,47,133,0,0
5672,435,376,587,909,57,15,10,152,533,48,133,0,0
5673,435,375,589,907,57,15,10,154,532,49,133,0,0
5674,438,374,592,903,57,15,10,154,529,50,133,0,0
5675,439,375,594,902,57,15,10,155,527,51,133,0,0
5676,436,370,596,914,57,15,10,160,544,52,133,0,0
5677,434,376,593,911,57,15,10,159,535,53,133,0,0
5678,432,377,591,909,57,15,10,159,532,54,133,0,0
5679,438,381,599,919,57,15,10,161,538,55,133,0,0
5680,442,381,608,944,57,15,10,166,563,56,133,0,0
5681,443,387,610,956,57,15,10,167,569,57,133,0,0
5682,440,386,609,963,57,15,10,169,577,58,133,0,0
5683,435,389,605,967,57,15,10,170,578,59,133,0,0
5684,430,391,599,968,57,15,10,169,577,60,133,0,0
5685,427,394,595,969,57,15,10,168,575,61,133,0,0
5686,428,398,593,966,57,15,10,165,568,62,133,0,0
5687,430,400,595,965,57,15,10,165,565,63,133,0,0
5688,431,399,595,961,57,15,10,164,562,64,133,0,0
5689,433,400,596,958,57,15,10,163,558,65,133,0,0
5690,435,399,598,957,57,15,10,163,558,66,133,0,0
5691,434,397,600,963,57,15,10,166,566,67,133,0,0
5692,435,395,602,966,57,15,10,167,571,68,133,0,0
5693,436,395,603,966,57,15,10,167,571,69,133,0,0
5694,439,398,604,962,57,15,10,165,564,70,133,0,0
5695,440,398,603,960,57,15,10,163,562,71,133,0,0
5696,439,398,602,959,57,15,10,163,561,72,133,0,0
5697,440,397,602,959,57,15,10,162,562,73,133,0,0
5698,437,394,600,962,57,15,10,163,568,74,133,0,0
5699,436,393,600,963,57,15,10,164,570,75,133,0,0
5700,435,393,599,964,57,15,10,164,571,76,133,0,0
5701,437,393,601,964,57,15,10,164,571,77,133,0,0
5702,437,393,602,964,57,15,10,165,571,78,133,0,0
5703,437,393,602,965,57,15,10,165,572,79,133,0,0
5704,437,393,603,965,57,15,10,166,572,80,133,0,0
5705,437,393,604,966,57,15,10,167,573,81,133,0,0
5706,441,396,605,961,57,15,10,164,565,82,133,0,0
5707,442,397,605,959,57,15,10,163,562,83,133,0,0
5708,443,398,605,958,57,15,10,162,560,84,133,0,0
5709,443,399,605,958,57,15,10,162,559,85,133,0,0
5710,443,399,605,959,57,15,10,162,560,86,133,0,0
5711,443,399,604,959,57,15,10,161,560,87,133,0,0
5712,442,400,604,959,57,15,10,162,559,88,133,0,0
5713,442,400,604,959,57,15,10,162,559,89,133,0,0
5714,442,400,604,959,57,15,10,162,559,90,133,0,0
5715,441,400,603,959,57,15,10,162,559,91,133,0,0
5716,442,400,603,958,57,15,10,161,558,92,133,0,0
5717,442,400,603,958,57,15,10,161,558,93,133,0,0
5718,442,401,603,958,57,15,10,161,557,94,133,0,0
5719,442,401,604,958,57,15,10,162,557,95,133,0,0
5720,443,400,605,958,57,15,10,162,558,96,133,0,0
5721,443,401,604,958,57,15,10,161,557,97,133,0,0
5722,442,401,603,958,57,15,10,161,557,98,133,0,0
5723,440,403,601,956,57,15,10,161,553,99,133,0,0
5724,440,402,602,958,57,15,10,162,556,100,133,0,0
5725,441,402,603,958,57,15,10,162,556,101,133,0,0
5726,441,401,603,959,57,15,10,162,558,102,133,0,0
5727,441,399,603,959,57,15,10,162,560,103,133,0,0
5728,439,399,601,957,57,15,10,162,558,104,133,0,0
5729,440,398,604,958,57,15,10,164,560,105,133,0,0
5730,445,400,608,958,57,15,10,163,558,106,133,0,0
5731,452,395,616,959,57,15,10,164,564,107,133,0,0
5732,463,392,628,957,57,15,10,165,565,108,133,0,0
5733,487,383,646,929,57,15,10,159,546,109,133,0,0
5734,515,380,668,904,57,15,10,153,524,110,133,0,0
5735,539,376,689,883,57,15,10,150,507,111,133,0,0
5736,561,374,712,870,57,15,10,151,496,112,133,0,0
5737,602,369,747,843,57,15,10,145,474,113,133,0,0
5738,636,371,779,831,57,15,10,143,460,114,133,0,0
5739,662,373,808,829,57,15,10,146,456,115,133,0,0
5740,723,368,863,806,57,15,10,140,438,116,133,0,0
5741,762,373,904,804,57,15,10,142,431,117,133,0,0
5742,786,378,932,801,57,15,10,146,423,118,133,0,0
5743,825,382,971,795,57,15,10,146,413,119,133,0,0
5744,877,368,1020,784,57,15,10,143,416,120,133,0,0
5745,896,362,1035,781,57,15,10,139,419,121,133,0,0
5746,891,359,1013,718,57,15,10,122,359,122,133,0,0
5747,883,356,1004,698,57,15,10,121,342,123,133,0,0
5748,881,357,1002,691,57,15,10,121,334,124,133,0,0
5749,879,361,998,685,57,15,10,119,324,125,133,0,0
5750,879,362,1001,686,57,15,10,122,324,126,133,0,0
5751,877,357,1004,683,57,15,10,127,326,127,133,0,0
5752,880,353,1010,684,57,15,10,130,331,128,133,0,0
5753,921,356,1023,624,57,15,10,102,268,129,133,0,0
5754,941,357,1033,605,57,15,10,92,248,130,133,0,0
5755,950,354,1038,601,57,15,10,88,247,131,133,0,0
5756,960,350,1044,596,57,15,10,84,246,132,133,0,0
5757,972,349,1053,583,57,15,10,81,234,133,133,1,0
5628,1272,861,1466,1078,60,15,10,194,217,0,0,0,0
5630,1022,564,1216,944,61,15,10,194,380,0,116,0,1
5631,946,534,1206,1047,61,15,10,260,513,1,116,0,0
5632,870,517,1147,1069,61,15,10,277,552,2,116,0,0
5633,791,488,1086,1080,61,15,10,295,592,3,116,0,0
5634,733,466,1033,1080,61,15,10,300,614,4,116,0,0
5635,713,454,1015,1080,61,15,10,302,626,5,116,0,0
5636,702,430,1005,1069,61,15,10,303,639,6,116,0,0
5637,697,415,988,1036,61,15,10,291,621,7,116,0,0
5638,689,408,977,1020,61,15,10,288,612,8,116,0,0
5639,692,399,979,1009,61,15,10,287,610,9,116,0,0
5640,698,398,984,1005,61,15,10,286,607,10,116,0,0
5641,691,401,972,1003,61,15,10,281,602,11,116,0,0
5642,678,403,951,1000,61,15,10,273,597,12,116,0,0
5643,672,408,933,997,61,15,10,261,589,13,116,0,0
5644,670,409,923,995,61,15,10,253,586,14,116,0,0
5645,672,412,918,994,61,15,10,246,582,15,116,0,0
5646,676,411,919,997,61,15,10,243,586,16,116,0,0
5647,678,410,917,998,61,15,10,239,588,17,116,0,0
5648,682,414,916,998,61,15,10,234,584,18,116,0,0
5649,686,417,914,996,61,15,10,228,579,19,116,0,0
5650,688,413,914,997,61,15,10,226,584,20,116,0,0
5651,692,413,915,998,61,15,10,223,585,21,116,0,0
5652,695,412,916,998,61,15,10,221,586,22,116,0,0
5653,698,411,918,998,61,15,10,220,587,23,116,0,0
5654,701,411,919,999,61,15,10,218,588,24,116,0,0
5655,702,410,919,1000,61,15,10,217,590,25,116,0,0
5656,704,412,919,1000,61,15,10,215,588,26,116,0,0
5657,704,420,916,1001,61,15,10,212,581,27,116,0,0
5658,700,416,913,1003,61,15,10,213,587,28,116,0,0
5659,697,420,907,1000,61,15,10,210,580,29,116,0,0
5660,694,422,903,1002,61,15,10,209,580,30,116,0,0
5661,696,419,906,1005,61,15,10,210,586,31,116,0,0
5662,702,424,908,1002,61,15,10,206,578,32,116,0,0
5663,706,424,910,1000,61,15,10,204,576,33,116,0,0
5664,707,417,911,997,61,15,10,204,580,34,116,0,0
5665,706,417,911,999,61,15,10,205,582,35,116,0,0
5666,704,414,911,1000,61,15,10,207,586,36,116,0,0
5667,700,414,908,1000,61,15,10,208,586,37,116,0,0
5668,700,415,907,1000,61,15,10,207,585,38,116,0,0
5669,702,414,907,999,61,15,10,205,585,39,116,0,0
5670,702,415,906,999,61,15,10,204,584,40,116,0,0
5671,700,416,901,998,61,15,10,201,582,41,116,0,0
5672,698,415,901,998,61,15,10,203,583,42,116,0,0
5673,701,415,904,998,61,15,10,203,583,43,116,0,0
5674,705,417,907,999,61,15,10,202,582,44,116,0,0
5675,707,415,909,999,61,15,10,202,584,45,116,0,0
5676,708,417,910,999,61,15,10,202,582,46,116,0,0
5677,706,413,909,999,61,15,10,203,586,47,116,0,0
5678,704,410,908,1001,61,15,10,204,591,48,116,0,0
5679,706,410,909,1000,61,15,10,203,590,49,116,0,0
5680,706,410,910,1001,61,15,10,204,591,50,116,0,0
5681,707,410,911,1001,61,15,10,204,591,51,116,0,0
5682,707,413,910,1001,61,15,10,203,588,52,116,0,0
5683,708,415,910,1000,61,15,10,202,585,53,116,0,0
5684,708,416,908,1000,61,15,10,200,584,54,116,0,0
5685,708,416,908,999,61,15,10,200,583,55,116,0,0
5686,708,418,907,999,61,15,10,199,581,56,116,0,0
5687,708,420,907,999,61,15,10,199,579,57,116,0,0
5688,708,418,906,999,61,15,10,198,581,58,116,0,0
5689,710,414,909,999,61,15,10,199,585,59,116,0,0
5690,711,412,910,1000,61,15,10,199,588,60,116,0,0
5691,711,411,911,1000,61,15,10,200,589,61,116,0,0
5692,712,412,911,1000,61,15,10,199,588,62,116,0,0
5693,711,413,911,1001,61,15,10,200,588,63,116,0,0
5694,712,415,911,1000,61,15,10,199,585,64,116,0,0
5695,713,416,911,1001,61,15,10,198,585,65,116,0,0
5696,714,416,911,1000,61,15,10,197,584,66,116,0,0
5697,714,416,912,1000,61,15,10,198,584,67,116,0,0
5698,713,415,911,1000,61,15,10,198,585,68,116,0,0
5699,716,421,912,1001,61,15,10,196,580,69,116,0,0
5700,715,418,911,1000,61,15,10,196,582,70,116,0,0
5701,713,418,909,1000,61,15,10,196,582,71,116,0,0
5702,712,418,908,1000,61,15,10,196,582,72,116,0,0
5703,712,418,907,999,61,15,10,195,581,73,116,0,0
5704,713,418,908,998,61,15,10,195,580,74,116,0,0
5705,713,418,908,998,61,15,10,195,580,75,116,0,0
5706,715,422,908,997,61,15,10,193,575,76,116,0,0
5707,716,424,909,996,61,15,10,193,572,77,116,0,0
5708,716,425,909,995,61,15,10,193,570,78,116,0,0
5709,716,422,910,997,61,15,10,194,575,79,116,0,0
5710,717,425,910,996,61,15,10,193,571,80,116,0,0
5711,715,422,910,998,61,15,10,195,576,81,116,0,0
5712,715,421,910,998,61,15,10,195,577,82,116,0,0
5713,714,421,910,999,61,15,10,196,578,83,116,0,0
5714,714,421,910,999,61,15,10,196,578,84,116,0,0
5715,713,422,909,999,61,15,10,196,577,85,116,0,0
5716,717,422,913,997,61,15,10,196,575,86,116,0,0
5717,716,425,911,996,61,15,10,195,571,87,116,0,0
5718,716,423,912,997,61,15,10,196,574,88,116,0,0
5719,715,423,912,997,61,15,10,197,574,89,116,0,0
5720,715,422,912,997,61,15,10,197,575,90,116,0,0
5721,715,421,913,997,61,15,10,198,576,91,116,0,0
5722,715,421,913,997,61,15,10,198,576,92,116,0,0
5723,714,420,913,997,61,15,10,199,577,93,116,0,0
5724,714,420,913,998,61,15,10,199,578,94,116,0,0
5725,713,419,912,998,61,15,10,199,579,95,116,0,0
5726,714,420,913,998,61,15,10,199,578,96,116,0,0
5727,715,421,915,997,61,15,10,200,576,97,116,0,0
5728,723,420,921,987,61,15,10,198,567,98,116,0,0
5729,736,420,933,979,61,15,10,197,559,99,116,0,0
5730,747,418,940,971,61,15,10,193,553,100,116,0,0
5731,750,420,939,967,61,15,10,189,547,101,116,0,0
5732,751,408,932,932,61,15,10,181,524,102,116,0,0
5733,755,404,923,894,61,15,10,168,490,103,116,0,0
5734,763,403,926,874,61,15,10,163,471,104,116,0,0
5735,782,394,942,850,61,15,10,160,456,105,116,0,0
5736,814,385,967,819,61,15,10,153,434,106,116,0,0
5737,836,379,987,809,61,15,10,151,430,107,116,0,0
5738,856,379,1002,795,61,15,10,146,416,108,116,0,0
5739,876,369,1015,770,61,15,10,139,401,109,116,0,0
5740,888,365,1022,753,61,15,10,134,388,110,116,0,0
5741,911,366,1024,695,61,15,10,113,329,111,116,0,0
5742,929,363,1025,643,61,15,10,96,280,112,116,0,0
5743,943,369,1026,618,61,15,10,83,249,113,116,0,0
5744,958,367,1032,592,61,15,10,74,225,114,116,0,0
5745,948,364,1007,530,61,15,10,59,166,115,116,0,0
5746,959,362,1006,497,61,15,10,47,135,116,116,1,0
5749,946,393,1015,672,62,15,10,69,279,0,0,0,0
151,1717,627,1920,1076,1,15,11,203,449,0,1,0,0
152,1601,447,1886,1076,1,15,11,285,629,1,1,0,0
153,1371,380,1719,1066,2,15,11,348,686,0,0,0,0
154,1102,407,1511,1064,3,15,11,409,657,0,53,0,1
155,975,389,1400,1076,3,15,11,425,687,1,53,0,0
156,889,397,1305,1070,3,15,11,416,673,2,53,0,0
157,779,407,1191,1073,3,15,11,412,666,3,53,0,0
158,630,400,1046,1072,3,15,11,416,672,4,53,0,0
159,537,407,945,1057,3,15,11,408,650,5,53,0,0
160,468,408,867,1036,3,15,11,399,628,6,53,0,0
161,431,419,836,1051,3,15,11,405,632,7,53,0,0
162,413,406,822,1047,3,15,11,409,641,8,53,0,0
163,414,427,811,1039,3,15,11,397,612,9,53,0,0
164,412,437,813,1045,3,15,11,401,608,10,53,0,0
165,411,448,813,1045,3,15,11,402,597,11,53,0,0
166,404,451,810,1043,3,15,11,406,592,12,53,0,0
167,391,449,803,1044,3,15,11,412,595,13,53,0,0
168,382,442,799,1040,3,15,11,417,598,14,53,0,0
169,369,428,796,1035,3,15,11,427,607,15,53,0,0
170,359,421,793,1033,3,15,11,434,612,16,53,0,0
171,359,423,781,1014,3,15,11,422,591,17,53,0,0
172,365,431,780,1008,3,15,11,415,577,18,53,0,0
173,371,439,778,1001,3,15,11,407,562,19,53,0,0
174,374,443,783,1005,3,15,11,409,562,20,53,0,0
175,377,444,789,1008,3,15,11,412,564,21,53,0,0
176,376,443,787,1004,3,15,11,411,561,22,53,0,0
177,375,445,789,1007,3,15,11,414,562,23,53,0,0
178,369,442,788,1005,3,15,11,419,563,24,53,0,0
179,365,450,791,1015,3,15,11,426,565,25,53,0,0
180,361,460,785,1013,3,15,11,424,553,26,53,0,0
181,354,469,789,1029,3,15,11,435,560,27,53,0,0
182,352,474,794,1035,3,15,11,442,561,28,53,0,0
183,349,475,797,1037,3,15,11,448,562,29,53,0,0
184,344,472,800,1039,3,15,11,456,567,30,53,0,0
185,341,469,803,1039,3,15,11,462,570,31,53,0,0
186,339,470,806,1040,3,15,11,467,570,32,53,0,0
187,336,469,806,1040,3,15,11,470,571,33,53,0,0
188,335,469,807,1039,3,15,11,472,570,34,53,0,0
189,330,460,820,1050,3,15,11,490,590,35,53,0,0
190,332,460,817,1041,3,15,11,485,581,36,53,0,0
191,334,461,816,1035,3,15,11,482,574,37,53,0,0
192,336,464,822,1035,3,15,11,486,571,38,53,0,0
193,339,458,829,1034,3,15,11,490,576,39,53,0,0
194,342,454,834,1031,3,15,11,492,577,40,53,0,0
195,343,453,837,1032,3,15,11,494,579,41,53,0,0
196,340,454,834,1031,3,15,11,494,577,42,53,0,0
197,338,456,831,1030,3,15,11,493,574,43,53,0,0
198,338,461,830,1030,3,15,11,492,569,44,53,0,0
199,336,463,831,1033,3,15,11,495,570,45,53,0,0
200,335,468,827,1030,3,15,11,492,562,46,53,0,0
201,334,479,825,1035,3,15,11,491,556,47,53,0,0
202,339,489,823,1033,3,15,11,484,544,48,53,0,0
203,344,513,810,1029,3,15,11,466,516,49,53,0,0
204,356,547,795,1020,3,15,11,439,473,50,53,0,0
205,352,558,791,1021,3,15,11,439,463,51,53,0,0
206,353,572,785,1017,3,15,11,432,445,52,53,0,0
207,346,572,789,1018,3,15,11,443,446,53,53,1,0
219,398,425,1012,1046,3,15,11,614,621,0,53,0,0
220,476,415,1088,1047,3,15,11,612,632,1,53,0,0
221,550,404,1159,1054,3,15,11,609,650,2,53,0,0
222,618,386,1219,1059,3,15,11,601,673,3,53,0,0
223,746,391,1323,1063,3,15,11,577,672,4,53,0,0
224,889,382,1452,1066,3,15,11,563,684,5,53,0,0
225,1059,362,1621,1070,3,15,11,562,708,6,53,0,0
226,1210,373,1757,1068,3,15,11,547,695,7,53,0,0
227,1418,366,1920,1070,3,15,11,502,704,8,53,0,0
228,1525,401,1920,1074,3,15,11,395,673,9,53,0,0
229,1598,397,1920,1077,3,15,11,322,680,10,53,0,0
430,1748,878,1920,1075,4,15,11,172,197,0,46,0,1
431,1653,698,1920,1075,4,15,11,267,377,1,46,0,0
432,1558,473,1920,1074,4,15,11,362,601,2,46,0,0
433,1502,358,1920,1069,4,15,11,418,711,3,46,0,0
434,1430,299,1920,1068,4,15,11,490,769,4,46,0,0
435,1383,283,1920,1071,4,15,11,537,788,5,46,0,0
436,1333,271,1920,1071,4,15,11,587,800,6,46,0,0
437,1272,271,1869,1070,4,15,11,597,799,7,46,0,0
438,1210,278,1784,1073,4,15,11,574,795,8,46,0,0
439,1166,289,1715,1074,4,15,11,549,785,9,46,0,0
440,1105,304,1625,1072,4,15,11,520,768,10,46,0,0
441,1053,318,1547,1072,4,15,11,494,754,11,46,0,0
442,1011,331,1482,1072,4,15,11,471,741,12,46,0,0
443,970,322,1434,1069,4,15,11,464,747,13,46,0,0
444,932,333,1381,1066,4,15,11,449,733,14,46,0,0
445,876,347,1271,1013,4,15,11,395,666,15,46,0,0
446,846,366,1244,1042,4,15,11,398,676,16,46,0,0
447,802,377,1200,1051,4,15,11,398,674,17,46,0,0
448,742,388,1138,1064,4,15,11,396,676,18,46,0,0
449,687,404,1074,1070,4,15,11,387,666,19,46,0,0
450,655,418,1031,1063,4,15,11,376,645,20,46,0,0
451,632,421,1013,1067,4,15,11,381,646,21,46,0,0
452,605,410,992,1062,4,15,11,387,652,22,46,0,0
453,571,397,964,1067,4,15,11,393,670,23,46,0,0
454,558,390,952,1071,4,15,11,394,681,24,46,0,0
455,559,390,944,1066,4,15,11,385,676,25,46,0,0
456,553,388,937,1066,4,15,11,384,678,26,46,0,0
457,552,381,936,1067,4,15,11,384,686,27,46,0,0
458,558,377,939,1069,4,15,11,381,692,28,46,0,0
459,556,375,930,1070,4,15,11,374,695,29,46,0,0
460,584,383,951,1069,4,15,11,367,686,30,46,0,0
461,610,398,972,1068,4,15,11,362,670,31,46,0,0
462,619,409,979,1067,4,15,11,360,658,32,46,0,0
463,625,431,981,1069,4,15,11,356,638,33,46,0,0
464,614,453,964,1066,4,15,11,350,613,34,46,0,0
465,576,468,918,1062,4,15,11,342,594,35,46,0,0
466,558,484,899,1062,4,15,11,341,578,36,46,0,0
467,512,504,848,1064,4,15,11,336,560,37,46,0,0
468,483,534,809,1065,4,15,11,326,531,38,46,0,0
469,472,570,787,1064,4,15,11,315,494,39,46,0,0
470,452,606,757,1064,4,15,11,305,458,40,46,0,0
471,429,655,718,1063,4,15,11,289,408,41,46,0,0
472,396,703,668,1057,4,15,11,272,354,42,46,0,0
473,342,751,600,1065,4,15,11,258,314,43,46,0,0
474,259,784,510,1072,4,15,11,251,288,44,46,0,0
475,203,813,439,1070,4,15,11,236,257,45,46,0,0
476,170,844,379,1071,4,15,11,209,227,46,46,1,0
504,345,509,894,1063,5,15,11,549,554,0,180,0,1
505,350,503,891,1059,5,15,11,541,556,1,180,0,0
506,354,504,883,1059,5,15,11,529,555,2,180,0,0
507,355,508,872,1059,5,15,11,517,551,3,180,0,0
508,355,508,867,1062,5,15,11,512,554,4,180,0,0
509,361,513,862,1060,5,15,11,501,547,5,180,0,0
510,366,513,863,1060,5,15,11,497,547,6,180,0,0
511,371,512,866,1061,5,15,11,495,549,7,180,0,0
512,373,512,865,1063,5,15,11,492,551,8,180,0,0
513,369,500,861,1057,5,15,11,492,557,9,180,0,0
514,369,507,855,1062,5,15,11,486,555,10,180,0,0
515,372,507,856,1063,5,15,11,484,556,11,180,0,0
516,376,499,863,1063,5,15,11,487,564,12,180,0,0
517,381,488,870,1061,5,15,11,489,573,13,180,0,0
518,387,477,879,1063,5,15,11,492,586,14,180,0,0
519,394,465,890,1066,5,15,11,496,601,15,180,0,0
520,407,462,897,1063,5,15,11,490,601,16,180,0,0
521,412,455,896,1055,5,15,11,484,600,17,180,0,0
522,415,448,898,1053,5,15,11,483,605,18,180,0,0
523,411,451,886,1054,5,15,11,475,603,19,180,0,0
524,409,447,883,1058,5,15,11,474,611,20,180,0,0
525,417,454,882,1058,5,15,11,465,604,21,180,0,0
526,428,454,889,1058,5,15,11,461,604,22,180,0,0
527,431,422,907,1056,5,15,11,476,634,23,180,0,0
528,445,439,910,1061,5,15,11,465,622,24,180,0,0
529,439,431,906,1059,5,15,11,467,628,25,180,0,0
530,446,450,896,1057,5,15,11,450,607,26,180,0,0
531,435,457,879,1058,5,15,11,444,601,27,180,0,0
532,423,454,866,1058,5,15,11,443,604,28,180,0,0
533,417,453,861,1057,5,15,11,444,604,29,180,0,0
534,438,454,881,1058,5,15,11,443,604,30,180,0,0
535,442,429,903,1062,5,15,11,461,633,31,180,0,0
536,452,439,907,1065,5,15,11,455,626,32,180,0,0
537,465,440,923,1067,5,15,11,458,627,33,180,0,0
538,471,414,940,1060,5,15,11,469,646,34,180,0,0
539,486,417,955,1065,5,15,11,469,648,35,180,0,0
540,498,410,970,1069,5,15,11,472,659,36,180,0,0
541,521,408,987,1068,5,15,11,466,660,37,180,0,0
542,546,404,1004,1064,5,15,11,458,660,38,180,0,0
543,560,396,1018,1068,5,15,11,458,672,39,180,0,0
544,567,388,1022,1068,5,15,11,455,680,40,180,0,0
545,575,376,1023,1061,5,15,11,448,685,41,180,0,0
546,584,368,1019,1048,5,15,11,435,680,42,180,0,0
547,590,361,1020,1046,5,15,11,430,685,43,180,0,0
548,607,358,1024,1042,5,15,11,417,684,44,180,0,0
549,616,358,1027,1048,5,15,11,411,690,45,180,0,0
550,621,369,1019,1045,5,15,11,398,676,46,180,0,0
551,618,385,1008,1046,5,15,11,390,661,47,180,0,0
552,619,406,1001,1045,5,15,11,382,639,48,180,0,0
553,618,420,998,1050,5,15,11,380,630,49,180,0,0
554,616,431,997,1059,5,15,11,381,628,50,180,0,0
555,622,438,999,1059,5,15,11,377,621,51,180,0,0
556,626,452,1001,1063,5,15,11,375,611,52,180,0,0
557,632,462,1007,1066,5,15,11,375,604,53,180,0,0
558,634,474,1005,1063,5,15,11,371,589,54,180,0,0
559,620,472,994,1060,5,15,11,374,588,55,180,0,0
560,598,473,974,1057,5,15,11,376,584,56,180,0,0
561,559,480,942,1058,5,15,11,383,578,57,180,0,0
562,522,484,906,1057,5,15,11,384,573,58,180,0,0
563,483,486,838,1014,5,15,11,355,528,59,180,0,0
564,451,495,823,1042,5,15,11,372,547,60,180,0,0
565,441,509,815,1049,5,15,11,374,540,61,180,0,0
566,412,515,792,1053,5,15,11,380,538,62,180,0,0
567,380,542,754,1060,5,15,11,374,518,63,180,0,0
568,349,561,716,1061,5,15,11,367,500,64,180,0,0
569,326,567,696,1064,5,15,11,370,497,65,180,0,0
570,321,582,687,1061,5,15,11,366,479,66,180,0,0
571,322,590,693,1061,5,15,11,371,471,67,180,0,0
572,320,588,705,1064,5,15,11,385,476,68,180,0,0
573,323,582,721,1067,5,15,11,398,485,69,180,0,0
574,326,568,737,1066,5,15,11,411,498,70,180,0,0
575,335,558,753,1063,5,15,11,418,505,71,180,0,0
576,345,544,777,1064,5,15,11,432,520,72,180,0,0
577,347,520,795,1060,5,15,11,448,540,73,180,0,0
578,355,507,813,1060,5,15,11,458,553,74,180,0,0
579,361,505,820,1061,5,15,11,459,556,75,180,0,0
580,361,508,814,1060,5,15,11,453,552,76,180,0,0
581,360,509,814,1064,5,15,11,454,555,77,180,0,0
582,342,444,829,1047,5,15,11,487,603,78,180,0,0
583,354,485,815,1058,5,15,11,461,573,79,180,0,0
584,357,499,802,1055,5,15,11,445,556,80,180,0,0
585,359,506,803,1062,5,15,11,444,556,81,180,0,0
586,363,511,804,1064,5,15,11,441,553,82,180,0,0
587,359,502,800,1056,5,15,11,441,554,83,180,0,0
588,364,510,801,1062,5,15,11,437,552,84,180,0,0
589,368,513,802,1063,5,15,11,434,550,85,180,0,0
590,358,490,799,1051,5,15,11,441,561,86,180,0,0
591,362,509,793,1057,5,15,11,431,548,87,180,0,0
592,370,519,798,1066,5,15,11,428,547,88,180,0,0
593,369,523,791,1062,5,15,11,422,539,89,180,0,0
594,367,525,787,1060,5,15,11,420,535,90,180,0,0
595,365,522,788,1060,5,15,11,423,538,91,180,0,0
596,365,521,791,1061,5,15,11,426,540,92,180,0,0
597,367,521,794,1061,5,15,11,427,540,93,180,0,0
598,365,518,795,1062,5,15,11,430,544,94,180,0,0
599,365,520,793,1062,5,15,11,428,542,95,180,0,0
600,366,520,795,1062,5,15,11,429,542,96,180,0,0
601,362,508,793,1055,5,15,11,431,547,97,180,0,0
602,367,516,798,1064,5,15,11,431,548,98,180,0,0
603,368,514,801,1065,5,15,11,433,551,99,180,0,0
604,368,518,796,1059,5,15,11,428,541,100,180,0,0
605,366,520,796,1062,5,15,11,430,542,101,180,0,0
606,373,525,804,1059,5,15,11,431,534,102,180,0,0
607,369,525,805,1061,5,15,11,436,536,103,180,0,0
608,363,508,806,1053,5,15,11,443,545,104,180,0,0
609,357,514,802,1061,5,15,11,445,547,105,180,0,0
610,351,523,794,1066,5,15,11,443,543,106,180,0,0
611,346,527,784,1068,5,15,11,438,541,107,180,0,0
612,347,532,779,1065,5,15,11,432,533,108,180,0,0
613,349,517,784,1057,5,15,11,435,540,109,180,0,0
614,351,528,782,1062,5,15,11,431,534,110,180,0,0
615,348,531,777,1064,5,15,11,429,533,111,180,0,0
616,345,534,772,1067,5,15,11,427,533,112,180,0,0
617,341,536,766,1068,5,15,11,425,532,113,180,0,0
618,337,534,761,1068,5,15,11,424,534,114,180,0,0
619,336,535,760,1070,5,15,11,424,535,115,180,0,0
620,344,540,764,1070,5,15,11,420,530,116,180,0,0
621,356,545,770,1064,5,15,11,414,519,117,180,0,0
622,369,535,796,1067,5,15,11,427,532,118,180,0,0
623,387,529,820,1065,5,15,11,433,536,119,180,0,0
624,400,528,838,1064,5,15,11,438,536,120,180,0,0
625,420,529,858,1064,5,15,11,438,535,121,180,0,0
626,436,531,871,1060,5,15,11,435,529,122,180,0,0
627,448,533,879,1056,5,15,11,431,523,123,180,0,0
628,456,531,888,1056,5,15,11,432,525,124,180,0,0
629,468,525,905,1057,5,15,11,437,532,125,180,0,0
630,452,466,930,1053,5,15,11,478,587,126,180,0,0
631,474,475,933,1040,5,15,11,459,565,127,180,0,0
632,445,434,933,1044,5,15,11,488,610,128,180,0,0
633,450,423,948,1054,5,15,11,498,631,129,180,0,0
634,481,432,962,1051,5,15,11,481,619,130,180,0,0
635,503,427,974,1046,5,15,11,471,619,131,180,0,0
636,527,411,1009,1056,5,15,11,482,645,132,180,0,0
637,544,408,1021,1065,5,15,11,477,657,133,180,0,0
638,573,418,1033,1067,5,15,11,460,649,134,180,0,0
639,604,416,1060,1070,5,15,11,456,654,135,180,0,0
640,633,405,1087,1064,5,15,11,454,659,136,180,0,0
641,652,396,1104,1068,5,15,11,452,672,137,180,0,0
642,672,389,1116,1067,5,15,11,444,678,138,180,0,0
643,690,376,1127,1060,5,15,11,437,684,139,180,0,0
644,698,369,1133,1064,5,15,11,435,695,140,180,0,0
645,702,370,1127,1062,5,15,11,425,692,141,180,0,0
646,697,373,1119,1065,5,15,11,422,692,142,180,0,0
647,682,395,1091,1063,5,15,11,409,668,143,180,0,0
648,659,410,1060,1054,5,15,11,401,644,144,180,0,0
649,624,425,1019,1056,5,15,11,395,631,145,180,0,0
650,580,445,966,1062,5,15,11,386,617,146,180,0,0
651,556,473,929,1065,5,15,11,373,592,147,180,0,0
652,537,492,904,1066,5,15,11,367,574,148,180,0,0
653,518,509,877,1060,5,15,11,359,551,149,180,0,0
654,487,533,839,1065,5,15,11,352,532,150,180,0,0
655,467,554,813,1069,5,15,11,346,515,151,180,0,0
656,436,560,782,1066,5,15,11,346,506,152,180,0,0
657,419,559,762,1049,5,15,11,343,490,153,180,0,0
658,395,562,750,1057,5,15,11,355,495,154,180,0,0
659,378,564,743,1059,5,15,11,365,495,155,180,0,0
660,371,578,736,1061,5,15,11,365,483,156,180,0,0
661,362,587,735,1057,5,15,11,373,470,157,180,0,0
662,323,601,701,1065,5,15,11,378,464,158,180,0,0
663,297,620,667,1061,5,15,11,370,441,159,180,0,0
664,284,634,654,1059,5,15,11,370,425,160,180,0,0
665,242,629,629,1065,5,15,11,387,436,161,180,0,0
666,249,639,631,1057,5,15,11,382,418,162,180,0,0
667,257,636,648,1055,5,15,11,391,419,163,180,0,0
668,244,631,655,1067,5,15,11,411,436,164,180,0,0
669,252,617,682,1070,5,15,11,430,453,165,180,0,0
670,280,608,717,1064,5,15,11,437,456,166,180,0,0
671,294,588,745,1062,5,15,11,451,474,167,180,0,0
672,310,581,761,1057,5,15,11,451,476,168,180,0,0
673,321,572,782,1062,5,15,11,461,490,169,180,0,0
674,324,566,791,1066,5,15,11,467,500,170,180,0,0
675,329,559,800,1069,5,15,11,471,510,171,180,0,0
676,329,562,794,1064,5,15,11,465,502,172,180,0,0
677,333,561,795,1059,5,15,11,462,498,173,180,0,0
678,332,562,797,1064,5,15,11,465,502,174,180,0,0
679,338,571,794,1062,5,15,11,456,491,175,180,0,0
680,339,582,789,1065,5,15,11,450,483,176,180,0,0
681,349,603,782,1063,5,15,11,433,460,177,180,0,0
682,350,619,772,1064,5,15,11,422,445,178,180,0,0
683,352,640,757,1061,5,15,11,405,421,179,180,0,0
684,353,659,746,1061,5,15,11,393,402,180,180,1,0
719,343,612,797,1067,5,15,11,454,455,0,180,0,0
720,345,608,800,1067,5,15,11,455,459,1,180,0,0
721,347,605,802,1067,5,15,11,455,462,2,180,0,0
722,350,607,801,1067,5,15,11,451,460,3,180,0,0
723,351,608,800,1067,5,15,11,449,459,4,180,0,0
724,352,609,798,1067,5,15,11,446,458,5,180,0,0
725,350,608,795,1067,5,15,11,445,459,6,180,0,0
726,353,613,795,1067,5,15,11,442,454,7,180,0,0
727,350,608,794,1066,5,15,11,444,458,8,180,0,0
728,352,611,793,1066,5,15,11,441,455,9,180,0,0
729,352,619,788,1064,5,15,11,436,445,10,180,0,0
730,348,622,784,1064,5,15,11,436,442,11,180,0,0
731,344,617,788,1063,5,15,11,444,446,12,180,0,0
732,336,613,783,1064,5,15,11,447,451,13,180,0,0
733,330,612,779,1066,5,15,11,449,454,14,180,0,0
734,336,615,784,1066,5,15,11,448,451,15,180,0,0
739,346,618,790,1065,5,15,11,444,447,0,180,0,0
740,347,622,790,1066,5,15,11,443,444,1,180,0,0
744,347,613,799,1066,5,15,11,452,453,0,180,0,0
745,351,614,799,1063,5,15,11,448,449,1,180,0,0
747,350,610,800,1062,5,15,11,450,452,0,180,0,0
748,350,610,801,1062,5,15,11,451,452,1,180,0,0
749,351,608,802,1061,5,15,11,451,453,2,180,0,0
750,352,607,803,1061,5,15,11,451,454,3,180,0,0
751,354,603,808,1060,5,15,11,454,457,4,180,0,0
752,352,600,810,1061,5,15,11,458,461,5,180,0,0
753,352,604,805,1061,5,15,11,453,457,6,180,0,0
754,355,608,802,1061,5,15,11,447,453,7,180,0,0
755,356,609,800,1060,5,15,11,444,451,8,180,0,0
756,360,609,803,1061,5,15,11,443,452,9,180,0,0
757,360,606,810,1065,5,15,11,450,459,10,180,0,0
758,356,579,827,1060,5,15,11,471,481,11,180,0,0
759,360,584,824,1056,5,15,11,464,472,12,180,0,0
760,356,602,814,1063,5,15,11,458,461,13,180,0,0
765,336,592,806,1064,5,15,11,470,472,0,180,0,0
766,330,601,789,1061,5,15,11,459,460,1,180,0,0
767,316,597,781,1063,5,15,11,465,466,2,180,0,0
769,238,424,853,1056,5,15,11,615,632,0,180,0,1
770,234,540,726,1056,5,15,11,492,516,1,180,0,0
771,233,614,640,1047,5,15,11,407,433,2,180,0,0
772,225,648,591,1044,5,15,11,366,396,3,180,0,0
773,214,650,576,1042,5,15,11,362,392,4,180,0,0
774,213,646,586,1057,5,15,11,373,411,5,180,0,0
775,226,663,563,1035,5,15,11,337,372,6,180,0,0
776,219,667,551,1033,5,15,11,332,366,7,180,0,0
777,233,666,581,1052,5,15,11,348,386,8,180,0,0
778,228,669,574,1052,5,15,11,346,383,9,180,0,0
779,227,661,590,1063,5,15,11,363,402,10,180,0,0
780,215,673,568,1058,5,15,11,353,385,11,180,0,0
781,216,679,563,1055,5,15,11,347,376,12,180,0,0
782,220,683,555,1043,5,15,11,335,360,13,180,0,0
783,213,673,572,1054,5,15,11,359,381,14,180,0,0
784,219,673,578,1053,5,15,11,359,380,15,180,0,0
785,213,670,579,1057,5,15,11,366,387,16,180,0,0
786,222,669,601,1067,5,15,11,379,398,17,180,0,0
787,228,681,596,1065,5,15,11,368,384,18,180,0,0
788,222,681,594,1068,5,15,11,372,387,19,180,0,0
789,218,681,594,1069,5,15,11,376,388,20,180,0,0
790,212,688,586,1069,5,15,11,374,381,21,180,0,0
791,207,687,572,1060,5,15,11,365,373,22,180,0,0
792,181,681,554,1066,5,15,11,373,385,23,180,0,0
793,176,682,549,1067,5,15,11,373,385,24,180,0,0
819,219,632,650,1067,5,15,11,431,435,0,180,0,1
820,216,643,632,1069,5,15,11,416,426,1,180,0,0
821,210,646,618,1073,5,15,11,408,427,2,180,0,0
822,215,665,598,1068,5,15,11,383,403,3,180,0,0
823,215,662,602,1069,5,15,11,387,407,4,180,0,0
824,203,651,598,1073,5,15,11,395,422,5,180,0,0
825,199,660,576,1069,5,15,11,377,409,6,180,0,0
826,215,668,580,1065,5,15,11,365,397,7,180,0,0
827,220,671,581,1063,5,15,11,361,392,8,180,0,0
828,215,674,576,1070,5,15,11,361,396,9,180,0,0
829,213,673,575,1071,5,15,11,362,398,10,180,0,0
830,217,677,575,1069,5,15,11,358,392,11,180,0,0
831,232,664,602,1067,5,15,11,370,403,12,180,0,0
832,237,670,607,1069,5,15,11,370,399,13,180,0,0
833,243,668,619,1066,5,15,11,376,398,14,180,0,0
834,265,677,639,1068,5,15,11,374,391,15,180,0,0
835,290,680,658,1066,5,15,11,368,386,16,180,0,0
836,306,678,671,1064,5,15,11,365,386,17,180,0,0
837,344,686,705,1063,5,15,11,361,377,18,180,0,0
838,358,687,714,1063,5,15,11,356,376,19,180,0,0
839,398,671,766,1063,5,15,11,368,392,20,180,0,0
840,423,646,810,1068,5,15,11,387,422,21,180,0,0
841,440,622,839,1068,5,15,11,399,446,22,180,0,0
842,465,617,864,1070,5,15,11,399,453,23,180,0,0
843,479,614,873,1068,5,15,11,394,454,24,180,0,0
844,486,613,881,1070,5,15,11,395,457,25,180,0,0
845,490,612,883,1069,5,15,11,393,457,26,180,0,0
846,496,610,886,1067,5,15,11,390,457,27,180,0,0
847,502,602,894,1065,5,15,11,392,463,28,180,0,0
848,514,595,915,1066,5,15,11,401,471,29,180,0,0
849,521,586,926,1065,5,15,11,405,479,30,180,0,0
850,534,577,942,1065,5,15,11,408,488,31,180,0,0
851,544,575,953,1067,5,15,11,409,492,32,180,0,0
852,549,573,958,1067,5,15,11,409,494,33,180,0,0
853,546,577,951,1067,5,15,11,405,490,34,180,0,0
854,525,585,924,1067,5,15,11,399,482,35,180,0,0
855,479,606,865,1067,5,15,11,386,461,36,180,0,0
856,430,625,806,1068,5,15,11,376,443,37,180,0,0
857,390,629,765,1069,5,15,11,375,440,38,180,0,0
858,362,637,732,1067,5,15,11,370,430,39,180,0,0
859,341,634,716,1068,5,15,11,375,434,40,180,0,0
860,338,629,717,1068,5,15,11,379,439,41,180,0,0
861,323,606,723,1065,5,15,11,400,459,42,180,0,0
862,320,582,741,1064,5,15,11,421,482,43,180,0,0
863,317,574,744,1062,5,15,11,427,488,44,180,0,0
864,309,564,746,1067,5,15,11,437,503,45,180,0,0
865,309,558,749,1068,5,15,11,440,510,46,180,0,0
866,310,554,751,1070,5,15,11,441,516,47,180,0,0
867,233,338,834,1065,5,15,11,601,727,48,180,0,0
868,279,452,784,1068,5,15,11,505,616,49,180,0,0
869,304,518,752,1069,5,15,11,448,551,50,180,0,0
870,318,556,729,1062,5,15,11,411,506,51,180,0,0
871,328,574,722,1056,5,15,11,394,482,52,180,0,0
872,331,582,718,1051,5,15,11,387,469,53,180,0,0
873,337,586,725,1053,5,15,11,388,467,54,180,0,0
874,337,586,728,1053,5,15,11,391,467,55,180,0,0
875,336,584,730,1052,5,15,11,394,468,56,180,0,0
876,341,582,739,1051,5,15,11,398,469,57,180,0,0
877,339,579,742,1052,5,15,11,403,473,58,180,0,0
878,339,580,745,1051,5,15,11,406,471,59,180,0,0
879,336,581,745,1053,5,15,11,409,472,60,180,0,0
880,316,578,730,1060,5,15,11,414,482,61,180,0,0
881,303,588,701,1053,5,15,11,398,465,62,180,0,0
882,294,607,686,1057,5,15,11,392,450,63,180,0,0
883,245,530,706,1064,5,15,11,461,534,64,180,0,0
884,229,619,605,1047,5,15,11,376,428,65,180,0,0
885,213,672,562,1064,5,15,11,349,392,66,180,0,0
886,205,688,550,1067,5,15,11,345,379,67,180,0,0
887,187,702,514,1049,5,15,11,327,347,68,180,0,0
888,191,717,520,1056,5,15,11,329,339,69,180,0,0
889,200,717,549,1069,5,15,11,349,352,70,180,0,0
892,251,696,620,1067,5,15,11,369,371,0,180,0,0
893,274,693,644,1067,5,15,11,370,374,1,180,0,0
894,293,694,662,1067,5,15,11,369,373,2,180,0,0
895,304,692,676,1067,5,15,11,372,375,3,180,0,0
896,293,673,680,1064,5,15,11,387,391,4,180,0,0
897,286,660,682,1057,5,15,11,396,397,5,180,0,0
898,279,653,675,1051,5,15,11,396,398,6,180,0,0
906,307,559,769,1025,5,15,11,462,466,0,180,0,1
907,318,555,804,1049,5,15,11,486,494,1,180,0,0
908,320,545,825,1062,5,15,11,505,517,2,180,0,0
909,323,546,829,1068,5,15,11,506,522,3,180,0,0
910,328,549,831,1074,5,15,11,503,525,4,180,0,0
911,333,550,828,1072,5,15,11,495,522,5,180,0,0
912,336,548,829,1071,5,15,11,493,523,6,180,0,0
913,338,549,829,1073,5,15,11,491,524,7,180,0,0
914,346,550,833,1070,5,15,11,487,520,8,180,0,0
915,347,550,833,1070,5,15,11,486,520,9,180,0,0
916,351,551,831,1069,5,15,11,480,518,10,180,0,0
917,343,544,823,1066,5,15,11,480,522,11,180,0,0
918,340,537,826,1068,5,15,11,486,531,12,180,0,0
919,346,535,831,1069,5,15,11,485,534,13,180,0,0
920,349,537,829,1067,5,15,11,480,530,14,180,0,0
921,348,540,823,1065,5,15,11,475,525,15,180,0,0
922,352,542,823,1065,5,15,11,471,523,16,180,0,0
923,352,540,822,1063,5,15,11,470,523,17,180,0,0
924,359,544,824,1060,5,15,11,465,516,18,180,0,0
925,359,546,824,1063,5,15,11,465,517,19,180,0,0
926,361,550,823,1061,5,15,11,462,511,20,180,0,0
927,357,552,820,1061,5,15,11,463,509,21,180,0,0
928,352,552,818,1062,5,15,11,466,510,22,180,0,0
929,350,552,818,1062,5,15,11,468,510,23,180,0,0
930,353,552,823,1062,5,15,11,470,510,24,180,0,0
931,354,552,829,1063,5,15,11,475,511,25,180,0,0
932,352,548,833,1063,5,15,11,481,515,26,180,0,0
933,353,548,834,1063,5,15,11,481,515,27,180,0,0
934,349,551,829,1067,5,15,11,480,516,28,180,0,0
935,348,552,826,1063,5,15,11,478,511,29,180,0,0
936,346,550,826,1063,5,15,11,480,513,30,180,0,0
937,347,550,826,1063,5,15,11,479,513,31,180,0,0
938,346,550,826,1062,5,15,11,480,512,32,180,0,0
939,345,550,826,1062,5,15,11,481,512,33,180,0,0
940,347,548,828,1062,5,15,11,481,514,34,180,0,0
941,350,550,829,1061,5,15,11,479,511,35,180,0,0
942,351,550,830,1061,5,15,11,479,511,36,180,0,0
943,350,551,829,1061,5,15,11,479,510,37,180,0,0
944,351,553,828,1061,5,15,11,477,508,38,180,0,0
945,353,553,830,1062,5,15,11,477,509,39,180,0,0
946,353,554,830,1063,5,15,11,477,509,40,180,0,0
947,352,556,828,1064,5,15,11,476,508,41,180,0,0
948,353,556,828,1064,5,15,11,475,508,42,180,0,0
949,354,557,829,1065,5,15,11,475,508,43,180,0,0
950,354,557,828,1065,5,15,11,474,508,44,180,0,0
951,354,557,827,1065,5,15,11,473,508,45,180,0,0
952,354,557,827,1065,5,15,11,473,508,46,180,0,0
953,353,555,825,1064,5,15,11,472,509,47,180,0,0
954,350,550,826,1063,5,15,11,476,513,48,180,0,0
955,351,551,825,1063,5,15,11,474,512,49,180,0,0
956,353,549,829,1063,5,15,11,476,514,50,180,0,0
957,355,550,829,1063,5,15,11,474,513,51,180,0,0
958,356,548,832,1063,5,15,11,476,515,52,180,0,0
959,355,548,833,1063,5,15,11,478,515,53,180,0,0
960,354,547,832,1063,5,15,11,478,516,54,180,0,0
961,351,548,829,1064,5,15,11,478,516,55,180,0,0
962,352,549,830,1064,5,15,11,478,515,56,180,0,0
963,352,549,829,1064,5,15,11,477,515,57,180,0,0
964,351,549,828,1064,5,15,11,477,515,58,180,0,0
965,353,551,829,1064,5,15,11,476,513,59,180,0,0
966,353,552,828,1064,5,15,11,475,512,60,180,0,0
967,354,553,829,1064,5,15,11,475,511,61,180,0,0
968,355,553,829,1064,5,15,11,474,511,62,180,0,0
969,354,554,829,1064,5,15,11,475,510,63,180,0,0
970,354,555,828,1063,5,15,11,474,508,64,180,0,0
971,352,552,829,1063,5,15,11,477,511,65,180,0,0
972,352,551,830,1063,5,15,11,478,512,66,180,0,0
973,353,551,831,1063,5,15,11,478,512,67,180,0,0
974,353,551,831,1063,5,15,11,478,512,68,180,0,0
975,354,551,831,1062,5,15,11,477,511,69,180,0,0
976,352,553,828,1061,5,15,11,476,508,70,180,0,0
977,351,553,827,1061,5,15,11,476,508,71,180,0,0
978,351,554,827,1061,5,15,11,476,507,72,180,0,0
979,351,554,828,1061,5,15,11,477,507,73,180,0,0
980,353,553,830,1061,5,15,11,477,508,74,180,0,0
981,345,553,825,1067,5,15,11,480,514,75,180,0,0
982,349,552,829,1064,5,15,11,480,512,76,180,0,0
983,345,553,823,1067,5,15,11,478,514,77,180,0,0
984,348,551,825,1064,5,15,11,477,513,78,180,0,0
985,347,553,821,1066,5,15,11,474,513,79,180,0,0
986,349,550,825,1063,5,15,11,476,513,80,180,0,0
987,352,550,827,1064,5,15,11,475,514,81,180,0,0
988,356,550,830,1064,5,15,11,474,514,82,180,0,0
989,356,550,830,1064,5,15,11,474,514,83,180,0,0
990,358,551,829,1062,5,15,11,471,511,84,180,0,0
991,357,551,829,1062,5,15,11,472,511,85,180,0,0
992,357,550,828,1062,5,15,11,471,512,86,180,0,0
993,358,551,828,1063,5,15,11,470,512,87,180,0,0
994,359,551,829,1063,5,15,11,470,512,88,180,0,0
995,358,549,829,1063,5,15,11,471,514,89,180,0,0
996,360,550,829,1063,5,15,11,469,513,90,180,0,0
997,362,550,831,1061,5,15,11,469,511,91,180,0,0
998,363,554,825,1057,5,15,11,462,503,92,180,0,0
999,356,567,808,1060,5,15,11,452,493,93,180,0,0
1000,254,323,893,1042,5,15,11,639,719,94,180,0,0
1001,297,466,825,1050,5,15,11,528,584,95,180,0,0
1002,164,280,847,1049,5,15,11,683,769,96,180,0,0
1003,144,251,852,1047,5,15,11,708,796,97,180,0,0
1006,152,245,836,1037,5,15,11,684,792,0,180,0,0
1007,136,221,839,1035,5,15,11,703,814,1,180,0,0
1011,120,157,864,1045,5,15,11,744,888,0,180,0,0
1012,107,135,869,1045,5,15,11,762,910,1,180,0,0
1015,91,167,826,1055,5,15,11,735,888,0,180,0,0
1016,80,153,827,1055,5,15,11,747,902,1,180,0,0
1029,261,429,789,1058,5,15,11,528,629,0,180,0,0
1030,270,443,786,1058,5,15,11,516,615,1,180,0,0
1031,246,364,819,1058,5,15,11,573,694,2,180,0,0
1032,212,297,815,1053,5,15,11,603,756,3,180,0,0
1033,210,263,826,1055,5,15,11,616,792,4,180,0,0
1034,205,249,831,1055,5,15,11,626,806,5,180,0,0
1035,150,189,806,1051,5,15,11,656,862,6,180,0,0
1036,210,289,785,1045,5,15,11,575,756,7,180,0,0
1037,207,283,786,1044,5,15,11,579,761,8,180,0,0
1051,169,257,762,1042,5,15,11,593,785,0,180,0,0
1052,166,255,761,1042,5,15,11,595,787,1,180,0,0
1053,195,257,778,1053,5,15,11,583,796,2,180,0,0
1054,254,426,737,1065,5,15,11,483,639,3,180,0,0
1055,261,443,732,1067,5,15,11,471,624,4,180,0,0
786,123,252,711,1031,6,15,11,588,779,0,0,0,0
804,114,205,814,1028,8,15,11,700,823,0,0,0,0
807,88,209,769,1025,9,15,11,681,816,0,6,0,0
808,103,204,796,1035,9,15,11,693,831,1,6,0,0
809,91,212,777,1035,9,15,11,686,823,2,6,0,0
810,89,211,775,1033,9,15,11,686,822,3,6,0,0
811,52,151,780,1030,9,15,11,728,879,4,6,0,0
812,41,150,763,1028,9,15,11,722,878,5,6,0,0
813,29,138,760,1027,9,15,11,731,889,6,6,0,0
816,18,182,713,1038,9,15,11,695,856,0,6,0,0
817,8,180,706,1039,9,15,11,698,859,1,6,0,0
832,71,226,727,1049,9,15,11,656,823,0,6,0,0
833,73,228,727,1049,9,15,11,654,821,1,6,0,0
887,90,252,700,1043,10,15,11,610,791,0,0,0,0
1103,319,576,796,1059,11,15,11,477,483,0,45,0,0
1104,324,580,795,1062,11,15,11,471,482,1,45,0,0
1105,326,583,791,1062,11,15,11,465,479,2,45,0,0
1106,320,580,783,1058,11,15,11,463,478,3,45,0,0
1107,319,584,779,1064,11,15,11,460,480,4,45,0,0
1108,319,588,772,1061,11,15,11,453,473,5,45,0,0
1109,317,595,765,1061,11,15,11,448,466,6,45,0,0
1110,319,606,758,1060,11,15,11,439,454,7,45,0,0
1111,303,616,739,1058,11,15,11,436,442,8,45,0,0
1112,302,619,735,1058,11,15,11,433,439,9,45,0,0
1113,222,626,660,1070,11,15,11,438,444,10,45,0,0
1131,325,563,814,1061,11,15,11,489,498,0,45,0,1
1132,346,556,832,1059,11,15,11,486,503,1,45,0,0
1133,358,536,850,1059,11,15,11,492,523,2,45,0,0
1134,378,514,879,1060,11,15,11,501,546,3,45,0,0
1135,396,495,903,1061,11,15,11,507,566,4,45,0,0
1136,429,479,941,1059,11,15,11,512,580,5,45,0,0
1137,465,455,990,1057,11,15,11,525,602,6,45,0,0
1138,488,427,1023,1056,11,15,11,535,629,7,45,0,0
1139,519,406,1063,1064,11,15,11,544,658,8,45,0,0
1140,545,394,1081,1064,11,15,11,536,670,9,45,0,0
1141,571,381,1099,1064,11,15,11,528,683,10,45,0,0
1142,596,374,1112,1066,11,15,11,516,692,11,45,0,0
1143,616,365,1121,1069,11,15,11,505,704,12,45,0,0
1144,632,340,1129,1060,11,15,11,497,720,13,45,0,0
1145,656,315,1133,1031,11,15,11,477,716,14,45,0,0
1146,697,294,1146,985,11,15,11,449,691,15,45,0,0
1147,729,287,1153,956,11,15,11,424,669,16,45,0,0
1148,759,276,1172,943,11,15,11,413,667,17,45,0,0
1149,793,255,1197,927,11,15,11,404,672,18,45,0,0
1150,835,246,1229,919,11,15,11,394,673,19,45,0,0
1151,866,255,1238,910,11,15,11,372,655,20,45,0,0
1152,918,263,1274,896,11,15,11,356,633,21,45,0,0
1153,962,262,1316,895,11,15,11,354,633,22,45,0,0
1154,993,261,1343,896,11,15,11,350,635,23,45,0,0
1155,1017,254,1360,893,11,15,11,343,639,24,45,0,0
1156,1036,248,1370,890,11,15,11,334,642,25,45,0,0
1157,1052,251,1385,914,11,15,11,333,663,26,45,0,0
1158,1055,253,1401,960,11,15,11,346,707,27,45,0,0
1159,1055,269,1399,984,11,15,11,344,715,28,45,0,0
1160,1030,277,1376,1000,11,15,11,346,723,29,45,0,0
1161,1003,296,1341,1005,11,15,11,338,709,30,45,0,0
1162,968,321,1304,1028,11,15,11,336,707,31,45,0,0
1163,937,343,1274,1057,11,15,11,337,714,32,45,0,0
1164,918,368,1248,1066,11,15,11,330,698,33,45,0,0
1165,892,396,1214,1068,11,15,11,322,672,34,45,0,0
1166,870,434,1181,1070,11,15,11,311,636,35,45,0,0
1167,853,458,1167,1074,11,15,11,314,616,36,45,0,0
1168,813,498,1123,1074,11,15,11,310,576,37,45,0,0
1169,756,527,1067,1075,11,15,11,311,548,38,45,0,0
1170,680,562,983,1069,11,15,11,303,507,39,45,0,0
1171,601,595,899,1072,11,15,11,298,477,40,45,0,0
1172,542,632,832,1071,11,15,11,290,439,41,45,0,0
1173,502,689,771,1069,11,15,11,269,380,42,45,0,0
1174,461,739,717,1073,11,15,11,256,334,43,45,0,0
1175,421,796,651,1071,11,15,11,230,275,44,45,0,0
1176,366,848,571,1073,11,15,11,205,225,45,45,1,0
1112,208,143,875,1038,12,15,11,667,895,0,0,0,0
1116,99,218,779,1021,13,15,11,680,803,0,1,0,0
1117,63,162,800,1034,13,15,11,737,872,1,1,0,0
1119,104,220,802,1022,14,15,11,698,802,0,1,0,0
1120,79,227,772,1024,14,15,11,693,797,1,1,0,0
1125,125,252,804,1030,15,15,11,679,778,0,0,0,0
1233,310,548,813,1058,17,15,11,503,510,0,18,0,0
1234,313,546,811,1058,17,15,11,498,512,1,18,0,0
1235,299,497,826,1052,17,15,11,527,555,2,18,0,0
1236,308,507,818,1052,17,15,11,510,545,3,18,0,0
1237,316,531,803,1057,17,15,11,487,526,4,18,0,0
1238,320,538,796,1058,17,15,11,476,520,5,18,0,0
1239,320,538,793,1064,17,15,11,473,526,6,18,0,0
1240,326,543,790,1063,17,15,11,464,520,7,18,0,0
1241,331,551,784,1060,17,15,11,453,509,8,18,0,0
1242,335,556,777,1054,17,15,11,442,498,9,18,0,0
1243,338,558,778,1055,17,15,11,440,497,10,18,0,0
1244,331,571,757,1052,17,15,11,426,481,11,18,0,0
1245,307,582,721,1059,17,15,11,414,477,12,18,0,0
1246,323,620,712,1061,17,15,11,389,441,13,18,0,0
1247,328,659,687,1057,17,15,11,359,398,14,18,0,0
1248,323,683,672,1064,17,15,11,349,381,15,18,0,0
1249,309,700,648,1067,17,15,11,339,367,16,18,0,0
1250,285,729,607,1070,17,15,11,322,341,17,18,0,0
1251,238,756,543,1069,17,15,11,305,313,18,18,0,0
1289,419,476,997,1061,20,15,11,578,585,0,64,0,1
1290,434,438,1022,1055,20,15,11,588,617,1,64,0,0
1291,457,436,1035,1059,20,15,11,578,623,2,64,0,0
1292,473,421,1043,1056,20,15,11,570,635,3,64,0,0
1293,477,407,1046,1062,20,15,11,569,655,4,64,0,0
1294,491,394,1053,1061,20,15,11,562,667,5,64,0,0
1295,521,371,1070,1042,20,15,11,549,671,6,64,0,0
1296,548,350,1087,1025,20,15,11,539,675,7,64,0,0
1297,582,325,1118,1014,20,15,11,536,689,8,64,0,0
1298,612,294,1139,995,20,15,11,527,701,9,64,0,0
1299,662,275,1144,937,20,15,11,482,662,10,64,0,0
1300,701,257,1156,907,20,15,11,455,650,11,64,0,0
1301,728,243,1168,897,20,15,11,440,654,12,64,0,0
1302,752,221,1181,883,20,15,11,429,662,13,64,0,0
1303,780,201,1181,838,20,15,11,401,637,14,64,0,0
1304,806,180,1180,785,20,15,11,374,605,15,64,0,0
1305,823,165,1193,777,20,15,11,370,612,16,64,0,0
1306,832,158,1193,771,20,15,11,361,613,17,64,0,0
1307,850,141,1201,757,20,15,11,351,616,18,64,0,0
1308,876,131,1206,730,20,15,11,330,599,19,64,0,0
1309,907,119,1212,685,20,15,11,305,566,20,64,0,0
1310,929,113,1219,667,20,15,11,290,554,21,64,0,0
1311,941,105,1222,657,20,15,11,281,552,22,64,0,0
1312,947,95,1216,633,20,15,11,269,538,23,64,0,0
1313,962,85,1212,597,20,15,11,250,512,24,64,0,0
1314,972,78,1218,587,20,15,11,246,509,25,64,0,0
1315,987,73,1230,581,20,15,11,243,508,26,64,0,0
1316,1004,68,1239,569,20,15,11,235,501,27,64,0,0
1317,1021,54,1246,542,20,15,11,225,488,28,64,0,0
1318,1039,47,1255,522,20,15,11,216,475,29,64,0,0
1319,1050,43,1262,517,20,15,11,212,474,30,64,0,0
1320,1063,40,1269,508,20,15,11,206,468,31,64,0,0
1321,1065,32,1271,502,20,15,11,206,470,32,64,0,0
1322,1068,32,1262,477,20,15,11,194,445,33,64,0,0
1323,1071,31,1261,465,20,15,11,190,434,34,64,0,0
1324,1077,26,1268,464,20,15,11,191,438,35,64,0,0
1325,1087,26,1276,464,20,15,11,189,438,36,64,0,0
1326,1101,18,1284,447,20,15,11,183,429,37,64,0,0
1327,1120,12,1296,424,20,15,11,176,412,38,64,0,0
1328,1139,10,1313,416,20,15,11,174,406,39,64,0,0
1329,1149,7,1323,412,20,15,11,174,405,40,64,0,0
1330,1155,2,1326,400,20,15,11,171,398,41,64,0,0
1331,1156,2,1316,372,20,15,11,160,370,42,64,0,0
1332,1159,0,1316,362,20,15,11,157,362,43,64,0,0
1333,1165,3,1320,358,20,15,11,155,355,44,64,0,0
1334,1177,3,1329,352,20,15,11,152,349,45,64,0,0
1335,1192,1,1338,337,20,15,11,146,336,46,64,0,0
1336,1208,4,1344,316,20,15,11,136,312,47,64,0,0
1337,1212,3,1348,313,20,15,11,136,310,48,64,0,0
1338,1208,1,1344,308,20,15,11,136,307,49,64,0,0
1339,1216,0,1348,297,20,15,11,132,297,50,64,0,0
1340,1211,0,1337,279,20,15,11,126,279,51,64,0,0
1341,1213,0,1339,279,20,15,11,126,279,52,64,0,0
1342,1212,0,1338,277,20,15,11,126,277,53,64,0,0
1343,1222,0,1344,271,20,15,11,122,271,54,64,0,0
1344,1236,0,1354,259,20,15,11,118,259,55,64,0,0
1345,1248,3,1362,250,20,15,11,114,247,56,64,0,0
1346,1256,2,1365,241,20,15,11,109,239,57,64,0,0
1347,1255,2,1370,248,20,15,11,115,246,58,64,0,0
1348,1251,2,1363,237,20,15,11,112,235,59,64,0,0
1349,1250,1,1361,230,20,15,11,111,229,60,64,0,0
1350,1248,1,1361,231,20,15,11,113,230,61,64,0,0
1351,1248,1,1360,228,20,15,11,112,227,62,64,0,0
1352,1258,3,1369,226,20,15,11,111,223,63,64,0,0
1353,1263,3,1371,221,20,15,11,108,218,64,64,1,0
1359,1282,0,1377,186,20,15,11,95,186,0,64,0,0
1360,1286,0,1378,180,20,15,11,92,180,1,64,0,0
1369,1318,0,1400,136,21,15,11,82,136,0,0,0,0
1371,1322,0,1413,116,22,15,11,91,116,0,1,0,0
1372,1323,1,1415,119,22,15,11,92,118,1,1,0,0
1374,1322,2,1406,112,23,15,11,84,110,0,0,0,0
1379,1348,0,1425,87,24,15,11,77,87,0,1,0,0
1380,1351,1,1428,88,24,15,11,77,87,1,1,0,0
1393,1365,0,1419,74,26,15,11,54,74,0,0,0,0
1396,1357,2,1433,90,27,15,11,76,88,0,71,0,0
1397,1344,0,1423,90,27,15,11,79,90,1,71,0,0
1398,1342,0,1424,95,27,15,11,82,95,2,71,0,0
1399,1337,1,1423,100,27,15,11,86,99,3,71,0,0
1400,1331,0,1420,103,27,15,11,89,103,4,71,0,0
1401,1326,0,1418,107,27,15,11,92,107,5,71,0,0
1403,1330,0,1429,115,27,15,11,99,115,0,71,0,0
1404,1332,0,1436,123,27,15,11,104,123,1,71,0,0
1405,1325,1,1433,129,27,15,11,108,128,2,71,0,0
1406,1318,3,1423,128,27,15,11,105,125,3,71,0,0
1407,1309,2,1414,129,27,15,11,105,127,4,71,0,0
1408,1306,2,1413,132,27,15,11,107,130,5,71,0,0
1411,1310,0,1423,140,27,15,11,113,140,0,71,0,0
1412,1310,0,1427,148,27,15,11,117,148,1,71,0,0
1413,1308,0,1429,156,27,15,11,121,156,2,71,0,0
1414,1303,0,1424,160,27,15,11,121,160,3,71,0,0
1415,1301,1,1420,163,27,15,11,119,162,4,71,0,0
1416,1296,3,1413,165,27,15,11,117,162,5,71,0,0
1417,1290,2,1409,171,27,15,11,119,169,6,71,0,0
1418,1286,2,1408,175,27,15,11,122,173,7,71,0,0
1422,1294,3,1434,209,27,15,11,140,206,0,71,0,1
1423,1290,4,1430,216,27,15,11,140,212,1,71,0,0
1424,1283,4,1419,214,27,15,11,136,210,2,71,0,0
1425,1277,8,1410,219,27,15,11,133,211,3,71,0,0
1426,1271,10,1406,231,27,15,11,135,221,4,71,0,0
1427,1271,9,1405,235,27,15,11,134,226,5,71,0,0
1428,1278,9,1407,233,27,15,11,129,224,6,71,0,0
1429,1281,8,1411,236,27,15,11,130,228,7,71,0,0
1430,1282,5,1418,248,27,15,11,136,243,8,71,0,0
1431,1282,5,1419,253,27,15,11,137,248,9,71,0,0
1432,1271,2,1412,258,27,15,11,141,256,10,71,0,0
1433,1261,2,1403,261,27,15,11,142,259,11,71,0,0
1434,1247,5,1393,277,27,15,11,146,272,12,71,0,0
1435,1240,8,1385,284,27,15,11,145,276,13,71,0,0
1436,1234,3,1382,290,27,15,11,148,287,14,71,0,0
1437,1234,2,1379,288,27,15,11,145,286,15,71,0,0
1438,1233,2,1383,303,27,15,11,150,301,16,71,0,0
1439,1230,2,1384,312,27,15,11,154,310,17,71,0,0
1440,1220,3,1377,320,27,15,11,157,317,18,71,0,0
1441,1202,3,1364,329,27,15,11,162,326,19,71,0,0
1442,1184,4,1347,339,27,15,11,163,335,20,71,0,0
1443,1175,4,1339,347,27,15,11,164,343,21,71,0,0
1444,1169,5,1336,362,27,15,11,167,357,22,71,0,0
1445,1171,5,1337,368,27,15,11,166,363,23,71,0,0
1446,1174,5,1341,374,27,15,11,167,369,24,71,0,0
1447,1175,7,1349,400,27,15,11,174,393,25,71,0,0
1448,1178,9,1356,413,27,15,11,178,404,26,71,0,0
1449,1173,9,1353,419,27,15,11,180,410,27,71,0,0
1450,1161,13,1338,423,27,15,11,177,410,28,71,0,0
1451,1154,21,1335,444,27,15,11,181,423,29,71,0,0
1452,1152,27,1334,456,27,15,11,182,429,30,71,0,0
1453,1156,29,1337,457,27,15,11,181,428,31,71,0,0
1454,1152,32,1345,488,27,15,11,193,456,32,71,0,0
1455,1149,45,1350,515,27,15,11,201,470,33,71,0,0
1456,1136,53,1337,521,27,15,11,201,468,34,71,0,0
1457,1109,58,1311,532,27,15,11,202,474,35,71,0,0
1458,1085,71,1294,572,27,15,11,209,501,36,71,0,0
1459,1076,78,1288,597,27,15,11,212,519,37,71,0,0
1460,1076,88,1284,603,27,15,11,208,515,38,71,0,0
1461,1066,99,1286,647,27,15,11,220,548,39,71,0,0
1462,1058,111,1284,680,27,15,11,226,569,40,71,0,0
1463,1048,121,1277,698,27,15,11,229,577,41,71,0,0
1464,1026,136,1254,707,27,15,11,228,571,42,71,0,0
1465,999,152,1238,759,27,15,11,239,607,43,71,0,0
1466,986,169,1231,796,27,15,11,245,627,44,71,0,0
1467,976,174,1224,817,27,15,11,248,643,45,71,0,0
1468,970,193,1212,818,27,15,11,242,625,46,71,0,0
1469,956,211,1211,862,27,15,11,255,651,47,71,0,0
1470,940,226,1205,890,27,15,11,265,664,48,71,0,0
1471,902,246,1172,905,27,15,11,270,659,49,71,0,0
1472,846,264,1124,937,27,15,11,278,673,50,71,0,0
1473,794,297,1085,1004,27,15,11,291,707,51,71,0,0
1474,769,323,1064,1034,27,15,11,295,711,52,71,0,0
1475,746,342,1041,1053,27,15,11,295,711,53,71,0,0
1476,733,367,1023,1052,27,15,11,290,685,54,71,0,0
1477,719,397,1013,1068,27,15,11,294,671,55,71,0,0
1478,695,426,992,1065,27,15,11,297,639,56,71,0,0
1479,659,456,958,1059,27,15,11,299,603,57,71,0,0
1480,611,487,913,1062,27,15,11,302,575,58,71,0,0
1481,562,518,866,1068,27,15,11,304,550,59,71,0,0
1482,527,543,823,1057,27,15,11,296,514,60,71,0,0
1483,504,562,801,1061,27,15,11,297,499,61,71,0,0
1484,495,577,798,1068,27,15,11,303,491,62,71,0,0
1485,485,604,784,1068,27,15,11,299,464,63,71,0,0
1486,470,638,760,1066,27,15,11,290,428,64,71,0,0
1487,443,673,726,1072,27,15,11,283,399,65,71,0,0
1488,396,698,674,1073,27,15,11,278,375,66,71,0,0
1489,332,731,596,1071,27,15,11,264,340,67,71,0,0
1490,270,765,520,1071,27,15,11,250,306,68,71,0,0
1491,230,804,463,1071,27,15,11,233,267,69,71,0,0
1492,195,841,413,1074,27,15,11,218,233,70,71,0,0
1493,152,872,356,1079,27,15,11,204,207,71,71,1,0
1421,1314,0,1421,202,28,15,11,107,202,0,0,0,0
1554,383,427,1019,1072,29,15,11,636,645,0,75,0,1
1555,401,437,1003,1071,29,15,11,602,634,1,75,0,0
1556,404,448,978,1071,29,15,11,574,623,2,75,0,0
1557,399,449,956,1071,29,15,11,557,622,3,75,0,0
1558,397,463,929,1068,29,15,11,532,605,4,75,0,0
1559,398,472,914,1068,29,15,11,516,596,5,75,0,0
1560,403,469,907,1060,29,15,11,504,591,6,75,0,0
1561,411,465,918,1064,29,15,11,507,599,7,75,0,0
1562,429,451,940,1064,29,15,11,511,613,8,75,0,0
1563,449,442,956,1064,29,15,11,507,622,9,75,0,0
1564,467,422,980,1067,29,15,11,513,645,10,75,0,0
1565,486,408,996,1065,29,15,11,510,657,11,75,0,0
1566,502,401,1004,1066,29,15,11,502,665,12,75,0,0
1567,516,380,1017,1065,29,15,11,501,685,13,75,0,0
1568,543,359,1026,1032,29,15,11,483,673,14,75,0,0
1569,575,346,1015,968,29,15,11,440,622,15,75,0,0
1570,602,334,1042,967,29,15,11,440,633,16,75,0,0
1571,635,311,1076,961,29,15,11,441,650,17,75,0,0
1572,671,285,1107,945,29,15,11,436,660,18,75,0,0
1573,711,263,1128,912,29,15,11,417,649,19,75,0,0
1574,736,248,1140,896,29,15,11,404,648,20,75,0,0
1575,758,228,1155,890,29,15,11,397,662,21,75,0,0
1576,774,205,1167,882,29,15,11,393,677,22,75,0,0
1577,794,187,1158,834,29,15,11,364,647,23,75,0,0
1578,819,175,1160,791,29,15,11,341,616,24,75,0,0
1579,834,164,1166,775,29,15,11,332,611,25,75,0,0
1580,846,160,1171,771,29,15,11,325,611,26,75,0,0
1581,867,147,1184,759,29,15,11,317,612,27,75,0,0
1582,893,143,1186,717,29,15,11,293,574,28,75,0,0
1583,913,135,1192,690,29,15,11,279,555,29,75,0,0
1584,925,138,1192,677,29,15,11,267,539,30,75,0,0
1585,926,140,1186,669,29,15,11,260,529,31,75,0,0
1586,924,125,1186,667,29,15,11,262,542,32,75,0,0
1587,928,126,1186,669,29,15,11,258,543,33,75,0,0
1588,937,127,1190,668,29,15,11,253,541,34,75,0,0
1589,941,124,1191,665,29,15,11,250,541,35,75,0,0
1590,948,135,1187,660,29,15,11,239,525,36,75,0,0
1591,948,138,1181,655,29,15,11,233,517,37,75,0,0
1592,958,151,1183,655,29,15,11,225,504,38,75,0,0
1593,964,151,1188,659,29,15,11,224,508,39,75,0,0
1594,980,134,1211,663,29,15,11,231,529,40,75,0,0
1595,989,125,1220,666,29,15,11,231,541,41,75,0,0
1596,1006,123,1239,677,29,15,11,233,554,42,75,0,0
1597,1040,122,1279,683,29,15,11,239,561,43,75,0,0
1598,1056,122,1298,687,29,15,11,242,565,44,75,0,0
1599,1073,120,1315,688,29,15,11,242,568,45,75,0,0
1600,1098,124,1337,690,29,15,11,239,566,46,75,0,0
1601,1117,125,1356,697,29,15,11,239,572,47,75,0,0
1602,1124,125,1373,728,29,15,11,249,603,48,75,0,0
1603,1128,130,1390,771,29,15,11,262,641,49,75,0,0
1604,1125,147,1391,801,29,15,11,266,654,50,75,0,0
1605,1107,167,1370,815,29,15,11,263,648,51,75,0,0
1606,1083,199,1336,824,29,15,11,253,625,52,75,0,0
1607,1060,220,1328,891,29,15,11,268,671,53,75,0,0
1608,1057,241,1328,923,29,15,11,271,682,54,75,0,0
1609,1063,254,1333,934,29,15,11,270,680,55,75,0,0
1610,1054,271,1343,1004,29,15,11,289,733,56,75,0,0
1611,1041,304,1336,1056,29,15,11,295,752,57,75,0,0
1612,1025,332,1320,1075,29,15,11,295,743,58,75,0,0
1613,997,363,1286,1080,29,15,11,289,717,59,75,0,0
1614,975,395,1256,1080,29,15,11,281,685,60,75,0,0
1615,963,421,1241,1079,29,15,11,278,658,61,75,0,0
1616,954,439,1232,1080,29,15,11,278,641,62,75,0,0
1617,954,457,1233,1080,29,15,11,279,623,63,75,0,0
1618,949,474,1228,1080,29,15,11,279,606,64,75,0,0
1619,931,503,1206,1080,29,15,11,275,577,65,75,0,0
1620,893,530,1162,1078,29,15,11,269,548,66,75,0,0
1621,837,559,1100,1076,29,15,11,263,517,67,75,0,0
1622,779,603,1034,1077,29,15,11,255,474,68,75,0,0
1623,718,652,962,1076,29,15,11,244,424,69,75,0,0
1624,658,713,883,1077,29,15,11,225,364,70,75,0,0
1625,600,760,810,1073,29,15,11,210,313,71,75,0,0
1626,547,807,744,1076,29,15,11,197,269,72,75,0,0
1627,479,849,662,1075,29,15,11,183,226,73,75,0,0
1628,399,879,575,1076,29,15,11,176,197,74,75,0,0
1629,323,897,501,1078,29,15,11,178,181,75,75,1,0
1681,496,381,1167,1064,30,15,11,671,683,0,114,0,1
1682,534,345,1178,1030,30,15,11,644,685,1,114,0,0
1683,567,320,1191,1013,30,15,11,624,693,2,114,0,0
1684,596,296,1200,1002,30,15,11,604,706,3,114,0,0
1685,622,272,1201,983,30,15,11,579,711,4,114,0,0
1686,670,250,1197,925,30,15,11,527,675,5,114,0,0
1687,716,221,1216,884,30,15,11,500,663,6,114,0,0
1688,759,198,1238,859,30,15,11,479,661,7,114,0,0
1689,792,183,1240,827,30,15,11,448,644,8,114,0,0
1690,832,167,1245,785,30,15,11,413,618,9,114,0,0
1691,864,157,1252,755,30,15,11,388,598,10,114,0,0
1692,881,148,1261,752,30,15,11,380,604,11,114,0,0
1693,888,133,1255,733,30,15,11,367,600,12,114,0,0
1694,901,132,1230,683,30,15,11,329,551,13,114,0,0
1695,899,114,1216,659,30,15,11,317,545,14,114,0,0
1696,913,107,1222,652,30,15,11,309,545,15,114,0,0
1697,926,106,1221,642,30,15,11,295,536,16,114,0,0
1698,955,96,1234,618,30,15,11,279,522,17,114,0,0
1699,984,84,1248,589,30,15,11,264,505,18,114,0,0
1700,999,77,1259,584,30,15,11,260,507,19,114,0,0
1701,1011,78,1261,575,30,15,11,250,497,20,114,0,0
1702,1019,73,1261,564,30,15,11,242,491,21,114,0,0
1703,1028,66,1255,534,30,15,11,227,468,22,114,0,0
1704,1032,55,1255,521,30,15,11,223,466,23,114,0,0
1705,1041,52,1262,520,30,15,11,221,468,24,114,0,0
1706,1046,47,1266,520,30,15,11,220,473,25,114,0,0
1707,1056,43,1270,515,30,15,11,214,472,26,114,0,0
1708,1072,38,1278,501,30,15,11,206,463,27,114,0,0
1709,1094,31,1291,481,30,15,11,197,450,28,114,0,0
1710,1109,30,1302,476,30,15,11,193,446,29,114,0,0
1711,1118,29,1311,472,30,15,11,193,443,30,114,0,0
1712,1122,26,1311,464,30,15,11,189,438,31,114,0,0
1713,1125,22,1305,444,30,15,11,180,422,32,114,0,0
1714,1127,21,1303,431,30,15,11,176,410,33,114,0,0
1715,1127,16,1302,424,30,15,11,175,408,34,114,0,0
1716,1127,12,1303,422,30,15,11,176,410,35,114,0,0
1717,1135,11,1308,417,30,15,11,173,406,36,114,0,0
1718,1142,8,1312,414,30,15,11,170,406,37,114,0,0
1719,1157,7,1321,395,30,15,11,164,388,38,114,0,0
1720,1170,1,1333,384,30,15,11,163,383,39,114,0,0
1721,1179,7,1337,373,30,15,11,158,366,40,114,0,0
1722,1183,12,1338,372,30,15,11,155,360,41,114,0,0
1723,1180,12,1337,375,30,15,11,157,363,42,114,0,0
1724,1174,3,1332,371,30,15,11,158,368,43,114,0,0
1725,1172,5,1324,356,30,15,11,152,351,44,114,0,0
1726,1166,2,1319,355,30,15,11,153,353,45,114,0,0
1727,1165,0,1318,355,30,15,11,153,355,46,114,0,0
1728,1169,1,1320,354,30,15,11,151,353,47,114,0,0
1729,1175,3,1322,345,30,15,11,147,342,48,114,0,0
1730,1183,0,1326,332,30,15,11,143,332,49,114,0,0
1731,1195,0,1336,321,30,15,11,141,321,50,114,0,0
1732,1201,0,1342,318,30,15,11,141,318,51,114,0,0
1733,1202,0,1342,315,30,15,11,140,315,52,114,0,0
1734,1202,0,1339,312,30,15,11,137,312,53,114,0,0
1735,1198,2,1334,318,30,15,11,136,316,54,114,0,0
1736,1197,2,1333,321,30,15,11,136,319,55,114,0,0
1737,1196,4,1331,323,30,15,11,135,319,56,114,0,0
1738,1197,1,1333,322,30,15,11,136,321,57,114,0,0
1739,1199,1,1339,333,30,15,11,140,332,58,114,0,0
1740,1198,4,1343,349,30,15,11,145,345,59,114,0,0
1741,1197,3,1344,352,30,15,11,147,349,60,114,0,0
1742,1206,1,1353,355,30,15,11,147,354,61,114,0,0
1743,1214,0,1363,358,30,15,11,149,358,62,114,0,0
1744,1219,0,1376,375,30,15,11,157,375,63,114,0,0
1745,1219,3,1383,392,30,15,11,164,389,64,114,0,0
1746,1211,3,1380,405,30,15,11,169,402,65,114,0,0
1747,1198,1,1371,412,30,15,11,173,411,66,114,0,0
1748,1189,3,1359,409,30,15,11,170,406,67,114,0,0
1749,1175,7,1350,432,30,15,11,175,425,68,114,0,0
1750,1169,15,1345,449,30,15,11,176,434,69,114,0,0
1751,1168,19,1343,455,30,15,11,175,436,70,114,0,0
1752,1169,26,1341,455,30,15,11,172,429,71,114,0,0
1753,1166,30,1348,483,30,15,11,182,453,72,114,0,0
1754,1164,41,1350,500,30,15,11,186,459,73,114,0,0
1755,1141,37,1335,510,30,15,11,194,473,74,114,0,0
1756,1118,45,1311,512,30,15,11,193,467,75,114,0,0
1757,1093,59,1288,533,30,15,11,195,474,76,114,0,0
1758,1083,70,1282,560,30,15,11,199,490,77,114,0,0
1759,1079,71,1281,577,30,15,11,202,506,78,114,0,0
1760,1082,81,1281,582,30,15,11,199,501,79,114,0,0
1761,1084,89,1295,622,30,15,11,211,533,80,114,0,0
1762,1074,104,1293,656,30,15,11,219,552,81,114,0,0
1763,1059,110,1287,678,30,15,11,228,568,82,114,0,0
1764,1040,128,1262,679,30,15,11,222,551,83,114,0,0
1765,1008,141,1241,724,30,15,11,233,583,84,114,0,0
1766,989,157,1231,766,30,15,11,242,609,85,114,0,0
1767,983,170,1226,786,30,15,11,243,616,86,114,0,0
1768,980,183,1222,794,30,15,11,242,611,87,114,0,0
1769,979,198,1230,831,30,15,11,251,633,88,114,0,0
1770,972,215,1233,869,30,15,11,261,654,89,114,0,0
1771,953,227,1223,889,30,15,11,270,662,90,114,0,0
1772,919,239,1193,897,30,15,11,274,658,91,114,0,0
1773,882,253,1166,926,30,15,11,284,673,92,114,0,0
1774,843,266,1141,982,30,15,11,298,716,93,114,0,0
1775,817,284,1119,1012,30,15,11,302,728,94,114,0,0
1776,804,299,1106,1028,30,15,11,302,729,95,114,0,0
1777,800,313,1102,1035,30,15,11,302,722,96,114,0,0
1778,802,340,1103,1041,30,15,11,301,701,97,114,0,0
1779,796,363,1108,1067,30,15,11,312,704,98,114,0,0
1780,782,395,1093,1064,30,15,11,311,669,99,114,0,0
1781,742,410,1062,1073,30,15,11,320,663,100,114,0,0
1782,702,432,1021,1075,30,15,11,319,643,101,114,0,0
1783,663,449,977,1068,30,15,11,314,619,102,114,0,0
1784,626,475,934,1067,30,15,11,308,592,103,114,0,0
1785,613,508,918,1069,30,15,11,305,561,104,114,0,0
1786,566,537,866,1068,30,15,11,300,531,105,114,0,0
1787,536,580,826,1068,30,15,11,290,488,106,114,0,0
1788,507,617,789,1064,30,15,11,282,447,107,114,0,0
1789,464,653,742,1067,30,15,11,278,414,108,114,0,0
1790,401,689,671,1070,30,15,11,270,381,109,114,0,0
1791,329,717,588,1069,30,15,11,259,352,110,114,0,0
1792,271,746,522,1069,30,15,11,251,323,111,114,0,0
1793,232,774,479,1072,30,15,11,247,298,112,114,0,0
1794,204,800,441,1070,30,15,11,237,270,113,114,0,0
1795,179,834,403,1074,30,15,11,224,240,114,114,1,0
1855,540,345,1257,1063,31,15,11,717,718,0,68,0,1
1856,561,329,1264,1065,31,15,11,703,736,1,68,0,0
1857,585,310,1250,1038,31,15,11,665,728,2,68,0,0
1858,621,287,1218,969,31,15,11,597,682,3,68,0,0
1859,651,261,1220,936,31,15,11,569,675,4,68,0,0
1860,673,245,1216,919,31,15,11,543,674,5,68,0,0
1861,693,219,1214,899,31,15,11,521,680,6,68,0,0
1862,734,196,1210,845,31,15,11,476,649,7,68,0,0
1863,775,190,1199,790,31,15,11,424,600,8,68,0,0
1864,803,188,1193,759,31,15,11,390,571,9,68,0,0
1865,800,184,1173,733,31,15,11,373,549,10,68,0,0
1866,794,184,1156,717,31,15,11,362,533,11,68,0,0
1867,788,177,1146,716,31,15,11,358,539,12,68,0,0
1868,779,172,1137,723,31,15,11,358,551,13,68,0,0
1869,770,166,1128,731,31,15,11,358,565,14,68,0,0
1870,781,173,1124,730,31,15,11,343,557,15,68,0,0
1871,795,166,1131,729,31,15,11,336,563,16,68,0,0
1872,799,157,1135,735,31,15,11,336,578,17,68,0,0
1873,802,148,1136,738,31,15,11,334,590,18,68,0,0
1874,807,155,1129,739,31,15,11,322,584,19,68,0,0
1875,812,158,1126,741,31,15,11,314,583,20,68,0,0
1876,815,160,1120,739,31,15,11,305,579,21,68,0,0
1877,817,160,1116,738,31,15,11,299,578,22,68,0,0
1878,822,163,1115,739,31,15,11,293,576,23,68,0,0
1879,827,166,1112,736,31,15,11,285,570,24,68,0,0
1880,830,164,1112,736,31,15,11,282,572,25,68,0,0
1881,837,164,1113,735,31,15,11,276,571,26,68,0,0
1882,843,169,1111,731,31,15,11,268,562,27,68,0,0
1883,847,166,1112,735,31,15,11,265,569,28,68,0,0
1884,856,172,1111,723,31,15,11,255,551,29,68,0,0
1885,862,161,1119,721,31,15,11,257,560,30,68,0,0
1886,875,163,1131,724,31,15,11,256,561,31,68,0,0
1887,880,165,1134,727,31,15,11,254,562,32,68,0,0
1888,890,168,1138,716,31,15,11,248,548,33,68,0,0
1889,900,176,1146,722,31,15,11,246,546,34,68,0,0
1890,903,176,1155,738,31,15,11,252,562,35,68,0,0
1891,903,175,1164,760,31,15,11,261,585,36,68,0,0
1892,896,186,1155,762,31,15,11,259,576,37,68,0,0
1893,883,185,1143,763,31,15,11,260,578,38,68,0,0
1894,867,188,1128,766,31,15,11,261,578,39,68,0,0
1895,834,197,1087,754,31,15,11,253,557,40,68,0,0
1896,809,201,1068,770,31,15,11,259,569,41,68,0,0
1897,799,202,1059,773,31,15,11,260,571,42,68,0,0
1898,792,202,1070,819,31,15,11,278,617,43,68,0,0
1899,778,220,1058,840,31,15,11,280,620,44,68,0,0
1900,781,233,1064,865,31,15,11,283,632,45,68,0,0
1901,781,251,1060,874,31,15,11,279,623,46,68,0,0
1902,778,265,1057,884,31,15,11,279,619,47,68,0,0
1903,756,280,1060,953,31,15,11,304,673,48,68,0,0
1904,732,309,1047,994,31,15,11,315,685,49,68,0,0
1905,701,334,1020,1012,31,15,11,319,678,50,68,0,0
1906,673,361,992,1027,31,15,11,319,666,51,68,0,0
1907,638,390,961,1057,31,15,11,323,667,52,68,0,0
1908,616,414,936,1068,31,15,11,320,654,53,68,0,0
1909,604,427,913,1048,31,15,11,309,621,54,68,0,0
1910,600,448,912,1061,31,15,11,312,613,55,68,0,0
1911,600,469,915,1068,31,15,11,315,599,56,68,0,0
1912,593,488,914,1067,31,15,11,321,579,57,68,0,0
1913,584,506,909,1059,31,15,11,325,553,58,68,0,0
1914,550,531,880,1059,31,15,11,330,528,59,68,0,0
1915,494,558,825,1059,31,15,11,331,501,60,68,0,0
1916,426,587,751,1066,31,15,11,325,479,61,68,0,0
1917,376,610,694,1064,31,15,11,318,454,62,68,0,0
1918,348,643,653,1065,31,15,11,305,422,63,68,0,0
1919,323,681,615,1070,31,15,11,292,389,64,68,0,0
1920,301,720,577,1071,31,15,11,276,351,65,68,0,0
1921,281,761,540,1070,31,15,11,259,309,66,68,0,0
1922,247,806,480,1066,31,15,11,233,260,67,68,0,0
1923,207,848,421,1072,31,15,11,214,224,68,68,1,0
1979,366,478,946,1061,32,15,11,580,583,0,43,0,1
1980,371,482,935,1060,32,15,11,564,578,1,43,0,0
1981,372,478,929,1060,32,15,11,557,582,2,43,0,0
1982,380,477,929,1061,32,15,11,549,584,3,43,0,0
1983,386,477,926,1061,32,15,11,540,584,4,43,0,0
1984,398,470,936,1060,32,15,11,538,590,5,43,0,0
1985,414,463,949,1056,32,15,11,535,593,6,43,0,0
1986,431,458,961,1054,32,15,11,530,596,7,43,0,0
1987,443,448,976,1059,32,15,11,533,611,8,43,0,0
1988,460,429,996,1060,32,15,11,536,631,9,43,0,0
1989,477,411,1013,1061,32,15,11,536,650,10,43,0,0
1990,490,378,1023,1046,32,15,11,533,668,11,43,0,0
1991,517,394,1027,1048,32,15,11,510,654,12,43,0,0
1992,527,398,1015,1038,32,15,11,488,640,13,43,0,0
1993,534,403,1004,1032,32,15,11,470,629,14,43,0,0
1994,530,397,1004,1042,32,15,11,474,645,15,43,0,0
1995,534,393,1002,1039,32,15,11,468,646,16,43,0,0
1996,540,396,991,1023,32,15,11,451,627,17,43,0,0
1997,533,396,979,1022,32,15,11,446,626,18,43,0,0
1998,531,394,978,1031,32,15,11,447,637,19,43,0,0
1999,527,390,969,1026,32,15,11,442,636,20,43,0,0
2000,532,381,976,1030,32,15,11,444,649,21,43,0,0
2001,549,373,981,1019,32,15,11,432,646,22,43,0,0
2002,556,361,993,1032,32,15,11,437,671,23,43,0,0
2003,560,361,997,1049,32,15,11,437,688,24,43,0,0
2004,573,367,1004,1061,32,15,11,431,694,25,43,0,0
2005,587,375,1007,1061,32,15,11,420,686,26,43,0,0
2006,601,385,1011,1066,32,15,11,410,681,27,43,0,0
2007,617,399,1017,1068,32,15,11,400,669,28,43,0,0
2008,628,411,1019,1070,32,15,11,391,659,29,43,0,0
2009,635,426,1016,1066,32,15,11,381,640,30,43,0,0
2010,630,439,1006,1063,32,15,11,376,624,31,43,0,0
2011,615,468,979,1058,32,15,11,364,590,32,43,0,0
2012,581,493,940,1058,32,15,11,359,565,33,43,0,0
2013,537,529,886,1059,32,15,11,349,530,34,43,0,0
2014,474,571,800,1057,32,15,11,326,486,35,43,0,0
2015,435,593,750,1049,32,15,11,315,456,36,43,0,0
2016,398,620,712,1057,32,15,11,314,437,37,43,0,0
2017,371,661,669,1057,32,15,11,298,396,38,43,0,0
2018,339,695,624,1058,32,15,11,285,363,39,43,0,0
2019,289,746,549,1059,32,15,11,260,313,40,43,0,0
2020,237,793,476,1066,32,15,11,239,273,41,43,0,0
2021,181,838,400,1073,32,15,11,219,235,42,43,0,0
2022,120,870,323,1076,32,15,11,203,206,43,43,1,0
2750,178,666,584,1073,37,15,11,406,407,0,0,0,0
3395,383,554,849,1025,39,15,11,466,471,0,32,0,0
3396,386,550,862,1043,39,15,11,476,493,1,32,0,0
3397,402,543,889,1061,39,15,11,487,518,2,32,0,0
3398,409,538,894,1069,39,15,11,485,531,3,32,0,0
3399,421,550,885,1067,39,15,11,464,517,4,32,0,0
3400,418,574,858,1066,39,15,11,440,492,5,32,0,0
3401,404,594,830,1066,39,15,11,426,472,6,32,0,0
3402,377,615,789,1066,39,15,11,412,451,7,32,0,0
3403,354,648,738,1062,39,15,11,384,414,8,32,0,0
3404,335,686,689,1056,39,15,11,354,370,9,32,0,0
3405,314,733,640,1063,39,15,11,326,330,10,32,0,0
3433,526,480,1095,1064,39,15,11,569,584,0,32,0,1
3434,554,457,1130,1066,39,15,11,576,609,1,32,0,0
3435,578,433,1157,1066,39,15,11,579,633,2,32,0,0
3436,598,414,1178,1069,39,15,11,580,655,3,32,0,0
3437,608,396,1189,1071,39,15,11,581,675,4,32,0,0
3438,619,374,1198,1067,39,15,11,579,693,5,32,0,0
3439,623,351,1201,1062,39,15,11,578,711,6,32,0,0
3440,619,343,1185,1058,39,15,11,566,715,7,32,0,0
3441,610,332,1167,1057,39,15,11,557,725,8,32,0,0
3442,625,322,1158,1033,39,15,11,533,711,9,32,0,0
3443,638,301,1168,1027,39,15,11,530,726,10,32,0,0
3444,684,295,1185,1006,39,15,11,501,711,11,32,0,0
3445,718,296,1185,990,39,15,11,467,694,12,32,0,0
3446,718,296,1184,1016,39,15,11,466,720,13,32,0,0
3447,719,306,1169,1029,39,15,11,450,723,14,32,0,0
3448,725,309,1158,1032,39,15,11,433,723,15,32,0,0
3449,724,322,1140,1036,39,15,11,416,714,16,32,0,0
3450,724,347,1115,1034,39,15,11,391,687,17,32,0,0
3451,719,366,1094,1033,39,15,11,375,667,18,32,0,0
3452,698,386,1073,1049,39,15,11,375,663,19,32,0,0
3453,683,402,1053,1051,39,15,11,370,649,20,32,0,0
3454,647,422,1016,1051,39,15,11,369,629,21,32,0,0
3455,605,451,968,1053,39,15,11,363,602,22,32,0,0
3456,562,468,924,1060,39,15,11,362,592,23,32,0,0
3457,536,488,895,1064,39,15,11,359,576,24,32,0,0
3458,530,515,878,1067,39,15,11,348,552,25,32,0,0
3459,539,531,886,1069,39,15,11,347,538,26,32,0,0
3460,561,550,910,1067,39,15,11,349,517,27,32,0,0
3461,575,584,918,1065,39,15,11,343,481,28,32,0,0
3462,552,645,872,1066,39,15,11,320,421,29,32,0,0
3463,486,708,778,1075,39,15,11,292,367,30,32,0,0
3464,423,766,686,1075,39,15,11,263,309,31,32,0,0
3465,364,813,605,1074,39,15,11,241,261,32,32,1,0
3551,377,494,944,1064,43,15,11,567,570,0,14,0,0
3552,384,493,936,1064,43,15,11,552,571,1,14,0,0
3553,392,497,928,1064,43,15,11,536,567,2,14,0,0
3554,394,498,919,1065,43,15,11,525,567,3,14,0,0
3555,399,502,907,1062,43,15,11,508,560,4,14,0,0
3556,404,518,893,1063,43,15,11,489,545,5,14,0,0
3557,400,534,874,1064,43,15,11,474,530,6,14,0,0
3558,402,555,849,1056,43,15,11,447,501,7,14,0,0
3559,359,608,755,1054,43,15,11,396,446,8,14,0,0
3560,346,652,715,1063,43,15,11,369,411,9,14,0,0
3561,326,690,670,1064,43,15,11,344,374,10,14,0,0
3562,283,723,609,1072,43,15,11,326,349,11,14,0,0
3563,230,745,539,1072,43,15,11,309,327,12,14,0,0
3564,185,767,475,1068,43,15,11,290,301,13,14,0,0
3565,154,800,418,1068,43,15,11,264,268,14,14,0,0
3611,347,430,961,1052,44,15,11,614,622,0,12,0,0
3612,363,445,952,1058,44,15,11,589,613,1,12,0,0
3613,389,465,945,1057,44,15,11,556,592,2,12,0,0
3614,397,488,923,1056,44,15,11,526,568,3,12,0,0
3615,400,528,884,1055,44,15,11,484,527,4,12,0,0
3616,389,567,831,1052,44,15,11,442,485,5,12,0,0
3617,379,602,794,1056,44,15,11,415,454,6,12,0,0
3618,362,627,759,1059,44,15,11,397,432,7,12,0,0
3619,330,653,708,1059,44,15,11,378,406,8,12,0,0
3620,271,686,625,1066,44,15,11,354,380,9,12,0,0
3621,229,714,561,1067,44,15,11,332,353,10,12,0,0
3622,198,746,508,1068,44,15,11,310,322,11,12,0,0
3623,174,783,455,1066,44,15,11,281,283,12,12,0,0
3704,321,521,860,1069,45,15,11,539,548,0,18,0,0
3705,330,512,864,1068,45,15,11,534,556,1,18,0,0
3706,340,503,867,1066,45,15,11,527,563,2,18,0,0
3707,340,493,865,1064,45,15,11,525,571,3,18,0,0
3708,355,486,874,1063,45,15,11,519,577,4,18,0,0
3709,358,479,869,1062,45,15,11,511,583,5,18,0,0
3710,366,476,868,1061,45,15,11,502,585,6,18,0,0
3711,370,475,859,1060,45,15,11,489,585,7,18,0,0
3712,381,484,852,1056,45,15,11,471,572,8,18,0,0
3713,398,497,840,1041,45,15,11,442,544,9,18,0,0
3714,400,526,822,1049,45,15,11,422,523,10,18,0,0
3715,409,560,809,1056,45,15,11,400,496,11,18,0,0
3716,404,594,782,1056,45,15,11,378,462,12,18,0,0
3717,399,625,755,1052,45,15,11,356,427,13,18,0,0
3718,373,656,716,1056,45,15,11,343,400,14,18,0,0
3719,319,688,647,1063,45,15,11,328,375,15,18,0,0
3720,255,717,570,1070,45,15,11,315,353,16,18,0,0
3721,209,750,503,1071,45,15,11,294,321,17,18,0,0
3722,180,786,449,1068,45,15,11,269,282,18,18,0,0
3769,416,418,1050,1061,46,15,11,634,643,0,26,0,1
3770,429,399,1062,1064,46,15,11,633,665,1,26,0,0
3771,449,390,1071,1069,46,15,11,622,679,2,26,0,0
3772,471,374,1085,1072,46,15,11,614,698,3,26,0,0
3773,494,360,1094,1075,46,15,11,600,715,4,26,0,0
3774,515,356,1092,1073,46,15,11,577,717,5,26,0,0
3775,533,356,1087,1071,46,15,11,554,715,6,26,0,0
3776,547,360,1077,1067,46,15,11,530,707,7,26,0,0
3777,552,371,1057,1065,46,15,11,505,694,8,26,0,0
3778,550,384,1031,1060,46,15,11,481,676,9,26,0,0
3779,544,399,1005,1058,46,15,11,461,659,10,26,0,0
3780,543,425,979,1056,46,15,11,436,631,11,26,0,0
3781,532,444,953,1060,46,15,11,421,616,12,26,0,0
3782,524,460,936,1061,46,15,11,412,601,13,26,0,0
3783,512,473,920,1062,46,15,11,408,589,14,26,0,0
3784,498,480,905,1059,46,15,11,407,579,15,26,0,0
3785,476,500,872,1053,46,15,11,396,553,16,26,0,0
3786,437,515,828,1056,46,15,11,391,541,17,26,0,0
3787,412,525,794,1051,46,15,11,382,526,18,26,0,0
3788,402,544,778,1056,46,15,11,376,512,19,26,0,0
3789,406,571,771,1057,46,15,11,365,486,20,26,0,0
3790,403,598,752,1051,46,15,11,349,453,21,26,0,0
3791,408,617,756,1057,46,15,11,348,440,22,26,0,0
3792,413,649,746,1048,46,15,11,333,399,23,26,0,0
3793,396,691,716,1057,46,15,11,320,366,24,26,0,0
3794,343,739,644,1066,46,15,11,301,327,25,26,0,0
3795,275,778,561,1072,46,15,11,286,294,26,26,1,0
3846,412,416,1045,1062,47,15,11,633,646,0,22,0,1
3847,422,408,1047,1070,47,15,11,625,662,1,22,0,0
3848,437,399,1047,1070,47,15,11,610,671,2,22,0,0
3849,453,388,1047,1067,47,15,11,594,679,3,22,0,0
3850,478,373,1039,1037,47,15,11,561,664,4,22,0,0
3851,489,362,1031,1027,47,15,11,542,665,5,22,0,0
3852,492,362,1023,1037,47,15,11,531,675,6,22,0,0
3853,503,376,1017,1049,47,15,11,514,673,7,22,0,0
3854,480,384,984,1058,47,15,11,504,674,8,22,0,0
3855,502,400,967,1039,47,15,11,465,639,9,22,0,0
3856,521,429,965,1049,47,15,11,444,620,10,22,0,0
3857,527,449,961,1059,47,15,11,434,610,11,22,0,0
3858,526,467,954,1065,47,15,11,428,598,12,22,0,0
3859,516,484,940,1067,47,15,11,424,583,13,22,0,0
3860,495,506,909,1062,47,15,11,414,556,14,22,0,0
3861,445,539,838,1062,47,15,11,393,523,15,22,0,0
3862,394,562,771,1060,47,15,11,377,498,16,22,0,0
3863,363,600,714,1056,47,15,11,351,456,17,22,0,0
3864,340,643,668,1058,47,15,11,328,415,18,22,0,0
3865,317,690,623,1064,47,15,11,306,374,19,22,0,0
3866,287,727,580,1073,47,15,11,293,346,20,22,0,0
3867,252,769,523,1071,47,15,11,271,302,21,22,0,0
3868,214,812,458,1070,47,15,11,244,258,22,22,1,0
3891,1439,1,1480,80,48,15,11,41,79,0,0,0,0
3894,1426,2,1477,105,49,15,11,51,103,0,35,0,1
3895,1421,0,1475,109,49,15,11,54,109,1,35,0,0
3896,1420,0,1478,115,49,15,11,58,115,2,35,0,0
3897,1412,0,1481,136,49,15,11,69,136,3,35,0,0
3898,1406,0,1480,145,49,15,11,74,145,4,35,0,0
3899,1400,0,1479,153,49,15,11,79,153,5,35,0,0
3900,1401,0,1486,165,49,15,11,85,165,6,35,0,0
3901,1400,0,1492,177,49,15,11,92,177,7,35,0,0
3902,1393,0,1495,197,49,15,11,102,197,8,35,0,0
3903,1384,0,1495,217,49,15,11,111,217,9,35,0,0
3904,1383,0,1499,228,49,15,11,116,228,10,35,0,0
3905,1386,0,1511,244,49,15,11,125,244,11,35,0,0
3906,1396,0,1525,249,49,15,11,129,249,12,35,0,0
3907,1398,0,1538,270,49,15,11,140,270,13,35,0,0
3908,1395,0,1547,295,49,15,11,152,295,14,35,0,0
3909,1400,1,1556,304,49,15,11,156,303,15,35,0,0
3910,1405,0,1577,333,49,15,11,172,333,16,35,0,0
3911,1414,0,1597,354,49,15,11,183,354,17,35,0,0
3912,1418,0,1611,378,49,15,11,193,378,18,35,0,0
3913,1411,3,1621,422,49,15,11,210,419,19,35,0,0
3914,1409,3,1626,440,49,15,11,217,437,20,35,0,0
3915,1401,2,1633,477,49,15,11,232,475,21,35,0,0
3916,1392,3,1642,522,49,15,11,250,519,22,35,0,0
3917,1390,5,1644,539,49,15,11,254,534,23,35,0,0
3918,1379,23,1648,602,49,15,11,269,579,24,35,0,0
3919,1359,37,1640,648,49,15,11,281,611,25,35,0,0
3920,1339,54,1640,715,49,15,11,301,661,26,35,0,0
3921,1325,79,1648,788,49,15,11,323,709,27,35,0,0
3922,1316,98,1645,820,49,15,11,329,722,28,35,0,0
3923,1294,134,1650,928,49,15,11,356,794,29,35,0,0
3924,1261,190,1627,1007,49,15,11,366,817,30,35,0,0
3925,1232,240,1607,1061,49,15,11,375,821,31,35,0,0
3926,1221,316,1592,1080,49,15,11,371,764,32,35,0,0
3927,1209,398,1557,1080,49,15,11,348,682,33,35,0,0
3928,1208,512,1527,1080,49,15,11,319,568,34,35,0,0
3929,1201,546,1519,1080,49,15,11,318,534,35,35,1,0
3922,363,526,899,1066,50,15,11,536,540,0,66,0,1
3923,392,503,934,1064,50,15,11,542,561,1,66,0,0
3924,417,483,960,1062,50,15,11,543,579,2,66,0,0
3925,428,451,979,1057,50,15,11,551,606,3,66,0,0
3926,443,428,988,1047,50,15,11,545,619,4,66,0,0
3927,470,380,1028,1033,50,15,11,558,653,5,66,0,0
3928,492,376,1047,1042,50,15,11,555,666,6,66,0,0
3929,521,351,1066,1028,50,15,11,545,677,7,66,0,0
3930,562,325,1100,1017,50,15,11,538,692,8,66,0,0
3931,608,303,1116,981,50,15,11,508,678,9,66,0,0
3932,650,277,1132,941,50,15,11,482,664,10,66,0,0
3933,680,266,1143,930,50,15,11,463,664,11,66,0,0
3934,706,250,1152,915,50,15,11,446,665,12,66,0,0
3935,727,236,1149,889,50,15,11,422,653,13,66,0,0
3936,756,215,1146,835,50,15,11,390,620,14,66,0,0
3937,779,196,1163,815,50,15,11,384,619,15,66,0,0
3938,793,181,1171,804,50,15,11,378,623,16,66,0,0
3939,806,171,1175,798,50,15,11,369,627,17,66,0,0
3940,825,168,1179,789,50,15,11,354,621,18,66,0,0
3941,849,156,1189,770,50,15,11,340,614,19,66,0,0
3942,882,144,1207,738,50,15,11,325,594,20,66,0,0
3943,899,134,1217,723,50,15,11,318,589,21,66,0,0
3944,909,135,1213,704,50,15,11,304,569,22,66,0,0
3945,906,130,1202,691,50,15,11,296,561,23,66,0,0
3946,899,129,1194,696,50,15,11,295,567,24,66,0,0
3947,896,125,1186,688,50,15,11,290,563,25,66,0,0
3948,898,130,1167,661,50,15,11,269,531,26,66,0,0
3949,894,126,1159,656,50,15,11,265,530,27,66,0,0
3950,894,123,1157,661,50,15,11,263,538,28,66,0,0
3951,902,125,1156,655,50,15,11,254,530,29,66,0,0
3952,899,123,1148,653,50,15,11,249,530,30,66,0,0
3953,902,129,1144,651,50,15,11,242,522,31,66,0,0
3954,909,137,1144,648,50,15,11,235,511,32,66,0,0
3955,911,138,1151,665,50,15,11,240,527,33,66,0,0
3956,912,133,1159,681,50,15,11,247,548,34,66,0,0
3957,916,129,1167,696,50,15,11,251,567,35,66,0,0
3958,922,129,1176,708,50,15,11,254,579,36,66,0,0
3959,933,134,1181,710,50,15,11,248,576,37,66,0,0
3960,937,144,1180,709,50,15,11,243,565,38,66,0,0
3961,941,152,1185,719,50,15,11,244,567,39,66,0,0
3962,938,163,1195,768,50,15,11,257,605,40,66,0,0
3963,924,170,1190,797,50,15,11,266,627,41,66,0,0
3964,908,179,1179,817,50,15,11,271,638,42,66,0,0
3965,888,200,1154,825,50,15,11,266,625,43,66,0,0
3966,868,212,1129,823,50,15,11,261,611,44,66,0,0
3967,841,225,1118,881,50,15,11,277,656,45,66,0,0
3968,824,240,1113,929,50,15,11,289,689,46,66,0,0
3969,814,264,1102,954,50,15,11,288,690,47,66,0,0
3970,817,271,1104,956,50,15,11,287,685,48,66,0,0
3971,831,281,1118,956,50,15,11,287,675,49,66,0,0
3972,821,297,1127,1009,50,15,11,306,712,50,66,0,0
3973,797,317,1111,1031,50,15,11,314,714,51,66,0,0
3974,762,343,1081,1043,50,15,11,319,700,52,66,0,0
3975,718,368,1038,1051,50,15,11,320,683,53,66,0,0
3976,667,397,982,1065,50,15,11,315,668,54,66,0,0
3977,637,424,946,1067,50,15,11,309,643,55,66,0,0
3978,613,448,918,1069,50,15,11,305,621,56,66,0,0
3979,597,476,897,1067,50,15,11,300,591,57,66,0,0
3980,590,496,898,1067,50,15,11,308,571,58,66,0,0
3981,581,532,889,1067,50,15,11,308,535,59,66,0,0
3982,557,563,867,1063,50,15,11,310,500,60,66,0,0
3983,485,608,778,1056,50,15,11,293,448,61,66,0,0
3984,410,656,688,1060,50,15,11,278,404,62,66,0,0
3985,349,703,616,1071,50,15,11,267,368,63,66,0,0
3986,299,754,547,1072,50,15,11,248,318,64,66,0,0
3987,260,798,485,1067,50,15,11,225,269,65,66,0,0
3988,216,858,413,1075,50,15,11,197,217,66,66,1,0
4044,530,299,1215,1013,52,15,11,685,714,0,50,0,1
4045,543,276,1187,978,52,15,11,644,702,1,50,0,0
4046,587,269,1168,927,52,15,11,581,658,2,50,0,0
4047,628,254,1170,887,52,15,11,542,633,3,50,0,0
4048,644,244,1172,876,52,15,11,528,632,4,50,0,0
4049,667,227,1189,872,52,15,11,522,645,5,50,0,0
4050,687,214,1195,866,52,15,11,508,652,6,50,0,0
4051,719,193,1203,842,52,15,11,484,649,7,50,0,0
4052,757,183,1205,808,52,15,11,448,625,8,50,0,0
4053,792,184,1206,779,52,15,11,414,595,9,50,0,0
4054,803,167,1213,777,52,15,11,410,610,10,50,0,0
4055,813,164,1209,774,52,15,11,396,610,11,50,0,0
4056,819,159,1192,750,52,15,11,373,591,12,50,0,0
4057,834,156,1182,721,52,15,11,348,565,13,50,0,0
4058,841,153,1174,702,52,15,11,333,549,14,50,0,0
4059,839,145,1165,699,52,15,11,326,554,15,50,0,0
4060,839,145,1156,699,52,15,11,317,554,16,50,0,0
4061,837,139,1147,697,52,15,11,310,558,17,50,0,0
4062,839,137,1142,695,52,15,11,303,558,18,50,0,0
4063,851,138,1138,677,52,15,11,287,539,19,50,0,0
4064,855,139,1138,680,52,15,11,283,541,20,50,0,0
4065,860,146,1141,696,52,15,11,281,550,21,50,0,0
4066,863,147,1146,712,52,15,11,283,565,22,50,0,0
4067,869,151,1152,727,52,15,11,283,576,23,50,0,0
4068,874,164,1152,736,52,15,11,278,572,24,50,0,0
4069,877,168,1155,745,52,15,11,278,577,25,50,0,0
4070,875,170,1168,786,52,15,11,293,616,26,50,0,0
4071,869,183,1170,822,52,15,11,301,639,27,50,0,0
4072,859,193,1165,843,52,15,11,306,650,28,50,0,0
4073,836,213,1140,852,52,15,11,304,639,29,50,0,0
4074,812,233,1102,838,52,15,11,290,605,30,50,0,0
4075,771,269,1084,929,52,15,11,313,660,31,50,0,0
4076,758,289,1076,968,52,15,11,318,679,32,50,0,0
4077,753,308,1071,986,52,15,11,318,678,33,50,0,0
4078,759,324,1074,987,52,15,11,315,663,34,50,0,0
4079,750,339,1088,1042,52,15,11,338,703,35,50,0,0
4080,735,363,1082,1067,52,15,11,347,704,36,50,0,0
4081,709,388,1059,1078,52,15,11,350,690,37,50,0,0
4082,672,414,1016,1073,52,15,11,344,659,38,50,0,0
4083,627,435,966,1072,52,15,11,339,637,39,50,0,0
4084,589,455,924,1073,52,15,11,335,618,40,50,0,0
4085,572,479,901,1069,52,15,11,329,590,41,50,0,0
4086,555,498,884,1068,52,15,11,329,570,42,50,0,0
4087,540,527,864,1067,52,15,11,324,540,43,50,0,0
4088,511,562,820,1060,52,15,11,309,498,44,50,0,0
4089,481,604,782,1064,52,15,11,301,460,45,50,0,0
4090,436,652,724,1065,52,15,11,288,413,46,50,0,0
4091,364,687,642,1062,52,15,11,278,375,47,50,0,0
4092,293,729,561,1067,52,15,11,268,338,48,50,0,0
4093,248,770,505,1072,52,15,11,257,302,49,50,0,0
4094,223,832,450,1076,52,15,11,227,244,50,50,1,0
4167,472,381,1141,1060,54,15,11,669,679,0,32,0,1
4168,499,350,1170,1063,54,15,11,671,713,1,32,0,0
4169,532,328,1191,1061,54,15,11,659,733,2,32,0,0
4170,559,315,1199,1058,54,15,11,640,743,3,32,0,0
4171,588,317,1198,1051,54,15,11,610,734,4,32,0,0
4172,609,326,1190,1046,54,15,11,581,720,5,32,0,0
4173,599,344,1150,1047,54,15,11,551,703,6,32,0,0
4174,593,366,1113,1045,54,15,11,520,679,7,32,0,0
4175,573,384,1072,1047,54,15,11,499,663,8,32,0,0
4176,551,387,1034,1042,54,15,11,483,655,9,32,0,0
4177,538,392,1009,1045,54,15,11,471,653,10,32,0,0
4178,536,398,989,1041,54,15,11,453,643,11,32,0,0
4179,536,402,978,1040,54,15,11,442,638,12,32,0,0
4180,535,404,973,1047,54,15,11,438,643,13,32,0,0
4181,531,408,965,1054,54,15,11,434,646,14,32,0,0
4182,531,420,954,1053,54,15,11,423,633,15,32,0,0
4183,564,437,874,880,54,15,11,310,443,16,32,0,0
4184,568,459,850,853,54,15,11,282,394,17,32,0,0
4185,542,471,917,996,54,15,11,375,525,18,32,0,0
4186,536,488,935,1040,54,15,11,399,552,19,32,0,0
4187,536,505,947,1062,54,15,11,411,557,20,32,0,0
4188,515,538,897,1038,54,15,11,382,500,21,32,0,0
4189,476,565,860,1049,54,15,11,384,484,22,32,0,0
4190,432,593,816,1058,54,15,11,384,465,23,32,0,0
4191,352,623,723,1067,54,15,11,371,444,24,32,0,0
4192,299,648,659,1072,54,15,11,360,424,25,32,0,0
4193,267,668,616,1073,54,15,11,349,405,26,32,0,0
4194,243,687,584,1080,54,15,11,341,393,27,32,0,0
4195,219,708,538,1067,54,15,11,319,359,28,32,0,0
4196,193,725,508,1070,54,15,11,315,345,29,32,0,0
4197,181,730,500,1070,54,15,11,319,340,30,32,0,0
4198,181,729,507,1065,54,15,11,326,336,31,32,0,0
4199,181,727,518,1067,54,15,11,337,340,32,32,1,0
4265,310,612,764,1067,54,15,11,454,455,0,32,0,0
4266,310,615,757,1065,54,15,11,447,450,1,32,0,0
4267,313,614,758,1063,54,15,11,445,449,2,32,0,0
4268,296,612,740,1062,54,15,11,444,450,3,32,0,0
4269,297,609,743,1061,54,15,11,446,452,4,32,0,0
4270,270,650,678,1061,54,15,11,408,411,5,32,0,0
4271,255,678,634,1058,54,15,11,379,380,6,32,0,0
4220,60,143,635,1039,55,15,11,575,896,0,1,0,0
4221,132,207,674,1051,55,15,11,542,844,1,1,0,0
4228,95,230,723,1046,57,15,11,628,816,0,1,0,0
4229,94,219,735,1053,57,15,11,641,834,1,1,0,0
4231,90,216,726,1039,59,15,11,636,823,0,1,0,0
4232,89,211,733,1045,59,15,11,644,834,1,1,0,0
4235,56,190,615,1008,60,15,11,559,818,0,0,0,0
4237,98,138,727,1065,61,15,11,629,927,0,0,0,0
4240,99,148,745,1049,62,15,11,646,901,0,0,0,0
4446,254,629,686,1062,65,15,11,432,433,0,35,0,0
4447,260,632,687,1060,65,15,11,427,428,1,35,0,0
4448,258,637,678,1060,65,15,11,420,423,2,35,0,0
4449,225,603,680,1068,65,15,11,455,465,3,35,0,0
4450,234,620,662,1059,65,15,11,428,439,4,35,0,0
4451,227,632,643,1060,65,15,11,416,428,5,35,0,0
4452,222,646,630,1062,65,15,11,408,416,6,35,0,0
4453,208,657,615,1066,65,15,11,407,409,7,35,0,0
4489,364,593,823,1060,65,15,11,459,467,0,35,0,1
4490,369,561,850,1061,65,15,11,481,500,1,35,0,0
4491,387,533,886,1060,65,15,11,499,527,2,35,0,0
4492,405,513,914,1059,65,15,11,509,546,3,35,0,0
4493,420,498,936,1061,65,15,11,516,563,4,35,0,0
4494,438,444,989,1058,65,15,11,551,614,5,35,0,0
4495,473,440,1017,1059,65,15,11,544,619,6,35,0,0
4496,501,433,1034,1059,65,15,11,533,626,7,35,0,0
4497,536,424,1064,1062,65,15,11,528,638,8,35,0,0
4498,569,429,1085,1067,65,15,11,516,638,9,35,0,0
4499,605,417,1117,1065,65,15,11,512,648,10,35,0,0
4500,638,398,1151,1068,65,15,11,513,670,11,35,0,0
4501,672,381,1177,1062,65,15,11,505,681,12,35,0,0
4502,706,377,1198,1062,65,15,11,492,685,13,35,0,0
4503,720,373,1197,1060,65,15,11,477,687,14,35,0,0
4504,725,366,1194,1060,65,15,11,469,694,15,35,0,0
4505,723,361,1187,1061,65,15,11,464,700,16,35,0,0
4506,715,375,1169,1064,65,15,11,454,689,17,35,0,0
4507,693,388,1137,1063,65,15,11,444,675,18,35,0,0
4508,668,391,1106,1060,65,15,11,438,669,19,35,0,0
4509,632,414,1050,1061,65,15,11,418,647,20,35,0,0
4510,613,434,1011,1059,65,15,11,398,625,21,35,0,0
4511,598,455,984,1061,65,15,11,386,606,22,35,0,0
4512,578,484,948,1059,65,15,11,370,575,23,35,0,0
4513,558,516,914,1061,65,15,11,356,545,24,35,0,0
4514,535,550,876,1061,65,15,11,341,511,25,35,0,0
4515,495,590,825,1060,65,15,11,330,470,26,35,0,0
4516,433,624,755,1063,65,15,11,322,439,27,35,0,0
4517,363,648,675,1062,65,15,11,312,414,28,35,0,0
4518,275,665,587,1062,65,15,11,312,397,29,35,0,0
4519,228,680,545,1067,65,15,11,317,387,30,35,0,0
4520,222,694,537,1066,65,15,11,315,372,31,35,0,0
4521,210,715,518,1065,65,15,11,308,350,32,35,0,0
4522,190,736,491,1066,65,15,11,301,330,33,35,0,0
4523,164,759,453,1067,65,15,11,289,308,34,35,0,0
4524,151,776,432,1064,65,15,11,281,288,35,35,1,0
4581,311,590,780,1063,65,15,11,469,473,0,35,0,0
4582,310,590,775,1063,65,15,11,465,473,1,35,0,0
4583,310,590,770,1062,65,15,11,460,472,2,35,0,0
4584,312,590,768,1062,65,15,11,456,472,3,35,0,0
4585,313,589,766,1062,65,15,11,453,473,4,35,0,0
4586,309,594,755,1059,65,15,11,446,465,5,35,0,0
4587,313,610,741,1053,65,15,11,428,443,6,35,0,0
4588,310,621,734,1060,65,15,11,424,439,7,35,0,0
4589,297,641,703,1061,65,15,11,406,420,8,35,0,0
4590,295,673,678,1063,65,15,11,383,390,9,35,0,0
4591,269,706,624,1066,65,15,11,355,360,10,35,0,0
4747,410,467,986,1051,65,15,11,576,584,0,35,0,1
4748,430,460,1006,1059,65,15,11,576,599,1,35,0,0
4749,450,453,1019,1059,65,15,11,569,606,2,35,0,0
4750,469,449,1028,1059,65,15,11,559,610,3,35,0,0
4751,485,447,1033,1061,65,15,11,548,614,4,35,0,0
4752,494,417,1047,1060,65,15,11,553,643,5,35,0,0
4753,519,428,1050,1066,65,15,11,531,638,6,35,0,0
4754,528,433,1042,1068,65,15,11,514,635,7,35,0,0
4755,524,438,1024,1069,65,15,11,500,631,8,35,0,0
4756,515,454,993,1065,65,15,11,478,611,9,35,0,0
4757,507,478,964,1063,65,15,11,457,585,10,35,0,0
4758,485,496,929,1062,65,15,11,444,566,11,35,0,0
4759,457,518,884,1062,65,15,11,427,544,12,35,0,0
4760,432,539,841,1062,65,15,11,409,523,13,35,0,0
4761,410,554,807,1062,65,15,11,397,508,14,35,0,0
4762,391,591,766,1062,65,15,11,375,471,15,35,0,0
4763,365,624,718,1062,65,15,11,353,438,16,35,0,0
4764,325,654,662,1062,65,15,11,337,408,17,35,0,0
4765,309,682,630,1062,65,15,11,321,380,18,35,0,0
4766,293,710,604,1067,65,15,11,311,357,19,35,0,0
4767,251,729,557,1070,65,15,11,306,341,20,35,0,0
4768,207,738,509,1072,65,15,11,302,334,21,35,0,0
4769,183,754,474,1071,65,15,11,291,317,22,35,0,0
4770,160,768,438,1066,65,15,11,278,298,23,35,0,0
4771,153,777,431,1068,65,15,11,278,291,24,35,0,0
4772,130,795,399,1069,65,15,11,269,274,25,35,0,0
4436,130,138,792,1063,66,15,11,662,925,0,0,0,0
5280,389,542,899,1061,67,15,11,510,519,0,45,0,1
5281,416,533,921,1061,67,15,11,505,528,1,45,0,0
5282,454,525,961,1065,67,15,11,507,540,2,45,0,0
5283,486,501,1000,1062,67,15,11,514,561,3,45,0,0
5284,498,471,1029,1069,67,15,11,531,598,4,45,0,0
5285,511,430,1060,1069,67,15,11,549,639,5,45,0,0
5286,547,425,1080,1066,67,15,11,533,641,6,45,0,0
5287,583,394,1117,1055,67,15,11,534,661,7,45,0,0
5288,623,383,1152,1049,67,15,11,529,666,8,45,0,0
5289,636,368,1169,1057,67,15,11,533,689,9,45,0,0
5290,650,342,1185,1055,67,15,11,535,713,10,45,0,0
5291,672,317,1199,1043,67,15,11,527,726,11,45,0,0
5292,698,292,1212,1020,67,15,11,514,728,12,45,0,0
5293,718,276,1217,998,67,15,11,499,722,13,45,0,0
5294,731,270,1209,976,67,15,11,478,706,14,45,0,0
5295,723,271,1186,969,67,15,11,463,698,15,45,0,0
5296,724,277,1148,926,67,15,11,424,649,16,45,0,0
5297,720,271,1123,904,67,15,11,403,633,17,45,0,0
5298,715,273,1108,911,67,15,11,393,638,18,45,0,0
5299,724,270,1103,904,67,15,11,379,634,19,45,0,0
5300,729,263,1097,897,67,15,11,368,634,20,45,0,0
5301,730,256,1089,889,67,15,11,359,633,21,45,0,0
5302,723,257,1074,890,67,15,11,351,633,22,45,0,0
5303,715,263,1067,908,67,15,11,352,645,23,45,0,0
5304,710,269,1066,936,67,15,11,356,667,24,45,0,0
5305,718,278,1069,948,67,15,11,351,670,25,45,0,0
5306,727,293,1071,956,67,15,11,344,663,26,45,0,0
5307,728,301,1063,955,67,15,11,335,654,27,45,0,0
5308,729,313,1066,973,67,15,11,337,660,28,45,0,0
5309,720,331,1073,1024,67,15,11,353,693,29,45,0,0
5310,697,348,1057,1050,67,15,11,360,702,30,45,0,0
5311,676,380,1029,1058,67,15,11,353,678,31,45,0,0
5312,644,407,984,1050,67,15,11,340,643,32,45,0,0
5313,610,435,940,1052,67,15,11,330,617,33,45,0,0
5314,597,468,903,1021,67,15,11,306,553,34,45,0,0
5315,577,490,885,1035,67,15,11,308,545,35,45,0,0
5316,569,525,880,1059,67,15,11,311,534,36,45,0,0
5317,552,551,862,1064,67,15,11,310,513,37,45,0,0
5318,530,583,836,1069,67,15,11,306,486,38,45,0,0
5319,499,619,791,1054,67,15,11,292,435,39,45,0,0
5320,423,648,710,1057,67,15,11,287,409,40,45,0,0
5321,363,675,649,1063,67,15,11,286,388,41,45,0,0
5322,313,712,590,1067,67,15,11,277,355,42,45,0,0
5323,273,757,532,1069,67,15,11,259,312,43,45,0,0
5324,229,805,462,1070,67,15,11,233,265,44,45,0,0
5325,194,849,407,1076,67,15,11,213,227,45,45,1,0
5020,219,669,595,1069,68,15,11,376,400,0,6,0,0
5021,242,687,593,1060,68,15,11,351,373,1,6,0,0
5022,273,697,620,1063,68,15,11,347,366,2,6,0,0
5023,305,707,648,1066,68,15,11,343,359,3,6,0,0
5024,322,715,667,1073,68,15,11,345,358,4,6,0,0
5025,330,724,671,1075,68,15,11,341,351,5,6,0,0
5026,327,728,664,1070,68,15,11,337,342,6,6,0,0
5479,322,593,785,1058,71,15,11,463,465,0,45,0,1
5480,326,591,786,1057,71,15,11,460,466,1,45,0,0
5481,326,587,787,1058,71,15,11,461,471,2,45,0,0
5482,328,586,786,1058,71,15,11,458,472,3,45,0,0
5483,331,588,784,1059,71,15,11,453,471,4,45,0,0
5484,332,590,781,1059,71,15,11,449,469,5,45,0,0
5485,334,590,779,1060,71,15,11,445,470,6,45,0,0
5486,333,589,778,1062,71,15,11,445,473,7,45,0,0
5487,333,589,776,1062,71,15,11,443,473,8,45,0,0
5488,334,590,775,1063,71,15,11,441,473,9,45,0,0
5489,334,590,773,1063,71,15,11,439,473,10,45,0,0
5490,335,591,771,1062,71,15,11,436,471,11,45,0,0
5491,339,591,768,1058,71,15,11,429,467,12,45,0,0
5492,340,592,765,1058,71,15,11,425,466,13,45,0,0
5493,341,592,761,1055,71,15,11,420,463,14,45,0,0
5494,344,600,759,1058,71,15,11,415,458,15,45,0,0
5495,347,602,760,1060,71,15,11,413,458,16,45,0,0
5496,344,598,760,1060,71,15,11,416,462,17,45,0,0
5497,344,597,760,1060,71,15,11,416,463,18,45,0,0
5498,344,597,760,1061,71,15,11,416,464,19,45,0,0
5499,345,596,761,1061,71,15,11,416,465,20,45,0,0
5500,345,596,760,1060,71,15,11,415,464,21,45,0,0
5501,345,597,758,1060,71,15,11,413,463,22,45,0,0
5502,345,597,757,1060,71,15,11,412,463,23,45,0,0
5503,345,600,757,1061,71,15,11,412,461,24,45,0,0
5504,346,602,756,1061,71,15,11,410,459,25,45,0,0
5505,348,602,758,1061,71,15,11,410,459,26,45,0,0
5506,348,601,758,1060,71,15,11,410,459,27,45,0,0
5507,347,600,759,1060,71,15,11,412,460,28,45,0,0
5508,346,600,759,1062,71,15,11,413,462,29,45,0,0
5509,342,592,761,1063,71,15,11,419,471,30,45,0,0
5510,339,590,756,1058,71,15,11,417,468,31,45,0,0
5511,339,604,746,1061,71,15,11,407,457,32,45,0,0
5512,341,619,739,1064,71,15,11,398,445,33,45,0,0
5513,349,635,736,1064,71,15,11,387,429,34,45,0,0
5514,363,652,738,1065,71,15,11,375,413,35,45,0,0
5515,364,666,734,1066,71,15,11,370,400,36,45,0,0
5516,363,675,728,1064,71,15,11,365,389,37,45,0,0
5517,350,688,707,1065,71,15,11,357,377,38,45,0,0
5518,324,697,681,1068,71,15,11,357,371,39,45,0,0
5519,289,697,644,1064,71,15,11,355,367,40,45,0,0
5520,244,694,595,1061,71,15,11,351,367,41,45,0,0
5521,237,691,594,1065,71,15,11,357,374,42,45,0,0
5522,229,696,584,1065,71,15,11,355,369,43,45,0,0
5523,210,704,565,1069,71,15,11,355,365,44,45,0,0
5524,197,728,534,1067,71,15,11,337,339,45,45,1,0
5751,128,332,834,1045,71,15,11,706,713,0,45,0,0
5752,172,496,729,1061,71,15,11,557,565,1,45,0,0
5753,201,584,679,1071,71,15,11,478,487,2,45,0,0
5754,201,638,627,1071,71,15,11,426,433,3,45,0,0
5532,1760,673,1920,1074,72,15,11,160,401,0,8,0,0
5533,1724,488,1920,1079,72,15,11,196,591,1,8,0,0
5534,1679,395,1920,1068,72,15,11,241,673,2,8,0,0
5535,1621,384,1895,1068,72,15,11,274,684,3,8,0,0
5536,1566,421,1830,1066,72,15,11,264,645,4,8,0,0
5537,1487,467,1741,1066,72,15,11,254,599,5,8,0,0
5538,1385,529,1622,1070,72,15,11,237,541,6,8,0,0
5539,1257,636,1460,1061,72,15,11,203,425,7,8,0,0
5540,1195,651,1390,1059,72,15,11,195,408,8,8,0,0
5535,1816,860,1919,1071,73,15,11,103,211,0,0,0,0
5619,1416,546,1920,1078,79,15,11,504,532,0,0,0,0
5618,1150,315,1534,1063,80,15,11,384,748,0,7,0,0
5619,1254,282,1653,1059,80,15,11,399,777,1,7,0,0
5620,1339,242,1760,1065,80,15,11,421,823,2,7,0,0
5621,1425,224,1854,1067,80,15,11,429,843,3,7,0,0
5622,1489,208,1920,1064,80,15,11,431,856,4,7,0,0
5623,1597,185,1920,1072,80,15,11,323,887,5,7,0,0
5624,1664,279,1920,1051,80,15,11,256,772,6,7,0,0
5625,1732,279,1920,1049,80,15,11,188,770,7,7,0,0
5620,1682,722,1913,1080,81,15,11,231,358,0,0,0,0
5625,1770,812,1920,1014,82,15,11,150,202,0,0,0,0
5771,107,242,702,1040,84,15,11,595,798,0,0,0,0
5774,100,236,693,1039,85,15,11,593,803,0,0,0,0
944,324,108,360,179,1,15,12,36,71,0,5,0,0
945,319,108,357,182,1,15,12,38,74,1,5,0,0
946,317,109,355,183,1,15,12,38,74,2,5,0,0
947,316,109,351,180,1,15,12,35,71,3,5,0,0
948,314,109,350,180,1,15,12,36,71,4,5,0,0
949,310,110,347,184,1,15,12,37,74,5,5,0,0
3328,321,110,370,183,10,15,12,49,73,0,3,0,0
3329,321,112,368,185,10,15,12,47,73,1,3,0,0
3330,321,114,367,187,10,15,12,46,73,2,3,0,0
3331,317,114,367,192,10,15,12,50,78,3,3,0,0
3356,335,114,370,210,11,15,12,35,96,0,81,0,0
3361,338,116,374,218,11,15,12,36,102,0,81,0,0
3364,339,119,374,222,11,15,12,35,103,0,81,0,1
3365,341,121,376,223,11,15,12,35,102,1,81,0,0
3366,345,121,381,226,11,15,12,36,105,2,81,0,0
3367,346,120,383,229,11,15,12,37,109,3,81,0,0
3368,347,122,384,230,11,15,12,37,108,4,81,0,0
3369,347,122,384,232,11,15,12,37,110,5,81,0,0
3370,348,121,388,238,11,15,12,40,117,6,81,0,0
3371,351,122,392,242,11,15,12,41,120,7,81,0,0
3372,353,121,395,243,11,15,12,42,122,8,81,0,0
3373,355,122,396,242,11,15,12,41,120,9,81,0,0
3374,356,124,397,244,11,15,12,41,120,10,81,0,0
3375,357,123,398,244,11,15,12,41,121,11,81,0,0
3376,359,129,398,245,11,15,12,39,116,12,81,0,0
3377,360,130,399,246,11,15,12,39,116,13,81,0,0
3378,360,128,401,249,11,15,12,41,121,14,81,0,0
3379,361,132,401,251,11,15,12,40,119,15,81,0,0
3380,361,132,402,254,11,15,12,41,122,16,81,0,0
3381,362,135,403,257,11,15,12,41,122,17,81,0,0
3382,364,137,406,259,11,15,12,42,122,18,81,0,0
3383,367,140,408,263,11,15,12,41,123,19,81,0,0
3384,368,138,412,265,11,15,12,44,127,20,81,0,0
3385,368,137,413,269,11,15,12,45,132,21,81,0,0
3386,371,135,417,272,11,15,12,46,137,22,81,0,0
3387,372,137,419,275,11,15,12,47,138,23,81,0,0
3388,374,138,421,280,11,15,12,47,142,24,81,0,0
3389,374,137,422,283,11,15,12,48,146,25,81,0,0
3390,375,142,422,287,11,15,12,47,145,26,81,0,0
3391,374,140,423,290,11,15,12,49,150,27,81,0,0
3392,374,143,423,295,11,15,12,49,152,28,81,0,0
3393,376,144,425,298,11,15,12,49,154,29,81,0,0
3394,378,146,427,299,11,15,12,49,153,30,81,0,0
3395,379,147,429,304,11,15,12,50,157,31,81,0,0
3396,379,148,431,310,11,15,12,52,162,32,81,0,0
3397,379,145,434,317,11,15,12,55,172,33,81,0,0
3398,382,149,438,323,11,15,12,56,174,34,81,0,0
3399,388,150,444,325,11,15,12,56,175,35,81,0,0
3400,392,150,450,333,11,15,12,58,183,36,81,0,0
3401,394,151,453,339,11,15,12,59,188,37,81,0,0
3402,397,151,457,342,11,15,12,60,191,38,81,0,0
3403,398,151,461,352,11,15,12,63,201,39,81,0,0
3404,401,152,465,355,11,15,12,64,203,40,81,0,0
3405,405,150,471,361,11,15,12,66,211,41,81,0,0
3406,408,159,474,370,11,15,12,66,211,42,81,0,0
3407,409,159,477,376,11,15,12,68,217,43,81,0,0
3408,414,162,484,385,11,15,12,70,223,44,81,0,0
3409,420,165,492,396,11,15,12,72,231,45,81,0,0
3410,426,167,498,398,11,15,12,72,231,46,81,0,0
3411,432,171,505,405,11,15,12,73,234,47,81,0,0
3412,432,173,509,421,11,15,12,77,248,48,81,0,0
3413,433,170,514,432,11,15,12,81,262,49,81,0,0
3414,441,178,523,443,11,15,12,82,265,50,81,0,0
3415,448,180,534,455,11,15,12,86,275,51,81,0,0
3416,451,183,541,468,11,15,12,90,285,52,81,0,0
3417,453,194,546,490,11,15,12,93,296,53,81,0,0
3418,460,196,553,492,11,15,12,93,296,54,81,0,0
3419,467,199,566,511,11,15,12,99,312,55,81,0,0
3420,478,204,581,528,11,15,12,103,324,56,81,0,0
3421,490,203,597,537,11,15,12,107,334,57,81,0,0
3422,501,213,612,561,11,15,12,111,348,58,81,0,0
3423,512,223,626,576,11,15,12,114,353,59,81,0,0
3424,524,224,644,589,11,15,12,120,365,60,81,0,0
3425,542,232,671,624,11,15,12,129,392,61,81,0,0
3426,554,233,688,638,11,15,12,134,405,62,81,0,0
3427,565,239,706,671,11,15,12,141,432,63,81,0,0
3428,575,255,722,709,11,15,12,147,454,64,81,0,0
3429,589,259,739,722,11,15,12,150,463,65,81,0,0
3430,612,274,769,755,11,15,12,157,481,66,81,0,0
3431,627,290,792,794,11,15,12,165,504,67,81,0,0
3432,643,295,816,820,11,15,12,173,525,68,81,0,0
3433,656,314,846,889,11,15,12,190,575,69,81,0,0
3434,664,324,865,927,11,15,12,201,603,70,81,0,0
3435,685,335,899,969,11,15,12,214,634,71,81,0,0
3436,703,356,928,1025,11,15,12,225,669,72,81,0,0
3437,736,370,965,1047,11,15,12,229,677,73,81,0,0
3438,763,381,998,1070,11,15,12,235,689,74,81,0,0
3439,774,412,1004,1080,11,15,12,230,668,75,81,0,0
3440,777,435,1006,1078,11,15,12,229,643,76,81,0,0
3441,766,472,993,1080,11,15,12,227,608,77,81,0,0
3442,750,530,970,1080,11,15,12,220,550,78,81,0,0
3443,709,582,920,1080,11,15,12,211,498,79,81,0,0
3444,635,621,842,1075,11,15,12,207,454,80,81,0,0
3445,630,646,831,1080,11,15,12,201,434,81,81,1,0
3368,304,121,339,227,16,15,12,35,106,0,74,0,1
3369,305,125,340,228,16,15,12,35,103,1,74,0,0
3370,305,123,341,232,16,15,12,36,109,2,74,0,0
3371,304,123,342,235,16,15,12,38,112,3,74,0,0
3372,307,126,342,231,16,15,12,35,105,4,74,0,0
3373,306,123,345,237,16,15,12,39,114,5,74,0,0
3374,306,125,346,241,16,15,12,40,116,6,74,0,0
3375,309,128,349,243,16,15,12,40,115,7,74,0,0
3376,309,129,350,245,16,15,12,41,116,8,74,0,0
3377,315,129,355,247,16,15,12,40,118,9,74,0,0
3378,317,131,357,249,16,15,12,40,118,10,74,0,0
3379,316,126,359,254,16,15,12,43,128,11,74,0,0
3380,316,127,360,259,16,15,12,44,132,12,74,0,0
3381,318,125,362,260,16,15,12,44,135,13,74,0,0
3382,318,129,362,264,16,15,12,44,135,14,74,0,0
3383,317,131,362,268,16,15,12,45,137,15,74,0,0
3384,318,128,364,268,16,15,12,46,140,16,74,0,0
3385,317,129,363,272,16,15,12,46,143,17,74,0,0
3386,317,130,364,276,16,15,12,47,146,18,74,0,0
3387,315,130,364,280,16,15,12,49,150,19,74,0,0
3388,314,129,364,285,16,15,12,50,156,20,74,0,0
3389,313,131,363,286,16,15,12,50,155,21,74,0,0
3390,312,132,362,291,16,15,12,50,159,22,74,0,0
3391,311,126,365,297,16,15,12,54,171,23,74,0,0
3392,314,126,369,301,16,15,12,55,175,24,74,0,0
3393,317,141,367,303,16,15,12,50,162,25,74,0,0
3394,317,144,367,304,16,15,12,50,160,26,74,0,0
3395,316,140,367,308,16,15,12,51,168,27,74,0,0
3396,317,137,371,318,16,15,12,54,181,28,74,0,0
3397,318,134,374,323,16,15,12,56,189,29,74,0,0
3398,318,140,374,329,16,15,12,56,189,30,74,0,0
3399,318,139,376,335,16,15,12,58,196,31,74,0,0
3400,318,136,375,337,16,15,12,57,201,32,74,0,0
3401,320,145,376,342,16,15,12,56,197,33,74,0,0
3402,325,159,379,349,16,15,12,54,190,34,74,0,0
3403,328,142,390,357,16,15,12,62,215,35,74,0,0
3404,330,156,391,364,16,15,12,61,208,36,74,0,0
3405,331,159,392,367,16,15,12,61,208,37,74,0,0
3406,332,168,392,372,16,15,12,60,204,38,74,0,0
3407,335,168,398,383,16,15,12,63,215,39,74,0,0
3408,336,164,402,392,16,15,12,66,228,40,74,0,0
3409,339,165,408,402,16,15,12,69,237,41,74,0,0
3410,336,164,409,410,16,15,12,73,246,42,74,0,0
3411,337,164,411,417,16,15,12,74,253,43,74,0,0
3412,341,165,417,428,16,15,12,76,263,44,74,0,0
3413,347,168,425,433,16,15,12,78,265,45,74,0,0
3414,349,174,431,449,16,15,12,82,275,46,74,0,0
3415,351,181,436,460,16,15,12,85,279,47,74,0,0
3416,352,183,441,472,16,15,12,89,289,48,74,0,0
3417,355,189,448,489,16,15,12,93,300,49,74,0,0
3418,364,190,459,493,16,15,12,95,303,50,74,0,0
3419,370,197,470,513,16,15,12,100,316,51,74,0,0
3420,374,200,481,535,16,15,12,107,335,52,74,0,0
3421,377,201,490,549,16,15,12,113,348,53,74,0,0
3422,384,216,496,561,16,15,12,112,345,54,74,0,0
3423,392,224,509,583,16,15,12,117,359,55,74,0,0
3424,398,222,524,607,16,15,12,126,385,56,74,0,0
3425,401,230,538,647,16,15,12,137,417,57,74,0,0
3426,406,239,548,671,16,15,12,142,432,58,74,0,0
3427,414,255,559,693,16,15,12,145,438,59,74,0,0
3428,425,259,579,729,16,15,12,154,470,60,74,0,0
3429,443,268,602,753,16,15,12,159,485,61,74,0,0
3430,460,286,629,800,16,15,12,169,514,62,74,0,0
3431,466,300,645,845,16,15,12,179,545,63,74,0,0
3432,469,311,651,864,16,15,12,182,553,64,74,0,0
3433,467,327,659,908,16,15,12,192,581,65,74,0,0
3434,460,341,665,952,16,15,12,205,611,66,74,0,0
3435,441,358,657,993,16,15,12,216,635,67,74,0,0
3436,409,381,643,1050,16,15,12,234,669,68,74,0,0
3437,354,396,598,1074,16,15,12,244,678,69,74,0,0
3438,268,413,513,1080,16,15,12,245,667,70,74,0,0
3439,206,454,448,1080,16,15,12,242,626,71,74,0,0
3440,113,481,344,1077,16,15,12,231,596,72,74,0,0
3441,44,523,265,1080,16,15,12,221,557,73,74,0,0
3442,17,540,240,1080,16,15,12,223,540,74,74,1,0
3445,332,685,704,1071,18,15,12,372,386,0,0,0,0
3446,121,683,471,1066,19,15,12,350,383,0,0,0,0
3447,0,732,252,1079,20,15,12,252,347,0,0,0,0
3461,1871,387,1920,673,21,15,12,49,286,0,38,0,1
3462,1849,377,1901,677,21,15,12,52,300,1,38,0,0
3463,1828,356,1888,689,21,15,12,60,333,2,38,0,0
3464,1819,346,1883,690,21,15,12,64,344,3,38,0,0
3465,1808,343,1879,706,21,15,12,71,363,4,38,0,0
3466,1797,352,1873,715,21,15,12,76,363,5,38,0,0
3467,1786,351,1867,718,21,15,12,81,367,6,38,0,0
3468,1763,353,1853,724,21,15,12,90,371,7,38,0,0
3469,1742,356,1841,741,21,15,12,99,385,8,38,0,0
3470,1721,355,1831,760,21,15,12,110,405,9,38,0,0
3471,1707,349,1827,777,21,15,12,120,428,10,38,0,0
3472,1696,355,1828,815,21,15,12,132,460,11,38,0,0
3473,1683,366,1825,850,21,15,12,142,484,12,38,0,0
3474,1675,368,1822,854,21,15,12,147,486,13,38,0,0
3475,1632,376,1790,868,21,15,12,158,492,14,38,0,0
3476,1596,383,1768,889,21,15,12,172,506,15,38,0,0
3477,1569,385,1752,904,21,15,12,183,519,16,38,0,0
3478,1548,381,1744,931,21,15,12,196,550,17,38,0,0
3479,1506,384,1712,946,21,15,12,206,562,18,38,0,0
3480,1469,383,1686,964,21,15,12,217,581,19,38,0,0
3481,1425,379,1651,973,21,15,12,226,594,20,38,0,0
3482,1345,392,1583,994,21,15,12,238,602,21,38,0,0
3483,1276,387,1533,1023,21,15,12,257,636,22,38,0,0
3484,1243,384,1508,1045,21,15,12,265,661,23,38,0,0
3485,1180,389,1452,1060,21,15,12,272,671,24,38,0,0
3486,1132,394,1404,1067,21,15,12,272,673,25,38,0,0
3487,1074,391,1347,1074,21,15,12,273,683,26,38,0,0
3488,988,385,1267,1077,21,15,12,279,692,27,38,0,0
3489,906,401,1180,1074,21,15,12,274,673,28,38,0,0
3490,812,397,1086,1073,21,15,12,274,676,29,38,0,0
3491,702,392,979,1075,21,15,12,277,683,30,38,0,0
3492,601,418,875,1078,21,15,12,274,660,31,38,0,0
3493,475,428,747,1075,21,15,12,272,647,32,38,0,0
3494,359,430,633,1078,21,15,12,274,648,33,38,0,0
3495,268,441,543,1078,21,15,12,275,637,34,38,0,0
3496,148,454,418,1078,21,15,12,270,624,35,38,0,0
3497,42,458,313,1080,21,15,12,271,622,36,38,0,0
3498,0,481,251,1080,21,15,12,251,599,37,38,0,0
3499,0,488,170,1080,21,15,12,170,592,38,38,1,0
3468,1846,408,1920,692,22,15,12,74,284,0,28,0,1
3469,1836,399,1916,705,22,15,12,80,306,1,28,0,0
3470,1830,396,1913,711,22,15,12,83,315,2,28,0,0
3471,1822,402,1909,729,22,15,12,87,327,3,28,0,0
3472,1816,420,1907,757,22,15,12,91,337,4,28,0,0
3473,1810,419,1903,761,22,15,12,93,342,5,28,0,0
3474,1794,435,1889,769,22,15,12,95,334,6,28,0,0
3475,1781,438,1881,779,22,15,12,100,341,7,28,0,0
3476,1769,439,1882,818,22,15,12,113,379,8,28,0,0
3477,1755,456,1880,867,22,15,12,125,411,9,28,0,0
3478,1749,462,1881,887,22,15,12,132,425,10,28,0,0
3479,1736,473,1876,905,22,15,12,140,432,11,28,0,0
3480,1730,489,1881,944,22,15,12,151,455,12,28,0,0
3481,1725,491,1884,959,22,15,12,159,468,13,28,0,0
3482,1716,499,1891,1006,22,15,12,175,507,14,28,0,0
3483,1707,521,1891,1042,22,15,12,184,521,15,28,0,0
3484,1680,532,1875,1065,22,15,12,195,533,16,28,0,0
3485,1644,550,1847,1080,22,15,12,203,530,17,28,0,0
3486,1622,564,1828,1080,22,15,12,206,516,18,28,0,0
3487,1611,571,1817,1079,22,15,12,206,508,19,28,0,0
3488,1591,592,1793,1079,22,15,12,202,487,20,28,0,0
3489,1537,619,1744,1080,22,15,12,207,461,21,28,0,0
3490,1486,647,1694,1080,22,15,12,208,433,22,28,0,0
3491,1428,665,1634,1075,22,15,12,206,410,23,28,0,0
3492,1348,668,1564,1080,22,15,12,216,412,24,28,0,0
3493,1262,700,1477,1080,22,15,12,215,380,25,28,0,0
3494,1175,726,1386,1077,22,15,12,211,351,26,28,0,0
3495,1048,748,1256,1075,22,15,12,208,327,27,28,0,0
3496,993,765,1194,1080,22,15,12,201,315,28,28,1,0
3502,0,872,110,1070,23,15,12,110,198,0,0,0,0
3617,1862,392,1918,664,24,15,12,56,272,0,34,0,1
3618,1858,360,1919,656,24,15,12,61,296,1,34,0,0
3619,1842,356,1909,676,24,15,12,67,320,2,34,0,0
3620,1835,363,1905,690,24,15,12,70,327,3,34,0,0
3621,1830,365,1903,704,24,15,12,73,339,4,34,0,0
3622,1815,380,1891,720,24,15,12,76,340,5,34,0,0
3623,1801,384,1882,729,24,15,12,81,345,6,34,0,0
3624,1778,379,1868,739,24,15,12,90,360,7,34,0,0
3625,1750,380,1849,753,24,15,12,99,373,8,34,0,0
3626,1736,374,1846,770,24,15,12,110,396,9,34,0,0
3627,1725,371,1841,781,24,15,12,116,410,10,34,0,0
3628,1693,376,1820,807,24,15,12,127,431,11,34,0,0
3629,1672,373,1809,823,24,15,12,137,450,12,34,0,0
3630,1627,381,1774,835,24,15,12,147,454,13,34,0,0
3631,1596,386,1752,849,24,15,12,156,463,14,34,0,0
3632,1577,386,1742,867,24,15,12,165,481,15,34,0,0
3633,1535,393,1711,900,24,15,12,176,507,16,34,0,0
3634,1502,403,1687,918,24,15,12,185,515,17,34,0,0
3635,1448,407,1649,941,24,15,12,201,534,18,34,0,0
3636,1401,415,1623,988,24,15,12,222,573,19,34,0,0
3637,1370,416,1603,1009,24,15,12,233,593,20,34,0,0
3638,1354,419,1593,1035,24,15,12,239,616,21,34,0,0
3639,1336,435,1579,1062,24,15,12,243,627,22,34,0,0
3640,1320,446,1564,1072,24,15,12,244,626,23,34,0,0
3641,1293,457,1541,1078,24,15,12,248,621,24,34,0,0
3642,1265,472,1514,1080,24,15,12,249,608,25,34,0,0
3643,1246,483,1497,1080,24,15,12,251,597,26,34,0,0
3644,1219,485,1475,1080,24,15,12,256,595,27,34,0,0
3645,1193,500,1446,1080,24,15,12,253,580,28,34,0,0
3646,1182,539,1423,1080,24,15,12,241,541,29,34,0,0
3647,1171,574,1407,1080,24,15,12,236,506,30,34,0,0
3648,1151,621,1384,1080,24,15,12,233,459,31,34,0,0
3649,1157,696,1372,1076,24,15,12,215,380,32,34,0,0
3650,1191,774,1379,1076,24,15,12,188,302,33,34,0,0
3651,1188,809,1358,1080,24,15,12,170,271,34,34,1,0
3630,1797,505,1918,919,25,15,12,121,414,0,0,0,0
3632,1730,510,1920,941,26,15,12,190,431,0,19,0,1
3633,1713,498,1914,954,26,15,12,201,456,1,19,0,0
3634,1707,505,1914,974,26,15,12,207,469,2,19,0,0
3635,1711,504,1920,979,26,15,12,209,475,3,19,0,0
3636,1711,498,1920,985,26,15,12,209,487,4,19,0,0
3637,1713,491,1920,989,26,15,12,207,498,5,19,0,0
3638,1711,497,1920,1003,26,15,12,209,506,6,19,0,0
3639,1710,501,1920,1008,26,15,12,210,507,7,19,0,0
3640,1714,516,1920,1001,26,15,12,206,485,8,19,0,0
3641,1706,529,1916,1014,26,15,12,210,485,9,19,0,0
3642,1693,549,1904,1029,26,15,12,211,480,10,19,0,0
3643,1671,549,1896,1055,26,15,12,225,506,11,19,0,0
3644,1658,542,1887,1062,26,15,12,229,520,12,19,0,0
3645,1632,566,1846,1037,26,15,12,214,471,13,19,0,0
3646,1577,577,1803,1065,26,15,12,226,488,14,19,0,0
3647,1544,593,1772,1073,26,15,12,228,480,15,19,0,0
3648,1478,610,1710,1072,26,15,12,232,462,16,19,0,0
3649,1429,606,1668,1073,26,15,12,239,467,17,19,0,0
3650,1402,621,1635,1080,26,15,12,233,459,18,19,0,0
3651,1378,630,1610,1080,26,15,12,232,450,19,19,0,0
3651,1148,666,1522,1068,27,15,12,374,402,0,3,0,0
3652,1081,677,1448,1073,27,15,12,367,396,1,3,0,0
3653,966,695,1313,1073,27,15,12,347,378,2,3,0,0
3654,907,704,1247,1074,27,15,12,340,370,3,3,0,0
3654,796,701,1021,1080,28,15,12,225,379,0,0,0,0
3655,598,693,849,1072,29,15,12,251,379,0,0,0,0
3656,392,737,646,1068,30,15,12,254,331,0,0,0,0
3657,198,743,466,1075,31,15,12,268,332,0,1,0,0
3658,77,716,366,1072,31,15,12,289,356,1,1,0,0
4152,298,392,582,1047,34,15,12,284,655,0,68,0,1
4153,296,381,581,1037,34,15,12,285,656,1,68,0,0
4154,294,361,564,984,34,15,12,270,623,2,68,0,0
4155,277,329,532,921,34,15,12,255,592,3,68,0,0
4156,264,325,508,892,34,15,12,244,567,4,68,0,0
4157,269,304,490,819,34,15,12,221,515,5,68,0,0
4158,269,293,480,790,34,15,12,211,497,6,68,0,0
4159,273,289,475,767,34,15,12,202,478,7,68,0,0
4160,275,263,466,718,34,15,12,191,455,8,68,0,0
4161,269,259,449,691,34,15,12,180,432,9,68,0,0
4162,267,249,437,661,34,15,12,170,412,10,68,0,0
4163,262,236,428,643,34,15,12,166,407,11,68,0,0
4164,262,237,422,634,34,15,12,160,397,12,68,0,0
4165,264,225,412,598,34,15,12,148,373,13,68,0,0
4166,265,223,405,578,34,15,12,140,355,14,68,0,0
4167,265,220,396,557,34,15,12,131,337,15,68,0,0
4168,261,213,388,544,34,15,12,127,331,16,68,0,0
4169,261,212,383,536,34,15,12,122,324,17,68,0,0
4170,266,200,380,507,34,15,12,114,307,18,68,0,0
4171,270,199,379,494,34,15,12,109,295,19,68,0,0
4172,270,194,376,481,34,15,12,106,287,20,68,0,0
4173,266,183,371,471,34,15,12,105,288,21,68,0,0
4174,267,183,369,467,34,15,12,102,284,22,68,0,0
4175,275,185,369,447,34,15,12,94,262,23,68,0,0
4176,278,181,370,439,34,15,12,92,258,24,68,0,0
4177,277,176,366,429,34,15,12,89,253,25,68,0,0
4178,273,176,360,419,34,15,12,87,243,26,68,0,0
4179,271,177,355,414,34,15,12,84,237,27,68,0,0
4180,273,176,352,399,34,15,12,79,223,28,68,0,0
4181,271,173,350,394,34,15,12,79,221,29,68,0,0
4182,269,172,348,390,34,15,12,79,218,30,68,0,0
4183,265,171,343,383,34,15,12,78,212,31,68,0,0
4184,263,169,337,371,34,15,12,74,202,32,68,0,0
4185,264,171,336,367,34,15,12,72,196,33,68,0,0
4186,265,165,336,361,34,15,12,71,196,34,68,0,0
4187,265,166,335,357,34,15,12,70,191,35,68,0,0
4188,263,163,332,352,34,15,12,69,189,36,68,0,0
4189,262,160,330,346,34,15,12,68,186,37,68,0,0
4190,264,160,329,338,34,15,12,65,178,38,68,0,0
4191,268,156,332,334,34,15,12,64,178,39,68,0,0
4192,272,158,333,326,34,15,12,61,168,40,68,0,0
4193,272,155,334,324,34,15,12,62,169,41,68,0,0
4194,271,152,333,320,34,15,12,62,168,42,68,0,0
4195,272,152,332,317,34,15,12,60,165,43,68,0,0
4196,274,150,334,313,34,15,12,60,163,44,68,0,0
4197,277,149,336,309,34,15,12,59,160,45,68,0,0
4198,277,149,334,304,34,15,12,57,155,46,68,0,0
4199,276,145,333,299,34,15,12,57,154,47,68,0,0
4200,278,144,333,294,34,15,12,55,150,48,68,0,0
4201,279,144,334,291,34,15,12,55,147,49,68,0,0
4202,279,142,333,287,34,15,12,54,145,50,68,0,0
4203,280,142,332,286,34,15,12,52,144,51,68,0,0
4204,278,144,328,282,34,15,12,50,138,52,68,0,0
4205,277,143,326,279,34,15,12,49,136,53,68,0,0
4206,276,142,324,277,34,15,12,48,135,54,68,0,0
4207,277,141,323,274,34,15,12,46,133,55,68,0,0
4208,275,140,322,274,34,15,12,47,134,56,68,0,0
4209,274,142,318,271,34,15,12,44,129,57,68,0,0
4210,272,137,316,267,34,15,12,44,130,58,68,0,0
4211,273,138,314,262,34,15,12,41,124,59,68,0,0
4212,273,138,313,258,34,15,12,40,120,60,68,0,0
4213,274,137,312,254,34,15,12,38,117,61,68,0,0
4214,274,139,312,255,34,15,12,38,116,62,68,0,0
4215,274,137,310,252,34,15,12,36,115,63,68,0,0
4216,273,135,309,251,34,15,12,36,116,64,68,0,0
4217,274,134,310,249,34,15,12,36,115,65,68,0,0
4218,276,134,312,248,34,15,12,36,114,66,68,0,0
4219,276,134,312,248,34,15,12,36,114,67,68,0,0
4220,276,133,311,244,34,15,12,35,111,68,68,1,0
5329,1842,405,1919,667,35,15,12,77,262,0,31,0,1
5330,1838,363,1920,669,35,15,12,82,306,1,31,0,0
5331,1833,357,1920,673,35,15,12,87,316,2,31,0,0
5332,1816,364,1919,714,35,15,12,103,350,3,31,0,0
5333,1793,357,1901,724,35,15,12,108,367,4,31,0,0
5334,1760,365,1872,727,35,15,12,112,362,5,31,0,0
5335,1738,361,1854,727,35,15,12,116,366,6,31,0,0
5336,1723,361,1849,753,35,15,12,126,392,7,31,0,0
5337,1719,369,1846,759,35,15,12,127,390,8,31,0,0
5338,1703,371,1838,780,35,15,12,135,409,9,31,0,0
5339,1669,374,1814,797,35,15,12,145,423,10,31,0,0
5340,1644,383,1797,815,35,15,12,153,432,11,31,0,0
5341,1627,382,1787,827,35,15,12,160,445,12,31,0,0
5342,1611,388,1782,861,35,15,12,171,473,13,31,0,0
5343,1584,401,1767,900,35,15,12,183,499,14,31,0,0
5344,1562,401,1753,912,35,15,12,191,511,15,31,0,0
5345,1496,406,1699,929,35,15,12,203,523,16,31,0,0
5346,1443,406,1661,957,35,15,12,218,551,17,31,0,0
5347,1407,403,1635,979,35,15,12,228,576,18,31,0,0
5348,1357,409,1605,1025,35,15,12,248,616,19,31,0,0
5349,1311,421,1569,1054,35,15,12,258,633,20,31,0,0
5350,1255,423,1521,1067,35,15,12,266,644,21,31,0,0
5351,1158,432,1439,1080,35,15,12,281,648,22,31,0,0
5352,1114,439,1397,1080,35,15,12,283,641,23,31,0,0
5353,1089,433,1373,1080,35,15,12,284,647,24,31,0,0
5354,1070,460,1345,1080,35,15,12,275,620,25,31,0,0
5355,1037,492,1302,1080,35,15,12,265,588,26,31,0,0
5356,1011,526,1270,1080,35,15,12,259,554,27,31,0,0
5357,995,588,1240,1080,35,15,12,245,492,28,31,0,0
5358,972,663,1199,1077,35,15,12,227,414,29,31,0,0
5359,944,755,1154,1075,35,15,12,210,320,30,31,0,0
5360,922,791,1112,1080,35,15,12,190,289,31,31,1,0
5336,1838,428,1920,878,36,15,12,82,450,0,22,0,1
5337,1841,473,1915,881,36,15,12,74,408,1,22,0,0
5338,1826,466,1904,890,36,15,12,78,424,2,22,0,0
5339,1799,414,1896,930,36,15,12,97,516,3,22,0,0
5340,1795,431,1893,938,36,15,12,98,507,4,22,0,0
5341,1785,455,1889,978,36,15,12,104,523,5,22,0,0
5342,1758,480,1871,1016,36,15,12,113,536,6,22,0,0
5343,1750,483,1871,1029,36,15,12,121,546,7,22,0,0
5344,1716,483,1851,1038,36,15,12,135,555,8,22,0,0
5345,1683,502,1833,1068,36,15,12,150,566,9,22,0,0
5346,1660,491,1827,1079,36,15,12,167,588,10,22,0,0
5347,1646,483,1827,1080,36,15,12,181,597,11,22,0,0
5348,1619,488,1811,1080,36,15,12,192,592,12,22,0,0
5349,1606,506,1804,1080,36,15,12,198,574,13,22,0,0
5350,1578,513,1789,1080,36,15,12,211,567,14,22,0,0
5351,1583,532,1805,1076,36,15,12,222,544,15,22,0,0
5352,1581,556,1810,1076,36,15,12,229,520,16,22,0,0
5353,1573,571,1809,1078,36,15,12,236,507,17,22,0,0
5354,1572,605,1802,1079,36,15,12,230,474,18,22,0,0
5355,1596,654,1813,1078,36,15,12,217,424,19,22,0,0
5356,1645,706,1845,1074,36,15,12,200,368,20,22,0,0
5357,1689,768,1867,1079,36,15,12,178,311,21,22,0,0
5358,1703,797,1867,1080,36,15,12,164,283,22,22,1,0
5358,1785,887,1917,1080,37,15,12,132,193,0,0,0,0
5811,1371,502,1920,1066,39,15,12,549,564,0,13,0,0
5812,1393,489,1920,1060,39,15,12,527,571,1,13,0,0
5813,1441,472,1920,1021,39,15,12,479,549,2,13,0,0
5814,1482,467,1918,975,39,15,12,436,508,3,13,0,0
5815,1506,464,1917,962,39,15,12,411,498,4,13,0,0
5816,1535,447,1920,936,39,15,12,385,489,5,13,0,0
5817,1587,441,1920,909,39,15,12,333,468,6,13,0,0
5818,1615,436,1920,899,39,15,12,305,463,7,13,0,0
5819,1654,430,1920,867,39,15,12,266,437,8,13,0,0
5820,1681,423,1920,842,39,15,12,239,419,9,13,0,0
5821,1700,430,1920,825,39,15,12,220,395,10,13,0,0
5822,1723,447,1920,810,39,15,12,197,363,11,13,0,0
5823,1751,437,1920,791,39,15,12,169,354,12,13,0,0
5824,1762,428,1920,774,39,15,12,158,346,13,13,0,0
5809,988,410,1606,1049,40,15,12,618,639,0,21,0,1
5810,1034,399,1602,1014,40,15,12,568,615,1,21,0,0
5811,1097,406,1606,977,40,15,12,509,571,2,21,0,0
5812,1184,396,1660,953,40,15,12,476,557,3,21,0,0
5813,1243,396,1684,932,40,15,12,441,536,4,21,0,0
5814,1307,390,1705,898,40,15,12,398,508,5,21,0,0
5815,1349,382,1716,868,40,15,12,367,486,6,21,0,0
5816,1390,380,1734,850,40,15,12,344,470,7,21,0,0
5817,1448,378,1772,836,40,15,12,324,458,8,21,0,0
5818,1481,378,1794,834,40,15,12,313,456,9,21,0,0
5819,1534,373,1816,799,40,15,12,282,426,10,21,0,0
5820,1560,378,1820,782,40,15,12,260,404,11,21,0,0
5821,1589,389,1832,770,40,15,12,243,381,12,21,0,0
5822,1631,382,1865,762,40,15,12,234,380,13,21,0,0
5823,1651,385,1879,764,40,15,12,228,379,14,21,0,0
5824,1680,372,1891,734,40,15,12,211,362,15,21,0,0
5825,1697,376,1891,714,40,15,12,194,338,16,21,0,0
5826,1715,365,1907,705,40,15,12,192,340,17,21,0,0
5827,1741,367,1920,717,40,15,12,179,350,18,21,0,0
5828,1761,377,1920,714,40,15,12,159,337,19,21,0,0
5829,1792,376,1920,671,40,15,12,128,295,20,21,0,0
5830,1816,373,1920,657,40,15,12,104,284,21,21,1,0
5825,1826,396,1920,777,41,15,12,94,381,0,1,0,0
5826,1839,388,1920,729,41,15,12,81,341,1,1,0,0
5829,1867,380,1920,521,42,15,12,53,141,0,0,0,0
5882,1873,368,1918,654,43,15,12,45,286,0,20,0,1
5883,1879,410,1918,659,43,15,12,39,249,1,20,0,0
5884,1873,398,1916,672,43,15,12,43,274,2,20,0,0
5885,1865,426,1913,727,43,15,12,48,301,3,20,0,0
5886,1853,427,1905,740,43,15,12,52,313,4,20,0,0
5887,1837,439,1888,723,43,15,12,51,284,5,20,0,0
5888,1824,440,1878,718,43,15,12,54,278,6,20,0,0
5889,1819,434,1880,730,43,15,12,61,296,7,20,0,0
5890,1807,440,1874,746,43,15,12,67,306,8,20,0,0
5891,1793,445,1865,753,43,15,12,72,308,9,20,0,0
5892,1770,448,1850,768,43,15,12,80,320,10,20,0,0
5893,1764,460,1851,790,43,15,12,87,330,11,20,0,0
5894,1754,460,1846,793,43,15,12,92,333,12,20,0,0
5895,1749,470,1849,823,43,15,12,100,353,13,20,0,0
5896,1734,494,1871,964,43,15,12,137,470,14,20,0,0
5897,1716,508,1867,1012,43,15,12,151,504,15,20,0,0
5898,1698,524,1858,1046,43,15,12,160,522,16,20,0,0
5899,1687,527,1854,1061,43,15,12,167,534,17,20,0,0
5900,1681,535,1851,1066,43,15,12,170,531,18,20,0,0
5901,1704,559,1861,1034,43,15,12,157,475,19,20,0,0
5902,1697,568,1858,1055,43,15,12,161,487,20,20,1,0
5904,1611,617,1771,1071,43,15,12,160,454,0,20,0,0
5905,1582,636,1744,1074,43,15,12,162,438,1,20,0,0
5906,1537,655,1709,1080,43,15,12,172,425,2,20,0,0
5907,1490,670,1671,1080,43,15,12,181,410,3,20,0,0
5908,1455,691,1643,1080,43,15,12,188,389,4,20,0,0
5909,1405,717,1598,1078,43,15,12,193,361,5,20,0,0
5910,1315,728,1517,1080,43,15,12,202,352,6,20,0,0
5911,1237,758,1433,1080,43,15,12,196,322,7,20,0,0
5912,1171,804,1347,1080,43,15,12,176,276,8,20,0,0
5913,1080,840,1238,1080,43,15,12,158,240,9,20,0,0
5914,1031,864,1177,1080,43,15,12,146,216,10,20,0,0
5888,1843,576,1917,873,45,15,12,74,297,0,0,0,0
5892,1790,546,1918,896,46,15,12,128,350,0,0,0,0
5901,1832,646,1920,985,48,15,12,88,339,0,20,0,1
5902,1807,504,1920,990,48,15,12,113,486,1,20,0,0
5903,1793,553,1911,1005,48,15,12,118,452,2,20,0,0
5904,1779,588,1896,1029,48,15,12,117,441,3,20,0,0
5905,1757,449,1915,1045,48,15,12,158,596,4,20,0,0
5906,1745,446,1908,1053,48,15,12,163,607,5,20,0,0
5907,1734,539,1881,1066,48,15,12,147,527,6,20,0,0
5908,1724,584,1868,1073,48,15,12,144,489,7,20,0,0
5909,1678,620,1825,1080,48,15,12,147,460,8,20,0,0
5910,1651,606,1811,1079,48,15,12,160,473,9,20,0,0
5911,1621,630,1781,1080,48,15,12,160,450,10,20,0,0
5912,1580,653,1739,1079,48,15,12,159,426,11,20,0,0
5913,1521,666,1685,1078,48,15,12,164,412,12,20,0,0
5914,1450,682,1620,1077,48,15,12,170,395,13,20,0,0
5915,1386,708,1549,1066,48,15,12,163,358,14,20,0,0
5916,1289,710,1463,1076,48,15,12,174,366,15,20,0,0
5917,1206,728,1375,1068,48,15,12,169,340,16,20,0,0
5918,1108,772,1268,1073,48,15,12,160,301,17,20,0,0
5919,985,808,1136,1070,48,15,12,151,262,18,20,0,0
5920,863,842,1005,1072,48,15,12,142,230,19,20,0,0
5921,789,864,919,1074,48,15,12,130,210,20,20,1,0
5901,1591,534,1798,971,49,15,12,207,437,0,19,0,1
5902,1575,520,1782,957,49,15,12,207,437,1,19,0,0
5903,1516,546,1719,972,49,15,12,203,426,2,19,0,0
5904,1453,556,1662,991,49,15,12,209,435,3,19,0,0
5905,1410,545,1635,1015,49,15,12,225,470,4,19,0,0
5906,1342,569,1574,1049,49,15,12,232,480,5,19,0,0
5907,1299,564,1538,1063,49,15,12,239,499,6,19,0,0
5908,1225,573,1468,1069,49,15,12,243,496,7,19,0,0
5909,1145,586,1391,1078,49,15,12,246,492,8,19,0,0
5910,1097,581,1341,1073,49,15,12,244,492,9,19,0,0
5911,1035,594,1273,1079,49,15,12,238,485,10,19,0,0
5912,968,609,1197,1078,49,15,12,229,469,11,19,0,0
5913,881,621,1105,1079,49,15,12,224,458,12,19,0,0
5914,772,648,980,1065,49,15,12,208,417,13,19,0,0
5915,662,655,849,1012,49,15,12,187,357,14,19,0,0
5916,550,660,747,1027,49,15,12,197,367,15,19,0,0
5917,422,695,624,1060,49,15,12,202,365,16,19,0,0
5918,303,706,513,1072,49,15,12,210,366,17,19,0,0
5919,184,717,401,1076,49,15,12,217,359,18,19,0,0
5920,92,730,305,1080,49,15,12,213,350,19,19,0,0
5901,1857,411,1920,629,50,15,12,63,218,0,41,0,1
5902,1843,397,1908,620,50,15,12,65,223,1,41,0,0
5903,1838,372,1913,627,50,15,12,75,255,2,41,0,0
5904,1816,361,1919,715,50,15,12,103,354,3,41,0,0
5905,1806,349,1920,744,50,15,12,114,395,4,41,0,0
5906,1808,367,1914,727,50,15,12,106,360,5,41,0,0
5907,1814,377,1911,700,50,15,12,97,323,6,41,0,0
5908,1824,378,1913,673,50,15,12,89,295,7,41,0,0
5909,1830,384,1916,666,50,15,12,86,282,8,41,0,0
5910,1827,405,1918,704,50,15,12,91,299,9,41,0,0
5911,1806,408,1919,779,50,15,12,113,371,10,41,0,0
5912,1793,413,1919,825,50,15,12,126,412,11,41,0,0
5913,1776,407,1920,887,50,15,12,144,480,12,41,0,0
5914,1768,396,1920,919,50,15,12,152,523,13,41,0,0
5915,1757,385,1920,937,50,15,12,163,552,14,41,0,0
5916,1738,407,1906,953,50,15,12,168,546,15,41,0,0
5917,1718,401,1898,978,50,15,12,180,577,16,41,0,0
5918,1708,384,1897,983,50,15,12,189,599,17,41,0,0
5919,1698,401,1897,1028,50,15,12,199,627,18,41,0,0
5920,1684,398,1886,1019,50,15,12,202,621,19,41,0,0
5921,1659,424,1864,1043,50,15,12,205,619,20,41,0,0
5922,1605,473,1812,1060,50,15,12,207,587,21,41,0,0
5923,1553,509,1764,1072,50,15,12,211,563,22,41,0,0
5924,1520,510,1738,1078,50,15,12,218,568,23,41,0,0
5925,1481,507,1704,1073,50,15,12,223,566,24,41,0,0
5926,1426,519,1655,1077,50,15,12,229,558,25,41,0,0
5927,1383,523,1616,1080,50,15,12,233,557,26,41,0,0
5928,1336,528,1572,1079,50,15,12,236,551,27,41,0,0
5929,1270,537,1510,1078,50,15,12,240,541,28,41,0,0
5930,1204,526,1454,1077,50,15,12,250,551,29,41,0,0
5931,1109,518,1374,1074,50,15,12,265,556,30,41,0,0
5932,1009,531,1279,1070,50,15,12,270,539,31,41,0,0
5933,927,535,1202,1072,50,15,12,275,537,32,41,0,0
5934,865,536,1144,1074,50,15,12,279,538,33,41,0,0
5935,782,572,1052,1077,50,15,12,270,505,34,41,0,0
5936,668,586,944,1078,50,15,12,276,492,35,41,0,0
5937,541,597,824,1078,50,15,12,283,481,36,41,0,0
5938,391,624,669,1079,50,15,12,278,455,37,41,0,0
5939,225,627,507,1074,50,15,12,282,447,38,41,0,0
5940,83,639,366,1072,50,15,12,283,433,39,41,0,0
5941,0,658,261,1078,50,15,12,261,420,40,41,0,0
5942,0,669,159,1080,50,15,12,159,411,41,41,1,0
5916,1798,379,1892,587,54,15,12,94,208,0,0,0,0
5919,1738,392,1850,573,55,15,12,112,181,0,1,0,0
5920,1730,385,1847,573,55,15,12,117,188,1,1,0,0
5921,1853,488,1919,797,57,15,12,66,309,0,29,0,1
5922,1837,427,1918,806,57,15,12,81,379,1,29,0,0
5923,1829,417,1908,780,57,15,12,79,363,2,29,0,0
5924,1811,422,1888,767,57,15,12,77,345,3,29,0,0
5925,1804,415,1887,774,57,15,12,83,359,4,29,0,0
5926,1800,408,1891,792,57,15,12,91,384,5,29,0,0
5927,1792,401,1898,845,57,15,12,106,444,6,29,0,0
5928,1786,401,1899,867,57,15,12,113,466,7,29,0,0
5929,1765,417,1884,888,57,15,12,119,471,8,29,0,0
5930,1758,444,1879,904,57,15,12,121,460,9,29,0,0
5931,1711,465,1842,928,57,15,12,131,463,10,29,0,0
5932,1676,476,1816,944,57,15,12,140,468,11,29,0,0
5933,1657,492,1800,951,57,15,12,143,459,12,29,0,0
5934,1625,484,1792,1001,57,15,12,167,517,13,29,0,0
5935,1596,494,1775,1032,57,15,12,179,538,14,29,0,0
5936,1576,519,1753,1040,57,15,12,177,521,15,29,0,0
5937,1515,541,1704,1064,57,15,12,189,523,16,29,0,0
5938,1488,552,1683,1075,57,15,12,195,523,17,29,0,0
5939,1461,558,1658,1073,57,15,12,197,515,18,29,0,0
5940,1424,573,1619,1074,57,15,12,195,501,19,29,0,0
5941,1382,584,1581,1076,57,15,12,199,492,20,29,0,0
5942,1317,589,1521,1078,57,15,12,204,489,21,29,0,0
5943,1253,597,1464,1080,57,15,12,211,483,22,29,0,0
5944,1173,611,1388,1077,57,15,12,215,466,23,29,0,0
5945,1095,626,1311,1075,57,15,12,216,449,24,29,0,0
5946,1017,632,1238,1075,57,15,12,221,443,25,29,0,0
5947,924,640,1151,1078,57,15,12,227,438,26,29,0,0
5948,836,654,1066,1078,57,15,12,230,424,27,29,0,0
5949,699,634,954,1078,57,15,12,255,444,28,29,0,0
5950,634,640,889,1080,57,15,12,255,440,29,29,1,0
5922,1656,384,1820,730,59,15,12,164,346,0,33,0,1
5923,1681,385,1795,625,59,15,12,114,240,1,33,0,0
5924,1677,390,1791,628,59,15,12,114,238,2,33,0,0
5925,1652,397,1792,693,59,15,12,140,296,3,33,0,0
5926,1628,397,1788,735,59,15,12,160,338,4,33,0,0
5927,1605,402,1783,784,59,15,12,178,382,5,33,0,0
5928,1578,405,1773,825,59,15,12,195,420,6,33,0,0
5929,1556,406,1763,854,59,15,12,207,448,7,33,0,0
5930,1535,411,1754,889,59,15,12,219,478,8,33,0,0
5931,1514,418,1745,929,59,15,12,231,511,9,33,0,0
5932,1493,425,1726,945,59,15,12,233,520,10,33,0,0
5933,1442,431,1684,960,59,15,12,242,529,11,33,0,0
5934,1400,433,1652,982,59,15,12,252,549,12,33,0,0
5935,1377,428,1633,990,59,15,12,256,562,13,33,0,0
5936,1330,435,1594,1011,59,15,12,264,576,14,33,0,0
5937,1280,444,1552,1038,59,15,12,272,594,15,33,0,0
5938,1244,444,1515,1042,59,15,12,271,598,16,33,0,0
5939,1161,442,1444,1057,59,15,12,283,615,17,33,0,0
5940,1089,442,1376,1061,59,15,12,287,619,18,33,0,0
5941,1040,433,1328,1062,59,15,12,288,629,19,33,0,0
5942,991,428,1278,1065,59,15,12,287,637,20,33,0,0
5943,936,443,1215,1070,59,15,12,279,627,21,33,0,0
5944,888,442,1166,1077,59,15,12,278,635,22,33,0,0
5945,812,451,1086,1078,59,15,12,274,627,23,33,0,0
5946,736,463,1008,1080,59,15,12,272,617,24,33,0,0
5947,653,467,922,1080,59,15,12,269,613,25,33,0,0
5948,573,473,834,1080,59,15,12,261,607,26,33,0,0
5949,492,489,735,1075,59,15,12,243,586,27,33,0,0
5950,482,503,724,1039,59,15,12,242,536,28,33,0,0
5951,392,514,652,1045,59,15,12,260,531,29,33,0,0
5952,292,510,578,1070,59,15,12,286,560,30,33,0,0
5953,189,606,449,1061,59,15,12,260,455,31,33,0,0
5954,107,747,317,1067,59,15,12,210,320,32,33,0,0
5955,44,781,235,1072,59,15,12,191,291,33,33,1,0
5929,1787,414,1901,642,62,15,12,114,228,0,0,0,0
5931,1852,434,1919,740,63,15,12,67,306,0,34,0,1
5932,1832,446,1911,805,63,15,12,79,359,1,34,0,0
5933,1814,449,1907,873,63,15,12,93,424,2,34,0,0
5934,1798,444,1898,892,63,15,12,100,448,3,34,0,0
5935,1775,444,1881,908,63,15,12,106,464,4,34,0,0
5936,1759,446,1867,906,63,15,12,108,460,5,34,0,0
5937,1742,445,1853,911,63,15,12,111,466,6,34,0,0
5938,1716,454,1834,924,63,15,12,118,470,7,34,0,0
5939,1686,461,1810,934,63,15,12,124,473,8,34,0,0
5940,1668,463,1797,952,63,15,12,129,489,9,34,0,0
5941,1635,474,1770,967,63,15,12,135,493,10,34,0,0
5942,1604,481,1754,1005,63,15,12,150,524,11,34,0,0
5943,1547,496,1711,1035,63,15,12,164,539,12,34,0,0
5944,1511,499,1684,1048,63,15,12,173,549,13,34,0,0
5945,1456,499,1640,1055,63,15,12,184,556,14,34,0,0
5946,1383,510,1582,1071,63,15,12,199,561,15,34,0,0
5947,1344,498,1550,1069,63,15,12,206,571,16,34,0,0
5948,1312,496,1521,1072,63,15,12,209,576,17,34,0,0
5949,1272,509,1480,1074,63,15,12,208,565,18,34,0,0
5950,1222,514,1433,1080,63,15,12,211,566,19,34,0,0
5951,1156,523,1371,1079,63,15,12,215,556,20,34,0,0
5952,1088,536,1307,1080,63,15,12,219,544,21,34,0,0
5953,1016,537,1238,1080,63,15,12,222,543,22,34,0,0
5954,947,531,1172,1077,63,15,12,225,546,23,34,0,0
5955,883,544,1106,1075,63,15,12,223,531,24,34,0,0
5956,805,566,1028,1080,63,15,12,223,514,25,34,0,0
5957,729,584,948,1071,63,15,12,219,487,26,34,0,0
5958,645,607,860,1067,63,15,12,215,460,27,34,0,0
5959,538,623,750,1062,63,15,12,212,439,28,34,0,0
5960,421,624,643,1067,63,15,12,222,443,29,34,0,0
5961,364,638,609,1076,63,15,12,245,438,30,34,0,0
5962,218,673,460,1077,63,15,12,242,404,31,34,0,0
5963,84,689,327,1078,63,15,12,243,389,32,34,0,0
5964,17,752,228,1080,63,15,12,211,328,33,34,0,0
5965,0,773,136,1080,63,15,12,136,307,34,34,1,0
5937,1782,594,1917,986,64,15,12,135,392,0,21,0,1
5938,1771,558,1920,997,64,15,12,149,439,1,21,0,0
5939,1758,573,1907,1005,64,15,12,149,432,2,21,0,0
5940,1712,537,1884,1027,64,15,12,172,490,3,21,0,0
5941,1704,553,1882,1050,64,15,12,178,497,4,21,0,0
5942,1694,566,1880,1075,64,15,12,186,509,5,21,0,0
5943,1682,573,1872,1080,64,15,12,190,507,6,21,0,0
5944,1681,594,1869,1078,64,15,12,188,484,7,21,0,0
5945,1675,611,1865,1080,64,15,12,190,469,8,21,0,0
5946,1657,620,1853,1080,64,15,12,196,460,9,21,0,0
5947,1631,639,1826,1077,64,15,12,195,438,10,21,0,0
5948,1599,652,1801,1079,64,15,12,202,427,11,21,0,0
5949,1568,669,1772,1073,64,15,12,204,404,12,21,0,0
5950,1547,706,1748,1075,64,15,12,201,369,13,21,0,0
5951,1518,725,1730,1079,64,15,12,212,354,14,21,0,0
5952,1476,740,1697,1080,64,15,12,221,340,15,21,0,0
5953,1433,766,1651,1080,64,15,12,218,314,16,21,0,0
5954,1359,772,1584,1080,64,15,12,225,308,17,21,0,0
5955,1284,780,1514,1080,64,15,12,230,300,18,21,0,0
5956,1215,813,1432,1078,64,15,12,217,265,19,21,0,0
5957,1143,850,1345,1077,64,15,12,202,227,20,21,0,0
5958,1048,872,1244,1073,64,15,12,196,201,21,21,1,0
5953,76,531,350,891,66,15,12,274,360,0,3,0,0
5954,3,546,315,957,66,15,12,312,411,1,3,0,0
5955,0,572,320,1046,66,15,12,320,474,2,3,0,0
5956,0,585,317,1080,66,15,12,317,495,3,3,0,0
379,540,135,580,272,1,15,13,40,137,0,73,0,1
380,525,137,561,259,1,15,13,36,122,1,73,0,0
381,511,133,546,252,1,15,13,35,119,2,73,0,0
382,488,136,523,251,1,15,13,35,115,3,73,0,0
383,470,137,506,254,1,15,13,36,117,4,73,0,0
384,452,143,488,255,1,15,13,36,112,5,73,0,0
385,433,140,471,254,1,15,13,38,114,6,73,0,0
386,411,134,451,256,1,15,13,40,122,7,73,0,0
387,388,132,430,254,1,15,13,42,122,8,73,0,0
388,370,131,413,254,1,15,13,43,123,9,73,0,0
389,353,130,397,254,1,15,13,44,124,10,73,0,0
390,339,127,386,257,1,15,13,47,130,11,73,0,0
391,331,122,379,257,1,15,13,48,135,12,73,0,0
392,328,129,372,255,1,15,13,44,126,13,73,0,0
393,327,132,370,257,1,15,13,43,125,14,73,0,0
394,328,128,372,256,1,15,13,44,128,15,73,0,0
395,330,125,376,256,1,15,13,46,131,16,73,0,0
396,334,125,380,258,1,15,13,46,133,17,73,0,0
397,342,127,388,259,1,15,13,46,132,18,73,0,0
398,348,128,395,262,1,15,13,47,134,19,73,0,0
399,354,131,401,265,1,15,13,47,134,20,73,0,0
400,363,133,413,269,1,15,13,50,136,21,73,0,0
401,380,131,430,269,1,15,13,50,138,22,73,0,0
402,396,133,447,268,1,15,13,51,135,23,73,0,0
403,408,138,459,269,1,15,13,51,131,24,73,0,0
404,427,141,477,270,1,15,13,50,129,25,73,0,0
405,442,142,494,270,1,15,13,52,128,26,73,0,0
406,458,139,512,271,1,15,13,54,132,27,73,0,0
407,472,136,529,271,1,15,13,57,135,28,73,0,0
408,486,137,544,272,1,15,13,58,135,29,73,0,0
409,494,142,551,272,1,15,13,57,130,30,73,0,0
410,497,148,551,271,1,15,13,54,123,31,73,0,0
411,500,154,552,271,1,15,13,52,117,32,73,0,0
412,499,156,550,271,1,15,13,51,115,33,73,0,0
413,504,157,555,272,1,15,13,51,115,34,73,0,0
414,505,155,557,273,1,15,13,52,118,35,73,0,0
415,506,155,558,274,1,15,13,52,119,36,73,0,0
416,506,155,558,272,1,15,13,52,117,37,73,0,0
417,506,155,558,272,1,15,13,52,117,38,73,0,0
418,505,156,558,272,1,15,13,53,116,39,73,0,0
419,504,157,557,272,1,15,13,53,115,40,73,0,0
420,504,156,558,273,1,15,13,54,117,41,73,0,0
421,504,156,557,273,1,15,13,53,117,42,73,0,0
422,504,156,558,274,1,15,13,54,118,43,73,0,0
423,504,156,559,274,1,15,13,55,118,44,73,0,0
424,504,158,558,274,1,15,13,54,116,45,73,0,0
425,504,158,559,274,1,15,13,55,116,46,73,0,0
426,503,158,558,273,1,15,13,55,115,47,73,0,0
427,503,159,558,273,1,15,13,55,114,48,73,0,0
428,502,158,558,273,1,15,13,56,115,49,73,0,0
429,502,156,559,273,1,15,13,57,117,50,73,0,0
430,501,155,559,273,1,15,13,58,118,51,73,0,0
431,501,157,558,273,1,15,13,57,116,52,73,0,0
432,500,157,558,273,1,15,13,58,116,53,73,0,0
433,499,155,558,273,1,15,13,59,118,54,73,0,0
434,498,159,554,272,1,15,13,56,113,55,73,0,0
435,496,155,553,270,1,15,13,57,115,56,73,0,0
436,492,153,549,270,1,15,13,57,117,57,73,0,0
437,490,150,545,268,1,15,13,55,118,58,73,0,0
438,487,144,545,268,1,15,13,58,124,59,73,0,0
439,483,141,542,265,1,15,13,59,124,60,73,0,0
440,479,140,536,260,1,15,13,57,120,61,73,0,0
441,479,137,534,253,1,15,13,55,116,62,73,0,0
442,471,139,526,256,1,15,13,55,117,63,73,0,0
443,461,139,518,260,1,15,13,57,121,64,73,0,0
444,452,138,508,259,1,15,13,56,121,65,73,0,0
445,441,137,497,259,1,15,13,56,122,66,73,0,0
446,428,138,483,259,1,15,13,55,121,67,73,0,0
447,408,132,465,258,1,15,13,57,126,68,73,0,0
448,389,131,445,253,1,15,13,56,122,69,73,0,0
449,371,130,428,253,1,15,13,57,123,70,73,0,0
450,353,129,409,252,1,15,13,56,123,71,73,0,0
451,340,127,395,251,1,15,13,55,124,72,73,0,0
452,329,125,385,250,1,15,13,56,125,73,73,1,0
882,343,126,381,255,3,15,13,38,129,0,23,0,1
883,351,127,390,261,3,15,13,39,134,1,23,0,0
884,363,124,404,262,3,15,13,41,138,2,23,0,0
885,377,125,418,264,3,15,13,41,139,3,23,0,0
886,391,128,433,266,3,15,13,42,138,4,23,0,0
887,407,133,447,267,3,15,13,40,134,5,23,0,0
888,425,134,467,268,3,15,13,42,134,6,23,0,0
889,438,139,481,271,3,15,13,43,132,7,23,0,0
890,452,139,494,273,3,15,13,42,134,8,23,0,0
891,464,135,509,274,3,15,13,45,139,9,23,0,0
892,474,138,521,278,3,15,13,47,140,10,23,0,0
893,492,135,540,276,3,15,13,48,141,11,23,0,0
894,513,134,561,275,3,15,13,48,141,12,23,0,0
895,524,137,575,281,3,15,13,51,144,13,23,0,0
896,535,137,586,282,3,15,13,51,145,14,23,0,0
897,540,136,591,284,3,15,13,51,148,15,23,0,0
898,544,137,594,284,3,15,13,50,147,16,23,0,0
899,548,136,598,284,3,15,13,50,148,17,23,0,0
900,551,134,602,286,3,15,13,51,152,18,23,0,0
901,553,134,605,286,3,15,13,52,152,19,23,0,0
902,555,134,611,293,3,15,13,56,159,20,23,0,0
903,564,134,620,295,3,15,13,56,161,21,23,0,0
904,572,138,619,279,3,15,13,47,141,22,23,0,0
905,580,139,628,279,3,15,13,48,140,23,23,1,0
1596,572,143,612,279,4,15,13,40,136,0,17,0,0
1597,559,144,601,285,4,15,13,42,141,1,17,0,0
1598,549,139,593,287,4,15,13,44,148,2,17,0,0
1599,524,139,569,286,4,15,13,45,147,3,17,0,0
1600,503,137,548,282,4,15,13,45,145,4,17,0,0
1601,492,132,537,279,4,15,13,45,147,5,17,0,0
1602,476,133,521,278,4,15,13,45,145,6,17,0,0
1603,464,131,509,275,4,15,13,45,144,7,17,0,0
1604,455,129,499,272,4,15,13,44,143,8,17,0,0
1605,441,134,485,272,4,15,13,44,138,9,17,0,0
1606,433,134,478,271,4,15,13,45,137,10,17,0,0
1607,420,135,464,270,4,15,13,44,135,11,17,0,0
1608,403,128,448,269,4,15,13,45,141,12,17,0,0
1609,390,128,436,268,4,15,13,46,140,13,17,0,0
1610,375,125,421,266,4,15,13,46,141,14,17,0,0
1611,356,124,403,266,4,15,13,47,142,15,17,0,0
1612,345,125,390,261,4,15,13,45,136,16,17,0,0
1613,331,123,377,259,4,15,13,46,136,17,17,0,0
2573,875,213,940,436,5,15,13,65,223,0,0,0,0
2574,798,204,921,451,6,15,13,123,247,0,31,0,1
2575,782,204,900,443,6,15,13,118,239,1,31,0,0
2576,737,201,854,437,6,15,13,117,236,2,31,0,0
2577,709,206,820,430,6,15,13,111,224,3,31,0,0
2578,687,200,796,423,6,15,13,109,223,4,31,0,0
2579,655,193,765,420,6,15,13,110,227,5,31,0,0
2580,629,184,737,408,6,15,13,108,224,6,31,0,0
2581,606,182,713,406,6,15,13,107,224,7,31,0,0
2582,593,177,695,396,6,15,13,102,219,8,31,0,0
2583,583,171,683,387,6,15,13,100,216,9,31,0,0
2584,577,171,674,380,6,15,13,97,209,10,31,0,0
2585,569,169,661,372,6,15,13,92,203,11,31,0,0
2586,559,166,647,365,6,15,13,88,199,12,31,0,0
2587,552,165,634,357,6,15,13,82,192,13,31,0,0
2588,541,159,624,352,6,15,13,83,193,14,31,0,0
2589,539,158,622,348,6,15,13,83,190,15,31,0,0
2590,533,151,611,335,6,15,13,78,184,16,31,0,0
2591,529,148,606,332,6,15,13,77,184,17,31,0,0
2592,524,154,595,329,6,15,13,71,175,18,31,0,0
2593,520,152,589,323,6,15,13,69,171,19,31,0,0
2594,518,147,586,318,6,15,13,68,171,20,31,0,0
2595,517,146,584,315,6,15,13,67,169,21,31,0,0
2596,517,141,585,316,6,15,13,68,175,22,31,0,0
2597,519,142,584,311,6,15,13,65,169,23,31,0,0
2598,521,140,584,306,6,15,13,63,166,24,31,0,0
2599,527,139,589,305,6,15,13,62,166,25,31,0,0
2600,533,135,594,303,6,15,13,61,168,26,31,0,0
2601,539,135,601,304,6,15,13,62,169,27,31,0,0
2602,543,136,605,305,6,15,13,62,169,28,31,0,0
2603,546,135,605,294,6,15,13,59,159,29,31,0,0
2604,543,134,610,313,6,15,13,67,179,30,31,0,0
2605,543,132,609,312,6,15,13,66,180,31,31,1,0
2586,541,189,582,320,7,15,13,41,131,0,0,0,0
2627,487,137,523,247,8,15,13,36,110,0,2,0,0
2628,504,133,544,252,8,15,13,40,119,1,2,0,0
2629,523,132,563,252,8,15,13,40,120,2,2,0,0
2745,575,140,612,288,9,15,13,37,148,0,38,0,1
2746,556,132,599,304,9,15,13,43,172,1,38,0,0
2747,551,133,595,305,9,15,13,44,172,2,38,0,0
2748,546,136,587,296,9,15,13,41,160,3,38,0,0
2749,536,135,578,295,9,15,13,42,160,4,38,0,0
2750,526,137,571,304,9,15,13,45,167,5,38,0,0
2751,519,137,563,299,9,15,13,44,162,6,38,0,0
2752,514,140,558,302,9,15,13,44,162,7,38,0,0
2753,510,142,555,304,9,15,13,45,162,8,38,0,0
2754,507,144,553,304,9,15,13,46,160,9,38,0,0
2755,501,147,548,311,9,15,13,47,164,10,38,0,0
2756,497,150,545,314,9,15,13,48,164,11,38,0,0
2757,493,149,544,317,9,15,13,51,168,12,38,0,0
2758,493,149,546,324,9,15,13,53,175,13,38,0,0
2759,494,150,549,328,9,15,13,55,178,14,38,0,0
2760,495,152,551,332,9,15,13,56,180,15,38,0,0
2761,497,153,554,337,9,15,13,57,184,16,38,0,0
2762,500,154,559,339,9,15,13,59,185,17,38,0,0
2763,507,154,568,347,9,15,13,61,193,18,38,0,0
2764,513,154,577,353,9,15,13,64,199,19,38,0,0
2765,524,159,588,355,9,15,13,64,196,20,38,0,0
2766,534,164,600,364,9,15,13,66,200,21,38,0,0
2767,540,170,607,370,9,15,13,67,200,22,38,0,0
2768,546,173,614,375,9,15,13,68,202,23,38,0,0
2769,557,176,627,382,9,15,13,70,206,24,38,0,0
2770,569,178,640,384,9,15,13,71,206,25,38,0,0
2771,585,182,657,390,9,15,13,72,208,26,38,0,0
2772,599,189,674,400,9,15,13,75,211,27,38,0,0
2773,616,190,693,406,9,15,13,77,216,28,38,0,0
2774,630,194,708,412,9,15,13,78,218,29,38,0,0
2775,646,200,727,420,9,15,13,81,220,30,38,0,0
2776,675,204,756,424,9,15,13,81,220,31,38,0,0
2777,695,211,779,428,9,15,13,84,217,32,38,0,0
2778,728,209,814,434,9,15,13,86,225,33,38,0,0
2779,756,210,842,435,9,15,13,86,225,34,38,0,0
2780,779,211,871,442,9,15,13,92,231,35,38,0,0
2781,818,208,912,445,9,15,13,94,237,36,38,0,0
2782,838,214,932,446,9,15,13,94,232,37,38,0,0
2783,857,217,952,451,9,15,13,95,234,38,38,1,0
2769,544,196,585,370,10,15,13,41,174,0,0,0,0
3026,377,149,412,261,11,15,13,35,112,0,11,0,0
3027,392,148,428,264,11,15,13,36,116,1,11,0,0
3028,406,151,442,263,11,15,13,36,112,2,11,0,0
3029,422,149,458,261,11,15,13,36,112,3,11,0,0
3030,439,153,475,264,11,15,13,36,111,4,11,0,0
3031,453,156,489,263,11,15,13,36,107,5,11,0,0
3032,471,150,509,264,11,15,13,38,114,6,11,0,0
3033,485,153,523,264,11,15,13,38,111,7,11,0,0
3034,502,152,541,263,11,15,13,39,111,8,11,0,0
3035,518,154,557,267,11,15,13,39,113,9,11,0,0
3036,532,162,569,268,11,15,13,37,106,10,11,0,0
3037,547,164,583,269,11,15,13,36,105,11,11,0,0
3443,1146,683,1405,1069,13,15,13,259,386,0,0,0,0
3444,931,616,1270,1064,14,15,13,339,448,0,103,0,1
3445,764,580,1133,1066,14,15,13,369,486,1,103,0,0
3446,689,533,1086,1060,14,15,13,397,527,2,103,0,0
3447,606,481,1038,1062,14,15,13,432,581,3,103,0,0
3448,523,463,960,1063,14,15,13,437,600,4,103,0,0
3449,434,420,893,1066,14,15,13,459,646,5,103,0,0
3450,365,400,822,1065,14,15,13,457,665,6,103,0,0
3451,286,376,750,1069,14,15,13,464,693,7,103,0,0
3452,236,358,694,1052,14,15,13,458,694,8,103,0,0
3453,227,348,665,1024,14,15,13,438,676,9,103,0,0
3454,231,339,647,987,14,15,13,416,648,10,103,0,0
3455,229,334,623,958,14,15,13,394,624,11,103,0,0
3456,239,325,620,944,14,15,13,381,619,12,103,0,0
3457,289,329,647,933,14,15,13,358,604,13,103,0,0
3458,331,328,676,930,14,15,13,345,602,14,103,0,0
3459,348,327,684,936,14,15,13,336,609,15,103,0,0
3460,352,327,678,945,14,15,13,326,618,16,103,0,0
3461,346,328,661,947,14,15,13,315,619,17,103,0,0
3462,347,327,650,944,14,15,13,303,617,18,103,0,0
3463,374,328,674,949,14,15,13,300,621,19,103,0,0
3464,408,325,711,951,14,15,13,303,626,20,103,0,0
3465,407,318,689,919,14,15,13,282,601,21,103,0,0
3466,421,313,682,886,14,15,13,261,573,22,103,0,0
3467,436,310,686,872,14,15,13,250,562,23,103,0,0
3468,453,300,697,855,14,15,13,244,555,24,103,0,0
3469,479,292,702,807,14,15,13,223,515,25,103,0,0
3470,489,285,701,789,14,15,13,212,504,26,103,0,0
3471,481,271,689,778,14,15,13,208,507,27,103,0,0
3472,469,269,669,765,14,15,13,200,496,28,103,0,0
3473,467,267,656,745,14,15,13,189,478,29,103,0,0
3474,471,262,658,743,14,15,13,187,481,30,103,0,0
3475,483,260,665,741,14,15,13,182,481,31,103,0,0
3476,485,261,665,745,14,15,13,180,484,32,103,0,0
3477,489,264,664,740,14,15,13,175,476,33,103,0,0
3478,493,266,665,740,14,15,13,172,474,34,103,0,0
3479,498,268,667,741,14,15,13,169,473,35,103,0,0
3480,497,268,664,742,14,15,13,167,474,36,103,0,0
3481,496,269,661,740,14,15,13,165,471,37,103,0,0
3482,499,267,662,739,14,15,13,163,472,38,103,0,0
3483,499,265,661,742,14,15,13,162,477,39,103,0,0
3484,500,263,662,743,14,15,13,162,480,40,103,0,0
3485,501,267,659,741,14,15,13,158,474,41,103,0,0
3486,499,269,657,737,14,15,13,158,468,42,103,0,0
3487,501,270,657,736,14,15,13,156,466,43,103,0,0
3488,503,272,660,741,14,15,13,157,469,44,103,0,0
3489,504,268,662,744,14,15,13,158,476,45,103,0,0
3490,506,267,663,740,14,15,13,157,473,46,103,0,0
3491,506,262,665,740,14,15,13,159,478,47,103,0,0
3492,503,263,661,742,14,15,13,158,479,48,103,0,0
3493,504,265,660,741,14,15,13,156,476,49,103,0,0
3494,505,264,660,740,14,15,13,155,476,50,103,0,0
3495,505,266,661,747,14,15,13,156,481,51,103,0,0
3496,506,268,660,749,14,15,13,154,481,52,103,0,0
3497,506,270,658,744,14,15,13,152,474,53,103,0,0
3498,505,268,657,743,14,15,13,152,475,54,103,0,0
3499,506,268,656,743,14,15,13,150,475,55,103,0,0
3500,506,268,655,742,14,15,13,149,474,56,103,0,0
3501,505,266,655,744,14,15,13,150,478,57,103,0,0
3502,506,268,657,747,14,15,13,151,479,58,103,0,0
3503,508,269,657,744,14,15,13,149,475,59,103,0,0
3504,506,264,656,744,14,15,13,150,480,60,103,0,0
3505,508,267,658,747,14,15,13,150,480,61,103,0,0
3506,508,270,657,750,14,15,13,149,480,62,103,0,0
3507,510,268,658,746,14,15,13,148,478,63,103,0,0
3508,510,269,657,745,14,15,13,147,476,64,103,0,0
3509,508,268,654,741,14,15,13,146,473,65,103,0,0
3510,511,270,657,746,14,15,13,146,476,66,103,0,0
3511,510,264,659,750,14,15,13,149,486,67,103,0,0
3512,513,271,657,742,14,15,13,144,471,68,103,0,0
3513,514,273,657,738,14,15,13,143,465,69,103,0,0
3514,515,275,657,737,14,15,13,142,462,70,103,0,0
3515,515,276,658,738,14,15,13,143,462,71,103,0,0
3516,514,270,659,740,14,15,13,145,470,72,103,0,0
3517,510,266,657,746,14,15,13,147,480,73,103,0,0
3518,513,264,659,744,14,15,13,146,480,74,103,0,0
3519,515,270,660,745,14,15,13,145,475,75,103,0,0
3520,520,271,664,743,14,15,13,144,472,76,103,0,0
3521,525,265,671,745,14,15,13,146,480,77,103,0,0
3522,528,265,674,743,14,15,13,146,478,78,103,0,0
3523,530,260,676,739,14,15,13,146,479,79,103,0,0
3524,533,264,680,741,14,15,13,147,477,80,103,0,0
3525,539,263,687,740,14,15,13,148,477,81,103,0,0
3526,544,263,694,750,14,15,13,150,487,82,103,0,0
3527,554,270,701,754,14,15,13,147,484,83,103,0,0
3528,572,272,717,751,14,15,13,145,479,84,103,0,0
3529,582,272,724,744,14,15,13,142,472,85,103,0,0
3530,585,270,732,751,14,15,13,147,481,86,103,0,0
3531,594,273,740,745,14,15,13,146,472,87,103,0,0
3532,609,275,755,743,14,15,13,146,468,88,103,0,0
3533,596,273,743,737,14,15,13,147,464,89,103,0,0
3534,582,273,730,735,14,15,13,148,462,90,103,0,0
3535,565,271,715,740,14,15,13,150,469,91,103,0,0
3536,549,277,694,737,14,15,13,145,460,92,103,0,0
3537,524,277,667,741,14,15,13,143,464,93,103,0,0
3538,501,278,644,738,14,15,13,143,460,94,103,0,0
3539,480,276,626,737,14,15,13,146,461,95,103,0,0
3540,453,265,595,723,14,15,13,142,458,96,103,0,0
3541,420,266,560,721,14,15,13,140,455,97,103,0,0
3542,386,271,524,713,14,15,13,138,442,98,103,0,0
3543,352,274,496,718,14,15,13,144,444,99,103,0,0
3544,309,278,451,721,14,15,13,142,443,100,103,0,0
3545,286,292,425,729,14,15,13,139,437,101,103,0,0
3546,278,336,398,718,14,15,13,120,382,102,103,0,0
3547,259,344,376,716,14,15,13,117,372,103,103,1,0
3453,529,457,1108,1041,16,15,13,579,584,0,4,0,0
3454,488,420,1095,1056,16,15,13,607,636,1,4,0,0
3455,461,385,1080,1061,16,15,13,619,676,2,4,0,0
3456,452,369,1051,1054,16,15,13,599,685,3,4,0,0
3457,391,328,1024,1052,16,15,13,633,724,4,4,0,0
3457,646,363,864,987,17,15,13,218,624,0,74,0,1
3458,644,350,856,958,17,15,13,212,608,1,74,0,0
3459,651,355,856,943,17,15,13,205,588,2,74,0,0
3460,663,340,853,886,17,15,13,190,546,3,74,0,0
3461,678,330,857,844,17,15,13,179,514,4,74,0,0
3462,671,323,844,824,17,15,13,173,501,5,74,0,0
3463,660,310,832,805,17,15,13,172,495,6,74,0,0
3464,650,291,816,769,17,15,13,166,478,7,74,0,0
3465,641,284,805,753,17,15,13,164,469,8,74,0,0
3466,644,281,808,751,17,15,13,164,470,9,74,0,0
3467,651,273,814,742,17,15,13,163,469,10,74,0,0
3468,653,271,808,718,17,15,13,155,447,11,74,0,0
3469,644,263,798,716,17,15,13,154,453,12,74,0,0
3470,628,260,778,703,17,15,13,150,443,13,74,0,0
3471,611,261,754,692,17,15,13,143,431,14,74,0,0
3472,590,260,732,704,17,15,13,142,444,15,74,0,0
3473,588,264,723,691,17,15,13,135,427,16,74,0,0
3474,591,262,723,686,17,15,13,132,424,17,74,0,0
3475,595,255,724,680,17,15,13,129,425,18,74,0,0
3476,598,256,726,685,17,15,13,128,429,19,74,0,0
3477,600,250,727,686,17,15,13,127,436,20,74,0,0
3478,604,249,728,683,17,15,13,124,434,21,74,0,0
3479,612,252,733,674,17,15,13,121,422,22,74,0,0
3480,618,250,737,668,17,15,13,119,418,23,74,0,0
3481,624,253,742,667,17,15,13,118,414,24,74,0,0
3482,634,256,752,667,17,15,13,118,411,25,74,0,0
3483,643,258,762,666,17,15,13,119,408,26,74,0,0
3484,648,262,769,665,17,15,13,121,403,27,74,0,0
3485,653,262,777,667,17,15,13,124,405,28,74,0,0
3486,653,262,777,664,17,15,13,124,402,29,74,0,0
3487,650,258,775,664,17,15,13,125,406,30,74,0,0
3488,645,256,773,665,17,15,13,128,409,31,74,0,0
3489,643,253,771,666,17,15,13,128,413,32,74,0,0
3490,642,253,769,666,17,15,13,127,413,33,74,0,0
3491,640,253,768,666,17,15,13,128,413,34,74,0,0
3492,640,253,767,666,17,15,13,127,413,35,74,0,0
3493,639,252,766,666,17,15,13,127,414,36,74,0,0
3494,639,252,766,666,17,15,13,127,414,37,74,0,0
3495,640,252,767,667,17,15,13,127,415,38,74,0,0
3496,640,252,767,668,17,15,13,127,416,39,74,0,0
3497,639,252,767,669,17,15,13,128,417,40,74,0,0
3498,639,252,767,670,17,15,13,128,418,41,74,0,0
3499,639,252,767,669,17,15,13,128,417,42,74,0,0
3500,639,252,767,670,17,15,13,128,418,43,74,0,0
3501,639,253,766,668,17,15,13,127,415,44,74,0,0
3502,639,253,765,668,17,15,13,126,415,45,74,0,0
3503,639,253,765,668,17,15,13,126,415,46,74,0,0
3504,638,253,764,668,17,15,13,126,415,47,74,0,0
3505,638,254,763,668,17,15,13,125,414,48,74,0,0
3506,638,254,763,668,17,15,13,125,414,49,74,0,0
3507,639,254,764,668,17,15,13,125,414,50,74,0,0
3508,640,254,765,669,17,15,13,125,415,51,74,0,0
3509,640,254,765,669,17,15,13,125,415,52,74,0,0
3510,640,254,765,669,17,15,13,125,415,53,74,0,0
3511,640,255,765,668,17,15,13,125,413,54,74,0,0
3512,640,254,764,668,17,15,13,124,414,55,74,0,0
3513,640,252,764,667,17,15,13,124,415,56,74,0,0
3514,638,251,763,667,17,15,13,125,416,57,74,0,0
3515,636,250,761,667,17,15,13,125,417,58,74,0,0
3516,634,250,758,669,17,15,13,124,419,59,74,0,0
3517,633,249,755,667,17,15,13,122,418,60,74,0,0
3518,631,249,751,663,17,15,13,120,414,61,74,0,0
3519,631,251,748,664,17,15,13,117,413,62,74,0,0
3520,630,252,746,665,17,15,13,116,413,63,74,0,0
3521,632,253,747,668,17,15,13,115,415,64,74,0,0
3522,633,253,748,670,17,15,13,115,417,65,74,0,0
3523,636,253,749,671,17,15,13,113,418,66,74,0,0
3524,638,251,751,671,17,15,13,113,420,67,74,0,0
3525,639,247,751,672,17,15,13,112,425,68,74,0,0
3526,637,244,749,673,17,15,13,112,429,69,74,0,0
3527,650,247,731,531,17,15,13,81,284,70,74,0,0
3528,657,244,721,457,17,15,13,64,213,71,74,0,0
3529,648,245,704,413,17,15,13,56,168,72,74,0,0
3530,624,253,670,385,17,15,13,46,132,73,74,0,0
3531,619,254,654,356,17,15,13,35,102,74,74,1,0
3496,1811,853,1920,1078,18,15,13,109,225,0,0,0,0
3497,1627,793,1900,1074,19,15,13,273,281,0,66,0,1
3498,1533,732,1864,1074,19,15,13,331,342,1,66,0,0
3499,1441,697,1803,1071,19,15,13,362,374,2,66,0,0
3500,1320,649,1729,1071,19,15,13,409,422,3,66,0,0
3501,1217,604,1664,1071,19,15,13,447,467,4,66,0,0
3502,1123,558,1608,1070,19,15,13,485,512,5,66,0,0
3503,1040,527,1542,1065,19,15,13,502,538,6,66,0,0
3504,958,498,1463,1047,19,15,13,505,549,7,66,0,0
3505,940,482,1408,998,19,15,13,468,516,8,66,0,0
3506,933,456,1349,923,19,15,13,416,467,9,66,0,0
3507,917,442,1305,887,19,15,13,388,445,10,66,0,0
3508,896,418,1278,870,19,15,13,382,452,11,66,0,0
3509,836,402,1268,933,19,15,13,432,531,12,66,0,0
3510,809,385,1255,955,19,15,13,446,570,13,66,0,0
3511,786,381,1247,1003,19,15,13,461,622,14,66,0,0
3512,764,373,1216,1017,19,15,13,452,644,15,66,0,0
3513,796,373,1151,889,19,15,13,355,516,16,66,0,0
3514,804,363,1101,802,19,15,13,297,439,17,66,0,0
3515,808,360,1091,787,19,15,13,283,427,18,66,0,0
3516,825,356,1082,757,19,15,13,257,401,19,66,0,0
3517,793,359,1117,887,19,15,13,324,528,20,66,0,0
3518,809,351,1082,815,19,15,13,273,464,21,66,0,0
3519,827,348,1076,789,19,15,13,249,441,22,66,0,0
3520,843,348,1073,771,19,15,13,230,423,23,66,0,0
3521,867,346,1049,685,19,15,13,182,339,24,66,0,0
3522,873,344,1044,665,19,15,13,171,321,25,66,0,0
3523,873,344,1039,659,19,15,13,166,315,26,66,0,0
3524,873,347,1031,647,19,15,13,158,300,27,66,0,0
3525,874,356,1038,670,19,15,13,164,314,28,66,0,0
3526,887,360,1058,688,19,15,13,171,328,29,66,0,0
3527,896,354,1076,711,19,15,13,180,357,30,66,0,0
3528,886,355,1124,846,19,15,13,238,491,31,66,0,0
3529,904,364,1151,888,19,15,13,247,524,32,66,0,0
3530,930,360,1181,905,19,15,13,251,545,33,66,0,0
3531,944,352,1199,912,19,15,13,255,560,34,66,0,0
3532,955,349,1202,902,19,15,13,247,553,35,66,0,0
3533,954,339,1202,901,19,15,13,248,562,36,66,0,0
3534,955,338,1196,898,19,15,13,241,560,37,66,0,0
3535,942,303,1193,902,19,15,13,251,599,38,66,0,0
3536,938,297,1180,890,19,15,13,242,593,39,66,0,0
3537,941,284,1157,821,19,15,13,216,537,40,66,0,0
3538,915,292,1142,866,19,15,13,227,574,41,66,0,0
3539,899,312,1120,880,19,15,13,221,568,42,66,0,0
3540,878,311,1100,890,19,15,13,222,579,43,66,0,0
3541,870,304,1093,893,19,15,13,223,589,44,66,0,0
3542,849,317,1064,894,19,15,13,215,577,45,66,0,0
3543,828,319,1036,887,19,15,13,208,568,46,66,0,0
3544,806,320,1012,886,19,15,13,206,566,47,66,0,0
3545,784,307,992,887,19,15,13,208,580,48,66,0,0
3546,758,292,961,860,19,15,13,203,568,49,66,0,0
3547,729,277,923,827,19,15,13,194,550,50,66,0,0
3548,684,270,881,814,19,15,13,197,544,51,66,0,0
3549,660,265,856,804,19,15,13,196,539,52,66,0,0
3550,639,261,831,788,19,15,13,192,527,53,66,0,0
3551,603,254,791,772,19,15,13,188,518,54,66,0,0
3552,572,249,758,762,19,15,13,186,513,55,66,0,0
3553,538,245,722,754,19,15,13,184,509,56,66,0,0
3554,514,232,700,748,19,15,13,186,516,57,66,0,0
3555,481,228,660,731,19,15,13,179,503,58,66,0,0
3556,447,229,620,720,19,15,13,173,491,59,66,0,0
3557,415,233,586,715,19,15,13,171,482,60,66,0,0
3558,379,237,553,723,19,15,13,174,486,61,66,0,0
3559,340,236,510,718,19,15,13,170,482,62,66,0,0
3560,307,239,471,712,19,15,13,164,473,63,66,0,0
3561,288,247,450,716,19,15,13,162,469,64,66,0,0
3562,272,252,421,697,19,15,13,149,445,65,66,0,0
3563,244,252,391,690,19,15,13,147,438,66,66,1,0
3506,945,660,1268,1063,20,15,13,323,403,0,52,0,1
3507,914,673,1230,1068,20,15,13,316,395,1,52,0,0
3508,846,639,1189,1065,20,15,13,343,426,2,52,0,0
3509,769,649,1109,1076,20,15,13,340,427,3,52,0,0
3510,706,611,1077,1079,20,15,13,371,468,4,52,0,0
3511,670,585,1055,1076,20,15,13,385,491,5,52,0,0
3512,647,562,1044,1077,20,15,13,397,515,6,52,0,0
3513,643,557,1033,1074,20,15,13,390,517,7,52,0,0
3514,645,539,1040,1072,20,15,13,395,533,8,52,0,0
3515,639,524,1033,1071,20,15,13,394,547,9,52,0,0
3516,633,514,1024,1073,20,15,13,391,559,10,52,0,0
3517,627,495,1017,1071,20,15,13,390,576,11,52,0,0
3518,635,486,1018,1071,20,15,13,383,585,12,52,0,0
3519,653,471,1033,1070,20,15,13,380,599,13,52,0,0
3520,671,464,1041,1068,20,15,13,370,604,14,52,0,0
3521,694,475,1046,1069,20,15,13,352,594,15,52,0,0
3522,715,471,1058,1067,20,15,13,343,596,16,52,0,0
3523,730,459,1069,1069,20,15,13,339,610,17,52,0,0
3524,739,451,1072,1069,20,15,13,333,618,18,52,0,0
3525,741,435,1075,1072,20,15,13,334,637,19,52,0,0
3526,743,442,1062,1069,20,15,13,319,627,20,52,0,0
3527,747,442,1058,1069,20,15,13,311,627,21,52,0,0
3528,748,448,1047,1067,20,15,13,299,619,22,52,0,0
3529,740,455,1031,1072,20,15,13,291,617,23,52,0,0
3530,739,455,1022,1071,20,15,13,283,616,24,52,0,0
3531,737,454,1016,1072,20,15,13,279,618,25,52,0,0
3532,736,451,1012,1074,20,15,13,276,623,26,52,0,0
3533,744,452,1013,1071,20,15,13,269,619,27,52,0,0
3534,750,450,1015,1066,20,15,13,265,616,28,52,0,0
3535,752,449,1016,1065,20,15,13,264,616,29,52,0,0
3536,750,442,1014,1064,20,15,13,264,622,30,52,0,0
3537,744,439,1004,1064,20,15,13,260,625,31,52,0,0
3538,735,433,990,1059,20,15,13,255,626,32,52,0,0
3539,724,427,972,1050,20,15,13,248,623,33,52,0,0
3540,715,423,958,1045,20,15,13,243,622,34,52,0,0
3541,695,413,938,1048,20,15,13,243,635,35,52,0,0
3542,684,403,911,1005,20,15,13,227,602,36,52,0,0
3543,674,396,890,976,20,15,13,216,580,37,52,0,0
3544,641,392,855,963,20,15,13,214,571,38,52,0,0
3545,619,391,830,964,20,15,13,211,573,39,52,0,0
3546,586,377,798,961,20,15,13,212,584,40,52,0,0
3547,556,376,763,955,20,15,13,207,579,41,52,0,0
3548,527,359,733,946,20,15,13,206,587,42,52,0,0
3549,505,345,703,920,20,15,13,198,575,43,52,0,0
3550,483,328,670,876,20,15,13,187,548,44,52,0,0
3551,453,336,630,852,20,15,13,177,516,45,52,0,0
3552,416,320,590,830,20,15,13,174,510,46,52,0,0
3553,380,311,550,817,20,15,13,170,506,47,52,0,0
3554,350,308,512,795,20,15,13,162,487,48,52,0,0
3555,320,295,474,759,20,15,13,154,464,49,52,0,0
3556,291,287,442,750,20,15,13,151,463,50,52,0,0
3557,285,332,415,731,20,15,13,130,399,51,52,0,0
3558,260,331,385,713,20,15,13,125,382,52,52,1,0
3564,300,333,348,476,20,15,13,48,143,0,52,0,0
3565,294,333,332,445,20,15,13,38,112,1,52,0,0
3531,587,250,671,512,21,15,13,84,262,0,1,0,0
3532,550,251,685,675,21,15,13,135,424,1,1,0,0
3534,492,244,636,688,22,15,13,144,444,0,6,0,0
3535,471,237,616,684,22,15,13,145,447,1,6,0,0
3536,466,242,608,683,22,15,13,142,441,2,6,0,0
3537,457,247,593,677,22,15,13,136,430,3,6,0,0
3538,443,247,573,666,22,15,13,130,419,4,6,0,0
3539,460,256,557,570,22,15,13,97,314,5,6,0,0
3540,456,259,544,543,22,15,13,88,284,6,6,0,0
3541,482,256,590,657,23,15,13,108,401,0,11,0,0
3542,470,261,587,693,23,15,13,117,432,1,11,0,0
3543,462,257,579,689,23,15,13,117,432,2,11,0,0
3544,433,259,555,705,23,15,13,122,446,3,11,0,0
3545,412,262,533,702,23,15,13,121,440,4,11,0,0
3546,392,262,516,702,23,15,13,124,440,5,11,0,0
3547,361,259,483,692,23,15,13,122,433,6,11,0,0
3548,331,264,453,697,23,15,13,122,433,7,11,0,0
3549,306,270,428,698,23,15,13,122,428,8,11,0,0
3550,291,305,402,700,23,15,13,111,395,9,11,0,0
3551,277,343,378,713,23,15,13,101,370,10,11,0,0
3552,258,354,356,716,23,15,13,98,362,11,11,0,0
3659,1400,830,1630,1069,24,15,13,230,239,0,0,0,0
3660,1231,750,1513,1073,25,15,13,282,323,0,44,0,1
3661,1154,709,1475,1077,25,15,13,321,368,1,44,0,0
3662,1073,650,1441,1073,25,15,13,368,423,2,44,0,0
3663,1014,592,1425,1069,25,15,13,411,477,3,44,0,0
3664,953,555,1378,1059,25,15,13,425,504,4,44,0,0
3665,861,513,1319,1071,25,15,13,458,558,5,44,0,0
3666,783,491,1251,1076,25,15,13,468,585,6,44,0,0
3667,717,472,1180,1067,25,15,13,463,595,7,44,0,0
3668,667,441,1115,1038,25,15,13,448,597,8,44,0,0
3669,590,419,1033,1034,25,15,13,443,615,9,44,0,0
3670,521,413,945,1010,25,15,13,424,597,10,44,0,0
3671,434,398,843,991,25,15,13,409,593,11,44,0,0
3672,359,382,761,977,25,15,13,402,595,12,44,0,0
3673,309,380,705,971,25,15,13,396,591,13,44,0,0
3674,269,369,657,951,25,15,13,388,582,14,44,0,0
3675,247,357,626,933,25,15,13,379,576,15,44,0,0
3676,277,359,633,920,25,15,13,356,561,16,44,0,0
3677,325,352,655,898,25,15,13,330,546,17,44,0,0
3678,361,341,664,864,25,15,13,303,523,18,44,0,0
3679,393,333,685,857,25,15,13,292,524,19,44,0,0
3680,422,331,662,773,25,15,13,240,442,20,44,0,0
3681,442,330,657,738,25,15,13,215,408,21,44,0,0
3682,432,321,689,835,25,15,13,257,514,22,44,0,0
3683,449,316,662,760,25,15,13,213,444,23,44,0,0
3684,439,306,651,746,25,15,13,212,440,24,44,0,0
3690,517,302,657,607,25,15,13,140,305,0,44,0,1
3691,508,296,674,675,25,15,13,166,379,1,44,0,0
3692,524,299,662,618,25,15,13,138,319,2,44,0,0
3693,502,295,676,713,25,15,13,174,418,3,44,0,0
3694,525,303,670,652,25,15,13,145,349,4,44,0,0
3695,527,306,678,680,25,15,13,151,374,5,44,0,0
3696,522,302,681,711,25,15,13,159,409,6,44,0,0
3697,541,303,671,639,25,15,13,130,336,7,44,0,0
3698,555,302,661,575,25,15,13,106,273,8,44,0,0
3699,558,303,658,558,25,15,13,100,255,9,44,0,0
3700,559,302,656,551,25,15,13,97,249,10,44,0,0
3701,534,306,668,654,25,15,13,134,348,11,44,0,0
3702,533,308,666,658,25,15,13,133,350,12,44,0,0
3703,534,306,663,648,25,15,13,129,342,13,44,0,0
3704,523,305,667,697,25,15,13,144,392,14,44,0,0
3705,530,307,661,668,25,15,13,131,361,15,44,0,0
3706,532,309,660,667,25,15,13,128,358,16,44,0,0
3707,521,307,663,712,25,15,13,142,405,17,44,0,0
3708,521,306,659,705,25,15,13,138,399,18,44,0,0
3709,540,305,654,640,25,15,13,114,335,19,44,0,0
3710,549,306,649,598,25,15,13,100,292,20,44,0,0
3711,543,300,645,595,25,15,13,102,295,21,44,0,0
3712,534,301,643,615,25,15,13,109,314,22,44,0,0
3713,532,301,642,609,25,15,13,110,308,23,44,0,0
3714,532,299,637,593,25,15,13,105,294,24,44,0,0
3715,530,301,641,614,25,15,13,111,313,25,44,0,0
3716,535,304,642,601,25,15,13,107,297,26,44,0,0
3717,534,298,646,619,25,15,13,112,321,27,44,0,0
3718,530,298,648,631,25,15,13,118,333,28,44,0,0
3719,527,301,651,650,25,15,13,124,349,29,44,0,0
3720,532,306,659,663,25,15,13,127,357,30,44,0,0
3721,535,306,664,671,25,15,13,129,365,31,44,0,0
3722,541,306,665,655,25,15,13,124,349,32,44,0,0
3723,545,302,666,643,25,15,13,121,341,33,44,0,0
3724,536,302,661,657,25,15,13,125,355,34,44,0,0
3725,508,298,657,729,25,15,13,149,431,35,44,0,0
3726,503,297,639,696,25,15,13,136,399,36,44,0,0
3727,485,299,628,723,25,15,13,143,424,37,44,0,0
3728,464,299,608,728,25,15,13,144,429,38,44,0,0
3729,442,298,587,738,25,15,13,145,440,39,44,0,0
3730,415,296,553,722,25,15,13,138,426,40,44,0,0
3731,384,300,510,691,25,15,13,126,391,41,44,0,0
3732,338,306,484,774,25,15,13,146,468,42,44,0,0
3733,304,305,454,790,25,15,13,150,485,43,44,0,0
3734,286,306,440,801,25,15,13,154,495,44,44,1,0
3670,1055,763,1276,1068,27,15,13,221,305,0,0,0,0
3671,861,649,1200,1074,28,15,13,339,425,0,69,0,1
3672,802,632,1152,1071,28,15,13,350,439,1,69,0,0
3673,733,588,1117,1070,28,15,13,384,482,2,69,0,0
3674,628,531,1056,1069,28,15,13,428,538,3,69,0,0
3675,574,489,1030,1069,28,15,13,456,580,4,69,0,0
3676,545,459,1014,1069,28,15,13,469,610,5,69,0,0
3677,520,421,1001,1064,28,15,13,481,643,6,69,0,0
3678,496,399,979,1066,28,15,13,483,667,7,69,0,0
3679,470,374,956,1067,28,15,13,486,693,8,69,0,0
3680,449,358,911,1038,28,15,13,462,680,9,69,0,0
3681,443,348,884,1024,28,15,13,441,676,10,69,0,0
3682,438,338,860,1014,28,15,13,422,676,11,69,0,0
3683,433,329,825,986,28,15,13,392,657,12,69,0,0
3684,437,326,799,958,28,15,13,362,632,13,69,0,0
3685,439,316,780,941,28,15,13,341,625,14,69,0,0
3686,443,310,771,937,28,15,13,328,627,15,69,0,0
3687,450,303,768,936,28,15,13,318,633,16,69,0,0
3688,454,280,770,937,28,15,13,316,657,17,69,0,0
3689,468,284,774,942,28,15,13,306,658,18,69,0,0
3690,487,296,780,943,28,15,13,293,647,19,69,0,0
3691,505,292,791,943,28,15,13,286,651,20,69,0,0
3692,515,283,797,942,28,15,13,282,659,21,69,0,0
3693,527,295,800,945,28,15,13,273,650,22,69,0,0
3694,536,306,801,944,28,15,13,265,638,23,69,0,0
3695,540,309,802,944,28,15,13,262,635,24,69,0,0
3696,543,307,802,943,28,15,13,259,636,25,69,0,0
3697,546,308,801,943,28,15,13,255,635,26,69,0,0
3698,544,305,798,946,28,15,13,254,641,27,69,0,0
3699,545,309,795,946,28,15,13,250,637,28,69,0,0
3700,547,318,793,949,28,15,13,246,631,29,69,0,0
3701,548,316,793,948,28,15,13,245,632,30,69,0,0
3702,549,312,795,947,28,15,13,246,635,31,69,0,0
3703,550,313,794,948,28,15,13,244,635,32,69,0,0
3704,551,317,791,947,28,15,13,240,630,33,69,0,0
3705,550,318,788,947,28,15,13,238,629,34,69,0,0
3706,549,321,784,948,28,15,13,235,627,35,69,0,0
3707,545,317,778,949,28,15,13,233,632,36,69,0,0
3708,544,316,776,949,28,15,13,232,633,37,69,0,0
3709,546,320,775,950,28,15,13,229,630,38,69,0,0
3710,548,318,776,951,28,15,13,228,633,39,69,0,0
3711,549,318,775,949,28,15,13,226,631,40,69,0,0
3712,550,320,774,948,28,15,13,224,628,41,69,0,0
3713,555,320,777,945,28,15,13,222,625,42,69,0,0
3714,557,322,778,944,28,15,13,221,622,43,69,0,0
3715,559,322,779,944,28,15,13,220,622,44,69,0,0
3716,560,325,777,942,28,15,13,217,617,45,69,0,0
3717,562,325,775,933,28,15,13,213,608,46,69,0,0
3718,566,325,777,936,28,15,13,211,611,47,69,0,0
3719,568,323,780,939,28,15,13,212,616,48,69,0,0
3720,571,328,782,940,28,15,13,211,612,49,69,0,0
3721,570,324,784,944,28,15,13,214,620,50,69,0,0
3722,570,324,783,945,28,15,13,213,621,51,69,0,0
3723,572,324,781,943,28,15,13,209,619,52,69,0,0
3724,568,323,777,941,28,15,13,209,618,53,69,0,0
3725,569,323,772,929,28,15,13,203,606,54,69,0,0
3726,557,318,755,918,28,15,13,198,600,55,69,0,0
3727,541,309,736,911,28,15,13,195,602,56,69,0,0
3728,515,302,706,895,28,15,13,191,593,57,69,0,0
3729,494,300,680,883,28,15,13,186,583,58,69,0,0
3730,489,298,667,863,28,15,13,178,565,59,69,0,0
3731,474,296,651,859,28,15,13,177,563,60,69,0,0
3732,464,286,640,849,28,15,13,176,563,61,69,0,0
3733,442,270,612,813,28,15,13,170,543,62,69,0,0
3734,426,263,590,792,28,15,13,164,529,63,69,0,0
3735,404,270,563,781,28,15,13,159,511,64,69,0,0
3736,368,257,529,766,28,15,13,161,509,65,69,0,0
3737,322,252,475,741,28,15,13,153,489,66,69,0,0
3738,301,260,450,736,28,15,13,149,476,67,69,0,0
3739,269,231,410,699,28,15,13,141,468,68,69,0,0
3740,247,225,386,683,28,15,13,139,458,69,69,1,0
4774,539,138,582,275,30,15,13,43,137,0,14,0,0
4775,532,137,573,265,30,15,13,41,128,1,14,0,0
4776,514,139,553,262,30,15,13,39,123,2,14,0,0
4777,495,133,536,261,30,15,13,41,128,3,14,0,0
4778,480,132,521,258,30,15,13,41,126,4,14,0,0
4779,462,135,503,261,30,15,13,41,126,5,14,0,0
4780,445,137,486,262,30,15,13,41,125,6,14,0,0
4781,431,132,474,262,30,15,13,43,130,7,14,0,0
4782,410,135,452,260,30,15,13,42,125,8,14,0,0
4783,393,132,436,259,30,15,13,43,127,9,14,0,0
4784,376,128,421,258,30,15,13,45,130,10,14,0,0
4785,359,129,405,260,30,15,13,46,131,11,14,0,0
4786,342,127,389,264,30,15,13,47,137,12,14,0,0
4787,332,129,378,264,30,15,13,46,135,13,14,0,0
4788,316,128,362,264,30,15,13,46,136,14,14,0,0
5919,1322,888,1489,1074,32,15,13,167,186,0,0,0,0
5927,236,443,846,1069,33,15,13,610,626,0,1,0,0
5928,180,399,832,1068,33,15,13,652,669,1,1,0,0
5920,1188,836,1415,1078,34,15,13,227,242,0,7,0,0
5921,1103,769,1392,1078,34,15,13,289,309,1,7,0,0
5922,1017,714,1355,1078,34,15,13,338,364,2,7,0,0
5923,928,674,1296,1075,34,15,13,368,401,3,7,0,0
5924,847,616,1256,1071,34,15,13,409,455,4,7,0,0
5925,780,575,1198,1053,34,15,13,418,478,5,7,0,0
5926,764,547,1141,987,34,15,13,377,440,6,7,0,0
5927,707,510,1105,975,34,15,13,398,465,7,7,0,0
5933,506,487,1065,1066,36,15,13,559,579,0,22,0,1
5934,507,455,1046,1037,36,15,13,539,582,1,22,0,0
5935,503,431,1017,1011,36,15,13,514,580,2,22,0,0
5936,492,410,978,984,36,15,13,486,574,3,22,0,0
5937,495,383,939,929,36,15,13,444,546,4,22,0,0
5938,484,372,895,898,36,15,13,411,526,5,22,0,0
5939,480,346,877,880,36,15,13,397,534,6,22,0,0
5940,486,331,842,828,36,15,13,356,497,7,22,0,0
5941,479,325,806,799,36,15,13,327,474,8,22,0,0
5942,476,309,777,762,36,15,13,301,453,9,22,0,0
5943,473,300,750,733,36,15,13,277,433,10,22,0,0
5944,470,292,733,719,36,15,13,263,427,11,22,0,0
5945,474,281,714,680,36,15,13,240,399,12,22,0,0
5946,471,279,697,665,36,15,13,226,386,13,22,0,0
5947,455,266,675,655,36,15,13,220,389,14,22,0,0
5948,454,265,645,615,36,15,13,191,350,15,22,0,0
5949,450,260,632,601,36,15,13,182,341,16,22,0,0
5950,456,258,616,566,36,15,13,160,308,17,22,0,0
5951,442,252,603,569,36,15,13,161,317,18,22,0,0
5952,439,246,602,577,36,15,13,163,331,19,22,0,0
5953,432,235,594,575,36,15,13,162,340,20,22,0,0
5954,428,231,582,557,36,15,13,154,326,21,22,0,0
5955,418,221,569,543,36,15,13,151,322,22,22,1,0
5958,501,240,629,522,36,15,13,128,282,0,22,0,0
5959,524,246,649,530,36,15,13,125,284,1,22,0,0
5960,545,250,668,531,36,15,13,123,281,2,22,0,0
5961,571,247,689,523,36,15,13,118,276,3,22,0,0
5962,596,249,712,522,36,15,13,116,273,4,22,0,0
5963,622,252,739,525,36,15,13,117,273,5,22,0,0
5964,657,251,770,517,36,15,13,113,266,6,22,0,0
5965,683,254,793,519,36,15,13,110,265,7,22,0,0
5966,721,252,815,480,36,15,13,94,228,8,22,0,0
5967,740,251,831,471,36,15,13,91,220,9,22,0,0
5968,788,255,861,432,36,15,13,73,177,10,22,0,0
5969,811,259,888,451,36,15,13,77,192,11,22,0,0
5970,836,262,904,430,36,15,13,68,168,12,22,0,0
5971,840,260,909,421,36,15,13,69,161,13,22,0,0
5972,860,260,925,411,36,15,13,65,151,14,22,0,0
5927,850,512,1027,787,37,15,13,177,275,0,20,0,1
5928,813,481,989,754,37,15,13,176,273,1,20,0,0
5929,794,469,965,735,37,15,13,171,266,2,20,0,0
5930,775,443,932,688,37,15,13,157,245,3,20,0,0
5931,761,424,883,608,37,15,13,122,184,4,20,0,0
5932,745,401,861,574,37,15,13,116,173,5,20,0,0
5933,729,388,852,569,37,15,13,123,181,6,20,0,0
5934,693,386,808,552,37,15,13,115,166,7,20,0,0
5935,651,369,789,572,37,15,13,138,203,8,20,0,0
5936,639,348,762,527,37,15,13,123,179,9,20,0,0
5937,635,342,731,479,37,15,13,96,137,10,20,0,0
5938,630,324,721,454,37,15,13,91,130,11,20,0,0
5939,619,313,704,434,37,15,13,85,121,12,20,0,0
5940,601,303,683,421,37,15,13,82,118,13,20,0,0
5941,582,293,660,407,37,15,13,78,114,14,20,0,0
5942,565,291,636,395,37,15,13,71,104,15,20,0,0
5943,548,280,614,376,37,15,13,66,96,16,20,0,0
5944,551,275,615,369,37,15,13,64,94,17,20,0,0
5945,540,275,595,355,37,15,13,55,80,18,20,0,0
5946,517,271,576,359,37,15,13,59,88,19,20,0,0
5947,502,264,557,346,37,15,13,55,82,20,20,1,0
5928,441,422,661,1008,38,15,13,220,586,0,26,0,1
5929,437,412,658,1001,38,15,13,221,589,1,26,0,0
5930,415,398,632,976,38,15,13,217,578,2,26,0,0
5931,409,381,606,908,38,15,13,197,527,3,26,0,0
5932,410,364,600,879,38,15,13,190,515,4,26,0,0
5933,409,352,595,861,38,15,13,186,509,5,26,0,0
5934,421,343,592,816,38,15,13,171,473,6,26,0,0
5935,426,329,593,799,38,15,13,167,470,7,26,0,0
5936,412,323,570,763,38,15,13,158,440,8,26,0,0
5937,414,317,563,731,38,15,13,149,414,9,26,0,0
5938,420,306,566,716,38,15,13,146,410,10,26,0,0
5939,431,296,564,677,38,15,13,133,381,11,26,0,0
5940,438,291,567,662,38,15,13,129,371,12,26,0,0
5941,433,280,563,654,38,15,13,130,374,13,26,0,0
5942,420,274,544,626,38,15,13,124,352,14,26,0,0
5943,401,264,521,609,38,15,13,120,345,15,26,0,0
5944,385,256,504,602,38,15,13,119,346,16,26,0,0
5945,377,248,484,561,38,15,13,107,313,17,26,0,0
5946,366,242,473,551,38,15,13,107,309,18,26,0,0
5947,355,240,460,547,38,15,13,105,307,19,26,0,0
5948,349,237,451,537,38,15,13,102,300,20,26,0,0
5949,347,224,450,527,38,15,13,103,303,21,26,0,0
5950,357,220,458,522,38,15,13,101,302,22,26,0,0
5951,372,221,472,523,38,15,13,100,302,23,26,0,0
5952,392,221,490,523,38,15,13,98,302,24,26,0,0
5953,406,217,507,531,38,15,13,101,314,25,26,0,0
5954,408,211,507,522,38,15,13,99,311,26,26,1,0
5939,1415,844,1639,1074,40,15,13,224,230,0,1,0,0
5940,1295,771,1586,1067,40,15,13,291,296,1,1,0,0
5941,1090,692,1410,1074,41,15,13,320,382,0,42,0,1
5942,998,650,1352,1074,41,15,13,354,424,1,42,0,0
5943,908,599,1301,1072,41,15,13,393,473,2,42,0,0
5944,818,551,1244,1070,41,15,13,426,519,3,42,0,0
5945,738,513,1190,1072,41,15,13,452,559,4,42,0,0
5946,654,470,1132,1071,41,15,13,478,601,5,42,0,0
5947,583,441,1073,1068,41,15,13,490,627,6,42,0,0
5948,540,417,1035,1070,41,15,13,495,653,7,42,0,0
5949,510,395,999,1062,41,15,13,489,667,8,42,0,0
5950,479,372,964,1059,41,15,13,485,687,9,42,0,0
5951,450,359,918,1045,41,15,13,468,686,10,42,0,0
5952,428,344,873,1023,41,15,13,445,679,11,42,0,0
5953,395,333,812,989,41,15,13,417,656,12,42,0,0
5954,352,324,755,972,41,15,13,403,648,13,42,0,0
5955,305,297,708,956,41,15,13,403,659,14,42,0,0
5956,280,292,657,918,41,15,13,377,626,15,42,0,0
5957,263,285,619,884,41,15,13,356,599,16,42,0,0
5958,255,284,593,860,41,15,13,338,576,17,42,0,0
5959,276,273,592,836,41,15,13,316,563,18,42,0,0
5960,271,276,567,818,41,15,13,296,542,19,42,0,0
5961,279,272,564,811,41,15,13,285,539,20,42,0,0
5962,297,262,565,784,41,15,13,268,522,21,42,0,0
5963,319,260,568,766,41,15,13,249,506,22,42,0,0
5964,334,257,572,762,41,15,13,238,505,23,42,0,0
5965,352,254,577,748,41,15,13,225,494,24,42,0,0
5966,375,251,590,734,41,15,13,215,483,25,42,0,0
5967,402,248,609,719,41,15,13,207,471,26,42,0,0
5968,425,234,637,729,41,15,13,212,495,27,42,0,0
5969,461,237,660,712,41,15,13,199,475,28,42,0,0
5970,484,241,673,711,41,15,13,189,470,29,42,0,0
5971,495,243,677,712,41,15,13,182,469,30,42,0,0
5972,515,245,668,645,41,15,13,153,400,31,42,0,0
5973,529,245,660,586,41,15,13,131,341,32,42,0,0
5974,531,236,668,595,41,15,13,137,359,33,42,0,0
5975,524,233,660,594,41,15,13,136,361,34,42,0,0
5976,543,237,655,519,41,15,13,112,282,35,42,0,0
5977,551,238,644,462,41,15,13,93,224,36,42,0,0
5978,556,232,642,426,41,15,13,86,194,37,42,0,0
5979,551,230,638,420,41,15,13,87,190,38,42,0,0
5980,530,223,636,451,41,15,13,106,228,39,42,0,0
5981,490,226,637,550,41,15,13,147,324,40,42,0,0
5982,472,220,630,577,41,15,13,158,357,41,42,0,0
5983,464,218,627,585,41,15,13,163,367,42,42,1,0
5998,672,206,759,403,41,15,13,87,197,0,42,0,0
5999,650,206,775,502,41,15,13,125,296,1,42,0,0
6000,648,211,773,523,41,15,13,125,312,2,42,0,0
6001,643,212,769,538,41,15,13,126,326,3,42,0,0
6002,639,215,768,558,41,15,13,129,343,4,42,0,0
6003,633,217,763,567,41,15,13,130,350,5,42,0,0
6004,625,220,757,579,41,15,13,132,359,6,42,0,0
6005,610,224,744,594,41,15,13,134,370,7,42,0,0
5950,566,258,632,357,42,15,13,66,99,0,0,0,0
5951,541,249,641,526,43,15,13,100,277,0,0,0,0
5952,586,256,668,374,44,15,13,82,118,0,0,0,0
5953,628,260,679,339,47,15,13,51,79,0,0,0,0
5954,625,260,725,504,48,15,13,100,244,0,8,0,0
5955,646,264,744,503,48,15,13,98,239,1,8,0,0
5956,675,269,776,512,48,15,13,101,243,2,8,0,0
5957,702,269,804,514,48,15,13,102,245,3,8,0,0
5958,749,266,854,517,48,15,13,105,251,4,8,0,0
5959,780,276,884,522,48,15,13,104,246,5,8,0,0
5960,811,278,917,528,48,15,13,106,250,6,8,0,0
5961,838,282,943,532,48,15,13,105,250,7,8,0,0
5962,867,285,972,537,48,15,13,105,252,8,8,0,0
5954,1225,876,1424,1076,49,15,13,199,200,0,0,0,0
5961,630,523,1160,1063,50,15,13,530,540,0,4,0,0
5962,598,493,1144,1069,50,15,13,546,576,1,4,0,0
5963,572,458,1124,1065,50,15,13,552,607,2,4,0,0
5964,568,437,1077,1019,50,15,13,509,582,3,4,0,0
5965,519,402,1053,1015,50,15,13,534,613,4,4,0,0
5955,479,226,593,349,51,15,13,114,123,0,0,0,0
5957,517,278,597,428,52,15,13,80,150,0,0,0,0
5957,582,230,644,473,53,15,13,62,243,0,11,0,0
5958,603,235,671,499,53,15,13,68,264,1,11,0,0
5959,615,234,689,516,53,15,13,74,282,2,11,0,0
5960,654,235,727,507,53,15,13,73,272,3,11,0,0
5961,691,239,763,503,53,15,13,72,264,4,11,0,0
5962,719,240,796,512,53,15,13,77,272,5,11,0,0
5963,758,239,837,514,53,15,13,79,275,6,11,0,0
5964,785,240,866,511,53,15,13,81,271,7,11,0,0
5965,823,245,888,449,53,15,13,65,204,8,11,0,0
5966,849,250,914,445,53,15,13,65,195,9,11,0,0
5967,859,256,935,485,53,15,13,76,229,10,11,0,0
5968,884,259,960,487,53,15,13,76,228,11,11,0,0
5961,1026,465,1266,1067,54,15,13,240,602,0,16,0,0
5962,961,452,1202,1054,54,15,13,241,602,1,16,0,0
5963,941,428,1170,1002,54,15,13,229,574,2,16,0,0
5964,925,425,1138,961,54,15,13,213,536,3,16,0,0
5965,898,415,1101,928,54,15,13,203,513,4,16,0,0
5966,895,385,1089,873,54,15,13,194,488,5,16,0,0
5967,874,364,1074,863,54,15,13,200,499,6,16,0,0
5968,860,353,1049,820,54,15,13,189,467,7,16,0,0
5969,846,336,1020,761,54,15,13,174,425,8,16,0,0
5970,837,319,1001,715,54,15,13,164,396,9,16,0,0
5971,830,303,989,676,54,15,13,159,373,10,16,0,0
5972,835,296,975,619,54,15,13,140,323,11,16,0,0
5973,832,297,958,582,54,15,13,126,285,12,16,0,0
5974,831,294,941,534,54,15,13,110,240,13,16,0,0
5975,805,282,919,533,54,15,13,114,251,14,16,0,0
5976,795,277,893,489,54,15,13,98,212,15,16,0,0
5977,785,268,871,454,54,15,13,86,186,16,16,0,0
5979,774,250,855,423,54,15,13,81,173,0,16,0,0
5980,766,242,838,395,54,15,13,72,153,1,16,0,0
5963,1353,860,1540,1067,55,15,13,187,207,0,0,0,0
5964,1153,800,1418,1080,56,15,13,265,280,0,41,0,1
5965,1045,731,1369,1074,56,15,13,324,343,1,41,0,0
5966,968,678,1340,1074,56,15,13,372,396,2,41,0,0
5967,901,642,1300,1073,56,15,13,399,431,3,41,0,0
5968,839,589,1275,1069,56,15,13,436,480,4,41,0,0
5969,788,551,1246,1069,56,15,13,458,518,5,41,0,0
5970,735,521,1205,1071,56,15,13,470,550,6,41,0,0
5971,698,496,1170,1070,56,15,13,472,574,7,41,0,0
5972,670,459,1141,1056,56,15,13,471,597,8,41,0,0
5973,662,449,1118,1052,56,15,13,456,603,9,41,0,0
5974,673,415,1083,983,56,15,13,410,568,10,41,0,0
5975,667,381,1060,949,56,15,13,393,568,11,41,0,0
5976,651,349,1033,928,56,15,13,382,579,12,41,0,0
5977,632,300,1011,907,56,15,13,379,607,13,41,0,0
5978,636,285,979,861,56,15,13,343,576,14,41,0,0
5979,641,303,941,833,56,15,13,300,530,15,41,0,0
5980,646,310,922,820,56,15,13,276,510,16,41,0,0
5981,655,312,899,780,56,15,13,244,468,17,41,0,0
5982,656,303,886,764,56,15,13,230,461,18,41,0,0
5983,646,274,873,748,56,15,13,227,474,19,41,0,0
5984,638,260,854,724,56,15,13,216,464,20,41,0,0
5985,640,268,833,698,56,15,13,193,430,21,41,0,0
5986,649,284,824,686,56,15,13,175,402,22,41,0,0
5987,653,278,823,678,56,15,13,170,400,23,41,0,0
5988,657,276,817,659,56,15,13,160,383,24,41,0,0
5989,659,273,814,654,56,15,13,155,381,25,41,0,0
5990,654,266,809,656,56,15,13,155,390,26,41,0,0
5991,655,262,799,634,56,15,13,144,372,27,41,0,0
5992,664,264,800,622,56,15,13,136,358,28,41,0,0
5993,662,257,798,618,56,15,13,136,361,29,41,0,0
5994,646,256,788,635,56,15,13,142,379,30,41,0,0
5995,643,256,786,644,56,15,13,143,388,31,41,0,0
5996,640,266,780,653,56,15,13,140,387,32,41,0,0
5997,623,268,765,658,56,15,13,142,390,33,41,0,0
5998,595,271,740,666,56,15,13,145,395,34,41,0,0
5999,572,272,719,671,56,15,13,147,399,35,41,0,0
6000,553,261,704,674,56,15,13,151,413,36,41,0,0
6001,540,266,690,685,56,15,13,150,419,37,41,0,0
6002,529,271,675,685,56,15,13,146,414,38,41,0,0
6003,498,272,649,701,56,15,13,151,429,39,41,0,0
6004,484,276,634,708,56,15,13,150,432,40,41,0,0
6005,470,278,619,712,56,15,13,149,434,41,41,1,0
5970,458,511,1007,1063,57,15,13,549,552,0,4,0,0
5971,418,490,972,1065,57,15,13,554,575,1,4,0,0
5972,375,460,942,1069,57,15,13,567,609,2,4,0,0
5973,366,433,932,1065,57,15,13,566,632,3,4,0,0
5974,333,397,931,1065,57,15,13,598,668,4,4,0,0
5965,697,416,920,802,58,15,13,223,386,0,18,0,0
5966,695,415,909,784,58,15,13,214,369,1,18,0,0
5967,690,398,885,734,58,15,13,195,336,2,18,0,0
5968,667,354,876,717,58,15,13,209,363,3,18,0,0
5969,659,344,853,681,58,15,13,194,337,4,18,0,0
5970,653,329,841,658,58,15,13,188,329,5,18,0,0
5971,635,324,839,688,58,15,13,204,364,6,18,0,0
5972,643,319,821,639,58,15,13,178,320,7,18,0,0
5973,647,308,807,600,58,15,13,160,292,8,18,0,0
5974,654,304,804,579,58,15,13,150,275,9,18,0,0
5975,653,301,800,579,58,15,13,147,278,10,18,0,0
5976,649,301,807,608,58,15,13,158,307,11,18,0,0
5977,649,296,804,601,58,15,13,155,305,12,18,0,0
5978,635,292,824,678,58,15,13,189,386,13,18,0,0
5979,655,282,801,582,58,15,13,146,300,14,18,0,0
5980,670,274,790,521,58,15,13,120,247,15,18,0,0
5981,642,280,806,629,58,15,13,164,349,16,18,0,0
5982,631,278,806,665,58,15,13,175,387,17,18,0,0
5983,624,273,805,672,58,15,13,181,399,18,18,0,0
5991,585,221,736,580,58,15,13,151,359,0,18,0,0
5992,603,212,740,553,58,15,13,137,341,1,18,0,0
5993,599,205,737,548,58,15,13,138,343,2,18,0,0
5974,539,468,770,974,59,15,13,231,506,0,31,0,1
5975,516,421,764,967,59,15,13,248,546,1,31,0,0
5976,498,379,758,952,59,15,13,260,573,2,31,0,0
5977,484,355,737,916,59,15,13,253,561,3,31,0,0
5978,481,330,721,865,59,15,13,240,535,4,31,0,0
5979,483,330,714,849,59,15,13,231,519,5,31,0,0
5980,485,321,712,837,59,15,13,227,516,6,31,0,0
5981,500,307,708,788,59,15,13,208,481,7,31,0,0
5982,495,299,696,768,59,15,13,201,469,8,31,0,0
5983,477,260,687,759,59,15,13,210,499,9,31,0,0
5984,484,270,671,717,59,15,13,187,447,10,31,0,0
5985,478,265,659,703,59,15,13,181,438,11,31,0,0
5986,477,270,653,699,59,15,13,176,429,12,31,0,0
5987,481,253,655,682,59,15,13,174,429,13,31,0,0
5988,491,239,658,658,59,15,13,167,419,14,31,0,0
5989,497,249,653,642,59,15,13,156,393,15,31,0,0
5990,497,252,645,627,59,15,13,148,375,16,31,0,0
5991,495,240,642,611,59,15,13,147,371,17,31,0,0
5992,497,239,639,597,59,15,13,142,358,18,31,0,0
5993,500,235,644,599,59,15,13,144,364,19,31,0,0
5994,511,232,648,576,59,15,13,137,344,20,31,0,0
5995,520,233,653,564,59,15,13,133,331,21,31,0,0
5996,523,232,655,561,59,15,13,132,329,22,31,0,0
5997,524,231,654,558,59,15,13,130,327,23,31,0,0
5998,525,225,659,569,59,15,13,134,344,24,31,0,0
5999,529,223,654,552,59,15,13,125,329,25,31,0,0
6000,542,223,644,495,59,15,13,102,272,26,31,0,0
6001,572,227,636,388,59,15,13,64,161,27,31,0,0
6002,593,226,644,352,59,15,13,51,126,28,31,0,0
6003,587,222,640,346,59,15,13,53,124,29,31,0,0
6004,596,221,649,342,59,15,13,53,121,30,31,0,0
6005,603,219,649,324,59,15,13,46,105,31,31,1,0
5981,761,244,806,316,60,15,13,45,72,0,1,0,0
5982,761,243,811,322,60,15,13,50,79,1,1,0,0
5983,664,273,759,466,61,15,13,95,193,0,1,0,0
5984,678,264,770,450,61,15,13,92,186,1,1,0,0
5984,497,222,611,485,62,15,13,114,263,0,0,0,0
5985,553,214,633,368,63,15,13,80,154,0,6,0,0
5986,551,214,668,440,63,15,13,117,226,1,6,0,0
5987,561,214,680,446,63,15,13,119,232,2,6,0,0
5988,565,211,694,468,63,15,13,129,257,3,6,0,0
5989,572,215,699,472,63,15,13,127,257,4,6,0,0
5990,582,218,696,451,63,15,13,114,233,5,6,0,0
5991,587,219,704,459,63,15,13,117,240,6,6,0,0
5985,759,239,828,398,64,15,13,69,159,0,20,0,1
5986,739,233,820,418,64,15,13,81,185,1,20,0,0
5987,745,233,838,450,64,15,13,93,217,2,20,0,0
5988,746,232,861,504,64,15,13,115,272,3,20,0,0
5989,751,235,869,522,64,15,13,118,287,4,20,0,0
5990,747,249,865,543,64,15,13,118,294,5,20,0,0
5991,746,255,863,551,64,15,13,117,296,6,20,0,0
5992,754,252,873,561,64,15,13,119,309,7,20,0,0
5993,759,246,880,566,64,15,13,121,320,8,20,0,0
5994,757,246,878,564,64,15,13,121,318,9,20,0,0
5995,755,240,880,572,64,15,13,125,332,10,20,0,0
5996,757,240,881,571,64,15,13,124,331,11,20,0,0
5997,759,236,882,565,64,15,13,123,329,12,20,0,0
5998,760,234,883,564,64,15,13,123,330,13,20,0,0
5999,758,230,883,565,64,15,13,125,335,14,20,0,0
6000,755,227,879,565,64,15,13,124,338,15,20,0,0
6001,758,237,877,561,64,15,13,119,324,16,20,0,0
6002,761,243,875,560,64,15,13,114,317,17,20,0,0
6003,762,245,874,559,64,15,13,112,314,18,20,0,0
6004,763,244,873,558,64,15,13,110,314,19,20,0,0
6005,761,244,871,557,64,15,13,110,313,20,20,1,0
5990,814,239,865,474,65,15,13,51,235,0,1,0,0
5991,815,240,868,486,65,15,13,53,246,1,1,0,0
5994,659,212,765,390,66,15,13,106,178,0,0,0,0
5996,718,220,776,353,67,15,13,58,133,0,1,0,0
5997,713,220,780,373,67,15,13,67,153,1,1,0,0
5999,503,134,549,264,69,15,13,46,130,0,6,0,0
6000,501,134,546,262,69,15,13,45,128,1,6,0,0
6001,499,132,544,259,69,15,13,45,127,2,6,0,0
6002,496,131,542,262,69,15,13,46,131,3,6,0,0
6003,495,130,542,265,69,15,13,47,135,4,6,0,0
6004,497,131,546,268,69,15,13,49,137,5,6,0,0
6005,500,131,548,269,69,15,13,48,138,6,6,0,0
6000,762,223,847,350,70,15,13,85,127,0,3,0,0
6001,741,218,850,382,70,15,13,109,164,1,3,0,0
6002,695,219,868,484,70,15,13,173,265,2,3,0,0
6003,676,218,876,525,70,15,13,200,307,3,3,0,0
6004,569,247,648,526,72,15,13,79,279,0,1,0,0
6005,568,220,656,530,72,15,13,88,310,1,1,0,0
6004,734,222,807,537,73,15,13,73,315,0,1,0,0
6005,725,224,796,527,73,15,13,71,303,1,1,0,0
3432,121,887,288,1080,2,15,14,167,193,0,0,0,0
3433,239,824,424,1075,3,15,14,185,251,0,0,0,0
3434,349,757,597,1073,4,15,14,248,316,0,12,0,0
3435,399,694,697,1074,4,15,14,298,380,1,12,0,0
3436,472,664,792,1072,4,15,14,320,408,2,12,0,0
3437,589,639,928,1074,4,15,14,339,435,3,12,0,0
3438,697,600,1062,1078,4,15,14,365,478,4,12,0,0
3439,803,578,1172,1069,4,15,14,369,491,5,12,0,0
3440,924,570,1295,1076,4,15,14,371,506,6,12,0,0
3441,1021,547,1404,1078,4,15,14,383,531,7,12,0,0
3442,1134,533,1524,1079,4,15,14,390,546,8,12,0,0
3443,1280,545,1657,1080,4,15,14,377,535,9,12,0,0
3444,1438,547,1802,1073,4,15,14,364,526,10,12,0,0
3445,1561,556,1916,1076,4,15,14,355,520,11,12,0,0
3446,1662,543,1920,1076,4,15,14,258,533,12,12,0,0
3464,0,532,71,849,6,15,14,71,317,0,32,0,1
3465,0,525,69,849,6,15,14,69,324,1,32,0,0
3466,0,493,70,864,6,15,14,70,371,2,32,0,0
3467,6,490,92,873,6,15,14,86,383,3,32,0,0
3468,13,466,110,890,6,15,14,97,424,4,32,0,0
3469,32,447,138,891,6,15,14,106,444,5,32,0,0
3470,56,442,171,898,6,15,14,115,456,6,32,0,0
3471,69,436,196,906,6,15,14,127,470,7,32,0,0
3472,83,432,219,917,6,15,14,136,485,8,32,0,0
3473,100,428,251,945,6,15,14,151,517,9,32,0,0
3474,116,435,282,978,6,15,14,166,543,10,32,0,0
3475,127,432,304,989,6,15,14,177,557,11,32,0,0
3476,173,432,368,1004,6,15,14,195,572,12,32,0,0
3477,202,442,414,1035,6,15,14,212,593,13,32,0,0
3478,223,439,448,1049,6,15,14,225,610,14,32,0,0
3479,239,437,472,1059,6,15,14,233,622,15,32,0,0
3480,270,439,512,1069,6,15,14,242,630,16,32,0,0
3481,311,443,561,1068,6,15,14,250,625,17,32,0,0
3482,349,443,610,1075,6,15,14,261,632,18,32,0,0
3483,398,452,666,1078,6,15,14,268,626,19,32,0,0
3484,455,450,728,1080,6,15,14,273,630,20,32,0,0
3485,531,446,815,1075,6,15,14,284,629,21,32,0,0
3486,621,457,917,1071,6,15,14,296,614,22,32,0,0
3487,685,473,981,1073,6,15,14,296,600,23,32,0,0
3488,771,488,1070,1076,6,15,14,299,588,24,32,0,0
3489,866,493,1171,1078,6,15,14,305,585,25,32,0,0
3490,981,521,1279,1080,6,15,14,298,559,26,32,0,0
3491,1143,535,1445,1077,6,15,14,302,542,27,32,0,0
3492,1269,536,1571,1071,6,15,14,302,535,28,32,0,0
3493,1346,562,1647,1070,6,15,14,301,508,29,32,0,0
3494,1514,613,1795,1068,6,15,14,281,455,30,32,0,0
3495,1592,632,1873,1067,6,15,14,281,435,31,32,0,0
3496,1685,646,1920,1069,6,15,14,235,423,32,32,1,0
3473,33,482,107,726,7,15,14,74,244,0,0,0,0
3481,402,453,516,617,8,15,14,114,164,0,1,0,0
3482,439,445,548,601,8,15,14,109,156,1,1,0,0
3486,589,452,738,703,9,15,14,149,251,0,15,0,0
3487,636,447,811,742,9,15,14,175,295,1,15,0,0
3488,699,459,872,751,9,15,14,173,292,2,15,0,0
3489,717,468,1002,957,9,15,14,285,489,3,15,0,0
3490,798,469,1071,939,9,15,14,273,470,4,15,0,0
3491,870,468,1200,1044,9,15,14,330,576,5,15,0,0
3492,956,473,1299,1078,9,15,14,343,605,6,15,0,0
3493,1052,487,1389,1080,9,15,14,337,593,7,15,0,0
3494,1135,511,1461,1080,9,15,14,326,569,8,15,0,0
3495,1248,516,1565,1080,9,15,14,317,564,9,15,0,0
3496,1341,528,1653,1080,9,15,14,312,552,10,15,0,0
3497,1435,547,1736,1080,9,15,14,301,533,11,15,0,0
3498,1539,563,1833,1080,9,15,14,294,517,12,15,0,0
3499,1630,597,1907,1080,9,15,14,277,483,13,15,0,0
3500,1720,708,1920,1080,9,15,14,200,372,14,15,0,0
3501,1793,733,1920,1080,9,15,14,127,347,15,15,0,0
3616,0,420,90,698,10,15,14,90,278,0,17,0,0
3617,6,429,97,712,10,15,14,91,283,1,17,0,0
3618,13,433,104,714,10,15,14,91,281,2,17,0,0
3619,19,444,118,746,10,15,14,99,302,3,17,0,0
3620,33,445,135,752,10,15,14,102,307,4,17,0,0
3621,63,445,172,764,10,15,14,109,319,5,17,0,0
3622,84,446,197,773,10,15,14,113,327,6,17,0,0
3623,94,448,209,777,10,15,14,115,329,7,17,0,0
3624,114,457,235,796,10,15,14,121,339,8,17,0,0
3625,129,461,251,798,10,15,14,122,337,9,17,0,0
3626,159,458,292,813,10,15,14,133,355,10,17,0,0
3627,186,459,325,824,10,15,14,139,365,11,17,0,0
3628,195,454,341,834,10,15,14,146,380,12,17,0,0
3629,217,455,370,854,10,15,14,153,399,13,17,0,0
3630,244,460,405,876,10,15,14,161,416,14,17,0,0
3631,266,466,427,880,10,15,14,161,414,15,17,0,0
3632,282,465,448,881,10,15,14,166,416,16,17,0,0
3633,300,468,470,892,10,15,14,170,424,17,17,0,0
3637,308,444,455,815,10,15,14,147,371,0,17,0,0
3638,323,447,481,848,10,15,14,158,401,1,17,0,0
3639,350,445,507,856,10,15,14,157,411,2,17,0,0
3640,371,451,529,868,10,15,14,158,417,3,17,0,0
3641,392,449,566,904,10,15,14,174,455,4,17,0,0
3642,435,461,619,929,10,15,14,184,468,5,17,0,0
3643,483,464,681,962,10,15,14,198,498,6,17,0,0
3644,512,461,721,985,10,15,14,209,524,7,17,0,0
3645,580,469,801,1016,10,15,14,221,547,8,17,0,0
3646,632,475,858,1036,10,15,14,226,561,9,17,0,0
3647,695,474,930,1055,10,15,14,235,581,10,17,0,0
3648,791,493,1032,1067,10,15,14,241,574,11,17,0,0
3649,869,497,1109,1075,10,15,14,240,578,12,17,0,0
3650,961,509,1197,1080,10,15,14,236,571,13,17,0,0
3651,1064,535,1291,1077,10,15,14,227,542,14,17,0,0
3652,1185,534,1409,1075,10,15,14,224,541,15,17,0,0
3653,1297,586,1500,1065,10,15,14,203,479,16,17,0,0
3654,1362,597,1564,1073,10,15,14,202,476,17,17,0,0
3620,2,607,50,817,11,15,14,48,210,0,37,0,0
3621,0,531,68,831,11,15,14,68,300,1,37,0,0
3622,7,539,78,844,11,15,14,71,305,2,37,0,0
3623,16,549,90,862,11,15,14,74,313,3,37,0,0
3624,27,539,108,871,11,15,14,81,332,4,37,0,0
3625,36,511,132,891,11,15,14,96,380,5,37,0,0
3626,42,494,151,905,11,15,14,109,411,6,37,0,0
3627,50,476,177,934,11,15,14,127,458,7,37,0,0
3628,57,464,191,948,11,15,14,134,484,8,37,0,0
3631,158,482,322,1028,11,15,14,164,546,0,37,0,1
3632,171,475,342,1045,11,15,14,171,570,1,37,0,0
3633,239,483,425,1061,11,15,14,186,578,2,37,0,0
3634,278,477,469,1056,11,15,14,191,579,3,37,0,0
3635,319,460,529,1067,11,15,14,210,607,4,37,0,0
3636,379,464,605,1079,11,15,14,226,615,5,37,0,0
3637,422,465,655,1080,11,15,14,233,615,6,37,0,0
3638,455,463,690,1080,11,15,14,235,617,7,37,0,0
3639,504,466,742,1080,11,15,14,238,614,8,37,0,0
3640,555,470,791,1080,11,15,14,236,610,9,37,0,0
3641,610,468,849,1080,11,15,14,239,612,10,37,0,0
3642,674,460,923,1078,11,15,14,249,618,11,37,0,0
3643,744,462,1002,1080,11,15,14,258,618,12,37,0,0
3644,817,451,1084,1080,11,15,14,267,629,13,37,0,0
3645,878,440,1150,1080,11,15,14,272,640,14,37,0,0
3646,956,428,1237,1076,11,15,14,281,648,15,37,0,0
3647,1029,421,1312,1067,11,15,14,283,646,16,37,0,0
3648,1105,406,1391,1060,11,15,14,286,654,17,37,0,0
3649,1156,404,1439,1047,11,15,14,283,643,18,37,0,0
3650,1217,382,1493,1011,11,15,14,276,629,19,37,0,0
3651,1289,367,1549,961,11,15,14,260,594,20,37,0,0
3652,1361,365,1596,903,11,15,14,235,538,21,37,0,0
3653,1401,344,1632,880,11,15,14,231,536,22,37,0,0
3654,1437,333,1637,804,11,15,14,200,471,23,37,0,0
3655,1448,333,1639,793,11,15,14,191,460,24,37,0,0
3656,1453,324,1645,800,11,15,14,192,476,25,37,0,0
3657,1448,318,1640,806,11,15,14,192,488,26,37,0,0
3658,1436,319,1636,838,11,15,14,200,519,27,37,0,0
3659,1430,321,1640,876,11,15,14,210,555,28,37,0,0
3660,1430,328,1642,882,11,15,14,212,554,29,37,0,0
3661,1406,349,1619,894,11,15,14,213,545,30,37,0,0
3662,1370,369,1605,956,11,15,14,235,587,31,37,0,0
3663,1376,381,1620,991,11,15,14,244,610,32,37,0,0
3664,1385,396,1642,1041,11,15,14,257,645,33,37,0,0
3665,1408,424,1663,1051,11,15,14,255,627,34,37,0,0
3666,1486,458,1733,1061,11,15,14,247,603,35,37,0,0
3667,1554,509,1798,1069,11,15,14,244,560,36,37,0,0
3668,1578,521,1821,1080,11,15,14,243,559,37,37,1,0
3629,31,488,298,933,12,15,14,267,445,0,1,0,0
3630,74,505,361,984,12,15,14,287,479,1,1,0,0
3635,304,464,508,727,13,15,14,204,263,0,1,0,0
3636,260,439,459,698,13,15,14,199,259,1,1,0,0
3654,1500,602,1703,1064,14,15,14,203,462,0,1,0,0
3655,1582,614,1784,1070,14,15,14,202,456,1,1,0,0
3656,1769,690,1915,1080,15,15,14,146,390,0,0,0,0
3668,1707,561,1915,1008,16,15,14,208,447,0,0,0,0
4030,1615,136,1654,227,17,15,14,39,91,0,74,0,1
4031,1612,136,1652,228,17,15,14,40,92,1,74,0,0
4032,1612,134,1655,235,17,15,14,43,101,2,74,0,0
4033,1612,133,1657,238,17,15,14,45,105,3,74,0,0
4034,1613,137,1655,235,17,15,14,42,98,4,74,0,0
4035,1614,135,1655,231,17,15,14,41,96,5,74,0,0
4036,1613,133,1657,236,17,15,14,44,103,6,74,0,0
4037,1613,133,1657,238,17,15,14,44,105,7,74,0,0
4038,1614,136,1658,239,17,15,14,44,103,8,74,0,0
4039,1613,134,1657,241,17,15,14,44,107,9,74,0,0
4040,1614,133,1657,239,17,15,14,43,106,10,74,0,0
4041,1613,134,1656,239,17,15,14,43,105,11,74,0,0
4042,1614,136,1656,240,17,15,14,42,104,12,74,0,0
4043,1614,138,1656,240,17,15,14,42,102,13,74,0,0
4044,1616,138,1657,241,17,15,14,41,103,14,74,0,0
4045,1615,138,1656,240,17,15,14,41,102,15,74,0,0
4046,1614,135,1656,241,17,15,14,42,106,16,74,0,0
4047,1614,133,1656,241,17,15,14,42,108,17,74,0,0
4048,1614,136,1655,242,17,15,14,41,106,18,74,0,0
4049,1613,137,1653,241,17,15,14,40,104,19,74,0,0
4050,1613,136,1654,242,17,15,14,41,106,20,74,0,0
4051,1613,138,1653,242,17,15,14,40,104,21,74,0,0
4052,1612,141,1652,243,17,15,14,40,102,22,74,0,0
4053,1611,144,1649,244,17,15,14,38,100,23,74,0,0
4054,1609,146,1647,246,17,15,14,38,100,24,74,0,0
4055,1609,149,1646,247,17,15,14,37,98,25,74,0,0
4057,1609,152,1644,247,17,15,14,35,95,0,74,0,0
4059,1606,150,1642,249,17,15,14,36,99,0,74,0,0
4060,1606,151,1641,249,17,15,14,35,98,1,74,0,0
4061,1606,151,1641,250,17,15,14,35,99,2,74,0,0
4062,1605,150,1642,252,17,15,14,37,102,3,74,0,0
4063,1604,148,1641,254,17,15,14,37,106,4,74,0,0
4064,1603,151,1639,256,17,15,14,36,105,5,74,0,0
4065,1603,156,1639,260,17,15,14,36,104,6,74,0,0
4066,1603,157,1639,260,17,15,14,36,103,7,74,0,0
4067,1602,153,1639,263,17,15,14,37,110,8,74,0,0
4068,1601,165,1636,268,17,15,14,35,103,9,74,0,0
4072,1600,164,1637,276,17,15,14,37,112,0,74,0,0
4075,1601,171,1636,281,17,15,14,35,110,0,74,0,1
4076,1603,173,1638,283,17,15,14,35,110,1,74,0,0
4077,1604,171,1640,283,17,15,14,36,112,2,74,0,0
4078,1604,168,1642,285,17,15,14,38,117,3,74,0,0
4079,1606,175,1641,283,17,15,14,35,108,4,74,0,0
4080,1605,173,1643,289,17,15,14,38,116,5,74,0,0
4081,1606,175,1643,289,17,15,14,37,114,6,74,0,0
4082,1608,174,1646,288,17,15,14,38,114,7,74,0,0
4083,1609,175,1647,290,17,15,14,38,115,8,74,0,0
4084,1607,161,1650,291,17,15,14,43,130,9,74,0,0
4085,1607,168,1649,295,17,15,14,42,127,10,74,0,0
4086,1606,174,1649,300,17,15,14,43,126,11,74,0,0
4087,1606,175,1649,305,17,15,14,43,130,12,74,0,0
4088,1604,176,1650,313,17,15,14,46,137,13,74,0,0
4089,1604,181,1647,310,17,15,14,43,129,14,74,0,0
4090,1601,181,1647,316,17,15,14,46,135,15,74,0,0
4091,1600,184,1647,321,17,15,14,47,137,16,74,0,0
4092,1602,182,1650,322,17,15,14,48,140,17,74,0,0
4093,1602,181,1653,329,17,15,14,51,148,18,74,0,0
4094,1601,185,1652,332,17,15,14,51,147,19,74,0,0
4095,1600,185,1653,336,17,15,14,53,151,20,74,0,0
4096,1600,187,1653,339,17,15,14,53,152,21,74,0,0
4097,1603,187,1657,340,17,15,14,54,153,22,74,0,0
4098,1602,186,1659,347,17,15,14,57,161,23,74,0,0
4099,1600,192,1658,354,17,15,14,58,162,24,74,0,0
4100,1597,190,1657,358,17,15,14,60,168,25,74,0,0
4101,1597,192,1659,363,17,15,14,62,171,26,74,0,0
4102,1600,194,1664,370,17,15,14,64,176,27,74,0,0
4103,1602,193,1667,371,17,15,14,65,178,28,74,0,0
4104,1601,199,1667,380,17,15,14,66,181,29,74,0,0
4105,1599,198,1667,385,17,15,14,68,187,30,74,0,0
4106,1598,200,1669,393,17,15,14,71,193,31,74,0,0
4107,1600,205,1671,398,17,15,14,71,193,32,74,0,0
4108,1598,203,1671,402,17,15,14,73,199,33,74,0,0
4109,1591,205,1669,411,17,15,14,78,206,34,74,0,0
4110,1586,204,1667,419,17,15,14,81,215,35,74,0,0
4111,1586,204,1670,425,17,15,14,84,221,36,74,0,0
4112,1587,208,1672,433,17,15,14,85,225,37,74,0,0
4113,1587,206,1675,439,17,15,14,88,233,38,74,0,0
4114,1587,215,1675,448,17,15,14,88,233,39,74,0,0
4115,1581,220,1671,458,17,15,14,90,238,40,74,0,0
4116,1579,222,1672,466,17,15,14,93,244,41,74,0,0
4117,1581,226,1674,472,17,15,14,93,246,42,74,0,0
4118,1580,225,1676,479,17,15,14,96,254,43,74,0,0
4119,1577,232,1674,490,17,15,14,97,258,44,74,0,0
4120,1570,239,1670,504,17,15,14,100,265,45,74,0,0
4121,1563,237,1670,516,17,15,14,107,279,46,74,0,0
4122,1558,241,1670,535,17,15,14,112,294,47,74,0,0
4123,1556,241,1671,540,17,15,14,115,299,48,74,0,0
4124,1554,245,1672,553,17,15,14,118,308,49,74,0,0
4125,1545,255,1666,573,17,15,14,121,318,50,74,0,0
4126,1534,253,1663,591,17,15,14,129,338,51,74,0,0
4127,1529,264,1664,617,17,15,14,135,353,52,74,0,0
4128,1529,271,1665,627,17,15,14,136,356,53,74,0,0
4129,1526,275,1667,644,17,15,14,141,369,54,74,0,0
4130,1518,288,1665,670,17,15,14,147,382,55,74,0,0
4131,1508,290,1660,685,17,15,14,152,395,56,74,0,0
4132,1501,298,1664,723,17,15,14,163,425,57,74,0,0
4133,1499,316,1664,742,17,15,14,165,426,58,74,0,0
4134,1492,331,1661,765,17,15,14,169,434,59,74,0,0
4135,1476,352,1656,809,17,15,14,180,457,60,74,0,0
4136,1459,363,1646,828,17,15,14,187,465,61,74,0,0
4137,1447,370,1652,879,17,15,14,205,509,62,74,0,0
4138,1438,386,1657,924,17,15,14,219,538,63,74,0,0
4139,1434,394,1664,959,17,15,14,230,565,64,74,0,0
4140,1423,420,1661,1003,17,15,14,238,583,65,74,0,0
4141,1392,437,1644,1049,17,15,14,252,612,66,74,0,0
4142,1377,455,1639,1070,17,15,14,262,615,67,74,0,0
4143,1366,498,1632,1077,17,15,14,266,579,68,74,0,0
4144,1353,521,1622,1080,17,15,14,269,559,69,74,0,0
4145,1340,577,1592,1080,17,15,14,252,503,70,74,0,0
4146,1293,640,1530,1077,17,15,14,237,437,71,74,0,0
4147,1226,705,1450,1068,17,15,14,224,363,72,74,0,0
4148,1237,865,1379,1075,17,15,14,142,210,73,74,0,0
4149,1226,917,1343,1080,17,15,14,117,163,74,74,1,0
5265,0,537,38,734,18,15,14,38,197,0,0,0,0
5272,1,423,53,648,19,15,14,52,225,0,0,0,0
5320,0,444,45,680,20,15,14,45,236,0,135,0,1
5321,1,438,52,705,20,15,14,51,267,1,135,0,0
5322,5,437,58,711,20,15,14,53,274,2,135,0,0
5323,10,425,69,727,20,15,14,59,302,3,135,0,0
5324,21,415,87,740,20,15,14,66,325,4,135,0,0
5325,28,407,99,745,20,15,14,71,338,5,135,0,0
5326,44,405,123,752,20,15,14,79,347,6,135,0,0
5327,51,402,138,758,20,15,14,87,356,7,135,0,0
5328,55,401,151,773,20,15,14,96,372,8,135,0,0
5329,81,408,183,783,20,15,14,102,375,9,135,0,0
5330,94,407,202,787,20,15,14,108,380,10,135,0,0
5331,111,407,224,791,20,15,14,113,384,11,135,0,0
5332,139,407,261,799,20,15,14,122,392,12,135,0,0
5333,154,402,284,807,20,15,14,130,405,13,135,0,0
5334,167,404,303,819,20,15,14,136,415,14,135,0,0
5335,195,404,343,837,20,15,14,148,433,15,135,0,0
5336,210,402,364,844,20,15,14,154,442,16,135,0,0
5337,229,403,391,857,20,15,14,162,454,17,135,0,0
5338,259,407,436,880,20,15,14,177,473,18,135,0,0
5339,278,413,463,891,20,15,14,185,478,19,135,0,0
5340,284,407,481,913,20,15,14,197,506,20,135,0,0
5341,331,408,542,932,20,15,14,211,524,21,135,0,0
5342,364,411,585,950,20,15,14,221,539,22,135,0,0
5343,392,409,614,956,20,15,14,222,547,23,135,0,0
5344,452,415,687,981,20,15,14,235,566,24,135,0,0
5345,496,417,734,988,20,15,14,238,571,25,135,0,0
5346,539,413,775,987,20,15,14,236,574,26,135,0,0
5347,615,408,863,998,20,15,14,248,590,27,135,0,0
5348,691,408,946,999,20,15,14,255,591,28,135,0,0
5349,747,396,1000,986,20,15,14,253,590,29,135,0,0
5350,804,393,1053,983,20,15,14,249,590,30,135,0,0
5351,879,381,1108,924,20,15,14,229,543,31,135,0,0
5352,973,374,1151,762,20,15,14,178,388,32,135,0,0
5353,1008,353,1138,637,20,15,14,130,284,33,135,0,0
5354,1002,343,1222,844,20,15,14,220,501,34,135,0,0
5355,1041,341,1290,928,20,15,14,249,587,35,135,0,0
5356,1094,334,1330,906,20,15,14,236,572,36,135,0,0
5357,1132,322,1359,885,20,15,14,227,563,37,135,0,0
5358,1169,316,1391,877,20,15,14,222,561,38,135,0,0
5359,1176,303,1392,864,20,15,14,216,561,39,135,0,0
5360,1195,294,1391,817,20,15,14,196,523,40,135,0,0
5361,1214,294,1398,791,20,15,14,184,497,41,135,0,0
5362,1232,289,1407,770,20,15,14,175,481,42,135,0,0
5363,1256,278,1421,738,20,15,14,165,460,43,135,0,0
5364,1279,277,1437,723,20,15,14,158,446,44,135,0,0
5365,1297,275,1452,714,20,15,14,155,439,45,135,0,0
5366,1311,265,1454,676,20,15,14,143,411,46,135,0,0
5367,1321,261,1458,655,20,15,14,137,394,47,135,0,0
5368,1332,259,1465,644,20,15,14,133,385,48,135,0,0
5369,1346,246,1476,627,20,15,14,130,381,49,135,0,0
5370,1361,240,1486,609,20,15,14,125,369,50,135,0,0
5371,1373,238,1497,605,20,15,14,124,367,51,135,0,0
5372,1383,232,1502,587,20,15,14,119,355,52,135,0,0
5373,1391,230,1504,567,20,15,14,113,337,53,135,0,0
5374,1396,230,1506,562,20,15,14,110,332,54,135,0,0
5375,1404,223,1513,557,20,15,14,109,334,55,135,0,0
5376,1409,216,1514,540,20,15,14,105,324,56,135,0,0
5377,1413,215,1516,531,20,15,14,103,316,57,135,0,0
5378,1413,213,1512,522,20,15,14,99,309,58,135,0,0
5379,1414,208,1510,506,20,15,14,96,298,59,135,0,0
5380,1418,214,1508,492,20,15,14,90,278,60,135,0,0
5381,1428,211,1515,484,20,15,14,87,273,61,135,0,0
5382,1437,205,1523,477,20,15,14,86,272,62,135,0,0
5383,1447,205,1530,470,20,15,14,83,265,63,135,0,0
5384,1456,204,1538,466,20,15,14,82,262,64,135,0,0
5385,1465,200,1545,455,20,15,14,80,255,65,135,0,0
5386,1472,201,1551,448,20,15,14,79,247,66,135,0,0
5387,1480,197,1558,441,20,15,14,78,244,67,135,0,0
5388,1485,195,1560,432,20,15,14,75,237,68,135,0,0
5389,1491,197,1565,432,20,15,14,74,235,69,135,0,0
5390,1493,196,1565,424,20,15,14,72,228,70,135,0,0
5391,1496,194,1566,416,20,15,14,70,222,71,135,0,0
5392,1498,197,1567,410,20,15,14,69,213,72,135,0,0
5393,1501,193,1569,406,20,15,14,68,213,73,135,0,0
5394,1501,186,1569,400,20,15,14,68,214,74,135,0,0
5395,1503,186,1569,397,20,15,14,66,211,75,135,0,0
5396,1505,184,1568,388,20,15,14,63,204,76,135,0,0
5397,1505,180,1568,385,20,15,14,63,205,77,135,0,0
5398,1509,181,1571,383,20,15,14,62,202,78,135,0,0
5399,1513,180,1573,375,20,15,14,60,195,79,135,0,0
5400,1516,178,1573,370,20,15,14,57,192,80,135,0,0
5401,1518,178,1574,368,20,15,14,56,190,81,135,0,0
5402,1519,178,1573,362,20,15,14,54,184,82,135,0,0
5403,1518,176,1573,359,20,15,14,55,183,83,135,0,0
5404,1520,176,1574,358,20,15,14,54,182,84,135,0,0
5405,1522,176,1574,351,20,15,14,52,175,85,135,0,0
5406,1523,176,1573,347,20,15,14,50,171,86,135,0,0
5407,1525,177,1573,341,20,15,14,48,164,87,135,0,0
5408,1527,177,1573,334,20,15,14,46,157,88,135,0,0
5409,1527,178,1574,338,20,15,14,47,160,89,135,0,0
5410,1529,178,1577,336,20,15,14,48,158,90,135,0,0
5411,1533,177,1582,335,20,15,14,49,158,91,135,0,0
5412,1537,174,1586,332,20,15,14,49,158,92,135,0,0
5413,1541,172,1589,327,20,15,14,48,155,93,135,0,0
5414,1541,171,1588,325,20,15,14,47,154,94,135,0,0
5415,1540,170,1584,314,20,15,14,44,144,95,135,0,0
5416,1536,170,1581,317,20,15,14,45,147,96,135,0,0
5417,1532,171,1577,318,20,15,14,45,147,97,135,0,0
5418,1529,170,1574,317,20,15,14,45,147,98,135,0,0
5419,1526,168,1571,317,20,15,14,45,149,99,135,0,0
5420,1523,168,1568,314,20,15,14,45,146,100,135,0,0
5421,1522,167,1566,310,20,15,14,44,143,101,135,0,0
5422,1523,168,1566,308,20,15,14,43,140,102,135,0,0
5423,1523,169,1566,308,20,15,14,43,139,103,135,0,0
5424,1526,168,1569,306,20,15,14,43,138,104,135,0,0
5425,1528,168,1570,302,20,15,14,42,134,105,135,0,0
5426,1531,171,1571,294,20,15,14,40,123,106,135,0,0
5427,1533,173,1573,295,20,15,14,40,122,107,135,0,0
5428,1535,169,1575,293,20,15,14,40,124,108,135,0,0
5429,1536,168,1576,289,20,15,14,40,121,109,135,0,0
5430,1537,168,1575,287,20,15,14,38,119,110,135,0,0
5431,1537,168,1576,286,20,15,14,39,118,111,135,0,0
5432,1537,168,1575,285,20,15,14,38,117,112,135,0,0
5433,1536,168,1574,282,20,15,14,38,114,113,135,0,0
5434,1536,166,1574,280,20,15,14,38,114,114,135,0,0
5435,1538,165,1576,280,20,15,14,38,115,115,135,0,0
5436,1538,163,1577,280,20,15,14,39,117,116,135,0,0
5437,1539,162,1579,282,20,15,14,40,120,117,135,0,0
5438,1541,163,1580,279,20,15,14,39,116,118,135,0,0
5439,1543,162,1581,278,20,15,14,38,116,119,135,0,0
5440,1545,161,1584,278,20,15,14,39,117,120,135,0,0
5441,1547,161,1584,273,20,15,14,37,112,121,135,0,0
5442,1548,160,1586,275,20,15,14,38,115,122,135,0,0
5443,1549,159,1588,273,20,15,14,39,114,123,135,0,0
5444,1550,158,1589,271,20,15,14,39,113,124,135,0,0
5445,1551,157,1589,270,20,15,14,38,113,125,135,0,0
5446,1551,157,1590,273,20,15,14,39,116,126,135,0,0
5447,1553,158,1590,268,20,15,14,37,110,127,135,0,0
5448,1553,157,1591,267,20,15,14,38,110,128,135,0,0
5449,1555,155,1591,263,20,15,14,36,108,129,135,0,0
5450,1555,153,1592,260,20,15,14,37,107,130,135,0,0
5451,1555,153,1591,258,20,15,14,36,105,131,135,0,0
5452,1554,154,1591,261,20,15,14,37,107,132,135,0,0
5453,1554,153,1590,259,20,15,14,36,106,133,135,0,0
5454,1555,154,1590,257,20,15,14,35,103,134,135,0,0
5455,1557,154,1592,254,20,15,14,35,100,135,135,1,0
5332,15,534,61,858,21,15,14,46,324,0,101,0,1
5333,35,520,87,865,21,15,14,52,345,1,101,0,0
5334,41,482,102,869,21,15,14,61,387,2,101,0,0
5335,42,458,114,893,21,15,14,72,435,3,101,0,0
5336,59,452,144,921,21,15,14,85,469,4,101,0,0
5337,69,449,164,935,21,15,14,95,486,5,101,0,0
5338,100,449,208,946,21,15,14,108,497,6,101,0,0
5339,132,452,252,959,21,15,14,120,507,7,101,0,0
5340,160,470,288,966,21,15,14,128,496,8,101,0,0
5341,182,468,330,1012,21,15,14,148,544,9,101,0,0
5342,208,476,374,1044,21,15,14,166,568,10,101,0,0
5343,221,476,400,1063,21,15,14,179,587,11,101,0,0
5344,276,485,474,1080,21,15,14,198,595,12,101,0,0
5345,326,489,533,1080,21,15,14,207,591,13,101,0,0
5346,361,482,574,1080,21,15,14,213,598,14,101,0,0
5347,434,487,657,1075,21,15,14,223,588,15,101,0,0
5348,497,500,727,1078,21,15,14,230,578,16,101,0,0
5349,549,499,782,1074,21,15,14,233,575,17,101,0,0
5350,636,499,877,1077,21,15,14,241,578,18,101,0,0
5351,733,492,978,1077,21,15,14,245,585,19,101,0,0
5352,839,461,1097,1075,21,15,14,258,614,20,101,0,0
5353,952,443,1219,1074,21,15,14,267,631,21,101,0,0
5354,1042,445,1313,1079,21,15,14,271,634,22,101,0,0
5355,1135,418,1412,1077,21,15,14,277,659,23,101,0,0
5356,1179,406,1463,1074,21,15,14,284,668,24,101,0,0
5357,1250,395,1531,1066,21,15,14,281,671,25,101,0,0
5358,1329,378,1588,1010,21,15,14,259,632,26,101,0,0
5359,1376,366,1622,980,21,15,14,246,614,27,101,0,0
5360,1418,347,1649,937,21,15,14,231,590,28,101,0,0
5361,1449,328,1672,900,21,15,14,223,572,29,101,0,0
5362,1465,320,1682,879,21,15,14,217,559,30,101,0,0
5363,1484,306,1681,817,21,15,14,197,511,31,101,0,0
5364,1498,294,1680,772,21,15,14,182,478,32,101,0,0
5365,1508,291,1681,755,21,15,14,173,464,33,101,0,0
5366,1520,279,1683,724,21,15,14,163,445,34,101,0,0
5367,1527,269,1687,703,21,15,14,160,434,35,101,0,0
5368,1529,265,1683,691,21,15,14,154,426,36,101,0,0
5369,1530,258,1673,658,21,15,14,143,400,37,101,0,0
5370,1529,248,1668,641,21,15,14,139,393,38,101,0,0
5371,1530,246,1665,634,21,15,14,135,388,39,101,0,0
5372,1533,236,1660,602,21,15,14,127,366,40,101,0,0
5373,1533,232,1656,587,21,15,14,123,355,41,101,0,0
5374,1530,232,1649,579,21,15,14,119,347,42,101,0,0
5375,1527,229,1639,557,21,15,14,112,328,43,101,0,0
5376,1529,226,1638,544,21,15,14,109,318,44,101,0,0
5377,1535,224,1642,536,21,15,14,107,312,45,101,0,0
5378,1541,220,1647,526,21,15,14,106,306,46,101,0,0
5379,1546,215,1652,519,21,15,14,106,304,47,101,0,0
5380,1549,216,1654,521,21,15,14,105,305,48,101,0,0
5381,1553,213,1653,502,21,15,14,100,289,49,101,0,0
5382,1557,210,1654,491,21,15,14,97,281,50,101,0,0
5383,1562,213,1656,486,21,15,14,94,273,51,101,0,0
5384,1565,207,1655,471,21,15,14,90,264,52,101,0,0
5385,1568,206,1655,459,21,15,14,87,253,53,101,0,0
5386,1567,206,1653,456,21,15,14,86,250,54,101,0,0
5387,1566,203,1650,449,21,15,14,84,246,55,101,0,0
5388,1568,200,1651,443,21,15,14,83,243,56,101,0,0
5389,1575,203,1656,441,21,15,14,81,238,57,101,0,0
5390,1580,198,1659,432,21,15,14,79,234,58,101,0,0
5391,1583,196,1662,427,21,15,14,79,231,59,101,0,0
5392,1583,196,1660,423,21,15,14,77,227,60,101,0,0
5393,1584,196,1658,413,21,15,14,74,217,61,101,0,0
5394,1588,197,1660,410,21,15,14,72,213,62,101,0,0
5395,1592,196,1663,404,21,15,14,71,208,63,101,0,0
5396,1598,191,1668,396,21,15,14,70,205,64,101,0,0
5397,1601,191,1669,393,21,15,14,68,202,65,101,0,0
5398,1599,189,1665,388,21,15,14,66,199,66,101,0,0
5399,1595,186,1662,384,21,15,14,67,198,67,101,0,0
5400,1593,186,1659,383,21,15,14,66,197,68,101,0,0
5401,1595,184,1658,374,21,15,14,63,190,69,101,0,0
5402,1596,182,1657,368,21,15,14,61,186,70,101,0,0
5403,1596,182,1656,366,21,15,14,60,184,71,101,0,0
5404,1595,182,1653,361,21,15,14,58,179,72,101,0,0
5405,1595,180,1651,354,21,15,14,56,174,73,101,0,0
5406,1595,183,1650,350,21,15,14,55,167,74,101,0,0
5407,1596,181,1650,346,21,15,14,54,165,75,101,0,0
5408,1597,180,1650,344,21,15,14,53,164,76,101,0,0
5409,1597,183,1648,343,21,15,14,51,160,77,101,0,0
5410,1596,186,1644,335,21,15,14,48,149,78,101,0,0
5411,1594,186,1641,330,21,15,14,47,144,79,101,0,0
5412,1592,186,1639,330,21,15,14,47,144,80,101,0,0
5413,1593,182,1639,324,21,15,14,46,142,81,101,0,0
5414,1592,179,1640,324,21,15,14,48,145,82,101,0,0
5415,1591,179,1638,320,21,15,14,47,141,83,101,0,0
5416,1590,178,1635,317,21,15,14,45,139,84,101,0,0
5417,1589,177,1634,316,21,15,14,45,139,85,101,0,0
5418,1590,178,1634,315,21,15,14,44,137,86,101,0,0
5419,1591,179,1634,312,21,15,14,43,133,87,101,0,0
5420,1592,180,1634,310,21,15,14,42,130,88,101,0,0
5421,1592,180,1634,309,21,15,14,42,129,89,101,0,0
5422,1590,179,1631,309,21,15,14,41,130,90,101,0,0
5423,1589,179,1629,303,21,15,14,40,124,91,101,0,0
5424,1590,182,1629,305,21,15,14,39,123,92,101,0,0
5425,1591,182,1630,305,21,15,14,39,123,93,101,0,0
5426,1593,185,1630,299,21,15,14,37,114,94,101,0,0
5427,1594,181,1632,302,21,15,14,38,121,95,101,0,0
5428,1596,180,1632,293,21,15,14,36,113,96,101,0,0
5429,1596,178,1633,291,21,15,14,37,113,97,101,0,0
5430,1599,178,1636,291,21,15,14,37,113,98,101,0,0
5431,1601,176,1637,287,21,15,14,36,111,99,101,0,0
5432,1603,176,1638,282,21,15,14,35,106,100,101,0,0
5433,1601,177,1637,283,21,15,14,36,106,101,101,1,0
5441,1596,162,1632,265,21,15,14,36,103,0,101,0,0
5442,1598,161,1634,265,21,15,14,36,104,1,101,0,0
5446,1606,159,1641,255,21,15,14,35,96,0,101,0,0
5453,1597,159,1632,252,21,15,14,35,93,0,101,0,0
5457,1597,156,1632,249,21,15,14,35,93,0,101,0,0
5461,1599,151,1634,246,21,15,14,35,95,0,101,0,0
5462,1600,147,1636,245,21,15,14,36,98,1,101,0,0
5712,1560,163,1595,265,29,15,14,35,102,0,109,0,1
5713,1560,164,1595,267,29,15,14,35,103,1,109,0,0
5714,1560,165,1595,268,29,15,14,35,103,2,109,0,0
5715,1559,162,1596,273,29,15,14,37,111,3,109,0,0
5716,1557,165,1595,277,29,15,14,38,112,4,109,0,0
5717,1554,166,1593,279,29,15,14,39,113,5,109,0,0
5718,1551,164,1590,279,29,15,14,39,115,6,109,0,0
5719,1550,163,1591,279,29,15,14,41,116,7,109,0,0
5720,1551,164,1591,281,29,15,14,40,117,8,109,0,0
5721,1552,165,1592,280,29,15,14,40,115,9,109,0,0
5722,1551,167,1591,282,29,15,14,40,115,10,109,0,0
5723,1549,167,1590,284,29,15,14,41,117,11,109,0,0
5724,1548,166,1589,285,29,15,14,41,119,12,109,0,0
5725,1547,168,1589,287,29,15,14,42,119,13,109,0,0
5726,1548,170,1590,292,29,15,14,42,122,14,109,0,0
5727,1551,173,1593,296,29,15,14,42,123,15,109,0,0
5728,1552,175,1595,300,29,15,14,43,125,16,109,0,0
5729,1551,176,1595,303,29,15,14,44,127,17,109,0,0
5730,1551,175,1594,304,29,15,14,43,129,18,109,0,0
5731,1550,173,1595,307,29,15,14,45,134,19,109,0,0
5732,1551,177,1595,311,29,15,14,44,134,20,109,0,0
5733,1554,180,1597,313,29,15,14,43,133,21,109,0,0
5734,1555,181,1598,313,29,15,14,43,132,22,109,0,0
5735,1555,182,1599,316,29,15,14,44,134,23,109,0,0
5736,1553,181,1598,320,29,15,14,45,139,24,109,0,0
5737,1551,180,1598,324,29,15,14,47,144,25,109,0,0
5738,1551,183,1596,324,29,15,14,45,141,26,109,0,0
5739,1551,185,1596,327,29,15,14,45,142,27,109,0,0
5740,1547,182,1595,331,29,15,14,48,149,28,109,0,0
5741,1544,183,1593,338,29,15,14,49,155,29,109,0,0
5742,1540,184,1590,339,29,15,14,50,155,30,109,0,0
5743,1537,183,1588,340,29,15,14,51,157,31,109,0,0
5744,1535,184,1586,343,29,15,14,51,159,32,109,0,0
5745,1533,184,1586,346,29,15,14,53,162,33,109,0,0
5746,1531,182,1586,350,29,15,14,55,168,34,109,0,0
5747,1529,184,1585,353,29,15,14,56,169,35,109,0,0
5748,1526,184,1582,356,29,15,14,56,172,36,109,0,0
5749,1522,185,1579,359,29,15,14,57,174,37,109,0,0
5750,1523,190,1580,362,29,15,14,57,172,38,109,0,0
5751,1525,195,1583,365,29,15,14,58,170,39,109,0,0
5752,1526,195,1584,367,29,15,14,58,172,40,109,0,0
5753,1526,199,1585,376,29,15,14,59,177,41,109,0,0
5754,1520,199,1583,384,29,15,14,63,185,42,109,0,0
5755,1514,199,1578,388,29,15,14,64,189,43,109,0,0
5756,1509,200,1574,395,29,15,14,65,195,44,109,0,0
5757,1505,203,1572,400,29,15,14,67,197,45,109,0,0
5758,1501,202,1569,401,29,15,14,68,199,46,109,0,0
5759,1494,203,1564,407,29,15,14,70,204,47,109,0,0
5760,1486,205,1558,415,29,15,14,72,210,48,109,0,0
5761,1477,205,1550,419,29,15,14,73,214,49,109,0,0
5762,1472,207,1546,425,29,15,14,74,218,50,109,0,0
5763,1470,214,1545,431,29,15,14,75,217,51,109,0,0
5764,1469,216,1543,435,29,15,14,74,219,52,109,0,0
5765,1462,218,1540,445,29,15,14,78,227,53,109,0,0
5766,1453,221,1534,454,29,15,14,81,233,54,109,0,0
5767,1444,219,1526,460,29,15,14,82,241,55,109,0,0
5768,1439,221,1523,466,29,15,14,84,245,56,109,0,0
5769,1435,223,1522,477,29,15,14,87,254,57,109,0,0
5770,1433,224,1522,483,29,15,14,89,259,58,109,0,0
5771,1429,226,1520,492,29,15,14,91,266,59,109,0,0
5772,1424,235,1515,502,29,15,14,91,267,60,109,0,0
5773,1415,237,1509,511,29,15,14,94,274,61,109,0,0
5774,1408,235,1504,520,29,15,14,96,285,62,109,0,0
5775,1404,245,1502,532,29,15,14,98,287,63,109,0,0
5776,1398,249,1500,550,29,15,14,102,301,64,109,0,0
5777,1392,251,1496,557,29,15,14,104,306,65,109,0,0
5778,1383,257,1491,574,29,15,14,108,317,66,109,0,0
5779,1375,265,1485,588,29,15,14,110,323,67,109,0,0
5780,1361,266,1473,597,29,15,14,112,331,68,109,0,0
5781,1352,277,1468,614,29,15,14,116,337,69,109,0,0
5782,1347,288,1469,642,29,15,14,122,354,70,109,0,0
5783,1341,288,1466,653,29,15,14,125,365,71,109,0,0
5784,1329,292,1459,668,29,15,14,130,376,72,109,0,0
5785,1317,300,1451,688,29,15,14,134,388,73,109,0,0
5786,1298,302,1437,703,29,15,14,139,401,74,109,0,0
5787,1286,316,1428,724,29,15,14,142,408,75,109,0,0
5788,1270,329,1422,768,29,15,14,152,439,76,109,0,0
5789,1259,335,1414,782,29,15,14,155,447,77,109,0,0
5790,1235,337,1395,798,29,15,14,160,461,78,109,0,0
5791,1208,353,1373,830,29,15,14,165,477,79,109,0,0
5792,1179,359,1348,850,29,15,14,169,491,80,109,0,0
5793,1146,371,1321,887,29,15,14,175,516,81,109,0,0
5794,1112,390,1288,909,29,15,14,176,519,82,109,0,0
5795,1072,402,1252,939,29,15,14,180,537,83,109,0,0
5796,1030,410,1197,909,29,15,14,167,499,84,109,0,0
5797,949,432,1123,954,29,15,14,174,522,85,109,0,0
5798,881,444,1056,977,29,15,14,175,533,86,109,0,0
5799,862,447,1068,1047,29,15,14,206,600,87,109,0,0
5800,779,462,1000,1074,29,15,14,221,612,88,109,0,0
5801,667,500,889,1076,29,15,14,222,576,89,109,0,0
5802,585,500,811,1080,29,15,14,226,580,90,109,0,0
5803,522,507,751,1080,29,15,14,229,573,91,109,0,0
5804,402,531,620,1080,29,15,14,218,549,92,109,0,0
5805,316,546,532,1075,29,15,14,216,529,93,109,0,0
5806,252,564,466,1069,29,15,14,214,505,94,109,0,0
5807,193,551,416,1073,29,15,14,223,522,95,109,0,0
5808,157,559,385,1079,29,15,14,228,520,96,109,0,0
5809,119,541,361,1075,29,15,14,242,534,97,109,0,0
5810,69,548,307,1068,29,15,14,238,520,98,109,0,0
5811,31,532,276,1060,29,15,14,245,528,99,109,0,0
5812,0,522,233,1034,29,15,14,233,512,100,109,0,0
5813,0,507,216,1002,29,15,14,216,495,101,109,0,0
5814,0,507,171,1000,29,15,14,171,493,102,109,0,0
5815,0,506,171,962,29,15,14,171,456,103,109,0,0
5816,0,513,150,952,29,15,14,150,439,104,109,0,0
5817,0,517,124,910,29,15,14,124,393,105,109,0,0
5818,0,518,89,898,29,15,14,89,380,106,109,0,0
5819,0,544,98,870,29,15,14,98,326,107,109,0,0
5820,0,490,94,858,29,15,14,94,368,108,109,0,0
5821,0,485,71,845,29,15,14,71,360,109,109,1,0
5714,1605,157,1640,269,35,15,14,35,112,0,85,0,1
5715,1604,158,1640,271,35,15,14,36,113,1,85,0,0
5716,1602,154,1640,274,35,15,14,38,120,2,85,0,0
5717,1601,152,1640,277,35,15,14,39,125,3,85,0,0
5718,1602,154,1642,279,35,15,14,40,125,4,85,0,0
5719,1604,154,1644,281,35,15,14,40,127,5,85,0,0
5720,1603,153,1644,283,35,15,14,41,130,6,85,0,0
5721,1602,148,1646,287,35,15,14,44,139,7,85,0,0
5722,1603,154,1645,287,35,15,14,42,133,8,85,0,0
5723,1605,161,1645,289,35,15,14,40,128,9,85,0,0
5724,1607,165,1647,291,35,15,14,40,126,10,85,0,0
5725,1608,169,1647,293,35,15,14,39,124,11,85,0,0
5726,1606,168,1646,293,35,15,14,40,125,12,85,0,0
5727,1607,170,1646,295,35,15,14,39,125,13,85,0,0
5728,1607,173,1647,297,35,15,14,40,124,14,85,0,0
5729,1607,173,1648,299,35,15,14,41,126,15,85,0,0
5730,1607,174,1649,303,35,15,14,42,129,16,85,0,0
5731,1608,177,1650,308,35,15,14,42,131,17,85,0,0
5732,1608,176,1651,310,35,15,14,43,134,18,85,0,0
5733,1609,178,1652,311,35,15,14,43,133,19,85,0,0
5734,1612,180,1655,314,35,15,14,43,134,20,85,0,0
5735,1613,180,1657,317,35,15,14,44,137,21,85,0,0
5736,1612,181,1656,319,35,15,14,44,138,22,85,0,0
5737,1612,181,1657,323,35,15,14,45,142,23,85,0,0
5738,1611,184,1656,325,35,15,14,45,141,24,85,0,0
5739,1612,183,1656,325,35,15,14,44,142,25,85,0,0
5740,1613,184,1658,329,35,15,14,45,145,26,85,0,0
5741,1612,186,1658,333,35,15,14,46,147,27,85,0,0
5742,1611,186,1658,335,35,15,14,47,149,28,85,0,0
5743,1610,187,1658,339,35,15,14,48,152,29,85,0,0
5744,1611,188,1659,342,35,15,14,48,154,30,85,0,0
5745,1612,187,1662,345,35,15,14,50,158,31,85,0,0
5746,1612,186,1664,354,35,15,14,52,168,32,85,0,0
5747,1611,185,1664,357,35,15,14,53,172,33,85,0,0
5748,1609,185,1665,363,35,15,14,56,178,34,85,0,0
5749,1610,186,1666,366,35,15,14,56,180,35,85,0,0
5750,1611,184,1667,366,35,15,14,56,182,36,85,0,0
5751,1607,186,1664,370,35,15,14,57,184,37,85,0,0
5752,1603,190,1659,372,35,15,14,56,182,38,85,0,0
5753,1599,195,1659,384,35,15,14,60,189,39,85,0,0
5754,1596,196,1657,388,35,15,14,61,192,40,85,0,0
5755,1592,198,1654,391,35,15,14,62,193,41,85,0,0
5756,1588,201,1652,397,35,15,14,64,196,42,85,0,0
5757,1585,201,1651,401,35,15,14,66,200,43,85,0,0
5758,1586,200,1656,410,35,15,14,70,210,44,85,0,0
5759,1586,201,1658,415,35,15,14,72,214,45,85,0,0
5760,1585,202,1658,418,35,15,14,73,216,46,85,0,0
5761,1582,205,1657,426,35,15,14,75,221,47,85,0,0
5762,1580,204,1656,431,35,15,14,76,227,48,85,0,0
5763,1581,207,1660,442,35,15,14,79,235,49,85,0,0
5764,1580,209,1661,450,35,15,14,81,241,50,85,0,0
5765,1576,210,1658,454,35,15,14,82,244,51,85,0,0
5766,1572,217,1654,460,35,15,14,82,243,52,85,0,0
5767,1564,220,1647,464,35,15,14,83,244,53,85,0,0
5768,1563,219,1652,478,35,15,14,89,259,54,85,0,0
5769,1562,221,1652,481,35,15,14,90,260,55,85,0,0
5770,1556,225,1647,489,35,15,14,91,264,56,85,0,0
5771,1546,232,1640,502,35,15,14,94,270,57,85,0,0
5772,1541,231,1635,507,35,15,14,94,276,58,85,0,0
5773,1537,233,1635,524,35,15,14,98,291,59,85,0,0
5774,1533,234,1635,535,35,15,14,102,301,60,85,0,0
5775,1534,237,1638,542,35,15,14,104,305,61,85,0,0
5776,1529,242,1636,560,35,15,14,107,318,62,85,0,0
5777,1519,244,1628,569,35,15,14,109,325,63,85,0,0
5778,1520,248,1637,596,35,15,14,117,348,64,85,0,0
5779,1522,254,1640,605,35,15,14,118,351,65,85,0,0
5780,1513,261,1634,617,35,15,14,121,356,66,85,0,0
5781,1506,270,1630,634,35,15,14,124,364,67,85,0,0
5782,1487,274,1617,651,35,15,14,130,377,68,85,0,0
5783,1485,283,1622,681,35,15,14,137,398,69,85,0,0
5784,1485,290,1629,704,35,15,14,144,414,70,85,0,0
5785,1466,296,1618,723,35,15,14,152,427,71,85,0,0
5786,1456,309,1613,756,35,15,14,157,447,72,85,0,0
5787,1439,314,1601,769,35,15,14,162,455,73,85,0,0
5788,1429,324,1602,796,35,15,14,173,472,74,85,0,0
5789,1414,332,1604,840,35,15,14,190,508,75,85,0,0
5790,1402,347,1594,858,35,15,14,192,511,76,85,0,0
5791,1371,363,1575,911,35,15,14,204,548,77,85,0,0
5792,1338,365,1552,936,35,15,14,214,571,78,85,0,0
5793,1319,378,1548,983,35,15,14,229,605,79,85,0,0
5794,1266,397,1508,1036,35,15,14,242,639,80,85,0,0
5795,1212,431,1445,1042,35,15,14,233,611,81,85,0,0
5796,1135,443,1378,1069,35,15,14,243,626,82,85,0,0
5797,1065,445,1312,1080,35,15,14,247,635,83,85,0,0
5798,994,466,1239,1080,35,15,14,245,614,84,85,0,0
5799,962,477,1213,1080,35,15,14,251,603,85,85,1,0
5684,1607,138,1644,240,36,15,14,37,102,0,1,0,0
5685,1609,141,1644,239,36,15,14,35,98,1,1,0,0
5799,805,438,917,562,41,15,14,112,124,0,0,0,0
5804,476,476,789,1037,42,15,14,313,561,0,18,0,0
5805,430,481,734,1026,42,15,14,304,545,1,18,0,0
5806,359,475,656,1011,42,15,14,297,536,2,18,0,0
5807,345,494,619,990,42,15,14,274,496,3,18,0,0
5808,315,509,569,968,42,15,14,254,459,4,18,0,0
5809,286,517,527,952,42,15,14,241,435,5,18,0,0
5810,194,483,450,946,42,15,14,256,463,6,18,0,0
5811,167,484,416,936,42,15,14,249,452,7,18,0,0
5812,135,479,366,902,42,15,14,231,423,8,18,0,0
5813,113,477,334,885,42,15,14,221,408,9,18,0,0
5814,97,479,309,868,42,15,14,212,389,10,18,0,0
5815,70,481,274,856,42,15,14,204,375,11,18,0,0
5816,35,471,240,857,42,15,14,205,386,12,18,0,0
5817,18,469,221,853,42,15,14,203,384,13,18,0,0
5818,9,471,195,829,42,15,14,186,358,14,18,0,0
5819,7,483,176,812,42,15,14,169,329,15,18,0,0
5820,9,483,167,792,42,15,14,158,309,16,18,0,0
5821,0,427,163,782,42,15,14,163,355,17,18,0,0
5822,0,419,139,768,42,15,14,139,349,18,18,0,0
5824,0,462,103,734,42,15,14,103,272,0,18,0,0
5825,0,466,99,729,42,15,14,99,263,1,18,0,0
5826,0,474,85,707,42,15,14,85,233,2,18,0,0
5827,0,474,67,692,42,15,14,67,218,3,18,0,0
5877,3,444,89,702,43,15,14,86,258,0,0,0,0
5880,52,445,164,742,44,15,14,112,297,0,37,0,1
5881,67,454,189,778,44,15,14,122,324,1,37,0,0
5882,82,460,204,784,44,15,14,122,324,2,37,0,0
5883,103,460,226,782,44,15,14,123,322,3,37,0,0
5884,119,464,244,792,44,15,14,125,328,4,37,0,0
5885,134,457,270,812,44,15,14,136,355,5,37,0,0
5886,160,464,302,833,44,15,14,142,369,6,37,0,0
5887,182,468,326,844,44,15,14,144,376,7,37,0,0
5888,219,466,368,849,44,15,14,149,383,8,37,0,0
5889,255,461,413,858,44,15,14,158,397,9,37,0,0
5890,279,457,439,858,44,15,14,160,401,10,37,0,0
5891,315,455,486,877,44,15,14,171,422,11,37,0,0
5892,348,460,520,886,44,15,14,172,426,12,37,0,0
5893,376,458,552,896,44,15,14,176,438,13,37,0,0
5894,416,460,600,905,44,15,14,184,445,14,37,0,0
5895,450,461,636,909,44,15,14,186,448,15,37,0,0
5896,477,460,668,922,44,15,14,191,462,16,37,0,0
5897,498,458,699,953,44,15,14,201,495,17,37,0,0
5898,515,471,718,980,44,15,14,203,509,18,37,0,0
5899,535,471,740,993,44,15,14,205,522,19,37,0,0
5900,574,477,782,996,44,15,14,208,519,20,37,0,0
5901,621,486,837,1011,44,15,14,216,525,21,37,0,0
5902,650,475,865,1000,44,15,14,215,525,22,37,0,0
5903,696,478,918,1024,44,15,14,222,546,23,37,0,0
5904,754,477,979,1028,44,15,14,225,551,24,37,0,0
5905,809,483,1039,1052,44,15,14,230,569,25,37,0,0
5906,862,488,1088,1060,44,15,14,226,572,26,37,0,0
5907,953,494,1188,1071,44,15,14,235,577,27,37,0,0
5908,1024,502,1255,1072,44,15,14,231,570,28,37,0,0
5909,1123,511,1353,1078,44,15,14,230,567,29,37,0,0
5910,1213,524,1447,1079,44,15,14,234,555,30,37,0,0
5911,1297,526,1528,1071,44,15,14,231,545,31,37,0,0
5912,1380,531,1609,1074,44,15,14,229,543,32,37,0,0
5913,1388,545,1630,1065,44,15,14,242,520,33,37,0,0
5914,1493,556,1742,1066,44,15,14,249,510,34,37,0,0
5915,1610,561,1857,1063,44,15,14,247,502,35,37,0,0
5916,1704,584,1920,1056,44,15,14,216,472,36,37,0,0
5917,1776,592,1920,1058,44,15,14,144,466,37,37,1,0
5883,0,454,84,717,45,15,14,84,263,0,19,0,0
5884,0,450,97,755,45,15,14,97,305,1,19,0,0
5885,24,449,120,744,45,15,14,96,295,2,19,0,0
5886,45,451,139,738,45,15,14,94,287,3,19,0,0
5887,51,445,148,740,45,15,14,97,295,4,19,0,0
5888,68,449,170,753,45,15,14,102,304,5,19,0,0
5889,83,449,188,763,45,15,14,105,314,6,19,0,0
5890,106,451,217,776,45,15,14,111,325,7,19,0,0
5891,121,451,233,781,45,15,14,112,330,8,19,0,0
5907,12,428,119,741,45,15,14,107,313,0,19,0,1
5908,15,436,117,729,45,15,14,102,293,1,19,0,0
5909,19,440,121,726,45,15,14,102,286,2,19,0,0
5910,29,445,140,744,45,15,14,111,299,3,19,0,0
5911,42,433,162,746,45,15,14,120,313,4,19,0,0
5912,57,432,178,746,45,15,14,121,314,5,19,0,0
5913,69,432,191,749,45,15,14,122,317,6,19,0,0
5914,74,434,198,756,45,15,14,124,322,7,19,0,0
5915,76,436,202,763,45,15,14,126,327,8,19,0,0
5916,79,438,205,765,45,15,14,126,327,9,19,0,0
5917,82,444,210,772,45,15,14,128,328,10,19,0,0
5918,100,447,233,782,45,15,14,133,335,11,19,0,0
5919,116,452,250,788,45,15,14,134,336,12,19,0,0
5920,125,449,261,792,45,15,14,136,343,13,19,0,0
5921,135,448,276,809,45,15,14,141,361,14,19,0,0
5922,153,452,300,824,45,15,14,147,372,15,19,0,0
5923,164,451,314,833,45,15,14,150,382,16,19,0,0
5924,182,456,337,847,45,15,14,155,391,17,19,0,0
5925,194,465,355,868,45,15,14,161,403,18,19,0,0
5926,204,466,367,876,45,15,14,163,410,19,19,0,0
5933,428,501,636,1022,45,15,14,208,521,0,19,0,0
5934,458,497,667,1027,45,15,14,209,530,1,19,0,0
5935,512,500,728,1035,45,15,14,216,535,2,19,0,0
5936,576,503,806,1059,45,15,14,230,556,3,19,0,0
5937,619,503,852,1073,45,15,14,233,570,4,19,0,0
5938,677,505,912,1080,45,15,14,235,575,5,19,0,0
5939,742,515,969,1070,45,15,14,227,555,6,19,0,0
5940,803,510,1036,1072,45,15,14,233,562,7,19,0,0
5941,882,523,1102,1053,45,15,14,220,530,8,19,0,0
5942,970,535,1183,1046,45,15,14,213,511,9,19,0,0
5943,1062,547,1269,1040,45,15,14,207,493,10,19,0,0
5944,1158,565,1353,1035,45,15,14,195,470,11,19,0,0
5945,1192,590,1404,1062,45,15,14,212,472,12,19,0,0
5946,1269,678,1459,1068,45,15,14,190,390,13,19,0,0
5947,1379,715,1565,1068,45,15,14,186,353,14,19,0,0
5948,1457,640,1689,1063,45,15,14,232,423,15,19,0,0
5949,1546,630,1792,1064,45,15,14,246,434,16,19,0,0
5950,1620,642,1868,1068,45,15,14,248,426,17,19,0,0
5951,1694,647,1920,1071,45,15,14,226,424,18,19,0,0
5885,0,646,64,811,46,15,14,64,165,0,37,0,1
5886,0,555,87,820,46,15,14,87,265,1,37,0,0
5887,0,530,94,829,46,15,14,94,299,2,37,0,0
5888,0,541,109,843,46,15,14,109,302,3,37,0,0
5889,1,547,121,861,46,15,14,120,314,4,37,0,0
5890,32,554,155,867,46,15,14,123,313,5,37,0,0
5891,62,524,199,868,46,15,14,137,344,6,37,0,0
5892,105,472,249,834,46,15,14,144,362,7,37,0,0
5893,131,458,289,856,46,15,14,158,398,8,37,0,0
5894,149,465,321,891,46,15,14,172,426,9,37,0,0
5895,168,482,340,904,46,15,14,172,422,10,37,0,0
5896,203,461,393,924,46,15,14,190,463,11,37,0,0
5897,240,454,429,914,46,15,14,189,460,12,37,0,0
5898,251,492,444,966,46,15,14,193,474,13,37,0,0
5899,273,481,485,1003,46,15,14,212,522,14,37,0,0
5900,294,530,498,1030,46,15,14,204,500,15,37,0,0
5901,342,559,550,1055,46,15,14,208,496,16,37,0,0
5902,387,603,587,1070,46,15,14,200,467,17,37,0,0
5903,418,605,620,1077,46,15,14,202,472,18,37,0,0
5904,446,517,680,1069,46,15,14,234,552,19,37,0,0
5905,491,499,724,1050,46,15,14,233,551,20,37,0,0
5906,533,470,785,1062,46,15,14,252,592,21,37,0,0
5907,599,472,853,1063,46,15,14,254,591,22,37,0,0
5908,641,481,849,957,46,15,14,208,476,23,37,0,0
5909,703,477,894,911,46,15,14,191,434,24,37,0,0
5910,747,485,957,963,46,15,14,210,478,25,37,0,0
5911,804,500,1023,1003,46,15,14,219,503,26,37,0,0
5912,860,503,1095,1047,46,15,14,235,544,27,37,0,0
5913,953,517,1194,1068,46,15,14,241,551,28,37,0,0
5914,1021,528,1259,1071,46,15,14,238,543,29,37,0,0
5915,1117,535,1351,1078,46,15,14,234,543,30,37,0,0
5916,1202,550,1432,1079,46,15,14,230,529,31,37,0,0
5917,1304,553,1539,1079,46,15,14,235,526,32,37,0,0
5918,1409,567,1632,1072,46,15,14,223,505,33,37,0,0
5919,1516,583,1729,1073,46,15,14,213,490,34,37,0,0
5920,1640,599,1827,1029,46,15,14,187,430,35,37,0,0
5921,1738,612,1917,1029,46,15,14,179,417,36,37,0,0
5922,1818,620,1920,1029,46,15,14,102,409,37,37,1,0
5900,1,511,58,780,47,15,14,57,269,0,39,0,1
5901,2,494,70,815,47,15,14,68,321,1,39,0,0
5902,16,467,91,818,47,15,14,75,351,2,39,0,0
5903,33,442,117,819,47,15,14,84,377,3,39,0,0
5904,42,430,133,819,47,15,14,91,389,4,39,0,0
5905,50,423,149,828,47,15,14,99,405,5,39,0,0
5906,76,429,181,832,47,15,14,105,403,6,39,0,0
5907,97,427,207,836,47,15,14,110,409,7,39,0,0
5908,121,423,238,842,47,15,14,117,419,8,39,0,0
5909,161,423,289,850,47,15,14,128,427,9,39,0,0
5910,186,414,324,853,47,15,14,138,439,10,39,0,0
5911,204,408,348,861,47,15,14,144,453,11,39,0,0
5912,232,412,385,874,47,15,14,153,462,12,39,0,0
5913,256,417,414,883,47,15,14,158,466,13,39,0,0
5914,275,419,436,888,47,15,14,161,469,14,39,0,0
5915,321,424,494,905,47,15,14,173,481,15,39,0,0
5916,348,425,531,917,47,15,14,183,492,16,39,0,0
5917,361,430,548,930,47,15,14,187,500,17,39,0,0
5918,379,442,581,976,47,15,14,202,534,18,39,0,0
5919,402,455,612,1006,47,15,14,210,551,19,39,0,0
5920,424,458,635,1013,47,15,14,211,555,20,39,0,0
5921,473,464,698,1036,47,15,14,225,572,21,39,0,0
5922,515,465,745,1050,47,15,14,230,585,22,39,0,0
5923,553,475,783,1060,47,15,14,230,585,23,39,0,0
5924,596,485,826,1071,47,15,14,230,586,24,39,0,0
5925,646,497,874,1074,47,15,14,228,577,25,39,0,0
5926,710,484,944,1079,47,15,14,234,595,26,39,0,0
5927,786,480,1024,1078,47,15,14,238,598,27,39,0,0
5928,866,480,1102,1074,47,15,14,236,594,28,39,0,0
5929,946,472,1183,1076,47,15,14,237,604,29,39,0,0
5930,1033,487,1264,1080,47,15,14,231,593,30,39,0,0
5931,1119,495,1347,1080,47,15,14,228,585,31,39,0,0
5932,1217,499,1443,1076,47,15,14,226,577,32,39,0,0
5933,1318,507,1543,1068,47,15,14,225,561,33,39,0,0
5934,1424,521,1647,1060,47,15,14,223,539,34,39,0,0
5935,1528,531,1754,1064,47,15,14,226,533,35,39,0,0
5936,1633,553,1860,1073,47,15,14,227,520,36,39,0,0
5937,1724,584,1920,1069,47,15,14,196,485,37,39,0,0
5938,1795,683,1920,1067,47,15,14,125,384,38,39,0,0
5939,1873,705,1920,1070,47,15,14,47,365,39,39,1,0
5903,472,458,622,840,48,15,14,150,382,0,0,0,0
5906,2,426,84,707,49,15,14,82,281,0,0,0,0
5908,723,632,983,1070,50,15,14,260,438,0,0,0,0
5909,861,711,1083,1067,51,15,14,222,356,0,4,0,0
5910,935,752,1141,1078,51,15,14,206,326,1,4,0,0
5911,1034,769,1230,1075,51,15,14,196,306,2,4,0,0
5912,1172,790,1359,1073,51,15,14,187,283,3,4,0,0
5913,1259,807,1436,1072,51,15,14,177,265,4,4,0,0
5911,2,450,46,741,52,15,14,44,291,0,9,0,0
5912,2,451,48,758,52,15,14,46,307,1,9,0,0
5913,2,430,58,799,52,15,14,56,369,2,9,0,0
5914,7,426,69,831,52,15,14,62,405,3,9,0,0
5915,11,429,74,833,52,15,14,63,404,4,9,0,0
5916,19,435,81,817,52,15,14,62,382,5,9,0,0
5917,26,448,86,803,52,15,14,60,355,6,9,0,0
5918,40,453,98,783,52,15,14,58,330,7,9,0,0
5919,60,445,125,776,52,15,14,65,331,8,9,0,0
5920,69,444,134,778,52,15,14,65,334,9,9,0,0
5922,95,426,167,775,52,15,14,72,349,0,9,0,0
5923,105,423,177,776,52,15,14,72,353,1,9,0,0
5924,119,428,185,734,52,15,14,66,306,2,9,0,0
5925,128,422,197,723,52,15,14,69,301,3,9,0,0
5926,150,429,208,668,52,15,14,58,239,4,9,0,0
5927,175,425,225,608,52,15,14,50,183,5,9,0,0
5928,199,422,242,569,52,15,14,43,147,6,9,0,0
5929,217,420,254,545,52,15,14,37,125,7,9,0,0
5920,0,461,174,928,53,15,14,174,467,0,1,0,0
5921,0,461,173,938,53,15,14,173,477,1,1,0,0
5923,21,493,234,957,54,15,14,213,464,0,22,0,1
5924,24,499,244,976,54,15,14,220,477,1,22,0,0
5925,42,503,261,978,54,15,14,219,475,2,22,0,0
5926,86,496,317,991,54,15,14,231,495,3,22,0,0
5927,165,481,393,975,54,15,14,228,494,4,22,0,0
5928,155,488,398,1013,54,15,14,243,525,5,22,0,0
5929,172,486,429,1035,54,15,14,257,549,6,22,0,0
5930,186,498,454,1062,54,15,14,268,564,7,22,0,0
5931,208,499,484,1074,54,15,14,276,575,8,22,0,0
5932,249,528,519,1080,54,15,14,270,552,9,22,0,0
5933,275,528,547,1080,54,15,14,272,552,10,22,0,0
5934,303,526,577,1080,54,15,14,274,554,11,22,0,0
5935,340,522,623,1080,54,15,14,283,558,12,22,0,0
5936,369,545,648,1080,54,15,14,279,535,13,22,0,0
5937,409,590,673,1079,54,15,14,264,489,14,22,0,0
5938,475,615,737,1078,54,15,14,262,463,15,22,0,0
5939,504,624,765,1079,54,15,14,261,455,16,22,0,0
5940,563,632,820,1078,54,15,14,257,446,17,22,0,0
5941,650,647,902,1075,54,15,14,252,428,18,22,0,0
5942,744,661,996,1077,54,15,14,252,416,19,22,0,0
5943,848,669,1100,1076,54,15,14,252,407,20,22,0,0
5944,953,687,1203,1074,54,15,14,250,387,21,22,0,0
5945,1021,698,1264,1075,54,15,14,243,377,22,22,1,0
5925,6,483,104,831,55,15,14,98,348,0,35,0,1
5926,19,469,118,819,55,15,14,99,350,1,35,0,0
5927,48,461,145,803,55,15,14,97,342,2,35,0,0
5928,78,467,160,751,55,15,14,82,284,3,35,0,0
5929,100,471,180,736,55,15,14,80,265,4,35,0,0
5930,114,469,198,739,55,15,14,84,270,5,35,0,0
5931,130,469,217,741,55,15,14,87,272,6,35,0,0
5932,139,476,251,827,55,15,14,112,351,7,35,0,0
5933,159,474,281,853,55,15,14,122,379,8,35,0,0
5934,184,470,319,881,55,15,14,135,411,9,35,0,0
5935,207,481,348,901,55,15,14,141,420,10,35,0,0
5936,227,485,364,887,55,15,14,137,402,11,35,0,0
5937,245,487,401,938,55,15,14,156,451,12,35,0,0
5938,270,490,437,966,55,15,14,167,476,13,35,0,0
5939,306,494,482,983,55,15,14,176,489,14,35,0,0
5940,331,492,518,1008,55,15,14,187,516,15,35,0,0
5941,372,500,576,1049,55,15,14,204,549,16,35,0,0
5942,399,508,610,1070,55,15,14,211,562,17,35,0,0
5943,428,508,646,1079,55,15,14,218,571,18,35,0,0
5944,479,517,702,1080,55,15,14,223,563,19,35,0,0
5945,530,525,756,1080,55,15,14,226,555,20,35,0,0
5946,570,519,797,1080,55,15,14,227,561,21,35,0,0
5947,619,528,843,1079,55,15,14,224,551,22,35,0,0
5948,681,550,901,1080,55,15,14,220,530,23,35,0,0
5949,743,555,966,1080,55,15,14,223,525,24,35,0,0
5950,813,552,1030,1054,55,15,14,217,502,25,35,0,0
5951,886,565,1107,1069,55,15,14,221,504,26,35,0,0
5952,978,545,1213,1074,55,15,14,235,529,27,35,0,0
5953,1061,567,1293,1077,55,15,14,232,510,28,35,0,0
5954,1148,589,1374,1074,55,15,14,226,485,29,35,0,0
5955,1242,602,1469,1070,55,15,14,227,468,30,35,0,0
5956,1306,609,1531,1074,55,15,14,225,465,31,35,0,0
5957,1441,633,1661,1070,55,15,14,220,437,32,35,0,0
5958,1569,640,1789,1068,55,15,14,220,428,33,35,0,0
5959,1685,639,1903,1067,55,15,14,218,428,34,35,0,0
5960,1769,647,1920,1069,55,15,14,151,422,35,35,1,0
5929,177,431,288,597,56,15,14,111,166,0,8,0,0
5930,197,436,305,597,56,15,14,108,161,1,8,0,0
5931,221,436,326,593,56,15,14,105,157,2,8,0,0
5932,183,446,393,763,56,15,14,210,317,3,8,0,0
5933,192,454,426,816,56,15,14,234,362,4,8,0,0
5934,221,452,463,834,56,15,14,242,382,5,8,0,0
5935,240,449,506,880,56,15,14,266,431,6,8,0,0
5936,256,447,547,935,56,15,14,291,488,7,8,0,0
5937,259,450,580,989,56,15,14,321,539,8,8,0,0
5937,370,437,516,771,57,15,14,146,334,0,15,0,0
5938,395,443,541,777,57,15,14,146,334,1,15,0,0
5939,411,448,597,877,57,15,14,186,429,2,15,0,0
5940,451,447,653,913,57,15,14,202,466,3,15,0,0
5941,499,433,723,954,57,15,14,224,521,4,15,0,0
5942,564,433,791,957,57,15,14,227,524,5,15,0,0
5943,615,434,851,981,57,15,14,236,547,6,15,0,0
5944,661,433,895,975,57,15,14,234,542,7,15,0,0
5945,724,436,962,983,57,15,14,238,547,8,15,0,0
5946,776,436,1020,992,57,15,14,244,556,9,15,0,0
5947,819,423,1074,1011,57,15,14,255,588,10,15,0,0
5948,865,423,1135,1045,57,15,14,270,622,11,15,0,0
5949,910,432,1180,1067,57,15,14,270,635,12,15,0,0
5950,952,435,1212,1062,57,15,14,260,627,13,15,0,0
5951,1020,447,1279,1071,57,15,14,259,624,14,15,0,0
5952,1064,448,1331,1080,57,15,14,267,632,15,15,0,0
5956,1281,496,1523,1059,57,15,14,242,563,0,15,0,0
5957,1415,489,1606,930,57,15,14,191,441,1,15,0,0
5958,1458,497,1688,1018,57,15,14,230,521,2,15,0,0
5959,1526,517,1770,1047,57,15,14,244,530,3,15,0,0
5960,1619,512,1869,1053,57,15,14,250,541,4,15,0,0
5961,1689,527,1920,1059,57,15,14,231,532,5,15,0,0
5962,1752,533,1920,1070,57,15,14,168,537,6,15,0,0
5948,1573,791,1804,1079,58,15,14,231,288,0,0,0,0
5949,1707,780,1909,1071,59,15,14,202,291,0,0,0,0
5950,878,819,1100,1077,60,15,14,222,258,0,0,0,0
5953,1180,459,1302,601,61,15,14,122,142,0,0,0,0
5954,1178,464,1381,795,62,15,14,203,331,0,1,0,0
5955,1233,475,1452,834,62,15,14,219,359,1,1,0,0
128,1374,225,1438,527,1,15,15,64,302,0,41,0,1
129,1326,227,1391,525,1,15,15,65,298,1,41,0,0
130,1305,219,1372,517,1,15,15,67,298,2,41,0,0
131,1268,213,1336,511,1,15,15,68,298,3,41,0,0
132,1236,209,1306,505,1,15,15,70,296,4,41,0,0
133,1209,205,1284,514,1,15,15,75,309,5,41,0,0
134,1183,199,1256,486,1,15,15,73,287,6,41,0,0
135,1169,194,1243,477,1,15,15,74,283,7,41,0,0
136,1157,188,1228,452,1,15,15,71,264,8,41,0,0
137,1144,184,1217,446,1,15,15,73,262,9,41,0,0
138,1134,178,1205,428,1,15,15,71,250,10,41,0,0
139,1128,173,1194,406,1,15,15,66,233,11,41,0,0
140,1124,171,1189,400,1,15,15,65,229,12,41,0,0
141,1126,165,1193,394,1,15,15,67,229,13,41,0,0
142,1130,166,1198,390,1,15,15,68,224,14,41,0,0
143,1129,163,1198,389,1,15,15,69,226,15,41,0,0
144,1132,163,1198,378,1,15,15,66,215,16,41,0,0
145,1141,160,1207,371,1,15,15,66,211,17,41,0,0
146,1139,153,1207,364,1,15,15,68,211,18,41,0,0
147,1142,153,1209,358,1,15,15,67,205,19,41,0,0
148,1145,152,1208,346,1,15,15,63,194,20,41,0,0
149,1157,148,1220,338,1,15,15,63,190,21,41,0,0
150,1165,149,1226,330,1,15,15,61,181,22,41,0,0
151,1176,149,1236,319,1,15,15,60,170,23,41,0,0
152,1182,152,1239,313,1,15,15,57,161,24,41,0,0
153,1182,150,1239,309,1,15,15,57,159,25,41,0,0
154,1185,148,1243,308,1,15,15,58,160,26,41,0,0
155,1184,150,1242,307,1,15,15,58,157,27,41,0,0
156,1186,140,1246,302,1,15,15,60,162,28,41,0,0
157,1186,140,1246,300,1,15,15,60,160,29,41,0,0
158,1189,137,1251,301,1,15,15,62,164,30,41,0,0
159,1195,135,1254,291,1,15,15,59,156,31,41,0,0
160,1194,132,1255,290,1,15,15,61,158,32,41,0,0
161,1193,128,1254,288,1,15,15,61,160,33,41,0,0
162,1192,129,1250,283,1,15,15,58,154,34,41,0,0
163,1193,130,1249,280,1,15,15,56,150,35,41,0,0
164,1194,128,1247,275,1,15,15,53,147,36,41,0,0
165,1193,128,1245,270,1,15,15,52,142,37,41,0,0
166,1190,124,1242,268,1,15,15,52,144,38,41,0,0
167,1185,122,1238,268,1,15,15,53,146,39,41,0,0
168,1178,121,1230,266,1,15,15,52,145,40,41,0,0
169,1177,119,1228,262,1,15,15,51,143,41,41,1,0
151,1154,157,1201,311,2,15,15,47,154,0,1,0,0
152,1156,158,1203,315,2,15,15,47,157,1,1,0,0
955,1296,311,1433,645,3,15,15,137,334,0,20,0,1
956,1277,257,1438,651,3,15,15,161,394,1,20,0,0
957,1246,256,1416,670,3,15,15,170,414,2,20,0,0
958,1203,251,1381,684,3,15,15,178,433,3,20,0,0
959,1158,256,1347,711,3,15,15,189,455,4,20,0,0
960,1114,263,1310,731,3,15,15,196,468,5,20,0,0
961,1065,260,1263,740,3,15,15,198,480,6,20,0,0
962,1000,270,1204,764,3,15,15,204,494,7,20,0,0
963,958,283,1166,789,3,15,15,208,506,8,20,0,0
964,905,285,1132,840,3,15,15,227,555,9,20,0,0
965,854,312,1103,914,3,15,15,249,602,10,20,0,0
966,818,332,1072,945,3,15,15,254,613,11,20,0,0
967,788,355,1052,998,3,15,15,264,643,12,20,0,0
968,757,388,1026,1053,3,15,15,269,665,13,20,0,0
969,715,399,989,1075,3,15,15,274,676,14,20,0,0
970,660,429,937,1080,3,15,15,277,651,15,20,0,0
971,644,471,919,1080,3,15,15,275,609,16,20,0,0
972,698,502,971,1080,3,15,15,273,578,17,20,0,0
973,778,563,1049,1078,3,15,15,271,515,18,20,0,0
974,829,658,1082,1077,3,15,15,253,419,19,20,0,0
975,827,689,1071,1080,3,15,15,244,391,20,20,1,0
962,1355,386,1423,534,4,15,15,68,148,0,0,0,0
963,1282,281,1433,792,5,15,15,151,511,0,21,0,1
964,1276,280,1428,792,5,15,15,152,512,1,21,0,0
965,1225,293,1382,817,5,15,15,157,524,2,21,0,0
966,1179,305,1345,849,5,15,15,166,544,3,21,0,0
967,1149,300,1320,860,5,15,15,171,560,4,21,0,0
968,1106,316,1301,936,5,15,15,195,620,5,21,0,0
969,1072,334,1278,968,5,15,15,206,634,6,21,0,0
970,1040,345,1248,985,5,15,15,208,640,7,21,0,0
971,986,366,1206,1028,5,15,15,220,662,8,21,0,0
972,936,377,1158,1041,5,15,15,222,664,9,21,0,0
973,911,393,1105,941,5,15,15,194,548,10,21,0,0
974,826,424,1019,915,5,15,15,193,491,11,21,0,0
975,793,448,1013,994,5,15,15,220,546,12,21,0,0
976,780,476,1015,1045,5,15,15,235,569,13,21,0,0
977,765,511,1006,1070,5,15,15,241,559,14,21,0,0
978,741,546,983,1078,5,15,15,242,532,15,21,0,0
979,708,580,950,1079,5,15,15,242,499,16,21,0,0
980,712,616,946,1078,5,15,15,234,462,17,21,0,0
981,750,649,979,1078,5,15,15,229,429,18,21,0,0
982,826,672,1053,1075,5,15,15,227,403,19,21,0,0
983,893,696,1122,1074,5,15,15,229,378,20,21,0,0
984,905,721,1125,1080,5,15,15,220,359,21,21,1,0
1107,0,786,236,1075,10,15,15,236,289,0,24,0,1
1108,45,755,304,1073,10,15,15,259,318,1,24,0,0
1109,107,700,406,1068,10,15,15,299,368,2,24,0,0
1110,178,644,523,1072,10,15,15,345,428,3,24,0,0
1111,267,612,633,1071,10,15,15,366,459,4,24,0,0
1112,373,574,768,1075,10,15,15,395,501,5,24,0,0
1113,446,532,867,1074,10,15,15,421,542,6,24,0,0
1114,528,502,963,1074,10,15,15,435,572,7,24,0,0
1115,608,471,1057,1073,10,15,15,449,602,8,24,0,0
1116,676,439,1136,1069,10,15,15,460,630,9,24,0,0
1117,732,414,1197,1069,10,15,15,465,655,10,24,0,0
1118,789,402,1246,1067,10,15,15,457,665,11,24,0,0
1119,842,385,1290,1063,10,15,15,448,678,12,24,0,0
1120,893,367,1330,1056,10,15,15,437,689,13,24,0,0
1121,945,357,1364,1043,10,15,15,419,686,14,24,0,0
1122,997,339,1389,1008,10,15,15,392,669,15,24,0,0
1123,1041,326,1396,956,10,15,15,355,630,16,24,0,0
1124,1081,321,1412,929,10,15,15,331,608,17,24,0,0
1125,1107,318,1428,927,10,15,15,321,609,18,24,0,0
1126,1163,308,1450,875,10,15,15,287,567,19,24,0,0
1127,1205,303,1475,859,10,15,15,270,556,20,24,0,0
1128,1232,292,1488,839,10,15,15,256,547,21,24,0,0
1129,1271,287,1500,801,10,15,15,229,514,22,24,0,0
1130,1288,273,1510,797,10,15,15,222,524,23,24,0,0
1131,1327,258,1548,780,10,15,15,221,522,24,24,1,0
1443,1450,820,1619,1076,11,15,15,169,256,0,40,0,1
1444,1398,811,1574,1075,11,15,15,176,264,1,40,0,0
1445,1316,791,1506,1072,11,15,15,190,281,2,40,0,0
1446,1207,756,1424,1074,11,15,15,217,318,3,40,0,0
1447,1085,706,1336,1073,11,15,15,251,367,4,40,0,0
1448,989,663,1269,1071,11,15,15,280,408,5,40,0,0
1449,897,638,1195,1069,11,15,15,298,431,6,40,0,0
1450,780,606,1096,1064,11,15,15,316,458,7,40,0,0
1451,673,574,1015,1067,11,15,15,342,493,8,40,0,0
1452,623,546,992,1066,11,15,15,369,520,9,40,0,0
1453,626,522,1026,1068,11,15,15,400,546,10,40,0,0
1454,581,487,1001,1067,11,15,15,420,580,11,40,0,0
1455,560,460,987,1067,11,15,15,427,607,12,40,0,0
1456,564,442,992,1069,11,15,15,428,627,13,40,0,0
1457,568,427,998,1070,11,15,15,430,643,14,40,0,0
1458,571,411,1008,1067,11,15,15,437,656,15,40,0,0
1459,561,402,999,1068,11,15,15,438,666,16,40,0,0
1460,573,397,1004,1070,11,15,15,431,673,17,40,0,0
1461,612,392,1032,1067,11,15,15,420,675,18,40,0,0
1462,650,378,1071,1069,11,15,15,421,691,19,40,0,0
1463,678,368,1088,1063,11,15,15,410,695,20,40,0,0
1464,706,361,1097,1052,11,15,15,391,691,21,40,0,0
1465,751,343,1112,1010,11,15,15,361,667,22,40,0,0
1466,783,331,1128,990,11,15,15,345,659,23,40,0,0
1467,814,326,1154,984,11,15,15,340,658,24,40,0,0
1468,861,306,1188,944,11,15,15,327,638,25,40,0,0
1469,909,297,1207,897,11,15,15,298,600,26,40,0,0
1470,952,292,1234,870,11,15,15,282,578,27,40,0,0
1471,974,288,1241,846,11,15,15,267,558,28,40,0,0
1472,1017,282,1267,817,11,15,15,250,535,29,40,0,0
1473,1046,275,1288,801,11,15,15,242,526,30,40,0,0
1474,1083,278,1311,787,11,15,15,228,509,31,40,0,0
1475,1125,267,1340,757,11,15,15,215,490,32,40,0,0
1476,1162,257,1367,737,11,15,15,205,480,33,40,0,0
1477,1190,256,1392,726,11,15,15,202,470,34,40,0,0
1478,1210,259,1407,718,11,15,15,197,459,35,40,0,0
1479,1239,253,1429,703,11,15,15,190,450,36,40,0,0
1480,1263,246,1448,697,11,15,15,185,451,37,40,0,0
1481,1280,247,1458,693,11,15,15,178,446,38,40,0,0
1482,1304,245,1471,680,11,15,15,167,435,39,40,0,0
1483,1326,240,1489,666,11,15,15,163,426,40,40,1,0
1715,1298,436,1418,841,12,15,15,120,405,0,24,0,1
1716,1282,398,1413,840,12,15,15,131,442,1,24,0,0
1717,1255,350,1404,850,12,15,15,149,500,2,24,0,0
1718,1215,349,1385,913,12,15,15,170,564,3,24,0,0
1719,1191,346,1372,936,12,15,15,181,590,4,24,0,0
1720,1130,356,1339,1013,12,15,15,209,657,5,24,0,0
1721,1094,373,1320,1062,12,15,15,226,689,6,24,0,0
1722,1094,386,1325,1078,12,15,15,231,692,7,24,0,0
1723,1091,405,1325,1080,12,15,15,234,675,8,24,0,0
1724,1064,434,1303,1080,12,15,15,239,646,9,24,0,0
1725,1022,458,1273,1080,12,15,15,251,622,10,24,0,0
1726,990,485,1256,1078,12,15,15,266,593,11,24,0,0
1727,963,513,1248,1080,12,15,15,285,567,12,24,0,0
1728,930,541,1231,1080,12,15,15,301,539,13,24,0,0
1729,886,560,1212,1078,12,15,15,326,518,14,24,0,0
1730,878,584,1219,1077,12,15,15,341,493,15,24,0,0
1731,784,603,1117,1080,12,15,15,333,477,16,24,0,0
1732,741,611,1065,1078,12,15,15,324,467,17,24,0,0
1733,720,620,1037,1079,12,15,15,317,459,18,24,0,0
1734,713,632,1026,1080,12,15,15,313,448,19,24,0,0
1735,716,645,1029,1079,12,15,15,313,434,20,24,0,0
1736,738,653,1057,1076,12,15,15,319,423,21,24,0,0
1737,777,667,1103,1076,12,15,15,326,409,22,24,0,0
1738,872,687,1214,1072,12,15,15,342,385,23,24,0,0
1739,916,710,1262,1072,12,15,15,346,362,24,24,1,0
2282,555,458,1140,1067,13,15,15,585,609,0,11,0,0
2283,590,426,1178,1068,13,15,15,588,642,1,11,0,0
2284,637,400,1212,1057,13,15,15,575,657,2,11,0,0
2285,699,383,1253,1045,13,15,15,554,662,3,11,0,0
2286,783,358,1282,983,13,15,15,499,625,4,11,0,0
2287,851,342,1305,934,13,15,15,454,592,5,11,0,0
2288,899,336,1319,903,13,15,15,420,567,6,11,0,0
2289,998,326,1380,867,13,15,15,382,541,7,11,0,0
2290,1064,324,1424,854,13,15,15,360,530,8,11,0,0
2291,1124,316,1465,838,13,15,15,341,522,9,11,0,0
2292,1189,320,1492,809,13,15,15,303,489,10,11,0,0
2293,1199,301,1504,793,13,15,15,305,492,11,11,0,0
2649,1322,800,1567,1074,14,15,15,245,274,0,0,0,0
2650,1164,725,1438,1074,15,15,15,274,349,0,0,0,0
2651,1009,687,1242,1078,16,15,15,233,391,0,0,0,0
2652,840,654,1126,1073,17,15,15,286,419,0,19,0,1
2653,714,581,1047,1069,17,15,15,333,488,1,19,0,0
2654,626,548,983,1068,17,15,15,357,520,2,19,0,0
2655,571,506,955,1068,17,15,15,384,562,3,19,0,0
2656,532,447,955,1072,17,15,15,423,625,4,19,0,0
2657,517,420,952,1073,17,15,15,435,653,5,19,0,0
2658,514,380,957,1061,17,15,15,443,681,6,19,0,0
2659,557,359,988,1034,17,15,15,431,675,7,19,0,0
2660,616,348,1006,976,17,15,15,390,628,8,19,0,0
2661,677,317,1039,916,17,15,15,362,599,9,19,0,0
2662,746,304,1089,889,17,15,15,343,585,10,19,0,0
2663,823,290,1138,846,17,15,15,315,556,11,19,0,0
2664,906,279,1198,808,17,15,15,292,529,12,19,0,0
2665,968,285,1247,790,17,15,15,279,505,13,19,0,0
2666,1041,283,1301,769,17,15,15,260,486,14,19,0,0
2667,1120,278,1376,766,17,15,15,256,488,15,19,0,0
2668,1164,283,1414,764,17,15,15,250,481,16,19,0,0
2669,1237,277,1469,746,17,15,15,232,469,17,19,0,0
2670,1288,325,1484,735,17,15,15,196,410,18,19,0,0
2671,1330,321,1520,719,17,15,15,190,398,19,19,0,0
2837,1177,129,1237,260,18,15,15,60,131,0,39,0,1
2838,1182,127,1248,272,18,15,15,66,145,1,39,0,0
2839,1192,123,1259,272,18,15,15,67,149,2,39,0,0
2840,1205,126,1272,275,18,15,15,67,149,3,39,0,0
2841,1219,129,1284,275,18,15,15,65,146,4,39,0,0
2842,1227,131,1292,278,18,15,15,65,147,5,39,0,0
2843,1234,132,1299,283,18,15,15,65,151,6,39,0,0
2844,1241,138,1304,284,18,15,15,63,146,7,39,0,0
2845,1248,140,1310,285,18,15,15,62,145,8,39,0,0
2846,1254,141,1316,288,18,15,15,62,147,9,39,0,0
2847,1258,143,1321,292,18,15,15,63,149,10,39,0,0
2848,1258,145,1321,295,18,15,15,63,150,11,39,0,0
2849,1256,147,1320,301,18,15,15,64,154,12,39,0,0
2850,1257,148,1322,305,18,15,15,65,157,13,39,0,0
2851,1258,149,1323,307,18,15,15,65,158,14,39,0,0
2852,1255,149,1324,315,18,15,15,69,166,15,39,0,0
2853,1249,149,1319,320,18,15,15,70,171,16,39,0,0
2854,1244,148,1316,327,18,15,15,72,179,17,39,0,0
2855,1243,148,1317,333,18,15,15,74,185,18,39,0,0
2856,1241,149,1317,341,18,15,15,76,192,19,39,0,0
2857,1238,151,1316,350,18,15,15,78,199,20,39,0,0
2858,1232,152,1312,358,18,15,15,80,206,21,39,0,0
2859,1229,163,1308,368,18,15,15,79,205,22,39,0,0
2860,1228,168,1308,379,18,15,15,80,211,23,39,0,0
2861,1227,169,1308,382,18,15,15,81,213,24,39,0,0
2862,1223,172,1307,392,18,15,15,84,220,25,39,0,0
2863,1216,171,1303,398,18,15,15,87,227,26,39,0,0
2864,1212,175,1300,408,18,15,15,88,233,27,39,0,0
2865,1214,178,1306,421,18,15,15,92,243,28,39,0,0
2866,1217,181,1314,432,18,15,15,97,251,29,39,0,0
2867,1221,182,1317,430,18,15,15,96,248,30,39,0,0
2868,1222,184,1320,437,18,15,15,98,253,31,39,0,0
2869,1226,192,1330,464,18,15,15,104,272,32,39,0,0
2870,1236,198,1343,479,18,15,15,107,281,33,39,0,0
2871,1257,199,1364,477,18,15,15,107,278,34,39,0,0
2872,1275,204,1384,488,18,15,15,109,284,35,39,0,0
2873,1297,208,1408,498,18,15,15,111,290,36,39,0,0
2874,1317,216,1428,507,18,15,15,111,291,37,39,0,0
2875,1334,246,1434,507,18,15,15,100,261,38,39,0,0
2876,1342,252,1442,514,18,15,15,100,262,39,39,1,0
3307,1175,140,1212,253,19,15,15,37,113,0,48,0,1
3308,1185,138,1223,253,19,15,15,38,115,1,48,0,0
3309,1193,136,1235,263,19,15,15,42,127,2,48,0,0
3310,1202,136,1243,259,19,15,15,41,123,3,48,0,0
3311,1210,138,1253,267,19,15,15,43,129,4,48,0,0
3312,1217,140,1262,275,19,15,15,45,135,5,48,0,0
3313,1225,141,1271,278,19,15,15,46,137,6,48,0,0
3314,1234,144,1280,278,19,15,15,46,134,7,48,0,0
3315,1240,145,1288,284,19,15,15,48,139,8,48,0,0
3316,1244,147,1292,284,19,15,15,48,137,9,48,0,0
3317,1247,148,1295,281,19,15,15,48,133,10,48,0,0
3318,1250,149,1300,287,19,15,15,50,138,11,48,0,0
3319,1255,151,1307,294,19,15,15,52,143,12,48,0,0
3320,1261,152,1312,290,19,15,15,51,138,13,48,0,0
3321,1263,154,1318,297,19,15,15,55,143,14,48,0,0
3322,1264,155,1320,299,19,15,15,56,144,15,48,0,0
3323,1264,157,1321,300,19,15,15,57,143,16,48,0,0
3324,1269,159,1327,305,19,15,15,58,146,17,48,0,0
3325,1274,159,1333,304,19,15,15,59,145,18,48,0,0
3326,1273,162,1335,311,19,15,15,62,149,19,48,0,0
3327,1272,165,1335,314,19,15,15,63,149,20,48,0,0
3328,1270,167,1335,315,19,15,15,65,148,21,48,0,0
3329,1272,170,1339,325,19,15,15,67,155,22,48,0,0
3330,1272,171,1341,328,19,15,15,69,157,23,48,0,0
3331,1269,175,1341,335,19,15,15,72,160,24,48,0,0
3332,1266,175,1340,343,19,15,15,74,168,25,48,0,0
3333,1262,175,1339,349,19,15,15,77,174,26,48,0,0
3334,1263,176,1343,356,19,15,15,80,180,27,48,0,0
3335,1264,176,1346,359,19,15,15,82,183,28,48,0,0
3336,1264,181,1348,369,19,15,15,84,188,29,48,0,0
3337,1261,184,1348,380,19,15,15,87,196,30,48,0,0
3338,1257,184,1348,386,19,15,15,91,202,31,48,0,0
3339,1260,193,1349,394,19,15,15,89,201,32,48,0,0
3340,1262,197,1353,402,19,15,15,91,205,33,48,0,0
3341,1262,203,1355,410,19,15,15,93,207,34,48,0,0
3342,1258,200,1355,418,19,15,15,97,218,35,48,0,0
3343,1251,199,1351,422,19,15,15,100,223,36,48,0,0
3344,1250,203,1351,427,19,15,15,101,224,37,48,0,0
3345,1251,208,1352,432,19,15,15,101,224,38,48,0,0
3346,1248,213,1353,445,19,15,15,105,232,39,48,0,0
3347,1244,220,1352,462,19,15,15,108,242,40,48,0,0
3348,1240,225,1351,471,19,15,15,111,246,41,48,0,0
3349,1243,230,1353,475,19,15,15,110,245,42,48,0,0
3350,1255,228,1366,474,19,15,15,111,246,43,48,0,0
3351,1263,232,1376,481,19,15,15,113,249,44,48,0,0
3352,1274,234,1393,498,19,15,15,119,264,45,48,0,0
3353,1292,237,1413,505,19,15,15,121,268,46,48,0,0
3354,1314,243,1433,507,19,15,15,119,264,47,48,0,0
3355,1319,246,1440,515,19,15,15,121,269,48,48,1,0
3429,3,764,196,1076,20,15,15,193,312,0,0,0,0
3430,177,749,421,1075,21,15,15,244,326,0,0,0,0
3431,352,652,680,1066,22,15,15,328,414,0,12,0,0
3432,492,606,860,1070,22,15,15,368,464,1,12,0,0
3433,648,559,1060,1074,22,15,15,412,515,2,12,0,0
3434,722,492,1186,1079,22,15,15,464,587,3,12,0,0
3435,802,463,1279,1077,22,15,15,477,614,4,12,0,0
3436,870,403,1374,1067,22,15,15,504,664,5,12,0,0
3437,931,370,1437,1056,22,15,15,506,686,6,12,0,0
3438,968,334,1484,1060,22,15,15,516,726,7,12,0,0
3439,1021,305,1512,1020,22,15,15,491,715,8,12,0,0
3440,1064,297,1527,1000,22,15,15,463,703,9,12,0,0
3441,1132,280,1532,906,22,15,15,400,626,10,12,0,0
3442,1183,268,1546,864,22,15,15,363,596,11,12,0,0
3443,1243,238,1613,845,22,15,15,370,607,12,12,0,0
3443,1307,324,1431,808,23,15,15,124,484,0,0,0,0
4482,1348,220,1437,555,24,15,15,89,335,0,45,0,1
4483,1312,212,1403,554,24,15,15,91,342,1,45,0,0
4484,1273,210,1365,547,24,15,15,92,337,2,45,0,0
4485,1239,203,1327,521,24,15,15,88,318,3,45,0,0
4486,1199,193,1290,516,24,15,15,91,323,4,45,0,0
4487,1176,191,1272,523,24,15,15,96,332,5,45,0,0
4488,1153,186,1245,499,24,15,15,92,313,6,45,0,0
4489,1141,187,1230,488,24,15,15,89,301,7,45,0,0
4490,1127,185,1214,472,24,15,15,87,287,8,45,0,0
4491,1123,176,1205,451,24,15,15,82,275,9,45,0,0
4492,1120,173,1199,437,24,15,15,79,264,10,45,0,0
4493,1112,171,1189,427,24,15,15,77,256,11,45,0,0
4494,1106,167,1183,418,24,15,15,77,251,12,45,0,0
4495,1107,165,1184,411,24,15,15,77,246,13,45,0,0
4496,1109,162,1183,398,24,15,15,74,236,14,45,0,0
4497,1110,162,1182,391,24,15,15,72,229,15,45,0,0
4498,1109,159,1180,384,24,15,15,71,225,16,45,0,0
4499,1113,152,1184,373,24,15,15,71,221,17,45,0,0
4500,1122,149,1192,369,24,15,15,70,220,18,45,0,0
4501,1129,146,1198,360,24,15,15,69,214,19,45,0,0
4502,1133,145,1201,357,24,15,15,68,212,20,45,0,0
4503,1136,144,1202,352,24,15,15,66,208,21,45,0,0
4504,1143,146,1206,341,24,15,15,63,195,22,45,0,0
4505,1149,148,1210,339,24,15,15,61,191,23,45,0,0
4506,1154,145,1214,330,24,15,15,60,185,24,45,0,0
4507,1156,140,1215,326,24,15,15,59,186,25,45,0,0
4508,1158,141,1215,321,24,15,15,57,180,26,45,0,0
4509,1162,144,1215,312,24,15,15,53,168,27,45,0,0
4510,1168,152,1218,309,24,15,15,50,157,28,45,0,0
4511,1173,150,1222,303,24,15,15,49,153,29,45,0,0
4512,1173,143,1223,300,24,15,15,50,157,30,45,0,0
4513,1173,143,1223,297,24,15,15,50,154,31,45,0,0
4514,1174,140,1225,293,24,15,15,51,153,32,45,0,0
4515,1177,134,1228,289,24,15,15,51,155,33,45,0,0
4516,1183,139,1233,288,24,15,15,50,149,34,45,0,0
4517,1185,131,1236,287,24,15,15,51,156,35,45,0,0
4518,1186,129,1237,282,24,15,15,51,153,36,45,0,0
4519,1185,129,1236,282,24,15,15,51,153,37,45,0,0
4520,1187,126,1237,276,24,15,15,50,150,38,45,0,0
4521,1185,122,1237,275,24,15,15,52,153,39,45,0,0
4522,1186,128,1234,271,24,15,15,48,143,40,45,0,0
4523,1185,127,1233,272,24,15,15,48,145,41,45,0,0
4524,1185,131,1230,266,24,15,15,45,135,42,45,0,0
4525,1181,131,1224,260,24,15,15,43,129,43,45,0,0
4526,1175,128,1216,252,24,15,15,41,124,44,45,0,0
4527,1174,127,1214,248,24,15,15,40,121,45,45,1,0
4484,1386,207,1441,568,25,15,15,55,361,0,43,0,1
4485,1354,222,1400,519,25,15,15,46,297,1,43,0,0
4486,1339,225,1386,507,25,15,15,47,282,2,43,0,0
4487,1317,220,1364,493,25,15,15,47,273,3,43,0,0
4488,1293,221,1339,481,25,15,15,46,260,4,43,0,0
4489,1271,211,1325,496,25,15,15,54,285,5,43,0,0
4490,1255,206,1310,482,25,15,15,55,276,6,43,0,0
4491,1239,201,1296,475,25,15,15,57,274,7,43,0,0
4492,1229,199,1285,455,25,15,15,56,256,8,43,0,0
4493,1222,196,1278,439,25,15,15,56,243,9,43,0,0
4494,1222,190,1279,430,25,15,15,57,240,10,43,0,0
4495,1223,185,1281,415,25,15,15,58,230,11,43,0,0
4496,1222,183,1283,420,25,15,15,61,237,12,43,0,0
4497,1219,178,1280,405,25,15,15,61,227,13,43,0,0
4498,1217,175,1279,394,25,15,15,62,219,14,43,0,0
4499,1218,174,1282,393,25,15,15,64,219,15,43,0,0
4500,1221,173,1286,391,25,15,15,65,218,16,43,0,0
4501,1224,173,1289,387,25,15,15,65,214,17,43,0,0
4502,1225,174,1288,380,25,15,15,63,206,18,43,0,0
4503,1223,167,1285,366,25,15,15,62,199,19,43,0,0
4504,1224,167,1285,356,25,15,15,61,189,20,43,0,0
4505,1223,159,1287,355,25,15,15,64,196,21,43,0,0
4506,1227,154,1289,345,25,15,15,62,191,22,43,0,0
4507,1230,155,1290,337,25,15,15,60,182,23,43,0,0
4508,1230,153,1289,328,25,15,15,59,175,24,43,0,0
4509,1231,150,1289,321,25,15,15,58,171,25,43,0,0
4510,1236,148,1294,314,25,15,15,58,166,26,43,0,0
4511,1240,148,1297,314,25,15,15,57,166,27,43,0,0
4512,1243,149,1300,314,25,15,15,57,165,28,43,0,0
4513,1242,151,1298,307,25,15,15,56,156,29,43,0,0
4514,1244,152,1298,300,25,15,15,54,148,30,43,0,0
4515,1249,155,1300,296,25,15,15,51,141,31,43,0,0
4516,1251,150,1303,290,25,15,15,52,140,32,43,0,0
4517,1251,151,1304,290,25,15,15,53,139,33,43,0,0
4518,1250,149,1305,289,25,15,15,55,140,34,43,0,0
4519,1249,148,1304,285,25,15,15,55,137,35,43,0,0
4520,1247,149,1302,285,25,15,15,55,136,36,43,0,0
4521,1240,145,1297,285,25,15,15,57,140,37,43,0,0
4522,1234,144,1292,284,25,15,15,58,140,38,43,0,0
4523,1226,142,1283,279,25,15,15,57,137,39,43,0,0
4524,1219,137,1273,270,25,15,15,54,133,40,43,0,0
4525,1212,139,1261,261,25,15,15,49,122,41,43,0,0
4526,1204,135,1253,257,25,15,15,49,122,42,43,0,0
4527,1200,133,1248,253,25,15,15,48,120,43,43,1,0
5620,1340,258,1438,547,27,15,15,98,289,0,61,0,1
5621,1328,206,1445,552,27,15,15,117,346,1,61,0,0
5622,1328,204,1444,548,27,15,15,116,344,2,61,0,0
5623,1297,207,1412,544,27,15,15,115,337,3,61,0,0
5624,1270,206,1386,540,27,15,15,116,334,4,61,0,0
5625,1247,204,1362,532,27,15,15,115,328,5,61,0,0
5626,1212,202,1326,523,27,15,15,114,321,6,61,0,0
5627,1187,198,1302,516,27,15,15,115,318,7,61,0,0
5628,1173,194,1290,520,27,15,15,117,326,8,61,0,0
5629,1162,199,1270,497,27,15,15,108,298,9,61,0,0
5630,1152,204,1253,479,27,15,15,101,275,10,61,0,0
5631,1137,188,1240,471,27,15,15,103,283,11,61,0,0
5632,1123,183,1225,460,27,15,15,102,277,12,61,0,0
5633,1120,182,1221,457,27,15,15,101,275,13,61,0,0
5634,1120,177,1214,435,27,15,15,94,258,14,61,0,0
5635,1118,173,1209,424,27,15,15,91,251,15,61,0,0
5636,1118,174,1207,419,27,15,15,89,245,16,61,0,0
5637,1113,171,1198,411,27,15,15,85,240,17,61,0,0
5638,1111,166,1194,402,27,15,15,83,236,18,61,0,0
5639,1112,171,1191,399,27,15,15,79,228,19,61,0,0
5640,1116,171,1194,398,27,15,15,78,227,20,61,0,0
5641,1125,164,1201,387,27,15,15,76,223,21,61,0,0
5642,1130,161,1204,381,27,15,15,74,220,22,61,0,0
5643,1134,159,1206,377,27,15,15,72,218,23,61,0,0
5644,1139,155,1210,371,27,15,15,71,216,24,61,0,0
5645,1143,157,1211,363,27,15,15,68,206,25,61,0,0
5646,1150,158,1215,354,27,15,15,65,196,26,61,0,0
5647,1157,151,1223,350,27,15,15,66,199,27,61,0,0
5648,1161,148,1227,347,27,15,15,66,199,28,61,0,0
5649,1162,147,1227,342,27,15,15,65,195,29,61,0,0
5650,1160,146,1224,338,27,15,15,64,192,30,61,0,0
5651,1160,146,1224,335,27,15,15,64,189,31,61,0,0
5652,1163,150,1224,329,27,15,15,61,179,32,61,0,0
5653,1167,146,1227,324,27,15,15,60,178,33,61,0,0
5654,1172,142,1231,321,27,15,15,59,179,34,61,0,0
5655,1175,141,1235,320,27,15,15,60,179,35,61,0,0
5656,1179,142,1238,320,27,15,15,59,178,36,61,0,0
5657,1185,140,1243,314,27,15,15,58,174,37,61,0,0
5658,1189,141,1245,308,27,15,15,56,167,38,61,0,0
5659,1193,146,1246,305,27,15,15,53,159,39,61,0,0
5660,1201,143,1252,299,27,15,15,51,156,40,61,0,0
5661,1206,144,1257,297,27,15,15,51,153,41,61,0,0
5662,1209,145,1260,297,27,15,15,51,152,42,61,0,0
5663,1210,143,1261,294,27,15,15,51,151,43,61,0,0
5664,1210,139,1260,288,27,15,15,50,149,44,61,0,0
5665,1209,139,1259,288,27,15,15,50,149,45,61,0,0
5666,1212,136,1264,286,27,15,15,52,150,46,61,0,0
5667,1211,135,1264,285,27,15,15,53,150,47,61,0,0
5668,1212,136,1265,283,27,15,15,53,147,48,61,0,0
5669,1209,135,1262,281,27,15,15,53,146,49,61,0,0
5670,1205,132,1258,279,27,15,15,53,147,50,61,0,0
5671,1199,129,1254,276,27,15,15,55,147,51,61,0,0
5672,1198,128,1252,275,27,15,15,54,147,52,61,0,0
5673,1199,127,1254,274,27,15,15,55,147,53,61,0,0
5674,1200,124,1255,271,27,15,15,55,147,54,61,0,0
5675,1199,129,1252,271,27,15,15,53,142,55,61,0,0
5676,1198,126,1252,271,27,15,15,54,145,56,61,0,0
5677,1192,123,1248,270,27,15,15,56,147,57,61,0,0
5678,1186,122,1242,266,27,15,15,56,144,58,61,0,0
5679,1179,125,1231,260,27,15,15,52,135,59,61,0,0
5680,1176,123,1228,254,27,15,15,52,131,60,61,0,0
5681,1175,122,1225,251,27,15,15,50,129,61,61,1,0
5625,1313,211,1387,494,28,15,15,74,283,0,50,0,1
5626,1300,204,1376,494,28,15,15,76,290,1,50,0,0
5627,1294,201,1366,471,28,15,15,72,270,2,50,0,0
5628,1259,191,1347,525,28,15,15,88,334,3,50,0,0
5629,1246,192,1338,536,28,15,15,92,344,4,50,0,0
5630,1246,194,1330,504,28,15,15,84,310,5,50,0,0
5631,1244,192,1321,471,28,15,15,77,279,6,50,0,0
5632,1246,185,1320,451,28,15,15,74,266,7,50,0,0
5633,1250,182,1322,436,28,15,15,72,254,8,50,0,0
5634,1252,178,1322,419,28,15,15,70,241,9,50,0,0
5635,1250,176,1322,420,28,15,15,72,244,10,50,0,0
5636,1249,175,1321,417,28,15,15,72,242,11,50,0,0
5637,1250,176,1319,405,28,15,15,69,229,12,50,0,0
5638,1254,177,1322,400,28,15,15,68,223,13,50,0,0
5639,1259,175,1326,396,28,15,15,67,221,14,50,0,0
5640,1258,172,1324,385,28,15,15,66,213,15,50,0,0
5641,1256,167,1323,382,28,15,15,67,215,16,50,0,0
5642,1254,164,1321,382,28,15,15,67,218,17,50,0,0
5643,1252,163,1317,374,28,15,15,65,211,18,50,0,0
5644,1247,159,1314,372,28,15,15,67,213,19,50,0,0
5645,1246,159,1312,370,28,15,15,66,211,20,50,0,0
5646,1248,156,1313,362,28,15,15,65,206,21,50,0,0
5647,1247,151,1313,363,28,15,15,66,212,22,50,0,0
5648,1248,149,1313,355,28,15,15,65,206,23,50,0,0
5649,1247,144,1311,347,28,15,15,64,203,24,50,0,0
5650,1248,143,1309,341,28,15,15,61,198,25,50,0,0
5651,1250,143,1310,336,28,15,15,60,193,26,50,0,0
5652,1252,142,1310,329,28,15,15,58,187,27,50,0,0
5653,1253,142,1311,328,28,15,15,58,186,28,50,0,0
5654,1256,141,1312,325,28,15,15,56,184,29,50,0,0
5655,1256,139,1311,320,28,15,15,55,181,30,50,0,0
5656,1255,140,1310,319,28,15,15,55,179,31,50,0,0
5657,1257,142,1310,314,28,15,15,53,172,32,50,0,0
5658,1259,140,1313,314,28,15,15,54,174,33,50,0,0
5659,1263,141,1315,312,28,15,15,52,171,34,50,0,0
5660,1264,142,1314,308,28,15,15,50,166,35,50,0,0
5661,1262,142,1312,305,28,15,15,50,163,36,50,0,0
5662,1261,144,1311,310,28,15,15,50,166,37,50,0,0
5663,1263,144,1310,303,28,15,15,47,159,38,50,0,0
5664,1263,143,1309,297,28,15,15,46,154,39,50,0,0
5665,1263,142,1308,297,28,15,15,45,155,40,50,0,0
5666,1263,141,1308,294,28,15,15,45,153,41,50,0,0
5667,1263,143,1304,283,28,15,15,41,140,42,50,0,0
5668,1263,143,1303,280,28,15,15,40,137,43,50,0,0
5669,1261,146,1301,280,28,15,15,40,134,44,50,0,0
5670,1258,142,1296,270,28,15,15,38,128,45,50,0,0
5671,1251,133,1294,279,28,15,15,43,146,46,50,0,0
5672,1245,128,1291,281,28,15,15,46,153,47,50,0,0
5673,1248,124,1288,259,28,15,15,40,135,48,50,0,0
5674,1248,128,1284,250,28,15,15,36,122,49,50,0,0
5675,1247,126,1282,246,28,15,15,35,120,50,50,1,0
5659,1230,149,1269,289,29,15,15,39,140,0,0,0,0
5835,1346,265,1434,679,30,15,15,88,414,0,19,0,1
5836,1302,272,1401,735,30,15,15,99,463,1,19,0,0
5837,1262,284,1365,749,30,15,15,103,465,2,19,0,0
5838,1227,287,1337,765,30,15,15,110,478,3,19,0,0
5839,1166,290,1290,809,30,15,15,124,519,4,19,0,0
5840,1131,294,1253,798,30,15,15,122,504,5,19,0,0
5841,1088,296,1213,809,30,15,15,125,513,6,19,0,0
5842,1031,308,1167,846,30,15,15,136,538,7,19,0,0
5843,984,321,1122,854,30,15,15,138,533,8,19,0,0
5844,933,332,1075,863,30,15,15,142,531,9,19,0,0
5845,868,355,1024,922,30,15,15,156,567,10,19,0,0
5846,814,367,975,946,30,15,15,161,579,11,19,0,0
5847,763,384,939,1011,30,15,15,176,627,12,19,0,0
5848,719,410,903,1059,30,15,15,184,649,13,19,0,0
5849,676,436,861,1075,30,15,15,185,639,14,19,0,0
5850,629,469,812,1080,30,15,15,183,611,15,19,0,0
5851,560,504,736,1080,30,15,15,176,576,16,19,0,0
5852,481,533,644,1055,30,15,15,163,522,17,19,0,0
5853,400,576,554,1045,30,15,15,154,469,18,19,0,0
5854,346,597,498,1058,30,15,15,152,461,19,19,0,0
5838,1304,295,1450,804,31,15,15,146,509,0,19,0,1
5839,1258,299,1408,820,31,15,15,150,521,1,19,0,0
5840,1235,301,1395,851,31,15,15,160,550,2,19,0,0
5841,1193,308,1375,929,31,15,15,182,621,3,19,0,0
5842,1161,326,1352,970,31,15,15,191,644,4,19,0,0
5843,1125,334,1323,991,31,15,15,198,657,5,19,0,0
5844,1065,345,1278,1035,31,15,15,213,690,6,19,0,0
5845,1032,369,1250,1067,31,15,15,218,698,7,19,0,0
5846,989,384,1212,1080,31,15,15,223,696,8,19,0,0
5847,945,402,1172,1080,31,15,15,227,678,9,19,0,0
5848,927,434,1151,1080,31,15,15,224,646,10,19,0,0
5849,886,456,1112,1074,31,15,15,226,618,11,19,0,0
5850,838,491,1063,1080,31,15,15,225,589,12,19,0,0
5851,757,552,974,1080,31,15,15,217,528,13,19,0,0
5852,668,590,888,1079,31,15,15,220,489,14,19,0,0
5853,566,635,788,1077,31,15,15,222,442,15,19,0,0
5854,427,663,658,1071,31,15,15,231,408,16,19,0,0
5855,263,687,499,1070,31,15,15,236,383,17,19,0,0
5856,134,733,363,1073,31,15,15,229,340,18,19,0,0
5857,49,763,262,1079,31,15,15,213,316,19,19,0,0
390,335,423,937,1045,2,15,2,602,622,0,2,0,0
391,322,402,908,1036,2,15,2,586,634,1,2,0,0
392,247,364,865,1033,2,15,2,618,669,2,2,0,0
392,525,406,714,1005,3,15,2,189,599,0,15,0,0
393,522,400,706,985,3,15,2,184,585,1,15,0,0
394,507,406,693,995,3,15,2,186,589,2,15,0,0
395,472,421,659,1009,3,15,2,187,588,3,15,0,0
396,431,439,615,1011,3,15,2,184,572,4,15,0,0
397,389,450,584,1044,3,15,2,195,594,5,15,0,0
398,347,460,542,1043,3,15,2,195,583,6,15,0,0
399,294,473,496,1068,3,15,2,202,595,7,15,0,0
400,261,503,458,1063,3,15,2,197,560,8,15,0,0
401,231,527,426,1064,3,15,2,195,537,9,15,0,0
402,207,560,402,1071,3,15,2,195,511,10,15,0,0
403,181,614,371,1074,3,15,2,190,460,11,15,0,0
404,141,664,329,1080,3,15,2,188,416,12,15,0,0
405,98,733,272,1080,3,15,2,174,347,13,15,0,0
406,88,835,230,1080,3,15,2,142,245,14,15,0,0
407,67,882,184,1080,3,15,2,117,198,15,15,0,0
448,608,525,943,1080,5,15,2,335,555,0,59,0,1
449,600,500,945,1074,5,15,2,345,574,1,59,0,0
450,579,454,938,1056,5,15,2,359,602,2,59,0,0
451,565,426,934,1047,5,15,2,369,621,3,59,0,0
452,563,393,919,1001,5,15,2,356,608,4,59,0,0
453,545,374,865,928,5,15,2,320,554,5,59,0,0
454,526,366,823,889,5,15,2,297,523,6,59,0,0
455,507,343,779,828,5,15,2,272,485,7,59,0,0
456,503,329,765,802,5,15,2,262,473,8,59,0,0
457,498,319,744,767,5,15,2,246,448,9,59,0,0
458,487,299,715,726,5,15,2,228,427,10,59,0,0
459,477,293,690,699,5,15,2,213,406,11,59,0,0
460,468,284,665,667,5,15,2,197,383,12,59,0,0
461,468,279,657,652,5,15,2,189,373,13,59,0,0
462,466,278,644,630,5,15,2,178,352,14,59,0,0
463,455,262,623,602,5,15,2,168,340,15,59,0,0
464,444,262,601,582,5,15,2,157,320,16,59,0,0
465,444,250,596,565,5,15,2,152,315,17,59,0,0
466,435,240,583,548,5,15,2,148,308,18,59,0,0
467,437,231,579,532,5,15,2,142,301,19,59,0,0
468,435,225,567,511,5,15,2,132,286,20,59,0,0
469,427,221,554,501,5,15,2,127,280,21,59,0,0
470,423,214,544,488,5,15,2,121,274,22,59,0,0
471,418,217,532,477,5,15,2,114,260,23,59,0,0
472,419,222,524,462,5,15,2,105,240,24,59,0,0
473,412,219,515,457,5,15,2,103,238,25,59,0,0
474,406,222,509,459,5,15,2,103,237,26,59,0,0
475,407,229,506,460,5,15,2,99,231,27,59,0,0
476,396,226,496,465,5,15,2,100,239,28,59,0,0
477,390,228,488,465,5,15,2,98,237,29,59,0,0
478,390,231,486,465,5,15,2,96,234,30,59,0,0
479,396,242,488,464,5,15,2,92,222,31,59,0,0
480,392,249,483,466,5,15,2,91,217,32,59,0,0
481,400,268,487,468,5,15,2,87,200,33,59,0,0
482,398,271,481,464,5,15,2,83,193,34,59,0,0
483,404,291,486,477,5,15,2,82,186,35,59,0,0
484,405,285,489,472,5,15,2,84,187,36,59,0,0
485,403,276,493,472,5,15,2,90,196,37,59,0,0
486,399,254,500,470,5,15,2,101,216,38,59,0,0
487,394,239,500,474,5,15,2,106,235,39,59,0,0
488,391,221,501,473,5,15,2,110,252,40,59,0,0
489,402,218,508,467,5,15,2,106,249,41,59,0,0
490,405,218,508,463,5,15,2,103,245,42,59,0,0
491,407,216,508,455,5,15,2,101,239,43,59,0,0
492,422,217,518,447,5,15,2,96,230,44,59,0,0
493,425,212,522,451,5,15,2,97,239,45,59,0,0
494,419,199,518,445,5,15,2,99,246,46,59,0,0
495,415,192,513,438,5,15,2,98,246,47,59,0,0
496,413,195,509,434,5,15,2,96,239,48,59,0,0
497,414,197,502,420,5,15,2,88,223,49,59,0,0
498,414,200,494,410,5,15,2,80,210,50,59,0,0
499,412,200,488,401,5,15,2,76,201,51,59,0,0
500,404,205,476,396,5,15,2,72,191,52,59,0,0
501,398,204,470,393,5,15,2,72,189,53,59,0,0
502,394,197,466,386,5,15,2,72,189,54,59,0,0
503,389,197,458,378,5,15,2,69,181,55,59,0,0
504,386,199,450,370,5,15,2,64,171,56,59,0,0
505,372,198,435,365,5,15,2,63,167,57,59,0,0
506,369,199,431,362,5,15,2,62,163,58,59,0,0
507,364,198,425,357,5,15,2,61,159,59,59,1,0
509,368,189,426,342,5,15,2,58,153,0,59,0,0
510,366,187,422,336,5,15,2,56,149,1,59,0,0
511,366,186,425,341,5,15,2,59,155,2,59,0,0
512,370,180,427,332,5,15,2,57,152,3,59,0,0
513,370,182,423,324,5,15,2,53,142,4,59,0,0
514,372,176,424,319,5,15,2,52,143,5,59,0,0
515,370,173,421,314,5,15,2,51,141,6,59,0,0
516,373,171,424,314,5,15,2,51,143,7,59,0,0
517,373,169,425,312,5,15,2,52,143,8,59,0,0
518,372,171,419,303,5,15,2,47,132,9,59,0,0
519,371,169,417,298,5,15,2,46,129,10,59,0,0
527,353,156,397,279,5,15,2,44,123,0,59,0,0
528,351,155,394,276,5,15,2,43,121,1,59,0,0
532,346,148,388,264,5,15,2,42,116,0,59,0,0
533,344,148,385,261,5,15,2,41,113,1,59,0,0
534,345,148,385,258,5,15,2,40,110,2,59,0,0
535,344,147,383,255,5,15,2,39,108,3,59,0,0
536,346,150,383,252,5,15,2,37,102,4,59,0,0
537,339,144,380,251,5,15,2,41,107,5,59,0,0
538,338,146,378,249,5,15,2,40,103,6,59,0,0
539,339,146,380,247,5,15,2,41,101,7,59,0,0
540,341,146,382,248,5,15,2,41,102,8,59,0,0
541,342,150,380,246,5,15,2,38,96,9,59,0,0
542,342,149,381,244,5,15,2,39,95,10,59,0,0
543,342,152,378,242,5,15,2,36,90,11,59,0,0
550,326,136,361,232,5,15,2,35,96,0,59,0,0
551,327,136,362,232,5,15,2,35,96,1,59,0,0
563,325,132,360,216,5,15,2,35,84,0,59,0,0
564,324,133,359,215,5,15,2,35,82,1,59,0,0
565,324,132,360,215,5,15,2,36,83,2,59,0,0
566,325,132,361,216,5,15,2,36,84,3,59,0,0
567,326,133,362,216,5,15,2,36,83,4,59,0,0
568,326,133,362,215,5,15,2,36,82,5,59,0,0
569,323,129,361,214,5,15,2,38,85,6,59,0,0
570,320,126,360,214,5,15,2,40,88,7,59,0,0
571,318,123,358,212,5,15,2,40,89,8,59,0,0
572,319,125,357,211,5,15,2,38,86,9,59,0,0
573,318,124,356,208,5,15,2,38,84,10,59,0,0
574,318,125,355,207,5,15,2,37,82,11,59,0,0
575,320,128,355,205,5,15,2,35,77,12,59,0,0
576,320,127,355,204,5,15,2,35,77,13,59,0,0
475,399,245,447,428,6,15,2,48,183,0,0,0,0
480,459,285,507,421,7,15,2,48,136,0,0,0,0
512,354,221,402,317,8,15,2,48,96,0,3,0,0
513,355,225,397,310,8,15,2,42,85,1,3,0,0
514,355,224,399,311,8,15,2,44,87,2,3,0,0
515,356,224,399,310,8,15,2,43,86,3,3,0,0
540,327,163,365,244,8,15,2,38,81,0,3,0,0
782,322,127,358,199,11,15,2,36,72,0,0,0,0
790,327,131,362,215,12,15,2,35,84,0,85,0,0
792,328,130,364,216,12,15,2,36,86,0,85,0,0
793,328,132,364,218,12,15,2,36,86,1,85,0,0
794,329,134,364,219,12,15,2,35,85,2,85,0,0
795,330,132,366,218,12,15,2,36,86,3,85,0,0
796,330,133,366,220,12,15,2,36,87,4,85,0,0
798,329,132,365,218,12,15,2,36,86,0,85,0,0
799,330,132,366,219,12,15,2,36,87,1,85,0,0
800,331,135,366,220,12,15,2,35,85,2,85,0,0
806,328,137,364,229,12,15,2,36,92,0,85,0,1
807,327,134,363,230,12,15,2,36,96,1,85,0,0
808,325,132,363,232,12,15,2,38,100,2,85,0,0
809,325,134,363,234,12,15,2,38,100,3,85,0,0
810,325,135,364,237,12,15,2,39,102,4,85,0,0
811,325,134,364,238,12,15,2,39,104,5,85,0,0
812,326,134,365,240,12,15,2,39,106,6,85,0,0
813,325,134,365,241,12,15,2,40,107,7,85,0,0
814,327,136,366,243,12,15,2,39,107,8,85,0,0
815,327,135,367,246,12,15,2,40,111,9,85,0,0
816,331,139,369,246,12,15,2,38,107,10,85,0,0
817,333,142,371,249,12,15,2,38,107,11,85,0,0
818,332,139,371,250,12,15,2,39,111,12,85,0,0
819,329,134,371,250,12,15,2,42,116,13,85,0,0
820,327,130,373,254,12,15,2,46,124,14,85,0,0
821,328,130,375,256,12,15,2,47,126,15,85,0,0
822,330,133,379,259,12,15,2,49,126,16,85,0,0
823,337,141,384,262,12,15,2,47,121,17,85,0,0
824,339,141,387,264,12,15,2,48,123,18,85,0,0
825,340,142,389,267,12,15,2,49,125,19,85,0,0
826,344,147,392,270,12,15,2,48,123,20,85,0,0
827,345,145,394,271,12,15,2,49,126,21,85,0,0
828,347,147,396,273,12,15,2,49,126,22,85,0,0
829,347,145,397,276,12,15,2,50,131,23,85,0,0
830,348,144,399,280,12,15,2,51,136,24,85,0,0
831,353,150,402,283,12,15,2,49,133,25,85,0,0
832,357,153,404,281,12,15,2,47,128,26,85,0,0
833,362,153,408,282,12,15,2,46,129,27,85,0,0
834,362,155,410,290,12,15,2,48,135,28,85,0,0
835,362,156,411,295,12,15,2,49,139,29,85,0,0
836,365,159,414,299,12,15,2,49,140,30,85,0,0
837,367,160,416,302,12,15,2,49,142,31,85,0,0
838,369,159,419,303,12,15,2,50,144,32,85,0,0
839,369,164,419,310,12,15,2,50,146,33,85,0,0
840,369,166,420,313,12,15,2,51,147,34,85,0,0
841,370,167,422,319,12,15,2,52,152,35,85,0,0
842,372,169,425,325,12,15,2,53,156,36,85,0,0
843,375,169,429,329,12,15,2,54,160,37,85,0,0
844,378,168,434,333,12,15,2,56,165,38,85,0,0
845,378,171,437,344,12,15,2,59,173,39,85,0,0
846,379,169,438,343,12,15,2,59,174,40,85,0,0
847,381,170,441,349,12,15,2,60,179,41,85,0,0
848,384,171,445,355,12,15,2,61,184,42,85,0,0
849,386,171,449,359,12,15,2,63,188,43,85,0,0
850,387,176,451,367,12,15,2,64,191,44,85,0,0
851,386,177,450,370,12,15,2,64,193,45,85,0,0
852,388,180,453,380,12,15,2,65,200,46,85,0,0
853,391,183,458,389,12,15,2,67,206,47,85,0,0
854,397,184,466,396,12,15,2,69,212,48,85,0,0
855,400,185,471,403,12,15,2,71,218,49,85,0,0
856,403,190,475,411,12,15,2,72,221,50,85,0,0
857,406,188,481,418,12,15,2,75,230,51,85,0,0
858,414,196,488,426,12,15,2,74,230,52,85,0,0
859,424,198,499,429,12,15,2,75,231,53,85,0,0
860,433,200,511,438,12,15,2,78,238,54,85,0,0
861,435,199,519,454,12,15,2,84,255,55,85,0,0
862,444,203,528,459,12,15,2,84,256,56,85,0,0
863,450,207,537,473,12,15,2,87,266,57,85,0,0
864,456,209,545,481,12,15,2,89,272,58,85,0,0
865,464,211,560,500,12,15,2,96,289,59,85,0,0
866,476,224,574,516,12,15,2,98,292,60,85,0,0
867,474,227,577,533,12,15,2,103,306,61,85,0,0
868,474,230,582,552,12,15,2,108,322,62,85,0,0
869,477,234,592,581,12,15,2,115,347,63,85,0,0
870,488,234,606,593,12,15,2,118,359,64,85,0,0
871,496,244,617,608,12,15,2,121,364,65,85,0,0
872,498,257,627,646,12,15,2,129,389,66,85,0,0
873,497,262,630,666,12,15,2,133,404,67,85,0,0
874,497,274,632,686,12,15,2,135,412,68,85,0,0
875,498,286,640,719,12,15,2,142,433,69,85,0,0
876,498,289,647,742,12,15,2,149,453,70,85,0,0
877,495,309,652,783,12,15,2,157,474,71,85,0,0
878,481,331,645,822,12,15,2,164,491,72,85,0,0
879,463,332,638,856,12,15,2,175,524,73,85,0,0
880,445,353,634,921,12,15,2,189,568,74,85,0,0
881,437,370,636,961,12,15,2,199,591,75,85,0,0
882,422,390,635,1021,12,15,2,213,631,76,85,0,0
883,397,416,615,1062,12,15,2,218,646,77,85,0,0
884,361,429,585,1079,12,15,2,224,650,78,85,0,0
885,314,447,539,1080,12,15,2,225,633,79,85,0,0
886,275,488,495,1080,12,15,2,220,592,80,85,0,0
887,228,521,443,1080,12,15,2,215,559,81,85,0,0
888,168,561,373,1080,12,15,2,205,519,82,85,0,0
889,84,623,275,1080,12,15,2,191,457,83,85,0,0
890,35,685,204,1080,12,15,2,169,395,84,85,0,0
891,5,715,168,1080,12,15,2,163,365,85,85,1,0
1604,2,737,219,1080,13,15,2,217,343,0,77,0,1
1605,37,702,276,1080,13,15,2,239,378,1,77,0,0
1606,80,662,345,1075,13,15,2,265,413,2,77,0,0
1607,115,615,411,1073,13,15,2,296,458,3,77,0,0
1608,129,561,460,1072,13,15,2,331,511,4,77,0,0
1609,151,523,505,1071,13,15,2,354,548,5,77,0,0
1610,187,493,559,1076,13,15,2,372,583,6,77,0,0
1611,209,456,597,1075,13,15,2,388,619,7,77,0,0
1612,222,426,617,1072,13,15,2,395,646,8,77,0,0
1613,231,404,626,1068,13,15,2,395,664,9,77,0,0
1614,251,382,613,1005,13,15,2,362,623,10,77,0,0
1615,258,369,602,978,13,15,2,344,609,11,77,0,0
1616,268,358,590,946,13,15,2,322,588,12,77,0,0
1617,283,343,570,881,13,15,2,287,538,13,77,0,0
1618,287,322,555,839,13,15,2,268,517,14,77,0,0
1619,284,316,539,822,13,15,2,255,506,15,77,0,0
1620,282,304,518,785,13,15,2,236,481,16,77,0,0
1621,275,295,497,760,13,15,2,222,465,17,77,0,0
1622,273,291,488,756,13,15,2,215,465,18,77,0,0
1623,283,278,479,714,13,15,2,196,436,19,77,0,0
1624,290,271,468,676,13,15,2,178,405,20,77,0,0
1625,297,269,457,642,13,15,2,160,373,21,77,0,0
1626,300,257,452,621,13,15,2,152,364,22,77,0,0
1627,298,253,447,615,13,15,2,149,362,23,77,0,0
1628,303,242,446,598,13,15,2,143,356,24,77,0,0
1629,313,237,445,567,13,15,2,132,330,25,77,0,0
1630,319,235,441,550,13,15,2,122,315,26,77,0,0
1631,321,231,437,530,13,15,2,116,299,27,77,0,0
1632,320,219,432,513,13,15,2,112,294,28,77,0,0
1633,320,220,430,510,13,15,2,110,290,29,77,0,0
1634,323,208,428,492,13,15,2,105,284,30,77,0,0
1635,326,204,424,473,13,15,2,98,269,31,77,0,0
1636,327,205,420,461,13,15,2,93,256,32,77,0,0
1637,326,203,414,444,13,15,2,88,241,33,77,0,0
1638,325,203,411,437,13,15,2,86,234,34,77,0,0
1639,326,196,410,426,13,15,2,84,230,35,77,0,0
1640,328,199,406,416,13,15,2,78,217,36,77,0,0
1641,328,202,401,407,13,15,2,73,205,37,77,0,0
1642,320,185,396,399,13,15,2,76,214,38,77,0,0
1643,312,166,393,400,13,15,2,81,234,39,77,0,0
1644,312,164,390,390,13,15,2,78,226,40,77,0,0
1645,314,162,388,378,13,15,2,74,216,41,77,0,0
1646,322,189,384,374,13,15,2,62,185,42,77,0,0
1647,319,179,382,368,13,15,2,63,189,43,77,0,0
1648,315,151,385,361,13,15,2,70,210,44,77,0,0
1649,317,160,382,355,13,15,2,65,195,45,77,0,0
1650,325,173,384,347,13,15,2,59,174,46,77,0,0
1651,328,172,386,343,13,15,2,58,171,47,77,0,0
1652,329,175,384,342,13,15,2,55,167,48,77,0,0
1653,329,173,383,334,13,15,2,54,161,49,77,0,0
1654,329,173,381,328,13,15,2,52,155,50,77,0,0
1655,330,175,382,329,13,15,2,52,154,51,77,0,0
1656,329,170,381,324,13,15,2,52,154,52,77,0,0
1657,328,171,379,322,13,15,2,51,151,53,77,0,0
1658,328,176,376,320,13,15,2,48,144,54,77,0,0
1659,326,172,373,315,13,15,2,47,143,55,77,0,0
1660,325,167,373,311,13,15,2,48,144,56,77,0,0
1661,327,167,375,309,13,15,2,48,142,57,77,0,0
1662,327,161,376,304,13,15,2,49,143,58,77,0,0
1663,327,153,378,304,13,15,2,51,151,59,77,0,0
1664,329,155,379,301,13,15,2,50,146,60,77,0,0
1665,329,152,378,295,13,15,2,49,143,61,77,0,0
1666,329,154,376,294,13,15,2,47,140,62,77,0,0
1667,330,151,376,289,13,15,2,46,138,63,77,0,0
1668,330,148,376,287,13,15,2,46,139,64,77,0,0
1669,329,150,373,285,13,15,2,44,135,65,77,0,0
1670,325,139,372,283,13,15,2,47,144,66,77,0,0
1671,325,140,369,279,13,15,2,44,139,67,77,0,0
1672,326,142,369,276,13,15,2,43,134,68,77,0,0
1673,328,142,369,272,13,15,2,41,130,69,77,0,0
1674,327,139,369,270,13,15,2,42,131,70,77,0,0
1675,329,144,368,268,13,15,2,39,124,71,77,0,0
1676,329,141,367,262,13,15,2,38,121,72,77,0,0
1677,329,140,367,261,13,15,2,38,121,73,77,0,0
1678,331,139,368,255,13,15,2,37,116,74,77,0,0
1679,331,135,369,254,13,15,2,38,119,75,77,0,0
1680,331,133,369,252,13,15,2,38,119,76,77,0,0
1681,335,137,370,250,13,15,2,35,113,77,77,1,0
1684,333,134,371,245,13,15,2,38,111,0,77,0,0
1685,334,134,372,244,13,15,2,38,110,1,77,0,0
1686,334,135,371,242,13,15,2,37,107,2,77,0,0
1687,336,138,372,239,13,15,2,36,101,3,77,0,0
1688,335,140,370,235,13,15,2,35,95,4,77,0,0
1689,332,138,369,236,13,15,2,37,98,5,77,0,0
1690,335,140,370,234,13,15,2,35,94,6,77,0,0
1691,333,137,369,234,13,15,2,36,97,7,77,0,0
1692,331,137,367,232,13,15,2,36,95,8,77,0,0
1695,330,135,365,228,13,15,2,35,93,0,77,0,0
2553,347,149,382,246,20,15,2,35,97,0,76,0,1
2554,347,148,383,248,20,15,2,36,100,1,76,0,0
2555,347,148,383,250,20,15,2,36,102,2,76,0,0
2556,345,147,384,255,20,15,2,39,108,3,76,0,0
2557,345,147,384,255,20,15,2,39,108,4,76,0,0
2558,346,149,386,257,20,15,2,40,108,5,76,0,0
2559,346,146,388,259,20,15,2,42,113,6,76,0,0
2560,346,150,387,261,20,15,2,41,111,7,76,0,0
2561,343,146,388,265,20,15,2,45,119,8,76,0,0
2562,345,146,390,267,20,15,2,45,121,9,76,0,0
2563,347,147,392,269,20,15,2,45,122,10,76,0,0
2564,349,149,395,271,20,15,2,46,122,11,76,0,0
2565,348,148,396,276,20,15,2,48,128,12,76,0,0
2566,350,149,398,278,20,15,2,48,129,13,76,0,0
2567,351,149,400,280,20,15,2,49,131,14,76,0,0
2568,355,154,402,283,20,15,2,47,129,15,76,0,0
2569,357,156,404,285,20,15,2,47,129,16,76,0,0
2570,357,158,405,289,20,15,2,48,131,17,76,0,0
2571,357,157,405,292,20,15,2,48,135,18,76,0,0
2572,359,161,406,293,20,15,2,47,132,19,76,0,0
2573,362,166,408,296,20,15,2,46,130,20,76,0,0
2574,364,164,412,299,20,15,2,48,135,21,76,0,0
2575,365,165,413,301,20,15,2,48,136,22,76,0,0
2576,363,166,413,309,20,15,2,50,143,23,76,0,0
2577,363,166,414,312,20,15,2,51,146,24,76,0,0
2578,364,167,418,321,20,15,2,54,154,25,76,0,0
2579,368,170,421,323,20,15,2,53,153,26,76,0,0
2580,368,169,421,326,20,15,2,53,157,27,76,0,0
2581,370,172,424,332,20,15,2,54,160,28,76,0,0
2582,373,174,427,334,20,15,2,54,160,29,76,0,0
2583,376,176,431,340,20,15,2,55,164,30,76,0,0
2584,378,179,434,345,20,15,2,56,166,31,76,0,0
2585,379,182,435,352,20,15,2,56,170,32,76,0,0
2586,380,186,436,354,20,15,2,56,168,33,76,0,0
2587,381,188,438,358,20,15,2,57,170,34,76,0,0
2588,382,190,441,367,20,15,2,59,177,35,76,0,0
2589,383,192,443,369,20,15,2,60,177,36,76,0,0
2590,385,197,445,374,20,15,2,60,177,37,76,0,0
2591,383,193,447,382,20,15,2,64,189,38,76,0,0
2592,382,196,447,388,20,15,2,65,192,39,76,0,0
2593,383,196,450,394,20,15,2,67,198,40,76,0,0
2594,384,197,454,401,20,15,2,70,204,41,76,0,0
2595,384,200,455,408,20,15,2,71,208,42,76,0,0
2596,382,200,457,415,20,15,2,75,215,43,76,0,0
2597,386,203,464,429,20,15,2,78,226,44,76,0,0
2598,393,203,473,436,20,15,2,80,233,45,76,0,0
2599,400,205,482,442,20,15,2,82,237,46,76,0,0
2600,403,211,486,454,20,15,2,83,243,47,76,0,0
2601,407,213,493,462,20,15,2,86,249,48,76,0,0
2602,413,218,502,477,20,15,2,89,259,49,76,0,0
2603,425,222,517,488,20,15,2,92,266,50,76,0,0
2604,433,222,530,500,20,15,2,97,278,51,76,0,0
2605,439,229,539,512,20,15,2,100,283,52,76,0,0
2606,447,232,550,525,20,15,2,103,293,53,76,0,0
2607,459,239,569,553,20,15,2,110,314,54,76,0,0
2608,473,243,586,564,20,15,2,113,321,55,76,0,0
2609,490,255,609,582,20,15,2,119,327,56,76,0,0
2610,501,264,627,607,20,15,2,126,343,57,76,0,0
2611,511,266,642,621,20,15,2,131,355,58,76,0,0
2612,526,274,665,655,20,15,2,139,381,59,76,0,0
2613,547,282,690,672,20,15,2,143,390,60,76,0,0
2614,566,294,720,706,20,15,2,154,412,61,76,0,0
2615,572,307,734,738,20,15,2,162,431,62,76,0,0
2616,578,316,747,767,20,15,2,169,451,63,76,0,0
2617,595,335,771,811,20,15,2,176,476,64,76,0,0
2618,622,342,808,840,20,15,2,186,498,65,76,0,0
2619,643,363,850,909,20,15,2,207,546,66,76,0,0
2620,659,378,879,954,20,15,2,220,576,67,76,0,0
2621,677,405,906,1012,20,15,2,229,607,68,76,0,0
2622,709,442,939,1057,20,15,2,230,615,69,76,0,0
2623,766,465,1001,1077,20,15,2,235,612,70,76,0,0
2624,829,520,1063,1080,20,15,2,234,560,71,76,0,0
2625,866,568,1095,1080,20,15,2,229,512,72,76,0,0
2626,918,640,1127,1080,20,15,2,209,440,73,76,0,0
2627,1016,730,1199,1079,20,15,2,183,349,74,76,0,0
2628,1145,820,1309,1080,20,15,2,164,260,75,76,0,0
2629,1202,863,1350,1080,20,15,2,148,217,76,76,1,0
2924,287,154,322,245,25,15,2,35,91,0,92,0,0
2925,287,154,322,243,25,15,2,35,89,1,92,0,0
2942,281,175,316,263,25,15,2,35,88,0,92,0,1
2943,282,176,317,266,25,15,2,35,90,1,92,0,0
2944,281,177,317,268,25,15,2,36,91,2,92,0,0
2945,281,175,319,273,25,15,2,38,98,3,92,0,0
2946,282,172,322,275,25,15,2,40,103,4,92,0,0
2947,283,168,326,278,25,15,2,43,110,5,92,0,0
2948,284,170,328,282,25,15,2,44,112,6,92,0,0
2949,283,168,328,280,25,15,2,45,112,7,92,0,0
2950,283,167,329,283,25,15,2,46,116,8,92,0,0
2951,284,169,329,285,25,15,2,45,116,9,92,0,0
2952,285,170,331,288,25,15,2,46,118,10,92,0,0
2953,286,172,333,290,25,15,2,47,118,11,92,0,0
2954,285,173,332,291,25,15,2,47,118,12,92,0,0
2955,284,172,332,294,25,15,2,48,122,13,92,0,0
2956,284,175,333,297,25,15,2,49,122,14,92,0,0
2957,286,175,335,299,25,15,2,49,124,15,92,0,0
2958,288,178,338,300,25,15,2,50,122,16,92,0,0
2959,288,179,337,299,25,15,2,49,120,17,92,0,0
2960,287,180,335,298,25,15,2,48,118,18,92,0,0
2961,285,178,337,305,25,15,2,52,127,19,92,0,0
2962,286,178,339,309,25,15,2,53,131,20,92,0,0
2963,285,179,340,313,25,15,2,55,134,21,92,0,0
2964,284,181,339,315,25,15,2,55,134,22,92,0,0
2965,281,181,337,318,25,15,2,56,137,23,92,0,0
2966,281,181,339,323,25,15,2,58,142,24,92,0,0
2967,282,182,341,326,25,15,2,59,144,25,92,0,0
2968,284,184,343,329,25,15,2,59,145,26,92,0,0
2969,286,190,343,328,25,15,2,57,138,27,92,0,0
2970,284,190,342,329,25,15,2,58,139,28,92,0,0
2971,283,190,342,333,25,15,2,59,143,29,92,0,0
2972,284,194,344,339,25,15,2,60,145,30,92,0,0
2973,285,193,347,343,25,15,2,62,150,31,92,0,0
2974,285,196,348,346,25,15,2,63,150,32,92,0,0
2975,283,200,344,346,25,15,2,61,146,33,92,0,0
2976,279,200,342,351,25,15,2,63,151,34,92,0,0
2977,279,202,344,357,25,15,2,65,155,35,92,0,0
2978,279,204,344,360,25,15,2,65,156,36,92,0,0
2979,279,206,347,365,25,15,2,68,159,37,92,0,0
2980,276,209,344,370,25,15,2,68,161,38,92,0,0
2981,271,209,343,378,25,15,2,72,169,39,92,0,0
2982,269,208,344,385,25,15,2,75,177,40,92,0,0
2983,270,209,347,391,25,15,2,77,182,41,92,0,0
2984,272,210,350,394,25,15,2,78,184,42,92,0,0
2985,273,214,351,396,25,15,2,78,182,43,92,0,0
2986,269,215,350,402,25,15,2,81,187,44,92,0,0
2987,270,216,354,416,25,15,2,84,200,45,92,0,0
2988,274,220,359,422,25,15,2,85,202,46,92,0,0
2989,275,223,361,427,25,15,2,86,204,47,92,0,0
2990,277,228,361,426,25,15,2,84,198,48,92,0,0
2991,275,229,362,434,25,15,2,87,205,49,92,0,0
2992,276,235,363,440,25,15,2,87,205,50,92,0,0
2993,281,238,368,443,25,15,2,87,205,51,92,0,0
2994,282,239,374,454,25,15,2,92,215,52,92,0,0
2995,285,246,376,456,25,15,2,91,210,53,92,0,0
2996,282,245,376,464,25,15,2,94,219,54,92,0,0
2997,280,246,381,479,25,15,2,101,233,55,92,0,0
2998,287,252,387,487,25,15,2,100,235,56,92,0,0
2999,291,257,393,495,25,15,2,102,238,57,92,0,0
3000,293,264,397,503,25,15,2,104,239,58,92,0,0
3001,292,269,396,509,25,15,2,104,240,59,92,0,0
3002,286,271,395,520,25,15,2,109,249,60,92,0,0
3003,288,277,399,530,25,15,2,111,253,61,92,0,0
3004,290,279,405,543,25,15,2,115,264,62,92,0,0
3005,289,284,411,564,25,15,2,122,280,63,92,0,0
3006,290,292,413,577,25,15,2,123,285,64,92,0,0
3007,287,295,412,584,25,15,2,125,289,65,92,0,0
3008,288,305,415,597,25,15,2,127,292,66,92,0,0
3009,294,309,423,608,25,15,2,129,299,67,92,0,0
3010,297,313,432,626,25,15,2,135,313,68,92,0,0
3011,292,321,437,658,25,15,2,145,337,69,92,0,0
3012,287,322,436,670,25,15,2,149,348,70,92,0,0
3013,289,333,440,685,25,15,2,151,352,71,92,0,0
3014,293,341,449,707,25,15,2,156,366,72,92,0,0
3015,298,344,458,719,25,15,2,160,375,73,92,0,0
3016,295,355,468,764,25,15,2,173,409,74,92,0,0
3017,291,365,468,781,25,15,2,177,416,75,92,0,0
3018,295,379,476,803,25,15,2,181,424,76,92,0,0
3019,300,393,489,835,25,15,2,189,442,77,92,0,0
3020,303,402,496,851,25,15,2,193,449,78,92,0,0
3021,295,420,508,915,25,15,2,213,495,79,92,0,0
3022,291,439,508,944,25,15,2,217,505,80,92,0,0
3023,295,458,520,978,25,15,2,225,520,81,92,0,0
3024,295,481,533,1031,25,15,2,238,550,82,92,0,0
3025,302,502,542,1052,25,15,2,240,550,83,92,0,0
3026,306,531,548,1075,25,15,2,242,544,84,92,0,0
3027,309,557,547,1077,25,15,2,238,520,85,92,0,0
3028,318,591,551,1078,25,15,2,233,487,86,92,0,0
3029,344,644,563,1075,25,15,2,219,431,87,92,0,0
3030,382,685,598,1080,25,15,2,216,395,88,92,0,0
3031,418,749,623,1080,25,15,2,205,331,89,92,0,0
3032,461,831,635,1080,25,15,2,174,249,90,92,0,0
3033,492,917,613,1079,25,15,2,121,162,91,92,0,0
3034,520,965,611,1080,25,15,2,91,115,92,92,1,0
4783,528,580,1013,1073,28,15,2,485,493,0,85,0,1
4784,479,537,993,1072,28,15,2,514,535,1,85,0,0
4785,446,500,979,1074,28,15,2,533,574,2,85,0,0
4786,424,474,958,1071,28,15,2,534,597,3,85,0,0
4787,405,445,923,1048,28,15,2,518,603,4,85,0,0
4788,393,420,873,1000,28,15,2,480,580,5,85,0,0
4789,385,405,839,978,28,15,2,454,573,6,85,0,0
4790,394,384,803,921,28,15,2,409,537,7,85,0,0
4791,407,373,775,877,28,15,2,368,504,8,85,0,0
4792,409,358,753,851,28,15,2,344,493,9,85,0,0
4793,400,339,713,805,28,15,2,313,466,10,85,0,0
4794,391,330,684,782,28,15,2,293,452,11,85,0,0
4795,392,324,670,769,28,15,2,278,445,12,85,0,0
4796,401,315,648,725,28,15,2,247,410,13,85,0,0
4797,404,310,635,708,28,15,2,231,398,14,85,0,0
4798,399,298,617,686,28,15,2,218,388,15,85,0,0
4799,392,289,595,663,28,15,2,203,374,16,85,0,0
4800,393,287,583,649,28,15,2,190,362,17,85,0,0
4801,401,282,573,616,28,15,2,172,334,18,85,0,0
4802,405,275,569,600,28,15,2,164,325,19,85,0,0
4803,400,272,554,587,28,15,2,154,315,20,85,0,0
4804,391,262,537,565,28,15,2,146,303,21,85,0,0
4805,388,257,530,555,28,15,2,142,298,22,85,0,0
4806,387,254,528,553,28,15,2,141,299,23,85,0,0
4807,388,248,520,534,28,15,2,132,286,24,85,0,0
4808,388,247,511,519,28,15,2,123,272,25,85,0,0
4809,383,240,502,506,28,15,2,119,266,26,85,0,0
4810,374,235,490,497,28,15,2,116,262,27,85,0,0
4811,375,232,489,490,28,15,2,114,258,28,85,0,0
4812,381,228,487,473,28,15,2,106,245,29,85,0,0
4813,383,226,485,463,28,15,2,102,237,30,85,0,0
4814,375,220,477,462,28,15,2,102,242,31,85,0,0
4815,374,218,472,449,28,15,2,98,231,32,85,0,0
4816,375,219,470,444,28,15,2,95,225,33,85,0,0
4817,376,217,470,440,28,15,2,94,223,34,85,0,0
4818,374,213,465,431,28,15,2,91,218,35,85,0,0
4819,373,210,460,422,28,15,2,87,212,36,85,0,0
4820,369,207,454,414,28,15,2,85,207,37,85,0,0
4821,366,204,449,410,28,15,2,83,206,38,85,0,0
4822,367,204,447,405,28,15,2,80,201,39,85,0,0
4823,367,207,444,403,28,15,2,77,196,40,85,0,0
4824,366,204,440,396,28,15,2,74,192,41,85,0,0
4825,360,202,434,393,28,15,2,74,191,42,85,0,0
4826,361,202,431,381,28,15,2,70,179,43,85,0,0
4827,362,203,429,373,28,15,2,67,170,44,85,0,0
4828,365,201,431,370,28,15,2,66,169,45,85,0,0
4829,364,193,431,365,28,15,2,67,172,46,85,0,0
4830,365,196,428,361,28,15,2,63,165,47,85,0,0
4831,359,190,423,357,28,15,2,64,167,48,85,0,0
4832,355,186,418,353,28,15,2,63,167,49,85,0,0
4833,353,183,416,351,28,15,2,63,168,50,85,0,0
4834,354,178,417,346,28,15,2,63,168,51,85,0,0
4835,356,178,416,339,28,15,2,60,161,52,85,0,0
4836,354,179,413,338,28,15,2,59,159,53,85,0,0
4837,351,178,408,331,28,15,2,57,153,54,85,0,0
4838,350,177,406,328,28,15,2,56,151,55,85,0,0
4839,351,176,407,327,28,15,2,56,151,56,85,0,0
4840,354,173,409,324,28,15,2,55,151,57,85,0,0
4841,354,172,408,322,28,15,2,54,150,58,85,0,0
4842,354,172,407,318,28,15,2,53,146,59,85,0,0
4843,354,170,405,313,28,15,2,51,143,60,85,0,0
4844,354,169,405,311,28,15,2,51,142,61,85,0,0
4845,355,168,404,308,28,15,2,49,140,62,85,0,0
4846,355,166,404,304,28,15,2,49,138,63,85,0,0
4847,353,166,401,304,28,15,2,48,138,64,85,0,0
4848,351,167,398,300,28,15,2,47,133,65,85,0,0
4849,350,168,395,298,28,15,2,45,130,66,85,0,0
4850,349,168,394,298,28,15,2,45,130,67,85,0,0
4851,348,164,393,296,28,15,2,45,132,68,85,0,0
4852,346,165,391,296,28,15,2,45,131,69,85,0,0
4853,346,164,389,292,28,15,2,43,128,70,85,0,0
4854,343,163,385,287,28,15,2,42,124,71,85,0,0
4855,343,164,384,283,28,15,2,41,119,72,85,0,0
4856,342,161,383,284,28,15,2,41,123,73,85,0,0
4857,342,158,383,282,28,15,2,41,124,74,85,0,0
4858,342,160,382,278,28,15,2,40,118,75,85,0,0
4859,340,157,380,276,28,15,2,40,119,76,85,0,0
4860,339,158,377,273,28,15,2,38,115,77,85,0,0
4861,337,157,374,272,28,15,2,37,115,78,85,0,0
4862,336,155,375,271,28,15,2,39,116,79,85,0,0
4863,337,157,374,269,28,15,2,37,112,80,85,0,0
4864,336,158,372,266,28,15,2,36,108,81,85,0,0
4865,334,156,370,264,28,15,2,36,108,82,85,0,0
4866,332,153,369,262,28,15,2,37,109,83,85,0,0
4867,332,152,368,260,28,15,2,36,108,84,85,0,0
4868,332,152,367,258,28,15,2,35,106,85,85,1,0
4779,553,835,745,1071,29,15,2,192,236,0,86,0,1
4780,482,752,749,1078,29,15,2,267,326,1,86,0,0
4781,410,699,721,1080,29,15,2,311,381,2,86,0,0
4782,334,621,701,1076,29,15,2,367,455,3,86,0,0
4783,275,563,683,1074,29,15,2,408,511,4,86,0,0
4784,242,512,681,1074,29,15,2,439,562,5,86,0,0
4785,218,460,686,1076,29,15,2,468,616,6,86,0,0
4786,204,433,676,1075,29,15,2,472,642,7,86,0,0
4787,188,407,658,1070,29,15,2,470,663,8,86,0,0
4788,176,380,638,1058,29,15,2,462,678,9,86,0,0
4789,193,372,619,1020,29,15,2,426,648,10,86,0,0
4790,212,351,597,959,29,15,2,385,608,11,86,0,0
4791,219,336,577,924,29,15,2,358,588,12,86,0,0
4792,226,326,557,892,29,15,2,331,566,13,86,0,0
4793,230,316,528,845,29,15,2,298,529,14,86,0,0
4794,230,308,513,827,29,15,2,283,519,15,86,0,0
4795,241,303,504,804,29,15,2,263,501,16,86,0,0
4796,252,288,488,757,29,15,2,236,469,17,86,0,0
4797,257,281,474,728,29,15,2,217,447,18,86,0,0
4798,258,276,456,696,29,15,2,198,420,19,86,0,0
4799,257,268,444,677,29,15,2,187,409,20,86,0,0
4800,263,267,439,659,29,15,2,176,392,21,86,0,0
4801,271,261,433,629,29,15,2,162,368,22,86,0,0
4802,273,249,427,610,29,15,2,154,361,23,86,0,0
4803,275,246,419,592,29,15,2,144,346,24,86,0,0
4804,276,238,414,581,29,15,2,138,343,25,86,0,0
4805,278,236,411,572,29,15,2,133,336,26,86,0,0
4806,285,236,407,551,29,15,2,122,315,27,86,0,0
4807,289,230,404,533,29,15,2,115,303,28,86,0,0
4808,291,226,405,527,29,15,2,114,301,29,86,0,0
4809,287,224,395,515,29,15,2,108,291,30,86,0,0
4810,283,223,387,502,29,15,2,104,279,31,86,0,0
4811,286,224,383,492,29,15,2,97,268,32,86,0,0
4812,292,220,383,472,29,15,2,91,252,33,86,0,0
4813,296,218,383,461,29,15,2,87,243,34,86,0,0
4814,293,215,379,457,29,15,2,86,242,35,86,0,0
4815,288,211,372,447,29,15,2,84,236,36,86,0,0
4816,287,207,370,444,29,15,2,83,237,37,86,0,0
4817,288,207,368,439,29,15,2,80,232,38,86,0,0
4818,290,202,368,430,29,15,2,78,228,39,86,0,0
4819,291,200,367,426,29,15,2,76,226,40,86,0,0
4820,290,198,364,419,29,15,2,74,221,41,86,0,0
4821,290,197,361,412,29,15,2,71,215,42,86,0,0
4822,292,197,360,405,29,15,2,68,208,43,86,0,0
4823,295,196,361,399,29,15,2,66,203,44,86,0,0
4824,296,193,361,392,29,15,2,65,199,45,86,0,0
4825,293,192,357,391,29,15,2,64,199,46,86,0,0
4826,290,185,354,383,29,15,2,64,198,47,86,0,0
4827,289,183,351,376,29,15,2,62,193,48,86,0,0
4828,292,183,353,375,29,15,2,61,192,49,86,0,0
4829,295,180,354,368,29,15,2,59,188,50,86,0,0
4830,296,179,355,363,29,15,2,59,184,51,86,0,0
4831,295,181,351,360,29,15,2,56,179,52,86,0,0
4832,292,177,349,355,29,15,2,57,178,53,86,0,0
4833,293,179,348,351,29,15,2,55,172,54,86,0,0
4834,295,179,347,344,29,15,2,52,165,55,86,0,0
4835,296,177,346,338,29,15,2,50,161,56,86,0,0
4836,295,176,344,334,29,15,2,49,158,57,86,0,0
4837,292,173,341,331,29,15,2,49,158,58,86,0,0
4838,290,170,339,327,29,15,2,49,157,59,86,0,0
4839,292,172,339,325,29,15,2,47,153,60,86,0,0
4840,294,173,340,320,29,15,2,46,147,61,86,0,0
4841,296,168,341,317,29,15,2,45,149,62,86,0,0
4842,296,170,340,313,29,15,2,44,143,63,86,0,0
4843,294,167,339,313,29,15,2,45,146,64,86,0,0
4844,295,166,339,309,29,15,2,44,143,65,86,0,0
4845,297,168,340,306,29,15,2,43,138,66,86,0,0
4846,299,167,340,302,29,15,2,41,135,67,86,0,0
4847,299,165,340,301,29,15,2,41,136,68,86,0,0
4848,297,164,339,300,29,15,2,42,136,69,86,0,0
4849,297,164,339,298,29,15,2,42,134,70,86,0,0
4850,297,165,338,296,29,15,2,41,131,71,86,0,0
4851,298,162,339,295,29,15,2,41,133,72,86,0,0
4852,299,161,339,292,29,15,2,40,131,73,86,0,0
4853,297,161,337,289,29,15,2,40,128,74,86,0,0
4854,296,156,336,286,29,15,2,40,130,75,86,0,0
4855,295,153,336,285,29,15,2,41,132,76,86,0,0
4856,295,155,335,286,29,15,2,40,131,77,86,0,0
4857,296,156,335,284,29,15,2,39,128,78,86,0,0
4858,295,155,332,279,29,15,2,37,124,79,86,0,0
4859,293,152,331,278,29,15,2,38,126,80,86,0,0
4860,292,150,330,275,29,15,2,38,125,81,86,0,0
4861,291,149,329,276,29,15,2,38,127,82,86,0,0
4862,292,150,329,272,29,15,2,37,122,83,86,0,0
4863,293,151,329,269,29,15,2,36,118,84,86,0,0
4864,293,152,328,267,29,15,2,35,115,85,86,0,0
4865,292,151,327,265,29,15,2,35,114,86,86,1,0
2576,237,231,291,549,3,15,3,54,318,0,25,0,1
2577,260,233,319,574,3,15,3,59,341,1,25,0,0
2578,283,242,345,584,3,15,3,62,342,2,25,0,0
2579,287,249,350,589,3,15,3,63,340,3,25,0,0
2580,296,260,365,616,3,15,3,69,356,4,25,0,0
2581,312,266,385,631,3,15,3,73,365,5,25,0,0
2582,336,276,420,659,3,15,3,84,383,6,25,0,0
2583,353,285,447,686,3,15,3,94,401,7,25,0,0
2584,349,290,448,705,3,15,3,99,415,8,25,0,0
2585,355,301,464,747,3,15,3,109,446,9,25,0,0
2586,370,301,488,771,3,15,3,118,470,10,25,0,0
2587,380,315,517,821,3,15,3,137,506,11,25,0,0
2588,390,327,541,855,3,15,3,151,528,12,25,0,0
2589,403,342,559,877,3,15,3,156,535,13,25,0,0
2590,419,364,587,938,3,15,3,168,574,14,25,0,0
2591,434,378,611,977,3,15,3,177,599,15,25,0,0
2592,448,393,650,1038,3,15,3,202,645,16,25,0,0
2593,463,424,678,1067,3,15,3,215,643,17,25,0,0
2594,467,450,681,1080,3,15,3,214,630,18,25,0,0
2595,475,495,682,1080,3,15,3,207,585,19,25,0,0
2596,491,540,695,1080,3,15,3,204,540,20,25,0,0
2597,501,592,708,1080,3,15,3,207,488,21,25,0,0
2598,449,659,648,1080,3,15,3,199,421,22,25,0,0
2599,404,729,594,1078,3,15,3,190,349,23,25,0,0
2600,387,845,538,1078,3,15,3,151,233,24,25,0,0
2601,371,967,468,1079,3,15,3,97,112,25,25,1,0
2751,451,531,985,1071,4,15,3,534,540,0,26,0,1
2752,441,494,992,1073,4,15,3,551,579,1,26,0,0
2753,418,457,982,1075,4,15,3,564,618,2,26,0,0
2754,411,434,969,1071,4,15,3,558,637,3,26,0,0
2755,419,407,959,1053,4,15,3,540,646,4,26,0,0
2756,441,387,941,1017,4,15,3,500,630,5,26,0,0
2757,444,372,905,984,4,15,3,461,612,6,26,0,0
2758,450,350,867,926,4,15,3,417,576,7,26,0,0
2759,451,335,844,898,4,15,3,393,563,8,26,0,0
2760,446,323,813,870,4,15,3,367,547,9,26,0,0
2761,434,311,760,818,4,15,3,326,507,10,26,0,0
2762,419,304,719,793,4,15,3,300,489,11,26,0,0
2763,407,293,680,758,4,15,3,273,465,12,26,0,0
2764,383,280,642,737,4,15,3,259,457,13,26,0,0
2765,371,276,618,722,4,15,3,247,446,14,26,0,0
2766,361,272,584,683,4,15,3,223,411,15,26,0,0
2767,346,267,553,665,4,15,3,207,398,16,26,0,0
2768,332,269,522,651,4,15,3,190,382,17,26,0,0
2769,312,261,490,630,4,15,3,178,369,18,26,0,0
2770,305,265,475,615,4,15,3,170,350,19,26,0,0
2771,293,262,459,605,4,15,3,166,343,20,26,0,0
2772,261,254,418,587,4,15,3,157,333,21,26,0,0
2773,242,252,392,575,4,15,3,150,323,22,26,0,0
2774,221,250,361,561,4,15,3,140,311,23,26,0,0
2775,208,246,340,553,4,15,3,132,307,24,26,0,0
2776,204,264,324,558,4,15,3,120,294,25,26,0,0
2777,188,261,304,545,4,15,3,116,284,26,26,1,0
3432,282,149,332,277,5,15,3,50,128,0,94,0,1
3433,291,148,340,275,5,15,3,49,127,1,94,0,0
3434,302,144,351,271,5,15,3,49,127,2,94,0,0
3435,306,139,360,279,5,15,3,54,140,3,94,0,0
3436,315,134,368,273,5,15,3,53,139,4,94,0,0
3437,321,132,374,272,5,15,3,53,140,5,94,0,0
3438,342,143,394,279,5,15,3,52,136,6,94,0,0
3439,362,145,411,274,5,15,3,49,129,7,94,0,0
3440,377,145,423,274,5,15,3,46,129,8,94,0,0
3441,372,149,424,293,5,15,3,52,144,9,94,0,0
3442,378,149,434,303,5,15,3,56,154,10,94,0,0
3443,385,148,443,310,5,15,3,58,162,11,94,0,0
3444,392,150,450,312,5,15,3,58,162,12,94,0,0
3445,400,150,460,316,5,15,3,60,166,13,94,0,0
3446,414,151,475,322,5,15,3,61,171,14,94,0,0
3447,427,153,488,326,5,15,3,61,173,15,94,0,0
3448,443,153,503,326,5,15,3,60,173,16,94,0,0
3449,462,156,512,298,5,15,3,50,142,17,94,0,0
3450,471,161,531,323,5,15,3,60,162,18,94,0,0
3451,482,164,545,330,5,15,3,63,166,19,94,0,0
3452,484,164,550,334,5,15,3,66,170,20,94,0,0
3453,483,163,552,335,5,15,3,69,172,21,94,0,0
3454,480,162,550,336,5,15,3,70,174,22,94,0,0
3455,477,162,547,337,5,15,3,70,175,23,94,0,0
3456,472,161,541,338,5,15,3,69,177,24,94,0,0
3457,468,160,536,340,5,15,3,68,180,25,94,0,0
3458,465,156,534,341,5,15,3,69,185,26,94,0,0
3459,463,154,531,341,5,15,3,68,187,27,94,0,0
3460,464,155,531,342,5,15,3,67,187,28,94,0,0
3461,463,155,529,340,5,15,3,66,185,29,94,0,0
3462,463,156,530,342,5,15,3,67,186,30,94,0,0
3463,463,157,529,343,5,15,3,66,186,31,94,0,0
3464,460,162,523,343,5,15,3,63,181,32,94,0,0
3465,457,163,522,349,5,15,3,65,186,33,94,0,0
3466,454,165,519,352,5,15,3,65,187,34,94,0,0
3467,450,166,516,355,5,15,3,66,189,35,94,0,0
3468,445,167,512,359,5,15,3,67,192,36,94,0,0
3469,443,168,508,362,5,15,3,65,194,37,94,0,0
3470,448,171,511,365,5,15,3,63,194,38,94,0,0
3471,452,170,516,369,5,15,3,64,199,39,94,0,0
3472,457,171,518,366,5,15,3,61,195,40,94,0,0
3473,457,171,516,364,5,15,3,59,193,41,94,0,0
3474,458,172,515,363,5,15,3,57,191,42,94,0,0
3475,456,170,513,366,5,15,3,57,196,43,94,0,0
3476,456,170,512,367,5,15,3,56,197,44,94,0,0
3477,456,170,512,367,5,15,3,56,197,45,94,0,0
3478,456,168,511,366,5,15,3,55,198,46,94,0,0
3479,456,170,510,366,5,15,3,54,196,47,94,0,0
3480,455,170,509,367,5,15,3,54,197,48,94,0,0
3481,453,171,508,368,5,15,3,55,197,49,94,0,0
3482,451,167,508,368,5,15,3,57,201,50,94,0,0
3483,450,167,507,367,5,15,3,57,200,51,94,0,0
3484,450,170,506,368,5,15,3,56,198,52,94,0,0
3485,449,172,506,368,5,15,3,57,196,53,94,0,0
3486,449,172,506,368,5,15,3,57,196,54,94,0,0
3487,448,172,506,369,5,15,3,58,197,55,94,0,0
3488,448,171,506,369,5,15,3,58,198,56,94,0,0
3489,448,171,506,369,5,15,3,58,198,57,94,0,0
3490,448,172,506,369,5,15,3,58,197,58,94,0,0
3491,448,171,507,369,5,15,3,59,198,59,94,0,0
3492,448,171,506,369,5,15,3,58,198,60,94,0,0
3493,447,171,506,369,5,15,3,59,198,61,94,0,0
3494,447,171,506,369,5,15,3,59,198,62,94,0,0
3495,447,171,506,369,5,15,3,59,198,63,94,0,0
3496,448,171,506,369,5,15,3,58,198,64,94,0,0
3497,448,172,506,369,5,15,3,58,197,65,94,0,0
3498,448,171,506,369,5,15,3,58,198,66,94,0,0
3499,448,171,506,369,5,15,3,58,198,67,94,0,0
3500,448,171,506,368,5,15,3,58,197,68,94,0,0
3501,448,167,507,371,5,15,3,59,204,69,94,0,0
3502,449,169,507,369,5,15,3,58,200,70,94,0,0
3503,448,166,508,372,5,15,3,60,206,71,94,0,0
3504,448,164,508,373,5,15,3,60,209,72,94,0,0
3505,449,167,508,370,5,15,3,59,203,73,94,0,0
3506,449,169,507,369,5,15,3,58,200,74,94,0,0
3507,450,169,508,369,5,15,3,58,200,75,94,0,0
3508,450,169,508,369,5,15,3,58,200,76,94,0,0
3509,450,169,507,368,5,15,3,57,199,77,94,0,0
3510,450,170,506,368,5,15,3,56,198,78,94,0,0
3511,451,171,507,367,5,15,3,56,196,79,94,0,0
3512,451,171,507,367,5,15,3,56,196,80,94,0,0
3513,450,169,506,368,5,15,3,56,199,81,94,0,0
3514,450,169,506,368,5,15,3,56,199,82,94,0,0
3515,449,169,506,368,5,15,3,57,199,83,94,0,0
3516,450,170,506,368,5,15,3,56,198,84,94,0,0
3517,451,168,507,369,5,15,3,56,201,85,94,0,0
3518,452,170,507,369,5,15,3,55,199,86,94,0,0
3519,451,170,506,369,5,15,3,55,199,87,94,0,0
3520,450,170,504,367,5,15,3,54,197,88,94,0,0
3521,447,168,501,368,5,15,3,54,200,89,94,0,0
3522,444,170,498,367,5,15,3,54,197,90,94,0,0
3523,444,171,497,365,5,15,3,53,194,91,94,0,0
3524,441,171,494,367,5,15,3,53,196,92,94,0,0
3525,440,173,492,367,5,15,3,52,194,93,94,0,0
3526,450,170,490,319,5,15,3,40,149,94,94,1,0
3455,321,120,356,221,7,15,3,35,101,0,59,0,1
3456,320,120,356,224,7,15,3,36,104,1,59,0,0
3457,320,122,356,226,7,15,3,36,104,2,59,0,0
3458,319,123,355,224,7,15,3,36,101,3,59,0,0
3459,318,123,354,226,7,15,3,36,103,4,59,0,0
3460,317,124,354,227,7,15,3,37,103,5,59,0,0
3461,315,123,354,229,7,15,3,39,106,6,59,0,0
3462,314,123,354,234,7,15,3,40,111,7,59,0,0
3463,315,126,355,234,7,15,3,40,108,8,59,0,0
3464,316,125,356,236,7,15,3,40,111,9,59,0,0
3465,318,125,359,239,7,15,3,41,114,10,59,0,0
3466,320,126,360,238,7,15,3,40,112,11,59,0,0
3467,322,128,362,240,7,15,3,40,112,12,59,0,0
3468,325,131,365,243,7,15,3,40,112,13,59,0,0
3469,328,133,368,244,7,15,3,40,111,14,59,0,0
3470,331,129,373,245,7,15,3,42,116,15,59,0,0
3471,335,126,378,247,7,15,3,43,121,16,59,0,0
3472,341,130,380,243,7,15,3,39,113,17,59,0,0
3473,343,130,383,244,7,15,3,40,114,18,59,0,0
3474,344,130,385,246,7,15,3,41,116,19,59,0,0
3475,346,136,386,250,7,15,3,40,114,20,59,0,0
3476,345,139,383,249,7,15,3,38,110,21,59,0,0
3477,343,138,383,252,7,15,3,40,114,22,59,0,0
3478,344,138,383,251,7,15,3,39,113,23,59,0,0
3479,344,139,381,245,7,15,3,37,106,24,59,0,0
3480,343,139,382,252,7,15,3,39,113,25,59,0,0
3481,344,138,386,260,7,15,3,42,122,26,59,0,0
3482,343,138,389,267,7,15,3,46,129,27,59,0,0
3483,343,135,390,268,7,15,3,47,133,28,59,0,0
3484,344,135,391,268,7,15,3,47,133,29,59,0,0
3485,345,137,392,272,7,15,3,47,135,30,59,0,0
3486,346,139,392,270,7,15,3,46,131,31,59,0,0
3487,345,136,392,271,7,15,3,47,135,32,59,0,0
3488,344,138,392,274,7,15,3,48,136,33,59,0,0
3489,343,141,391,277,7,15,3,48,136,34,59,0,0
3490,343,143,392,281,7,15,3,49,138,35,59,0,0
3491,343,142,393,285,7,15,3,50,143,36,59,0,0
3492,341,142,393,290,7,15,3,52,148,37,59,0,0
3493,339,141,391,292,7,15,3,52,151,38,59,0,0
3494,337,141,390,293,7,15,3,53,152,39,59,0,0
3495,336,143,390,296,7,15,3,54,153,40,59,0,0
3496,338,143,392,300,7,15,3,54,157,41,59,0,0
3497,341,143,395,297,7,15,3,54,154,42,59,0,0
3498,343,145,396,298,7,15,3,53,153,43,59,0,0
3499,346,147,398,296,7,15,3,52,149,44,59,0,0
3500,346,148,399,300,7,15,3,53,152,45,59,0,0
3501,346,146,400,304,7,15,3,54,158,46,59,0,0
3502,346,146,403,312,7,15,3,57,166,47,59,0,0
3503,350,146,406,313,7,15,3,56,167,48,59,0,0
3504,353,145,410,314,7,15,3,57,169,49,59,0,0
3505,352,145,412,325,7,15,3,60,180,50,59,0,0
3506,352,145,412,328,7,15,3,60,183,51,59,0,0
3507,351,145,412,332,7,15,3,61,187,52,59,0,0
3508,350,145,410,331,7,15,3,60,186,53,59,0,0
3509,350,147,411,334,7,15,3,61,187,54,59,0,0
3510,351,149,413,336,7,15,3,62,187,55,59,0,0
3511,353,150,418,347,7,15,3,65,197,56,59,0,0
3512,356,151,421,351,7,15,3,65,200,57,59,0,0
3513,358,152,421,345,7,15,3,63,193,58,59,0,0
3514,359,152,423,348,7,15,3,64,196,59,59,1,0
3516,358,152,417,333,7,15,3,59,181,0,59,0,1
3517,354,157,410,328,7,15,3,56,171,1,59,0,0
3518,354,157,409,324,7,15,3,55,167,2,59,0,0
3519,356,155,412,326,7,15,3,56,171,3,59,0,0
3520,357,153,415,332,7,15,3,58,179,4,59,0,0
3521,358,157,413,323,7,15,3,55,166,5,59,0,0
3522,360,153,415,321,7,15,3,55,168,6,59,0,0
3523,357,152,414,321,7,15,3,57,169,7,59,0,0
3524,355,152,414,326,7,15,3,59,174,8,59,0,0
3525,351,154,410,326,7,15,3,59,172,9,59,0,0
3526,346,155,405,327,7,15,3,59,172,10,59,0,0
3527,340,156,398,325,7,15,3,58,169,11,59,0,0
3528,333,159,393,329,7,15,3,60,170,12,59,0,0
3529,323,162,382,333,7,15,3,59,171,13,59,0,0
3530,315,157,374,330,7,15,3,59,173,14,59,0,0
3531,317,155,365,297,7,15,3,48,142,15,59,0,0
3532,312,153,366,314,7,15,3,54,161,16,59,0,0
3533,313,155,364,307,7,15,3,51,152,17,59,0,0
3534,308,151,366,327,7,15,3,58,176,18,59,0,0
3535,306,150,366,335,7,15,3,60,185,19,59,0,0
3536,307,155,366,337,7,15,3,59,182,20,59,0,0
3537,311,159,369,339,7,15,3,58,180,21,59,0,0
3538,317,160,375,338,7,15,3,58,178,22,59,0,0
3539,325,156,383,337,7,15,3,58,181,23,59,0,0
3540,331,153,392,339,7,15,3,61,186,24,59,0,0
3541,335,152,397,342,7,15,3,62,190,25,59,0,0
3542,340,152,402,341,7,15,3,62,189,26,59,0,0
3543,345,152,407,343,7,15,3,62,191,27,59,0,0
3544,350,152,412,342,7,15,3,62,190,28,59,0,0
3545,358,153,421,341,7,15,3,63,188,29,59,0,0
3546,362,152,429,350,7,15,3,67,198,30,59,0,0
3547,367,153,436,354,7,15,3,69,201,31,59,0,0
3548,377,153,447,350,7,15,3,70,197,32,59,0,0
3549,385,152,458,356,7,15,3,73,204,33,59,0,0
3550,397,152,472,360,7,15,3,75,208,34,59,0,0
3551,407,155,481,359,7,15,3,74,204,35,59,0,0
3552,418,158,491,362,7,15,3,73,204,36,59,0,0
3553,426,157,501,364,7,15,3,75,207,37,59,0,0
3554,442,159,516,365,7,15,3,74,206,38,59,0,0
3555,453,157,528,365,7,15,3,75,208,39,59,0,0
3556,467,161,541,366,7,15,3,74,205,40,59,0,0
3557,481,158,557,368,7,15,3,76,210,41,59,0,0
3558,500,159,575,368,7,15,3,75,209,42,59,0,0
3559,517,162,590,367,7,15,3,73,205,43,59,0,0
3560,528,164,602,368,7,15,3,74,204,44,59,0,0
3561,543,163,615,369,7,15,3,72,206,45,59,0,0
3562,557,171,621,358,7,15,3,64,187,46,59,0,0
3563,569,172,632,358,7,15,3,63,186,47,59,0,0
3439,351,155,390,279,8,15,3,39,124,0,1,0,0
3440,358,153,403,297,8,15,3,45,144,1,1,0,0
3446,399,153,446,309,9,15,3,47,156,0,105,0,1
3447,400,154,447,310,9,15,3,47,156,1,105,0,0
3448,405,151,452,307,9,15,3,47,156,2,105,0,0
3449,410,154,457,309,9,15,3,47,155,3,105,0,0
3450,414,156,461,312,9,15,3,47,156,4,105,0,0
3451,416,154,466,315,9,15,3,50,161,5,105,0,0
3452,417,156,468,323,9,15,3,51,167,6,105,0,0
3453,417,156,469,323,9,15,3,52,167,7,105,0,0
3454,415,155,468,326,9,15,3,53,171,8,105,0,0
3455,414,157,469,331,9,15,3,55,174,9,105,0,0
3456,413,157,468,332,9,15,3,55,175,10,105,0,0
3457,410,159,466,335,9,15,3,56,176,11,105,0,0
3458,404,161,462,342,9,15,3,58,181,12,105,0,0
3459,398,162,459,347,9,15,3,61,185,13,105,0,0
3460,393,163,454,350,9,15,3,61,187,14,105,0,0
3461,391,164,453,353,9,15,3,62,189,15,105,0,0
3462,391,165,455,358,9,15,3,64,193,16,105,0,0
3463,391,164,456,361,9,15,3,65,197,17,105,0,0
3464,388,165,456,366,9,15,3,68,201,18,105,0,0
3465,387,169,455,369,9,15,3,68,200,19,105,0,0
3466,387,172,455,372,9,15,3,68,200,20,105,0,0
3467,386,173,454,372,9,15,3,68,199,21,105,0,0
3468,388,175,456,373,9,15,3,68,198,22,105,0,0
3469,392,175,460,371,9,15,3,68,196,23,105,0,0
3470,400,176,468,376,9,15,3,68,200,24,105,0,0
3471,407,174,475,375,9,15,3,68,201,25,105,0,0
3472,412,173,478,375,9,15,3,66,202,26,105,0,0
3473,415,172,481,376,9,15,3,66,204,27,105,0,0
3474,416,173,480,376,9,15,3,64,203,28,105,0,0
3475,415,172,478,378,9,15,3,63,206,29,105,0,0
3476,414,172,476,378,9,15,3,62,206,30,105,0,0
3477,409,173,471,380,9,15,3,62,207,31,105,0,0
3478,407,179,467,377,9,15,3,60,198,32,105,0,0
3479,401,176,462,376,9,15,3,61,200,33,105,0,0
3480,395,173,458,376,9,15,3,63,203,34,105,0,0
3481,391,171,455,380,9,15,3,64,209,35,105,0,0
3482,386,169,452,384,9,15,3,66,215,36,105,0,0
3483,385,173,449,385,9,15,3,64,212,37,105,0,0
3484,383,169,448,382,9,15,3,65,213,38,105,0,0
3485,382,166,447,382,9,15,3,65,216,39,105,0,0
3486,384,167,447,383,9,15,3,63,216,40,105,0,0
3487,385,168,448,384,9,15,3,63,216,41,105,0,0
3488,386,175,448,385,9,15,3,62,210,42,105,0,0
3489,388,172,450,383,9,15,3,62,211,43,105,0,0
3490,388,170,451,384,9,15,3,63,214,44,105,0,0
3491,388,168,451,384,9,15,3,63,216,45,105,0,0
3492,387,165,451,383,9,15,3,64,218,46,105,0,0
3493,386,160,452,384,9,15,3,66,224,47,105,0,0
3494,386,164,451,384,9,15,3,65,220,48,105,0,0
3495,387,165,450,384,9,15,3,63,219,49,105,0,0
3496,386,165,450,384,9,15,3,64,219,50,105,0,0
3497,386,165,450,384,9,15,3,64,219,51,105,0,0
3498,385,165,449,384,9,15,3,64,219,52,105,0,0
3499,385,164,449,384,9,15,3,64,220,53,105,0,0
3500,386,165,449,384,9,15,3,63,219,54,105,0,0
3501,386,165,450,384,9,15,3,64,219,55,105,0,0
3502,387,166,450,384,9,15,3,63,218,56,105,0,0
3503,388,167,451,384,9,15,3,63,217,57,105,0,0
3504,389,169,451,384,9,15,3,62,215,58,105,0,0
3505,388,165,451,384,9,15,3,63,219,59,105,0,0
3506,389,165,451,384,9,15,3,62,219,60,105,0,0
3507,393,173,454,384,9,15,3,61,211,61,105,0,0
3508,394,171,457,385,9,15,3,63,214,62,105,0,0
3509,396,169,460,385,9,15,3,64,216,63,105,0,0
3510,396,169,460,384,9,15,3,64,215,64,105,0,0
3511,398,165,463,380,9,15,3,65,215,65,105,0,0
3512,397,165,463,383,9,15,3,66,218,66,105,0,0
3513,396,166,462,383,9,15,3,66,217,67,105,0,0
3514,396,168,462,382,9,15,3,66,214,68,105,0,0
3515,396,169,461,382,9,15,3,65,213,69,105,0,0
3516,396,169,461,383,9,15,3,65,214,70,105,0,0
3517,395,167,461,383,9,15,3,66,216,71,105,0,0
3518,393,169,458,385,9,15,3,65,216,72,105,0,0
3519,393,169,459,386,9,15,3,66,217,73,105,0,0
3520,394,171,458,384,9,15,3,64,213,74,105,0,0
3521,394,170,460,387,9,15,3,66,217,75,105,0,0
3522,394,170,460,388,9,15,3,66,218,76,105,0,0
3523,393,170,459,388,9,15,3,66,218,77,105,0,0
3524,393,169,459,386,9,15,3,66,217,78,105,0,0
3525,395,172,460,386,9,15,3,65,214,79,105,0,0
3526,395,167,460,386,9,15,3,65,219,80,105,0,0
3527,397,167,461,380,9,15,3,64,213,81,105,0,0
3528,404,168,467,381,9,15,3,63,213,82,105,0,0
3529,408,170,471,378,9,15,3,63,208,83,105,0,0
3530,413,174,474,378,9,15,3,61,204,84,105,0,0
3531,418,173,479,377,9,15,3,61,204,85,105,0,0
3532,426,173,487,378,9,15,3,61,205,86,105,0,0
3533,436,173,498,380,9,15,3,62,207,87,105,0,0
3534,440,172,504,379,9,15,3,64,207,88,105,0,0
3535,446,173,511,379,9,15,3,65,206,89,105,0,0
3536,454,173,520,380,9,15,3,66,207,90,105,0,0
3537,462,172,529,379,9,15,3,67,207,91,105,0,0
3538,467,172,532,374,9,15,3,65,202,92,105,0,0
3539,472,170,539,379,9,15,3,67,209,93,105,0,0
3540,477,172,544,381,9,15,3,67,209,94,105,0,0
3541,481,174,546,380,9,15,3,65,206,95,105,0,0
3542,485,173,552,378,9,15,3,67,205,96,105,0,0
3543,489,174,557,381,9,15,3,68,207,97,105,0,0
3544,494,175,563,379,9,15,3,69,204,98,105,0,0
3545,501,175,570,377,9,15,3,69,202,99,105,0,0
3546,516,175,584,372,9,15,3,68,197,100,105,0,0
3547,530,175,596,370,9,15,3,66,195,101,105,0,0
3548,542,177,607,370,9,15,3,65,193,102,105,0,0
3549,555,173,618,366,9,15,3,63,193,103,105,0,0
3550,563,183,621,365,9,15,3,58,182,104,105,0,0
3551,571,184,628,363,9,15,3,57,179,105,105,1,0
3514,364,158,417,286,10,15,3,53,128,0,2,0,0
3515,359,157,415,292,10,15,3,56,135,1,2,0,0
3516,357,157,414,295,10,15,3,57,138,2,2,0,0
3488,409,149,445,219,11,15,3,36,70,0,0,0,0
3519,377,153,420,230,13,15,3,43,77,0,1,0,0
3520,376,152,420,230,13,15,3,44,78,1,1,0,0
3521,456,169,492,259,14,15,3,36,90,0,1,0,0
3522,452,167,490,261,14,15,3,38,94,1,1,0,0
3529,395,166,440,333,18,15,3,45,167,0,30,0,1
3530,397,166,440,326,18,15,3,43,160,1,30,0,0
3531,396,164,440,325,18,15,3,44,161,2,30,0,0
3532,393,163,436,322,18,15,3,43,159,3,30,0,0
3533,392,162,435,322,18,15,3,43,160,4,30,0,0
3534,392,162,436,321,18,15,3,44,159,5,30,0,0
3535,393,162,437,322,18,15,3,44,160,6,30,0,0
3536,396,161,440,323,18,15,3,44,162,7,30,0,0
3537,397,161,443,323,18,15,3,46,162,8,30,0,0
3538,400,162,445,324,18,15,3,45,162,9,30,0,0
3539,403,162,449,326,18,15,3,46,164,10,30,0,0
3540,405,162,452,329,18,15,3,47,167,11,30,0,0
3541,407,163,455,331,18,15,3,48,168,12,30,0,0
3542,410,164,458,329,18,15,3,48,165,13,30,0,0
3543,414,166,463,331,18,15,3,49,165,14,30,0,0
3544,420,166,470,332,18,15,3,50,166,15,30,0,0
3545,427,164,478,334,18,15,3,51,170,16,30,0,0
3546,432,165,484,337,18,15,3,52,172,17,30,0,0
3547,440,170,491,336,18,15,3,51,166,18,30,0,0
3548,450,172,500,336,18,15,3,50,164,19,30,0,0
3549,455,168,509,342,18,15,3,54,174,20,30,0,0
3550,465,174,520,347,18,15,3,55,173,21,30,0,0
3551,476,172,531,349,18,15,3,55,177,22,30,0,0
3552,491,176,545,348,18,15,3,54,172,23,30,0,0
3553,504,177,559,352,18,15,3,55,175,24,30,0,0
3554,519,178,574,349,18,15,3,55,171,25,30,0,0
3555,533,179,590,352,18,15,3,57,173,26,30,0,0
3556,549,183,605,353,18,15,3,56,170,27,30,0,0
3557,562,193,613,350,18,15,3,51,157,28,30,0,0
3558,570,197,618,350,18,15,3,48,153,29,30,0,0
3559,580,200,628,351,18,15,3,48,151,30,30,1,0
3542,544,177,584,355,19,15,3,40,178,0,2,0,0
3544,564,177,604,352,19,15,3,40,175,0,2,0,0
3545,568,184,609,362,19,15,3,41,178,1,2,0,0
3546,572,186,615,370,19,15,3,43,184,2,2,0,0
3607,318,127,353,216,21,15,3,35,89,0,27,0,0
3609,319,128,354,218,21,15,3,35,90,0,27,0,0
3623,326,142,361,240,21,15,3,35,98,0,27,0,1
3624,327,141,363,241,21,15,3,36,100,1,27,0,0
3625,329,138,365,241,21,15,3,36,103,2,27,0,0
3626,331,140,368,244,21,15,3,37,104,3,27,0,0
3627,332,141,368,245,21,15,3,36,104,4,27,0,0
3628,332,140,369,246,21,15,3,37,106,5,27,0,0
3629,332,142,370,249,21,15,3,38,107,6,27,0,0
3630,335,143,372,250,21,15,3,37,107,7,27,0,0
3631,337,142,375,250,21,15,3,38,108,8,27,0,0
3632,340,142,376,249,21,15,3,36,107,9,27,0,0
3633,344,142,380,250,21,15,3,36,108,10,27,0,0
3634,347,144,383,253,21,15,3,36,109,11,27,0,0
3635,352,143,389,256,21,15,3,37,113,12,27,0,0
3636,357,145,393,255,21,15,3,36,110,13,27,0,0
3637,364,143,401,254,21,15,3,37,111,14,27,0,0
3638,367,143,404,258,21,15,3,37,115,15,27,0,0
3639,371,145,408,258,21,15,3,37,113,16,27,0,0
3640,380,144,418,258,21,15,3,38,114,17,27,0,0
3641,382,145,421,260,21,15,3,39,115,18,27,0,0
3642,385,145,426,263,21,15,3,41,118,19,27,0,0
3643,390,144,433,264,21,15,3,43,120,20,27,0,0
3644,399,144,441,264,21,15,3,42,120,21,27,0,0
3645,419,144,461,262,21,15,3,42,118,22,27,0,0
3646,430,144,473,268,21,15,3,43,124,23,27,0,0
3647,442,142,486,268,21,15,3,44,126,24,27,0,0
3648,451,143,497,271,21,15,3,46,128,25,27,0,0
3649,465,144,509,271,21,15,3,44,127,26,27,0,0
3650,473,144,517,272,21,15,3,44,128,27,27,1,0
3649,398,153,435,267,23,15,3,37,114,0,90,0,1
3650,395,153,435,275,23,15,3,40,122,1,90,0,0
3651,393,154,434,278,23,15,3,41,124,2,90,0,0
3652,391,155,433,283,23,15,3,42,128,3,90,0,0
3653,389,155,431,283,23,15,3,42,128,4,90,0,0
3654,385,155,427,288,23,15,3,42,133,5,90,0,0
3655,378,156,421,292,23,15,3,43,136,6,90,0,0
3656,375,156,417,292,23,15,3,42,136,7,90,0,0
3657,372,156,417,299,23,15,3,45,143,8,90,0,0
3658,370,155,415,302,23,15,3,45,147,9,90,0,0
3659,368,154,412,303,23,15,3,44,149,10,90,0,0
3660,365,159,409,306,23,15,3,44,147,11,90,0,0
3661,362,161,406,309,23,15,3,44,148,12,90,0,0
3662,360,161,403,308,23,15,3,43,147,13,90,0,0
3663,360,163,403,312,23,15,3,43,149,14,90,0,0
3664,364,164,407,312,23,15,3,43,148,15,90,0,0
3665,369,166,414,317,23,15,3,45,151,16,90,0,0
3666,374,168,420,322,23,15,3,46,154,17,90,0,0
3667,387,164,434,322,23,15,3,47,158,18,90,0,0
3668,400,164,450,325,23,15,3,50,161,19,90,0,0
3669,414,170,465,328,23,15,3,51,158,20,90,0,0
3670,433,168,484,325,23,15,3,51,157,21,90,0,0
3671,453,168,506,325,23,15,3,53,157,22,90,0,0
3672,464,169,522,331,23,15,3,58,162,23,90,0,0
3673,470,172,532,337,23,15,3,62,165,24,90,0,0
3674,472,176,535,339,23,15,3,63,163,25,90,0,0
3675,474,177,536,342,23,15,3,62,165,26,90,0,0
3676,469,176,533,347,23,15,3,64,171,27,90,0,0
3677,466,177,528,346,23,15,3,62,169,28,90,0,0
3678,460,174,524,351,23,15,3,64,177,29,90,0,0
3679,460,177,523,354,23,15,3,63,177,30,90,0,0
3680,459,178,520,354,23,15,3,61,176,31,90,0,0
3681,451,173,514,356,23,15,3,63,183,32,90,0,0
3682,443,168,509,356,23,15,3,66,188,33,90,0,0
3683,438,165,503,351,23,15,3,65,186,34,90,0,0
3684,438,162,501,343,23,15,3,63,181,35,90,0,0
3685,436,159,503,351,23,15,3,67,192,36,90,0,0
3686,433,158,503,359,23,15,3,70,201,37,90,0,0
3687,431,155,503,363,23,15,3,72,208,38,90,0,0
3688,431,160,500,361,23,15,3,69,201,39,90,0,0
3689,429,163,495,359,23,15,3,66,196,40,90,0,0
3690,428,160,492,358,23,15,3,64,198,41,90,0,0
3691,428,164,493,363,23,15,3,65,199,42,90,0,0
3692,427,165,493,366,23,15,3,66,201,43,90,0,0
3693,429,163,494,364,23,15,3,65,201,44,90,0,0
3694,429,163,494,363,23,15,3,65,200,45,90,0,0
3695,430,161,494,362,23,15,3,64,201,46,90,0,0
3696,430,162,494,361,23,15,3,64,199,47,90,0,0
3697,430,164,493,362,23,15,3,63,198,48,90,0,0
3698,430,165,493,362,23,15,3,63,197,49,90,0,0
3699,431,166,493,362,23,15,3,62,196,50,90,0,0
3700,431,166,492,363,23,15,3,61,197,51,90,0,0
3701,431,167,492,363,23,15,3,61,196,52,90,0,0
3702,432,167,492,363,23,15,3,60,196,53,90,0,0
3703,432,165,493,363,23,15,3,61,198,54,90,0,0
3704,432,162,492,361,23,15,3,60,199,55,90,0,0
3705,432,164,492,361,23,15,3,60,197,56,90,0,0
3706,433,163,493,362,23,15,3,60,199,57,90,0,0
3707,433,163,493,362,23,15,3,60,199,58,90,0,0
3708,432,162,493,363,23,15,3,61,201,59,90,0,0
3709,431,157,493,365,23,15,3,62,208,60,90,0,0
3710,431,158,493,364,23,15,3,62,206,61,90,0,0
3711,431,159,493,363,23,15,3,62,204,62,90,0,0
3712,431,159,492,361,23,15,3,61,202,63,90,0,0
3713,430,158,488,354,23,15,3,58,196,64,90,0,0
3714,427,155,484,349,23,15,3,57,194,65,90,0,0
3715,427,156,482,347,23,15,3,55,191,66,90,0,0
3716,428,159,481,347,23,15,3,53,188,67,90,0,0
3717,430,162,484,353,23,15,3,54,191,68,90,0,0
3718,432,166,486,357,23,15,3,54,191,69,90,0,0
3719,434,167,489,361,23,15,3,55,194,70,90,0,0
3720,435,168,490,361,23,15,3,55,193,71,90,0,0
3721,434,167,490,362,23,15,3,56,195,72,90,0,0
3722,435,166,491,362,23,15,3,56,196,73,90,0,0
3723,434,165,493,362,23,15,3,59,197,74,90,0,0
3724,430,166,485,355,23,15,3,55,189,75,90,0,0
3725,431,168,482,342,23,15,3,51,174,76,90,0,0
3726,433,167,484,344,23,15,3,51,177,77,90,0,0
3727,439,168,489,343,23,15,3,50,175,78,90,0,0
3728,445,164,498,349,23,15,3,53,185,79,90,0,0
3729,453,163,506,352,23,15,3,53,189,80,90,0,0
3730,459,167,512,352,23,15,3,53,185,81,90,0,0
3731,464,167,518,354,23,15,3,54,187,82,90,0,0
3732,472,166,525,346,23,15,3,53,180,83,90,0,0
3733,479,168,535,353,23,15,3,56,185,84,90,0,0
3734,485,169,543,357,23,15,3,58,188,85,90,0,0
3735,500,166,562,361,23,15,3,62,195,86,90,0,0
3736,516,165,579,364,23,15,3,63,199,87,90,0,0
3737,527,163,593,365,23,15,3,66,202,88,90,0,0
3738,546,170,609,363,23,15,3,63,193,89,90,0,0
3739,555,170,617,363,23,15,3,62,193,90,90,1,0
3645,405,164,447,263,26,15,3,42,99,0,1,0,0
3646,395,154,441,264,26,15,3,46,110,1,1,0,0
3664,452,145,490,281,27,15,3,38,136,0,12,0,0
3665,442,145,482,284,27,15,3,40,139,1,12,0,0
3666,435,149,477,290,27,15,3,42,141,2,12,0,0
3667,427,150,469,285,27,15,3,42,135,3,12,0,0
3668,427,150,470,287,27,15,3,43,137,4,12,0,0
3670,415,146,462,306,27,15,3,47,160,0,12,0,0
3671,415,149,462,309,27,15,3,47,160,1,12,0,0
3672,414,151,461,310,27,15,3,47,159,2,12,0,0
3673,413,150,462,315,27,15,3,49,165,3,12,0,0
3674,415,151,465,320,27,15,3,50,169,4,12,0,0
3675,418,151,468,319,27,15,3,50,168,5,12,0,0
3676,419,150,470,325,27,15,3,51,175,6,12,0,0
3677,420,153,471,330,27,15,3,51,177,7,12,0,0
3678,420,151,470,331,27,15,3,50,180,8,12,0,0
3679,421,151,471,330,27,15,3,50,179,9,12,0,0
3680,424,156,473,333,27,15,3,49,177,10,12,0,0
3681,427,159,474,335,27,15,3,47,176,11,12,0,0
3682,427,160,475,338,27,15,3,48,178,12,12,0,0
3707,432,155,467,230,27,15,3,35,75,0,12,0,0
3708,432,159,468,234,27,15,3,36,75,1,12,0,0
3709,432,158,468,235,27,15,3,36,77,2,12,0,0
3710,432,158,469,235,27,15,3,37,77,3,12,0,0
3718,429,157,464,229,27,15,3,35,72,0,12,0,0
3719,426,159,462,231,27,15,3,36,72,1,12,0,0
3683,453,159,495,246,30,15,3,42,87,0,0,0,0
3694,426,159,468,234,31,15,3,42,75,0,0,0,0
3696,426,156,466,237,32,15,3,40,81,0,0,0,0
3714,461,172,498,290,33,15,3,37,118,0,0,0,0
3724,470,183,508,291,34,15,3,38,108,0,9,0,0
3725,475,180,510,279,34,15,3,35,99,1,9,0,0
3726,459,175,517,343,34,15,3,58,168,2,9,0,0
3727,452,173,521,370,34,15,3,69,197,3,9,0,0
3728,466,176,535,372,34,15,3,69,196,4,9,0,0
3729,476,177,547,381,34,15,3,71,204,5,9,0,0
3730,492,178,561,377,34,15,3,69,199,6,9,0,0
3731,507,178,575,375,34,15,3,68,197,7,9,0,0
3732,512,180,583,376,34,15,3,71,196,8,9,0,0
3733,515,180,591,389,34,15,3,76,209,9,9,0,0
3727,491,178,530,304,35,15,3,39,126,0,0,0,0
3733,563,195,606,348,36,15,3,43,153,0,0,0,0
4139,453,148,504,283,37,15,3,51,135,0,9,0,0
4140,443,148,492,278,37,15,3,49,130,1,9,0,0
4141,428,147,477,278,37,15,3,49,131,2,9,0,0
4142,416,149,466,281,37,15,3,50,132,3,9,0,0
4143,393,147,443,281,37,15,3,50,134,4,9,0,0
4144,372,147,423,282,37,15,3,51,135,5,9,0,0
4145,352,150,400,278,37,15,3,48,128,6,9,0,0
4146,330,150,378,280,37,15,3,48,130,7,9,0,0
4147,313,150,360,278,37,15,3,47,128,8,9,0,0
4148,296,151,343,278,37,15,3,47,127,9,9,0,0
5327,364,131,399,233,41,15,3,35,102,0,18,0,0
5328,366,131,401,233,41,15,3,35,102,1,18,0,0
5337,383,135,418,247,41,15,3,35,112,0,18,0,0
5338,384,136,419,248,41,15,3,35,112,1,18,0,0
5339,385,135,421,248,41,15,3,36,113,2,18,0,0
5340,389,135,425,250,41,15,3,36,115,3,18,0,0
5341,391,137,427,251,41,15,3,36,114,4,18,0,0
5342,393,139,429,251,41,15,3,36,112,5,18,0,0
5343,395,137,432,253,41,15,3,37,116,6,18,0,0
5344,396,139,434,257,41,15,3,38,118,7,18,0,0
5345,400,141,437,257,41,15,3,37,116,8,18,0,0
5346,405,138,442,253,41,15,3,37,115,9,18,0,0
5347,411,139,452,258,41,15,3,41,119,10,18,0,0
5348,416,139,457,259,41,15,3,41,120,11,18,0,0
5349,423,139,463,255,41,15,3,40,116,12,18,0,0
5350,432,136,473,258,41,15,3,41,122,13,18,0,0
5351,441,137,483,259,41,15,3,42,122,14,18,0,0
5352,454,136,495,258,41,15,3,41,122,15,18,0,0
5353,462,136,505,262,41,15,3,43,126,16,18,0,0
5354,467,136,510,265,41,15,3,43,129,17,18,0,0
5355,473,136,516,267,41,15,3,43,131,18,18,0,0
5334,323,134,358,244,42,15,3,35,110,0,16,0,0
5335,327,134,362,246,42,15,3,35,112,1,16,0,0
5336,329,135,364,248,42,15,3,35,113,2,16,0,0
5337,331,136,366,249,42,15,3,35,113,3,16,0,0
5338,333,139,368,251,42,15,3,35,112,4,16,0,0
5343,341,141,376,255,42,15,3,35,114,0,16,0,0
5344,342,144,377,258,42,15,3,35,114,1,16,0,0
5345,346,145,381,259,42,15,3,35,114,2,16,0,0
5346,349,145,385,261,42,15,3,36,116,3,16,0,0
5347,352,146,389,261,42,15,3,37,115,4,16,0,0
5348,353,144,391,262,42,15,3,38,118,5,16,0,0
5349,355,143,394,264,42,15,3,39,121,6,16,0,0
5350,359,146,398,266,42,15,3,39,120,7,16,0,0
5351,367,145,407,267,42,15,3,40,122,8,16,0,0
5352,381,143,422,266,42,15,3,41,123,9,16,0,0
5353,395,143,439,269,42,15,3,44,126,10,16,0,0
5354,406,142,451,268,42,15,3,45,126,11,16,0,0
5355,423,146,463,260,42,15,3,40,114,12,16,0,0
5356,435,146,481,272,42,15,3,46,126,13,16,0,0
5357,453,143,500,270,42,15,3,47,127,14,16,0,0
5358,467,155,508,271,42,15,3,41,116,15,16,0,0
5359,476,156,517,272,42,15,3,41,116,16,16,0,0
5793,463,139,509,275,43,15,3,46,136,0,64,0,1
5794,459,145,503,273,43,15,3,44,128,1,64,0,0
5795,466,148,506,267,43,15,3,40,119,2,64,0,0
5796,466,154,502,262,43,15,3,36,108,3,64,0,0
5797,455,151,492,260,43,15,3,37,109,4,64,0,0
5798,443,150,480,257,43,15,3,37,107,5,64,0,0
5799,432,149,470,258,43,15,3,38,109,6,64,0,0
5800,423,150,461,257,43,15,3,38,107,7,64,0,0
5801,411,148,450,257,43,15,3,39,109,8,64,0,0
5802,403,149,442,258,43,15,3,39,109,9,64,0,0
5803,396,147,435,254,43,15,3,39,107,10,64,0,0
5804,390,147,427,248,43,15,3,37,101,11,64,0,0
5805,385,147,424,251,43,15,3,39,104,12,64,0,0
5806,380,149,419,255,43,15,3,39,106,13,64,0,0
5807,376,153,413,253,43,15,3,37,100,14,64,0,0
5808,372,153,408,252,43,15,3,36,99,15,64,0,0
5809,366,149,403,249,43,15,3,37,100,16,64,0,0
5810,363,146,399,246,43,15,3,36,100,17,64,0,0
5811,362,146,397,241,43,15,3,35,95,18,64,0,0
5812,361,144,396,240,43,15,3,35,96,19,64,0,0
5813,359,143,395,242,43,15,3,36,99,20,64,0,0
5814,356,143,393,243,43,15,3,37,100,21,64,0,0
5815,355,142,390,239,43,15,3,35,97,22,64,0,0
5902,406,149,442,250,43,15,3,36,101,0,64,0,1
5903,406,148,445,257,43,15,3,39,109,1,64,0,0
5904,407,148,446,256,43,15,3,39,108,2,64,0,0
5905,407,149,447,259,43,15,3,40,110,3,64,0,0
5906,406,147,448,263,43,15,3,42,116,4,64,0,0
5907,406,149,449,266,43,15,3,43,117,5,64,0,0
5908,408,150,451,266,43,15,3,43,116,6,64,0,0
5909,409,149,454,268,43,15,3,45,119,7,64,0,0
5910,410,149,456,272,43,15,3,46,123,8,64,0,0
5911,411,151,458,275,43,15,3,47,124,9,64,0,0
5912,412,151,459,277,43,15,3,47,126,10,64,0,0
5913,411,151,460,282,43,15,3,49,131,11,64,0,0
5914,412,152,462,282,43,15,3,50,130,12,64,0,0
5915,414,153,464,284,43,15,3,50,131,13,64,0,0
5916,415,157,466,292,43,15,3,51,135,14,64,0,0
5917,415,156,466,292,43,15,3,51,136,15,64,0,0
5918,418,157,470,296,43,15,3,52,139,16,64,0,0
5919,422,162,475,303,43,15,3,53,141,17,64,0,0
5920,428,162,480,305,43,15,3,52,143,18,64,0,0
5921,431,163,483,308,43,15,3,52,145,19,64,0,0
5922,433,164,485,312,43,15,3,52,148,20,64,0,0
5923,434,165,487,314,43,15,3,53,149,21,64,0,0
5924,440,167,493,317,43,15,3,53,150,22,64,0,0
5925,448,168,501,318,43,15,3,53,150,23,64,0,0
5926,456,170,508,317,43,15,3,52,147,24,64,0,0
5927,460,172,514,323,43,15,3,54,151,25,64,0,0
5928,460,173,515,326,43,15,3,55,153,26,64,0,0
5929,462,174,519,332,43,15,3,57,158,27,64,0,0
5930,463,177,521,338,43,15,3,58,161,28,64,0,0
5931,468,176,527,338,43,15,3,59,162,29,64,0,0
5932,470,178,528,341,43,15,3,58,163,30,64,0,0
5933,472,179,529,339,43,15,3,57,160,31,64,0,0
5934,473,180,529,340,43,15,3,56,160,32,64,0,0
5935,472,182,530,350,43,15,3,58,168,33,64,0,0
5936,474,185,535,360,43,15,3,61,175,34,64,0,0
5937,479,185,543,366,43,15,3,64,181,35,64,0,0
5938,482,185,548,370,43,15,3,66,185,36,64,0,0
5939,482,189,547,378,43,15,3,65,189,37,64,0,0
5940,481,191,546,381,43,15,3,65,190,38,64,0,0
5941,482,195,548,388,43,15,3,66,193,39,64,0,0
5942,488,198,556,395,43,15,3,68,197,40,64,0,0
5943,498,190,569,398,43,15,3,71,208,41,64,0,0
5944,508,194,580,408,43,15,3,72,214,42,64,0,0
5945,523,199,593,408,43,15,3,70,209,43,64,0,0
5946,536,201,605,409,43,15,3,69,208,44,64,0,0
5947,547,204,620,421,43,15,3,73,217,45,64,0,0
5948,557,204,632,425,43,15,3,75,221,46,64,0,0
5949,562,205,638,426,43,15,3,76,221,47,64,0,0
5950,563,205,639,426,43,15,3,76,221,48,64,0,0
5951,552,205,630,430,43,15,3,78,225,49,64,0,0
5952,541,206,618,430,43,15,3,77,224,50,64,0,0
5953,526,214,601,438,43,15,3,75,224,51,64,0,0
5954,498,208,575,441,43,15,3,77,233,52,64,0,0
5955,481,208,560,447,43,15,3,79,239,53,64,0,0
5956,462,196,546,451,43,15,3,84,255,54,64,0,0
5957,438,182,527,452,43,15,3,89,270,55,64,0,0
5958,409,187,493,447,43,15,3,84,260,56,64,0,0
5959,376,222,455,456,43,15,3,79,234,57,64,0,0
5960,345,219,423,455,43,15,3,78,236,58,64,0,0
5961,317,200,398,448,43,15,3,81,248,59,64,0,0
5962,296,206,376,448,43,15,3,80,242,60,64,0,0
5963,272,214,345,432,43,15,3,73,218,61,64,0,0
5964,243,209,322,442,43,15,3,79,233,62,64,0,0
5965,234,216,312,448,43,15,3,78,232,63,64,0,0
5966,217,217,295,450,43,15,3,78,233,64,64,1,0
5795,435,148,477,271,44,15,3,42,123,0,29,0,1
5796,425,146,469,273,44,15,3,44,127,1,29,0,0
5797,411,145,453,268,44,15,3,42,123,2,29,0,0
5798,393,146,436,270,44,15,3,43,124,3,29,0,0
5799,379,146,422,270,44,15,3,43,124,4,29,0,0
5800,366,146,407,266,44,15,3,41,120,5,29,0,0
5801,355,145,398,268,44,15,3,43,123,6,29,0,0
5802,347,145,388,266,44,15,3,41,121,7,29,0,0
5803,339,145,381,265,44,15,3,42,120,8,29,0,0
5804,330,145,372,264,44,15,3,42,119,9,29,0,0
5805,326,141,369,263,44,15,3,43,122,10,29,0,0
5806,324,139,367,262,44,15,3,43,123,11,29,0,0
5807,321,139,363,260,44,15,3,42,121,12,29,0,0
5808,317,139,358,256,44,15,3,41,117,13,29,0,0
5809,315,139,356,256,44,15,3,41,117,14,29,0,0
5810,315,139,356,255,44,15,3,41,116,15,29,0,0
5811,315,140,355,253,44,15,3,40,113,16,29,0,0
5812,314,139,354,251,44,15,3,40,112,17,29,0,0
5813,312,138,353,250,44,15,3,41,112,18,29,0,0
5814,311,138,352,248,44,15,3,41,110,19,29,0,0
5815,311,137,352,246,44,15,3,41,109,20,29,0,0
5816,313,137,352,244,44,15,3,39,107,21,29,0,0
5817,313,135,353,244,44,15,3,40,109,22,29,0,0
5818,312,136,351,241,44,15,3,39,105,23,29,0,0
5819,311,135,348,239,44,15,3,37,104,24,29,0,0
5820,311,135,347,236,44,15,3,36,101,25,29,0,0
5821,310,136,346,234,44,15,3,36,98,26,29,0,0
5822,310,135,346,234,44,15,3,36,99,27,29,0,0
5823,308,135,343,231,44,15,3,35,96,28,29,0,0
5824,307,135,342,230,44,15,3,35,95,29,29,1,0
5890,332,136,368,241,49,15,3,36,105,0,39,0,0
5891,336,137,372,241,49,15,3,36,104,1,39,0,0
5922,324,137,359,247,49,15,3,35,110,0,39,0,1
5923,327,137,362,250,49,15,3,35,113,1,39,0,0
5924,328,137,364,249,49,15,3,36,112,2,39,0,0
5925,330,138,366,251,49,15,3,36,113,3,39,0,0
5926,332,138,369,252,49,15,3,37,114,4,39,0,0
5927,335,145,370,252,49,15,3,35,107,5,39,0,0
5928,336,144,372,254,49,15,3,36,110,6,39,0,0
5929,338,145,374,255,49,15,3,36,110,7,39,0,0
5930,339,145,375,257,49,15,3,36,112,8,39,0,0
5931,339,145,376,259,49,15,3,37,114,9,39,0,0
5932,340,145,376,257,49,15,3,36,112,10,39,0,0
5933,338,146,375,260,49,15,3,37,114,11,39,0,0
5934,338,146,375,261,49,15,3,37,115,12,39,0,0
5935,337,146,374,262,49,15,3,37,116,13,39,0,0
5936,333,146,371,263,49,15,3,38,117,14,39,0,0
5937,331,146,369,265,49,15,3,38,119,15,39,0,0
5938,328,146,368,270,49,15,3,40,124,16,39,0,0
5939,329,148,368,271,49,15,3,39,123,17,39,0,0
5940,330,148,369,273,49,15,3,39,125,18,39,0,0
5941,331,151,370,275,49,15,3,39,124,19,39,0,0
5942,331,151,370,276,49,15,3,39,125,20,39,0,0
5943,331,150,370,275,49,15,3,39,125,21,39,0,0
5944,330,152,370,280,49,15,3,40,128,22,39,0,0
5945,331,157,369,279,49,15,3,38,122,23,39,0,0
5946,333,158,370,278,49,15,3,37,120,24,39,0,0
5947,334,157,372,281,49,15,3,38,124,25,39,0,0
5948,336,156,373,280,49,15,3,37,124,26,39,0,0
5949,336,156,375,284,49,15,3,39,128,27,39,0,0
5950,337,155,378,290,49,15,3,41,135,28,39,0,0
5951,339,152,381,294,49,15,3,42,142,29,39,0,0
5952,342,152,385,296,49,15,3,43,144,30,39,0,0
5953,340,154,383,296,49,15,3,43,142,31,39,0,0
5954,338,156,380,301,49,15,3,42,145,32,39,0,0
5955,338,157,381,303,49,15,3,43,146,33,39,0,0
5956,330,160,373,305,49,15,3,43,145,34,39,0,0
5957,332,160,373,300,49,15,3,41,140,35,39,0,0
5958,332,160,375,310,49,15,3,43,150,36,39,0,0
5959,334,162,378,316,49,15,3,44,154,37,39,0,0
5960,333,163,378,318,49,15,3,45,155,38,39,0,0
5962,336,164,381,320,49,15,3,45,156,0,39,0,0
5963,344,165,380,283,49,15,3,36,118,1,39,0,0
5966,345,173,391,311,49,15,3,46,138,0,39,0,1
5967,338,173,392,334,49,15,3,54,161,1,39,0,0
5968,333,174,390,350,49,15,3,57,176,2,39,0,0
5969,330,174,389,360,49,15,3,59,186,3,39,0,0
5970,328,175,389,366,49,15,3,61,191,4,39,0,0
5971,324,178,385,370,49,15,3,61,192,5,39,0,0
5972,319,177,381,372,49,15,3,62,195,6,39,0,0
5973,316,178,378,374,49,15,3,62,196,7,39,0,0
5974,317,180,379,377,49,15,3,62,197,8,39,0,0
5975,319,181,381,378,49,15,3,62,197,9,39,0,0
5976,320,181,385,386,49,15,3,65,205,10,39,0,0
5977,321,182,387,392,49,15,3,66,210,11,39,0,0
5978,320,183,386,398,49,15,3,66,215,12,39,0,0
5979,320,186,387,402,49,15,3,67,216,13,39,0,0
5980,322,189,388,406,49,15,3,66,217,14,39,0,0
5981,323,188,389,408,49,15,3,66,220,15,39,0,0
5982,323,191,390,414,49,15,3,67,223,16,39,0,0
5983,321,194,387,417,49,15,3,66,223,17,39,0,0
5984,314,194,381,421,49,15,3,67,227,18,39,0,0
5985,307,192,376,425,49,15,3,69,233,19,39,0,0
5986,302,193,370,432,49,15,3,68,239,20,39,0,0
5987,295,194,362,432,49,15,3,67,238,21,39,0,0
5988,289,195,355,433,49,15,3,66,238,22,39,0,0
5989,282,200,348,437,49,15,3,66,237,23,39,0,0
5990,270,206,334,440,49,15,3,64,234,24,39,0,0
5991,261,204,324,438,49,15,3,63,234,25,39,0,0
5992,256,206,320,441,49,15,3,64,235,26,39,0,0
5993,248,211,311,443,49,15,3,63,232,27,39,0,0
5994,239,207,304,444,49,15,3,65,237,28,39,0,0
5995,233,202,299,448,49,15,3,66,246,29,39,0,0
5996,231,200,297,450,49,15,3,66,250,30,39,0,0
5997,232,200,298,450,49,15,3,66,250,31,39,0,0
5998,234,201,299,448,49,15,3,65,247,32,39,0,0
5999,234,200,298,446,49,15,3,64,246,33,39,0,0
6000,240,200,305,446,49,15,3,65,246,34,39,0,0
6001,251,199,319,448,49,15,3,68,249,35,39,0,0
6002,262,199,331,447,49,15,3,69,248,36,39,0,0
6003,268,199,337,448,49,15,3,69,249,37,39,0,0
6004,276,200,345,446,49,15,3,69,246,38,39,0,0
6005,287,200,354,443,49,15,3,67,243,39,39,1,0
5920,408,159,443,290,52,15,3,35,131,0,10,0,0
5921,411,158,447,293,52,15,3,36,135,1,10,0,0
5923,415,163,451,293,52,15,3,36,130,0,10,0,0
5924,414,163,452,300,52,15,3,38,137,1,10,0,0
5925,414,164,454,304,52,15,3,40,140,2,10,0,0
5926,415,164,456,304,52,15,3,41,140,3,10,0,0
5927,416,165,459,308,52,15,3,43,143,4,10,0,0
5928,417,169,459,308,52,15,3,42,139,5,10,0,0
5929,418,170,460,309,52,15,3,42,139,6,10,0,0
5930,416,171,460,314,52,15,3,44,143,7,10,0,0
5931,418,174,463,314,52,15,3,45,140,8,10,0,0
5932,417,175,462,315,52,15,3,45,140,9,10,0,0
5933,417,174,464,319,52,15,3,47,145,10,10,0,0
5950,427,149,467,262,52,15,3,40,113,0,10,0,0
5951,426,148,471,269,52,15,3,45,121,1,10,0,0
5952,430,150,476,271,52,15,3,46,121,2,10,0,0
5953,438,156,487,283,52,15,3,49,127,3,10,0,0
5954,428,155,474,276,52,15,3,46,121,4,10,0,0
5955,425,153,469,274,52,15,3,44,121,5,10,0,0
5956,424,152,471,282,52,15,3,47,130,6,10,0,0
5957,423,151,471,282,52,15,3,48,131,7,10,0,0
5958,429,153,470,267,52,15,3,41,114,8,10,0,0
5959,414,161,451,262,52,15,3,37,101,9,10,0,0
5960,413,160,449,261,52,15,3,36,101,10,10,0,0
5903,351,158,388,261,56,15,3,37,103,0,58,0,1
5904,350,156,389,263,56,15,3,39,107,1,58,0,0
5905,349,159,387,263,56,15,3,38,104,2,58,0,0
5906,347,147,389,263,56,15,3,42,116,3,58,0,0
5907,348,153,389,263,56,15,3,41,110,4,58,0,0
5908,350,155,390,266,56,15,3,40,111,5,58,0,0
5909,350,150,394,269,56,15,3,44,119,6,58,0,0
5910,351,146,398,275,56,15,3,47,129,7,58,0,0
5911,353,148,399,275,56,15,3,46,127,8,58,0,0
5912,354,157,397,277,56,15,3,43,120,9,58,0,0
5913,355,163,397,279,56,15,3,42,116,10,58,0,0
5914,355,163,399,283,56,15,3,44,120,11,58,0,0
5915,354,158,402,289,56,15,3,48,131,12,58,0,0
5916,354,156,402,290,56,15,3,48,134,13,58,0,0
5917,354,155,403,291,56,15,3,49,136,14,58,0,0
5918,354,151,406,295,56,15,3,52,144,15,58,0,0
5919,359,155,409,297,56,15,3,50,142,16,58,0,0
5920,363,157,413,301,56,15,3,50,144,17,58,0,0
5921,365,161,415,303,56,15,3,50,142,18,58,0,0
5922,367,162,416,303,56,15,3,49,141,19,58,0,0
5923,368,159,418,309,56,15,3,50,150,20,58,0,0
5924,370,165,419,311,56,15,3,49,146,21,58,0,0
5925,372,167,420,313,56,15,3,48,146,22,58,0,0
5926,370,162,422,321,56,15,3,52,159,23,58,0,0
5927,369,158,423,325,56,15,3,54,167,24,58,0,0
5928,371,167,422,328,56,15,3,51,161,25,58,0,0
5929,372,175,422,333,56,15,3,50,158,26,58,0,0
5930,373,169,426,337,56,15,3,53,168,27,58,0,0
5931,374,170,429,344,56,15,3,55,174,28,58,0,0
5932,375,180,428,350,56,15,3,53,170,29,58,0,0
5933,375,174,432,352,56,15,3,57,178,30,58,0,0
5934,377,178,434,357,56,15,3,57,179,31,58,0,0
5935,382,188,437,358,56,15,3,55,170,32,58,0,0
5936,386,164,448,361,56,15,3,62,197,33,58,0,0
5937,395,192,452,366,56,15,3,57,174,34,58,0,0
5938,401,202,456,368,56,15,3,55,166,35,58,0,0
5939,401,199,460,377,56,15,3,59,178,36,58,0,0
5940,405,198,469,389,56,15,3,64,191,37,58,0,0
5941,410,191,480,398,56,15,3,70,207,38,58,0,0
5942,415,188,487,401,56,15,3,72,213,39,58,0,0
5943,416,189,493,412,56,15,3,77,223,40,58,0,0
5944,424,193,499,412,56,15,3,75,219,41,58,0,0
5945,431,192,507,411,56,15,3,76,219,42,58,0,0
5946,439,204,514,419,56,15,3,75,215,43,58,0,0
5947,450,215,522,420,56,15,3,72,205,44,58,0,0
5948,454,204,532,418,56,15,3,78,214,45,58,0,0
5949,448,206,529,427,56,15,3,81,221,46,58,0,0
5950,443,212,522,432,56,15,3,79,220,47,58,0,0
5951,434,226,509,438,56,15,3,75,212,48,58,0,0
5952,418,221,497,444,56,15,3,79,223,49,58,0,0
5953,404,235,480,447,56,15,3,76,212,50,58,0,0
5954,380,237,462,451,56,15,3,82,214,51,58,0,0
5955,349,224,434,448,56,15,3,85,224,52,58,0,0
5956,326,237,406,448,56,15,3,80,211,53,58,0,0
5957,307,275,377,449,56,15,3,70,174,54,58,0,0
5958,277,276,344,445,56,15,3,67,169,55,58,0,0
5959,249,262,322,443,56,15,3,73,181,56,58,0,0
5960,235,264,301,434,56,15,3,66,170,57,58,0,0
5961,220,267,286,434,56,15,3,66,167,58,58,1,0
5956,373,154,409,278,62,15,3,36,124,0,1,0,0
5958,377,157,413,278,62,15,3,36,121,0,1,0,0
5959,380,162,415,274,62,15,3,35,112,1,1,0,0
5960,436,152,474,247,64,15,3,38,95,0,10,0,0
5961,435,153,477,256,64,15,3,42,103,1,10,0,0
5962,430,154,480,285,64,15,3,50,131,2,10,0,0
5963,426,153,482,303,64,15,3,56,150,3,10,0,0
5964,427,156,483,311,64,15,3,56,155,4,10,0,0
5965,428,158,483,316,64,15,3,55,158,5,10,0,0
5966,434,157,486,312,64,15,3,52,155,6,10,0,0
5967,433,157,487,322,64,15,3,54,165,7,10,0,0
5968,432,164,484,324,64,15,3,52,160,8,10,0,0
5969,432,167,483,327,64,15,3,51,160,9,10,0,0
5970,432,168,484,332,64,15,3,52,164,10,10,0,0
5996,380,185,443,392,64,15,3,63,207,0,10,0,0
5997,383,179,446,394,64,15,3,63,215,1,10,0,0
5998,389,177,449,385,64,15,3,60,208,2,10,0,0
5999,398,177,456,375,64,15,3,58,198,3,10,0,0
6000,399,176,456,374,64,15,3,57,198,4,10,0,0
5925,375,139,417,209,66,15,3,42,70,0,21,0,0
5926,375,139,419,214,66,15,3,44,75,1,21,0,0
5927,375,139,421,217,66,15,3,46,78,2,21,0,0
5931,378,140,427,224,66,15,3,49,84,0,21,0,1
5932,379,140,429,228,66,15,3,50,88,1,21,0,0
5933,379,142,430,233,66,15,3,51,91,2,21,0,0
5934,381,142,433,238,66,15,3,52,96,3,21,0,0
5935,384,142,438,244,66,15,3,54,102,4,21,0,0
5936,386,142,439,242,66,15,3,53,100,5,21,0,0
5937,386,146,437,246,66,15,3,51,100,6,21,0,0
5938,382,147,435,255,66,15,3,53,108,7,21,0,0
5939,381,151,433,259,66,15,3,52,108,8,21,0,0
5940,377,152,436,278,66,15,3,59,126,9,21,0,0
5941,378,152,438,283,66,15,3,60,131,10,21,0,0
5942,379,153,441,293,66,15,3,62,140,11,21,0,0
5943,386,152,438,270,66,15,3,52,118,12,21,0,0
5944,386,150,448,293,66,15,3,62,143,13,21,0,0
5945,396,153,445,268,66,15,3,49,115,14,21,0,0
5946,404,153,449,257,66,15,3,45,104,15,21,0,0
5947,392,154,436,259,66,15,3,44,105,16,21,0,0
5948,388,155,431,262,66,15,3,43,107,17,21,0,0
5949,387,153,431,267,66,15,3,44,114,18,21,0,0
5950,386,152,430,273,66,15,3,44,121,19,21,0,0
5951,386,153,427,269,66,15,3,41,116,20,21,0,0
5952,391,154,427,255,66,15,3,36,101,21,21,1,0
5954,400,155,435,260,66,15,3,35,105,0,21,0,0
5946,412,198,477,321,69,15,3,65,123,0,50,0,0
5947,392,156,476,316,69,15,3,84,160,1,50,0,0
5948,391,149,479,320,69,15,3,88,171,2,50,0,0
5949,393,145,483,321,69,15,3,90,176,3,50,0,0
5950,391,138,485,322,69,15,3,94,184,4,50,0,0
5955,437,161,517,322,69,15,3,80,161,0,50,0,1
5956,471,161,526,267,69,15,3,55,106,1,50,0,0
5957,465,167,545,327,69,15,3,80,160,2,50,0,0
5958,476,165,551,316,69,15,3,75,151,3,50,0,0
5959,476,164,559,340,69,15,3,83,176,4,50,0,0
5960,481,162,567,349,69,15,3,86,187,5,50,0,0
5961,485,163,571,354,69,15,3,86,191,6,50,0,0
5962,489,165,574,355,69,15,3,85,190,7,50,0,0
5963,488,165,571,357,69,15,3,83,192,8,50,0,0
5964,488,165,570,361,69,15,3,82,196,9,50,0,0
5965,486,167,566,364,69,15,3,80,197,10,50,0,0
5966,479,166,560,369,69,15,3,81,203,11,50,0,0
5967,470,166,552,374,69,15,3,82,208,12,50,0,0
5968,458,166,539,376,69,15,3,81,210,13,50,0,0
5969,449,167,527,373,69,15,3,78,206,14,50,0,0
5970,439,166,517,374,69,15,3,78,208,15,50,0,0
5971,435,164,515,379,69,15,3,80,215,16,50,0,0
5972,433,164,511,378,69,15,3,78,214,17,50,0,0
5973,432,166,508,377,69,15,3,76,211,18,50,0,0
5974,433,167,508,379,69,15,3,75,212,19,50,0,0
5975,434,167,506,375,69,15,3,72,208,20,50,0,0
5976,436,167,505,369,69,15,3,69,202,21,50,0,0
5977,436,169,505,373,69,15,3,69,204,22,50,0,0
5978,435,169,508,382,69,15,3,73,213,23,50,0,0
5979,433,170,506,386,69,15,3,73,216,24,50,0,0
5980,436,173,508,388,69,15,3,72,215,25,50,0,0
5981,438,173,514,397,69,15,3,76,224,26,50,0,0
5982,441,173,518,398,69,15,3,77,225,27,50,0,0
5983,444,173,523,401,69,15,3,79,228,28,50,0,0
5984,443,175,523,404,69,15,3,80,229,29,50,0,0
5985,442,176,522,404,69,15,3,80,228,30,50,0,0
5986,438,176,518,405,69,15,3,80,229,31,50,0,0
5987,437,180,516,406,69,15,3,79,226,32,50,0,0
5988,444,183,519,403,69,15,3,75,220,33,50,0,0
5989,446,186,518,399,69,15,3,72,213,34,50,0,0
5990,447,188,519,404,69,15,3,72,216,35,50,0,0
5991,447,186,520,403,69,15,3,73,217,36,50,0,0
5992,446,185,520,404,69,15,3,74,219,37,50,0,0
5993,443,187,518,407,69,15,3,75,220,38,50,0,0
5994,441,191,516,409,69,15,3,75,218,39,50,0,0
5995,438,194,513,413,69,15,3,75,219,40,50,0,0
5996,436,196,513,420,69,15,3,77,224,41,50,0,0
5997,433,197,511,424,69,15,3,78,227,42,50,0,0
5998,432,197,510,425,69,15,3,78,228,43,50,0,0
5999,427,198,504,423,69,15,3,77,225,44,50,0,0
6000,421,191,500,425,69,15,3,79,234,45,50,0,0
6001,416,186,497,430,69,15,3,81,244,46,50,0,0
6002,412,185,494,436,69,15,3,82,251,47,50,0,0
6003,410,194,486,435,69,15,3,76,241,48,50,0,0
6004,408,201,480,436,69,15,3,72,235,49,50,0,0
6005,410,204,480,436,69,15,3,70,232,50,50,1,0
5947,433,198,504,311,71,15,3,71,113,0,0,0,0
5951,479,204,541,392,72,15,3,62,188,0,14,0,0
5952,476,203,547,418,72,15,3,71,215,1,14,0,0
5953,470,208,540,420,72,15,3,70,212,2,14,0,0
5954,467,209,538,425,72,15,3,71,216,3,14,0,0
5958,457,191,530,414,72,15,3,73,223,0,14,0,0
5959,435,198,506,411,72,15,3,71,213,1,14,0,0
5960,418,197,493,422,72,15,3,75,225,2,14,0,0
5961,403,204,477,427,72,15,3,74,223,3,14,0,0
5962,379,198,456,433,72,15,3,77,235,4,14,0,0
5963,361,203,438,435,72,15,3,77,232,5,14,0,0
5964,341,202,418,435,72,15,3,77,233,6,14,0,0
5965,321,196,398,433,72,15,3,77,237,7,14,0,0
5966,308,211,381,434,72,15,3,73,223,8,14,0,0
5967,288,212,360,437,72,15,3,72,225,9,14,0,0
5968,275,216,346,435,72,15,3,71,219,10,14,0,0
5969,255,216,327,435,72,15,3,72,219,11,14,0,0
5970,237,211,308,434,72,15,3,71,223,12,14,0,0
5971,228,213,296,430,72,15,3,68,217,13,14,0,0
5972,213,213,281,430,72,15,3,68,217,14,14,0,0
5953,421,160,462,247,73,15,3,41,87,0,0,0,0
5954,451,156,500,276,74,15,3,49,120,0,0,0,0
5959,436,154,474,250,75,15,3,38,96,0,0,0,0
5963,402,167,442,295,76,15,3,40,128,0,42,0,1
5964,392,160,439,313,76,15,3,47,153,1,42,0,0
5965,391,160,442,322,76,15,3,51,162,2,42,0,0
5966,391,159,444,329,76,15,3,53,170,3,42,0,0
5967,389,162,444,337,76,15,3,55,175,4,42,0,0
5968,387,163,443,343,76,15,3,56,180,5,42,0,0
5969,388,165,445,348,76,15,3,57,183,6,42,0,0
5970,389,167,445,349,76,15,3,56,182,7,42,0,0
5971,390,168,448,353,76,15,3,58,185,8,42,0,0
5972,389,165,446,349,76,15,3,57,184,9,42,0,0
5973,387,169,446,358,76,15,3,59,189,10,42,0,0
5974,385,168,445,364,76,15,3,60,196,11,42,0,0
5975,387,169,445,365,76,15,3,58,196,12,42,0,0
5976,386,170,445,371,76,15,3,59,201,13,42,0,0
5977,383,174,444,383,76,15,3,61,209,14,42,0,0
5978,380,173,442,385,76,15,3,62,212,15,42,0,0
5979,379,174,438,379,76,15,3,59,205,16,42,0,0
5980,378,175,439,388,76,15,3,61,213,17,42,0,0
5981,376,174,439,394,76,15,3,63,220,18,42,0,0
5982,376,175,437,394,76,15,3,61,219,19,42,0,0
5983,376,176,436,391,76,15,3,60,215,20,42,0,0
5984,373,179,435,397,76,15,3,62,218,21,42,0,0
5985,370,180,433,400,76,15,3,63,220,22,42,0,0
5986,371,183,432,399,76,15,3,61,216,23,42,0,0
5987,361,182,427,410,76,15,3,66,228,24,42,0,0
5988,352,185,420,416,76,15,3,68,231,25,42,0,0
5989,361,182,431,420,76,15,3,70,238,26,42,0,0
5990,376,182,447,423,76,15,3,71,241,27,42,0,0
5991,376,182,451,438,76,15,3,75,256,28,42,0,0
5992,371,184,446,438,76,15,3,75,254,29,42,0,0
5993,367,184,432,402,76,15,3,65,218,30,42,0,0
5994,349,186,421,426,76,15,3,72,240,31,42,0,0
5995,352,179,427,428,76,15,3,75,249,32,42,0,0
5996,330,181,407,442,76,15,3,77,261,33,42,0,0
5997,322,183,400,450,76,15,3,78,267,34,42,0,0
5998,321,187,398,450,76,15,3,77,263,35,42,0,0
5999,330,185,405,443,76,15,3,75,258,36,42,0,0
6000,339,182,415,442,76,15,3,76,260,37,42,0,0
6001,346,181,422,438,76,15,3,76,257,38,42,0,0
6002,353,183,427,436,76,15,3,74,253,39,42,0,0
6003,355,178,432,442,76,15,3,77,264,40,42,0,0
6004,361,182,434,433,76,15,3,73,251,41,42,0,0
6005,367,184,439,437,76,15,3,72,253,42,42,1,0
5986,355,198,392,333,78,15,3,37,135,0,0,0,0
5988,421,176,483,421,79,15,3,62,245,0,1,0,0
5989,414,176,475,418,79,15,3,61,242,1,1,0,0
5989,327,194,379,409,80,15,3,52,215,0,12,0,0
5990,317,197,372,422,80,15,3,55,225,1,12,0,0
5991,313,198,370,429,80,15,3,57,231,2,12,0,0
5992,313,200,369,424,80,15,3,56,224,3,12,0,0
5993,305,201,360,418,80,15,3,55,217,4,12,0,0
5994,291,199,347,417,80,15,3,56,218,5,12,0,0
5995,286,200,343,424,80,15,3,57,224,6,12,0,0
5996,279,200,337,428,80,15,3,58,228,7,12,0,0
5997,273,199,331,427,80,15,3,58,228,8,12,0,0
5998,272,199,330,428,80,15,3,58,229,9,12,0,0
5999,276,200,335,430,80,15,3,59,230,10,12,0,0
6000,281,203,341,432,80,15,3,60,229,11,12,0,0
6001,279,204,338,433,80,15,3,59,229,12,12,0,0
5994,406,193,446,325,81,15,3,40,132,0,0,0,0
6002,455,179,490,261,82,15,3,35,82,0,0,0,0
6003,464,181,511,371,83,15,3,47,190,0,2,0,0
6004,460,179,510,379,83,15,3,50,200,1,2,0,0
6005,466,177,515,374,83,15,3,49,197,2,2,0,0
306,1574,152,1609,245,2,15,4,35,93,0,75,0,0
307,1573,152,1608,246,2,15,4,35,94,1,75,0,0
310,1572,157,1609,250,2,15,4,37,93,0,75,0,1
311,1570,156,1608,252,2,15,4,38,96,1,75,0,0
312,1570,153,1610,256,2,15,4,40,103,2,75,0,0
313,1569,154,1611,257,2,15,4,42,103,3,75,0,0
314,1568,155,1610,257,2,15,4,42,102,4,75,0,0
315,1568,154,1613,262,2,15,4,45,108,5,75,0,0
316,1567,154,1613,264,2,15,4,46,110,6,75,0,0
317,1565,152,1612,266,2,15,4,47,114,7,75,0,0
318,1566,152,1614,269,2,15,4,48,117,8,75,0,0
319,1563,156,1610,267,2,15,4,47,111,9,75,0,0
320,1562,154,1611,271,2,15,4,49,117,10,75,0,0
321,1559,151,1611,274,2,15,4,52,123,11,75,0,0
322,1556,148,1611,278,2,15,4,55,130,12,75,0,0
323,1553,151,1609,283,2,15,4,56,132,13,75,0,0
324,1551,153,1607,283,2,15,4,56,130,14,75,0,0
325,1550,155,1608,288,2,15,4,58,133,15,75,0,0
326,1548,166,1604,292,2,15,4,56,126,16,75,0,0
327,1546,168,1602,294,2,15,4,56,126,17,75,0,0
328,1543,177,1598,300,2,15,4,55,123,18,75,0,0
329,1540,180,1594,301,2,15,4,54,121,19,75,0,0
330,1542,181,1597,303,2,15,4,55,122,20,75,0,0
331,1541,181,1597,308,2,15,4,56,127,21,75,0,0
332,1538,178,1597,310,2,15,4,59,132,22,75,0,0
333,1534,178,1596,318,2,15,4,62,140,23,75,0,0
334,1532,181,1594,321,2,15,4,62,140,24,75,0,0
335,1530,180,1593,326,2,15,4,63,146,25,75,0,0
336,1528,184,1592,331,2,15,4,64,147,26,75,0,0
337,1525,183,1591,333,2,15,4,66,150,27,75,0,0
338,1521,184,1589,340,2,15,4,68,156,28,75,0,0
339,1520,185,1589,346,2,15,4,69,161,29,75,0,0
340,1520,184,1591,350,2,15,4,71,166,30,75,0,0
341,1516,183,1590,356,2,15,4,74,173,31,75,0,0
342,1513,182,1589,360,2,15,4,76,178,32,75,0,0
343,1510,188,1588,371,2,15,4,78,183,33,75,0,0
344,1506,192,1585,376,2,15,4,79,184,34,75,0,0
345,1507,196,1586,380,2,15,4,79,184,35,75,0,0
346,1508,200,1587,386,2,15,4,79,186,36,75,0,0
347,1503,201,1585,391,2,15,4,82,190,37,75,0,0
348,1498,201,1583,399,2,15,4,85,198,38,75,0,0
349,1491,197,1582,409,2,15,4,91,212,39,75,0,0
350,1486,194,1582,415,2,15,4,96,221,40,75,0,0
351,1480,197,1579,422,2,15,4,99,225,41,75,0,0
352,1474,207,1570,425,2,15,4,96,218,42,75,0,0
353,1462,211,1561,431,2,15,4,99,220,43,75,0,0
354,1454,216,1560,449,2,15,4,106,233,44,75,0,0
355,1449,215,1560,459,2,15,4,111,244,45,75,0,0
356,1445,222,1558,469,2,15,4,113,247,46,75,0,0
357,1437,226,1553,478,2,15,4,116,252,47,75,0,0
358,1428,226,1549,491,2,15,4,121,265,48,75,0,0
359,1418,231,1547,514,2,15,4,129,283,49,75,0,0
360,1414,234,1546,523,2,15,4,132,289,50,75,0,0
361,1405,240,1540,535,2,15,4,135,295,51,75,0,0
362,1397,249,1535,550,2,15,4,138,301,52,75,0,0
363,1380,251,1525,566,2,15,4,145,315,53,75,0,0
364,1366,256,1524,595,2,15,4,158,339,54,75,0,0
365,1357,258,1521,610,2,15,4,164,352,55,75,0,0
366,1344,270,1511,626,2,15,4,167,356,56,75,0,0
367,1329,283,1503,652,2,15,4,174,369,57,75,0,0
368,1308,286,1488,669,2,15,4,180,383,58,75,0,0
369,1284,297,1477,709,2,15,4,193,412,59,75,0,0
370,1270,307,1471,736,2,15,4,201,429,60,75,0,0
371,1252,317,1461,762,2,15,4,209,445,61,75,0,0
372,1230,340,1448,801,2,15,4,218,461,62,75,0,0
373,1208,351,1431,823,2,15,4,223,472,63,75,0,0
374,1176,370,1418,883,2,15,4,242,513,64,75,0,0
375,1151,397,1402,925,2,15,4,251,528,65,75,0,0
376,1124,414,1387,963,2,15,4,263,549,66,75,0,0
377,1078,436,1364,1032,2,15,4,286,596,67,75,0,0
378,1034,456,1326,1062,2,15,4,292,606,68,75,0,0
379,995,494,1284,1079,2,15,4,289,585,69,75,0,0
380,955,530,1236,1080,2,15,4,281,550,70,75,0,0
381,907,565,1186,1080,2,15,4,279,515,71,75,0,0
382,848,624,1115,1080,2,15,4,267,456,72,75,0,0
383,782,681,1035,1080,2,15,4,253,399,73,75,0,0
384,737,762,957,1077,2,15,4,220,315,74,75,0,0
385,706,796,912,1080,2,15,4,206,284,75,75,1,0
404,1470,581,1920,1068,8,15,4,450,487,0,6,0,0
405,1468,549,1920,1064,8,15,4,452,515,1,6,0,0
406,1495,541,1920,1052,8,15,4,425,511,2,6,0,0
407,1518,545,1920,1050,8,15,4,402,505,3,6,0,0
408,1522,552,1920,1061,8,15,4,398,509,4,6,0,0
409,1561,567,1920,1020,8,15,4,359,453,5,6,0,0
410,1560,538,1920,1015,8,15,4,360,477,6,6,0,0
432,1607,576,1915,1076,9,15,4,308,500,0,15,0,0
433,1576,544,1896,1062,9,15,4,320,518,1,15,0,0
434,1546,534,1872,1061,9,15,4,326,527,2,15,0,0
435,1519,537,1842,1063,9,15,4,323,526,3,15,0,0
436,1500,542,1813,1060,9,15,4,313,518,4,15,0,0
437,1439,550,1745,1064,9,15,4,306,514,5,15,0,0
438,1376,539,1679,1055,9,15,4,303,516,6,15,0,0
439,1285,539,1595,1061,9,15,4,310,522,7,15,0,0
440,1182,561,1494,1071,9,15,4,312,510,8,15,0,0
441,1113,590,1417,1077,9,15,4,304,487,9,15,0,0
442,1059,621,1348,1079,9,15,4,289,458,10,15,0,0
443,974,669,1242,1080,9,15,4,268,411,11,15,0,0
444,845,706,1102,1080,9,15,4,257,374,12,15,0,0
445,719,752,962,1077,9,15,4,243,325,13,15,0,0
446,601,832,810,1078,9,15,4,209,246,14,15,0,0
447,521,866,702,1079,9,15,4,181,213,15,15,0,0
886,1676,708,1916,1080,20,15,4,240,372,0,0,0,0
1599,1779,733,1919,1072,28,15,4,140,339,0,7,0,0
1600,1723,613,1915,1075,28,15,4,192,462,1,7,0,0
1601,1675,582,1880,1070,28,15,4,205,488,2,7,0,0
1602,1634,605,1838,1074,28,15,4,204,469,3,7,0,0
1603,1618,655,1808,1073,28,15,4,190,418,4,7,0,0
1604,1599,707,1778,1076,28,15,4,179,369,5,7,0,0
1605,1537,775,1694,1075,28,15,4,157,300,6,7,0,0
1606,1508,797,1654,1075,28,15,4,146,278,7,7,0,0
2620,543,709,868,1076,45,15,4,325,367,0,66,0,1
2621,636,653,1009,1076,45,15,4,373,423,1,66,0,0
2622,734,592,1157,1077,45,15,4,423,485,2,66,0,0
2623,820,558,1265,1074,45,15,4,445,516,3,66,0,0
2624,887,504,1368,1075,45,15,4,481,571,4,66,0,0
2625,946,468,1444,1074,45,15,4,498,606,5,66,0,0
2626,1002,445,1495,1066,45,15,4,493,621,6,66,0,0
2627,1083,412,1531,997,45,15,4,448,585,7,66,0,0
2628,1133,386,1562,965,45,15,4,429,579,8,66,0,0
2629,1188,362,1570,895,45,15,4,382,533,9,66,0,0
2630,1234,351,1575,844,45,15,4,341,493,10,66,0,0
2631,1268,335,1587,813,45,15,4,319,478,11,66,0,0
2632,1306,314,1594,764,45,15,4,288,450,12,66,0,0
2633,1323,305,1596,744,45,15,4,273,439,13,66,0,0
2634,1352,292,1594,695,45,15,4,242,403,14,66,0,0
2635,1363,281,1587,668,45,15,4,224,387,15,66,0,0
2636,1377,272,1586,646,45,15,4,209,374,16,66,0,0
2637,1391,261,1583,614,45,15,4,192,353,17,66,0,0
2638,1397,255,1581,603,45,15,4,184,348,18,66,0,0
2639,1402,246,1571,571,45,15,4,169,325,19,66,0,0
2640,1406,241,1564,554,45,15,4,158,313,20,66,0,0
2641,1416,238,1561,534,45,15,4,145,296,21,66,0,0
2642,1424,228,1562,515,45,15,4,138,287,22,66,0,0
2643,1431,228,1562,510,45,15,4,131,282,23,66,0,0
2644,1434,222,1555,484,45,15,4,121,262,24,66,0,0
2645,1443,219,1557,472,45,15,4,114,253,25,66,0,0
2646,1452,213,1562,461,45,15,4,110,248,26,66,0,0
2647,1459,204,1565,449,45,15,4,106,245,27,66,0,0
2648,1464,204,1568,444,45,15,4,104,240,28,66,0,0
2649,1463,198,1562,431,45,15,4,99,233,29,66,0,0
2650,1465,198,1560,425,45,15,4,95,227,30,66,0,0
2651,1470,198,1561,419,45,15,4,91,221,31,66,0,0
2652,1477,197,1562,406,45,15,4,85,209,32,66,0,0
2653,1483,198,1564,402,45,15,4,81,204,33,66,0,0
2654,1489,195,1565,391,45,15,4,76,196,34,66,0,0
2655,1492,195,1565,387,45,15,4,73,192,35,66,0,0
2656,1495,187,1568,381,45,15,4,73,194,36,66,0,0
2657,1499,182,1569,373,45,15,4,70,191,37,66,0,0
2658,1503,182,1571,368,45,15,4,68,186,38,66,0,0
2659,1508,180,1574,361,45,15,4,66,181,39,66,0,0
2660,1513,180,1575,354,45,15,4,62,174,40,66,0,0
2661,1519,182,1577,347,45,15,4,58,165,41,66,0,0
2662,1525,183,1580,340,45,15,4,55,157,42,66,0,0
2663,1529,184,1583,338,45,15,4,54,154,43,66,0,0
2664,1532,181,1584,330,45,15,4,52,149,44,66,0,0
2665,1534,180,1585,326,45,15,4,51,146,45,66,0,0
2666,1536,180,1587,324,45,15,4,51,144,46,66,0,0
2667,1541,178,1590,318,45,15,4,49,140,47,66,0,0
2668,1545,177,1592,312,45,15,4,47,135,48,66,0,0
2669,1547,178,1591,304,45,15,4,44,126,49,66,0,0
2670,1551,177,1593,298,45,15,4,42,121,50,66,0,0
2671,1557,181,1597,300,45,15,4,40,119,51,66,0,0
2672,1560,178,1601,297,45,15,4,41,119,52,66,0,0
2673,1564,178,1603,292,45,15,4,39,114,53,66,0,0
2674,1565,176,1604,291,45,15,4,39,115,54,66,0,0
2675,1565,168,1606,289,45,15,4,41,121,55,66,0,0
2676,1567,170,1606,287,45,15,4,39,117,56,66,0,0
2677,1569,167,1607,283,45,15,4,38,116,57,66,0,0
2678,1570,166,1608,279,45,15,4,38,113,58,66,0,0
2679,1571,162,1609,275,45,15,4,38,113,59,66,0,0
2680,1571,159,1609,273,45,15,4,38,114,60,66,0,0
2681,1572,155,1611,272,45,15,4,39,117,61,66,0,0
2682,1574,154,1613,270,45,15,4,39,116,62,66,0,0
2683,1578,158,1615,269,45,15,4,37,111,63,66,0,0
2684,1582,154,1617,264,45,15,4,35,110,64,66,0,0
2685,1582,156,1617,265,45,15,4,35,109,65,66,0,0
2686,1584,155,1619,264,45,15,4,35,109,66,66,1,0
3034,1410,491,1647,996,52,15,4,237,505,0,92,0,1
3035,1414,466,1656,983,52,15,4,242,517,1,92,0,0
3036,1416,450,1665,985,52,15,4,249,535,2,92,0,0
3037,1430,423,1655,908,52,15,4,225,485,3,92,0,0
3038,1430,413,1643,874,52,15,4,213,461,4,92,0,0
3039,1454,397,1656,832,52,15,4,202,435,5,92,0,0
3040,1457,379,1653,803,52,15,4,196,424,6,92,0,0
3041,1465,376,1655,793,52,15,4,190,417,7,92,0,0
3042,1467,357,1644,747,52,15,4,177,390,8,92,0,0
3043,1470,346,1642,728,52,15,4,172,382,9,92,0,0
3044,1482,341,1652,717,52,15,4,170,376,10,92,0,0
3045,1491,331,1651,687,52,15,4,160,356,11,92,0,0
3046,1496,323,1651,670,52,15,4,155,347,12,92,0,0
3047,1498,311,1642,635,52,15,4,144,324,13,92,0,0
3048,1506,302,1647,620,52,15,4,141,318,14,92,0,0
3049,1514,302,1652,610,52,15,4,138,308,15,92,0,0
3050,1521,291,1654,585,52,15,4,133,294,16,92,0,0
3051,1525,285,1656,580,52,15,4,131,295,17,92,0,0
3052,1527,281,1654,566,52,15,4,127,285,18,92,0,0
3053,1531,274,1655,553,52,15,4,124,279,19,92,0,0
3054,1535,270,1657,544,52,15,4,122,274,20,92,0,0
3055,1542,261,1659,524,52,15,4,117,263,21,92,0,0
3056,1546,260,1662,517,52,15,4,116,257,22,92,0,0
3057,1545,259,1658,513,52,15,4,113,254,23,92,0,0
3058,1547,254,1654,494,52,15,4,107,240,24,92,0,0
3059,1553,252,1657,485,52,15,4,104,233,25,92,0,0
3060,1565,248,1665,475,52,15,4,100,227,26,92,0,0
3061,1573,244,1673,470,52,15,4,100,226,27,92,0,0
3062,1575,241,1674,465,52,15,4,99,224,28,92,0,0
3063,1577,236,1672,452,52,15,4,95,216,29,92,0,0
3064,1581,234,1673,445,52,15,4,92,211,30,92,0,0
3065,1584,231,1674,436,52,15,4,90,205,31,92,0,0
3066,1587,230,1675,431,52,15,4,88,201,32,92,0,0
3067,1588,232,1672,425,52,15,4,84,193,33,92,0,0
3068,1591,227,1674,418,52,15,4,83,191,34,92,0,0
3069,1593,225,1676,415,52,15,4,83,190,35,92,0,0
3070,1598,224,1680,412,52,15,4,82,188,36,92,0,0
3071,1601,216,1681,400,52,15,4,80,184,37,92,0,0
3072,1602,214,1680,395,52,15,4,78,181,38,92,0,0
3073,1603,210,1678,388,52,15,4,75,178,39,92,0,0
3074,1604,207,1679,385,52,15,4,75,178,40,92,0,0
3075,1607,209,1679,383,52,15,4,72,174,41,92,0,0
3076,1610,207,1680,376,52,15,4,70,169,42,92,0,0
3077,1612,207,1677,365,52,15,4,65,158,43,92,0,0
3078,1609,204,1673,361,52,15,4,64,157,44,92,0,0
3079,1607,202,1672,358,52,15,4,65,156,45,92,0,0
3080,1608,202,1671,356,52,15,4,63,154,46,92,0,0
3081,1609,198,1671,349,52,15,4,62,151,47,92,0,0
3082,1608,196,1668,345,52,15,4,60,149,48,92,0,0
3083,1604,193,1665,344,52,15,4,61,151,49,92,0,0
3084,1604,190,1665,339,52,15,4,61,149,50,92,0,0
3085,1605,190,1664,336,52,15,4,59,146,51,92,0,0
3086,1607,187,1666,331,52,15,4,59,144,52,92,0,0
3087,1607,185,1665,329,52,15,4,58,144,53,92,0,0
3088,1604,186,1661,328,52,15,4,57,142,54,92,0,0
3089,1603,183,1659,321,52,15,4,56,138,55,92,0,0
3090,1604,183,1659,317,52,15,4,55,134,56,92,0,0
3091,1606,181,1662,315,52,15,4,56,134,57,92,0,0
3092,1606,179,1661,314,52,15,4,55,135,58,92,0,0
3093,1606,180,1660,311,52,15,4,54,131,59,92,0,0
3094,1606,179,1659,307,52,15,4,53,128,60,92,0,0
3095,1608,179,1660,303,52,15,4,52,124,61,92,0,0
3096,1611,179,1662,301,52,15,4,51,122,62,92,0,0
3097,1615,178,1665,299,52,15,4,50,121,63,92,0,0
3098,1616,177,1665,297,52,15,4,49,120,64,92,0,0
3099,1616,175,1665,296,52,15,4,49,121,65,92,0,0
3100,1617,176,1665,293,52,15,4,48,117,66,92,0,0
3101,1619,179,1665,292,52,15,4,46,113,67,92,0,0
3102,1620,178,1665,290,52,15,4,45,112,68,92,0,0
3103,1621,177,1665,287,52,15,4,44,110,69,92,0,0
3104,1620,172,1664,283,52,15,4,44,111,70,92,0,0
3105,1620,171,1664,282,52,15,4,44,111,71,92,0,0
3106,1623,171,1666,281,52,15,4,43,110,72,92,0,0
3107,1623,168,1666,278,52,15,4,43,110,73,92,0,0
3108,1623,167,1666,277,52,15,4,43,110,74,92,0,0
3109,1623,168,1665,274,52,15,4,42,106,75,92,0,0
3110,1623,167,1664,272,52,15,4,41,105,76,92,0,0
3111,1624,168,1664,270,52,15,4,40,102,77,92,0,0
3112,1623,162,1664,267,52,15,4,41,105,78,92,0,0
3113,1623,159,1664,265,52,15,4,41,106,79,92,0,0
3114,1622,157,1662,260,52,15,4,40,103,80,92,0,0
3115,1622,157,1662,260,52,15,4,40,103,81,92,0,0
3116,1622,161,1661,259,52,15,4,39,98,82,92,0,0
3117,1621,158,1661,259,52,15,4,40,101,83,92,0,0
3118,1620,157,1660,259,52,15,4,40,102,84,92,0,0
3119,1620,156,1660,256,52,15,4,40,100,85,92,0,0
3120,1619,155,1658,254,52,15,4,39,99,86,92,0,0
3121,1621,160,1658,251,52,15,4,37,91,87,92,0,0
3122,1621,156,1658,248,52,15,4,37,92,88,92,0,0
3123,1623,155,1659,247,52,15,4,36,92,89,92,0,0
3124,1622,152,1659,245,52,15,4,37,93,90,92,0,0
3125,1622,152,1658,244,52,15,4,36,92,91,92,0,0
3126,1622,151,1658,242,52,15,4,36,91,92,92,1,0
3131,1624,148,1659,239,52,15,4,35,91,0,92,0,0
4682,1590,145,1625,237,60,15,4,35,92,0,98,0,1
4683,1589,146,1625,239,60,15,4,36,93,1,98,0,0
4684,1589,145,1625,242,60,15,4,36,97,2,98,0,0
4685,1589,146,1625,241,60,15,4,36,95,3,98,0,0
4686,1588,148,1624,243,60,15,4,36,95,4,98,0,0
4687,1587,148,1624,246,60,15,4,37,98,5,98,0,0
4688,1585,146,1623,248,60,15,4,38,102,6,98,0,0
4689,1585,149,1622,249,60,15,4,37,100,7,98,0,0
4690,1586,150,1622,250,60,15,4,36,100,8,98,0,0
4691,1585,149,1621,250,60,15,4,36,101,9,98,0,0
4692,1583,150,1620,252,60,15,4,37,102,10,98,0,0
4693,1582,152,1619,254,60,15,4,37,102,11,98,0,0
4694,1582,152,1619,256,60,15,4,37,104,12,98,0,0
4695,1583,153,1620,256,60,15,4,37,103,13,98,0,0
4696,1583,153,1621,260,60,15,4,38,107,14,98,0,0
4697,1582,157,1620,261,60,15,4,38,104,15,98,0,0
4698,1580,154,1619,261,60,15,4,39,107,16,98,0,0
4699,1579,155,1619,266,60,15,4,40,111,17,98,0,0
4700,1579,159,1619,267,60,15,4,40,108,18,98,0,0
4701,1579,159,1619,269,60,15,4,40,110,19,98,0,0
4702,1577,159,1618,270,60,15,4,41,111,20,98,0,0
4703,1575,163,1616,271,60,15,4,41,108,21,98,0,0
4704,1574,164,1615,274,60,15,4,41,110,22,98,0,0
4705,1573,165,1615,277,60,15,4,42,112,23,98,0,0
4706,1572,163,1616,279,60,15,4,44,116,24,98,0,0
4707,1570,162,1616,281,60,15,4,46,119,25,98,0,0
4708,1569,165,1614,285,60,15,4,45,120,26,98,0,0
4709,1566,170,1610,286,60,15,4,44,116,27,98,0,0
4710,1562,171,1606,287,60,15,4,44,116,28,98,0,0
4711,1560,174,1604,289,60,15,4,44,115,29,98,0,0
4712,1559,173,1604,292,60,15,4,45,119,30,98,0,0
4713,1557,176,1603,294,60,15,4,46,118,31,98,0,0
4714,1553,177,1600,298,60,15,4,47,121,32,98,0,0
4715,1550,177,1598,301,60,15,4,48,124,33,98,0,0
4716,1548,177,1597,303,60,15,4,49,126,34,98,0,0
4717,1547,177,1598,309,60,15,4,51,132,35,98,0,0
4718,1546,176,1598,309,60,15,4,52,133,36,98,0,0
4719,1545,177,1598,315,60,15,4,53,138,37,98,0,0
4720,1542,178,1597,319,60,15,4,55,141,38,98,0,0
4721,1540,180,1596,322,60,15,4,56,142,39,98,0,0
4722,1539,181,1596,326,60,15,4,57,145,40,98,0,0
4723,1541,184,1598,328,60,15,4,57,144,41,98,0,0
4724,1542,184,1600,330,60,15,4,58,146,42,98,0,0
4725,1537,185,1598,337,60,15,4,61,152,43,98,0,0
4726,1533,184,1596,339,60,15,4,63,155,44,98,0,0
4727,1531,185,1595,344,60,15,4,64,159,45,98,0,0
4728,1530,188,1594,349,60,15,4,64,161,46,98,0,0
4729,1534,189,1599,354,60,15,4,65,165,47,98,0,0
4730,1533,193,1599,359,60,15,4,66,166,48,98,0,0
4731,1531,194,1598,364,60,15,4,67,170,49,98,0,0
4732,1529,193,1598,367,60,15,4,69,174,50,98,0,0
4733,1529,199,1598,375,60,15,4,69,176,51,98,0,0
4734,1531,201,1601,379,60,15,4,70,178,52,98,0,0
4735,1530,202,1602,386,60,15,4,72,184,53,98,0,0
4736,1527,203,1600,393,60,15,4,73,190,54,98,0,0
4737,1523,204,1598,397,60,15,4,75,193,55,98,0,0
4738,1519,204,1596,405,60,15,4,77,201,56,98,0,0
4739,1518,206,1596,413,60,15,4,78,207,57,98,0,0
4740,1518,208,1596,416,60,15,4,78,208,58,98,0,0
4741,1514,213,1594,426,60,15,4,80,213,59,98,0,0
4742,1508,215,1590,433,60,15,4,82,218,60,98,0,0
4743,1504,214,1588,440,60,15,4,84,226,61,98,0,0
4744,1501,219,1587,449,60,15,4,86,230,62,98,0,0
4745,1502,222,1588,457,60,15,4,86,235,63,98,0,0
4746,1498,224,1587,464,60,15,4,89,240,64,98,0,0
4747,1492,230,1583,474,60,15,4,91,244,65,98,0,0
4748,1484,230,1577,479,60,15,4,93,249,66,98,0,0
4749,1478,235,1575,490,60,15,4,97,255,67,98,0,0
4750,1476,239,1575,501,60,15,4,99,262,68,98,0,0
4751,1473,240,1576,509,60,15,4,103,269,69,98,0,0
4752,1463,247,1569,525,60,15,4,106,278,70,98,0,0
4753,1455,252,1563,537,60,15,4,108,285,71,98,0,0
4754,1445,254,1558,549,60,15,4,113,295,72,98,0,0
4755,1436,260,1553,565,60,15,4,117,305,73,98,0,0
4756,1432,262,1554,581,60,15,4,122,319,74,98,0,0
4757,1423,267,1549,596,60,15,4,126,329,75,98,0,0
4758,1412,278,1541,613,60,15,4,129,335,76,98,0,0
4759,1404,286,1533,624,60,15,4,129,338,77,98,0,0
4760,1392,291,1527,643,60,15,4,135,352,78,98,0,0
4761,1384,302,1524,666,60,15,4,140,364,79,98,0,0
4762,1380,309,1523,679,60,15,4,143,370,80,98,0,0
4763,1364,322,1513,708,60,15,4,149,386,81,98,0,0
4764,1347,330,1500,729,60,15,4,153,399,82,98,0,0
4765,1332,334,1494,755,60,15,4,162,421,83,98,0,0
4766,1314,351,1486,797,60,15,4,172,446,84,98,0,0
4767,1309,362,1486,823,60,15,4,177,461,85,98,0,0
4768,1290,378,1473,853,60,15,4,183,475,86,98,0,0
4769,1267,395,1457,892,60,15,4,190,497,87,98,0,0
4770,1239,417,1433,918,60,15,4,194,501,88,98,0,0
4771,1208,441,1417,980,60,15,4,209,539,89,98,0,0
4772,1188,465,1411,1032,60,15,4,223,567,90,98,0,0
4773,1167,479,1393,1052,60,15,4,226,573,91,98,0,0
4774,1134,517,1357,1075,60,15,4,223,558,92,98,0,0
4775,1092,547,1309,1080,60,15,4,217,533,93,98,0,0
4776,1047,580,1263,1080,60,15,4,216,500,94,98,0,0
4777,1003,630,1214,1080,60,15,4,211,450,95,98,0,0
4778,975,682,1179,1080,60,15,4,204,398,96,98,0,0
4779,924,740,1109,1080,60,15,4,185,340,97,98,0,0
4780,899,769,1076,1080,60,15,4,177,311,98,98,1,0
4701,1624,160,1659,271,62,15,4,35,111,0,81,0,1
4702,1623,160,1659,274,62,15,4,36,114,1,81,0,0
4703,1623,164,1658,274,62,15,4,35,110,2,81,0,0
4704,1622,165,1658,276,62,15,4,36,111,3,81,0,0
4705,1621,163,1660,284,62,15,4,39,121,4,81,0,0
4706,1622,167,1659,283,62,15,4,37,116,5,81,0,0
4707,1620,167,1657,286,62,15,4,37,119,6,81,0,0
4708,1618,170,1656,289,62,15,4,38,119,7,81,0,0
4709,1616,174,1652,290,62,15,4,36,116,8,81,0,0
4710,1615,174,1651,291,62,15,4,36,117,9,81,0,0
4711,1612,159,1655,295,62,15,4,43,136,10,81,0,0
4712,1612,157,1655,298,62,15,4,43,141,11,81,0,0
4713,1609,160,1652,300,62,15,4,43,140,12,81,0,0
4714,1606,159,1650,303,62,15,4,44,144,13,81,0,0
4715,1605,153,1651,305,62,15,4,46,152,14,81,0,0
4716,1605,159,1650,308,62,15,4,45,149,15,81,0,0
4717,1605,163,1650,310,62,15,4,45,147,16,81,0,0
4718,1605,165,1649,309,62,15,4,44,144,17,81,0,0
4719,1603,166,1649,318,62,15,4,46,152,18,81,0,0
4720,1601,164,1648,319,62,15,4,47,155,19,81,0,0
4721,1602,168,1648,323,62,15,4,46,155,20,81,0,0
4722,1603,170,1651,329,62,15,4,48,159,21,81,0,0
4723,1604,173,1652,333,62,15,4,48,160,22,81,0,0
4724,1604,170,1654,336,62,15,4,50,166,23,81,0,0
4725,1604,176,1653,337,62,15,4,49,161,24,81,0,0
4726,1604,175,1654,341,62,15,4,50,166,25,81,0,0
4727,1603,176,1654,348,62,15,4,51,172,26,81,0,0
4728,1603,177,1656,355,62,15,4,53,178,27,81,0,0
4729,1605,177,1658,357,62,15,4,53,180,28,81,0,0
4730,1603,179,1656,362,62,15,4,53,183,29,81,0,0
4731,1601,180,1654,364,62,15,4,53,184,30,81,0,0
4732,1600,179,1654,369,62,15,4,54,190,31,81,0,0
4733,1601,181,1656,373,62,15,4,55,192,32,81,0,0
4734,1604,181,1659,377,62,15,4,55,196,33,81,0,0
4735,1604,185,1661,384,62,15,4,57,199,34,81,0,0
4736,1602,186,1660,391,62,15,4,58,205,35,81,0,0
4737,1600,183,1660,396,62,15,4,60,213,36,81,0,0
4738,1598,186,1659,402,62,15,4,61,216,37,81,0,0
4739,1602,191,1665,411,62,15,4,63,220,38,81,0,0
4740,1603,192,1666,415,62,15,4,63,223,39,81,0,0
4741,1600,194,1666,425,62,15,4,66,231,40,81,0,0
4742,1596,195,1664,431,62,15,4,68,236,41,81,0,0
4743,1596,196,1665,437,62,15,4,69,241,42,81,0,0
4744,1594,201,1663,444,62,15,4,69,243,43,81,0,0
4745,1595,203,1666,449,62,15,4,71,246,44,81,0,0
4746,1592,209,1664,459,62,15,4,72,250,45,81,0,0
4747,1587,211,1661,467,62,15,4,74,256,46,81,0,0
4748,1583,215,1659,476,62,15,4,76,261,47,81,0,0
4749,1580,221,1658,490,62,15,4,78,269,48,81,0,0
4750,1580,223,1660,498,62,15,4,80,275,49,81,0,0
4751,1577,223,1660,507,62,15,4,83,284,50,81,0,0
4752,1572,228,1658,520,62,15,4,86,292,51,81,0,0
4753,1567,231,1653,526,62,15,4,86,295,52,81,0,0
4754,1561,234,1652,544,62,15,4,91,310,53,81,0,0
4755,1557,242,1651,564,62,15,4,94,322,54,81,0,0
4756,1553,243,1651,575,62,15,4,98,332,55,81,0,0
4757,1549,246,1650,588,62,15,4,101,342,56,81,0,0
4758,1543,253,1646,603,62,15,4,103,350,57,81,0,0
4759,1536,253,1642,615,62,15,4,106,362,58,81,0,0
4760,1533,260,1646,642,62,15,4,113,382,59,81,0,0
4761,1531,268,1647,663,62,15,4,116,395,60,81,0,0
4762,1527,280,1646,679,62,15,4,119,399,61,81,0,0
4763,1519,288,1644,706,62,15,4,125,418,62,81,0,0
4764,1511,291,1640,721,62,15,4,129,430,63,81,0,0
4765,1502,296,1642,762,62,15,4,140,466,64,81,0,0
4766,1499,311,1645,797,62,15,4,146,486,65,81,0,0
4767,1494,318,1644,814,62,15,4,150,496,66,81,0,0
4768,1484,329,1644,856,62,15,4,160,527,67,81,0,0
4769,1472,350,1639,896,62,15,4,167,546,68,81,0,0
4770,1462,358,1637,929,62,15,4,175,571,69,81,0,0
4771,1454,384,1639,987,62,15,4,185,603,70,81,0,0
4772,1446,404,1639,1026,62,15,4,193,622,71,81,0,0
4773,1426,421,1630,1060,62,15,4,204,639,72,81,0,0
4774,1412,451,1614,1067,62,15,4,202,616,73,81,0,0
4775,1396,470,1601,1074,62,15,4,205,604,74,81,0,0
4776,1375,500,1579,1077,62,15,4,204,577,75,81,0,0
4777,1353,549,1553,1072,62,15,4,200,523,76,81,0,0
4778,1337,604,1536,1076,62,15,4,199,472,77,81,0,0
4779,1319,680,1507,1074,62,15,4,188,394,78,81,0,0
4780,1276,759,1449,1075,62,15,4,173,316,79,81,0,0
4781,1233,841,1371,1075,62,15,4,138,234,80,81,0,0
4782,1217,887,1334,1080,62,15,4,117,193,81,81,1,0
5878,1618,144,1653,240,71,15,4,35,96,0,90,0,0
5880,1614,147,1649,242,71,15,4,35,95,0,90,0,1
5881,1615,149,1650,245,71,15,4,35,96,1,90,0,0
5882,1617,150,1653,246,71,15,4,36,96,2,90,0,0
5883,1619,149,1654,247,71,15,4,35,98,3,90,0,0
5884,1620,148,1657,248,71,15,4,37,100,4,90,0,0
5885,1621,149,1658,249,71,15,4,37,100,5,90,0,0
5886,1620,145,1658,252,71,15,4,38,107,6,90,0,0
5887,1620,145,1659,255,71,15,4,39,110,7,90,0,0
5888,1620,145,1659,257,71,15,4,39,112,8,90,0,0
5889,1622,146,1659,256,71,15,4,37,110,9,90,0,0
5890,1623,146,1660,258,71,15,4,37,112,10,90,0,0
5891,1625,148,1662,257,71,15,4,37,109,11,90,0,0
5892,1626,149,1661,255,71,15,4,35,106,12,90,0,0
5893,1627,150,1663,260,71,15,4,36,110,13,90,0,0
5894,1627,151,1663,262,71,15,4,36,111,14,90,0,0
5895,1627,149,1664,263,71,15,4,37,114,15,90,0,0
5896,1627,150,1665,264,71,15,4,38,114,16,90,0,0
5897,1624,157,1660,265,71,15,4,36,108,17,90,0,0
5898,1621,156,1657,264,71,15,4,36,108,18,90,0,0
5899,1618,154,1655,264,71,15,4,37,110,19,90,0,0
5900,1613,153,1652,270,71,15,4,39,117,20,90,0,0
5901,1609,152,1650,271,71,15,4,41,119,21,90,0,0
5902,1607,150,1649,272,71,15,4,42,122,22,90,0,0
5903,1607,152,1648,274,71,15,4,41,122,23,90,0,0
5904,1606,153,1648,274,71,15,4,42,121,24,90,0,0
5905,1605,149,1650,277,71,15,4,45,128,25,90,0,0
5906,1604,148,1649,278,71,15,4,45,130,26,90,0,0
5908,1614,149,1661,285,71,15,4,47,136,0,90,0,1
5909,1615,150,1664,293,71,15,4,49,143,1,90,0,0
5910,1616,154,1664,295,71,15,4,48,141,2,90,0,0
5911,1619,159,1665,293,71,15,4,46,134,3,90,0,0
5912,1619,160,1665,295,71,15,4,46,135,4,90,0,0
5913,1618,161,1665,300,71,15,4,47,139,5,90,0,0
5914,1617,161,1664,302,71,15,4,47,141,6,90,0,0
5915,1615,163,1662,302,71,15,4,47,139,7,90,0,0
5916,1609,160,1658,303,71,15,4,49,143,8,90,0,0
5917,1604,158,1653,302,71,15,4,49,144,9,90,0,0
5918,1599,155,1650,303,71,15,4,51,148,10,90,0,0
5919,1596,155,1648,307,71,15,4,52,152,11,90,0,0
5920,1594,152,1648,312,71,15,4,54,160,12,90,0,0
5921,1593,159,1645,316,71,15,4,52,157,13,90,0,0
5922,1593,162,1646,320,71,15,4,53,158,14,90,0,0
5923,1594,168,1646,322,71,15,4,52,154,15,90,0,0
5924,1594,166,1646,322,71,15,4,52,156,16,90,0,0
5925,1594,167,1647,326,71,15,4,53,159,17,90,0,0
5926,1594,168,1648,330,71,15,4,54,162,18,90,0,0
5927,1595,168,1648,331,71,15,4,53,163,19,90,0,0
5928,1595,173,1648,335,71,15,4,53,162,20,90,0,0
5929,1594,179,1647,338,71,15,4,53,159,21,90,0,0
5930,1592,184,1644,339,71,15,4,52,155,22,90,0,0
5931,1588,183,1641,344,71,15,4,53,161,23,90,0,0
5932,1587,185,1641,349,71,15,4,54,164,24,90,0,0
5933,1588,183,1644,352,71,15,4,56,169,25,90,0,0
5934,1590,182,1646,355,71,15,4,56,173,26,90,0,0
5935,1588,186,1645,361,71,15,4,57,175,27,90,0,0
5936,1585,186,1643,364,71,15,4,58,178,28,90,0,0
5937,1582,186,1640,367,71,15,4,58,181,29,90,0,0
5938,1580,189,1639,372,71,15,4,59,183,30,90,0,0
5939,1580,193,1639,379,71,15,4,59,186,31,90,0,0
5940,1578,195,1639,383,71,15,4,61,188,32,90,0,0
5941,1579,197,1640,385,71,15,4,61,188,33,90,0,0
5942,1579,200,1640,390,71,15,4,61,190,34,90,0,0
5943,1575,198,1638,391,71,15,4,63,193,35,90,0,0
5944,1572,198,1636,396,71,15,4,64,198,36,90,0,0
5945,1571,200,1637,401,71,15,4,66,201,37,90,0,0
5946,1571,201,1639,407,71,15,4,68,206,38,90,0,0
5947,1570,201,1639,411,71,15,4,69,210,39,90,0,0
5948,1567,202,1638,418,71,15,4,71,216,40,90,0,0
5949,1561,204,1632,417,71,15,4,71,213,41,90,0,0
5950,1552,202,1626,423,71,15,4,74,221,42,90,0,0
5951,1545,201,1622,431,71,15,4,77,230,43,90,0,0
5952,1543,208,1620,436,71,15,4,77,228,44,90,0,0
5953,1540,210,1618,443,71,15,4,78,233,45,90,0,0
5954,1534,209,1615,448,71,15,4,81,239,46,90,0,0
5955,1524,207,1608,452,71,15,4,84,245,47,90,0,0
5956,1519,205,1606,460,71,15,4,87,255,48,90,0,0
5957,1521,204,1611,465,71,15,4,90,261,49,90,0,0
5958,1521,206,1614,473,71,15,4,93,267,50,90,0,0
5959,1521,212,1614,482,71,15,4,93,270,51,90,0,0
5960,1523,214,1617,488,71,15,4,94,274,52,90,0,0
5961,1526,214,1624,493,71,15,4,98,279,53,90,0,0
5962,1529,222,1627,502,71,15,4,98,280,54,90,0,0
5963,1523,222,1623,508,71,15,4,100,286,55,90,0,0
5964,1521,222,1623,516,71,15,4,102,294,56,90,0,0
5965,1523,227,1628,526,71,15,4,105,299,57,90,0,0
5966,1521,229,1630,537,71,15,4,109,308,58,90,0,0
5967,1522,227,1637,545,71,15,4,115,318,59,90,0,0
5968,1523,228,1642,554,71,15,4,119,326,60,90,0,0
5969,1520,235,1645,569,71,15,4,125,334,61,90,0,0
5970,1519,239,1649,581,71,15,4,130,342,62,90,0,0
5971,1521,241,1652,584,71,15,4,131,343,63,90,0,0
5972,1514,245,1649,599,71,15,4,135,354,64,90,0,0
5973,1511,253,1649,615,71,15,4,138,362,65,90,0,0
5974,1514,259,1653,622,71,15,4,139,363,66,90,0,0
5975,1504,264,1645,631,71,15,4,141,367,67,90,0,0
5976,1492,275,1637,653,71,15,4,145,378,68,90,0,0
5977,1489,279,1635,663,71,15,4,146,384,69,90,0,0
5978,1487,278,1642,677,71,15,4,155,399,70,90,0,0
5979,1481,285,1647,708,71,15,4,166,423,71,90,0,0
5980,1468,294,1640,734,71,15,4,172,440,72,90,0,0
5981,1462,297,1636,745,71,15,4,174,448,73,90,0,0
5982,1447,299,1630,761,71,15,4,183,462,74,90,0,0
5983,1430,305,1623,788,71,15,4,193,483,75,90,0,0
5984,1426,308,1625,802,71,15,4,199,494,76,90,0,0
5985,1425,319,1629,824,71,15,4,204,505,77,90,0,0
5986,1403,332,1618,868,71,15,4,215,536,78,90,0,0
5987,1395,344,1618,898,71,15,4,223,554,79,90,0,0
5988,1402,354,1627,912,71,15,4,225,558,80,90,0,0
5989,1400,366,1634,931,71,15,4,234,565,81,90,0,0
5990,1404,370,1651,940,71,15,4,247,570,82,90,0,0
5991,1400,373,1659,949,71,15,4,259,576,83,90,0,0
5992,1399,376,1667,952,71,15,4,268,576,84,90,0,0
5993,1398,376,1672,954,71,15,4,274,578,85,90,0,0
5994,1404,381,1676,947,71,15,4,272,566,86,90,0,0
5995,1410,388,1691,968,71,15,4,281,580,87,90,0,0
5996,1428,401,1678,903,71,15,4,250,502,88,90,0,0
5997,1469,400,1678,797,71,15,4,209,397,89,90,0,0
5998,1477,405,1678,789,71,15,4,201,384,90,90,1,0
5902,1566,155,1603,274,74,15,4,37,119,0,86,0,0
5903,1568,155,1604,270,74,15,4,36,115,1,86,0,0
5904,1570,157,1605,271,74,15,4,35,114,2,86,0,0
5905,1570,157,1605,272,74,15,4,35,115,3,86,0,0
5909,1569,157,1609,288,74,15,4,40,131,0,86,0,0
5910,1568,161,1606,287,74,15,4,38,126,1,86,0,0
5911,1565,161,1603,286,74,15,4,38,125,2,86,0,0
5912,1565,162,1603,288,74,15,4,38,126,3,86,0,0
5914,1557,162,1594,287,74,15,4,37,125,0,86,0,1
5915,1557,168,1596,298,74,15,4,39,130,1,86,0,0
5916,1553,171,1593,304,74,15,4,40,133,2,86,0,0
5917,1550,162,1592,306,74,15,4,42,144,3,86,0,0
5918,1548,161,1591,308,74,15,4,43,147,4,86,0,0
5919,1548,163,1591,314,74,15,4,43,151,5,86,0,0
5920,1547,161,1591,315,74,15,4,44,154,6,86,0,0
5921,1546,164,1590,319,74,15,4,44,155,7,86,0,0
5922,1545,165,1590,323,74,15,4,45,158,8,86,0,0
5923,1542,165,1586,323,74,15,4,44,158,9,86,0,0
5924,1538,162,1583,323,74,15,4,45,161,10,86,0,0
5925,1536,162,1582,325,74,15,4,46,163,11,86,0,0
5926,1536,165,1583,332,74,15,4,47,167,12,86,0,0
5927,1533,163,1583,337,74,15,4,50,174,13,86,0,0
5928,1533,172,1580,338,74,15,4,47,166,14,86,0,0
5929,1530,173,1576,338,74,15,4,46,165,15,86,0,0
5930,1527,175,1574,340,74,15,4,47,165,16,86,0,0
5931,1526,171,1575,346,74,15,4,49,175,17,86,0,0
5932,1525,172,1576,351,74,15,4,51,179,18,86,0,0
5933,1525,173,1575,355,74,15,4,50,182,19,86,0,0
5934,1524,176,1575,358,74,15,4,51,182,20,86,0,0
5935,1520,175,1572,362,74,15,4,52,187,21,86,0,0
5936,1515,175,1568,367,74,15,4,53,192,22,86,0,0
5937,1513,178,1567,371,74,15,4,54,193,23,86,0,0
5938,1512,177,1567,375,74,15,4,55,198,24,86,0,0
5939,1511,178,1567,379,74,15,4,56,201,25,86,0,0
5940,1509,183,1565,383,74,15,4,56,200,26,86,0,0
5941,1505,184,1562,386,74,15,4,57,202,27,86,0,0
5942,1500,185,1559,390,74,15,4,59,205,28,86,0,0
5943,1496,188,1555,396,74,15,4,59,208,29,86,0,0
5944,1494,192,1551,394,74,15,4,57,202,30,86,0,0
5945,1488,192,1548,401,74,15,4,60,209,31,86,0,0
5946,1481,197,1542,407,74,15,4,61,210,32,86,0,0
5947,1473,195,1535,407,74,15,4,62,212,33,86,0,0
5948,1462,195,1526,411,74,15,4,64,216,34,86,0,0
5949,1459,194,1525,421,74,15,4,66,227,35,86,0,0
5950,1453,199,1519,425,74,15,4,66,226,36,86,0,0
5951,1447,194,1516,430,74,15,4,69,236,37,86,0,0
5952,1445,195,1514,435,74,15,4,69,240,38,86,0,0
5953,1441,197,1512,442,74,15,4,71,245,39,86,0,0
5954,1437,199,1507,444,74,15,4,70,245,40,86,0,0
5955,1433,202,1505,454,74,15,4,72,252,41,86,0,0
5956,1428,204,1502,462,74,15,4,74,258,42,86,0,0
5957,1426,202,1501,467,74,15,4,75,265,43,86,0,0
5958,1423,205,1499,472,74,15,4,76,267,44,86,0,0
5959,1417,210,1495,482,74,15,4,78,272,45,86,0,0
5960,1409,212,1490,488,74,15,4,81,276,46,86,0,0
5961,1406,216,1488,495,74,15,4,82,279,47,86,0,0
5962,1402,218,1488,508,74,15,4,86,290,48,86,0,0
5963,1401,220,1488,512,74,15,4,87,292,49,86,0,0
5964,1399,222,1488,518,74,15,4,89,296,50,86,0,0
5965,1399,230,1490,532,74,15,4,91,302,51,86,0,0
5966,1395,234,1488,541,74,15,4,93,307,52,86,0,0
5967,1391,238,1485,548,74,15,4,94,310,53,86,0,0
5968,1386,241,1482,560,74,15,4,96,319,54,86,0,0
5969,1383,244,1482,574,74,15,4,99,330,55,86,0,0
5970,1381,246,1481,579,74,15,4,100,333,56,86,0,0
5971,1378,253,1483,600,74,15,4,105,347,57,86,0,0
5972,1368,254,1477,612,74,15,4,109,358,58,86,0,0
5973,1357,254,1467,616,74,15,4,110,362,59,86,0,0
5974,1347,258,1463,638,74,15,4,116,380,60,86,0,0
5975,1337,261,1456,655,74,15,4,119,394,61,86,0,0
5976,1327,268,1447,664,74,15,4,120,396,62,86,0,0
5977,1319,273,1441,676,74,15,4,122,403,63,86,0,0
5978,1309,278,1436,698,74,15,4,127,420,64,86,0,0
5979,1293,281,1423,709,74,15,4,130,428,65,86,0,0
5980,1274,286,1410,731,74,15,4,136,445,66,86,0,0
5981,1266,300,1407,762,74,15,4,141,462,67,86,0,0
5982,1260,312,1404,779,74,15,4,144,467,68,86,0,0
5983,1253,320,1398,788,74,15,4,145,468,69,86,0,0
5984,1239,336,1389,815,74,15,4,150,479,70,86,0,0
5985,1219,342,1374,834,74,15,4,155,492,71,86,0,0
5986,1203,349,1364,857,74,15,4,161,508,72,86,0,0
5987,1190,363,1360,902,74,15,4,170,539,73,86,0,0
5988,1184,365,1359,921,74,15,4,175,556,74,86,0,0
5989,1189,383,1361,929,74,15,4,172,546,75,86,0,0
5990,1186,404,1365,967,74,15,4,179,563,76,86,0,0
5991,1180,420,1362,992,74,15,4,182,572,77,86,0,0
5992,1180,430,1368,1011,74,15,4,188,581,78,86,0,0
5993,1190,443,1383,1034,74,15,4,193,591,79,86,0,0
5994,1203,461,1402,1064,74,15,4,199,603,80,86,0,0
5995,1226,473,1427,1072,74,15,4,201,599,81,86,0,0
5996,1275,473,1478,1079,74,15,4,203,606,82,86,0,0
5997,1312,488,1518,1080,74,15,4,206,592,83,86,0,0
5998,1374,463,1599,1073,74,15,4,225,610,84,86,0,0
5999,1420,429,1665,1076,74,15,4,245,647,85,86,0,0
6000,1481,448,1721,1078,74,15,4,240,630,86,86,1,0
5878,1598,141,1637,235,76,15,4,39,94,0,0,0,0
6000,1418,417,1593,989,77,15,4,175,572,0,0,0,0
87,1855,577,1919,687,1,15,5,64,110,0,25,0,1
88,1819,475,1920,699,1,15,5,101,224,1,25,0,0
89,1801,416,1920,702,1,15,5,119,286,2,25,0,0
90,1774,370,1920,714,1,15,5,146,344,3,25,0,0
91,1745,343,1920,724,1,15,5,175,381,4,25,0,0
92,1729,325,1920,731,1,15,5,191,406,5,25,0,0
93,1685,310,1918,737,1,15,5,233,427,6,25,0,0
94,1645,307,1887,750,1,15,5,242,443,7,25,0,0
95,1618,298,1867,758,1,15,5,249,460,8,25,0,0
96,1572,304,1838,798,1,15,5,266,494,9,25,0,0
97,1527,304,1807,831,1,15,5,280,527,10,25,0,0
98,1481,308,1767,848,1,15,5,286,540,11,25,0,0
99,1398,316,1699,880,1,15,5,301,564,12,25,0,0
100,1338,322,1648,906,1,15,5,310,584,13,25,0,0
101,1261,329,1601,971,1,15,5,340,642,14,25,0,0
102,1168,350,1528,1028,1,15,5,360,678,15,25,0,0
103,1095,363,1457,1057,1,15,5,362,694,16,25,0,0
104,964,388,1322,1066,1,15,5,358,678,17,25,0,0
105,875,395,1229,1068,1,15,5,354,673,18,25,0,0
106,746,392,1104,1077,1,15,5,358,685,19,25,0,0
107,604,421,966,1080,1,15,5,362,659,20,25,0,0
108,473,450,813,1077,1,15,5,340,627,21,25,0,0
109,322,461,648,1077,1,15,5,326,616,22,25,0,0
110,163,501,472,1080,1,15,5,309,579,23,25,0,0
111,13,509,307,1072,1,15,5,294,563,24,25,0,0
112,0,515,211,1080,1,15,5,211,565,25,25,1,0
191,4,618,225,1073,2,15,5,221,455,0,55,0,1
192,10,497,291,1074,2,15,5,281,577,1,55,0,0
193,56,448,359,1072,2,15,5,303,624,2,55,0,0
194,184,413,510,1077,2,15,5,326,664,3,55,0,0
195,292,408,620,1074,2,15,5,328,666,4,55,0,0
196,362,383,697,1071,2,15,5,335,688,5,55,0,0
197,450,374,787,1074,2,15,5,337,700,6,55,0,0
198,552,367,894,1074,2,15,5,342,707,7,55,0,0
199,605,365,946,1074,2,15,5,341,709,8,55,0,0
200,685,349,1033,1068,2,15,5,348,719,9,55,0,0
201,744,335,1099,1070,2,15,5,355,735,10,55,0,0
202,779,329,1129,1062,2,15,5,350,733,11,55,0,0
203,812,318,1143,1029,2,15,5,331,711,12,55,0,0
204,837,311,1155,1007,2,15,5,318,696,13,55,0,0
205,862,305,1176,1002,2,15,5,314,697,14,55,0,0
206,866,303,1179,1001,2,15,5,313,698,15,55,0,0
207,865,302,1174,1001,2,15,5,309,699,16,55,0,0
208,862,296,1170,1003,2,15,5,308,707,17,55,0,0
209,867,301,1167,1000,2,15,5,300,699,18,55,0,0
210,875,300,1165,988,2,15,5,290,688,19,55,0,0
211,880,306,1161,980,2,15,5,281,674,20,55,0,0
212,896,309,1175,980,2,15,5,279,671,21,55,0,0
213,918,316,1195,977,2,15,5,277,661,22,55,0,0
214,968,320,1240,980,2,15,5,272,660,23,55,0,0
215,994,327,1258,974,2,15,5,264,647,24,55,0,0
216,1008,323,1274,972,2,15,5,266,649,25,55,0,0
217,1022,315,1290,967,2,15,5,268,652,26,55,0,0
218,1034,312,1306,965,2,15,5,272,653,27,55,0,0
219,1030,305,1303,959,2,15,5,273,654,28,55,0,0
220,1016,303,1288,956,2,15,5,272,653,29,55,0,0
221,1013,301,1287,958,2,15,5,274,657,30,55,0,0
222,1015,300,1289,960,2,15,5,274,660,31,55,0,0
223,1013,299,1286,961,2,15,5,273,662,32,55,0,0
224,1013,295,1286,960,2,15,5,273,665,33,55,0,0
225,1016,298,1287,960,2,15,5,271,662,34,55,0,0
226,1032,305,1298,958,2,15,5,266,653,35,55,0,0
227,1050,325,1316,984,2,15,5,266,659,36,55,0,0
228,1058,343,1326,1007,2,15,5,268,664,37,55,0,0
229,1079,354,1348,1013,2,15,5,269,659,38,55,0,0
230,1122,360,1392,1020,2,15,5,270,660,39,55,0,0
231,1166,364,1434,1015,2,15,5,268,651,40,55,0,0
232,1190,374,1463,1023,2,15,5,273,649,41,55,0,0
233,1215,394,1494,1029,2,15,5,279,635,42,55,0,0
234,1254,396,1549,1031,2,15,5,295,635,43,55,0,0
235,1328,396,1622,1016,2,15,5,294,620,44,55,0,0
236,1388,393,1686,1014,2,15,5,298,621,45,55,0,0
237,1436,410,1727,996,2,15,5,291,586,46,55,0,0
238,1508,414,1796,982,2,15,5,288,568,47,55,0,0
239,1579,413,1862,968,2,15,5,283,555,48,55,0,0
240,1617,408,1901,962,2,15,5,284,554,49,55,0,0
241,1682,390,1920,911,2,15,5,238,521,50,55,0,0
242,1711,387,1920,880,2,15,5,209,493,51,55,0,0
243,1738,432,1920,862,2,15,5,182,430,52,55,0,0
244,1775,431,1920,839,2,15,5,145,408,53,55,0,0
245,1802,433,1920,832,2,15,5,118,399,54,55,0,0
246,1838,437,1920,818,2,15,5,82,381,55,55,1,0
246,1859,497,1918,807,3,15,5,59,310,0,0,0,0
393,1867,321,1920,562,4,15,5,53,241,0,45,0,1
394,1868,317,1920,567,4,15,5,52,250,1,45,0,0
395,1866,313,1920,581,4,15,5,54,268,2,45,0,0
396,1856,294,1920,593,4,15,5,64,299,3,45,0,0
397,1851,302,1917,602,4,15,5,66,300,4,45,0,0
398,1830,305,1900,612,4,15,5,70,307,5,45,0,0
399,1808,302,1886,620,4,15,5,78,318,6,45,0,0
400,1796,291,1881,620,4,15,5,85,329,7,45,0,0
401,1785,285,1879,639,4,15,5,94,354,8,45,0,0
402,1762,288,1864,657,4,15,5,102,369,9,45,0,0
403,1743,283,1855,668,4,15,5,112,385,10,45,0,0
404,1707,284,1828,676,4,15,5,121,392,11,45,0,0
405,1675,288,1806,689,4,15,5,131,401,12,45,0,0
406,1651,283,1792,700,4,15,5,141,417,13,45,0,0
407,1627,276,1781,720,4,15,5,154,444,14,45,0,0
408,1599,282,1764,745,4,15,5,165,463,15,45,0,0
409,1579,289,1750,762,4,15,5,171,473,16,45,0,0
410,1547,287,1726,769,4,15,5,179,482,17,45,0,0
411,1492,292,1685,786,4,15,5,193,494,18,45,0,0
412,1457,295,1657,797,4,15,5,200,502,19,45,0,0
413,1417,288,1633,820,4,15,5,216,532,20,45,0,0
414,1357,287,1590,847,4,15,5,233,560,21,45,0,0
415,1308,292,1549,862,4,15,5,241,570,22,45,0,0
416,1267,293,1510,868,4,15,5,243,575,23,45,0,0
417,1170,289,1427,874,4,15,5,257,585,24,45,0,0
418,1113,284,1374,875,4,15,5,261,591,25,45,0,0
419,1061,272,1330,887,4,15,5,269,615,26,45,0,0
420,978,274,1252,891,4,15,5,274,617,27,45,0,0
421,903,279,1183,904,4,15,5,280,625,28,45,0,0
422,846,282,1122,915,4,15,5,276,633,29,45,0,0
423,756,281,1035,916,4,15,5,279,635,30,45,0,0
424,699,278,988,925,4,15,5,289,647,31,45,0,0
425,663,271,948,917,4,15,5,285,646,32,45,0,0
426,581,264,871,930,4,15,5,290,666,33,45,0,0
427,517,268,809,941,4,15,5,292,673,34,45,0,0
428,483,279,776,953,4,15,5,293,674,35,45,0,0
429,436,284,720,955,4,15,5,284,671,36,45,0,0
430,369,285,646,958,4,15,5,277,673,37,45,0,0
431,309,293,592,970,4,15,5,283,677,38,45,0,0
432,260,298,548,971,4,15,5,288,673,39,45,0,0
433,168,295,445,951,4,15,5,277,656,40,45,0,0
434,98,303,380,973,4,15,5,282,670,41,45,0,0
435,55,322,340,983,4,15,5,285,661,42,45,0,0
436,0,331,266,1001,4,15,5,266,670,43,45,0,0
437,0,417,208,1007,4,15,5,208,590,44,45,0,0
438,0,431,151,1015,4,15,5,151,584,45,45,1,0
587,4,460,169,1072,5,15,5,165,612,0,109,0,1
588,25,412,206,1077,5,15,5,181,665,1,109,0,0
589,84,422,259,1050,5,15,5,175,628,2,109,0,0
590,185,414,372,1065,5,15,5,187,651,3,109,0,0
591,286,393,485,1069,5,15,5,199,676,4,109,0,0
592,428,386,640,1072,5,15,5,212,686,5,109,0,0
593,516,371,740,1077,5,15,5,224,706,6,109,0,0
594,607,361,836,1077,5,15,5,229,716,7,109,0,0
595,705,364,942,1074,5,15,5,237,710,8,109,0,0
596,769,366,1015,1071,5,15,5,246,705,9,109,0,0
597,877,351,1130,1062,5,15,5,253,711,10,109,0,0
598,945,355,1205,1053,5,15,5,260,698,11,109,0,0
599,978,357,1239,1041,5,15,5,261,684,12,109,0,0
600,1043,363,1291,1022,5,15,5,248,659,13,109,0,0
601,1086,361,1339,1038,5,15,5,253,677,14,109,0,0
602,1117,355,1377,1052,5,15,5,260,697,15,109,0,0
603,1117,358,1382,1055,5,15,5,265,697,16,109,0,0
604,1103,361,1371,1053,5,15,5,268,692,17,109,0,0
605,1104,357,1374,1056,5,15,5,270,699,18,109,0,0
606,1103,356,1370,1056,5,15,5,267,700,19,109,0,0
607,1103,355,1367,1055,5,15,5,264,700,20,109,0,0
608,1109,361,1369,1055,5,15,5,260,694,21,109,0,0
609,1115,369,1372,1053,5,15,5,257,684,22,109,0,0
610,1119,371,1376,1056,5,15,5,257,685,23,109,0,0
611,1118,375,1378,1063,5,15,5,260,688,24,109,0,0
612,1144,376,1416,1066,5,15,5,272,690,25,109,0,0
613,1153,377,1437,1067,5,15,5,284,690,26,109,0,0
614,1156,382,1447,1066,5,15,5,291,684,27,109,0,0
615,1180,394,1469,1062,5,15,5,289,668,28,109,0,0
616,1198,401,1492,1067,5,15,5,294,666,29,109,0,0
617,1201,404,1500,1073,5,15,5,299,669,30,109,0,0
618,1213,411,1516,1072,5,15,5,303,661,31,109,0,0
619,1221,416,1532,1071,5,15,5,311,655,32,109,0,0
620,1225,411,1550,1072,5,15,5,325,661,33,109,0,0
621,1249,406,1583,1067,5,15,5,334,661,34,109,0,0
622,1304,413,1633,1063,5,15,5,329,650,35,109,0,0
623,1332,428,1656,1061,5,15,5,324,633,36,109,0,0
624,1340,436,1663,1063,5,15,5,323,627,37,109,0,0
625,1336,437,1662,1066,5,15,5,326,629,38,109,0,0
626,1337,437,1665,1065,5,15,5,328,628,39,109,0,0
627,1333,433,1667,1067,5,15,5,334,634,40,109,0,0
628,1339,437,1672,1064,5,15,5,333,627,41,109,0,0
629,1342,437,1677,1060,5,15,5,335,623,42,109,0,0
630,1343,438,1680,1057,5,15,5,337,619,43,109,0,0
631,1334,438,1674,1060,5,15,5,340,622,44,109,0,0
632,1326,429,1671,1063,5,15,5,345,634,45,109,0,0
633,1325,422,1674,1062,5,15,5,349,640,46,109,0,0
634,1328,422,1678,1062,5,15,5,350,640,47,109,0,0
635,1334,432,1681,1062,5,15,5,347,630,48,109,0,0
636,1336,437,1682,1060,5,15,5,346,623,49,109,0,0
637,1336,439,1683,1059,5,15,5,347,620,50,109,0,0
638,1336,436,1687,1058,5,15,5,351,622,51,109,0,0
639,1334,435,1690,1058,5,15,5,356,623,52,109,0,0
640,1336,432,1699,1060,5,15,5,363,628,53,109,0,0
641,1343,428,1717,1063,5,15,5,374,635,54,109,0,0
642,1314,431,1681,1065,5,15,5,367,634,55,109,0,0
643,1307,431,1670,1065,5,15,5,363,634,56,109,0,0
644,1309,432,1669,1065,5,15,5,360,633,57,109,0,0
645,1305,432,1663,1067,5,15,5,358,635,58,109,0,0
646,1298,429,1654,1066,5,15,5,356,637,59,109,0,0
647,1298,426,1650,1064,5,15,5,352,638,60,109,0,0
648,1302,429,1649,1064,5,15,5,347,635,61,109,0,0
649,1306,433,1651,1067,5,15,5,345,634,62,109,0,0
650,1311,434,1653,1066,5,15,5,342,632,63,109,0,0
651,1309,429,1651,1066,5,15,5,342,637,64,109,0,0
652,1303,427,1645,1068,5,15,5,342,641,65,109,0,0
653,1306,428,1645,1066,5,15,5,339,638,66,109,0,0
654,1307,428,1643,1066,5,15,5,336,638,67,109,0,0
655,1307,429,1641,1067,5,15,5,334,638,68,109,0,0
656,1308,433,1638,1067,5,15,5,330,634,69,109,0,0
657,1307,434,1632,1065,5,15,5,325,631,70,109,0,0
658,1304,434,1625,1063,5,15,5,321,629,71,109,0,0
659,1300,432,1619,1063,5,15,5,319,631,72,109,0,0
660,1302,430,1618,1063,5,15,5,316,633,73,109,0,0
661,1302,428,1616,1064,5,15,5,314,636,74,109,0,0
662,1303,430,1614,1065,5,15,5,311,635,75,109,0,0
663,1306,432,1615,1067,5,15,5,309,635,76,109,0,0
664,1308,432,1616,1068,5,15,5,308,636,77,109,0,0
665,1309,434,1615,1068,5,15,5,306,634,78,109,0,0
666,1312,437,1615,1067,5,15,5,303,630,79,109,0,0
667,1314,438,1616,1067,5,15,5,302,629,80,109,0,0
668,1318,435,1619,1062,5,15,5,301,627,81,109,0,0
669,1335,436,1615,1020,5,15,5,280,584,82,109,0,0
670,1359,434,1626,999,5,15,5,267,565,83,109,0,0
671,1347,432,1629,1036,5,15,5,282,604,84,109,0,0
672,1339,431,1627,1055,5,15,5,288,624,85,109,0,0
673,1328,431,1620,1064,5,15,5,292,633,86,109,0,0
674,1324,430,1617,1067,5,15,5,293,637,87,109,0,0
675,1325,431,1620,1066,5,15,5,295,635,88,109,0,0
676,1322,431,1621,1070,5,15,5,299,639,89,109,0,0
677,1324,429,1626,1069,5,15,5,302,640,90,109,0,0
678,1322,431,1626,1071,5,15,5,304,640,91,109,0,0
679,1328,437,1628,1068,5,15,5,300,631,92,109,0,0
680,1319,443,1616,1065,5,15,5,297,622,93,109,0,0
681,1318,445,1610,1060,5,15,5,292,615,94,109,0,0
682,1342,454,1643,1064,5,15,5,301,610,95,109,0,0
683,1389,464,1714,1072,5,15,5,325,608,96,109,0,0
684,1394,470,1747,1072,5,15,5,353,602,97,109,0,0
685,1381,472,1762,1072,5,15,5,381,600,98,109,0,0
686,1369,472,1774,1071,5,15,5,405,599,99,109,0,0
687,1358,475,1785,1074,5,15,5,427,599,100,109,0,0
688,1350,476,1796,1074,5,15,5,446,598,101,109,0,0
689,1339,483,1797,1071,5,15,5,458,588,102,109,0,0
690,1334,494,1799,1070,5,15,5,465,576,103,109,0,0
691,1337,510,1806,1073,5,15,5,469,563,104,109,0,0
692,1334,538,1795,1074,5,15,5,461,536,105,109,0,0
693,1334,588,1761,1075,5,15,5,427,487,106,109,0,0
694,1343,648,1733,1078,5,15,5,390,430,107,109,0,0
695,1424,736,1750,1079,5,15,5,326,343,108,109,0,0
696,1445,766,1743,1080,5,15,5,298,314,109,109,1,0
680,655,598,1124,1075,7,15,5,469,477,0,33,0,1
681,653,588,1115,1072,7,15,5,462,484,1,33,0,0
682,659,563,1128,1072,7,15,5,469,509,2,33,0,0
683,689,546,1163,1067,7,15,5,474,521,3,33,0,0
684,730,536,1209,1064,7,15,5,479,528,4,33,0,0
685,750,529,1237,1069,7,15,5,487,540,5,33,0,0
686,782,530,1266,1068,7,15,5,484,538,6,33,0,0
687,798,541,1280,1066,7,15,5,482,525,7,33,0,0
688,818,555,1293,1069,7,15,5,475,514,8,33,0,0
689,824,570,1293,1072,7,15,5,469,502,9,33,0,0
690,776,574,1229,1071,7,15,5,453,497,10,33,0,0
691,751,575,1188,1068,7,15,5,437,493,11,33,0,0
692,783,581,1217,1068,7,15,5,434,487,12,33,0,0
693,824,588,1272,1071,7,15,5,448,483,13,33,0,0
694,814,570,1282,1072,7,15,5,468,502,14,33,0,0
695,762,550,1226,1062,7,15,5,464,512,15,33,0,0
696,786,533,1249,1063,7,15,5,463,530,16,33,0,0
697,836,544,1287,1067,7,15,5,451,523,17,33,0,0
698,898,550,1346,1073,7,15,5,448,523,18,33,0,0
699,976,549,1428,1078,7,15,5,452,529,19,33,0,0
700,1059,548,1510,1075,7,15,5,451,527,20,33,0,0
701,1154,533,1611,1073,7,15,5,457,540,21,33,0,0
702,1228,499,1701,1072,7,15,5,473,573,22,33,0,0
703,1304,479,1766,1053,7,15,5,462,574,23,33,0,0
704,1358,476,1805,1037,7,15,5,447,561,24,33,0,0
705,1439,455,1870,1008,7,15,5,431,553,25,33,0,0
706,1495,440,1919,996,7,15,5,424,556,26,33,0,0
707,1564,422,1920,947,7,15,5,356,525,27,33,0,0
708,1617,421,1920,905,7,15,5,303,484,28,33,0,0
709,1659,420,1920,869,7,15,5,261,449,29,33,0,0
710,1708,433,1920,845,7,15,5,212,412,30,33,0,0
711,1734,438,1920,836,7,15,5,186,398,31,33,0,0
712,1775,453,1920,811,7,15,5,145,358,32,33,0,0
713,1813,452,1920,793,7,15,5,107,341,33,33,1,0
708,1839,412,1918,775,9,15,5,79,363,0,0,0,0
713,1847,507,1918,764,10,15,5,71,257,0,1,0,0
714,1846,497,1917,756,10,15,5,71,259,1,1,0,0
1797,1654,738,1910,1080,11,15,5,256,342,0,22,0,1
1798,1480,659,1794,1075,11,15,5,314,416,1,22,0,0
1799,1409,595,1773,1074,11,15,5,364,479,2,22,0,0
1800,1397,521,1811,1069,11,15,5,414,548,3,22,0,0
1801,1374,463,1825,1066,11,15,5,451,603,4,22,0,0
1802,1370,437,1832,1064,11,15,5,462,627,5,22,0,0
1803,1384,395,1832,1014,11,15,5,448,619,6,22,0,0
1804,1399,377,1829,982,11,15,5,430,605,7,22,0,0
1805,1419,359,1833,951,11,15,5,414,592,8,22,0,0
1806,1479,340,1850,881,11,15,5,371,541,9,22,0,0
1807,1515,327,1868,854,11,15,5,353,527,10,22,0,0
1808,1557,319,1883,820,11,15,5,326,501,11,22,0,0
1809,1602,309,1890,763,11,15,5,288,454,12,22,0,0
1810,1626,308,1895,738,11,15,5,269,430,13,22,0,0
1811,1672,309,1912,704,11,15,5,240,395,14,22,0,0
1812,1707,297,1920,692,11,15,5,213,395,15,22,0,0
1813,1727,294,1920,684,11,15,5,193,390,16,22,0,0
1814,1755,290,1920,650,11,15,5,165,360,17,22,0,0
1815,1771,304,1920,629,11,15,5,149,325,18,22,0,0
1816,1787,315,1920,613,11,15,5,133,298,19,22,0,0
1817,1810,310,1920,596,11,15,5,110,286,20,22,0,0
1818,1822,314,1920,594,11,15,5,98,280,21,22,0,0
1819,1837,310,1920,576,11,15,5,83,266,22,22,1,0
1819,1878,330,1918,570,12,15,5,40,240,0,1,0,0
1820,1879,328,1918,557,12,15,5,39,229,1,1,0,0
2409,1873,414,1919,690,13,15,5,46,276,0,17,0,0
2410,1864,401,1913,692,13,15,5,49,291,1,17,0,0
2411,1834,382,1891,709,13,15,5,57,327,2,17,0,0
2412,1819,352,1886,720,13,15,5,67,368,3,17,0,0
2413,1803,340,1883,768,13,15,5,80,428,4,17,0,0
2414,1785,345,1875,799,13,15,5,90,454,5,17,0,0
2415,1755,358,1854,812,13,15,5,99,454,6,17,0,0
2416,1711,376,1823,843,13,15,5,112,467,7,17,0,0
2417,1681,384,1805,867,13,15,5,124,483,8,17,0,0
2418,1645,406,1790,936,13,15,5,145,530,9,17,0,0
2419,1612,430,1774,991,13,15,5,162,561,10,17,0,0
2420,1556,455,1736,1019,13,15,5,180,564,11,17,0,0
2421,1509,495,1705,1064,13,15,5,196,569,12,17,0,0
2422,1482,524,1690,1080,13,15,5,208,556,13,17,0,0
2423,1467,584,1675,1080,13,15,5,208,496,14,17,0,0
2424,1481,654,1689,1080,13,15,5,208,426,15,17,0,0
2425,1520,725,1721,1080,13,15,5,201,355,16,17,0,0
2426,1511,752,1709,1080,13,15,5,198,328,17,17,0,0
2740,1877,540,1918,815,15,15,5,41,275,0,1,0,0
2741,1856,536,1899,814,15,15,5,43,278,1,1,0,0
2742,1795,553,1918,850,16,15,5,123,297,0,15,0,0
2743,1787,525,1920,852,16,15,5,133,327,1,15,0,0
2744,1780,539,1920,888,16,15,5,140,349,2,15,0,0
2745,1760,515,1920,924,16,15,5,160,409,3,15,0,0
2746,1725,497,1907,937,16,15,5,182,440,4,15,0,0
2747,1694,505,1891,971,16,15,5,197,466,5,15,0,0
2748,1673,506,1881,993,16,15,5,208,487,6,15,0,0
2749,1646,524,1868,1034,16,15,5,222,510,7,15,0,0
2750,1623,545,1849,1055,16,15,5,226,510,8,15,0,0
2751,1578,569,1809,1067,16,15,5,231,498,9,15,0,0
2752,1549,597,1777,1065,16,15,5,228,468,10,15,0,0
2753,1507,618,1740,1069,16,15,5,233,451,11,15,0,0
2754,1473,668,1702,1072,16,15,5,229,404,12,15,0,0
2755,1470,728,1694,1079,16,15,5,224,351,13,15,0,0
2756,1472,805,1678,1080,16,15,5,206,275,14,15,0,0
2757,1460,834,1654,1080,16,15,5,194,246,15,15,0,0
5028,1045,375,1671,1021,20,15,5,626,646,0,24,0,1
5029,1113,342,1715,988,20,15,5,602,646,1,24,0,0
5030,1156,325,1732,967,20,15,5,576,642,2,24,0,0
5031,1224,301,1740,899,20,15,5,516,598,3,24,0,0
5032,1275,291,1738,848,20,15,5,463,557,4,24,0,0
5033,1322,293,1741,811,20,15,5,419,518,5,24,0,0
5034,1391,277,1777,774,20,15,5,386,497,6,24,0,0
5035,1430,279,1799,770,20,15,5,369,491,7,24,0,0
5036,1477,269,1810,730,20,15,5,333,461,8,24,0,0
5037,1520,267,1819,697,20,15,5,299,430,9,24,0,0
5038,1549,267,1827,680,20,15,5,278,413,10,24,0,0
5039,1583,274,1839,662,20,15,5,256,388,11,24,0,0
5040,1619,266,1867,655,20,15,5,248,389,12,24,0,0
5041,1639,262,1878,649,20,15,5,239,387,13,24,0,0
5042,1675,260,1890,621,20,15,5,215,361,14,24,0,0
5043,1690,262,1893,610,20,15,5,203,348,15,24,0,0
5044,1714,272,1904,602,20,15,5,190,330,16,24,0,0
5045,1746,267,1920,592,20,15,5,174,325,17,24,0,0
5046,1769,293,1920,589,20,15,5,151,296,18,24,0,0
5047,1791,281,1920,576,20,15,5,129,295,19,24,0,0
5048,1803,277,1920,573,20,15,5,117,296,20,24,0,0
5049,1818,305,1920,564,20,15,5,102,259,21,24,0,0
5050,1830,310,1920,559,20,15,5,90,249,22,24,0,0
5051,1850,323,1920,550,20,15,5,70,227,23,24,0,0
5052,1868,327,1920,539,20,15,5,52,212,24,24,1,0
5021,1709,863,1887,1076,21,15,5,178,213,0,0,0,0
5022,1555,769,1843,1071,22,15,5,288,302,0,23,0,1
5023,1485,711,1832,1076,22,15,5,347,365,1,23,0,0
5024,1413,647,1820,1079,22,15,5,407,432,2,23,0,0
5025,1353,579,1818,1077,22,15,5,465,498,3,23,0,0
5026,1338,536,1835,1077,22,15,5,497,541,4,23,0,0
5027,1334,501,1846,1069,22,15,5,512,568,5,23,0,0
5028,1357,477,1864,1054,22,15,5,507,577,6,23,0,0
5029,1382,462,1877,1040,22,15,5,495,578,7,23,0,0
5030,1419,439,1883,998,22,15,5,464,559,8,23,0,0
5031,1453,423,1874,946,22,15,5,421,523,9,23,0,0
5032,1479,417,1872,916,22,15,5,393,499,10,23,0,0
5033,1528,405,1887,870,22,15,5,359,465,11,23,0,0
5034,1578,400,1914,848,22,15,5,336,448,12,23,0,0
5035,1610,396,1920,838,22,15,5,310,442,13,23,0,0
5036,1644,386,1920,801,22,15,5,276,415,14,23,0,0
5037,1665,380,1920,771,22,15,5,255,391,15,23,0,0
5038,1691,375,1920,749,22,15,5,229,374,16,23,0,0
5039,1720,363,1920,735,22,15,5,200,372,17,23,0,0
5040,1738,363,1920,727,22,15,5,182,364,18,23,0,0
5041,1760,345,1920,708,22,15,5,160,363,19,23,0,0
5042,1781,366,1920,689,22,15,5,139,323,20,23,0,0
5043,1791,366,1920,673,22,15,5,129,307,21,23,0,0
5044,1811,350,1920,650,22,15,5,109,300,22,23,0,0
5045,1825,341,1920,631,22,15,5,95,290,23,23,1,0
113,1292,736,1576,1076,2,15,6,284,340,0,10,0,0
114,1133,645,1494,1079,2,15,6,361,434,1,10,0,0
115,980,585,1388,1075,2,15,6,408,490,2,10,0,0
116,867,533,1315,1074,2,15,6,448,541,3,10,0,0
117,796,469,1287,1076,2,15,6,491,607,4,10,0,0
118,712,430,1214,1065,2,15,6,502,635,5,10,0,0
119,655,393,1158,1051,2,15,6,503,658,6,10,0,0
120,595,352,1087,1016,2,15,6,492,664,7,10,0,0
121,553,334,1027,995,2,15,6,474,661,8,10,0,0
122,544,310,971,930,2,15,6,427,620,9,10,0,0
123,474,272,917,915,2,15,6,443,643,10,10,0,0
123,668,377,829,828,3,15,6,161,451,0,68,0,1
124,629,361,794,823,3,15,6,165,462,1,68,0,0
125,590,289,758,761,3,15,6,168,472,2,68,0,0
126,534,253,710,743,3,15,6,176,490,3,68,0,0
127,501,245,674,725,3,15,6,173,480,4,68,0,0
128,486,234,647,679,3,15,6,161,445,5,68,0,0
129,474,220,628,654,3,15,6,154,434,6,68,0,0
130,451,220,599,637,3,15,6,148,417,7,68,0,0
131,435,213,578,618,3,15,6,143,405,8,68,0,0
132,399,206,535,590,3,15,6,136,384,9,68,0,0
133,370,207,508,591,3,15,6,138,384,10,68,0,0
134,358,193,496,577,3,15,6,138,384,11,68,0,0
135,345,184,479,561,3,15,6,134,377,12,68,0,0
136,324,187,453,553,3,15,6,129,366,13,68,0,0
137,313,184,437,540,3,15,6,124,356,14,68,0,0
138,291,183,411,525,3,15,6,120,342,15,68,0,0
139,263,179,381,517,3,15,6,118,338,16,68,0,0
140,260,178,380,527,3,15,6,120,349,17,68,0,0
141,265,176,381,525,3,15,6,116,349,18,68,0,0
142,267,174,381,517,3,15,6,114,343,19,68,0,0
143,267,173,379,512,3,15,6,112,339,20,68,0,0
144,270,172,380,515,3,15,6,110,343,21,68,0,0
145,272,172,380,517,3,15,6,108,345,22,68,0,0
146,265,173,374,527,3,15,6,109,354,23,68,0,0
147,256,176,362,521,3,15,6,106,345,24,68,0,0
148,250,179,355,521,3,15,6,105,342,25,68,0,0
149,242,179,346,514,3,15,6,104,335,26,68,0,0
150,224,176,325,518,3,15,6,101,342,27,68,0,0
151,218,179,313,515,3,15,6,95,336,28,68,0,0
152,220,172,311,510,3,15,6,91,338,29,68,0,0
153,226,181,312,512,3,15,6,86,331,30,68,0,0
154,240,186,327,512,3,15,6,87,326,31,68,0,0
155,242,184,328,504,3,15,6,86,320,32,68,0,0
156,243,181,331,505,3,15,6,88,324,33,68,0,0
157,252,183,343,513,3,15,6,91,330,34,68,0,0
158,264,184,357,517,3,15,6,93,333,35,68,0,0
159,274,192,373,538,3,15,6,99,346,36,68,0,0
160,289,192,393,551,3,15,6,104,359,37,68,0,0
161,303,194,410,556,3,15,6,107,362,38,68,0,0
162,321,205,432,572,3,15,6,111,367,39,68,0,0
163,334,212,449,588,3,15,6,115,376,40,68,0,0
164,346,214,467,611,3,15,6,121,397,41,68,0,0
165,357,221,486,643,3,15,6,129,422,42,68,0,0
166,371,227,503,652,3,15,6,132,425,43,68,0,0
167,386,227,523,664,3,15,6,137,437,44,68,0,0
168,408,235,553,691,3,15,6,145,456,45,68,0,0
169,427,240,576,707,3,15,6,149,467,46,68,0,0
170,449,241,601,719,3,15,6,152,478,47,68,0,0
171,472,249,624,729,3,15,6,152,480,48,68,0,0
172,493,264,653,771,3,15,6,160,507,49,68,0,0
173,520,267,686,796,3,15,6,166,529,50,68,0,0
174,554,280,722,807,3,15,6,168,527,51,68,0,0
175,583,300,763,857,3,15,6,180,557,52,68,0,0
176,611,311,797,881,3,15,6,186,570,53,68,0,0
177,648,320,842,914,3,15,6,194,594,54,68,0,0
178,682,338,889,977,3,15,6,207,639,55,68,0,0
179,722,358,938,1013,3,15,6,216,655,56,68,0,0
180,776,367,997,1034,3,15,6,221,667,57,68,0,0
181,819,386,1048,1063,3,15,6,229,677,58,68,0,0
182,850,419,1085,1075,3,15,6,235,656,59,68,0,0
183,938,436,1173,1080,3,15,6,235,644,60,68,0,0
184,1012,459,1249,1080,3,15,6,237,621,61,68,0,0
185,1075,501,1312,1080,3,15,6,237,579,62,68,0,0
186,1181,536,1407,1070,3,15,6,226,534,63,68,0,0
187,1261,570,1482,1076,3,15,6,221,506,64,68,0,0
188,1343,626,1551,1078,3,15,6,208,452,65,68,0,0
189,1450,678,1647,1079,3,15,6,197,401,66,68,0,0
190,1557,735,1741,1076,3,15,6,184,341,67,68,0,0
191,1633,769,1803,1080,3,15,6,170,311,68,68,1,0
125,756,159,818,382,4,15,6,62,223,0,1,0,0
126,733,160,786,349,4,15,6,53,189,1,1,0,0
127,690,240,760,373,5,15,6,70,133,0,0,0,0
129,612,151,676,348,6,15,6,64,197,0,0,0,0
130,578,141,638,371,7,15,6,60,230,0,1,0,0
131,551,133,615,375,7,15,6,64,242,1,1,0,0
132,509,137,576,354,8,15,6,67,217,0,107,0,1
133,490,132,558,352,8,15,6,68,220,1,107,0,0
134,459,131,532,369,8,15,6,73,238,2,107,0,0
135,442,132,510,354,8,15,6,68,222,3,107,0,0
136,422,131,482,326,8,15,6,60,195,4,107,0,0
137,410,124,469,318,8,15,6,59,194,5,107,0,0
138,398,127,454,308,8,15,6,56,181,6,107,0,0
139,387,123,443,305,8,15,6,56,182,7,107,0,0
140,375,121,431,302,8,15,6,56,181,8,107,0,0
141,371,119,425,295,8,15,6,54,176,9,107,0,0
142,366,118,419,288,8,15,6,53,170,10,107,0,0
143,361,119,413,287,8,15,6,52,168,11,107,0,0
144,358,115,408,276,8,15,6,50,161,12,107,0,0
145,355,113,405,274,8,15,6,50,161,13,107,0,0
146,352,111,401,268,8,15,6,49,157,14,107,0,0
147,350,112,397,260,8,15,6,47,148,15,107,0,0
148,345,111,391,254,8,15,6,46,143,16,107,0,0
149,341,109,385,247,8,15,6,44,138,17,107,0,0
150,339,110,382,242,8,15,6,43,132,18,107,0,0
151,336,108,378,237,8,15,6,42,129,19,107,0,0
152,333,107,374,233,8,15,6,41,126,20,107,0,0
153,330,104,371,232,8,15,6,41,128,21,107,0,0
154,328,104,369,230,8,15,6,41,126,22,107,0,0
155,329,105,369,225,8,15,6,40,120,23,107,0,0
156,329,102,368,223,8,15,6,39,121,24,107,0,0
157,330,104,367,217,8,15,6,37,113,25,107,0,0
158,328,103,363,212,8,15,6,35,109,26,107,0,0
163,332,103,367,212,8,15,6,35,109,0,107,0,0
164,331,103,366,211,8,15,6,35,108,1,107,0,0
165,330,103,365,212,8,15,6,35,109,2,107,0,0
166,330,103,365,212,8,15,6,35,109,3,107,0,0
167,329,100,365,213,8,15,6,36,113,4,107,0,0
168,329,99,365,214,8,15,6,36,115,5,107,0,0
169,329,98,366,215,8,15,6,37,117,6,107,0,0
170,330,98,366,214,8,15,6,36,116,7,107,0,0
171,330,99,365,213,8,15,6,35,114,8,107,0,0
176,332,98,367,214,8,15,6,35,116,0,107,0,0
177,332,97,367,214,8,15,6,35,117,1,107,0,0
218,336,97,371,216,8,15,6,35,119,0,107,0,0
219,336,96,371,216,8,15,6,35,120,1,107,0,0
226,346,110,382,232,8,15,6,36,122,0,107,0,1
227,346,111,383,234,8,15,6,37,123,1,107,0,0
228,347,111,385,237,8,15,6,38,126,2,107,0,0
229,346,111,385,240,8,15,6,39,129,3,107,0,0
230,345,111,385,242,8,15,6,40,131,4,107,0,0
231,343,111,385,247,8,15,6,42,136,5,107,0,0
232,343,112,386,251,8,15,6,43,139,6,107,0,0
233,343,113,387,255,8,15,6,44,142,7,107,0,0
234,344,117,387,259,8,15,6,43,142,8,107,0,0
235,346,118,390,264,8,15,6,44,146,9,107,0,0
236,347,119,392,268,8,15,6,45,149,10,107,0,0
237,347,116,395,273,8,15,6,48,157,11,107,0,0
238,343,116,392,278,8,15,6,49,162,12,107,0,0
239,334,120,383,280,8,15,6,49,160,13,107,0,0
240,321,113,374,289,8,15,6,53,176,14,107,0,0
241,319,113,373,292,8,15,6,54,179,15,107,0,0
242,297,120,348,289,8,15,6,51,169,16,107,0,0
243,285,122,337,292,8,15,6,52,170,17,107,0,0
244,280,123,331,290,8,15,6,51,167,18,107,0,0
245,279,123,333,294,8,15,6,54,171,19,107,0,0
246,283,124,337,297,8,15,6,54,173,20,107,0,0
247,285,124,342,302,8,15,6,57,178,21,107,0,0
248,286,125,344,303,8,15,6,58,178,22,107,0,0
249,284,128,343,304,8,15,6,59,176,23,107,0,0
250,282,127,341,304,8,15,6,59,177,24,107,0,0
251,285,124,345,302,8,15,6,60,178,25,107,0,0
252,291,122,350,302,8,15,6,59,180,26,107,0,0
253,298,119,356,300,8,15,6,58,181,27,107,0,0
254,304,119,361,300,8,15,6,57,181,28,107,0,0
255,307,120,363,302,8,15,6,56,182,29,107,0,0
256,311,124,365,304,8,15,6,54,180,30,107,0,0
257,313,128,365,308,8,15,6,52,180,31,107,0,0
258,313,125,364,306,8,15,6,51,181,32,107,0,0
259,310,124,361,309,8,15,6,51,185,33,107,0,0
260,308,122,359,308,8,15,6,51,186,34,107,0,0
261,308,120,359,309,8,15,6,51,189,35,107,0,0
262,308,120,358,307,8,15,6,50,187,36,107,0,0
263,309,120,359,309,8,15,6,50,189,37,107,0,0
264,311,118,360,310,8,15,6,49,192,38,107,0,0
265,312,119,361,309,8,15,6,49,190,39,107,0,0
266,312,120,361,308,8,15,6,49,188,40,107,0,0
267,313,122,361,308,8,15,6,48,186,41,107,0,0
268,314,123,362,309,8,15,6,48,186,42,107,0,0
269,315,124,361,310,8,15,6,46,186,43,107,0,0
270,315,121,362,311,8,15,6,47,190,44,107,0,0
271,316,123,362,311,8,15,6,46,188,45,107,0,0
272,317,123,362,311,8,15,6,45,188,46,107,0,0
273,316,122,361,311,8,15,6,45,189,47,107,0,0
274,317,126,361,308,8,15,6,44,182,48,107,0,0
275,317,121,361,311,8,15,6,44,190,49,107,0,0
276,318,121,361,308,8,15,6,43,187,50,107,0,0
277,318,121,361,306,8,15,6,43,185,51,107,0,0
278,318,121,361,308,8,15,6,43,187,52,107,0,0
279,319,122,361,306,8,15,6,42,184,53,107,0,0
280,318,121,361,305,8,15,6,43,184,54,107,0,0
281,317,121,360,307,8,15,6,43,186,55,107,0,0
282,317,122,360,307,8,15,6,43,185,56,107,0,0
283,317,123,360,307,8,15,6,43,184,57,107,0,0
284,317,123,360,307,8,15,6,43,184,58,107,0,0
285,317,123,359,308,8,15,6,42,185,59,107,0,0
286,316,123,359,307,8,15,6,43,184,60,107,0,0
287,316,123,358,307,8,15,6,42,184,61,107,0,0
288,316,121,358,307,8,15,6,42,186,62,107,0,0
289,316,120,359,306,8,15,6,43,186,63,107,0,0
290,316,122,358,306,8,15,6,42,184,64,107,0,0
291,317,123,359,306,8,15,6,42,183,65,107,0,0
292,317,124,359,306,8,15,6,42,182,66,107,0,0
293,316,124,358,306,8,15,6,42,182,67,107,0,0
294,316,125,358,306,8,15,6,42,181,68,107,0,0
295,316,125,358,306,8,15,6,42,181,69,107,0,0
296,316,124,358,306,8,15,6,42,182,70,107,0,0
297,316,124,358,306,8,15,6,42,182,71,107,0,0
298,315,124,358,306,8,15,6,43,182,72,107,0,0
299,316,124,358,306,8,15,6,42,182,73,107,0,0
300,315,124,358,306,8,15,6,43,182,74,107,0,0
301,316,125,357,306,8,15,6,41,181,75,107,0,0
302,316,125,357,306,8,15,6,41,181,76,107,0,0
303,316,126,357,306,8,15,6,41,180,77,107,0,0
304,315,126,357,306,8,15,6,42,180,78,107,0,0
305,315,126,357,306,8,15,6,42,180,79,107,0,0
306,316,125,358,306,8,15,6,42,181,80,107,0,0
307,315,122,357,306,8,15,6,42,184,81,107,0,0
308,313,121,356,306,8,15,6,43,185,82,107,0,0
309,313,120,356,306,8,15,6,43,186,83,107,0,0
310,313,119,356,306,8,15,6,43,187,84,107,0,0
311,314,120,356,306,8,15,6,42,186,85,107,0,0
312,314,121,356,306,8,15,6,42,185,86,107,0,0
313,314,120,356,306,8,15,6,42,186,87,107,0,0
314,315,120,357,306,8,15,6,42,186,88,107,0,0
315,315,120,357,306,8,15,6,42,186,89,107,0,0
316,315,120,357,307,8,15,6,42,187,90,107,0,0
317,315,120,358,307,8,15,6,43,187,91,107,0,0
318,316,120,358,308,8,15,6,42,188,92,107,0,0
319,316,120,358,308,8,15,6,42,188,93,107,0,0
320,316,122,359,308,8,15,6,43,186,94,107,0,0
321,316,121,358,308,8,15,6,42,187,95,107,0,0
322,316,121,359,308,8,15,6,43,187,96,107,0,0
323,315,120,358,308,8,15,6,43,188,97,107,0,0
324,315,120,358,308,8,15,6,43,188,98,107,0,0
325,314,120,357,307,8,15,6,43,187,99,107,0,0
326,313,120,356,306,8,15,6,43,186,100,107,0,0
327,311,121,354,306,8,15,6,43,185,101,107,0,0
328,304,120,349,308,8,15,6,45,188,102,107,0,0
329,301,124,345,307,8,15,6,44,183,103,107,0,0
330,291,123,337,309,8,15,6,46,186,104,107,0,0
331,274,122,322,318,8,15,6,48,196,105,107,0,0
332,261,122,310,328,8,15,6,49,206,106,107,0,0
333,256,122,306,330,8,15,6,50,208,107,107,1,0
259,728,214,823,469,9,15,6,95,255,0,23,0,1
260,726,195,827,468,9,15,6,101,273,1,23,0,0
261,688,200,794,487,9,15,6,106,287,2,23,0,0
262,666,203,774,492,9,15,6,108,289,3,23,0,0
263,644,208,755,506,9,15,6,111,298,4,23,0,0
264,603,215,726,537,9,15,6,123,322,5,23,0,0
265,593,216,721,548,9,15,6,128,332,6,23,0,0
266,570,220,702,568,9,15,6,132,348,7,23,0,0
267,536,223,674,588,9,15,6,138,365,8,23,0,0
268,497,227,644,608,9,15,6,147,381,9,23,0,0
269,469,240,626,638,9,15,6,157,398,10,23,0,0
270,459,245,620,653,9,15,6,161,408,11,23,0,0
271,445,256,607,672,9,15,6,162,416,12,23,0,0
272,422,266,589,691,9,15,6,167,425,13,23,0,0
273,374,277,555,719,9,15,6,181,442,14,23,0,0
274,322,291,534,786,9,15,6,212,495,15,23,0,0
275,283,304,497,780,9,15,6,214,476,16,23,0,0
276,238,320,482,855,9,15,6,244,535,17,23,0,0
277,208,333,467,900,9,15,6,259,567,18,23,0,0
278,194,350,450,919,9,15,6,256,569,19,23,0,0
279,184,363,431,923,9,15,6,247,560,20,23,0,0
280,169,382,410,940,9,15,6,241,558,21,23,0,0
281,162,417,380,941,9,15,6,218,524,22,23,0,0
282,138,430,360,963,9,15,6,222,533,23,23,1,0
330,261,143,304,317,10,15,6,43,174,0,0,0,0
385,247,172,303,442,11,15,6,56,270,0,48,0,1
386,260,170,315,434,11,15,6,55,264,1,48,0,0
387,275,170,330,432,11,15,6,55,262,2,48,0,0
388,296,163,349,413,11,15,6,53,250,3,48,0,0
389,317,162,371,408,11,15,6,54,246,4,48,0,0
390,334,158,389,403,11,15,6,55,245,5,48,0,0
391,351,153,407,396,11,15,6,56,243,6,48,0,0
392,367,150,422,385,11,15,6,55,235,7,48,0,0
393,378,152,435,388,11,15,6,57,236,8,48,0,0
394,387,148,445,387,11,15,6,58,239,9,48,0,0
395,394,147,450,373,11,15,6,56,226,10,48,0,0
396,401,145,457,367,11,15,6,56,222,11,48,0,0
397,410,139,466,359,11,15,6,56,220,12,48,0,0
398,417,136,473,348,11,15,6,56,212,13,48,0,0
399,418,137,473,346,11,15,6,55,209,14,48,0,0
400,414,137,469,339,11,15,6,55,202,15,48,0,0
401,409,137,463,333,11,15,6,54,196,16,48,0,0
402,406,137,461,332,11,15,6,55,195,17,48,0,0
403,407,135,461,324,11,15,6,54,189,18,48,0,0
404,408,135,460,318,11,15,6,52,183,19,48,0,0
405,404,136,455,313,11,15,6,51,177,20,48,0,0
406,400,132,450,305,11,15,6,50,173,21,48,0,0
407,394,130,445,304,11,15,6,51,174,22,48,0,0
408,392,131,442,300,11,15,6,50,169,23,48,0,0
409,391,126,442,297,11,15,6,51,171,24,48,0,0
410,391,123,443,294,11,15,6,52,171,25,48,0,0
411,392,123,444,294,11,15,6,52,171,26,48,0,0
412,389,122,441,292,11,15,6,52,170,27,48,0,0
413,383,119,435,287,11,15,6,52,168,28,48,0,0
414,381,119,431,282,11,15,6,50,163,29,48,0,0
415,380,119,431,281,11,15,6,51,162,30,48,0,0
416,383,122,430,274,11,15,6,47,152,31,48,0,0
417,384,125,429,270,11,15,6,45,145,32,48,0,0
418,382,121,428,271,11,15,6,46,150,33,48,0,0
419,377,116,425,267,11,15,6,48,151,34,48,0,0
420,374,114,422,269,11,15,6,48,155,35,48,0,0
421,372,113,419,265,11,15,6,47,152,36,48,0,0
422,371,111,417,257,11,15,6,46,146,37,48,0,0
423,371,108,418,256,11,15,6,47,148,38,48,0,0
424,370,109,416,254,11,15,6,46,145,39,48,0,0
425,367,116,410,253,11,15,6,43,137,40,48,0,0
426,363,116,406,250,11,15,6,43,134,41,48,0,0
427,361,111,405,250,11,15,6,44,139,42,48,0,0
428,361,102,407,247,11,15,6,46,145,43,48,0,0
429,363,98,409,245,11,15,6,46,147,44,48,0,0
430,365,100,410,243,11,15,6,45,143,45,48,0,0
431,366,111,406,242,11,15,6,40,131,46,48,0,0
432,361,102,404,239,11,15,6,43,137,47,48,0,0
433,360,101,402,236,11,15,6,42,135,48,48,1,0
437,360,114,397,233,11,15,6,37,119,0,48,0,0
438,358,104,398,231,11,15,6,40,127,1,48,0,0
439,354,97,396,231,11,15,6,42,134,2,48,0,0
440,351,97,393,230,11,15,6,42,133,3,48,0,0
441,348,95,390,228,11,15,6,42,133,4,48,0,0
442,345,91,388,227,11,15,6,43,136,5,48,0,0
443,347,96,388,226,11,15,6,41,130,6,48,0,0
444,348,96,389,224,11,15,6,41,128,7,48,0,0
445,348,98,387,223,11,15,6,39,125,8,48,0,0
446,346,98,385,223,11,15,6,39,125,9,48,0,0
447,345,98,384,222,11,15,6,39,124,10,48,0,0
437,1507,634,1877,1071,12,15,6,370,437,0,36,0,1
438,1454,607,1844,1069,12,15,6,390,462,1,36,0,0
439,1374,568,1793,1068,12,15,6,419,500,2,36,0,0
440,1282,538,1722,1070,12,15,6,440,532,3,36,0,0
441,1157,522,1612,1077,12,15,6,455,555,4,36,0,0
442,1088,496,1555,1074,12,15,6,467,578,5,36,0,0
443,1013,460,1496,1073,12,15,6,483,613,6,36,0,0
444,929,436,1415,1069,12,15,6,486,633,7,36,0,0
445,865,411,1354,1068,12,15,6,489,657,8,36,0,0
446,834,379,1282,1005,12,15,6,448,626,9,36,0,0
447,752,365,1183,983,12,15,6,431,618,10,36,0,0
448,718,346,1129,953,12,15,6,411,607,11,36,0,0
449,679,320,1062,907,12,15,6,383,587,12,36,0,0
450,645,307,1016,887,12,15,6,371,580,13,36,0,0
451,633,291,984,857,12,15,6,351,566,14,36,0,0
452,652,270,957,782,12,15,6,305,512,15,36,0,0
453,658,262,931,740,12,15,6,273,478,16,36,0,0
454,651,254,905,720,12,15,6,254,466,17,36,0,0
455,644,236,878,677,12,15,6,234,441,18,36,0,0
456,638,231,862,662,12,15,6,224,431,19,36,0,0
457,632,224,844,647,12,15,6,212,423,20,36,0,0
458,627,214,819,610,12,15,6,192,396,21,36,0,0
459,608,215,783,588,12,15,6,175,373,22,36,0,0
460,591,208,763,580,12,15,6,172,372,23,36,0,0
461,562,197,723,556,12,15,6,161,359,24,36,0,0
462,524,192,683,552,12,15,6,159,360,25,36,0,0
463,500,190,655,544,12,15,6,155,354,26,36,0,0
464,472,179,618,524,12,15,6,146,345,27,36,0,0
465,434,181,575,519,12,15,6,141,338,28,36,0,0
466,407,187,553,526,12,15,6,146,339,29,36,0,0
467,373,181,516,524,12,15,6,143,343,30,36,0,0
468,326,180,460,512,12,15,6,134,332,31,36,0,0
469,287,181,425,518,12,15,6,138,337,32,36,0,0
470,261,168,397,510,12,15,6,136,342,33,36,0,0
471,223,165,357,512,12,15,6,134,347,34,36,0,0
472,209,172,333,508,12,15,6,124,336,35,36,0,0
473,178,168,301,500,12,15,6,123,332,36,36,1,0
534,248,184,317,514,13,15,6,69,330,0,35,0,0
535,274,190,345,526,13,15,6,71,336,1,35,0,0
536,288,158,367,529,13,15,6,79,371,2,35,0,0
537,339,169,415,519,13,15,6,76,350,3,35,0,0
538,373,182,449,511,13,15,6,76,329,4,35,0,0
539,406,173,483,500,13,15,6,77,327,5,35,0,0
540,449,175,527,494,13,15,6,78,319,6,35,0,0
541,471,175,552,498,13,15,6,81,323,7,35,0,0
542,490,169,567,471,13,15,6,77,302,8,35,0,0
543,508,163,583,459,13,15,6,75,296,9,35,0,0
544,520,163,597,456,13,15,6,77,293,10,35,0,0
545,535,164,611,447,13,15,6,76,283,11,35,0,0
546,548,160,622,438,13,15,6,74,278,12,35,0,0
547,559,163,630,430,13,15,6,71,267,13,35,0,0
548,568,157,640,425,13,15,6,72,268,14,35,0,0
549,574,158,649,432,13,15,6,75,274,15,35,0,0
550,582,159,657,427,13,15,6,75,268,16,35,0,0
551,598,158,672,422,13,15,6,74,264,17,35,0,0
553,588,158,660,410,13,15,6,72,252,0,35,0,1
554,583,160,662,436,13,15,6,79,276,1,35,0,0
555,586,164,667,447,13,15,6,81,283,2,35,0,0
556,592,165,675,455,13,15,6,83,290,3,35,0,0
557,596,167,682,465,13,15,6,86,298,4,35,0,0
558,604,173,696,483,13,15,6,92,310,5,35,0,0
559,607,181,701,495,13,15,6,94,314,6,35,0,0
560,611,181,708,499,13,15,6,97,318,7,35,0,0
561,624,182,725,514,13,15,6,101,332,8,35,0,0
562,631,197,732,525,13,15,6,101,328,9,35,0,0
563,650,196,756,536,13,15,6,106,340,10,35,0,0
564,691,202,799,540,13,15,6,108,338,11,35,0,0
565,719,212,836,569,13,15,6,117,357,12,35,0,0
566,741,221,857,584,13,15,6,116,363,13,35,0,0
567,767,223,885,593,13,15,6,118,370,14,35,0,0
568,787,231,912,618,13,15,6,125,387,15,35,0,0
569,815,238,948,643,13,15,6,133,405,16,35,0,0
570,860,248,1004,670,13,15,6,144,422,17,35,0,0
571,890,264,1051,721,13,15,6,161,457,18,35,0,0
572,917,276,1079,738,13,15,6,162,462,19,35,0,0
573,941,285,1107,766,13,15,6,166,481,20,35,0,0
574,962,308,1138,815,13,15,6,176,507,21,35,0,0
575,994,320,1175,836,13,15,6,181,516,22,35,0,0
576,1029,336,1229,895,13,15,6,200,559,23,35,0,0
577,1058,362,1273,951,13,15,6,215,589,24,35,0,0
578,1087,383,1304,977,13,15,6,217,594,25,35,0,0
579,1119,406,1334,997,13,15,6,215,591,26,35,0,0
580,1139,435,1369,1050,13,15,6,230,615,27,35,0,0
581,1184,457,1424,1076,13,15,6,240,619,28,35,0,0
582,1240,492,1485,1080,13,15,6,245,588,29,35,0,0
583,1294,540,1539,1080,13,15,6,245,540,30,35,0,0
584,1382,583,1623,1080,13,15,6,241,497,31,35,0,0
585,1460,628,1696,1080,13,15,6,236,452,32,35,0,0
586,1566,700,1781,1080,13,15,6,215,380,33,35,0,0
587,1658,768,1848,1080,13,15,6,190,312,34,35,0,0
588,1721,805,1897,1080,13,15,6,176,275,35,35,1,0
543,204,515,350,858,14,15,6,146,343,0,15,0,0
544,179,376,391,877,14,15,6,212,501,1,15,0,0
545,191,337,416,874,14,15,6,225,537,2,15,0,0
546,240,320,466,863,14,15,6,226,543,3,15,0,0
547,295,289,495,775,14,15,6,200,486,4,15,0,0
548,348,278,537,742,14,15,6,189,464,5,15,0,0
549,398,265,569,687,14,15,6,171,422,6,15,0,0
550,447,237,610,636,14,15,6,163,399,7,15,0,0
551,498,173,667,591,14,15,6,169,418,8,15,0,0
552,539,153,699,559,14,15,6,160,406,9,15,0,0
553,594,181,729,523,14,15,6,135,342,10,15,0,0
554,642,194,764,503,14,15,6,122,309,11,15,0,0
555,683,190,797,485,14,15,6,114,295,12,15,0,0
556,713,182,822,463,14,15,6,109,281,13,15,0,0
557,743,187,843,452,14,15,6,100,265,14,15,0,0
558,780,177,875,427,14,15,6,95,250,15,15,0,0
640,340,100,380,222,15,15,6,40,122,0,1,0,0
641,345,105,383,222,15,15,6,38,117,1,1,0,0
643,349,104,388,218,16,15,6,39,114,0,1,0,0
644,349,101,389,218,16,15,6,40,117,1,1,0,0
646,346,96,386,219,17,15,6,40,123,0,0,0,0
818,262,129,306,311,18,15,6,44,182,0,22,0,1
819,268,124,317,325,18,15,6,49,201,1,22,0,0
820,284,118,334,321,18,15,6,50,203,2,22,0,0
821,304,123,353,319,18,15,6,49,196,3,22,0,0
822,325,123,373,319,18,15,6,48,196,4,22,0,0
823,345,122,395,323,18,15,6,50,201,5,22,0,0
824,365,128,416,328,18,15,6,51,200,6,22,0,0
825,383,126,435,329,18,15,6,52,203,7,22,0,0
826,400,130,452,333,18,15,6,52,203,8,22,0,0
827,418,129,473,341,18,15,6,55,212,9,22,0,0
828,435,135,492,346,18,15,6,57,211,10,22,0,0
829,462,138,519,351,18,15,6,57,213,11,22,0,0
830,490,138,548,353,18,15,6,58,215,12,22,0,0
831,510,142,575,363,18,15,6,65,221,13,22,0,0
832,551,143,614,361,18,15,6,63,218,14,22,0,0
833,581,145,646,361,18,15,6,65,216,15,22,0,0
834,618,147,682,361,18,15,6,64,214,16,22,0,0
835,655,147,720,361,18,15,6,65,214,17,22,0,0
836,682,185,742,362,18,15,6,60,177,18,22,0,0
837,715,160,783,364,18,15,6,68,204,19,22,0,0
838,739,151,811,364,18,15,6,72,213,20,22,0,0
839,769,149,839,364,18,15,6,70,215,21,22,0,0
840,796,149,866,365,18,15,6,70,216,22,22,1,0
832,285,104,322,215,19,15,6,37,111,0,2,0,0
833,288,107,323,214,19,15,6,35,107,1,2,0,0
834,288,107,323,215,19,15,6,35,108,2,2,0,0
824,262,133,302,329,20,15,6,40,196,0,32,0,1
825,265,136,304,330,20,15,6,39,194,1,32,0,0
826,273,130,314,326,20,15,6,41,196,2,32,0,0
827,287,132,329,327,20,15,6,42,195,3,32,0,0
828,298,137,341,332,20,15,6,43,195,4,32,0,0
829,313,138,357,335,20,15,6,44,197,5,32,0,0
830,325,143,369,335,20,15,6,44,192,6,32,0,0
831,335,140,384,344,20,15,6,49,204,7,32,0,0
832,355,142,404,344,20,15,6,49,202,8,32,0,0
833,372,146,423,350,20,15,6,51,204,9,32,0,0
834,388,145,442,351,20,15,6,54,206,10,32,0,0
835,407,146,463,355,20,15,6,56,209,11,32,0,0
836,423,147,481,361,20,15,6,58,214,12,32,0,0
837,448,147,508,361,20,15,6,60,214,13,32,0,0
838,472,146,535,364,20,15,6,63,218,14,32,0,0
839,485,149,549,364,20,15,6,64,215,15,32,0,0
840,511,149,576,362,20,15,6,65,213,16,32,0,0
841,534,152,600,367,20,15,6,66,215,17,32,0,0
842,550,156,619,369,20,15,6,69,213,18,32,0,0
843,581,153,649,367,20,15,6,68,214,19,32,0,0
844,604,154,673,367,20,15,6,69,213,20,32,0,0
845,624,153,693,361,20,15,6,69,208,21,32,0,0
846,658,156,725,358,20,15,6,67,202,22,32,0,0
847,677,158,748,366,20,15,6,71,208,23,32,0,0
848,694,160,765,366,20,15,6,71,206,24,32,0,0
849,717,159,788,368,20,15,6,71,209,25,32,0,0
850,732,163,803,367,20,15,6,71,204,26,32,0,0
851,741,162,813,368,20,15,6,72,206,27,32,0,0
852,756,164,826,367,20,15,6,70,203,28,32,0,0
853,771,165,838,366,20,15,6,67,201,29,32,0,0
854,779,167,842,365,20,15,6,63,198,30,32,0,0
855,783,172,842,363,20,15,6,59,191,31,32,0,0
856,798,174,856,363,20,15,6,58,189,32,32,1,0
1119,287,99,323,217,21,15,6,36,118,0,1,0,0
1120,287,99,322,216,21,15,6,35,117,1,1,0,0
1122,284,102,321,210,22,15,6,37,108,0,18,0,0
1123,283,99,322,211,22,15,6,39,112,1,18,0,0
1124,283,98,321,211,22,15,6,38,113,2,18,0,0
1125,284,98,323,212,22,15,6,39,114,3,18,0,0
1126,287,103,324,211,22,15,6,37,108,4,18,0,0
1127,289,103,327,214,22,15,6,38,111,5,18,0,0
1128,290,104,328,215,22,15,6,38,111,6,18,0,0
1144,354,100,391,211,22,15,6,37,111,0,18,0,0
1145,359,96,397,211,22,15,6,38,115,1,18,0,0
1154,387,118,424,219,22,15,6,37,101,0,18,0,0
1155,389,116,426,217,22,15,6,37,101,1,18,0,0
1156,391,119,428,219,22,15,6,37,100,2,18,0,0
1157,393,120,429,217,22,15,6,36,97,3,18,0,0
1158,391,108,431,216,22,15,6,40,108,4,18,0,0
1159,388,105,430,218,22,15,6,42,113,5,18,0,0
1160,380,99,424,220,22,15,6,44,121,6,18,0,0
1161,374,95,418,221,22,15,6,44,126,7,18,0,0
1162,369,103,410,220,22,15,6,41,117,8,18,0,0
1163,361,102,402,221,22,15,6,41,119,9,18,0,0
1164,356,99,397,220,22,15,6,41,121,10,18,0,0
1165,350,104,390,220,22,15,6,40,116,11,18,0,0
1166,345,114,381,219,22,15,6,36,105,12,18,0,0
1167,336,105,374,219,22,15,6,38,114,13,18,0,0
1168,331,102,370,221,22,15,6,39,119,14,18,0,0
1169,325,99,364,220,22,15,6,39,121,15,18,0,0
1170,319,99,356,221,22,15,6,37,122,16,18,0,0
1171,314,102,349,217,22,15,6,35,115,17,18,0,0
1172,310,102,345,217,22,15,6,35,115,18,18,0,0
1132,788,163,824,359,23,15,6,36,196,0,122,0,1
1133,760,162,798,365,23,15,6,38,203,1,122,0,0
1134,739,158,779,364,23,15,6,40,206,2,122,0,0
1135,710,152,751,361,23,15,6,41,209,3,122,0,0
1136,672,155,715,360,23,15,6,43,205,4,122,0,0
1137,637,154,681,354,23,15,6,44,200,5,122,0,0
1138,596,149,643,356,23,15,6,47,207,6,122,0,0
1139,564,149,615,357,23,15,6,51,208,7,122,0,0
1140,539,145,591,354,23,15,6,52,209,8,122,0,0
1141,512,143,566,354,23,15,6,54,211,9,122,0,0
1142,489,143,543,347,23,15,6,54,204,10,122,0,0
1143,468,141,521,341,23,15,6,53,200,11,122,0,0
1144,444,143,498,339,23,15,6,54,196,12,122,0,0
1145,425,139,481,336,23,15,6,56,197,13,122,0,0
1146,409,138,464,333,23,15,6,55,195,14,122,0,0
1147,393,137,445,320,23,15,6,52,183,15,122,0,0
1148,376,131,430,319,23,15,6,54,188,16,122,0,0
1149,357,133,413,322,23,15,6,56,189,17,122,0,0
1150,343,133,400,320,23,15,6,57,187,18,122,0,0
1151,333,130,388,311,23,15,6,55,181,19,122,0,0
1152,323,132,376,308,23,15,6,53,176,20,122,0,0
1153,311,130,366,307,23,15,6,55,177,21,122,0,0
1154,299,129,354,308,23,15,6,55,179,22,122,0,0
1155,291,130,344,302,23,15,6,53,172,23,122,0,0
1156,280,128,332,300,23,15,6,52,172,24,122,0,0
1157,272,126,323,300,23,15,6,51,174,25,122,0,0
1158,263,123,316,304,23,15,6,53,181,26,122,0,0
1159,260,121,313,306,23,15,6,53,185,27,122,0,0
1160,261,119,314,306,23,15,6,53,187,28,122,0,0
1161,262,118,314,305,23,15,6,52,187,29,122,0,0
1162,263,120,314,304,23,15,6,51,184,30,122,0,0
1163,265,123,315,303,23,15,6,50,180,31,122,0,0
1164,266,124,315,303,23,15,6,49,179,32,122,0,0
1165,266,124,315,302,23,15,6,49,178,33,122,0,0
1166,267,126,315,301,23,15,6,48,175,34,122,0,0
1167,269,126,316,301,23,15,6,47,175,35,122,0,0
1168,269,126,317,302,23,15,6,48,176,36,122,0,0
1169,269,124,318,303,23,15,6,49,179,37,122,0,0
1170,268,123,317,302,23,15,6,49,179,38,122,0,0
1171,268,124,317,302,23,15,6,49,178,39,122,0,0
1172,271,124,320,302,23,15,6,49,178,40,122,0,0
1173,274,125,322,301,23,15,6,48,176,41,122,0,0
1174,273,119,323,302,23,15,6,50,183,42,122,0,0
1175,272,117,322,303,23,15,6,50,186,43,122,0,0
1176,270,112,322,303,23,15,6,52,191,44,122,0,0
1177,268,111,319,302,23,15,6,51,191,45,122,0,0
1178,267,112,319,303,23,15,6,52,191,46,122,0,0
1179,267,114,318,301,23,15,6,51,187,47,122,0,0
1180,270,117,320,302,23,15,6,50,185,48,122,0,0
1181,270,120,320,302,23,15,6,50,182,49,122,0,0
1182,271,123,320,302,23,15,6,49,179,50,122,0,0
1183,272,124,320,302,23,15,6,48,178,51,122,0,0
1184,272,125,320,302,23,15,6,48,177,52,122,0,0
1185,271,124,320,303,23,15,6,49,179,53,122,0,0
1186,271,123,320,304,23,15,6,49,181,54,122,0,0
1187,271,123,320,305,23,15,6,49,182,55,122,0,0
1188,271,123,320,305,23,15,6,49,182,56,122,0,0
1189,272,123,321,305,23,15,6,49,182,57,122,0,0
1190,271,124,320,305,23,15,6,49,181,58,122,0,0
1191,272,124,321,305,23,15,6,49,181,59,122,0,0
1192,272,124,321,304,23,15,6,49,180,60,122,0,0
1193,273,124,321,304,23,15,6,48,180,61,122,0,0
1194,273,124,321,304,23,15,6,48,180,62,122,0,0
1195,273,125,321,304,23,15,6,48,179,63,122,0,0
1196,273,125,321,303,23,15,6,48,178,64,122,0,0
1197,273,125,321,303,23,15,6,48,178,65,122,0,0
1198,274,125,321,303,23,15,6,47,178,66,122,0,0
1199,275,125,322,303,23,15,6,47,178,67,122,0,0
1200,276,125,323,303,23,15,6,47,178,68,122,0,0
1201,276,128,322,302,23,15,6,46,174,69,122,0,0
1202,276,128,322,302,23,15,6,46,174,70,122,0,0
1203,276,129,322,301,23,15,6,46,172,71,122,0,0
1204,276,128,322,301,23,15,6,46,173,72,122,0,0
1205,276,128,322,301,23,15,6,46,173,73,122,0,0
1206,275,126,321,303,23,15,6,46,177,74,122,0,0
1207,274,126,321,304,23,15,6,47,178,75,122,0,0
1208,273,127,321,304,23,15,6,48,177,76,122,0,0
1209,274,127,321,304,23,15,6,47,177,77,122,0,0
1210,273,122,321,303,23,15,6,48,181,78,122,0,0
1211,271,118,320,303,23,15,6,49,185,79,122,0,0
1212,268,114,319,303,23,15,6,51,189,80,122,0,0
1213,268,113,320,303,23,15,6,52,190,81,122,0,0
1214,269,113,320,302,23,15,6,51,189,82,122,0,0
1215,269,113,321,302,23,15,6,52,189,83,122,0,0
1216,272,114,323,302,23,15,6,51,188,84,122,0,0
1217,274,115,323,301,23,15,6,49,186,85,122,0,0
1218,275,115,324,301,23,15,6,49,186,86,122,0,0
1219,277,114,326,300,23,15,6,49,186,87,122,0,0
1220,278,114,327,300,23,15,6,49,186,88,122,0,0
1221,278,113,328,300,23,15,6,50,187,89,122,0,0
1222,281,119,329,299,23,15,6,48,180,90,122,0,0
1223,282,125,327,299,23,15,6,45,174,91,122,0,0
1224,282,129,326,298,23,15,6,44,169,92,122,0,0
1225,282,130,326,298,23,15,6,44,168,93,122,0,0
1226,281,131,324,298,23,15,6,43,167,94,122,0,0
1227,280,131,324,298,23,15,6,44,167,95,122,0,0
1228,279,131,323,298,23,15,6,44,167,96,122,0,0
1229,279,131,323,299,23,15,6,44,168,97,122,0,0
1230,279,131,323,299,23,15,6,44,168,98,122,0,0
1231,279,131,323,299,23,15,6,44,168,99,122,0,0
1232,280,131,323,298,23,15,6,43,167,100,122,0,0
1233,279,131,323,298,23,15,6,44,167,101,122,0,0
1234,279,131,323,298,23,15,6,44,167,102,122,0,0
1235,280,131,323,298,23,15,6,43,167,103,122,0,0
1236,280,131,323,298,23,15,6,43,167,104,122,0,0
1237,280,131,323,298,23,15,6,43,167,105,122,0,0
1238,280,131,323,298,23,15,6,43,167,106,122,0,0
1239,280,132,323,298,23,15,6,43,166,107,122,0,0
1240,280,132,323,298,23,15,6,43,166,108,122,0,0
1241,281,132,323,298,23,15,6,42,166,109,122,0,0
1242,280,132,323,298,23,15,6,43,166,110,122,0,0
1243,281,132,323,298,23,15,6,42,166,111,122,0,0
1244,281,130,323,298,23,15,6,42,168,112,122,0,0
1245,281,128,324,300,23,15,6,43,172,113,122,0,0
1246,280,127,323,299,23,15,6,43,172,114,122,0,0
1247,278,123,323,301,23,15,6,45,178,115,122,0,0
1248,276,118,322,301,23,15,6,46,183,116,122,0,0
1249,272,117,318,302,23,15,6,46,185,117,122,0,0
1250,267,117,314,304,23,15,6,47,187,118,122,0,0
1251,262,127,308,311,23,15,6,46,184,119,122,0,0
1252,260,133,305,313,23,15,6,45,180,120,122,0,0
1253,256,107,307,315,23,15,6,51,208,121,122,0,0
1254,254,104,306,316,23,15,6,52,212,122,122,1,0
1305,415,100,453,210,25,15,6,38,110,0,0,0,0
1467,426,98,463,218,28,15,6,37,120,0,2,0,0
1468,420,99,455,214,28,15,6,35,115,1,2,0,0
1469,416,99,451,213,28,15,6,35,114,2,2,0,0
1480,331,97,366,215,28,15,6,35,118,0,2,0,0
1481,324,96,359,215,28,15,6,35,119,1,2,0,0
1547,311,105,352,213,30,15,6,41,108,0,1,0,0
1548,315,104,356,212,30,15,6,41,108,1,1,0,0
1550,329,98,364,209,31,15,6,35,111,0,8,0,0
1551,330,98,365,208,31,15,6,35,110,1,8,0,0
1553,332,98,367,208,31,15,6,35,110,0,8,0,0
1554,333,98,369,210,31,15,6,36,112,1,8,0,0
1555,334,97,370,211,31,15,6,36,114,2,8,0,0
1561,322,100,357,211,31,15,6,35,111,0,8,0,0
1562,323,101,359,211,31,15,6,36,110,1,8,0,0
1563,328,102,363,212,31,15,6,35,110,2,8,0,0
1564,328,103,363,213,31,15,6,35,110,3,8,0,0
1567,343,102,378,212,31,15,6,35,110,0,8,0,0
1580,423,105,458,211,31,15,6,35,106,0,8,0,0
1587,449,98,485,211,31,15,6,36,113,0,8,0,0
1588,453,97,488,208,31,15,6,35,111,1,8,0,0
1589,457,96,492,208,31,15,6,35,112,2,8,0,0
1601,447,102,483,212,31,15,6,36,110,0,8,0,0
1602,445,102,482,214,31,15,6,37,112,1,8,0,0
1603,442,101,480,213,31,15,6,38,112,2,8,0,0
1604,435,101,474,213,31,15,6,39,112,3,8,0,0
1605,435,100,474,213,31,15,6,39,113,4,8,0,0
1606,422,100,462,214,31,15,6,40,114,5,8,0,0
1607,408,98,449,219,31,15,6,41,121,6,8,0,0
1608,404,97,447,220,31,15,6,43,123,7,8,0,0
1610,381,95,424,224,31,15,6,43,129,0,8,0,0
1611,376,94,420,225,31,15,6,44,131,1,8,0,0
1614,347,96,389,224,31,15,6,42,128,0,8,0,0
1615,341,103,380,224,31,15,6,39,121,1,8,0,0
1616,335,103,374,225,31,15,6,39,122,2,8,0,0
1617,331,99,370,223,31,15,6,39,124,3,8,0,0
1618,324,94,365,224,31,15,6,41,130,4,8,0,0
1619,319,99,358,227,31,15,6,39,128,5,8,0,0
1620,316,100,355,228,31,15,6,39,128,6,8,0,0
1621,315,107,351,226,31,15,6,36,119,7,8,0,0
1622,309,108,345,227,31,15,6,36,119,8,8,0,0
1676,314,110,349,217,33,15,6,35,107,0,0,0,0
1679,336,102,371,216,34,15,6,35,114,0,0,0,0
1681,337,102,379,220,35,15,6,42,118,0,3,0,0
1682,345,101,386,218,35,15,6,41,117,1,3,0,0
1683,353,103,394,218,35,15,6,41,115,2,3,0,0
1684,358,104,398,218,35,15,6,40,114,3,3,0,0
1690,411,101,450,213,35,15,6,39,112,0,3,0,0
1691,421,101,457,205,35,15,6,36,104,1,3,0,0
1692,429,101,464,202,35,15,6,35,101,2,3,0,0
1694,441,99,476,204,35,15,6,35,105,0,3,0,0
1695,448,99,483,203,35,15,6,35,104,1,3,0,0
1766,440,102,475,210,38,15,6,35,108,0,5,0,0
1767,434,100,470,211,38,15,6,36,111,1,5,0,0
1768,428,99,465,213,38,15,6,37,114,2,5,0,0
1769,421,101,457,214,38,15,6,36,113,3,5,0,0
1770,414,100,451,213,38,15,6,37,113,4,5,0,0
1771,409,100,446,214,38,15,6,37,114,5,5,0,0
1776,372,101,410,216,38,15,6,38,115,0,5,0,0
1777,366,102,403,217,38,15,6,37,115,1,5,0,0
1779,354,101,391,218,38,15,6,37,117,0,5,0,0
1780,348,103,384,217,38,15,6,36,114,1,5,0,0
1781,343,103,379,215,38,15,6,36,112,2,5,0,0
1782,337,103,373,215,38,15,6,36,112,3,5,0,0
1786,316,101,353,216,38,15,6,37,115,0,5,0,0
1787,310,101,347,217,38,15,6,37,116,1,5,0,0
1868,423,100,458,206,42,15,6,35,106,0,7,0,0
1872,434,98,469,200,42,15,6,35,102,0,7,0,0
1873,438,98,473,199,42,15,6,35,101,1,7,0,0
1879,436,107,473,205,42,15,6,37,98,0,7,0,0
1880,436,106,472,203,42,15,6,36,97,1,7,0,0
1881,437,106,474,203,42,15,6,37,97,2,7,0,0
1882,437,106,473,203,42,15,6,36,97,3,7,0,0
1883,436,105,474,204,42,15,6,38,99,4,7,0,0
1884,435,105,473,206,42,15,6,38,101,5,7,0,0
1885,434,105,473,207,42,15,6,39,102,6,7,0,0
1886,434,105,474,207,42,15,6,40,102,7,7,0,0
1896,412,102,453,205,42,15,6,41,103,0,7,0,0
1897,413,100,452,200,42,15,6,39,100,1,7,0,0
1898,411,100,450,201,42,15,6,39,101,2,7,0,0
1899,410,100,449,200,42,15,6,39,100,3,7,0,0
1913,323,99,365,217,42,15,6,42,118,0,7,0,0
1914,318,103,358,218,42,15,6,40,115,1,7,0,0
1915,312,103,353,219,42,15,6,41,116,2,7,0,0
1867,743,173,822,475,43,15,6,79,302,0,29,0,1
1868,728,176,807,475,43,15,6,79,299,1,29,0,0
1869,712,182,791,480,43,15,6,79,298,2,29,0,0
1870,691,186,773,491,43,15,6,82,305,3,29,0,0
1871,666,190,751,499,43,15,6,85,309,4,29,0,0
1872,643,193,732,513,43,15,6,89,320,5,29,0,0
1873,620,192,714,528,43,15,6,94,336,6,29,0,0
1874,601,192,699,539,43,15,6,98,347,7,29,0,0
1875,582,203,682,552,43,15,6,100,349,8,29,0,0
1876,556,204,660,563,43,15,6,104,359,9,29,0,0
1877,527,208,634,577,43,15,6,107,369,10,29,0,0
1878,498,216,611,597,43,15,6,113,381,11,29,0,0
1879,465,214,583,609,43,15,6,118,395,12,29,0,0
1880,439,221,565,635,43,15,6,126,414,13,29,0,0
1881,411,226,545,655,43,15,6,134,429,14,29,0,0
1882,379,231,519,667,43,15,6,140,436,15,29,0,0
1883,341,237,491,689,43,15,6,150,452,16,29,0,0
1884,299,247,464,712,43,15,6,165,465,17,29,0,0
1885,281,253,457,722,43,15,6,176,469,18,29,0,0
1886,272,261,459,738,43,15,6,187,477,19,29,0,0
1887,274,264,467,748,43,15,6,193,484,20,29,0,0
1888,286,265,477,755,43,15,6,191,490,21,29,0,0
1889,303,266,485,756,43,15,6,182,490,22,29,0,0
1890,298,266,477,757,43,15,6,179,491,23,29,0,0
1891,287,268,462,752,43,15,6,175,484,24,29,0,0
1892,274,269,451,757,43,15,6,177,488,25,29,0,0
1893,241,263,405,729,43,15,6,164,466,26,29,0,0
1894,217,261,374,716,43,15,6,157,455,27,29,0,0
1895,214,265,365,711,43,15,6,151,446,28,29,0,0
1896,198,268,350,713,43,15,6,152,445,29,29,1,0
1974,323,105,358,209,44,15,6,35,104,0,7,0,0
1975,322,109,357,214,44,15,6,35,105,1,7,0,0
1976,323,106,358,211,44,15,6,35,105,2,7,0,0
1977,323,104,359,210,44,15,6,36,106,3,7,0,0
1978,324,103,361,212,44,15,6,37,109,4,7,0,0
1979,324,102,361,213,44,15,6,37,111,5,7,0,0
1980,324,101,361,211,44,15,6,37,110,6,7,0,0
1981,325,100,361,211,44,15,6,36,111,7,7,0,0
1984,326,102,362,213,44,15,6,36,111,0,7,0,0
1985,326,102,363,213,44,15,6,37,111,1,7,0,0
1996,346,103,381,212,44,15,6,35,109,0,7,0,0
1997,345,103,381,212,44,15,6,36,109,1,7,0,0
1998,343,100,381,212,44,15,6,38,112,2,7,0,0
1999,344,100,382,213,44,15,6,38,113,3,7,0,0
2007,345,104,382,217,44,15,6,37,113,0,7,0,0
2008,346,104,383,218,44,15,6,37,114,1,7,0,0
2236,227,271,300,602,45,15,6,73,331,0,43,0,1
2237,228,262,306,618,45,15,6,78,356,1,43,0,0
2238,241,260,337,690,45,15,6,96,430,2,43,0,0
2239,270,260,375,717,45,15,6,105,457,3,43,0,0
2240,283,259,396,735,45,15,6,113,476,4,43,0,0
2241,311,254,425,734,45,15,6,114,480,5,43,0,0
2242,347,250,465,730,45,15,6,118,480,6,43,0,0
2243,369,247,496,737,45,15,6,127,490,7,43,0,0
2244,382,248,514,731,45,15,6,132,483,8,43,0,0
2245,421,248,555,721,45,15,6,134,473,9,43,0,0
2246,451,251,586,715,45,15,6,135,464,10,43,0,0
2247,477,242,610,693,45,15,6,133,451,11,43,0,0
2248,491,236,622,672,45,15,6,131,436,12,43,0,0
2249,499,232,631,665,45,15,6,132,433,13,43,0,0
2250,503,227,631,637,45,15,6,128,410,14,43,0,0
2251,502,220,625,608,45,15,6,123,388,15,43,0,0
2252,502,216,623,597,45,15,6,121,381,16,43,0,0
2253,508,208,627,577,45,15,6,119,369,17,43,0,0
2254,511,196,629,556,45,15,6,118,360,18,43,0,0
2255,512,192,632,547,45,15,6,120,355,19,43,0,0
2256,510,187,629,537,45,15,6,119,350,20,43,0,0
2257,519,182,633,514,45,15,6,114,332,21,43,0,0
2258,530,181,640,501,45,15,6,110,320,22,43,0,0
2259,540,180,649,496,45,15,6,109,316,23,43,0,0
2260,547,173,653,476,45,15,6,106,303,24,43,0,0
2261,552,168,657,468,45,15,6,105,300,25,43,0,0
2262,557,166,660,456,45,15,6,103,290,26,43,0,0
2263,565,162,665,443,45,15,6,100,281,27,43,0,0
2264,573,164,670,435,45,15,6,97,271,28,43,0,0
2265,583,163,676,430,45,15,6,93,267,29,43,0,0
2266,597,159,686,411,45,15,6,89,252,30,43,0,0
2267,609,160,693,400,45,15,6,84,240,31,43,0,0
2268,617,159,700,398,45,15,6,83,239,32,43,0,0
2269,625,152,708,390,45,15,6,83,238,33,43,0,0
2270,632,151,715,385,45,15,6,83,234,34,43,0,0
2271,647,154,728,381,45,15,6,81,227,35,43,0,0
2272,665,152,746,379,45,15,6,81,227,36,43,0,0
2273,680,154,758,377,45,15,6,78,223,37,43,0,0
2274,691,147,771,375,45,15,6,80,228,38,43,0,0
2275,708,145,784,364,45,15,6,76,219,39,43,0,0
2276,724,148,797,359,45,15,6,73,211,40,43,0,0
2277,736,149,809,358,45,15,6,73,209,41,43,0,0
2278,753,143,827,359,45,15,6,74,216,42,43,0,0
2279,766,142,839,354,45,15,6,73,212,43,43,1,0
2649,280,95,316,223,48,15,6,36,128,0,0,0,0
2700,284,98,320,213,49,15,6,36,115,0,0,0,0
2976,254,66,299,551,52,15,6,45,485,0,25,0,1
2977,253,118,291,526,52,15,6,38,408,1,25,0,0
2978,267,180,304,554,52,15,6,37,374,2,25,0,0
2979,279,202,317,565,52,15,6,38,363,3,25,0,0
2980,295,211,336,565,52,15,6,41,354,4,25,0,0
2981,307,220,352,572,52,15,6,45,352,5,25,0,0
2982,314,220,363,569,52,15,6,49,349,6,25,0,0
2983,319,223,374,583,52,15,6,55,360,7,25,0,0
2984,318,236,379,605,52,15,6,61,369,8,25,0,0
2985,306,239,377,633,52,15,6,71,394,9,25,0,0
2986,293,240,373,649,52,15,6,80,409,10,25,0,0
2987,287,247,375,671,52,15,6,88,424,11,25,0,0
2988,284,251,379,677,52,15,6,95,426,12,25,0,0
2989,283,249,390,696,52,15,6,107,447,13,25,0,0
2990,278,255,399,733,52,15,6,121,478,14,25,0,0
2991,278,265,406,735,52,15,6,128,470,15,25,0,0
2992,283,267,421,748,52,15,6,138,481,16,25,0,0
2993,292,278,436,760,52,15,6,144,482,17,25,0,0
2994,311,267,460,763,52,15,6,149,496,18,25,0,0
2995,315,272,461,767,52,15,6,146,495,19,25,0,0
2996,306,276,450,765,52,15,6,144,489,20,25,0,0
2997,289,280,434,764,52,15,6,145,484,21,25,0,0
2998,269,276,409,730,52,15,6,140,454,22,25,0,0
2999,250,275,390,721,52,15,6,140,446,23,25,0,0
3000,236,275,376,716,52,15,6,140,441,24,25,0,0
3001,233,278,372,719,52,15,6,139,441,25,25,1,0
3001,233,341,327,514,53,15,6,94,173,0,0,0,0
3162,264,85,305,312,56,15,6,41,227,0,0,0,0
3353,250,120,307,371,57,15,6,57,251,0,43,0,1
3354,251,134,305,373,57,15,6,54,239,1,43,0,0
3355,269,134,326,376,57,15,6,57,242,2,43,0,0
3356,283,136,341,382,57,15,6,58,246,3,43,0,0
3357,302,136,358,367,57,15,6,56,231,4,43,0,0
3358,316,136,372,362,57,15,6,56,226,5,43,0,0
3359,321,130,381,364,57,15,6,60,234,6,43,0,0
3360,325,128,384,346,57,15,6,59,218,7,43,0,0
3361,328,129,386,337,57,15,6,58,208,8,43,0,0
3362,328,125,385,327,57,15,6,57,202,9,43,0,0
3363,326,126,382,321,57,15,6,56,195,10,43,0,0
3364,322,126,376,312,57,15,6,54,186,11,43,0,0
3365,315,122,369,309,57,15,6,54,187,12,43,0,0
3366,306,120,360,305,57,15,6,54,185,13,43,0,0
3367,302,121,354,299,57,15,6,52,178,14,43,0,0
3368,300,120,351,296,57,15,6,51,176,15,43,0,0
3369,297,120,347,294,57,15,6,50,174,16,43,0,0
3370,296,120,344,289,57,15,6,48,169,17,43,0,0
3371,295,120,342,287,57,15,6,47,167,18,43,0,0
3372,297,124,343,288,57,15,6,46,164,19,43,0,0
3373,296,124,343,285,57,15,6,47,161,20,43,0,0
3374,303,141,346,282,57,15,6,43,141,21,43,0,0
3375,305,147,348,282,57,15,6,43,135,22,43,0,0
3376,307,149,350,281,57,15,6,43,132,23,43,0,0
3377,304,145,350,282,57,15,6,46,137,24,43,0,0
3378,304,139,353,283,57,15,6,49,144,25,43,0,0
3379,304,132,356,288,57,15,6,52,156,26,43,0,0
3380,305,126,358,288,57,15,6,53,162,27,43,0,0
3381,306,120,361,290,57,15,6,55,170,28,43,0,0
3382,304,122,361,296,57,15,6,57,174,29,43,0,0
3383,299,121,359,301,57,15,6,60,180,30,43,0,0
3384,298,120,360,306,57,15,6,62,186,31,43,0,0
3385,299,122,363,317,57,15,6,64,195,32,43,0,0
3386,302,122,367,322,57,15,6,65,200,33,43,0,0
3387,304,123,371,327,57,15,6,67,204,34,43,0,0
3388,303,129,374,345,57,15,6,71,216,35,43,0,0
3389,305,131,374,343,57,15,6,69,212,36,43,0,0
3390,304,135,374,348,57,15,6,70,213,37,43,0,0
3391,303,138,373,354,57,15,6,70,216,38,43,0,0
3392,298,137,372,363,57,15,6,74,226,39,43,0,0
3393,286,142,364,376,57,15,6,78,234,40,43,0,0
3394,267,141,348,390,57,15,6,81,249,41,43,0,0
3395,249,144,328,394,57,15,6,79,250,42,43,0,0
3396,245,145,326,399,57,15,6,81,254,43,43,1,0
3395,307,112,342,204,59,15,6,35,92,0,0,0,0
3428,224,287,356,506,60,15,6,132,219,0,23,0,1
3429,185,277,426,680,60,15,6,241,403,1,23,0,0
3430,182,272,448,722,60,15,6,266,450,2,23,0,0
3431,205,276,479,744,60,15,6,274,468,3,23,0,0
3432,230,265,508,746,60,15,6,278,481,4,23,0,0
3433,289,262,570,758,60,15,6,281,496,5,23,0,0
3434,334,265,605,751,60,15,6,271,486,6,23,0,0
3435,370,261,633,742,60,15,6,263,481,7,23,0,0
3436,407,259,658,725,60,15,6,251,466,8,23,0,0
3437,422,262,662,717,60,15,6,240,455,9,23,0,0
3438,424,252,663,716,60,15,6,239,464,10,23,0,0
3439,422,242,643,682,60,15,6,221,440,11,23,0,0
3440,408,230,621,660,60,15,6,213,430,12,23,0,0
3441,392,229,598,654,60,15,6,206,425,13,23,0,0
3442,381,223,571,619,60,15,6,190,396,14,23,0,0
3443,365,210,543,594,60,15,6,178,384,15,23,0,0
3444,347,213,520,589,60,15,6,173,376,16,23,0,0
3445,329,211,490,565,60,15,6,161,354,17,23,0,0
3446,284,200,439,552,60,15,6,155,352,18,23,0,0
3447,255,200,407,548,60,15,6,152,348,19,23,0,0
3448,230,196,374,535,60,15,6,144,339,20,23,0,0
3449,209,188,344,522,60,15,6,135,334,21,23,0,0
3450,204,195,328,518,60,15,6,124,323,22,23,0,0
3451,189,192,311,510,60,15,6,122,318,23,23,1,0
3607,316,106,354,208,62,15,6,38,102,0,0,0,0
3772,342,105,377,213,64,15,6,35,108,0,6,0,0
3773,342,98,380,213,64,15,6,38,115,1,6,0,0
3774,344,97,380,209,64,15,6,36,112,2,6,0,0
3775,343,88,382,210,64,15,6,39,122,3,6,0,0
3776,343,84,384,209,64,15,6,41,125,4,6,0,0
3777,342,91,381,212,64,15,6,39,121,5,6,0,0
3778,342,90,382,212,64,15,6,40,122,6,6,0,0
3849,342,99,377,209,65,15,6,35,110,0,0,0,0
3853,345,100,383,211,66,15,6,38,111,0,3,0,0
3854,344,100,381,208,66,15,6,37,108,1,3,0,0
3855,342,101,379,210,66,15,6,37,109,2,3,0,0
3856,342,102,379,210,66,15,6,37,108,3,3,0,0
3861,315,106,352,214,66,15,6,37,108,0,3,0,0
3862,311,107,348,215,66,15,6,37,108,1,3,0,0
3866,289,112,325,219,66,15,6,36,107,0,3,0,0
3867,285,113,320,220,66,15,6,35,107,1,3,0,0
3918,297,104,332,215,67,15,6,35,111,0,0,0,0
3921,447,95,493,221,69,15,6,46,126,0,8,0,0
3922,433,100,477,220,69,15,6,44,120,1,8,0,0
3923,415,95,463,227,69,15,6,48,132,2,8,0,0
3924,396,91,446,229,69,15,6,50,138,3,8,0,0
3925,374,96,422,228,69,15,6,48,132,4,8,0,0
3926,346,99,393,227,69,15,6,47,128,5,8,0,0
3927,333,100,381,231,69,15,6,48,131,6,8,0,0
3928,324,101,371,230,69,15,6,47,129,7,8,0,0
3929,309,102,356,231,69,15,6,47,129,8,8,0,0
3965,421,98,456,211,70,15,6,35,113,0,1,0,0
3966,419,98,455,211,70,15,6,36,113,1,1,0,0
3969,396,109,431,217,70,15,6,35,108,0,1,0,0
3970,393,110,428,218,70,15,6,35,108,1,1,0,0
3974,363,100,401,217,70,15,6,38,117,0,1,0,0
3975,358,100,397,218,70,15,6,39,118,1,1,0,0
3981,319,105,355,221,70,15,6,36,116,0,1,0,0
3982,313,105,350,222,70,15,6,37,117,1,1,0,0
4071,416,102,457,210,73,15,6,41,108,0,3,0,0
4072,408,102,451,216,73,15,6,43,114,1,3,0,0
4073,402,102,445,216,73,15,6,43,114,2,3,0,0
4074,398,102,442,217,73,15,6,44,115,3,3,0,0
4077,375,101,416,210,73,15,6,41,109,0,3,0,0
4078,369,100,410,209,73,15,6,41,109,1,3,0,0
4082,343,101,385,216,73,15,6,42,115,0,3,0,0
4083,337,101,379,216,73,15,6,42,115,1,3,0,0
4170,358,92,393,211,74,15,6,35,119,0,0,0,0
4341,285,103,325,215,75,15,6,40,112,0,0,0,0
4502,345,108,386,220,76,15,6,41,112,0,6,0,0
4503,347,105,389,219,76,15,6,42,114,1,6,0,0
4504,347,103,389,219,76,15,6,42,116,2,6,0,0
4505,348,101,390,216,76,15,6,42,115,3,6,0,0
4506,346,99,389,217,76,15,6,43,118,4,6,0,0
4507,343,96,387,219,76,15,6,44,123,5,6,0,0
4508,342,94,387,219,76,15,6,45,125,6,6,0,0
4662,290,107,325,220,78,15,6,35,113,0,0,0,0
4717,287,102,323,217,79,15,6,36,115,0,0,0,0
4726,763,175,827,415,80,15,6,64,240,0,24,0,1
4727,721,176,798,462,80,15,6,77,286,1,24,0,0
4728,700,181,780,476,80,15,6,80,295,2,24,0,0
4729,684,181,765,477,80,15,6,81,296,3,24,0,0
4730,644,185,734,496,80,15,6,90,311,4,24,0,0
4731,617,186,714,512,80,15,6,97,326,5,24,0,0
4732,607,189,707,521,80,15,6,100,332,6,24,0,0
4733,590,201,695,545,80,15,6,105,344,7,24,0,0
4734,557,206,670,572,80,15,6,113,366,8,24,0,0
4735,524,213,646,588,80,15,6,122,375,9,24,0,0
4736,490,223,623,612,80,15,6,133,389,10,24,0,0
4737,452,229,600,642,80,15,6,148,413,11,24,0,0
4738,423,233,581,661,80,15,6,158,428,12,24,0,0
4739,379,249,552,690,80,15,6,173,441,13,24,0,0
4740,334,262,520,707,80,15,6,186,445,14,24,0,0
4741,308,266,510,719,80,15,6,202,453,15,24,0,0
4742,295,277,517,748,80,15,6,222,471,16,24,0,0
4743,281,283,514,765,80,15,6,233,482,17,24,0,0
4744,273,280,505,773,80,15,6,232,493,18,24,0,0
4745,269,286,489,767,80,15,6,220,481,19,24,0,0
4746,253,288,475,778,80,15,6,222,490,20,24,0,0
4747,230,291,446,775,80,15,6,216,484,21,24,0,0
4748,213,285,418,747,80,15,6,205,462,22,24,0,0
4749,198,285,390,731,80,15,6,192,446,23,24,0,0
4750,178,289,371,738,80,15,6,193,449,24,24,1,0
5032,227,296,324,553,82,15,6,97,257,0,19,0,1
5033,237,286,350,585,82,15,6,113,299,1,19,0,0
5034,237,275,392,687,82,15,6,155,412,2,19,0,0
5035,255,279,431,743,82,15,6,176,464,3,19,0,0
5036,282,277,465,758,82,15,6,183,481,4,19,0,0
5037,332,265,517,756,82,15,6,185,491,5,19,0,0
5038,362,258,549,758,82,15,6,187,500,6,19,0,0
5039,389,254,574,751,82,15,6,185,497,7,19,0,0
5040,410,244,584,713,82,15,6,174,469,8,19,0,0
5041,414,239,586,706,82,15,6,172,467,9,19,0,0
5042,409,242,575,695,82,15,6,166,453,10,19,0,0
5043,404,234,556,650,82,15,6,152,416,11,19,0,0
5044,386,226,531,623,82,15,6,145,397,12,19,0,0
5045,364,230,504,610,82,15,6,140,380,13,19,0,0
5046,327,219,462,587,82,15,6,135,368,14,19,0,0
5047,284,207,419,579,82,15,6,135,372,15,19,0,0
5048,258,207,389,566,82,15,6,131,359,16,19,0,0
5049,232,196,354,539,82,15,6,122,343,17,19,0,0
5050,212,151,344,541,82,15,6,132,390,18,19,0,0
5051,197,139,331,534,82,15,6,134,395,19,19,0,0
5101,246,156,307,430,83,15,6,61,274,0,16,0,0
5102,272,162,332,426,83,15,6,60,264,1,16,0,0
5103,305,164,361,410,83,15,6,56,246,2,16,0,0
5104,349,162,405,402,83,15,6,56,240,3,16,0,0
5105,379,163,440,412,83,15,6,61,249,4,16,0,0
5106,427,156,487,397,83,15,6,60,241,5,16,0,0
5107,464,151,527,395,83,15,6,63,244,6,16,0,0
5108,495,149,561,393,83,15,6,66,244,7,16,0,0
5109,537,147,599,380,83,15,6,62,233,8,16,0,0
5110,577,147,643,375,83,15,6,66,228,9,16,0,0
5111,606,151,672,373,83,15,6,66,222,10,16,0,0
5112,644,149,712,373,83,15,6,68,224,11,16,0,0
5113,666,154,734,370,83,15,6,68,216,12,16,0,0
5114,703,147,772,365,83,15,6,69,218,13,16,0,0
5115,731,168,794,364,83,15,6,63,196,14,16,0,0
5116,750,164,817,363,83,15,6,67,199,15,16,0,0
5117,783,165,848,359,83,15,6,65,194,16,16,0,0
5337,698,102,760,290,84,15,6,62,188,0,10,0,0
5338,703,117,759,286,84,15,6,56,169,1,10,0,0
5339,702,120,759,293,84,15,6,57,173,2,10,0,0
5340,701,129,759,303,84,15,6,58,174,3,10,0,0
5341,707,134,764,302,84,15,6,57,168,4,10,0,0
5342,712,140,771,312,84,15,6,59,172,5,10,0,0
5343,725,151,783,319,84,15,6,58,168,6,10,0,0
5344,740,152,798,317,84,15,6,58,165,7,10,0,0
5345,749,153,807,319,84,15,6,58,166,8,10,0,0
5346,757,151,816,323,84,15,6,59,172,9,10,0,0
5347,764,155,823,327,84,15,6,59,172,10,10,0,0
5350,769,152,821,311,84,15,6,52,159,0,10,0,0
5351,766,150,817,312,84,15,6,51,162,1,10,0,0
5352,763,150,812,307,84,15,6,49,157,2,10,0,0
5353,760,151,809,306,84,15,6,49,155,3,10,0,0
5354,757,157,804,306,84,15,6,47,149,4,10,0,0
5355,756,162,802,305,84,15,6,46,143,5,10,0,0
5356,751,168,797,305,84,15,6,46,137,6,10,0,0
5357,745,176,789,300,84,15,6,44,124,7,10,0,0
5358,742,176,781,283,84,15,6,39,107,8,10,0,0
5359,739,183,774,274,84,15,6,35,91,9,10,0,0
5356,285,100,321,211,85,15,6,36,111,0,0,0,0
5479,769,204,824,425,86,15,6,55,221,0,59,0,1
5480,763,182,823,424,86,15,6,60,242,1,59,0,0
5481,755,169,818,423,86,15,6,63,254,2,59,0,0
5482,743,160,809,420,86,15,6,66,260,3,59,0,0
5483,726,160,792,416,86,15,6,66,256,4,59,0,0
5484,701,159,769,411,86,15,6,68,252,5,59,0,0
5485,687,157,757,408,86,15,6,70,251,6,59,0,0
5486,662,161,729,403,86,15,6,67,242,7,59,0,0
5487,636,154,707,402,86,15,6,71,248,8,59,0,0
5488,616,150,687,393,86,15,6,71,243,9,59,0,0
5489,592,144,665,388,86,15,6,73,244,10,59,0,0
5490,569,145,643,388,86,15,6,74,243,11,59,0,0
5491,547,146,620,380,86,15,6,73,234,12,59,0,0
5492,521,145,597,381,86,15,6,76,236,13,59,0,0
5493,503,144,580,377,86,15,6,77,233,14,59,0,0
5494,494,142,570,372,86,15,6,76,230,15,59,0,0
5495,479,140,555,369,86,15,6,76,229,16,59,0,0
5496,458,138,537,371,86,15,6,79,233,17,59,0,0
5497,437,134,515,364,86,15,6,78,230,18,59,0,0
5498,422,135,499,359,86,15,6,77,224,19,59,0,0
5499,411,133,491,368,86,15,6,80,235,20,59,0,0
5500,404,132,485,369,86,15,6,81,237,21,59,0,0
5501,393,130,474,366,86,15,6,81,236,22,59,0,0
5502,383,130,461,358,86,15,6,78,228,23,59,0,0
5503,377,128,451,345,86,15,6,74,217,24,59,0,0
5504,374,128,446,344,86,15,6,72,216,25,59,0,0
5505,367,127,442,355,86,15,6,75,228,26,59,0,0
5506,362,124,432,340,86,15,6,70,216,27,59,0,0
5507,354,122,422,332,86,15,6,68,210,28,59,0,0
5508,347,122,415,328,86,15,6,68,206,29,59,0,0
5509,342,123,406,324,86,15,6,64,201,30,59,0,0
5510,338,124,400,320,86,15,6,62,196,31,59,0,0
5511,335,123,396,319,86,15,6,61,196,32,59,0,0
5512,334,122,393,313,86,15,6,59,191,33,59,0,0
5513,332,122,390,308,86,15,6,58,186,34,59,0,0
5514,328,119,386,307,86,15,6,58,188,35,59,0,0
5515,325,118,383,306,86,15,6,58,188,36,59,0,0
5516,325,118,383,304,86,15,6,58,186,37,59,0,0
5517,327,118,383,297,86,15,6,56,179,38,59,0,0
5518,328,119,382,293,86,15,6,54,174,39,59,0,0
5519,329,118,381,289,86,15,6,52,171,40,59,0,0
5520,326,114,379,288,86,15,6,53,174,41,59,0,0
5521,324,115,376,286,86,15,6,52,171,42,59,0,0
5522,325,119,375,284,86,15,6,50,165,43,59,0,0
5523,324,117,373,277,86,15,6,49,160,44,59,0,0
5524,321,115,370,273,86,15,6,49,158,45,59,0,0
5525,316,113,366,273,86,15,6,50,160,46,59,0,0
5526,313,111,361,268,86,15,6,48,157,47,59,0,0
5527,310,108,358,267,86,15,6,48,159,48,59,0,0
5528,309,108,357,267,86,15,6,48,159,49,59,0,0
5529,307,106,355,263,86,15,6,48,157,50,59,0,0
5530,305,106,352,260,86,15,6,47,154,51,59,0,0
5531,303,105,349,257,86,15,6,46,152,52,59,0,0
5532,300,106,344,252,86,15,6,44,146,53,59,0,0
5533,299,110,342,251,86,15,6,43,141,54,59,0,0
5534,298,108,340,247,86,15,6,42,139,55,59,0,0
5535,297,106,338,242,86,15,6,41,136,56,59,0,0
5536,293,105,335,242,86,15,6,42,137,57,59,0,0
5537,288,104,328,237,86,15,6,40,133,58,59,0,0
5538,286,106,321,222,86,15,6,35,116,59,59,1,0
5487,780,163,826,394,87,15,6,46,231,0,60,0,1
5488,752,163,798,389,87,15,6,46,226,1,60,0,0
5489,742,163,790,394,87,15,6,48,231,2,60,0,0
5490,731,160,781,388,87,15,6,50,228,3,60,0,0
5491,713,157,766,388,87,15,6,53,231,4,60,0,0
5492,682,161,737,390,87,15,6,55,229,5,60,0,0
5493,668,165,725,389,87,15,6,57,224,6,60,0,0
5494,643,153,703,379,87,15,6,60,226,7,60,0,0
5495,617,151,678,367,87,15,6,61,216,8,60,0,0
5496,595,151,658,367,87,15,6,63,216,9,60,0,0
5497,582,145,648,362,87,15,6,66,217,10,60,0,0
5498,570,142,638,359,87,15,6,68,217,11,60,0,0
5499,555,146,623,355,87,15,6,68,209,12,60,0,0
5500,540,140,612,357,87,15,6,72,217,13,60,0,0
5501,525,136,598,352,87,15,6,73,216,14,60,0,0
5502,515,136,587,346,87,15,6,72,210,15,60,0,0
5503,505,136,579,347,87,15,6,74,211,16,60,0,0
5504,497,137,568,339,87,15,6,71,202,17,60,0,0
5505,487,134,558,332,87,15,6,71,198,18,60,0,0
5506,475,131,550,336,87,15,6,75,205,19,60,0,0
5507,469,137,544,339,87,15,6,75,202,20,60,0,0
5508,462,136,537,337,87,15,6,75,201,21,60,0,0
5509,455,133,529,333,87,15,6,74,200,22,60,0,0
5510,452,136,522,322,87,15,6,70,186,23,60,0,0
5511,451,135,521,316,87,15,6,70,181,24,60,0,0
5512,453,130,522,307,87,15,6,69,177,25,60,0,0
5513,454,131,522,303,87,15,6,68,172,26,60,0,0
5514,453,132,519,301,87,15,6,66,169,27,60,0,0
5515,450,130,515,297,87,15,6,65,167,28,60,0,0
5516,445,127,511,293,87,15,6,66,166,29,60,0,0
5517,443,128,508,291,87,15,6,65,163,30,60,0,0
5518,441,123,506,286,87,15,6,65,163,31,60,0,0
5519,440,121,503,280,87,15,6,63,159,32,60,0,0
5520,435,122,499,281,87,15,6,64,159,33,60,0,0
5521,428,121,492,279,87,15,6,64,158,34,60,0,0
5522,417,118,479,272,87,15,6,62,154,35,60,0,0
5523,410,118,472,269,87,15,6,62,151,36,60,0,0
5524,407,117,469,267,87,15,6,62,150,37,60,0,0
5525,404,114,466,264,87,15,6,62,150,38,60,0,0
5526,400,115,460,261,87,15,6,60,146,39,60,0,0
5527,397,117,455,259,87,15,6,58,142,40,60,0,0
5528,390,116,446,252,87,15,6,56,136,41,60,0,0
5529,383,113,440,251,87,15,6,57,138,42,60,0,0
5530,379,111,435,248,87,15,6,56,137,43,60,0,0
5531,377,110,433,243,87,15,6,56,133,44,60,0,0
5532,375,113,428,240,87,15,6,53,127,45,60,0,0
5533,366,113,419,240,87,15,6,53,127,46,60,0,0
5534,357,111,410,239,87,15,6,53,128,47,60,0,0
5535,347,108,401,238,87,15,6,54,130,48,60,0,0
5536,336,108,389,235,87,15,6,53,127,49,60,0,0
5537,328,109,380,236,87,15,6,52,127,50,60,0,0
5538,321,109,371,228,87,15,6,50,119,51,60,0,0
5539,311,110,361,229,87,15,6,50,119,52,60,0,0
5540,300,110,349,229,87,15,6,49,119,53,60,0,0
5541,289,108,337,226,87,15,6,48,118,54,60,0,0
5542,278,105,326,222,87,15,6,48,117,55,60,0,0
5543,273,104,321,222,87,15,6,48,118,56,60,0,0
5544,278,107,321,214,87,15,6,43,107,57,60,0,0
5545,281,108,322,213,87,15,6,41,105,58,60,0,0
5546,281,105,322,214,87,15,6,41,109,59,60,0,0
5547,276,105,316,212,87,15,6,40,107,60,60,1,0
5618,282,108,321,219,90,15,6,39,111,0,119,0,1
5619,290,107,330,221,90,15,6,40,114,1,119,0,0
5620,298,105,341,225,90,15,6,43,120,2,119,0,0
5621,305,107,347,222,90,15,6,42,115,3,119,0,0
5622,308,108,352,230,90,15,6,44,122,4,119,0,0
5623,312,104,359,234,90,15,6,47,130,5,119,0,0
5624,318,109,365,238,90,15,6,47,129,6,119,0,0
5625,323,109,372,246,90,15,6,49,137,7,119,0,0
5626,326,104,379,255,90,15,6,53,151,8,119,0,0
5627,328,107,383,264,90,15,6,55,157,9,119,0,0
5628,328,107,383,266,90,15,6,55,159,10,119,0,0
5629,326,104,384,271,90,15,6,58,167,11,119,0,0
5630,326,104,385,278,90,15,6,59,174,12,119,0,0
5631,326,105,384,275,90,15,6,58,170,13,119,0,0
5632,322,104,382,279,90,15,6,60,175,14,119,0,0
5633,318,109,376,280,90,15,6,58,171,15,119,0,0
5634,311,110,369,281,90,15,6,58,171,16,119,0,0
5635,304,112,364,285,90,15,6,60,173,17,119,0,0
5636,300,112,362,290,90,15,6,62,178,18,119,0,0
5637,297,109,361,294,90,15,6,64,185,19,119,0,0
5638,297,108,362,294,90,15,6,65,186,20,119,0,0
5639,300,106,364,293,90,15,6,64,187,21,119,0,0
5640,304,107,366,293,90,15,6,62,186,22,119,0,0
5641,308,109,369,292,90,15,6,61,183,23,119,0,0
5642,311,109,372,293,90,15,6,61,184,24,119,0,0
5643,311,109,373,293,90,15,6,62,184,25,119,0,0
5644,312,109,373,294,90,15,6,61,185,26,119,0,0
5645,312,109,374,293,90,15,6,62,184,27,119,0,0
5646,312,110,374,293,90,15,6,62,183,28,119,0,0
5647,313,110,373,292,90,15,6,60,182,29,119,0,0
5648,312,110,373,292,90,15,6,61,182,30,119,0,0
5649,312,109,373,292,90,15,6,61,183,31,119,0,0
5650,312,110,372,292,90,15,6,60,182,32,119,0,0
5651,311,110,372,292,90,15,6,61,182,33,119,0,0
5652,311,109,371,292,90,15,6,60,183,34,119,0,0
5653,311,109,370,292,90,15,6,59,183,35,119,0,0
5654,310,109,370,292,90,15,6,60,183,36,119,0,0
5655,311,109,369,290,90,15,6,58,181,37,119,0,0
5656,310,108,368,291,90,15,6,58,183,38,119,0,0
5657,310,108,368,291,90,15,6,58,183,39,119,0,0
5658,310,109,368,292,90,15,6,58,183,40,119,0,0
5659,309,107,368,292,90,15,6,59,185,41,119,0,0
5660,309,106,368,290,90,15,6,59,184,42,119,0,0
5661,311,110,368,290,90,15,6,57,180,43,119,0,0
5662,312,109,369,291,90,15,6,57,182,44,119,0,0
5663,311,109,368,291,90,15,6,57,182,45,119,0,0
5664,312,109,369,292,90,15,6,57,183,46,119,0,0
5665,312,110,371,292,90,15,6,59,182,47,119,0,0
5666,312,110,371,292,90,15,6,59,182,48,119,0,0
5667,313,110,371,291,90,15,6,58,181,49,119,0,0
5668,313,109,372,292,90,15,6,59,183,50,119,0,0
5669,313,108,372,292,90,15,6,59,184,51,119,0,0
5670,313,109,372,293,90,15,6,59,184,52,119,0,0
5671,312,109,372,293,90,15,6,60,184,53,119,0,0
5672,311,109,371,293,90,15,6,60,184,54,119,0,0
5673,311,109,369,292,90,15,6,58,183,55,119,0,0
5674,310,109,369,293,90,15,6,59,184,56,119,0,0
5675,310,108,369,292,90,15,6,59,184,57,119,0,0
5676,311,108,369,292,90,15,6,58,184,58,119,0,0
5677,310,108,369,292,90,15,6,59,184,59,119,0,0
5678,310,108,368,291,90,15,6,58,183,60,119,0,0
5679,310,108,368,291,90,15,6,58,183,61,119,0,0
5680,310,108,369,291,90,15,6,59,183,62,119,0,0
5681,311,108,369,291,90,15,6,58,183,63,119,0,0
5682,311,108,369,291,90,15,6,58,183,64,119,0,0
5683,311,108,370,292,90,15,6,59,184,65,119,0,0
5684,311,108,370,292,90,15,6,59,184,66,119,0,0
5685,311,108,370,292,90,15,6,59,184,67,119,0,0
5686,311,108,369,292,90,15,6,58,184,68,119,0,0
5687,310,108,368,292,90,15,6,58,184,69,119,0,0
5688,311,108,369,292,90,15,6,58,184,70,119,0,0
5689,312,108,370,292,90,15,6,58,184,71,119,0,0
5690,311,108,369,292,90,15,6,58,184,72,119,0,0
5691,312,109,369,292,90,15,6,57,183,73,119,0,0
5692,312,109,370,292,90,15,6,58,183,74,119,0,0
5693,313,109,370,292,90,15,6,57,183,75,119,0,0
5694,313,109,370,292,90,15,6,57,183,76,119,0,0
5695,313,111,369,291,90,15,6,56,180,77,119,0,0
5696,313,113,368,289,90,15,6,55,176,78,119,0,0
5697,313,113,368,290,90,15,6,55,177,79,119,0,0
5698,313,113,368,290,90,15,6,55,177,80,119,0,0
5699,313,112,368,290,90,15,6,55,178,81,119,0,0
5700,313,112,368,290,90,15,6,55,178,82,119,0,0
5701,313,112,368,290,90,15,6,55,178,83,119,0,0
5702,313,113,368,290,90,15,6,55,177,84,119,0,0
5703,313,113,368,290,90,15,6,55,177,85,119,0,0
5704,313,113,367,290,90,15,6,54,177,86,119,0,0
5705,313,113,368,290,90,15,6,55,177,87,119,0,0
5706,313,113,368,291,90,15,6,55,178,88,119,0,0
5707,312,113,368,291,90,15,6,56,178,89,119,0,0
5708,312,113,368,291,90,15,6,56,178,90,119,0,0
5709,312,113,368,292,90,15,6,56,179,91,119,0,0
5710,312,113,368,292,90,15,6,56,179,92,119,0,0
5711,313,112,368,291,90,15,6,55,179,93,119,0,0
5712,312,112,368,291,90,15,6,56,179,94,119,0,0
5713,313,112,368,291,90,15,6,55,179,95,119,0,0
5714,313,111,368,290,90,15,6,55,179,96,119,0,0
5715,313,111,368,290,90,15,6,55,179,97,119,0,0
5716,313,111,368,290,90,15,6,55,179,98,119,0,0
5717,313,110,369,290,90,15,6,56,180,99,119,0,0
5718,313,110,369,290,90,15,6,56,180,100,119,0,0
5719,312,110,368,290,90,15,6,56,180,101,119,0,0
5720,312,111,368,288,90,15,6,56,177,102,119,0,0
5721,313,111,368,290,90,15,6,55,179,103,119,0,0
5722,312,111,368,291,90,15,6,56,180,104,119,0,0
5723,312,111,368,291,90,15,6,56,180,105,119,0,0
5724,310,110,366,291,90,15,6,56,181,106,119,0,0
5725,307,112,363,290,90,15,6,56,178,107,119,0,0
5726,304,113,359,290,90,15,6,55,177,108,119,0,0
5727,298,113,353,294,90,15,6,55,181,109,119,0,0
5728,294,115,348,294,90,15,6,54,179,110,119,0,0
5729,290,119,341,290,90,15,6,51,171,111,119,0,0
5730,282,118,335,298,90,15,6,53,180,112,119,0,0
5731,271,115,326,302,90,15,6,55,187,113,119,0,0
5732,259,116,319,325,90,15,6,60,209,114,119,0,0
5733,250,120,315,354,90,15,6,65,234,115,119,0,0
5734,245,120,312,360,90,15,6,67,240,116,119,0,0
5735,255,100,313,314,90,15,6,58,214,117,119,0,0
5736,255,104,310,308,90,15,6,55,204,118,119,0,0
5737,252,104,307,309,90,15,6,55,205,119,119,1,0
5616,294,103,340,227,91,15,6,46,124,0,124,0,1
5617,301,102,348,227,91,15,6,47,125,1,124,0,0
5618,310,96,359,229,91,15,6,49,133,2,124,0,0
5619,320,95,371,233,91,15,6,51,138,3,124,0,0
5620,332,96,381,230,91,15,6,49,134,4,124,0,0
5621,344,97,392,230,91,15,6,48,133,5,124,0,0
5622,352,98,402,235,91,15,6,50,137,6,124,0,0
5623,359,98,409,237,91,15,6,50,139,7,124,0,0
5624,366,100,416,239,91,15,6,50,139,8,124,0,0
5625,372,99,422,243,91,15,6,50,144,9,124,0,0
5626,380,100,430,245,91,15,6,50,145,10,124,0,0
5627,385,100,436,248,91,15,6,51,148,11,124,0,0
5628,389,100,441,250,91,15,6,52,150,12,124,0,0
5629,394,104,445,253,91,15,6,51,149,13,124,0,0
5630,397,105,447,254,91,15,6,50,149,14,124,0,0
5631,400,110,450,261,91,15,6,50,151,15,124,0,0
5632,401,107,453,264,91,15,6,52,157,16,124,0,0
5633,401,108,452,264,91,15,6,51,156,17,124,0,0
5634,398,108,451,269,91,15,6,53,161,18,124,0,0
5635,398,108,452,273,91,15,6,54,165,19,124,0,0
5636,397,110,452,276,91,15,6,55,166,20,124,0,0
5637,394,111,450,284,91,15,6,56,173,21,124,0,0
5638,391,111,448,287,91,15,6,57,176,22,124,0,0
5639,388,112,445,289,91,15,6,57,177,23,124,0,0
5640,386,112,444,291,91,15,6,58,179,24,124,0,0
5641,385,112,442,290,91,15,6,57,178,25,124,0,0
5642,384,112,441,292,91,15,6,57,180,26,124,0,0
5643,383,110,441,297,91,15,6,58,187,27,124,0,0
5644,382,109,440,298,91,15,6,58,189,28,124,0,0
5645,381,107,440,297,91,15,6,59,190,29,124,0,0
5646,380,106,438,298,91,15,6,58,192,30,124,0,0
5647,380,106,437,298,91,15,6,57,192,31,124,0,0
5648,379,107,436,298,91,15,6,57,191,32,124,0,0
5649,379,109,435,297,91,15,6,56,188,33,124,0,0
5650,379,109,435,297,91,15,6,56,188,34,124,0,0
5651,379,109,435,297,91,15,6,56,188,35,124,0,0
5652,380,109,434,297,91,15,6,54,188,36,124,0,0
5653,380,109,434,296,91,15,6,54,187,37,124,0,0
5654,380,109,434,296,91,15,6,54,187,38,124,0,0
5655,380,109,434,296,91,15,6,54,187,39,124,0,0
5656,381,109,434,296,91,15,6,53,187,40,124,0,0
5657,381,109,434,296,91,15,6,53,187,41,124,0,0
5658,381,108,434,296,91,15,6,53,188,42,124,0,0
5659,381,108,434,296,91,15,6,53,188,43,124,0,0
5660,381,105,435,296,91,15,6,54,191,44,124,0,0
5661,381,100,435,297,91,15,6,54,197,45,124,0,0
5662,382,100,435,295,91,15,6,53,195,46,124,0,0
5663,382,97,436,295,91,15,6,54,198,47,124,0,0
5664,383,98,436,295,91,15,6,53,197,48,124,0,0
5665,383,99,436,295,91,15,6,53,196,49,124,0,0
5666,383,99,436,295,91,15,6,53,196,50,124,0,0
5667,384,105,434,294,91,15,6,50,189,51,124,0,0
5668,384,107,434,297,91,15,6,50,190,52,124,0,0
5669,383,109,433,297,91,15,6,50,188,53,124,0,0
5670,384,109,435,298,91,15,6,51,189,54,124,0,0
5671,383,109,435,299,91,15,6,52,190,55,124,0,0
5672,382,109,435,300,91,15,6,53,191,56,124,0,0
5673,382,109,435,300,91,15,6,53,191,57,124,0,0
5674,382,110,435,300,91,15,6,53,190,58,124,0,0
5675,384,110,436,299,91,15,6,52,189,59,124,0,0
5676,382,112,435,297,91,15,6,53,185,60,124,0,0
5677,383,110,435,295,91,15,6,52,185,61,124,0,0
5678,384,109,436,294,91,15,6,52,185,62,124,0,0
5679,385,107,437,294,91,15,6,52,187,63,124,0,0
5680,387,107,439,293,91,15,6,52,186,64,124,0,0
5681,390,109,441,293,91,15,6,51,184,65,124,0,0
5682,392,107,444,293,91,15,6,52,186,66,124,0,0
5683,393,107,445,292,91,15,6,52,185,67,124,0,0
5684,394,107,445,292,91,15,6,51,185,68,124,0,0
5685,394,106,446,292,91,15,6,52,186,69,124,0,0
5686,394,107,446,291,91,15,6,52,184,70,124,0,0
5687,394,107,445,291,91,15,6,51,184,71,124,0,0
5688,394,109,445,291,91,15,6,51,182,72,124,0,0
5689,393,109,444,291,91,15,6,51,182,73,124,0,0
5690,393,109,444,292,91,15,6,51,183,74,124,0,0
5691,393,109,443,292,91,15,6,50,183,75,124,0,0
5692,393,109,443,292,91,15,6,50,183,76,124,0,0
5693,392,109,443,292,91,15,6,51,183,77,124,0,0
5694,392,109,443,292,91,15,6,51,183,78,124,0,0
5695,393,110,443,292,91,15,6,50,182,79,124,0,0
5696,393,108,443,291,91,15,6,50,183,80,124,0,0
5697,393,107,443,291,91,15,6,50,184,81,124,0,0
5698,393,107,443,290,91,15,6,50,183,82,124,0,0
5699,393,109,442,291,91,15,6,49,182,83,124,0,0
5700,392,109,442,291,91,15,6,50,182,84,124,0,0
5701,392,109,442,291,91,15,6,50,182,85,124,0,0
5702,392,110,442,290,91,15,6,50,180,86,124,0,0
5703,392,110,442,290,91,15,6,50,180,87,124,0,0
5704,392,110,443,290,91,15,6,51,180,88,124,0,0
5705,392,110,443,290,91,15,6,51,180,89,124,0,0
5706,392,110,443,290,91,15,6,51,180,90,124,0,0
5707,392,110,443,291,91,15,6,51,181,91,124,0,0
5708,392,110,443,291,91,15,6,51,181,92,124,0,0
5709,392,110,443,291,91,15,6,51,181,93,124,0,0
5710,391,110,443,291,91,15,6,52,181,94,124,0,0
5711,391,110,443,291,91,15,6,52,181,95,124,0,0
5712,391,109,443,291,91,15,6,52,182,96,124,0,0
5713,391,109,443,291,91,15,6,52,182,97,124,0,0
5714,391,109,443,290,91,15,6,52,181,98,124,0,0
5715,391,108,443,290,91,15,6,52,182,99,124,0,0
5716,391,108,443,290,91,15,6,52,182,100,124,0,0
5717,391,108,443,290,91,15,6,52,182,101,124,0,0
5718,391,108,443,290,91,15,6,52,182,102,124,0,0
5719,391,108,443,290,91,15,6,52,182,103,124,0,0
5720,391,108,443,290,91,15,6,52,182,104,124,0,0
5721,391,108,443,290,91,15,6,52,182,105,124,0,0
5722,391,108,443,290,91,15,6,52,182,106,124,0,0
5723,391,108,443,290,91,15,6,52,182,107,124,0,0
5724,391,108,443,290,91,15,6,52,182,108,124,0,0
5725,391,110,443,290,91,15,6,52,180,109,124,0,0
5726,391,110,443,291,91,15,6,52,181,110,124,0,0
5727,390,112,442,292,91,15,6,52,180,111,124,0,0
5728,387,112,439,293,91,15,6,52,181,112,124,0,0
5729,381,110,434,293,91,15,6,53,183,113,124,0,0
5730,375,113,427,294,91,15,6,52,181,114,124,0,0
5731,364,113,417,295,91,15,6,53,182,115,124,0,0
5732,351,112,405,298,91,15,6,54,186,116,124,0,0
5733,335,108,393,304,91,15,6,58,196,117,124,0,0
5734,323,112,381,306,91,15,6,58,194,118,124,0,0
5735,306,112,365,309,91,15,6,59,197,119,124,0,0
5736,291,114,349,309,91,15,6,58,195,120,124,0,0
5737,273,113,332,309,91,15,6,59,196,121,124,0,0
5738,257,113,316,311,91,15,6,59,198,122,124,0,0
5739,251,96,315,324,91,15,6,64,228,123,124,0,0
5740,241,95,307,326,91,15,6,66,231,124,124,1,0
5628,279,94,314,212,92,15,6,35,118,0,77,0,0
5630,276,97,311,209,92,15,6,35,112,0,77,0,0
5631,265,96,315,258,92,15,6,50,162,1,77,0,0
5632,266,99,313,252,92,15,6,47,153,2,77,0,0
5633,270,102,309,226,92,15,6,39,124,3,77,0,0
5634,263,101,312,258,92,15,6,49,157,4,77,0,0
5635,260,100,311,265,92,15,6,51,165,5,77,0,0
5638,258,101,315,289,92,15,6,57,188,0,77,0,0
5639,258,98,317,295,92,15,6,59,197,1,77,0,0
5640,260,99,316,293,92,15,6,56,194,2,77,0,0
5641,262,101,316,291,92,15,6,54,190,3,77,0,0
5642,270,104,314,255,92,15,6,44,151,4,77,0,0
5643,277,106,312,220,92,15,6,35,114,5,77,0,0
5646,277,107,312,213,92,15,6,35,106,0,77,0,0
5649,276,107,313,214,92,15,6,37,107,0,77,0,1
5650,274,107,314,220,92,15,6,40,113,1,77,0,0
5651,272,107,314,226,92,15,6,42,119,2,77,0,0
5652,272,107,315,227,92,15,6,43,120,3,77,0,0
5653,272,107,315,228,92,15,6,43,121,4,77,0,0
5654,272,107,314,228,92,15,6,42,121,5,77,0,0
5655,263,103,319,266,92,15,6,56,163,6,77,0,0
5656,260,101,320,283,92,15,6,60,182,7,77,0,0
5657,259,101,321,290,92,15,6,62,189,8,77,0,0
5658,260,102,319,291,92,15,6,59,189,9,77,0,0
5659,260,104,319,292,92,15,6,59,188,10,77,0,0
5660,261,105,318,292,92,15,6,57,187,11,77,0,0
5661,262,105,318,291,92,15,6,56,186,12,77,0,0
5662,263,99,318,286,92,15,6,55,187,13,77,0,0
5663,272,103,314,238,92,15,6,42,135,14,77,0,0
5664,277,106,313,223,92,15,6,36,117,15,77,0,0
5665,278,108,313,217,92,15,6,35,109,16,77,0,0
5666,278,107,313,213,92,15,6,35,106,17,77,0,0
5667,277,105,314,214,92,15,6,37,109,18,77,0,0
5668,277,106,314,211,92,15,6,37,105,19,77,0,0
5669,277,106,314,212,92,15,6,37,106,20,77,0,0
5670,276,106,314,212,92,15,6,38,106,21,77,0,0
5671,276,105,314,207,92,15,6,38,102,22,77,0,0
5672,276,105,314,208,92,15,6,38,103,23,77,0,0
5673,275,105,314,208,92,15,6,39,103,24,77,0,0
5674,275,105,314,208,92,15,6,39,103,25,77,0,0
5675,274,106,313,209,92,15,6,39,103,26,77,0,0
5676,274,106,313,208,92,15,6,39,102,27,77,0,0
5677,274,106,313,209,92,15,6,39,103,28,77,0,0
5678,264,103,319,251,92,15,6,55,148,29,77,0,0
5679,261,101,320,262,92,15,6,59,161,30,77,0,0
5680,264,101,318,253,92,15,6,54,152,31,77,0,0
5681,271,104,315,224,92,15,6,44,120,32,77,0,0
5682,274,106,313,211,92,15,6,39,105,33,77,0,0
5683,275,106,313,207,92,15,6,38,101,34,77,0,0
5684,274,106,313,210,92,15,6,39,104,35,77,0,0
5685,268,102,317,236,92,15,6,49,134,36,77,0,0
5686,272,105,314,218,92,15,6,42,113,37,77,0,0
5687,272,105,314,213,92,15,6,42,108,38,77,0,0
5688,274,105,314,208,92,15,6,40,103,39,77,0,0
5689,275,106,314,206,92,15,6,39,100,40,77,0,0
5690,275,106,314,206,92,15,6,39,100,41,77,0,0
5691,275,106,316,210,92,15,6,41,104,42,77,0,0
5692,269,103,319,232,92,15,6,50,129,43,77,0,0
5693,262,103,323,266,92,15,6,61,163,44,77,0,0
5694,267,104,322,250,92,15,6,55,146,45,77,0,0
5695,263,102,323,269,92,15,6,60,167,46,77,0,0
5696,268,103,320,247,92,15,6,52,144,47,77,0,0
5697,271,105,318,233,92,15,6,47,128,48,77,0,0
5698,273,105,317,225,92,15,6,44,120,49,77,0,0
5699,273,105,316,222,92,15,6,43,117,50,77,0,0
5700,272,106,316,225,92,15,6,44,119,51,77,0,0
5701,275,106,315,215,92,15,6,40,109,52,77,0,0
5702,276,107,315,212,92,15,6,39,105,53,77,0,0
5703,266,104,320,252,92,15,6,54,148,54,77,0,0
5704,263,102,321,266,92,15,6,58,164,55,77,0,0
5705,271,105,317,236,92,15,6,46,131,56,77,0,0
5706,263,102,320,269,92,15,6,57,167,57,77,0,0
5707,261,101,321,278,92,15,6,60,177,58,77,0,0
5708,267,104,318,256,92,15,6,51,152,59,77,0,0
5709,264,102,319,270,92,15,6,55,168,60,77,0,0
5710,271,105,316,241,92,15,6,45,136,61,77,0,0
5711,274,105,314,224,92,15,6,40,119,62,77,0,0
5712,270,102,315,236,92,15,6,45,134,63,77,0,0
5713,274,104,314,218,92,15,6,40,114,64,77,0,0
5714,276,106,312,210,92,15,6,36,104,65,77,0,0
5715,277,107,312,208,92,15,6,35,101,66,77,0,0
5716,275,107,314,217,92,15,6,39,110,67,77,0,0
5717,275,107,314,213,92,15,6,39,106,68,77,0,0
5718,272,106,315,227,92,15,6,43,121,69,77,0,0
5719,271,106,316,234,92,15,6,45,128,70,77,0,0
5720,270,106,316,237,92,15,6,46,131,71,77,0,0
5721,264,102,319,264,92,15,6,55,162,72,77,0,0
5722,262,101,320,274,92,15,6,58,173,73,77,0,0
5723,261,101,320,282,92,15,6,59,181,74,77,0,0
5724,261,101,319,286,92,15,6,58,185,75,77,0,0
5725,260,101,318,290,92,15,6,58,189,76,77,0,0
5726,259,101,319,295,92,15,6,60,194,77,77,1,0
5734,272,95,316,227,92,15,6,44,132,0,77,0,0
5735,273,94,316,224,92,15,6,43,130,1,77,0,0
74,0,304,39,500,1,15,7,39,196,0,38,0,1
75,0,285,43,512,1,15,7,43,227,1,38,0,0
76,0,287,51,520,1,15,7,51,233,2,38,0,0
77,1,270,59,525,1,15,7,58,255,3,38,0,0
78,8,254,73,531,1,15,7,65,277,4,38,0,0
79,15,250,84,535,1,15,7,69,285,5,38,0,0
80,17,247,89,539,1,15,7,72,292,6,38,0,0
81,16,248,95,556,1,15,7,79,308,7,38,0,0
82,18,253,101,569,1,15,7,83,316,8,38,0,0
83,22,259,106,573,1,15,7,84,314,9,38,0,0
84,32,264,120,578,1,15,7,88,314,10,38,0,0
85,36,273,126,582,1,15,7,90,309,11,38,0,0
86,37,274,132,592,1,15,7,95,318,12,38,0,0
87,36,275,137,606,1,15,7,101,331,13,38,0,0
88,33,278,143,631,1,15,7,110,353,14,38,0,0
89,32,280,148,650,1,15,7,116,370,15,38,0,0
90,29,284,148,658,1,15,7,119,374,16,38,0,0
91,32,291,159,678,1,15,7,127,387,17,38,0,0
92,33,299,168,704,1,15,7,135,405,18,38,0,0
93,38,303,181,728,1,15,7,143,425,19,38,0,0
94,47,318,201,769,1,15,7,154,451,20,38,0,0
95,57,327,221,801,1,15,7,164,474,21,38,0,0
96,78,335,250,822,1,15,7,172,487,22,38,0,0
97,121,342,307,847,1,15,7,186,505,23,38,0,0
98,153,350,350,873,1,15,7,197,523,24,38,0,0
99,186,352,405,925,1,15,7,219,573,25,38,0,0
100,233,370,472,980,1,15,7,239,610,26,38,0,0
101,278,384,520,999,1,15,7,242,615,27,38,0,0
102,377,391,642,1033,1,15,7,265,642,28,38,0,0
103,462,417,736,1063,1,15,7,274,646,29,38,0,0
104,552,414,840,1077,1,15,7,288,663,30,38,0,0
105,670,444,955,1080,1,15,7,285,636,31,38,0,0
106,791,457,1072,1078,1,15,7,281,621,32,38,0,0
107,941,469,1219,1080,1,15,7,278,611,33,38,0,0
108,1095,509,1356,1079,1,15,7,261,570,34,38,0,0
109,1262,521,1517,1075,1,15,7,255,554,35,38,0,0
110,1435,551,1683,1070,1,15,7,248,519,36,38,0,0
111,1603,611,1837,1080,1,15,7,234,469,37,38,0,0
112,1706,631,1920,1080,1,15,7,214,449,38,38,1,0
194,1497,659,1882,1080,2,15,7,385,421,0,64,0,1
195,1374,659,1751,1070,2,15,7,377,411,1,64,0,0
196,1289,644,1679,1074,2,15,7,390,430,2,64,0,0
197,1171,608,1588,1073,2,15,7,417,465,3,64,0,0
198,1043,596,1469,1078,2,15,7,426,482,4,64,0,0
199,922,578,1356,1079,2,15,7,434,501,5,64,0,0
200,807,548,1249,1073,2,15,7,442,525,6,64,0,0
201,701,526,1146,1072,2,15,7,445,546,7,64,0,0
202,626,536,1048,1068,2,15,7,422,532,8,64,0,0
203,557,544,966,1075,2,15,7,409,531,9,64,0,0
204,482,541,881,1074,2,15,7,399,533,10,64,0,0
205,459,531,853,1076,2,15,7,394,545,11,64,0,0
206,441,527,825,1075,2,15,7,384,548,12,64,0,0
207,433,520,812,1077,2,15,7,379,557,13,64,0,0
208,431,521,801,1078,2,15,7,370,557,14,64,0,0
209,439,523,798,1079,2,15,7,359,556,15,64,0,0
210,444,530,792,1080,2,15,7,348,550,16,64,0,0
211,444,525,790,1078,2,15,7,346,553,17,64,0,0
212,436,515,785,1077,2,15,7,349,562,18,64,0,0
213,423,496,775,1076,2,15,7,352,580,19,64,0,0
214,407,476,763,1075,2,15,7,356,599,20,64,0,0
215,388,464,746,1074,2,15,7,358,610,21,64,0,0
216,372,458,734,1074,2,15,7,362,616,22,64,0,0
217,350,451,720,1075,2,15,7,370,624,23,64,0,0
218,331,454,705,1077,2,15,7,374,623,24,64,0,0
219,320,465,691,1074,2,15,7,371,609,25,64,0,0
220,304,464,680,1075,2,15,7,376,611,26,64,0,0
221,295,464,673,1074,2,15,7,378,610,27,64,0,0
222,292,463,669,1072,2,15,7,377,609,28,64,0,0
223,294,469,667,1072,2,15,7,373,603,29,64,0,0
224,298,466,670,1069,2,15,7,372,603,30,64,0,0
225,307,465,681,1072,2,15,7,374,607,31,64,0,0
226,317,466,691,1072,2,15,7,374,606,32,64,0,0
227,318,463,692,1071,2,15,7,374,608,33,64,0,0
228,336,458,713,1071,2,15,7,377,613,34,64,0,0
229,350,442,729,1070,2,15,7,379,628,35,64,0,0
230,376,416,762,1070,2,15,7,386,654,36,64,0,0
231,396,408,782,1075,2,15,7,386,667,37,64,0,0
232,408,392,791,1070,2,15,7,383,678,38,64,0,0
233,409,380,788,1069,2,15,7,379,689,39,64,0,0
234,409,376,778,1065,2,15,7,369,689,40,64,0,0
235,407,357,762,1030,2,15,7,355,673,41,64,0,0
236,400,345,729,972,2,15,7,329,627,42,64,0,0
237,383,346,695,949,2,15,7,312,603,43,64,0,0
238,370,342,667,923,2,15,7,297,581,44,64,0,0
239,339,317,605,848,2,15,7,266,531,45,64,0,0
240,320,302,573,814,2,15,7,253,512,46,64,0,0
241,298,305,541,795,2,15,7,243,490,47,64,0,0
242,251,293,477,754,2,15,7,226,461,48,64,0,0
243,206,286,424,736,2,15,7,218,450,49,64,0,0
244,178,279,390,720,2,15,7,212,441,50,64,0,0
245,155,268,353,686,2,15,7,198,418,51,64,0,0
246,146,277,330,668,2,15,7,184,391,52,64,0,0
247,122,290,294,652,2,15,7,172,362,53,64,0,0
248,78,282,244,638,2,15,7,166,356,54,64,0,0
249,51,278,218,635,2,15,7,167,357,55,64,0,0
250,34,280,186,609,2,15,7,152,329,56,64,0,0
251,20,279,161,592,2,15,7,141,313,57,64,0,0
252,13,282,150,586,2,15,7,137,304,58,64,0,0
253,0,280,127,583,2,15,7,127,303,59,64,0,0
254,0,275,105,579,2,15,7,105,304,60,64,0,0
255,0,303,88,576,2,15,7,88,273,61,64,0,0
256,0,307,67,561,2,15,7,67,254,62,64,0,0
257,0,308,59,552,2,15,7,59,244,63,64,0,0
258,0,310,38,540,2,15,7,38,230,64,64,1,0
402,1,448,77,720,4,15,7,76,272,0,27,0,1
403,0,409,87,733,4,15,7,87,324,1,27,0,0
404,0,387,91,742,4,15,7,91,355,2,27,0,0
405,0,371,108,781,4,15,7,108,410,3,27,0,0
406,2,362,126,808,4,15,7,124,446,4,27,0,0
407,7,355,138,820,4,15,7,131,465,5,27,0,0
408,31,355,170,830,4,15,7,139,475,6,27,0,0
409,47,356,197,846,4,15,7,150,490,7,27,0,0
410,57,352,217,859,4,15,7,160,507,8,27,0,0
411,65,352,243,901,4,15,7,178,549,9,27,0,0
412,86,368,275,935,4,15,7,189,567,10,27,0,0
413,101,372,299,951,4,15,7,198,579,11,27,0,0
414,128,374,339,965,4,15,7,211,591,12,27,0,0
415,159,394,390,1019,4,15,7,231,625,13,27,0,0
416,179,397,425,1044,4,15,7,246,647,14,27,0,0
417,197,408,455,1065,4,15,7,258,657,15,27,0,0
418,226,431,490,1075,4,15,7,264,644,16,27,0,0
419,240,461,501,1078,4,15,7,261,617,17,27,0,0
420,262,480,526,1079,4,15,7,264,599,18,27,0,0
421,291,513,549,1076,4,15,7,258,563,19,27,0,0
422,337,542,594,1079,4,15,7,257,537,20,27,0,0
423,412,574,676,1078,4,15,7,264,504,21,27,0,0
424,470,622,733,1079,4,15,7,263,457,22,27,0,0
425,498,680,751,1080,4,15,7,253,400,23,27,0,0
426,516,724,755,1080,4,15,7,239,356,24,27,0,0
427,553,765,774,1080,4,15,7,221,315,25,27,0,0
428,655,812,849,1077,4,15,7,194,265,26,27,0,0
429,706,845,878,1080,4,15,7,172,235,27,27,1,0
599,1599,81,1634,180,11,15,7,35,99,0,2,0,0
600,1596,80,1633,181,11,15,7,37,101,1,2,0,0
601,1595,80,1632,182,11,15,7,37,102,2,2,0,0
591,1452,738,1788,1077,13,15,7,336,339,0,162,0,1
592,1305,697,1676,1070,13,15,7,371,373,1,162,0,0
593,1124,664,1524,1066,13,15,7,400,402,2,162,0,0
594,945,633,1384,1074,13,15,7,439,441,3,162,0,0
595,796,582,1284,1073,13,15,7,488,491,4,162,0,0
596,679,550,1192,1070,13,15,7,513,520,5,162,0,0
597,570,502,1115,1068,13,15,7,545,566,6,162,0,0
598,514,473,1066,1068,13,15,7,552,595,7,162,0,0
599,463,455,1014,1071,13,15,7,551,616,8,162,0,0
600,427,453,962,1072,13,15,7,535,619,9,162,0,0
601,388,438,918,1074,13,15,7,530,636,10,162,0,0
602,361,427,881,1074,13,15,7,520,647,11,162,0,0
603,370,418,877,1077,13,15,7,507,659,12,162,0,0
604,382,416,871,1079,13,15,7,489,663,13,162,0,0
605,389,414,860,1078,13,15,7,471,664,14,162,0,0
606,399,418,852,1078,13,15,7,453,660,15,162,0,0
607,404,424,840,1077,13,15,7,436,653,16,162,0,0
608,409,428,831,1076,13,15,7,422,648,17,162,0,0
609,418,428,831,1076,13,15,7,413,648,18,162,0,0
610,435,422,847,1079,13,15,7,412,657,19,162,0,0
611,449,411,861,1079,13,15,7,412,668,20,162,0,0
612,458,405,866,1076,13,15,7,408,671,21,162,0,0
613,468,396,870,1074,13,15,7,402,678,22,162,0,0
614,484,389,883,1074,13,15,7,399,685,23,162,0,0
615,512,382,907,1072,13,15,7,395,690,24,162,0,0
616,536,374,927,1071,13,15,7,391,697,25,162,0,0
617,543,362,931,1067,13,15,7,388,705,26,162,0,0
618,543,355,926,1066,13,15,7,383,711,27,162,0,0
619,541,357,916,1065,13,15,7,375,708,28,162,0,0
620,535,351,906,1064,13,15,7,371,713,29,162,0,0
621,528,339,893,1046,13,15,7,365,707,30,162,0,0
622,535,334,884,1010,13,15,7,349,676,31,162,0,0
623,552,335,896,988,13,15,7,344,653,32,162,0,0
624,558,337,900,976,13,15,7,342,639,33,162,0,0
625,559,339,903,973,13,15,7,344,634,34,162,0,0
626,566,341,907,966,13,15,7,341,625,35,162,0,0
627,568,327,915,963,13,15,7,347,636,36,162,0,0
628,569,317,920,963,13,15,7,351,646,37,162,0,0
629,571,313,924,963,13,15,7,353,650,38,162,0,0
630,572,324,921,964,13,15,7,349,640,39,162,0,0
631,570,328,918,963,13,15,7,348,635,40,162,0,0
632,569,327,920,965,13,15,7,351,638,41,162,0,0
633,567,322,921,967,13,15,7,354,645,42,162,0,0
634,563,318,922,968,13,15,7,359,650,43,162,0,0
635,558,322,917,969,13,15,7,359,647,44,162,0,0
636,559,335,912,970,13,15,7,353,635,45,162,0,0
637,559,342,911,970,13,15,7,352,628,46,162,0,0
638,560,343,913,970,13,15,7,353,627,47,162,0,0
639,566,348,916,970,13,15,7,350,622,48,162,0,0
640,568,346,920,970,13,15,7,352,624,49,162,0,0
641,570,347,922,970,13,15,7,352,623,50,162,0,0
642,572,350,921,971,13,15,7,349,621,51,162,0,0
643,574,352,922,970,13,15,7,348,618,52,162,0,0
644,565,349,916,969,13,15,7,351,620,53,162,0,0
645,563,348,915,968,13,15,7,352,620,54,162,0,0
646,565,345,920,970,13,15,7,355,625,55,162,0,0
647,568,349,920,971,13,15,7,352,622,56,162,0,0
648,568,348,921,971,13,15,7,353,623,57,162,0,0
649,569,345,923,970,13,15,7,354,625,58,162,0,0
650,570,344,923,970,13,15,7,353,626,59,162,0,0
651,570,342,924,971,13,15,7,354,629,60,162,0,0
652,570,342,924,973,13,15,7,354,631,61,162,0,0
653,572,342,925,974,13,15,7,353,632,62,162,0,0
654,574,344,926,974,13,15,7,352,630,63,162,0,0
655,575,343,926,972,13,15,7,351,629,64,162,0,0
656,578,348,925,974,13,15,7,347,626,65,162,0,0
657,579,350,925,976,13,15,7,346,626,66,162,0,0
658,579,353,924,978,13,15,7,345,625,67,162,0,0
659,578,353,924,979,13,15,7,346,626,68,162,0,0
660,579,354,924,980,13,15,7,345,626,69,162,0,0
661,587,355,927,972,13,15,7,340,617,70,162,0,0
662,586,357,926,973,13,15,7,340,616,71,162,0,0
663,586,352,928,971,13,15,7,342,619,72,162,0,0
664,586,351,928,971,13,15,7,342,620,73,162,0,0
665,588,351,928,971,13,15,7,340,620,74,162,0,0
666,584,351,926,972,13,15,7,342,621,75,162,0,0
667,582,351,924,973,13,15,7,342,622,76,162,0,0
668,582,352,923,973,13,15,7,341,621,77,162,0,0
669,582,354,922,973,13,15,7,340,619,78,162,0,0
670,582,356,920,973,13,15,7,338,617,79,162,0,0
671,581,356,919,974,13,15,7,338,618,80,162,0,0
672,581,358,918,974,13,15,7,337,616,81,162,0,0
673,580,359,917,974,13,15,7,337,615,82,162,0,0
674,578,357,917,974,13,15,7,339,617,83,162,0,0
675,578,359,918,975,13,15,7,340,616,84,162,0,0
676,579,360,919,975,13,15,7,340,615,85,162,0,0
677,578,356,920,975,13,15,7,342,619,86,162,0,0
678,579,354,922,975,13,15,7,343,621,87,162,0,0
679,584,355,925,973,13,15,7,341,618,88,162,0,0
680,597,358,937,976,13,15,7,340,618,89,162,0,0
681,618,353,962,979,13,15,7,344,626,90,162,0,0
682,644,356,980,980,13,15,7,336,624,91,162,0,0
683,676,356,1002,977,13,15,7,326,621,92,162,0,0
684,709,344,1020,955,13,15,7,311,611,93,162,0,0
685,731,332,1026,927,13,15,7,295,595,94,162,0,0
686,747,330,1033,926,13,15,7,286,596,95,162,0,0
687,759,330,1039,930,13,15,7,280,600,96,162,0,0
688,766,334,1051,963,13,15,7,285,629,97,162,0,0
689,775,342,1049,966,13,15,7,274,624,98,162,0,0
690,782,341,1048,963,13,15,7,266,622,99,162,0,0
691,792,346,1049,966,13,15,7,257,620,100,162,0,0
692,809,344,1060,964,13,15,7,251,620,101,162,0,0
693,831,337,1080,968,13,15,7,249,631,102,162,0,0
694,892,322,1113,900,13,15,7,221,578,103,162,0,0
695,939,306,1158,900,13,15,7,219,594,104,162,0,0
696,958,302,1176,894,13,15,7,218,592,105,162,0,0
697,1070,292,1270,845,13,15,7,200,553,106,162,0,0
698,1119,274,1318,821,13,15,7,199,547,107,162,0,0
699,1164,263,1376,823,13,15,7,212,560,108,162,0,0
700,1218,250,1418,770,13,15,7,200,520,109,162,0,0
701,1235,219,1424,720,13,15,7,189,501,110,162,0,0
702,1252,207,1434,697,13,15,7,182,490,111,162,0,0
703,1278,192,1444,643,13,15,7,166,451,112,162,0,0
704,1295,181,1454,618,13,15,7,159,437,113,162,0,0
705,1305,171,1457,598,13,15,7,152,427,114,162,0,0
706,1316,158,1457,555,13,15,7,141,397,115,162,0,0
707,1326,156,1458,532,13,15,7,132,376,116,162,0,0
708,1343,148,1466,498,13,15,7,123,350,117,162,0,0
709,1358,148,1474,482,13,15,7,116,334,118,162,0,0
710,1366,142,1482,478,13,15,7,116,336,119,162,0,0
711,1378,139,1483,447,13,15,7,105,308,120,162,0,0
712,1391,140,1491,432,13,15,7,100,292,121,162,0,0
713,1402,140,1497,419,13,15,7,95,279,122,162,0,0
714,1413,130,1505,403,13,15,7,92,273,123,162,0,0
715,1420,126,1512,400,13,15,7,92,274,124,162,0,0
716,1427,126,1513,385,13,15,7,86,259,125,162,0,0
717,1438,121,1521,373,13,15,7,83,252,126,162,0,0
718,1446,122,1527,366,13,15,7,81,244,127,162,0,0
719,1460,121,1535,349,13,15,7,75,228,128,162,0,0
720,1469,114,1545,343,13,15,7,76,229,129,162,0,0
721,1476,112,1550,338,13,15,7,74,226,130,162,0,0
722,1484,116,1553,323,13,15,7,69,207,131,162,0,0
723,1489,119,1555,320,13,15,7,66,201,132,162,0,0
724,1494,115,1559,313,13,15,7,65,198,133,162,0,0
725,1499,104,1564,305,13,15,7,65,201,134,162,0,0
726,1503,109,1564,298,13,15,7,61,189,135,162,0,0
727,1505,103,1564,285,13,15,7,59,182,136,162,0,0
728,1508,105,1566,283,13,15,7,58,178,137,162,0,0
729,1510,99,1570,281,13,15,7,60,182,138,162,0,0
730,1518,99,1575,275,13,15,7,57,176,139,162,0,0
731,1523,101,1579,269,13,15,7,56,168,140,162,0,0
732,1527,106,1579,262,13,15,7,52,156,141,162,0,0
733,1531,98,1585,262,13,15,7,54,164,142,162,0,0
734,1532,93,1586,260,13,15,7,54,167,143,162,0,0
735,1538,98,1590,255,13,15,7,52,157,144,162,0,0
736,1543,94,1593,249,13,15,7,50,155,145,162,0,0
737,1547,93,1597,247,13,15,7,50,154,146,162,0,0
738,1550,91,1599,240,13,15,7,49,149,147,162,0,0
739,1553,88,1601,237,13,15,7,48,149,148,162,0,0
740,1558,90,1605,234,13,15,7,47,144,149,162,0,0
741,1566,86,1612,228,13,15,7,46,142,150,162,0,0
742,1571,87,1615,225,13,15,7,44,138,151,162,0,0
743,1576,86,1619,221,13,15,7,43,135,152,162,0,0
744,1579,83,1623,220,13,15,7,44,137,153,162,0,0
745,1583,83,1626,219,13,15,7,43,136,154,162,0,0
746,1588,78,1631,214,13,15,7,43,136,155,162,0,0
747,1591,73,1634,212,13,15,7,43,139,156,162,0,0
748,1593,71,1635,210,13,15,7,42,139,157,162,0,0
749,1595,73,1634,202,13,15,7,39,129,158,162,0,0
750,1596,73,1634,200,13,15,7,38,127,159,162,0,0
751,1597,74,1634,198,13,15,7,37,124,160,162,0,0
752,1598,73,1635,198,13,15,7,37,125,161,162,0,0
753,1598,72,1635,197,13,15,7,37,125,162,162,1,0
755,1597,77,1632,192,13,15,7,35,115,0,162,0,0
756,1596,78,1631,191,13,15,7,35,113,1,162,0,0
605,1589,85,1625,191,14,15,7,36,106,0,121,0,1
606,1588,84,1625,194,14,15,7,37,110,1,121,0,0
607,1586,86,1624,196,14,15,7,38,110,2,121,0,0
608,1584,86,1623,198,14,15,7,39,112,3,121,0,0
609,1581,86,1621,200,14,15,7,40,114,4,121,0,0
610,1578,87,1620,202,14,15,7,42,115,5,121,0,0
611,1576,89,1619,206,14,15,7,43,117,6,121,0,0
612,1573,91,1618,208,14,15,7,45,117,7,121,0,0
613,1572,91,1617,210,14,15,7,45,119,8,121,0,0
614,1570,93,1616,211,14,15,7,46,118,9,121,0,0
615,1569,93,1614,211,14,15,7,45,118,10,121,0,0
616,1568,94,1617,218,14,15,7,49,124,11,121,0,0
617,1568,94,1619,223,14,15,7,51,129,12,121,0,0
618,1566,92,1619,227,14,15,7,53,135,13,121,0,0
619,1565,94,1618,230,14,15,7,53,136,14,121,0,0
620,1565,96,1619,231,14,15,7,54,135,15,121,0,0
621,1565,98,1619,235,14,15,7,54,137,16,121,0,0
622,1562,99,1618,240,14,15,7,56,141,17,121,0,0
623,1560,100,1617,244,14,15,7,57,144,18,121,0,0
624,1558,103,1616,250,14,15,7,58,147,19,121,0,0
625,1555,102,1613,252,14,15,7,58,150,20,121,0,0
626,1554,110,1609,255,14,15,7,55,145,21,121,0,0
627,1551,113,1607,258,14,15,7,56,145,22,121,0,0
628,1547,114,1605,263,14,15,7,58,149,23,121,0,0
629,1542,113,1602,271,14,15,7,60,158,24,121,0,0
630,1536,112,1598,273,14,15,7,62,161,25,121,0,0
631,1534,113,1596,277,14,15,7,62,164,26,121,0,0
632,1533,114,1596,281,14,15,7,63,167,27,121,0,0
633,1528,114,1593,290,14,15,7,65,176,28,121,0,0
634,1524,116,1591,297,14,15,7,67,181,29,121,0,0
635,1518,115,1587,302,14,15,7,69,187,30,121,0,0
636,1516,114,1587,309,14,15,7,71,195,31,121,0,0
637,1510,115,1584,319,14,15,7,74,204,32,121,0,0
638,1502,106,1582,326,14,15,7,80,220,33,121,0,0
639,1495,117,1572,331,14,15,7,77,214,34,121,0,0
640,1485,119,1563,337,14,15,7,78,218,35,121,0,0
641,1480,129,1556,343,14,15,7,76,214,36,121,0,0
642,1472,129,1552,350,14,15,7,80,221,37,121,0,0
643,1464,134,1544,356,14,15,7,80,222,38,121,0,0
644,1455,136,1538,367,14,15,7,83,231,39,121,0,0
645,1444,136,1529,371,14,15,7,85,235,40,121,0,0
646,1436,138,1525,384,14,15,7,89,246,41,121,0,0
647,1430,138,1526,401,14,15,7,96,263,42,121,0,0
648,1424,141,1520,403,14,15,7,96,262,43,121,0,0
649,1413,147,1513,419,14,15,7,100,272,44,121,0,0
650,1402,149,1505,428,14,15,7,103,279,45,121,0,0
651,1388,155,1501,458,14,15,7,113,303,46,121,0,0
652,1381,158,1499,474,14,15,7,118,316,47,121,0,0
653,1372,161,1493,486,14,15,7,121,325,48,121,0,0
654,1358,170,1482,501,14,15,7,124,331,49,121,0,0
655,1343,169,1472,511,14,15,7,129,342,50,121,0,0
656,1330,178,1469,546,14,15,7,139,368,51,121,0,0
657,1322,180,1469,568,14,15,7,147,388,52,121,0,0
658,1317,189,1466,580,14,15,7,149,391,53,121,0,0
659,1298,197,1457,613,14,15,7,159,416,54,121,0,0
660,1281,204,1445,629,14,15,7,164,425,55,121,0,0
661,1261,215,1439,672,14,15,7,178,457,56,121,0,0
662,1245,233,1431,703,14,15,7,186,470,57,121,0,0
663,1235,241,1427,719,14,15,7,192,478,58,121,0,0
664,1213,260,1416,760,14,15,7,203,500,59,121,0,0
665,1184,269,1398,787,14,15,7,214,518,60,121,0,0
666,1150,283,1380,826,14,15,7,230,543,61,121,0,0
667,1125,309,1373,890,14,15,7,248,581,62,121,0,0
668,1120,322,1376,914,14,15,7,256,592,63,121,0,0
669,1103,336,1367,940,14,15,7,264,604,64,121,0,0
670,1068,367,1352,1000,14,15,7,284,633,65,121,0,0
671,1051,381,1347,1033,14,15,7,296,652,66,121,0,0
672,1064,395,1362,1050,14,15,7,298,655,67,121,0,0
673,1081,417,1375,1070,14,15,7,294,653,68,121,0,0
674,1093,422,1388,1073,14,15,7,295,651,69,121,0,0
675,1102,430,1396,1076,14,15,7,294,646,70,121,0,0
676,1118,437,1411,1080,14,15,7,293,643,71,121,0,0
677,1126,436,1420,1080,14,15,7,294,644,72,121,0,0
678,1129,437,1423,1080,14,15,7,294,643,73,121,0,0
679,1110,442,1408,1080,14,15,7,298,638,74,121,0,0
680,1118,445,1416,1077,14,15,7,298,632,75,121,0,0
681,1096,443,1405,1078,14,15,7,309,635,76,121,0,0
682,1066,446,1383,1078,14,15,7,317,632,77,121,0,0
683,1041,447,1363,1080,14,15,7,322,633,78,121,0,0
684,1010,445,1336,1080,14,15,7,326,635,79,121,0,0
685,984,448,1313,1080,14,15,7,329,632,80,121,0,0
686,964,446,1298,1080,14,15,7,334,634,81,121,0,0
687,962,438,1299,1080,14,15,7,337,642,82,121,0,0
688,966,433,1305,1080,14,15,7,339,647,83,121,0,0
689,981,427,1321,1080,14,15,7,340,653,84,121,0,0
690,996,434,1333,1080,14,15,7,337,646,85,121,0,0
691,1021,441,1362,1080,14,15,7,341,639,86,121,0,0
692,1045,448,1385,1073,14,15,7,340,625,87,121,0,0
693,1019,441,1363,1074,14,15,7,344,633,88,121,0,0
694,1002,439,1349,1078,14,15,7,347,639,89,121,0,0
695,982,437,1328,1075,14,15,7,346,638,90,121,0,0
696,958,418,1311,1074,14,15,7,353,656,91,121,0,0
697,894,437,1236,1072,14,15,7,342,635,92,121,0,0
698,860,442,1193,1069,14,15,7,333,627,93,121,0,0
699,794,430,1127,1058,14,15,7,333,628,94,121,0,0
700,718,406,1055,1060,14,15,7,337,654,95,121,0,0
701,666,413,989,1047,14,15,7,323,634,96,121,0,0
702,619,401,934,1008,14,15,7,315,607,97,121,0,0
703,519,373,815,955,14,15,7,296,582,98,121,0,0
704,461,369,749,944,14,15,7,288,575,99,121,0,0
705,394,343,676,912,14,15,7,282,569,100,121,0,0
706,342,330,603,861,14,15,7,261,531,101,121,0,0
707,326,330,569,824,14,15,7,243,494,102,121,0,0
708,278,316,508,787,14,15,7,230,471,103,121,0,0
709,236,308,462,774,14,15,7,226,466,104,121,0,0
710,199,299,416,751,14,15,7,217,452,105,121,0,0
711,168,295,369,716,14,15,7,201,421,106,121,0,0
712,153,304,341,695,14,15,7,188,391,107,121,0,0
713,128,306,303,671,14,15,7,175,365,108,121,0,0
714,96,297,269,665,14,15,7,173,368,109,121,0,0
715,74,288,246,655,14,15,7,172,367,110,121,0,0
716,53,284,211,626,14,15,7,158,342,111,121,0,0
717,46,289,195,609,14,15,7,149,320,112,121,0,0
718,25,285,169,594,14,15,7,144,309,113,121,0,0
719,1,284,143,589,14,15,7,142,305,114,121,0,0
720,0,283,125,579,14,15,7,125,296,115,121,0,0
721,0,274,107,563,14,15,7,107,289,116,121,0,0
722,0,275,98,553,14,15,7,98,278,117,121,0,0
723,0,290,81,542,14,15,7,81,252,118,121,0,0
724,0,294,72,539,14,15,7,72,245,119,121,0,0
725,0,295,62,534,14,15,7,62,239,120,121,0,0
726,0,295,43,522,14,15,7,43,227,121,121,1,0
1736,1599,75,1635,184,17,15,7,36,109,0,80,0,1
1737,1597,79,1634,188,17,15,7,37,109,1,80,0,0
1738,1596,75,1634,187,17,15,7,38,112,2,80,0,0
1739,1593,73,1634,191,17,15,7,41,118,3,80,0,0
1740,1591,75,1632,195,17,15,7,41,120,4,80,0,0
1741,1588,76,1629,197,17,15,7,41,121,5,80,0,0
1742,1584,74,1627,200,17,15,7,43,126,6,80,0,0
1743,1583,78,1625,202,17,15,7,42,124,7,80,0,0
1744,1580,76,1623,204,17,15,7,43,128,8,80,0,0
1745,1577,77,1622,208,17,15,7,45,131,9,80,0,0
1746,1575,77,1620,209,17,15,7,45,132,10,80,0,0
1747,1572,80,1617,213,17,15,7,45,133,11,80,0,0
1748,1571,84,1616,217,17,15,7,45,133,12,80,0,0
1749,1569,82,1615,217,17,15,7,46,135,13,80,0,0
1750,1567,84,1613,222,17,15,7,46,138,14,80,0,0
1751,1565,86,1611,224,17,15,7,46,138,15,80,0,0
1752,1562,85,1609,227,17,15,7,47,142,16,80,0,0
1753,1560,88,1606,231,17,15,7,46,143,17,80,0,0
1754,1559,91,1606,233,17,15,7,47,142,18,80,0,0
1755,1558,90,1607,238,17,15,7,49,148,19,80,0,0
1756,1554,91,1604,243,17,15,7,50,152,20,80,0,0
1757,1550,90,1601,247,17,15,7,51,157,21,80,0,0
1758,1545,89,1599,254,17,15,7,54,165,22,80,0,0
1759,1544,96,1597,259,17,15,7,53,163,23,80,0,0
1760,1542,92,1596,261,17,15,7,54,169,24,80,0,0
1761,1541,98,1594,267,17,15,7,53,169,25,80,0,0
1762,1538,100,1592,270,17,15,7,54,170,26,80,0,0
1763,1534,99,1589,273,17,15,7,55,174,27,80,0,0
1764,1533,105,1587,276,17,15,7,54,171,28,80,0,0
1765,1532,108,1587,282,17,15,7,55,174,29,80,0,0
1766,1529,110,1585,290,17,15,7,56,180,30,80,0,0
1767,1525,112,1582,296,17,15,7,57,184,31,80,0,0
1768,1520,111,1579,301,17,15,7,59,190,32,80,0,0
1769,1515,109,1576,305,17,15,7,61,196,33,80,0,0
1770,1511,105,1575,313,17,15,7,64,208,34,80,0,0
1771,1507,108,1573,322,17,15,7,66,214,35,80,0,0
1772,1503,110,1571,332,17,15,7,68,222,36,80,0,0
1773,1498,109,1567,339,17,15,7,69,230,37,80,0,0
1774,1493,109,1565,348,17,15,7,72,239,38,80,0,0
1775,1491,118,1563,359,17,15,7,72,241,39,80,0,0
1776,1488,111,1563,363,17,15,7,75,252,40,80,0,0
1777,1480,118,1558,378,17,15,7,78,260,41,80,0,0
1778,1470,125,1551,390,17,15,7,81,265,42,80,0,0
1779,1459,125,1543,399,17,15,7,84,274,43,80,0,0
1780,1450,128,1537,407,17,15,7,87,279,44,80,0,0
1781,1438,131,1530,423,17,15,7,92,292,45,80,0,0
1782,1426,132,1524,440,17,15,7,98,308,46,80,0,0
1783,1414,142,1515,458,17,15,7,101,316,47,80,0,0
1784,1399,144,1504,471,17,15,7,105,327,48,80,0,0
1785,1388,150,1496,487,17,15,7,108,337,49,80,0,0
1786,1374,158,1490,520,17,15,7,116,362,50,80,0,0
1787,1367,159,1487,531,17,15,7,120,372,51,80,0,0
1788,1344,173,1468,553,17,15,7,124,380,52,80,0,0
1789,1320,174,1453,578,17,15,7,133,404,53,80,0,0
1790,1297,174,1440,610,17,15,7,143,436,54,80,0,0
1791,1266,184,1416,632,17,15,7,150,448,55,80,0,0
1792,1243,199,1402,672,17,15,7,159,473,56,80,0,0
1793,1216,205,1380,691,17,15,7,164,486,57,80,0,0
1794,1169,221,1344,726,17,15,7,175,505,58,80,0,0
1795,1127,227,1310,756,17,15,7,183,529,59,80,0,0
1796,1067,245,1266,812,17,15,7,199,567,60,80,0,0
1797,1004,273,1216,860,17,15,7,212,587,61,80,0,0
1798,949,282,1161,874,17,15,7,212,592,62,80,0,0
1799,862,298,1084,881,17,15,7,222,583,63,80,0,0
1800,813,311,1044,888,17,15,7,231,577,64,80,0,0
1801,697,310,930,891,17,15,7,233,581,65,80,0,0
1802,593,317,836,904,17,15,7,243,587,66,80,0,0
1803,526,325,778,909,17,15,7,252,584,67,80,0,0
1804,405,329,652,906,17,15,7,247,577,68,80,0,0
1805,299,331,559,901,17,15,7,260,570,69,80,0,0
1806,226,335,473,872,17,15,7,247,537,70,80,0,0
1807,173,330,414,860,17,15,7,241,530,71,80,0,0
1808,138,342,369,845,17,15,7,231,503,72,80,0,0
1809,79,335,299,817,17,15,7,220,482,73,80,0,0
1810,19,333,235,805,17,15,7,216,472,74,80,0,0
1811,0,334,197,790,17,15,7,197,456,75,80,0,0
1812,0,331,154,750,17,15,7,154,419,76,80,0,0
1813,0,329,140,727,17,15,7,140,398,77,80,0,0
1814,0,370,115,705,17,15,7,115,335,78,80,0,0
1815,0,382,85,689,17,15,7,85,307,79,80,0,0
1816,0,401,67,682,17,15,7,67,281,80,80,1,0
1816,1,587,43,691,18,15,7,42,104,0,0,0,0
2404,4,310,42,554,19,15,7,38,244,0,82,0,1
2405,10,299,53,566,19,15,7,43,267,1,82,0,0
2406,13,289,61,578,19,15,7,48,289,2,82,0,0
2407,15,282,70,602,19,15,7,55,320,3,82,0,0
2408,17,282,75,615,19,15,7,58,333,4,82,0,0
2409,34,289,99,629,19,15,7,65,340,5,82,0,0
2410,40,297,112,644,19,15,7,72,347,6,82,0,0
2411,43,295,125,670,19,15,7,82,375,7,82,0,0
2412,56,306,148,700,19,15,7,92,394,8,82,0,0
2413,73,306,173,714,19,15,7,100,408,9,82,0,0
2414,113,317,224,730,19,15,7,111,413,10,82,0,0
2415,142,316,262,743,19,15,7,120,427,11,82,0,0
2416,166,310,306,790,19,15,7,140,480,12,82,0,0
2417,200,318,352,819,19,15,7,152,501,13,82,0,0
2418,243,319,404,832,19,15,7,161,513,14,82,0,0
2419,319,334,494,849,19,15,7,175,515,15,82,0,0
2420,375,336,560,862,19,15,7,185,526,16,82,0,0
2421,447,340,652,902,19,15,7,205,562,17,82,0,0
2422,527,345,744,923,19,15,7,217,578,18,82,0,0
2423,604,336,827,931,19,15,7,223,595,19,82,0,0
2424,715,337,950,935,19,15,7,235,598,20,82,0,0
2425,815,325,1046,919,19,15,7,231,594,21,82,0,0
2426,935,309,1172,899,19,15,7,237,590,22,82,0,0
2427,1008,305,1245,887,19,15,7,237,582,23,82,0,0
2428,1114,293,1344,862,19,15,7,230,569,24,82,0,0
2429,1192,291,1420,844,19,15,7,228,553,25,82,0,0
2430,1250,272,1459,784,19,15,7,209,512,26,82,0,0
2431,1287,261,1483,746,19,15,7,196,485,27,82,0,0
2432,1325,259,1506,708,19,15,7,181,449,28,82,0,0
2433,1358,239,1536,680,19,15,7,178,441,29,82,0,0
2434,1366,234,1541,667,19,15,7,175,433,30,82,0,0
2435,1387,215,1548,616,19,15,7,161,401,31,82,0,0
2436,1400,202,1552,588,19,15,7,152,386,32,82,0,0
2437,1409,192,1552,559,19,15,7,143,367,33,82,0,0
2438,1419,178,1557,534,19,15,7,138,356,34,82,0,0
2439,1421,177,1556,526,19,15,7,135,349,35,82,0,0
2440,1425,169,1550,493,19,15,7,125,324,36,82,0,0
2441,1431,158,1551,474,19,15,7,120,316,37,82,0,0
2442,1437,154,1554,461,19,15,7,117,307,38,82,0,0
2443,1446,146,1559,441,19,15,7,113,295,39,82,0,0
2444,1451,152,1559,433,19,15,7,108,281,40,82,0,0
2445,1451,145,1555,416,19,15,7,104,271,41,82,0,0
2446,1456,142,1553,398,19,15,7,97,256,42,82,0,0
2447,1463,136,1559,389,19,15,7,96,253,43,82,0,0
2448,1469,129,1563,376,19,15,7,94,247,44,82,0,0
2449,1475,130,1567,374,19,15,7,92,244,45,82,0,0
2450,1476,126,1564,364,19,15,7,88,238,46,82,0,0
2451,1482,121,1566,352,19,15,7,84,231,47,82,0,0
2452,1492,130,1569,344,19,15,7,77,214,48,82,0,0
2453,1498,117,1578,338,19,15,7,80,221,49,82,0,0
2454,1505,113,1585,335,19,15,7,80,222,50,82,0,0
2455,1509,110,1586,327,19,15,7,77,217,51,82,0,0
2456,1514,106,1588,321,19,15,7,74,215,52,82,0,0
2457,1517,99,1591,319,19,15,7,74,220,53,82,0,0
2458,1528,106,1596,309,19,15,7,68,203,54,82,0,0
2459,1534,109,1599,303,19,15,7,65,194,55,82,0,0
2460,1537,109,1600,297,19,15,7,63,188,56,82,0,0
2461,1539,109,1599,289,19,15,7,60,180,57,82,0,0
2462,1541,109,1599,286,19,15,7,58,177,58,82,0,0
2463,1547,110,1603,280,19,15,7,56,170,59,82,0,0
2464,1553,111,1607,275,19,15,7,54,164,60,82,0,0
2465,1555,110,1608,271,19,15,7,53,161,61,82,0,0
2466,1557,110,1608,265,19,15,7,51,155,62,82,0,0
2467,1560,105,1610,262,19,15,7,50,157,63,82,0,0
2468,1564,102,1614,256,19,15,7,50,154,64,82,0,0
2469,1569,99,1619,252,19,15,7,50,153,65,82,0,0
2470,1572,100,1619,248,19,15,7,47,148,66,82,0,0
2471,1572,94,1621,246,19,15,7,49,152,67,82,0,0
2472,1575,94,1622,243,19,15,7,47,149,68,82,0,0
2473,1579,94,1625,238,19,15,7,46,144,69,82,0,0
2474,1583,95,1628,235,19,15,7,45,140,70,82,0,0
2475,1586,91,1630,229,19,15,7,44,138,71,82,0,0
2476,1588,90,1631,226,19,15,7,43,136,72,82,0,0
2477,1589,91,1631,224,19,15,7,42,133,73,82,0,0
2478,1593,89,1635,221,19,15,7,42,132,74,82,0,0
2479,1598,90,1639,219,19,15,7,41,129,75,82,0,0
2480,1601,88,1641,215,19,15,7,40,127,76,82,0,0
2481,1604,87,1643,211,19,15,7,39,124,77,82,0,0
2482,1605,89,1644,210,19,15,7,39,121,78,82,0,0
2483,1609,92,1646,207,19,15,7,37,115,79,82,0,0
2484,1614,92,1650,206,19,15,7,36,114,80,82,0,0
2485,1617,93,1653,205,19,15,7,36,112,81,82,0,0
2486,1619,91,1654,202,19,15,7,35,111,82,82,1,0
2727,17,293,55,531,20,15,7,38,238,0,134,0,1
2728,18,297,59,542,20,15,7,41,245,1,134,0,0
2729,22,295,68,549,20,15,7,46,254,2,134,0,0
2730,35,302,86,554,20,15,7,51,252,3,134,0,0
2731,44,302,101,560,20,15,7,57,258,4,134,0,0
2732,46,301,110,569,20,15,7,64,268,5,134,0,0
2733,52,304,122,585,20,15,7,70,281,6,134,0,0
2734,61,307,135,590,20,15,7,74,283,7,134,0,0
2735,81,310,163,597,20,15,7,82,287,8,134,0,0
2736,93,312,180,602,20,15,7,87,290,9,134,0,0
2737,101,309,197,623,20,15,7,96,314,10,134,0,0
2738,115,313,217,635,20,15,7,102,322,11,134,0,0
2739,133,318,239,643,20,15,7,106,325,12,134,0,0
2740,168,321,283,654,20,15,7,115,333,13,134,0,0
2741,185,317,306,660,20,15,7,121,343,14,134,0,0
2742,199,320,327,676,20,15,7,128,356,15,134,0,0
2743,219,329,355,703,20,15,7,136,374,16,134,0,0
2744,243,334,383,714,20,15,7,140,380,17,134,0,0
2745,286,344,433,725,20,15,7,147,381,18,134,0,0
2746,314,346,468,738,20,15,7,154,392,19,134,0,0
2747,337,347,505,770,20,15,7,168,423,20,134,0,0
2748,366,353,539,791,20,15,7,173,438,21,134,0,0
2749,404,359,582,803,20,15,7,178,444,22,134,0,0
2750,468,372,654,817,20,15,7,186,445,23,134,0,0
2751,510,370,700,828,20,15,7,190,458,24,134,0,0
2752,569,371,775,864,20,15,7,206,493,25,134,0,0
2753,622,381,835,889,20,15,7,213,508,26,134,0,0
2754,699,388,909,894,20,15,7,210,506,27,134,0,0
2755,773,383,993,900,20,15,7,220,517,28,134,0,0
2756,855,380,1065,883,20,15,7,210,503,29,134,0,0
2757,956,378,1175,893,20,15,7,219,515,30,134,0,0
2758,1014,380,1233,884,20,15,7,219,504,31,134,0,0
2759,1105,373,1322,876,20,15,7,217,503,32,134,0,0
2760,1161,369,1376,862,20,15,7,215,493,33,134,0,0
2761,1214,346,1418,814,20,15,7,204,468,34,134,0,0
2762,1255,336,1452,786,20,15,7,197,450,35,134,0,0
2763,1283,322,1481,770,20,15,7,198,448,36,134,0,0
2764,1329,308,1518,731,20,15,7,189,423,37,134,0,0
2765,1342,298,1528,716,20,15,7,186,418,38,134,0,0
2766,1364,283,1538,675,20,15,7,174,392,39,134,0,0
2767,1383,279,1548,653,20,15,7,165,374,40,134,0,0
2768,1395,273,1557,635,20,15,7,162,362,41,134,0,0
2769,1420,255,1578,607,20,15,7,158,352,42,134,0,0
2770,1424,244,1581,600,20,15,7,157,356,43,134,0,0
2771,1435,234,1581,568,20,15,7,146,334,44,134,0,0
2772,1451,232,1590,548,20,15,7,139,316,45,134,0,0
2773,1461,228,1596,532,20,15,7,135,304,46,134,0,0
2774,1481,218,1616,520,20,15,7,135,302,47,134,0,0
2775,1487,213,1621,517,20,15,7,134,304,48,134,0,0
2776,1495,207,1622,497,20,15,7,127,290,49,134,0,0
2777,1509,204,1633,483,20,15,7,124,279,50,134,0,0
2778,1521,200,1643,476,20,15,7,122,276,51,134,0,0
2779,1535,192,1657,464,20,15,7,122,272,52,134,0,0
2780,1544,190,1663,458,20,15,7,119,268,53,134,0,0
2781,1555,188,1667,440,20,15,7,112,252,54,134,0,0
2782,1565,183,1675,429,20,15,7,110,246,55,134,0,0
2783,1569,182,1679,427,20,15,7,110,245,56,134,0,0
2784,1583,178,1689,411,20,15,7,106,233,57,134,0,0
2785,1589,176,1691,398,20,15,7,102,222,58,134,0,0
2786,1590,174,1689,391,20,15,7,99,217,59,134,0,0
2787,1597,173,1693,384,20,15,7,96,211,60,134,0,0
2788,1602,172,1701,385,20,15,7,99,213,61,134,0,0
2789,1607,167,1704,376,20,15,7,97,209,62,134,0,0
2790,1610,166,1704,365,20,15,7,94,199,63,134,0,0
2791,1608,160,1703,364,20,15,7,95,204,64,134,0,0
2792,1607,153,1703,358,20,15,7,96,205,65,134,0,0
2793,1611,155,1701,350,20,15,7,90,195,66,134,0,0
2794,1616,153,1702,338,20,15,7,86,185,67,134,0,0
2795,1615,152,1702,336,20,15,7,87,184,68,134,0,0
2796,1611,147,1696,333,20,15,7,85,186,69,134,0,0
2797,1610,144,1693,328,20,15,7,83,184,70,134,0,0
2798,1612,145,1692,323,20,15,7,80,178,71,134,0,0
2799,1621,143,1697,311,20,15,7,76,168,72,134,0,0
2800,1623,142,1699,306,20,15,7,76,164,73,134,0,0
2801,1622,142,1696,305,20,15,7,74,163,74,134,0,0
2802,1622,137,1694,299,20,15,7,72,162,75,134,0,0
2803,1625,138,1697,297,20,15,7,72,159,76,134,0,0
2804,1629,134,1699,292,20,15,7,70,158,77,134,0,0
2805,1630,131,1699,287,20,15,7,69,156,78,134,0,0
2806,1628,129,1697,287,20,15,7,69,158,79,134,0,0
2807,1628,127,1695,280,20,15,7,67,153,80,134,0,0
2808,1631,129,1694,275,20,15,7,63,146,81,134,0,0
2809,1634,125,1696,270,20,15,7,62,145,82,134,0,0
2810,1634,124,1695,265,20,15,7,61,141,83,134,0,0
2811,1632,122,1694,267,20,15,7,62,145,84,134,0,0
2812,1632,119,1692,263,20,15,7,60,144,85,134,0,0
2813,1635,119,1692,258,20,15,7,57,139,86,134,0,0
2814,1637,119,1692,254,20,15,7,55,135,87,134,0,0
2815,1638,119,1691,249,20,15,7,53,130,88,134,0,0
2816,1637,118,1690,247,20,15,7,53,129,89,134,0,0
2817,1635,116,1688,246,20,15,7,53,130,90,134,0,0
2818,1637,118,1689,243,20,15,7,52,125,91,134,0,0
2819,1638,116,1690,241,20,15,7,52,125,92,134,0,0
2820,1640,116,1690,236,20,15,7,50,120,93,134,0,0
2821,1639,115,1688,235,20,15,7,49,120,94,134,0,0
2822,1638,113,1688,234,20,15,7,50,121,95,134,0,0
2823,1640,112,1688,229,20,15,7,48,117,96,134,0,0
2824,1643,113,1690,230,20,15,7,47,117,97,134,0,0
2825,1647,111,1694,229,20,15,7,47,118,98,134,0,0
2826,1649,109,1695,226,20,15,7,46,117,99,134,0,0
2827,1650,108,1696,225,20,15,7,46,117,100,134,0,0
2828,1652,107,1695,216,20,15,7,43,109,101,134,0,0
2829,1655,107,1698,215,20,15,7,43,108,102,134,0,0
2830,1658,104,1702,215,20,15,7,44,111,103,134,0,0
2831,1661,105,1704,213,20,15,7,43,108,104,134,0,0
2832,1662,104,1705,212,20,15,7,43,108,105,134,0,0
2833,1663,103,1705,207,20,15,7,42,104,106,134,0,0
2834,1664,104,1706,207,20,15,7,42,103,107,134,0,0
2835,1665,103,1706,207,20,15,7,41,104,108,134,0,0
2836,1667,102,1707,201,20,15,7,40,99,109,134,0,0
2837,1667,101,1707,201,20,15,7,40,100,110,134,0,0
2838,1667,101,1707,200,20,15,7,40,99,111,134,0,0
2839,1667,102,1706,197,20,15,7,39,95,112,134,0,0
2840,1668,101,1708,200,20,15,7,40,99,113,134,0,0
2841,1669,100,1707,195,20,15,7,38,95,114,134,0,0
2842,1669,99,1707,190,20,15,7,38,91,115,134,0,0
2843,1668,97,1707,192,20,15,7,39,95,116,134,0,0
2844,1669,97,1706,184,20,15,7,37,87,117,134,0,0
2845,1668,99,1705,188,20,15,7,37,89,118,134,0,0
2846,1667,97,1707,190,20,15,7,40,93,119,134,0,0
2847,1667,97,1706,189,20,15,7,39,92,120,134,0,0
2848,1666,97,1704,188,20,15,7,38,91,121,134,0,0
2849,1666,96,1703,183,20,15,7,37,87,122,134,0,0
2850,1666,96,1704,182,20,15,7,38,86,123,134,0,0
2851,1666,95,1704,183,20,15,7,38,88,124,134,0,0
2852,1665,94,1704,182,20,15,7,39,88,125,134,0,0
2853,1663,92,1702,182,20,15,7,39,90,126,134,0,0
2854,1662,93,1699,180,20,15,7,37,87,127,134,0,0
2855,1661,92,1699,179,20,15,7,38,87,128,134,0,0
2856,1663,93,1700,178,20,15,7,37,85,129,134,0,0
2857,1664,91,1699,175,20,15,7,35,84,130,134,0,0
2858,1663,92,1698,173,20,15,7,35,81,131,134,0,0
2859,1661,89,1697,174,20,15,7,36,85,132,134,0,0
2860,1660,89,1695,169,20,15,7,35,80,133,134,0,0
2861,1660,88,1695,169,20,15,7,35,81,134,134,1,0
4939,1616,81,1651,179,25,15,7,35,98,0,81,0,0
4941,1615,83,1650,182,25,15,7,35,99,0,81,0,0
4942,1614,86,1649,185,25,15,7,35,99,1,81,0,0
4945,1614,90,1650,191,25,15,7,36,101,0,81,0,1
4946,1613,89,1649,192,25,15,7,36,103,1,81,0,0
4947,1612,87,1649,192,25,15,7,37,105,2,81,0,0
4948,1611,91,1647,194,25,15,7,36,103,3,81,0,0
4949,1610,93,1646,195,25,15,7,36,102,4,81,0,0
4950,1608,90,1646,197,25,15,7,38,107,5,81,0,0
4951,1606,91,1645,199,25,15,7,39,108,6,81,0,0
4952,1604,91,1643,201,25,15,7,39,110,7,81,0,0
4953,1602,92,1641,203,25,15,7,39,111,8,81,0,0
4954,1603,93,1642,205,25,15,7,39,112,9,81,0,0
4955,1604,94,1642,203,25,15,7,38,109,10,81,0,0
4956,1603,96,1642,206,25,15,7,39,110,11,81,0,0
4957,1600,95,1640,208,25,15,7,40,113,12,81,0,0
4958,1598,94,1640,212,25,15,7,42,118,13,81,0,0
4959,1599,97,1641,215,25,15,7,42,118,14,81,0,0
4960,1599,98,1641,215,25,15,7,42,117,15,81,0,0
4961,1598,98,1640,218,25,15,7,42,120,16,81,0,0
4962,1596,98,1640,221,25,15,7,44,123,17,81,0,0
4963,1594,99,1638,224,25,15,7,44,125,18,81,0,0
4964,1593,102,1637,227,25,15,7,44,125,19,81,0,0
4965,1593,101,1638,229,25,15,7,45,128,20,81,0,0
4966,1593,103,1640,233,25,15,7,47,130,21,81,0,0
4967,1593,107,1639,237,25,15,7,46,130,22,81,0,0
4968,1591,107,1637,237,25,15,7,46,130,23,81,0,0
4969,1588,108,1636,242,25,15,7,48,134,24,81,0,0
4970,1586,111,1634,247,25,15,7,48,136,25,81,0,0
4971,1584,110,1632,248,25,15,7,48,138,26,81,0,0
4972,1581,113,1631,250,25,15,7,50,137,27,81,0,0
4973,1577,114,1628,257,25,15,7,51,143,28,81,0,0
4974,1574,113,1625,260,25,15,7,51,147,29,81,0,0
4975,1572,115,1626,266,25,15,7,54,151,30,81,0,0
4976,1573,115,1627,268,25,15,7,54,153,31,81,0,0
4977,1573,115,1629,273,25,15,7,56,158,32,81,0,0
4978,1570,116,1627,278,25,15,7,57,162,33,81,0,0
4979,1567,117,1625,280,25,15,7,58,163,34,81,0,0
4980,1564,118,1623,284,25,15,7,59,166,35,81,0,0
4981,1565,119,1626,291,25,15,7,61,172,36,81,0,0
4982,1565,118,1628,295,25,15,7,63,177,37,81,0,0
4983,1563,121,1627,301,25,15,7,64,180,38,81,0,0
4984,1559,119,1625,305,25,15,7,66,186,39,81,0,0
4985,1556,120,1624,313,25,15,7,68,193,40,81,0,0
4986,1554,122,1622,319,25,15,7,68,197,41,81,0,0
4987,1552,125,1621,324,25,15,7,69,199,42,81,0,0
4988,1547,127,1618,328,25,15,7,71,201,43,81,0,0
4989,1542,134,1612,335,25,15,7,70,201,44,81,0,0
4990,1535,137,1606,340,25,15,7,71,203,45,81,0,0
4991,1532,139,1602,343,25,15,7,70,204,46,81,0,0
4992,1529,140,1603,353,25,15,7,74,213,47,81,0,0
4993,1526,140,1602,356,25,15,7,76,216,48,81,0,0
4994,1520,142,1599,368,25,15,7,79,226,49,81,0,0
4995,1515,143,1595,376,25,15,7,80,233,50,81,0,0
4996,1509,146,1591,384,25,15,7,82,238,51,81,0,0
4997,1505,153,1588,394,25,15,7,83,241,52,81,0,0
4998,1501,154,1586,401,25,15,7,85,247,53,81,0,0
4999,1495,158,1584,412,25,15,7,89,254,54,81,0,0
5000,1489,162,1579,422,25,15,7,90,260,55,81,0,0
5001,1481,160,1574,429,25,15,7,93,269,56,81,0,0
5002,1472,166,1569,444,25,15,7,97,278,57,81,0,0
5003,1464,170,1566,456,25,15,7,102,286,58,81,0,0
5004,1460,175,1566,465,25,15,7,106,290,59,81,0,0
5005,1446,185,1555,484,25,15,7,109,299,60,81,0,0
5006,1435,187,1549,498,25,15,7,114,311,61,81,0,0
5007,1424,190,1544,516,25,15,7,120,326,62,81,0,0
5008,1416,200,1540,534,25,15,7,124,334,63,81,0,0
5009,1406,207,1533,545,25,15,7,127,338,64,81,0,0
5010,1386,218,1517,562,25,15,7,131,344,65,81,0,0
5011,1361,224,1499,585,25,15,7,138,361,66,81,0,0
5012,1337,226,1479,593,25,15,7,142,367,67,81,0,0
5013,1315,233,1469,630,25,15,7,154,397,68,81,0,0
5014,1297,238,1460,654,25,15,7,163,416,69,81,0,0
5015,1273,249,1440,676,25,15,7,167,427,70,81,0,0
5016,1245,267,1416,706,25,15,7,171,439,71,81,0,0
5017,1222,274,1395,721,25,15,7,173,447,72,81,0,0
5018,1195,285,1377,760,25,15,7,182,475,73,81,0,0
5019,1161,301,1353,800,25,15,7,192,499,74,81,0,0
5020,1125,315,1318,819,25,15,7,193,504,75,81,0,0
5021,1068,332,1265,840,25,15,7,197,508,76,81,0,0
5022,1010,343,1210,861,25,15,7,200,518,77,81,0,0
5023,938,351,1143,892,25,15,7,205,541,78,81,0,0
5024,854,364,1057,908,25,15,7,203,544,79,81,0,0
5025,775,384,968,921,25,15,7,193,537,80,81,0,0
5026,736,394,932,941,25,15,7,196,547,81,81,1,0
5032,325,391,506,872,25,15,7,181,481,0,81,0,1
5033,262,385,449,861,25,15,7,187,476,1,81,0,0
5034,217,380,398,838,25,15,7,181,458,2,81,0,0
5035,186,376,365,813,25,15,7,179,437,3,81,0,0
5036,153,380,326,786,25,15,7,173,406,4,81,0,0
5037,99,361,279,782,25,15,7,180,421,5,81,0,0
5038,68,354,249,776,25,15,7,181,422,6,81,0,0
5039,49,345,220,747,25,15,7,171,402,7,81,0,0
5040,34,343,197,719,25,15,7,163,376,8,81,0,0
5041,20,343,181,706,25,15,7,161,363,9,81,0,0
5042,0,337,157,699,25,15,7,157,362,10,81,0,0
5043,0,338,143,690,25,15,7,143,352,11,81,0,0
5044,0,325,131,675,25,15,7,131,350,12,81,0,0
5045,0,317,118,654,25,15,7,118,337,13,81,0,0
5046,0,320,111,637,25,15,7,111,317,14,81,0,0
5047,0,346,94,619,25,15,7,94,273,15,81,0,0
5048,0,352,78,613,25,15,7,78,261,16,81,0,0
5049,0,354,71,602,25,15,7,71,248,17,81,0,0
5050,0,348,60,586,25,15,7,60,238,18,81,0,0
5051,0,366,52,574,25,15,7,52,208,19,81,0,0
5052,0,397,43,561,25,15,7,43,164,20,81,0,0
4953,1654,93,1690,205,28,15,7,36,112,0,89,0,1
4954,1653,92,1690,210,28,15,7,37,118,1,89,0,0
4955,1654,93,1690,207,28,15,7,36,114,2,89,0,0
4956,1654,95,1690,208,28,15,7,36,113,3,89,0,0
4957,1653,97,1688,210,28,15,7,35,113,4,89,0,0
4958,1651,94,1688,212,28,15,7,37,118,5,89,0,0
4959,1651,97,1689,217,28,15,7,38,120,6,89,0,0
4960,1651,96,1691,222,28,15,7,40,126,7,89,0,0
4961,1652,96,1692,222,28,15,7,40,126,8,89,0,0
4962,1651,97,1691,228,28,15,7,40,131,9,89,0,0
4963,1648,98,1689,230,28,15,7,41,132,10,89,0,0
4964,1646,96,1689,234,28,15,7,43,138,11,89,0,0
4965,1646,97,1689,236,28,15,7,43,139,12,89,0,0
4966,1645,97,1689,238,28,15,7,44,141,13,89,0,0
4967,1644,100,1686,240,28,15,7,42,140,14,89,0,0
4968,1641,104,1682,240,28,15,7,41,136,15,89,0,0
4969,1640,105,1681,240,28,15,7,41,135,16,89,0,0
4970,1640,106,1683,247,28,15,7,43,141,17,89,0,0
4971,1641,107,1685,252,28,15,7,44,145,18,89,0,0
4972,1642,106,1687,253,28,15,7,45,147,19,89,0,0
4973,1640,107,1687,261,28,15,7,47,154,20,89,0,0
4974,1641,110,1688,264,28,15,7,47,154,21,89,0,0
4975,1640,109,1688,267,28,15,7,48,158,22,89,0,0
4976,1641,113,1689,271,28,15,7,48,158,23,89,0,0
4977,1641,110,1691,277,28,15,7,50,167,24,89,0,0
4978,1640,114,1691,281,28,15,7,51,167,25,89,0,0
4979,1639,115,1691,287,28,15,7,52,172,26,89,0,0
4980,1637,115,1690,292,28,15,7,53,177,27,89,0,0
4981,1636,117,1690,300,28,15,7,54,183,28,89,0,0
4982,1636,118,1690,302,28,15,7,54,184,29,89,0,0
4983,1635,117,1690,304,28,15,7,55,187,30,89,0,0
4984,1634,116,1691,310,28,15,7,57,194,31,89,0,0
4985,1631,120,1688,315,28,15,7,57,195,32,89,0,0
4986,1627,119,1687,319,28,15,7,60,200,33,89,0,0
4987,1625,119,1688,330,28,15,7,63,211,34,89,0,0
4988,1625,122,1689,338,28,15,7,64,216,35,89,0,0
4989,1625,122,1689,339,28,15,7,64,217,36,89,0,0
4990,1623,125,1689,346,28,15,7,66,221,37,89,0,0
4991,1619,131,1686,353,28,15,7,67,222,38,89,0,0
4992,1618,132,1685,358,28,15,7,67,226,39,89,0,0
4993,1617,135,1687,368,28,15,7,70,233,40,89,0,0
4994,1616,135,1687,371,28,15,7,71,236,41,89,0,0
4995,1612,134,1687,382,28,15,7,75,248,42,89,0,0
4996,1610,142,1685,388,28,15,7,75,246,43,89,0,0
4997,1605,144,1682,396,28,15,7,77,252,44,89,0,0
4998,1605,147,1685,410,28,15,7,80,263,45,89,0,0
4999,1602,154,1684,421,28,15,7,82,267,46,89,0,0
5000,1600,156,1684,429,28,15,7,84,273,47,89,0,0
5001,1595,161,1683,445,28,15,7,88,284,48,89,0,0
5002,1588,167,1677,455,28,15,7,89,288,49,89,0,0
5003,1583,166,1675,466,28,15,7,92,300,50,89,0,0
5004,1582,173,1680,485,28,15,7,98,312,51,89,0,0
5005,1580,175,1681,500,28,15,7,101,325,52,89,0,0
5006,1576,175,1684,516,28,15,7,108,341,53,89,0,0
5007,1570,183,1680,531,28,15,7,110,348,54,89,0,0
5008,1561,182,1674,540,28,15,7,113,358,55,89,0,0
5009,1552,187,1673,576,28,15,7,121,389,56,89,0,0
5010,1547,193,1674,600,28,15,7,127,407,57,89,0,0
5011,1543,198,1672,609,28,15,7,129,411,58,89,0,0
5012,1531,212,1663,635,28,15,7,132,423,59,89,0,0
5013,1516,217,1652,655,28,15,7,136,438,60,89,0,0
5014,1500,220,1648,699,28,15,7,148,479,61,89,0,0
5015,1486,235,1643,739,28,15,7,157,504,62,89,0,0
5016,1462,243,1623,756,28,15,7,161,513,63,89,0,0
5017,1416,258,1588,792,28,15,7,172,534,64,89,0,0
5018,1381,278,1555,819,28,15,7,174,541,65,89,0,0
5019,1334,283,1523,866,28,15,7,189,583,66,89,0,0
5020,1288,317,1491,924,28,15,7,203,607,67,89,0,0
5021,1230,324,1440,954,28,15,7,210,630,68,89,0,0
5022,1147,332,1366,976,28,15,7,219,644,69,89,0,0
5023,1078,340,1314,1014,28,15,7,236,674,70,89,0,0
5024,984,347,1222,1037,28,15,7,238,690,71,89,0,0
5025,892,369,1141,1055,28,15,7,249,686,72,89,0,0
5026,772,388,1032,1068,28,15,7,260,680,73,89,0,0
5027,621,383,896,1075,28,15,7,275,692,74,89,0,0
5028,477,392,758,1056,28,15,7,281,664,75,89,0,0
5029,382,383,657,1039,28,15,7,275,656,76,89,0,0
5030,297,394,558,1023,28,15,7,261,629,77,89,0,0
5031,241,399,506,1017,28,15,7,265,618,78,89,0,0
5032,150,407,408,1000,28,15,7,258,593,79,89,0,0
5033,91,414,348,989,28,15,7,257,575,80,89,0,0
5034,49,406,289,941,28,15,7,240,535,81,89,0,0
5035,16,382,252,911,28,15,7,236,529,82,89,0,0
5036,0,382,225,891,28,15,7,225,509,83,89,0,0
5037,0,380,187,864,28,15,7,187,484,84,89,0,0
5038,0,408,156,847,28,15,7,156,439,85,89,0,0
5039,0,435,123,818,28,15,7,123,383,86,89,0,0
5040,0,422,104,800,28,15,7,104,378,87,89,0,0
5041,0,415,100,778,28,15,7,100,363,88,89,0,0
5042,0,417,65,762,28,15,7,65,345,89,89,1,0
5030,404,383,686,980,35,15,7,282,597,0,0,0,0
1025,1599,104,1642,237,1,15,8,43,133,0,15,0,0
1026,1585,106,1629,241,1,15,8,44,135,1,15,0,0
1027,1571,106,1616,245,1,15,8,45,139,2,15,0,0
1028,1552,103,1600,251,1,15,8,48,148,3,15,0,0
1029,1536,110,1581,249,1,15,8,45,139,4,15,0,0
1030,1515,107,1563,254,1,15,8,48,147,5,15,0,0
1031,1499,110,1546,251,1,15,8,47,141,6,15,0,0
1032,1483,103,1533,254,1,15,8,50,151,7,15,0,0
1033,1469,106,1520,261,1,15,8,51,155,8,15,0,0
1034,1449,112,1501,262,1,15,8,52,150,9,15,0,0
1035,1437,115,1489,266,1,15,8,52,151,10,15,0,0
1036,1429,116,1481,270,1,15,8,52,154,11,15,0,0
1037,1420,118,1471,269,1,15,8,51,151,12,15,0,0
1038,1412,117,1465,273,1,15,8,53,156,13,15,0,0
1039,1410,120,1462,272,1,15,8,52,152,14,15,0,0
1040,1398,122,1451,275,1,15,8,53,153,15,15,0,0
1536,1420,119,1472,272,3,15,8,52,153,0,8,0,0
1537,1433,118,1485,269,3,15,8,52,151,1,8,0,0
1538,1452,116,1501,261,3,15,8,49,145,2,8,0,0
1539,1477,106,1526,252,3,15,8,49,146,3,8,0,0
1540,1497,109,1547,253,3,15,8,50,144,4,8,0,0
1541,1516,103,1566,251,3,15,8,50,148,5,8,0,0
1542,1537,102,1588,250,3,15,8,51,148,6,8,0,0
1543,1557,102,1607,247,3,15,8,50,145,7,8,0,0
1544,1576,100,1625,244,3,15,8,49,144,8,8,0,0
5247,1435,112,1479,275,4,15,8,44,163,0,9,0,0
5248,1446,109,1485,252,4,15,8,39,143,1,9,0,0
5249,1456,111,1496,255,4,15,8,40,144,2,9,0,0
5250,1464,110,1505,252,4,15,8,41,142,3,9,0,0
5251,1469,112,1511,253,4,15,8,42,141,4,9,0,0
5252,1461,113,1506,259,4,15,8,45,146,5,9,0,0
5253,1450,112,1497,264,4,15,8,47,152,6,9,0,0
5254,1441,114,1490,268,4,15,8,49,154,7,9,0,0
5255,1427,114,1479,277,4,15,8,52,163,8,9,0,0
5256,1424,115,1477,280,4,15,8,53,165,9,9,0,0
5524,1425,116,1473,267,5,15,8,48,151,0,7,0,0
5525,1440,117,1487,264,5,15,8,47,147,1,7,0,0
5526,1450,116,1496,256,5,15,8,46,140,2,7,0,0
5527,1460,112,1507,256,5,15,8,47,144,3,7,0,0
5528,1464,112,1513,257,5,15,8,49,145,4,7,0,0
5529,1463,109,1511,251,5,15,8,48,142,5,7,0,0
5530,1456,104,1509,258,5,15,8,53,154,6,7,0,0
5531,1459,102,1512,257,5,15,8,53,155,7,7,0,0
151,0,809,129,1075,1,15,9,129,266,0,0,0,0
152,5,555,231,1076,2,15,9,226,521,0,74,0,1
153,105,538,341,1078,2,15,9,236,540,1,74,0,0
154,226,528,464,1074,2,15,9,238,546,2,74,0,0
155,379,500,632,1075,2,15,9,253,575,3,74,0,0
156,525,496,779,1072,2,15,9,254,576,4,74,0,0
157,660,483,919,1072,2,15,9,259,589,5,74,0,0
158,781,483,1041,1073,2,15,9,260,590,6,74,0,0
159,911,484,1168,1070,2,15,9,257,586,7,74,0,0
160,1011,478,1270,1070,2,15,9,259,592,8,74,0,0
161,1076,479,1338,1071,2,15,9,262,592,9,74,0,0
162,1144,490,1402,1064,2,15,9,258,574,10,74,0,0
163,1196,493,1454,1061,2,15,9,258,568,11,74,0,0
164,1221,495,1481,1057,2,15,9,260,562,12,74,0,0
165,1231,495,1491,1048,2,15,9,260,553,13,74,0,0
166,1219,491,1489,1059,2,15,9,270,568,14,74,0,0
167,1214,494,1486,1064,2,15,9,272,570,15,74,0,0
168,1203,488,1481,1070,2,15,9,278,582,16,74,0,0
169,1191,478,1475,1074,2,15,9,284,596,17,74,0,0
170,1187,469,1474,1075,2,15,9,287,606,18,74,0,0
171,1185,467,1472,1075,2,15,9,287,608,19,74,0,0
172,1185,468,1473,1077,2,15,9,288,609,20,74,0,0
173,1187,472,1473,1076,2,15,9,286,604,21,74,0,0
174,1187,475,1473,1075,2,15,9,286,600,22,74,0,0
175,1188,489,1469,1074,2,15,9,281,585,23,74,0,0
176,1187,497,1466,1074,2,15,9,279,577,24,74,0,0
177,1186,500,1465,1073,2,15,9,279,573,25,74,0,0
178,1185,501,1466,1073,2,15,9,281,572,26,74,0,0
179,1186,500,1469,1072,2,15,9,283,572,27,74,0,0
180,1187,496,1475,1070,2,15,9,288,574,28,74,0,0
181,1193,500,1482,1067,2,15,9,289,567,29,74,0,0
182,1198,517,1484,1067,2,15,9,286,550,30,74,0,0
183,1200,524,1489,1067,2,15,9,289,543,31,74,0,0
184,1198,529,1492,1068,2,15,9,294,539,32,74,0,0
185,1194,530,1494,1069,2,15,9,300,539,33,74,0,0
186,1187,523,1495,1069,2,15,9,308,546,34,74,0,0
187,1184,523,1497,1070,2,15,9,313,547,35,74,0,0
188,1184,525,1498,1067,2,15,9,314,542,36,74,0,0
189,1180,524,1499,1070,2,15,9,319,546,37,74,0,0
190,1175,522,1499,1072,2,15,9,324,550,38,74,0,0
191,1177,524,1500,1070,2,15,9,323,546,39,74,0,0
192,1176,521,1501,1069,2,15,9,325,548,40,74,0,0
193,1174,519,1502,1069,2,15,9,328,550,41,74,0,0
194,1176,511,1506,1069,2,15,9,330,558,42,74,0,0
195,1172,499,1506,1068,2,15,9,334,569,43,74,0,0
196,1164,492,1502,1074,2,15,9,338,582,44,74,0,0
197,1165,493,1498,1072,2,15,9,333,579,45,74,0,0
198,1164,489,1496,1075,2,15,9,332,586,46,74,0,0
199,1165,490,1495,1076,2,15,9,330,586,47,74,0,0
200,1173,496,1496,1072,2,15,9,323,576,48,74,0,0
201,1180,504,1498,1069,2,15,9,318,565,49,74,0,0
202,1185,510,1500,1069,2,15,9,315,559,50,74,0,0
203,1187,517,1500,1068,2,15,9,313,551,51,74,0,0
204,1189,526,1499,1067,2,15,9,310,541,52,74,0,0
205,1189,537,1496,1069,2,15,9,307,532,53,74,0,0
206,1189,550,1493,1072,2,15,9,304,522,54,74,0,0
207,1189,559,1491,1074,2,15,9,302,515,55,74,0,0
208,1188,564,1490,1074,2,15,9,302,510,56,74,0,0
209,1187,566,1489,1075,2,15,9,302,509,57,74,0,0
210,1186,565,1490,1074,2,15,9,304,509,58,74,0,0
211,1185,562,1492,1072,2,15,9,307,510,59,74,0,0
212,1182,555,1494,1072,2,15,9,312,517,60,74,0,0
213,1181,552,1495,1072,2,15,9,314,520,61,74,0,0
214,1180,551,1494,1072,2,15,9,314,521,62,74,0,0
215,1179,550,1495,1072,2,15,9,316,522,63,74,0,0
216,1178,545,1496,1070,2,15,9,318,525,64,74,0,0
217,1170,523,1499,1070,2,15,9,329,547,65,74,0,0
218,1160,504,1496,1069,2,15,9,336,565,66,74,0,0
219,1156,493,1492,1069,2,15,9,336,576,67,74,0,0
220,1145,484,1481,1069,2,15,9,336,585,68,74,0,0
221,1122,480,1452,1069,2,15,9,330,589,69,74,0,0
222,1086,490,1404,1074,2,15,9,318,584,70,74,0,0
223,1024,502,1327,1071,2,15,9,303,569,71,74,0,0
224,929,512,1224,1075,2,15,9,295,563,72,74,0,0
225,807,522,1098,1076,2,15,9,291,554,73,74,0,0
226,772,523,1064,1076,2,15,9,292,553,74,74,1,0
226,608,535,896,1072,3,15,9,288,537,0,7,0,0
227,476,528,768,1072,3,15,9,292,544,1,7,0,0
228,344,548,626,1073,3,15,9,282,525,2,7,0,0
229,192,551,473,1074,3,15,9,281,523,3,7,0,0
230,58,566,332,1075,3,15,9,274,509,4,7,0,0
231,0,578,222,1074,3,15,9,222,496,5,7,0,0
232,0,659,150,1078,3,15,9,150,419,6,7,0,0
233,0,683,47,1079,3,15,9,47,396,7,7,0,0
429,2,937,93,1080,4,15,9,91,143,0,0,0,0
431,1,768,118,1075,5,15,9,117,307,0,878,0,1
432,33,723,168,1075,5,15,9,135,352,1,878,0,0
433,64,692,215,1074,5,15,9,151,382,2,878,0,0
434,115,667,280,1073,5,15,9,165,406,3,878,0,0
435,184,661,357,1069,5,15,9,173,408,4,878,0,0
436,252,652,435,1069,5,15,9,183,417,5,878,0,0
437,329,645,521,1069,5,15,9,192,424,6,878,0,0
438,407,637,610,1069,5,15,9,203,432,7,878,0,0
439,481,633,692,1071,5,15,9,211,438,8,878,0,0
440,551,625,772,1071,5,15,9,221,446,9,878,0,0
441,617,608,850,1071,5,15,9,233,463,10,878,0,0
442,669,597,911,1073,5,15,9,242,476,11,878,0,0
443,723,592,972,1077,5,15,9,249,485,12,878,0,0
444,775,588,1026,1073,5,15,9,251,485,13,878,0,0
445,825,578,1079,1070,5,15,9,254,492,14,878,0,0
446,869,573,1127,1070,5,15,9,258,497,15,878,0,0
447,904,568,1161,1064,5,15,9,257,496,16,878,0,0
448,936,555,1196,1061,5,15,9,260,506,17,878,0,0
449,956,538,1224,1065,5,15,9,268,527,18,878,0,0
450,967,527,1239,1065,5,15,9,272,538,19,878,0,0
451,982,520,1260,1068,5,15,9,278,548,20,878,0,0
452,1002,515,1284,1070,5,15,9,282,555,21,878,0,0
453,1036,513,1320,1068,5,15,9,284,555,22,878,0,0
454,1088,519,1366,1068,5,15,9,278,549,23,878,0,0
455,1124,529,1396,1068,5,15,9,272,539,24,878,0,0
456,1145,541,1409,1067,5,15,9,264,526,25,878,0,0
457,1151,556,1409,1067,5,15,9,258,511,26,878,0,0
458,1157,568,1411,1066,5,15,9,254,498,27,878,0,0
459,1148,583,1399,1070,5,15,9,251,487,28,878,0,0
460,1129,585,1386,1074,5,15,9,257,489,29,878,0,0
461,1118,573,1374,1065,5,15,9,256,492,30,878,0,0
462,1085,545,1355,1067,5,15,9,270,522,31,878,0,0
463,1049,521,1329,1069,5,15,9,280,548,32,878,0,0
464,1025,512,1309,1074,5,15,9,284,562,33,878,0,0
465,1009,506,1291,1068,5,15,9,282,562,34,878,0,0
466,997,496,1284,1070,5,15,9,287,574,35,878,0,0
467,993,480,1284,1071,5,15,9,291,591,36,878,0,0
468,993,472,1283,1070,5,15,9,290,598,37,878,0,0
469,990,471,1276,1070,5,15,9,286,599,38,878,0,0
470,971,458,1257,1069,5,15,9,286,611,39,878,0,0
471,939,443,1223,1065,5,15,9,284,622,40,878,0,0
472,913,431,1188,1047,5,15,9,275,616,41,878,0,0
473,888,417,1160,1040,5,15,9,272,623,42,878,0,0
474,877,413,1141,1029,5,15,9,264,616,43,878,0,0
475,877,401,1137,1021,5,15,9,260,620,44,878,0,0
476,884,394,1129,989,5,15,9,245,595,45,878,0,0
477,890,388,1119,952,5,15,9,229,564,46,878,0,0
478,892,380,1113,932,5,15,9,221,552,47,878,0,0
479,887,372,1103,920,5,15,9,216,548,48,878,0,0
480,877,367,1092,920,5,15,9,215,553,49,878,0,0
481,870,368,1083,932,5,15,9,213,564,50,878,0,0
482,865,376,1072,943,5,15,9,207,567,51,878,0,0
483,857,383,1060,947,5,15,9,203,564,52,878,0,0
484,878,391,1081,951,5,15,9,203,560,53,878,0,0
485,897,400,1099,952,5,15,9,202,552,54,878,0,0
486,907,406,1115,968,5,15,9,208,562,55,878,0,0
487,915,411,1129,975,5,15,9,214,564,56,878,0,0
488,940,413,1161,987,5,15,9,221,574,57,878,0,0
489,985,420,1210,991,5,15,9,225,571,58,878,0,0
490,1021,429,1256,1013,5,15,9,235,584,59,878,0,0
491,1037,432,1283,1030,5,15,9,246,598,60,878,0,0
492,1045,436,1295,1038,5,15,9,250,602,61,878,0,0
493,1048,445,1302,1048,5,15,9,254,603,62,878,0,0
494,1047,451,1306,1055,5,15,9,259,604,63,878,0,0
495,1044,457,1308,1058,5,15,9,264,601,64,878,0,0
496,1046,466,1314,1064,5,15,9,268,598,65,878,0,0
497,1045,466,1319,1066,5,15,9,274,600,66,878,0,0
498,1060,464,1338,1066,5,15,9,278,602,67,878,0,0
499,1083,468,1357,1063,5,15,9,274,595,68,878,0,0
500,1099,475,1369,1065,5,15,9,270,590,69,878,0,0
501,1103,476,1372,1067,5,15,9,269,591,70,878,0,0
502,1109,473,1375,1066,5,15,9,266,593,71,878,0,0
503,1103,471,1368,1070,5,15,9,265,599,72,878,0,0
504,1103,470,1366,1071,5,15,9,263,601,73,878,0,0
505,1109,474,1370,1075,5,15,9,261,601,74,878,0,0
506,1109,479,1364,1069,5,15,9,255,590,75,878,0,0
507,1105,480,1358,1068,5,15,9,253,588,76,878,0,0
508,1107,478,1361,1070,5,15,9,254,592,77,878,0,0
509,1111,480,1364,1070,5,15,9,253,590,78,878,0,0
510,1108,476,1361,1067,5,15,9,253,591,79,878,0,0
511,1105,469,1358,1066,5,15,9,253,597,80,878,0,0
512,1106,467,1357,1067,5,15,9,251,600,81,878,0,0
513,1107,468,1357,1069,5,15,9,250,601,82,878,0,0
514,1108,470,1356,1069,5,15,9,248,599,83,878,0,0
515,1106,478,1349,1069,5,15,9,243,591,84,878,0,0
516,1110,477,1353,1067,5,15,9,243,590,85,878,0,0
517,1117,479,1358,1068,5,15,9,241,589,86,878,0,0
518,1115,477,1359,1072,5,15,9,244,595,87,878,0,0
519,1114,479,1358,1070,5,15,9,244,591,88,878,0,0
520,1128,492,1365,1055,5,15,9,237,563,89,878,0,0
521,1125,496,1367,1065,5,15,9,242,569,90,878,0,0
522,1141,496,1385,1068,5,15,9,244,572,91,878,0,0
523,1138,500,1383,1072,5,15,9,245,572,92,878,0,0
524,1136,504,1382,1075,5,15,9,246,571,93,878,0,0
525,1131,501,1379,1075,5,15,9,248,574,94,878,0,0
526,1133,503,1380,1072,5,15,9,247,569,95,878,0,0
527,1141,501,1387,1068,5,15,9,246,567,96,878,0,0
528,1145,504,1389,1066,5,15,9,244,562,97,878,0,0
529,1144,499,1391,1067,5,15,9,247,568,98,878,0,0
530,1136,498,1382,1069,5,15,9,246,571,99,878,0,0
531,1137,500,1381,1069,5,15,9,244,569,100,878,0,0
532,1138,497,1383,1071,5,15,9,245,574,101,878,0,0
533,1135,502,1378,1071,5,15,9,243,569,102,878,0,0
534,1138,504,1381,1073,5,15,9,243,569,103,878,0,0
535,1139,499,1384,1074,5,15,9,245,575,104,878,0,0
536,1136,494,1384,1077,5,15,9,248,583,105,878,0,0
537,1140,500,1383,1069,5,15,9,243,569,106,878,0,0
538,1132,502,1377,1066,5,15,9,245,564,107,878,0,0
539,1119,506,1364,1068,5,15,9,245,562,108,878,0,0
540,1116,509,1361,1066,5,15,9,245,557,109,878,0,0
541,1114,510,1363,1075,5,15,9,249,565,110,878,0,0
542,1113,514,1363,1078,5,15,9,250,564,111,878,0,0
543,1115,522,1362,1074,5,15,9,247,552,112,878,0,0
544,1109,528,1358,1072,5,15,9,249,544,113,878,0,0
545,1121,539,1372,1070,5,15,9,251,531,114,878,0,0
546,1135,540,1395,1070,5,15,9,260,530,115,878,0,0
547,1173,557,1430,1067,5,15,9,257,510,116,878,0,0
548,1205,573,1458,1060,5,15,9,253,487,117,878,0,0
549,1210,573,1470,1065,5,15,9,260,492,118,878,0,0
550,1210,577,1466,1056,5,15,9,256,479,119,878,0,0
551,1190,566,1453,1063,5,15,9,263,497,120,878,0,0
552,1172,555,1437,1060,5,15,9,265,505,121,878,0,0
553,1140,539,1411,1066,5,15,9,271,527,122,878,0,0
554,1095,521,1375,1072,5,15,9,280,551,123,878,0,0
555,1062,515,1341,1069,5,15,9,279,554,124,878,0,0
556,1035,503,1316,1069,5,15,9,281,566,125,878,0,0
557,1008,501,1287,1072,5,15,9,279,571,126,878,0,0
558,973,498,1252,1070,5,15,9,279,572,127,878,0,0
559,957,499,1235,1072,5,15,9,278,573,128,878,0,0
560,952,494,1230,1070,5,15,9,278,576,129,878,0,0
561,957,495,1238,1070,5,15,9,281,575,130,878,0,0
562,979,489,1264,1069,5,15,9,285,580,131,878,0,0
563,1014,483,1302,1073,5,15,9,288,590,132,878,0,0
564,1044,473,1332,1072,5,15,9,288,599,133,878,0,0
565,1059,463,1347,1072,5,15,9,288,609,134,878,0,0
566,1073,464,1357,1069,5,15,9,284,605,135,878,0,0
567,1067,461,1344,1066,5,15,9,277,605,136,878,0,0
568,1058,456,1331,1060,5,15,9,273,604,137,878,0,0
569,1047,449,1316,1056,5,15,9,269,607,138,878,0,0
570,1047,434,1310,1035,5,15,9,263,601,139,878,0,0
571,1050,429,1314,1036,5,15,9,264,607,140,878,0,0
572,1055,427,1317,1040,5,15,9,262,613,141,878,0,0
573,1062,432,1320,1047,5,15,9,258,615,142,878,0,0
574,1065,428,1321,1044,5,15,9,256,616,143,878,0,0
575,1069,436,1319,1042,5,15,9,250,606,144,878,0,0
576,1070,441,1319,1052,5,15,9,249,611,145,878,0,0
577,1080,446,1326,1056,5,15,9,246,610,146,878,0,0
578,1096,461,1331,1049,5,15,9,235,588,147,878,0,0
579,1105,471,1337,1053,5,15,9,232,582,148,878,0,0
580,1112,475,1340,1049,5,15,9,228,574,149,878,0,0
581,1107,476,1335,1050,5,15,9,228,574,150,878,0,0
582,1102,465,1335,1058,5,15,9,233,593,151,878,0,0
583,1104,469,1334,1055,5,15,9,230,586,152,878,0,0
584,1105,473,1333,1053,5,15,9,228,580,153,878,0,0
585,1102,469,1333,1057,5,15,9,231,588,154,878,0,0
586,1104,479,1330,1058,5,15,9,226,579,155,878,0,0
587,1105,483,1329,1056,5,15,9,224,573,156,878,0,0
588,1108,476,1333,1055,5,15,9,225,579,157,878,0,0
589,1105,475,1329,1054,5,15,9,224,579,158,878,0,0
590,1105,471,1328,1053,5,15,9,223,582,159,878,0,0
591,1104,477,1324,1054,5,15,9,220,577,160,878,0,0
592,1108,480,1325,1052,5,15,9,217,572,161,878,0,0
593,1109,482,1324,1051,5,15,9,215,569,162,878,0,0
594,1108,482,1324,1053,5,15,9,216,571,163,878,0,0
595,1109,473,1326,1048,5,15,9,217,575,164,878,0,0
596,1109,471,1326,1047,5,15,9,217,576,165,878,0,0
597,1109,471,1326,1046,5,15,9,217,575,166,878,0,0
598,1111,472,1328,1048,5,15,9,217,576,167,878,0,0
599,1110,478,1325,1050,5,15,9,215,572,168,878,0,0
600,1112,474,1328,1050,5,15,9,216,576,169,878,0,0
601,1113,472,1330,1052,5,15,9,217,580,170,878,0,0
602,1110,480,1326,1055,5,15,9,216,575,171,878,0,0
603,1111,482,1325,1055,5,15,9,214,573,172,878,0,0
604,1111,481,1326,1057,5,15,9,215,576,173,878,0,0
605,1115,474,1333,1056,5,15,9,218,582,174,878,0,0
606,1118,474,1336,1050,5,15,9,218,576,175,878,0,0
607,1120,471,1340,1046,5,15,9,220,575,176,878,0,0
608,1115,470,1337,1046,5,15,9,222,576,177,878,0,0
609,1108,459,1335,1045,5,15,9,227,586,178,878,0,0
610,1109,463,1336,1049,5,15,9,227,586,179,878,0,0
611,1113,460,1340,1049,5,15,9,227,589,180,878,0,0
612,1114,455,1341,1049,5,15,9,227,594,181,878,0,0
613,1110,454,1335,1049,5,15,9,225,595,182,878,0,0
614,1100,450,1328,1054,5,15,9,228,604,183,878,0,0
615,1096,456,1324,1057,5,15,9,228,601,184,878,0,0
616,1093,455,1321,1056,5,15,9,228,601,185,878,0,0
617,1093,455,1319,1051,5,15,9,226,596,186,878,0,0
618,1091,455,1315,1045,5,15,9,224,590,187,878,0,0
619,1089,458,1313,1049,5,15,9,224,591,188,878,0,0
620,1086,453,1312,1048,5,15,9,226,595,189,878,0,0
621,1082,456,1310,1059,5,15,9,228,603,190,878,0,0
622,1081,454,1310,1055,5,15,9,229,601,191,878,0,0
623,1081,461,1308,1058,5,15,9,227,597,192,878,0,0
624,1071,459,1302,1060,5,15,9,231,601,193,878,0,0
625,1053,455,1287,1063,5,15,9,234,608,194,878,0,0
626,1046,461,1280,1061,5,15,9,234,600,195,878,0,0
627,1023,470,1258,1066,5,15,9,235,596,196,878,0,0
628,989,466,1230,1069,5,15,9,241,603,197,878,0,0
629,979,469,1223,1071,5,15,9,244,602,198,878,0,0
630,993,473,1240,1074,5,15,9,247,601,199,878,0,0
631,1006,479,1253,1072,5,15,9,247,593,200,878,0,0
632,1028,484,1276,1071,5,15,9,248,587,201,878,0,0
633,1052,492,1299,1068,5,15,9,247,576,202,878,0,0
634,1075,498,1323,1069,5,15,9,248,571,203,878,0,0
635,1092,505,1338,1068,5,15,9,246,563,204,878,0,0
636,1099,515,1343,1070,5,15,9,244,555,205,878,0,0
637,1099,521,1343,1072,5,15,9,244,551,206,878,0,0
638,1090,522,1333,1069,5,15,9,243,547,207,878,0,0
639,1076,528,1319,1074,5,15,9,243,546,208,878,0,0
640,1064,526,1311,1076,5,15,9,247,550,209,878,0,0
641,1056,533,1301,1076,5,15,9,245,543,210,878,0,0
642,1060,535,1304,1075,5,15,9,244,540,211,878,0,0
643,1071,542,1310,1071,5,15,9,239,529,212,878,0,0
644,1080,552,1315,1070,5,15,9,235,518,213,878,0,0
645,1085,550,1321,1071,5,15,9,236,521,214,878,0,0
646,1082,536,1322,1071,5,15,9,240,535,215,878,0,0
647,1081,536,1320,1068,5,15,9,239,532,216,878,0,0
648,1085,531,1322,1068,5,15,9,237,537,217,878,0,0
649,1075,524,1316,1067,5,15,9,241,543,218,878,0,0
650,1060,514,1309,1073,5,15,9,249,559,219,878,0,0
651,1048,504,1299,1068,5,15,9,251,564,220,878,0,0
652,1045,499,1299,1072,5,15,9,254,573,221,878,0,0
653,1029,484,1290,1076,5,15,9,261,592,222,878,0,0
654,1012,477,1271,1069,5,15,9,259,592,223,878,0,0
655,983,464,1248,1073,5,15,9,265,609,224,878,0,0
656,973,462,1240,1067,5,15,9,267,605,225,878,0,0
657,970,460,1235,1057,5,15,9,265,597,226,878,0,0
658,980,456,1245,1052,5,15,9,265,596,227,878,0,0
659,999,450,1265,1052,5,15,9,266,602,228,878,0,0
660,1028,451,1286,1034,5,15,9,258,583,229,878,0,0
661,1050,447,1305,1026,5,15,9,255,579,230,878,0,0
662,1056,442,1310,1024,5,15,9,254,582,231,878,0,0
663,1059,433,1312,1020,5,15,9,253,587,232,878,0,0
664,1050,425,1305,1030,5,15,9,255,605,233,878,0,0
665,1049,422,1295,1015,5,15,9,246,593,234,878,0,0
666,1035,423,1281,1025,5,15,9,246,602,235,878,0,0
667,1031,422,1271,1019,5,15,9,240,597,236,878,0,0
668,1036,415,1275,1021,5,15,9,239,606,237,878,0,0
669,1040,421,1278,1028,5,15,9,238,607,238,878,0,0
670,1054,427,1285,1020,5,15,9,231,593,239,878,0,0
671,1057,433,1284,1018,5,15,9,227,585,240,878,0,0
672,1058,443,1283,1028,5,15,9,225,585,241,878,0,0
673,1065,453,1289,1038,5,15,9,224,585,242,878,0,0
674,1075,457,1296,1037,5,15,9,221,580,243,878,0,0
675,1081,458,1301,1036,5,15,9,220,578,244,878,0,0
676,1084,462,1300,1029,5,15,9,216,567,245,878,0,0
677,1081,466,1296,1034,5,15,9,215,568,246,878,0,0
678,1077,462,1295,1034,5,15,9,218,572,247,878,0,0
679,1070,459,1287,1031,5,15,9,217,572,248,878,0,0
680,1048,454,1270,1029,5,15,9,222,575,249,878,0,0
681,1039,444,1272,1033,5,15,9,233,589,250,878,0,0
682,1034,452,1270,1035,5,15,9,236,583,251,878,0,0
683,1027,458,1266,1033,5,15,9,239,575,252,878,0,0
684,1017,458,1259,1027,5,15,9,242,569,253,878,0,0
685,1011,462,1258,1027,5,15,9,247,565,254,878,0,0
686,1005,466,1256,1029,5,15,9,251,563,255,878,0,0
687,1002,467,1256,1028,5,15,9,254,561,256,878,0,0
688,1000,466,1256,1024,5,15,9,256,558,257,878,0,0
689,999,469,1259,1027,5,15,9,260,558,258,878,0,0
690,998,466,1261,1027,5,15,9,263,561,259,878,0,0
691,1008,477,1266,1021,5,15,9,258,544,260,878,0,0
692,1008,483,1267,1021,5,15,9,259,538,261,878,0,0
693,999,480,1262,1022,5,15,9,263,542,262,878,0,0
694,996,477,1262,1021,5,15,9,266,544,263,878,0,0
695,991,465,1269,1028,5,15,9,278,563,264,878,0,0
696,987,455,1270,1028,5,15,9,283,573,265,878,0,0
697,981,446,1263,1020,5,15,9,282,574,266,878,0,0
698,979,442,1261,1019,5,15,9,282,577,267,878,0,0
699,978,444,1255,1016,5,15,9,277,572,268,878,0,0
700,982,449,1253,1013,5,15,9,271,564,269,878,0,0
701,984,453,1253,1014,5,15,9,269,561,270,878,0,0
702,983,454,1252,1015,5,15,9,269,561,271,878,0,0
703,981,456,1250,1017,5,15,9,269,561,272,878,0,0
704,980,456,1248,1017,5,15,9,268,561,273,878,0,0
705,982,456,1250,1017,5,15,9,268,561,274,878,0,0
706,983,459,1252,1022,5,15,9,269,563,275,878,0,0
707,986,463,1252,1021,5,15,9,266,558,276,878,0,0
708,987,464,1253,1023,5,15,9,266,559,277,878,0,0
709,986,465,1251,1026,5,15,9,265,561,278,878,0,0
710,989,462,1254,1022,5,15,9,265,560,279,878,0,0
711,994,466,1255,1017,5,15,9,261,551,280,878,0,0
712,994,471,1257,1022,5,15,9,263,551,281,878,0,0
713,1000,468,1264,1016,5,15,9,264,548,282,878,0,0
714,1001,478,1262,1016,5,15,9,261,538,283,878,0,0
715,997,482,1258,1018,5,15,9,261,536,284,878,0,0
716,998,484,1262,1022,5,15,9,264,538,285,878,0,0
717,1003,484,1268,1022,5,15,9,265,538,286,878,0,0
718,1004,483,1269,1020,5,15,9,265,537,287,878,0,0
719,998,480,1268,1023,5,15,9,270,543,288,878,0,0
720,998,479,1271,1026,5,15,9,273,547,289,878,0,0
721,1001,485,1268,1019,5,15,9,267,534,290,878,0,0
722,1001,482,1270,1018,5,15,9,269,536,291,878,0,0
723,994,481,1268,1023,5,15,9,274,542,292,878,0,0
724,992,479,1268,1025,5,15,9,276,546,293,878,0,0
725,998,479,1272,1020,5,15,9,274,541,294,878,0,0
726,1000,481,1275,1021,5,15,9,275,540,295,878,0,0
727,995,483,1269,1017,5,15,9,274,534,296,878,0,0
728,992,481,1267,1020,5,15,9,275,539,297,878,0,0
729,989,483,1264,1022,5,15,9,275,539,298,878,0,0
730,987,483,1261,1018,5,15,9,274,535,299,878,0,0
731,983,480,1254,1011,5,15,9,271,531,300,878,0,0
732,985,478,1259,1013,5,15,9,274,535,301,878,0,0
733,989,476,1262,1008,5,15,9,273,532,302,878,0,0
734,994,473,1270,1009,5,15,9,276,536,303,878,0,0
735,996,472,1274,1008,5,15,9,278,536,304,878,0,0
736,993,471,1267,1003,5,15,9,274,532,305,878,0,0
737,984,471,1258,1006,5,15,9,274,535,306,878,0,0
738,981,468,1258,1011,5,15,9,277,543,307,878,0,0
739,981,467,1256,1008,5,15,9,275,541,308,878,0,0
740,982,472,1255,1011,5,15,9,273,539,309,878,0,0
741,977,470,1253,1016,5,15,9,276,546,310,878,0,0
742,979,470,1254,1015,5,15,9,275,545,311,878,0,0
743,982,471,1257,1014,5,15,9,275,543,312,878,0,0
744,985,473,1258,1014,5,15,9,273,541,313,878,0,0
745,991,474,1265,1016,5,15,9,274,542,314,878,0,0
746,997,475,1268,1009,5,15,9,271,534,315,878,0,0
747,993,476,1266,1011,5,15,9,273,535,316,878,0,0
748,990,476,1268,1018,5,15,9,278,542,317,878,0,0
749,994,478,1272,1019,5,15,9,278,541,318,878,0,0
750,995,474,1273,1014,5,15,9,278,540,319,878,0,0
751,991,474,1270,1015,5,15,9,279,541,320,878,0,0
752,986,472,1265,1015,5,15,9,279,543,321,878,0,0
753,984,472,1260,1014,5,15,9,276,542,322,878,0,0
754,980,473,1254,1012,5,15,9,274,539,323,878,0,0
755,980,472,1251,1011,5,15,9,271,539,324,878,0,0
756,979,478,1248,1015,5,15,9,269,537,325,878,0,0
757,981,478,1249,1016,5,15,9,268,538,326,878,0,0
758,973,469,1247,1025,5,15,9,274,556,327,878,0,0
759,976,458,1257,1030,5,15,9,281,572,328,878,0,0
760,978,453,1258,1029,5,15,9,280,576,329,878,0,0
761,979,452,1257,1031,5,15,9,278,579,330,878,0,0
762,986,450,1261,1028,5,15,9,275,578,331,878,0,0
763,988,447,1263,1030,5,15,9,275,583,332,878,0,0
764,992,453,1263,1030,5,15,9,271,577,333,878,0,0
765,993,452,1260,1029,5,15,9,267,577,334,878,0,0
766,993,443,1263,1029,5,15,9,270,586,335,878,0,0
767,997,446,1263,1027,5,15,9,266,581,336,878,0,0
768,1000,452,1261,1028,5,15,9,261,576,337,878,0,0
769,994,453,1257,1037,5,15,9,263,584,338,878,0,0
770,992,450,1254,1035,5,15,9,262,585,339,878,0,0
771,993,436,1260,1034,5,15,9,267,598,340,878,0,0
772,980,426,1250,1035,5,15,9,270,609,341,878,0,0
773,985,427,1248,1018,5,15,9,263,591,342,878,0,0
774,988,426,1247,1000,5,15,9,259,574,343,878,0,0
775,988,425,1247,995,5,15,9,259,570,344,878,0,0
776,982,425,1239,990,5,15,9,257,565,345,878,0,0
777,987,429,1242,991,5,15,9,255,562,346,878,0,0
778,994,430,1248,988,5,15,9,254,558,347,878,0,0
779,998,430,1251,986,5,15,9,253,556,348,878,0,0
780,1007,429,1257,983,5,15,9,250,554,349,878,0,0
781,1012,429,1265,992,5,15,9,253,563,350,878,0,0
782,1015,430,1265,985,5,15,9,250,555,351,878,0,0
783,1013,430,1260,985,5,15,9,247,555,352,878,0,0
784,1012,431,1262,995,5,15,9,250,564,353,878,0,0
785,1013,433,1259,991,5,15,9,246,558,354,878,0,0
786,1005,430,1247,989,5,15,9,242,559,355,878,0,0
787,1012,430,1254,990,5,15,9,242,560,356,878,0,0
788,1017,430,1261,996,5,15,9,244,566,357,878,0,0
789,1016,429,1256,988,5,15,9,240,559,358,878,0,0
790,1017,431,1252,983,5,15,9,235,552,359,878,0,0
791,1020,430,1260,991,5,15,9,240,561,360,878,0,0
792,1023,426,1262,986,5,15,9,239,560,361,878,0,0
793,1007,429,1250,993,5,15,9,243,564,362,878,0,0
794,997,428,1242,993,5,15,9,245,565,363,878,0,0
795,989,430,1234,991,5,15,9,245,561,364,878,0,0
796,987,434,1235,1000,5,15,9,248,566,365,878,0,0
797,992,442,1236,997,5,15,9,244,555,366,878,0,0
798,998,445,1244,998,5,15,9,246,553,367,878,0,0
799,1002,448,1247,996,5,15,9,245,548,368,878,0,0
800,1003,448,1248,995,5,15,9,245,547,369,878,0,0
801,1002,449,1248,997,5,15,9,246,548,370,878,0,0
802,1000,448,1247,997,5,15,9,247,549,371,878,0,0
803,1000,448,1248,997,5,15,9,248,549,372,878,0,0
804,997,449,1245,998,5,15,9,248,549,373,878,0,0
805,998,451,1246,997,5,15,9,248,546,374,878,0,0
806,999,452,1248,996,5,15,9,249,544,375,878,0,0
807,998,450,1248,995,5,15,9,250,545,376,878,0,0
808,996,449,1247,995,5,15,9,251,546,377,878,0,0
809,996,446,1249,993,5,15,9,253,547,378,878,0,0
810,992,444,1247,993,5,15,9,255,549,379,878,0,0
811,992,444,1247,991,5,15,9,255,547,380,878,0,0
812,991,445,1247,989,5,15,9,256,544,381,878,0,0
813,990,444,1249,990,5,15,9,259,546,382,878,0,0
814,991,445,1251,989,5,15,9,260,544,383,878,0,0
815,991,439,1256,990,5,15,9,265,551,384,878,0,0
816,990,431,1258,989,5,15,9,268,558,385,878,0,0
817,994,426,1265,991,5,15,9,271,565,386,878,0,0
818,996,424,1267,989,5,15,9,271,565,387,878,0,0
819,997,425,1263,983,5,15,9,266,558,388,878,0,0
820,997,426,1262,983,5,15,9,265,557,389,878,0,0
821,993,429,1257,985,5,15,9,264,556,390,878,0,0
822,985,426,1250,991,5,15,9,265,565,391,878,0,0
823,981,423,1247,996,5,15,9,266,573,392,878,0,0
824,982,424,1247,1000,5,15,9,265,576,393,878,0,0
825,990,426,1251,994,5,15,9,261,568,394,878,0,0
826,994,427,1251,989,5,15,9,257,562,395,878,0,0
827,997,428,1252,984,5,15,9,255,556,396,878,0,0
828,998,428,1252,983,5,15,9,254,555,397,878,0,0
829,998,428,1253,986,5,15,9,255,558,398,878,0,0
830,1000,428,1257,988,5,15,9,257,560,399,878,0,0
831,1005,428,1259,982,5,15,9,254,554,400,878,0,0
832,1003,427,1264,992,5,15,9,261,565,401,878,0,0
833,986,429,1237,988,5,15,9,251,559,402,878,0,0
834,1004,436,1253,988,5,15,9,249,552,403,878,0,0
835,1003,436,1255,991,5,15,9,252,555,404,878,0,0
836,991,435,1247,996,5,15,9,256,561,405,878,0,0
837,982,432,1250,1012,5,15,9,268,580,406,878,0,0
838,970,431,1255,1038,5,15,9,285,607,407,878,0,0
839,954,435,1249,1050,5,15,9,295,615,408,878,0,0
840,912,436,1204,1061,5,15,9,292,625,409,878,0,0
841,896,440,1180,1063,5,15,9,284,623,410,878,0,0
842,888,451,1158,1061,5,15,9,270,610,411,878,0,0
843,886,457,1148,1064,5,15,9,262,607,412,878,0,0
844,884,457,1141,1067,5,15,9,257,610,413,878,0,0
845,887,458,1139,1070,5,15,9,252,612,414,878,0,0
846,888,458,1136,1071,5,15,9,248,613,415,878,0,0
847,887,458,1131,1070,5,15,9,244,612,416,878,0,0
848,884,456,1124,1062,5,15,9,240,606,417,878,0,0
849,880,461,1116,1060,5,15,9,236,599,418,878,0,0
850,875,464,1109,1062,5,15,9,234,598,419,878,0,0
851,866,458,1100,1065,5,15,9,234,607,420,878,0,0
852,856,462,1086,1067,5,15,9,230,605,421,878,0,0
853,853,467,1073,1058,5,15,9,220,591,422,878,0,0
854,851,463,1073,1062,5,15,9,222,599,423,878,0,0
855,854,460,1076,1059,5,15,9,222,599,424,878,0,0
856,871,452,1096,1062,5,15,9,225,610,425,878,0,0
857,932,446,1170,1055,5,15,9,238,609,426,878,0,0
858,963,443,1208,1057,5,15,9,245,614,427,878,0,0
859,974,432,1215,1040,5,15,9,241,608,428,878,0,0
860,990,441,1225,1021,5,15,9,235,580,429,878,0,0
861,980,432,1216,1016,5,15,9,236,584,430,878,0,0
862,988,426,1228,1019,5,15,9,240,593,431,878,0,0
863,1001,430,1245,1023,5,15,9,244,593,432,878,0,0
864,1011,438,1255,1023,5,15,9,244,585,433,878,0,0
865,1033,445,1279,1027,5,15,9,246,582,434,878,0,0
866,1060,448,1302,1024,5,15,9,242,576,435,878,0,0
867,1072,453,1310,1021,5,15,9,238,568,436,878,0,0
868,1077,461,1312,1022,5,15,9,235,561,437,878,0,0
869,1078,463,1310,1019,5,15,9,232,556,438,878,0,0
870,1077,463,1308,1017,5,15,9,231,554,439,878,0,0
871,1076,459,1309,1018,5,15,9,233,559,440,878,0,0
872,1075,458,1308,1019,5,15,9,233,561,441,878,0,0
873,1076,457,1309,1021,5,15,9,233,564,442,878,0,0
874,1075,456,1310,1024,5,15,9,235,568,443,878,0,0
875,1077,452,1311,1022,5,15,9,234,570,444,878,0,0
876,1075,451,1309,1022,5,15,9,234,571,445,878,0,0
877,1074,450,1305,1019,5,15,9,231,569,446,878,0,0
878,1068,450,1300,1028,5,15,9,232,578,447,878,0,0
879,1072,453,1301,1023,5,15,9,229,570,448,878,0,0
880,1068,451,1299,1029,5,15,9,231,578,449,878,0,0
881,1061,450,1292,1025,5,15,9,231,575,450,878,0,0
882,1053,444,1286,1031,5,15,9,233,587,451,878,0,0
883,1038,433,1276,1035,5,15,9,238,602,452,878,0,0
884,1032,422,1274,1036,5,15,9,242,614,453,878,0,0
885,1015,421,1253,1028,5,15,9,238,607,454,878,0,0
886,1009,415,1250,1023,5,15,9,241,608,455,878,0,0
887,993,408,1234,1018,5,15,9,241,610,456,878,0,0
888,982,403,1219,1010,5,15,9,237,607,457,878,0,0
889,979,401,1214,1012,5,15,9,235,611,458,878,0,0
890,991,403,1225,997,5,15,9,234,594,459,878,0,0
891,965,410,1190,984,5,15,9,225,574,460,878,0,0
892,942,412,1165,986,5,15,9,223,574,461,878,0,0
893,928,414,1143,981,5,15,9,215,567,462,878,0,0
894,919,420,1128,979,5,15,9,209,559,463,878,0,0
895,911,419,1118,978,5,15,9,207,559,464,878,0,0
896,910,422,1118,982,5,15,9,208,560,465,878,0,0
897,924,421,1134,987,5,15,9,210,566,466,878,0,0
898,970,431,1187,993,5,15,9,217,562,467,878,0,0
899,990,436,1208,999,5,15,9,218,563,468,878,0,0
900,1022,438,1241,1005,5,15,9,219,567,469,878,0,0
901,1039,439,1266,1028,5,15,9,227,589,470,878,0,0
902,1055,437,1281,1025,5,15,9,226,588,471,878,0,0
903,1052,439,1282,1041,5,15,9,230,602,472,878,0,0
904,1048,437,1281,1050,5,15,9,233,613,473,878,0,0
905,1049,444,1276,1049,5,15,9,227,605,474,878,0,0
906,1053,440,1282,1051,5,15,9,229,611,475,878,0,0
907,1053,441,1283,1052,5,15,9,230,611,476,878,0,0
908,1059,446,1284,1045,5,15,9,225,599,477,878,0,0
909,1070,446,1294,1044,5,15,9,224,598,478,878,0,0
910,1075,451,1299,1042,5,15,9,224,591,479,878,0,0
911,1074,451,1300,1039,5,15,9,226,588,480,878,0,0
912,1078,456,1302,1037,5,15,9,224,581,481,878,0,0
913,1083,460,1304,1029,5,15,9,221,569,482,878,0,0
914,1082,464,1302,1029,5,15,9,220,565,483,878,0,0
915,1083,465,1303,1028,5,15,9,220,563,484,878,0,0
916,1079,465,1301,1032,5,15,9,222,567,485,878,0,0
917,1079,464,1302,1030,5,15,9,223,566,486,878,0,0
918,1075,464,1297,1032,5,15,9,222,568,487,878,0,0
919,1070,474,1287,1031,5,15,9,217,557,488,878,0,0
920,1074,471,1288,1023,5,15,9,214,552,489,878,0,0
921,1077,472,1294,1029,5,15,9,217,557,490,878,0,0
922,1078,470,1298,1031,5,15,9,220,561,491,878,0,0
923,1077,472,1302,1041,5,15,9,225,569,492,878,0,0
924,1078,471,1302,1036,5,15,9,224,565,493,878,0,0
925,1073,471,1299,1037,5,15,9,226,566,494,878,0,0
926,1061,475,1292,1056,5,15,9,231,581,495,878,0,0
927,1056,467,1288,1055,5,15,9,232,588,496,878,0,0
928,1052,460,1290,1065,5,15,9,238,605,497,878,0,0
929,1055,464,1292,1070,5,15,9,237,606,498,878,0,0
930,1063,471,1294,1062,5,15,9,231,591,499,878,0,0
931,1059,465,1295,1068,5,15,9,236,603,500,878,0,0
932,1057,465,1294,1069,5,15,9,237,604,501,878,0,0
933,1059,465,1296,1067,5,15,9,237,602,502,878,0,0
934,1062,465,1297,1064,5,15,9,235,599,503,878,0,0
935,1063,466,1298,1063,5,15,9,235,597,504,878,0,0
936,1060,470,1293,1059,5,15,9,233,589,505,878,0,0
937,1058,467,1292,1059,5,15,9,234,592,506,878,0,0
938,1058,470,1291,1059,5,15,9,233,589,507,878,0,0
939,1067,477,1293,1045,5,15,9,226,568,508,878,0,0
940,1063,474,1293,1052,5,15,9,230,578,509,878,0,0
941,1062,473,1294,1056,5,15,9,232,583,510,878,0,0
942,1060,470,1295,1060,5,15,9,235,590,511,878,0,0
943,1067,474,1296,1049,5,15,9,229,575,512,878,0,0
944,1064,473,1296,1053,5,15,9,232,580,513,878,0,0
945,1062,469,1297,1058,5,15,9,235,589,514,878,0,0
946,1059,467,1293,1057,5,15,9,234,590,515,878,0,0
947,1065,472,1293,1043,5,15,9,228,571,516,878,0,0
948,1067,472,1293,1038,5,15,9,226,566,517,878,0,0
949,1061,469,1293,1048,5,15,9,232,579,518,878,0,0
950,1066,471,1293,1040,5,15,9,227,569,519,878,0,0
951,1060,469,1291,1051,5,15,9,231,582,520,878,0,0
952,1059,469,1290,1054,5,15,9,231,585,521,878,0,0
953,1067,471,1292,1041,5,15,9,225,570,522,878,0,0
954,1061,469,1289,1050,5,15,9,228,581,523,878,0,0
955,1060,474,1284,1051,5,15,9,224,577,524,878,0,0
956,1069,472,1288,1037,5,15,9,219,565,525,878,0,0
957,1064,469,1289,1047,5,15,9,225,578,526,878,0,0
958,1063,467,1289,1051,5,15,9,226,584,527,878,0,0
959,1062,467,1287,1053,5,15,9,225,586,528,878,0,0
960,1062,467,1288,1053,5,15,9,226,586,529,878,0,0
961,1066,467,1290,1052,5,15,9,224,585,530,878,0,0
962,1066,466,1290,1055,5,15,9,224,589,531,878,0,0
963,1066,466,1289,1054,5,15,9,223,588,532,878,0,0
964,1068,466,1289,1053,5,15,9,221,587,533,878,0,0
965,1074,470,1289,1035,5,15,9,215,565,534,878,0,0
966,1071,466,1290,1044,5,15,9,219,578,535,878,0,0
967,1072,467,1289,1037,5,15,9,217,570,536,878,0,0
968,1072,467,1288,1033,5,15,9,216,566,537,878,0,0
969,1073,468,1288,1031,5,15,9,215,563,538,878,0,0
970,1075,468,1290,1029,5,15,9,215,561,539,878,0,0
971,1069,468,1288,1037,5,15,9,219,569,540,878,0,0
972,1065,466,1285,1040,5,15,9,220,574,541,878,0,0
973,1062,465,1283,1042,5,15,9,221,577,542,878,0,0
974,1062,465,1282,1042,5,15,9,220,577,543,878,0,0
975,1061,465,1281,1042,5,15,9,220,577,544,878,0,0
976,1066,466,1286,1047,5,15,9,220,581,545,878,0,0
977,1068,467,1287,1050,5,15,9,219,583,546,878,0,0
978,1073,469,1286,1033,5,15,9,213,564,547,878,0,0
979,1067,469,1282,1041,5,15,9,215,572,548,878,0,0
980,1073,470,1285,1031,5,15,9,212,561,549,878,0,0
981,1066,469,1282,1041,5,15,9,216,572,550,878,0,0
982,1064,469,1281,1045,5,15,9,217,576,551,878,0,0
983,1063,473,1278,1047,5,15,9,215,574,552,878,0,0
984,1065,469,1282,1051,5,15,9,217,582,553,878,0,0
985,1064,469,1279,1046,5,15,9,215,577,554,878,0,0
986,1063,475,1275,1048,5,15,9,212,573,555,878,0,0
987,1062,470,1278,1053,5,15,9,216,583,556,878,0,0
988,1060,468,1277,1055,5,15,9,217,587,557,878,0,0
989,1060,466,1276,1055,5,15,9,216,589,558,878,0,0
990,1062,467,1274,1047,5,15,9,212,580,559,878,0,0
991,1063,465,1276,1052,5,15,9,213,587,560,878,0,0
992,1065,464,1278,1054,5,15,9,213,590,561,878,0,0
993,1066,464,1279,1055,5,15,9,213,591,562,878,0,0
994,1066,464,1278,1055,5,15,9,212,591,563,878,0,0
995,1066,465,1278,1054,5,15,9,212,589,564,878,0,0
996,1067,466,1278,1054,5,15,9,211,588,565,878,0,0
997,1067,467,1276,1049,5,15,9,209,582,566,878,0,0
998,1069,465,1279,1055,5,15,9,210,590,567,878,0,0
999,1069,465,1277,1044,5,15,9,208,579,568,878,0,0
1000,1074,468,1279,1036,5,15,9,205,568,569,878,0,0
1001,1076,470,1285,1038,5,15,9,209,568,570,878,0,0
1002,1073,466,1290,1041,5,15,9,217,575,571,878,0,0
1003,1059,468,1285,1052,5,15,9,226,584,572,878,0,0
1004,1053,471,1285,1055,5,15,9,232,584,573,878,0,0
1005,1050,479,1287,1058,5,15,9,237,579,574,878,0,0
1006,1049,486,1290,1057,5,15,9,241,571,575,878,0,0
1007,1047,487,1292,1057,5,15,9,245,570,576,878,0,0
1008,1049,491,1295,1050,5,15,9,246,559,577,878,0,0
1009,1050,492,1297,1044,5,15,9,247,552,578,878,0,0
1010,1055,486,1304,1034,5,15,9,249,548,579,878,0,0
1011,1055,486,1308,1035,5,15,9,253,549,580,878,0,0
1012,1053,487,1309,1038,5,15,9,256,551,581,878,0,0
1013,1052,486,1311,1039,5,15,9,259,553,582,878,0,0
1014,1052,487,1312,1040,5,15,9,260,553,583,878,0,0
1015,1049,486,1313,1041,5,15,9,264,555,584,878,0,0
1016,1047,485,1313,1040,5,15,9,266,555,585,878,0,0
1017,1045,485,1312,1039,5,15,9,267,554,586,878,0,0
1018,1045,486,1314,1039,5,15,9,269,553,587,878,0,0
1019,1045,487,1315,1039,5,15,9,270,552,588,878,0,0
1020,1046,487,1316,1039,5,15,9,270,552,589,878,0,0
1021,1046,484,1319,1039,5,15,9,273,555,590,878,0,0
1022,1047,484,1321,1039,5,15,9,274,555,591,878,0,0
1023,1047,483,1321,1038,5,15,9,274,555,592,878,0,0
1024,1046,483,1320,1037,5,15,9,274,554,593,878,0,0
1025,1046,485,1320,1039,5,15,9,274,554,594,878,0,0
1026,1045,484,1320,1039,5,15,9,275,555,595,878,0,0
1027,1044,484,1320,1040,5,15,9,276,556,596,878,0,0
1028,1045,483,1320,1040,5,15,9,275,557,597,878,0,0
1029,1045,479,1323,1040,5,15,9,278,561,598,878,0,0
1030,1046,478,1322,1038,5,15,9,276,560,599,878,0,0
1031,1049,482,1321,1032,5,15,9,272,550,600,878,0,0
1032,1050,484,1323,1035,5,15,9,273,551,601,878,0,0
1033,1053,484,1324,1031,5,15,9,271,547,602,878,0,0
1034,1050,483,1323,1032,5,15,9,273,549,603,878,0,0
1035,1049,482,1321,1033,5,15,9,272,551,604,878,0,0
1036,1043,469,1325,1042,5,15,9,282,573,605,878,0,0
1037,1045,469,1327,1043,5,15,9,282,574,606,878,0,0
1038,1052,466,1331,1036,5,15,9,279,570,607,878,0,0
1039,1054,465,1335,1042,5,15,9,281,577,608,878,0,0
1040,1055,457,1336,1040,5,15,9,281,583,609,878,0,0
1041,1057,459,1335,1043,5,15,9,278,584,610,878,0,0
1042,1059,454,1337,1045,5,15,9,278,591,611,878,0,0
1043,1061,454,1335,1044,5,15,9,274,590,612,878,0,0
1044,1058,448,1327,1037,5,15,9,269,589,613,878,0,0
1045,1055,442,1323,1036,5,15,9,268,594,614,878,0,0
1046,1050,436,1314,1030,5,15,9,264,594,615,878,0,0
1047,1038,434,1296,1027,5,15,9,258,593,616,878,0,0
1048,1034,422,1292,1025,5,15,9,258,603,617,878,0,0
1049,1024,414,1285,1028,5,15,9,261,614,618,878,0,0
1050,1021,412,1280,1028,5,15,9,259,616,619,878,0,0
1051,1019,412,1272,1025,5,15,9,253,613,620,878,0,0
1052,1027,417,1276,1028,5,15,9,249,611,621,878,0,0
1053,1030,419,1273,1021,5,15,9,243,602,622,878,0,0
1054,1036,419,1277,1022,5,15,9,241,603,623,878,0,0
1055,1044,427,1277,1016,5,15,9,233,589,624,878,0,0
1056,1049,422,1284,1017,5,15,9,235,595,625,878,0,0
1057,1058,433,1288,1018,5,15,9,230,585,626,878,0,0
1058,1063,444,1287,1019,5,15,9,224,575,627,878,0,0
1059,1062,447,1283,1020,5,15,9,221,573,628,878,0,0
1060,1062,448,1280,1019,5,15,9,218,571,629,878,0,0
1061,1064,450,1279,1021,5,15,9,215,571,630,878,0,0
1062,1062,449,1279,1027,5,15,9,217,578,631,878,0,0
1063,1063,453,1275,1019,5,15,9,212,566,632,878,0,0
1064,1062,451,1273,1010,5,15,9,211,559,633,878,0,0
1065,1052,444,1269,1020,5,15,9,217,576,634,878,0,0
1066,1054,450,1267,1011,5,15,9,213,561,635,878,0,0
1067,1049,452,1264,1018,5,15,9,215,566,636,878,0,0
1068,1047,451,1264,1021,5,15,9,217,570,637,878,0,0
1069,1047,452,1265,1022,5,15,9,218,570,638,878,0,0
1070,1046,451,1264,1023,5,15,9,218,572,639,878,0,0
1071,1053,452,1269,1012,5,15,9,216,560,640,878,0,0
1072,1050,454,1267,1015,5,15,9,217,561,641,878,0,0
1073,1048,457,1265,1016,5,15,9,217,559,642,878,0,0
1074,1047,456,1264,1016,5,15,9,217,560,643,878,0,0
1075,1046,456,1265,1018,5,15,9,219,562,644,878,0,0
1076,1044,455,1263,1018,5,15,9,219,563,645,878,0,0
1077,1043,456,1262,1019,5,15,9,219,563,646,878,0,0
1078,1044,457,1263,1020,5,15,9,219,563,647,878,0,0
1079,1044,457,1263,1020,5,15,9,219,563,648,878,0,0
1080,1045,457,1264,1020,5,15,9,219,563,649,878,0,0
1081,1046,449,1269,1022,5,15,9,223,573,650,878,0,0
1082,1047,451,1271,1030,5,15,9,224,579,651,878,0,0
1083,1047,451,1272,1033,5,15,9,225,582,652,878,0,0
1084,1048,451,1273,1032,5,15,9,225,581,653,878,0,0
1085,1048,454,1268,1024,5,15,9,220,570,654,878,0,0
1086,1048,452,1269,1024,5,15,9,221,572,655,878,0,0
1087,1047,452,1268,1021,5,15,9,221,569,656,878,0,0
1088,1050,451,1270,1016,5,15,9,220,565,657,878,0,0
1089,1048,447,1270,1018,5,15,9,222,571,658,878,0,0
1090,1047,445,1270,1020,5,15,9,223,575,659,878,0,0
1091,1046,446,1270,1023,5,15,9,224,577,660,878,0,0
1092,1047,453,1267,1021,5,15,9,220,568,661,878,0,0
1093,1046,448,1270,1023,5,15,9,224,575,662,878,0,0
1094,1046,444,1270,1021,5,15,9,224,577,663,878,0,0
1095,1046,451,1268,1020,5,15,9,222,569,664,878,0,0
1096,1047,448,1271,1022,5,15,9,224,574,665,878,0,0
1097,1046,451,1268,1021,5,15,9,222,570,666,878,0,0
1098,1047,450,1273,1029,5,15,9,226,579,667,878,0,0
1099,1048,447,1273,1024,5,15,9,225,577,668,878,0,0
1100,1048,447,1272,1025,5,15,9,224,578,669,878,0,0
1101,1047,452,1266,1018,5,15,9,219,566,670,878,0,0
1102,1044,444,1266,1025,5,15,9,222,581,671,878,0,0
1103,1046,449,1264,1018,5,15,9,218,569,672,878,0,0
1104,1047,451,1264,1015,5,15,9,217,564,673,878,0,0
1105,1042,443,1263,1021,5,15,9,221,578,674,878,0,0
1106,1043,441,1264,1024,5,15,9,221,583,675,878,0,0
1107,1043,439,1264,1026,5,15,9,221,587,676,878,0,0
1108,1045,440,1265,1025,5,15,9,220,585,677,878,0,0
1109,1046,440,1265,1025,5,15,9,219,585,678,878,0,0
1110,1051,443,1269,1027,5,15,9,218,584,679,878,0,0
1111,1056,439,1275,1029,5,15,9,219,590,680,878,0,0
1112,1053,429,1273,1026,5,15,9,220,597,681,878,0,0
1113,1048,423,1271,1031,5,15,9,223,608,682,878,0,0
1114,1049,420,1274,1034,5,15,9,225,614,683,878,0,0
1115,1041,418,1265,1029,5,15,9,224,611,684,878,0,0
1116,1032,420,1252,1030,5,15,9,220,610,685,878,0,0
1117,1037,418,1255,1029,5,15,9,218,611,686,878,0,0
1118,1042,416,1261,1027,5,15,9,219,611,687,878,0,0
1119,1038,416,1257,1028,5,15,9,219,612,688,878,0,0
1120,1036,417,1252,1026,5,15,9,216,609,689,878,0,0
1121,1033,416,1249,1027,5,15,9,216,611,690,878,0,0
1122,1035,414,1251,1028,5,15,9,216,614,691,878,0,0
1123,1038,414,1252,1026,5,15,9,214,612,692,878,0,0
1124,1041,414,1254,1023,5,15,9,213,609,693,878,0,0
1125,1048,415,1260,1018,5,15,9,212,603,694,878,0,0
1126,1057,420,1269,1011,5,15,9,212,591,695,878,0,0
1127,1061,429,1272,1013,5,15,9,211,584,696,878,0,0
1128,1054,441,1262,1016,5,15,9,208,575,697,878,0,0
1129,1047,449,1255,1023,5,15,9,208,574,698,878,0,0
1130,1054,453,1269,1030,5,15,9,215,577,699,878,0,0
1131,1061,457,1283,1035,5,15,9,222,578,700,878,0,0
1132,1063,462,1293,1047,5,15,9,230,585,701,878,0,0
1133,1055,462,1300,1068,5,15,9,245,606,702,878,0,0
1134,1048,466,1300,1076,5,15,9,252,610,703,878,0,0
1135,1064,477,1320,1076,5,15,9,256,599,704,878,0,0
1136,1073,484,1330,1074,5,15,9,257,590,705,878,0,0
1137,1091,491,1350,1074,5,15,9,259,583,706,878,0,0
1138,1104,503,1361,1075,5,15,9,257,572,707,878,0,0
1139,1110,513,1366,1074,5,15,9,256,561,708,878,0,0
1140,1110,520,1364,1070,5,15,9,254,550,709,878,0,0
1141,1101,524,1359,1071,5,15,9,258,547,710,878,0,0
1142,1080,528,1343,1074,5,15,9,263,546,711,878,0,0
1143,1074,543,1338,1074,5,15,9,264,531,712,878,0,0
1144,1089,556,1354,1073,5,15,9,265,517,713,878,0,0
1145,1115,569,1380,1071,5,15,9,265,502,714,878,0,0
1146,1155,591,1415,1071,5,15,9,260,480,715,878,0,0
1147,1195,607,1450,1065,5,15,9,255,458,716,878,0,0
1148,1221,620,1486,1071,5,15,9,265,451,717,878,0,0
1149,1230,632,1500,1073,5,15,9,270,441,718,878,0,0
1150,1213,654,1483,1078,5,15,9,270,424,719,878,0,0
1151,1187,660,1464,1076,5,15,9,277,416,720,878,0,0
1152,1156,673,1431,1073,5,15,9,275,400,721,878,0,0
1153,1127,685,1399,1072,5,15,9,272,387,722,878,0,0
1154,1109,691,1384,1073,5,15,9,275,382,723,878,0,0
1155,1094,702,1362,1069,5,15,9,268,367,724,878,0,0
1156,1066,708,1329,1071,5,15,9,263,363,725,878,0,0
1157,1037,719,1291,1071,5,15,9,254,352,726,878,0,0
1158,1009,725,1256,1068,5,15,9,247,343,727,878,0,0
1159,983,716,1236,1070,5,15,9,253,354,728,878,0,0
1160,956,697,1221,1072,5,15,9,265,375,729,878,0,0
1161,927,670,1204,1068,5,15,9,277,398,730,878,0,0
1162,907,646,1200,1073,5,15,9,293,427,731,878,0,0
1163,891,630,1191,1073,5,15,9,300,443,732,878,0,0
1164,872,615,1177,1071,5,15,9,305,456,733,878,0,0
1165,850,598,1162,1071,5,15,9,312,473,734,878,0,0
1166,815,569,1142,1073,5,15,9,327,504,735,878,0,0
1167,788,539,1126,1071,5,15,9,338,532,736,878,0,0
1168,764,513,1110,1069,5,15,9,346,556,737,878,0,0
1169,751,497,1101,1071,5,15,9,350,574,738,878,0,0
1170,753,488,1100,1069,5,15,9,347,581,739,878,0,0
1171,760,474,1110,1071,5,15,9,350,597,740,878,0,0
1172,784,461,1129,1069,5,15,9,345,608,741,878,0,0
1173,799,447,1140,1071,5,15,9,341,624,742,878,0,0
1174,809,433,1145,1069,5,15,9,336,636,743,878,0,0
1175,797,418,1129,1064,5,15,9,332,646,744,878,0,0
1176,786,414,1089,1024,5,15,9,303,610,745,878,0,0
1177,773,396,1060,993,5,15,9,287,597,746,878,0,0
1178,765,384,1045,984,5,15,9,280,600,747,878,0,0
1179,764,380,1035,979,5,15,9,271,599,748,878,0,0
1180,771,369,1033,961,5,15,9,262,592,749,878,0,0
1181,789,360,1034,926,5,15,9,245,566,750,878,0,0
1182,803,355,1036,904,5,15,9,233,549,751,878,0,0
1183,811,351,1037,894,5,15,9,226,543,752,878,0,0
1184,804,346,1027,894,5,15,9,223,548,753,878,0,0
1185,793,337,1008,875,5,15,9,215,538,754,878,0,0
1186,782,326,987,850,5,15,9,205,524,755,878,0,0
1187,779,323,974,827,5,15,9,195,504,756,878,0,0
1188,771,323,962,820,5,15,9,191,497,757,878,0,0
1189,779,322,967,813,5,15,9,188,491,758,878,0,0
1190,798,316,982,804,5,15,9,184,488,759,878,0,0
1191,818,317,993,781,5,15,9,175,464,760,878,0,0
1192,837,318,1004,769,5,15,9,167,451,761,878,0,0
1193,849,315,1011,761,5,15,9,162,446,762,878,0,0
1194,852,310,1011,758,5,15,9,159,448,763,878,0,0
1195,853,312,1008,760,5,15,9,155,448,764,878,0,0
1196,851,313,1002,759,5,15,9,151,446,765,878,0,0
1197,847,314,997,762,5,15,9,150,448,766,878,0,0
1198,843,315,993,775,5,15,9,150,460,767,878,0,0
1199,836,315,986,780,5,15,9,150,465,768,878,0,0
1200,831,315,981,788,5,15,9,150,473,769,878,0,0
1201,829,318,977,791,5,15,9,148,473,770,878,0,0
1202,827,319,977,797,5,15,9,150,478,771,878,0,0
1203,818,325,971,803,5,15,9,153,478,772,878,0,0
1204,820,328,979,819,5,15,9,159,491,773,878,0,0
1205,825,330,988,827,5,15,9,163,497,774,878,0,0
1206,833,338,999,835,5,15,9,166,497,775,878,0,0
1207,855,347,1019,831,5,15,9,164,484,776,878,0,0
1208,878,350,1047,855,5,15,9,169,505,777,878,0,0
1209,894,360,1068,887,5,15,9,174,527,778,878,0,0
1210,902,369,1079,913,5,15,9,177,544,779,878,0,0
1211,907,376,1083,926,5,15,9,176,550,780,878,0,0
1212,910,387,1084,935,5,15,9,174,548,781,878,0,0
1213,905,397,1081,945,5,15,9,176,548,782,878,0,0
1214,908,396,1090,959,5,15,9,182,563,783,878,0,0
1215,916,412,1097,963,5,15,9,181,551,784,878,0,0
1216,931,417,1118,975,5,15,9,187,558,785,878,0,0
1217,963,425,1149,979,5,15,9,186,554,786,878,0,0
1218,993,438,1176,982,5,15,9,183,544,787,878,0,0
1219,1021,447,1211,1013,5,15,9,190,566,788,878,0,0
1220,1043,453,1232,1016,5,15,9,189,563,789,878,0,0
1221,1063,451,1254,1020,5,15,9,191,569,790,878,0,0
1222,1063,450,1260,1028,5,15,9,197,578,791,878,0,0
1223,1074,451,1274,1030,5,15,9,200,579,792,878,0,0
1224,1076,449,1278,1025,5,15,9,202,576,793,878,0,0
1225,1080,455,1285,1030,5,15,9,205,575,794,878,0,0
1226,1078,454,1287,1034,5,15,9,209,580,795,878,0,0
1227,1082,454,1291,1025,5,15,9,209,571,796,878,0,0
1228,1082,453,1295,1033,5,15,9,213,580,797,878,0,0
1229,1083,454,1297,1035,5,15,9,214,581,798,878,0,0
1230,1083,456,1297,1034,5,15,9,214,578,799,878,0,0
1231,1088,457,1301,1026,5,15,9,213,569,800,878,0,0
1232,1088,456,1304,1032,5,15,9,216,576,801,878,0,0
1233,1089,458,1304,1033,5,15,9,215,575,802,878,0,0
1234,1087,460,1299,1028,5,15,9,212,568,803,878,0,0
1235,1087,458,1301,1030,5,15,9,214,572,804,878,0,0
1236,1088,456,1301,1024,5,15,9,213,568,805,878,0,0
1237,1084,459,1296,1027,5,15,9,212,568,806,878,0,0
1238,1085,459,1301,1032,5,15,9,216,573,807,878,0,0
1239,1081,456,1300,1038,5,15,9,219,582,808,878,0,0
1240,1085,457,1300,1027,5,15,9,215,570,809,878,0,0
1241,1086,455,1301,1025,5,15,9,215,570,810,878,0,0
1242,1083,455,1302,1033,5,15,9,219,578,811,878,0,0
1243,1076,456,1295,1030,5,15,9,219,574,812,878,0,0
1244,1060,451,1282,1023,5,15,9,222,572,813,878,0,0
1245,1037,442,1266,1030,5,15,9,229,588,814,878,0,0
1246,1015,434,1248,1038,5,15,9,233,604,815,878,0,0
1247,998,431,1229,1034,5,15,9,231,603,816,878,0,0
1248,974,427,1203,1028,5,15,9,229,601,817,878,0,0
1249,952,423,1180,1026,5,15,9,228,603,818,878,0,0
1250,937,423,1162,1020,5,15,9,225,597,819,878,0,0
1251,932,422,1152,1014,5,15,9,220,592,820,878,0,0
1252,925,415,1138,997,5,15,9,213,582,821,878,0,0
1253,915,399,1127,981,5,15,9,212,582,822,878,0,0
1254,917,391,1119,949,5,15,9,202,558,823,878,0,0
1255,908,386,1107,931,5,15,9,199,545,824,878,0,0
1256,894,377,1093,919,5,15,9,199,542,825,878,0,0
1257,878,371,1078,917,5,15,9,200,546,826,878,0,0
1258,859,361,1057,909,5,15,9,198,548,827,878,0,0
1259,845,359,1039,900,5,15,9,194,541,828,878,0,0
1260,834,356,1028,899,5,15,9,194,543,829,878,0,0
1261,833,354,1028,899,5,15,9,195,545,830,878,0,0
1262,842,355,1036,902,5,15,9,194,547,831,878,0,0
1263,858,353,1051,901,5,15,9,193,548,832,878,0,0
1264,875,360,1065,902,5,15,9,190,542,833,878,0,0
1265,892,365,1079,901,5,15,9,187,536,834,878,0,0
1266,911,377,1092,894,5,15,9,181,517,835,878,0,0
1267,929,383,1108,898,5,15,9,179,515,836,878,0,0
1268,937,387,1116,907,5,15,9,179,520,837,878,0,0
1269,942,386,1116,900,5,15,9,174,514,838,878,0,0
1270,943,386,1116,901,5,15,9,173,515,839,878,0,0
1271,945,389,1116,906,5,15,9,171,517,840,878,0,0
1272,952,388,1119,898,5,15,9,167,510,841,878,0,0
1273,955,386,1121,900,5,15,9,166,514,842,878,0,0
1274,955,385,1127,926,5,15,9,172,541,843,878,0,0
1275,956,385,1131,942,5,15,9,175,557,844,878,0,0
1276,958,387,1133,947,5,15,9,175,560,845,878,0,0
1277,957,393,1131,951,5,15,9,174,558,846,878,0,0
1278,961,398,1135,962,5,15,9,174,564,847,878,0,0
1279,965,402,1138,964,5,15,9,173,562,848,878,0,0
1280,968,410,1145,979,5,15,9,177,569,849,878,0,0
1281,968,418,1152,1002,5,15,9,184,584,850,878,0,0
1282,978,421,1171,1022,5,15,9,193,601,851,878,0,0
1283,1002,433,1196,1028,5,15,9,194,595,852,878,0,0
1284,1021,437,1217,1031,5,15,9,196,594,853,878,0,0
1285,1042,443,1243,1044,5,15,9,201,601,854,878,0,0
1286,1058,454,1262,1059,5,15,9,204,605,855,878,0,0
1287,1067,463,1271,1064,5,15,9,204,601,856,878,0,0
1288,1075,470,1280,1073,5,15,9,205,603,857,878,0,0
1289,1077,478,1281,1072,5,15,9,204,594,858,878,0,0
1290,1068,479,1274,1069,5,15,9,206,590,859,878,0,0
1291,1064,486,1272,1072,5,15,9,208,586,860,878,0,0
1292,1068,499,1275,1072,5,15,9,207,573,861,878,0,0
1293,1081,511,1291,1079,5,15,9,210,568,862,878,0,0
1294,1107,522,1320,1080,5,15,9,213,558,863,878,0,0
1295,1146,524,1361,1077,5,15,9,215,553,864,878,0,0
1296,1190,545,1397,1071,5,15,9,207,526,865,878,0,0
1297,1226,565,1427,1069,5,15,9,201,504,866,878,0,0
1298,1247,585,1446,1072,5,15,9,199,487,867,878,0,0
1299,1269,600,1468,1072,5,15,9,199,472,868,878,0,0
1300,1299,625,1488,1058,5,15,9,189,433,869,878,0,0
1301,1312,659,1498,1066,5,15,9,186,407,870,878,0,0
1302,1344,689,1524,1070,5,15,9,180,381,871,878,0,0
1303,1401,715,1578,1076,5,15,9,177,361,872,878,0,0
1304,1466,741,1636,1074,5,15,9,170,333,873,878,0,0
1305,1527,757,1696,1075,5,15,9,169,318,874,878,0,0
1306,1586,793,1747,1072,5,15,9,161,279,875,878,0,0
1307,1638,834,1788,1074,5,15,9,150,240,876,878,0,0
1308,1691,868,1833,1075,5,15,9,142,207,877,878,0,0
1309,1742,895,1866,1076,5,15,9,124,181,878,878,1,0
1478,914,540,1438,1077,10,15,9,524,537,0,111,0,1
1479,903,523,1412,1069,10,15,9,509,546,1,111,0,0
1480,891,504,1394,1067,10,15,9,503,563,2,111,0,0
1481,883,481,1383,1068,10,15,9,500,587,3,111,0,0
1482,876,467,1366,1070,10,15,9,490,603,4,111,0,0
1483,876,467,1346,1073,10,15,9,470,606,5,111,0,0
1484,874,459,1327,1070,10,15,9,453,611,6,111,0,0
1485,864,452,1301,1069,10,15,9,437,617,7,111,0,0
1486,840,448,1253,1059,10,15,9,413,611,8,111,0,0
1487,825,438,1219,1047,10,15,9,394,609,9,111,0,0
1488,810,425,1193,1042,10,15,9,383,617,10,111,0,0
1489,805,418,1178,1044,10,15,9,373,626,11,111,0,0
1490,819,420,1168,1034,10,15,9,349,614,12,111,0,0
1491,832,404,1163,1012,10,15,9,331,608,13,111,0,0
1492,847,394,1151,971,10,15,9,304,577,14,111,0,0
1493,849,383,1139,952,10,15,9,290,569,15,111,0,0
1494,849,383,1124,941,10,15,9,275,558,16,111,0,0
1495,836,371,1105,934,10,15,9,269,563,17,111,0,0
1496,821,362,1073,907,10,15,9,252,545,18,111,0,0
1497,806,352,1047,888,10,15,9,241,536,19,111,0,0
1498,795,346,1029,885,10,15,9,234,539,20,111,0,0
1499,791,344,1017,877,10,15,9,226,533,21,111,0,0
1500,794,337,1012,862,10,15,9,218,525,22,111,0,0
1501,800,328,1008,843,10,15,9,208,515,23,111,0,0
1502,806,319,1000,810,10,15,9,194,491,24,111,0,0
1503,804,316,994,804,10,15,9,190,488,25,111,0,0
1504,800,314,988,801,10,15,9,188,487,26,111,0,0
1505,786,309,971,791,10,15,9,185,482,27,111,0,0
1506,767,305,943,773,10,15,9,176,468,28,111,0,0
1507,756,300,927,764,10,15,9,171,464,29,111,0,0
1508,751,296,918,762,10,15,9,167,466,30,111,0,0
1509,750,293,915,759,10,15,9,165,466,31,111,0,0
1510,754,291,916,754,10,15,9,162,463,32,111,0,0
1511,765,289,923,743,10,15,9,158,454,33,111,0,0
1512,780,292,929,725,10,15,9,149,433,34,111,0,0
1513,792,291,938,719,10,15,9,146,428,35,111,0,0
1514,798,288,941,716,10,15,9,143,428,36,111,0,0
1515,802,284,943,713,10,15,9,141,429,37,111,0,0
1516,804,281,943,707,10,15,9,139,426,38,111,0,0
1517,802,276,940,709,10,15,9,138,433,39,111,0,0
1518,804,278,936,701,10,15,9,132,423,40,111,0,0
1519,808,281,936,698,10,15,9,128,417,41,111,0,0
1520,808,282,936,709,10,15,9,128,427,42,111,0,0
1521,810,286,938,716,10,15,9,128,430,43,111,0,0
1522,809,286,936,720,10,15,9,127,434,44,111,0,0
1523,804,289,933,724,10,15,9,129,435,45,111,0,0
1524,804,295,933,728,10,15,9,129,433,46,111,0,0
1525,804,303,938,744,10,15,9,134,441,47,111,0,0
1526,809,306,949,758,10,15,9,140,452,48,111,0,0
1527,819,307,965,771,10,15,9,146,464,49,111,0,0
1528,844,315,989,775,10,15,9,145,460,50,111,0,0
1529,862,322,1010,796,10,15,9,148,474,51,111,0,0
1530,867,328,1020,821,10,15,9,153,493,52,111,0,0
1531,868,331,1024,837,10,15,9,156,506,53,111,0,0
1532,870,334,1029,848,10,15,9,159,514,54,111,0,0
1533,873,346,1030,852,10,15,9,157,506,55,111,0,0
1534,879,356,1042,875,10,15,9,163,519,56,111,0,0
1535,885,365,1056,901,10,15,9,171,536,57,111,0,0
1536,906,372,1080,906,10,15,9,174,534,58,111,0,0
1537,931,374,1105,907,10,15,9,174,533,59,111,0,0
1538,948,386,1126,930,10,15,9,178,544,60,111,0,0
1539,955,397,1138,965,10,15,9,183,568,61,111,0,0
1540,964,404,1148,985,10,15,9,184,581,62,111,0,0
1541,968,410,1153,997,10,15,9,185,587,63,111,0,0
1542,967,418,1148,998,10,15,9,181,580,64,111,0,0
1543,964,427,1146,1001,10,15,9,182,574,65,111,0,0
1544,970,437,1158,1017,10,15,9,188,580,66,111,0,0
1545,974,443,1168,1024,10,15,9,194,581,67,111,0,0
1546,1009,451,1205,1028,10,15,9,196,577,68,111,0,0
1547,1051,460,1253,1059,10,15,9,202,599,69,111,0,0
1548,1088,473,1289,1067,10,15,9,201,594,70,111,0,0
1549,1102,476,1304,1073,10,15,9,202,597,71,111,0,0
1550,1125,481,1327,1075,10,15,9,202,594,72,111,0,0
1551,1128,482,1334,1076,10,15,9,206,594,73,111,0,0
1552,1137,493,1344,1076,10,15,9,207,583,74,111,0,0
1553,1145,505,1350,1073,10,15,9,205,568,75,111,0,0
1554,1144,505,1353,1074,10,15,9,209,569,76,111,0,0
1555,1140,498,1354,1074,10,15,9,214,576,77,111,0,0
1556,1142,500,1356,1072,10,15,9,214,572,78,111,0,0
1557,1138,497,1353,1074,10,15,9,215,577,79,111,0,0
1558,1136,491,1351,1072,10,15,9,215,581,80,111,0,0
1559,1131,486,1345,1068,10,15,9,214,582,81,111,0,0
1560,1123,481,1338,1067,10,15,9,215,586,82,111,0,0
1561,1120,476,1337,1067,10,15,9,217,591,83,111,0,0
1562,1127,479,1342,1067,10,15,9,215,588,84,111,0,0
1563,1124,491,1335,1067,10,15,9,211,576,85,111,0,0
1564,1115,498,1327,1069,10,15,9,212,571,86,111,0,0
1565,1114,504,1328,1071,10,15,9,214,567,87,111,0,0
1566,1120,513,1338,1075,10,15,9,218,562,88,111,0,0
1567,1133,522,1355,1073,10,15,9,222,551,89,111,0,0
1568,1151,522,1384,1077,10,15,9,233,555,90,111,0,0
1569,1200,549,1425,1073,10,15,9,225,524,91,111,0,0
1570,1232,565,1456,1075,10,15,9,224,510,92,111,0,0
1571,1263,587,1481,1074,10,15,9,218,487,93,111,0,0
1572,1282,612,1496,1076,10,15,9,214,464,94,111,0,0
1573,1288,633,1498,1073,10,15,9,210,440,95,111,0,0
1574,1296,651,1507,1073,10,15,9,211,422,96,111,0,0
1575,1311,683,1515,1076,10,15,9,204,393,97,111,0,0
1576,1342,713,1537,1073,10,15,9,195,360,98,111,0,0
1577,1402,744,1590,1074,10,15,9,188,330,99,111,0,0
1578,1474,766,1656,1072,10,15,9,182,306,100,111,0,0
1579,1539,796,1717,1073,10,15,9,178,277,101,111,0,0
1580,1593,823,1766,1073,10,15,9,173,250,102,111,0,0
1581,1638,861,1800,1076,10,15,9,162,215,103,111,0,0
1582,1671,884,1828,1075,10,15,9,157,191,104,111,0,0
1583,1705,909,1849,1074,10,15,9,144,165,105,111,0,0
1584,1725,917,1870,1076,10,15,9,145,159,106,111,0,0
1585,1747,930,1887,1077,10,15,9,140,147,107,111,0,0
1586,1772,935,1908,1077,10,15,9,136,142,108,111,0,0
1587,1798,950,1920,1078,10,15,9,122,128,109,111,0,0
1588,1820,966,1920,1079,10,15,9,100,113,110,111,0,0
1589,1851,983,1920,1080,10,15,9,69,97,111,111,1,0
1619,528,495,1101,1073,13,15,9,573,578,0,76,0,1
1620,527,491,1076,1073,13,15,9,549,582,1,76,0,0
1621,534,484,1064,1075,13,15,9,530,591,2,76,0,0
1622,551,474,1063,1075,13,15,9,512,601,3,76,0,0
1623,573,461,1068,1072,13,15,9,495,611,4,76,0,0
1624,595,447,1076,1071,13,15,9,481,624,5,76,0,0
1625,613,436,1080,1070,13,15,9,467,634,6,76,0,0
1626,612,424,1057,1060,13,15,9,445,636,7,76,0,0
1627,623,420,1021,1017,13,15,9,398,597,8,76,0,0
1628,641,416,1013,999,13,15,9,372,583,9,76,0,0
1629,658,405,1014,990,13,15,9,356,585,10,76,0,0
1630,683,387,1026,971,13,15,9,343,584,11,76,0,0
1631,720,376,1041,945,13,15,9,321,569,12,76,0,0
1632,744,373,1051,940,13,15,9,307,567,13,76,0,0
1633,754,363,1054,940,13,15,9,300,577,14,76,0,0
1634,752,355,1041,932,13,15,9,289,577,15,76,0,0
1635,746,350,1015,904,13,15,9,269,554,16,76,0,0
1636,742,342,990,869,13,15,9,248,527,17,76,0,0
1637,737,341,972,857,13,15,9,235,516,18,76,0,0
1638,735,333,963,851,13,15,9,228,518,19,76,0,0
1639,734,330,957,850,13,15,9,223,520,20,76,0,0
1640,742,327,957,839,13,15,9,215,512,21,76,0,0
1641,751,322,954,812,13,15,9,203,490,22,76,0,0
1642,765,318,959,795,13,15,9,194,477,23,76,0,0
1643,775,316,964,790,13,15,9,189,474,24,76,0,0
1644,778,309,963,786,13,15,9,185,477,25,76,0,0
1645,777,303,958,780,13,15,9,181,477,26,76,0,0
1646,775,298,950,777,13,15,9,175,479,27,76,0,0
1647,772,296,943,773,13,15,9,171,477,28,76,0,0
1648,775,298,939,770,13,15,9,164,472,29,76,0,0
1649,779,298,939,775,13,15,9,160,477,30,76,0,0
1650,782,301,939,781,13,15,9,157,480,31,76,0,0
1651,789,306,942,784,13,15,9,153,478,32,76,0,0
1652,797,313,945,783,13,15,9,148,470,33,76,0,0
1653,808,316,955,786,13,15,9,147,470,34,76,0,0
1654,818,319,967,794,13,15,9,149,475,35,76,0,0
1655,826,324,980,808,13,15,9,154,484,36,76,0,0
1656,830,330,989,817,13,15,9,159,487,37,76,0,0
1657,846,332,1006,812,13,15,9,160,480,38,76,0,0
1658,874,340,1035,821,13,15,9,161,481,39,76,0,0
1659,888,347,1058,857,13,15,9,170,510,40,76,0,0
1660,896,353,1072,885,13,15,9,176,532,41,76,0,0
1661,897,358,1075,898,13,15,9,178,540,42,76,0,0
1662,885,367,1065,904,13,15,9,180,537,43,76,0,0
1663,878,372,1060,911,13,15,9,182,539,44,76,0,0
1664,874,378,1064,932,13,15,9,190,554,45,76,0,0
1665,879,391,1075,947,13,15,9,196,556,46,76,0,0
1666,893,396,1093,952,13,15,9,200,556,47,76,0,0
1667,921,401,1122,958,13,15,9,201,557,48,76,0,0
1668,949,405,1152,968,13,15,9,203,563,49,76,0,0
1669,968,412,1182,1010,13,15,9,214,598,50,76,0,0
1670,979,422,1193,1031,13,15,9,214,609,51,76,0,0
1671,988,429,1200,1042,13,15,9,212,613,52,76,0,0
1672,980,429,1193,1048,13,15,9,213,619,53,76,0,0
1673,969,436,1182,1048,13,15,9,213,612,54,76,0,0
1674,960,444,1176,1055,13,15,9,216,611,55,76,0,0
1675,957,457,1180,1068,13,15,9,223,611,56,76,0,0
1676,966,470,1193,1072,13,15,9,227,602,57,76,0,0
1677,996,476,1226,1075,13,15,9,230,599,58,76,0,0
1678,1039,480,1271,1078,13,15,9,232,598,59,76,0,0
1679,1084,500,1307,1075,13,15,9,223,575,60,76,0,0
1680,1113,512,1332,1077,13,15,9,219,565,61,76,0,0
1681,1133,526,1349,1079,13,15,9,216,553,62,76,0,0
1682,1147,546,1361,1080,13,15,9,214,534,63,76,0,0
1683,1164,573,1369,1075,13,15,9,205,502,64,76,0,0
1684,1176,599,1378,1077,13,15,9,202,478,65,76,0,0
1685,1206,626,1405,1074,13,15,9,199,448,66,76,0,0
1686,1256,654,1451,1073,13,15,9,195,419,67,76,0,0
1687,1323,681,1513,1072,13,15,9,190,391,68,76,0,0
1688,1373,706,1557,1068,13,15,9,184,362,69,76,0,0
1689,1429,744,1605,1074,13,15,9,176,330,70,76,0,0
1690,1466,774,1638,1078,13,15,9,172,304,71,76,0,0
1691,1515,815,1674,1072,13,15,9,159,257,72,76,0,0
1692,1571,852,1722,1075,13,15,9,151,223,73,76,0,0
1693,1646,897,1784,1076,13,15,9,138,179,74,76,0,0
1694,1719,927,1844,1076,13,15,9,125,149,75,76,0,0
1695,1782,959,1882,1077,13,15,9,100,118,76,76,1,0
1780,892,562,1399,1070,20,15,9,507,508,0,86,0,1
1781,882,553,1372,1066,20,15,9,490,513,1,86,0,0
1782,871,534,1359,1066,20,15,9,488,532,2,86,0,0
1783,869,521,1343,1063,20,15,9,474,542,3,86,0,0
1784,863,503,1332,1065,20,15,9,469,562,4,86,0,0
1785,860,495,1316,1067,20,15,9,456,572,5,86,0,0
1786,852,480,1299,1066,20,15,9,447,586,6,86,0,0
1787,845,469,1283,1067,20,15,9,438,598,7,86,0,0
1788,825,455,1251,1067,20,15,9,426,612,8,86,0,0
1789,811,443,1222,1062,20,15,9,411,619,9,86,0,0
1790,808,434,1200,1050,20,15,9,392,616,10,86,0,0
1791,806,423,1189,1049,20,15,9,383,626,11,86,0,0
1792,813,411,1181,1038,20,15,9,368,627,12,86,0,0
1793,831,405,1173,1010,20,15,9,342,605,13,86,0,0
1794,853,395,1170,976,20,15,9,317,581,14,86,0,0
1795,860,386,1164,962,20,15,9,304,576,15,86,0,0
1796,859,384,1152,958,20,15,9,293,574,16,86,0,0
1797,855,383,1134,947,20,15,9,279,564,17,86,0,0
1798,844,375,1113,938,20,15,9,269,563,18,86,0,0
1799,832,367,1086,917,20,15,9,254,550,19,86,0,0
1800,820,362,1063,903,20,15,9,243,541,20,86,0,0
1801,814,354,1049,894,20,15,9,235,540,21,86,0,0
1802,813,350,1040,886,20,15,9,227,536,22,86,0,0
1803,813,340,1035,880,20,15,9,222,540,23,86,0,0
1804,820,333,1026,850,20,15,9,206,517,24,86,0,0
1805,821,330,1017,828,20,15,9,196,498,25,86,0,0
1806,814,326,1005,819,20,15,9,191,493,26,86,0,0
1807,806,323,995,816,20,15,9,189,493,27,86,0,0
1808,790,315,977,809,20,15,9,187,494,28,86,0,0
1809,780,311,957,789,20,15,9,177,478,29,86,0,0
1810,773,305,943,773,20,15,9,170,468,30,86,0,0
1811,768,307,934,770,20,15,9,166,463,31,86,0,0
1812,771,303,936,765,20,15,9,165,462,32,86,0,0
1813,785,303,943,742,20,15,9,158,439,33,86,0,0
1814,800,299,955,730,20,15,9,155,431,34,86,0,0
1815,816,298,967,725,20,15,9,151,427,35,86,0,0
1816,828,298,974,720,20,15,9,146,422,36,86,0,0
1817,831,294,975,720,20,15,9,144,426,37,86,0,0
1818,831,292,972,717,20,15,9,141,425,38,86,0,0
1819,828,288,966,713,20,15,9,138,425,39,86,0,0
1820,828,288,963,712,20,15,9,135,424,40,86,0,0
1821,830,290,961,707,20,15,9,131,417,41,86,0,0
1822,828,290,960,717,20,15,9,132,427,42,86,0,0
1823,826,294,957,724,20,15,9,131,430,43,86,0,0
1824,818,296,949,732,20,15,9,131,436,44,86,0,0
1825,810,303,941,738,20,15,9,131,435,45,86,0,0
1826,808,300,941,738,20,15,9,133,438,46,86,0,0
1827,803,300,941,746,20,15,9,138,446,47,86,0,0
1828,805,305,951,768,20,15,9,146,463,48,86,0,0
1829,812,311,963,782,20,15,9,151,471,49,86,0,0
1830,828,313,982,787,20,15,9,154,474,50,86,0,0
1831,847,319,1001,793,20,15,9,154,474,51,86,0,0
1832,861,325,1016,798,20,15,9,155,473,52,86,0,0
1833,861,338,1022,829,20,15,9,161,491,53,86,0,0
1834,851,341,1019,855,20,15,9,168,514,54,86,0,0
1835,833,343,1008,869,20,15,9,175,526,55,86,0,0
1836,824,347,1003,877,20,15,9,179,530,56,86,0,0
1837,821,352,1010,911,20,15,9,189,559,57,86,0,0
1838,825,360,1021,936,20,15,9,196,576,58,86,0,0
1839,847,372,1043,942,20,15,9,196,570,59,86,0,0
1840,868,382,1064,941,20,15,9,196,559,60,86,0,0
1841,888,394,1090,964,20,15,9,202,570,61,86,0,0
1842,892,403,1103,995,20,15,9,211,592,62,86,0,0
1843,893,415,1106,1016,20,15,9,213,601,63,86,0,0
1844,885,420,1101,1027,20,15,9,216,607,64,86,0,0
1845,872,434,1084,1022,20,15,9,212,588,65,86,0,0
1846,864,449,1086,1056,20,15,9,222,607,66,86,0,0
1847,868,469,1093,1069,20,15,9,225,600,67,86,0,0
1848,885,475,1114,1070,20,15,9,229,595,68,86,0,0
1849,926,469,1160,1070,20,15,9,234,601,69,86,0,0
1850,966,476,1197,1076,20,15,9,231,600,70,86,0,0
1851,1003,488,1227,1078,20,15,9,224,590,71,86,0,0
1852,1024,503,1240,1076,20,15,9,216,573,72,86,0,0
1853,1042,523,1251,1077,20,15,9,209,554,73,86,0,0
1854,1053,534,1262,1078,20,15,9,209,544,74,86,0,0
1855,1069,544,1277,1077,20,15,9,208,533,75,86,0,0
1856,1086,561,1292,1079,20,15,9,206,518,76,86,0,0
1857,1121,585,1323,1080,20,15,9,202,495,77,86,0,0
1858,1178,608,1375,1078,20,15,9,197,470,78,86,0,0
1859,1247,630,1442,1078,20,15,9,195,448,79,86,0,0
1860,1307,654,1499,1077,20,15,9,192,423,80,86,0,0
1861,1364,695,1544,1073,20,15,9,180,378,81,86,0,0
1862,1418,728,1592,1070,20,15,9,174,342,82,86,0,0
1863,1467,753,1636,1063,20,15,9,169,310,83,86,0,0
1864,1505,786,1674,1068,20,15,9,169,282,84,86,0,0
1865,1561,813,1730,1072,20,15,9,169,259,85,86,0,0
1866,1611,837,1764,1073,20,15,9,153,236,86,86,1,0
1903,1259,669,1650,1072,21,15,9,391,403,0,2043,0,1
1904,1228,650,1619,1067,21,15,9,391,417,1,2043,0,0
1905,1193,626,1593,1067,21,15,9,400,441,2,2043,0,0
1906,1153,598,1566,1068,21,15,9,413,470,3,2043,0,0
1907,1105,573,1527,1069,21,15,9,422,496,4,2043,0,0
1908,1066,551,1493,1069,21,15,9,427,518,5,2043,0,0
1909,1040,544,1460,1071,21,15,9,420,527,6,2043,0,0
1910,1012,523,1432,1073,21,15,9,420,550,7,2043,0,0
1911,983,504,1401,1075,21,15,9,418,571,8,2043,0,0
1912,958,495,1363,1073,21,15,9,405,578,9,2043,0,0
1913,935,485,1331,1071,21,15,9,396,586,10,2043,0,0
1914,916,479,1305,1075,21,15,9,389,596,11,2043,0,0
1915,914,468,1295,1073,21,15,9,381,605,12,2043,0,0
1916,925,465,1293,1067,21,15,9,368,602,13,2043,0,0
1917,934,452,1287,1045,21,15,9,353,593,14,2043,0,0
1918,928,441,1270,1033,21,15,9,342,592,15,2043,0,0
1919,921,438,1251,1030,21,15,9,330,592,16,2043,0,0
1920,912,427,1238,1029,21,15,9,326,602,17,2043,0,0
1921,892,416,1209,1022,21,15,9,317,606,18,2043,0,0
1922,877,410,1164,981,21,15,9,287,571,19,2043,0,0
1923,855,401,1131,961,21,15,9,276,560,20,2043,0,0
1924,845,390,1114,951,21,15,9,269,561,21,2043,0,0
1925,841,384,1103,947,21,15,9,262,563,22,2043,0,0
1926,840,376,1094,941,21,15,9,254,565,23,2043,0,0
1927,854,367,1088,899,21,15,9,234,532,24,2043,0,0
1928,855,358,1079,881,21,15,9,224,523,25,2043,0,0
1929,849,355,1066,871,21,15,9,217,516,26,2043,0,0
1930,831,344,1045,860,21,15,9,214,516,27,2043,0,0
1931,812,328,1016,832,21,15,9,204,504,28,2043,0,0
1932,799,319,996,812,21,15,9,197,493,29,2043,0,0
1933,787,320,977,804,21,15,9,190,484,30,2043,0,0
1934,785,318,973,807,21,15,9,188,489,31,2043,0,0
1935,791,316,977,806,21,15,9,186,490,32,2043,0,0
1936,803,315,983,797,21,15,9,180,482,33,2043,0,0
1937,814,312,987,777,21,15,9,173,465,34,2043,0,0
1938,821,307,989,763,21,15,9,168,456,35,2043,0,0
1939,830,307,996,763,21,15,9,166,456,36,2043,0,0
1940,834,306,998,762,21,15,9,164,456,37,2043,0,0
1941,834,300,995,755,21,15,9,161,455,38,2043,0,0
1942,834,296,992,747,21,15,9,158,451,39,2043,0,0
1943,832,292,987,743,21,15,9,155,451,40,2043,0,0
1944,833,292,983,739,21,15,9,150,447,41,2043,0,0
1945,837,292,984,738,21,15,9,147,446,42,2043,0,0
1946,837,295,982,745,21,15,9,145,450,43,2043,0,0
1947,835,297,979,754,21,15,9,144,457,44,2043,0,0
1948,831,298,972,755,21,15,9,141,457,45,2043,0,0
1949,829,300,969,759,21,15,9,140,459,46,2043,0,0
1950,830,316,964,761,21,15,9,134,445,47,2043,0,0
1951,829,313,965,766,21,15,9,136,453,48,2043,0,0
1952,829,315,965,770,21,15,9,136,455,49,2043,0,0
1953,827,315,970,791,21,15,9,143,476,50,2043,0,0
1954,833,321,980,804,21,15,9,147,483,51,2043,0,0
1955,841,323,992,811,21,15,9,151,488,52,2043,0,0
1956,860,326,1012,814,21,15,9,152,488,53,2043,0,0
1957,878,336,1034,839,21,15,9,156,503,54,2043,0,0
1958,887,347,1049,874,21,15,9,162,527,55,2043,0,0
1959,893,351,1059,894,21,15,9,166,543,56,2043,0,0
1960,897,363,1059,889,21,15,9,162,526,57,2043,0,0
1961,893,373,1056,897,21,15,9,163,524,58,2043,0,0
1962,892,388,1066,929,21,15,9,174,541,59,2043,0,0
1963,902,396,1082,942,21,15,9,180,546,60,2043,0,0
1964,926,404,1108,948,21,15,9,182,544,61,2043,0,0
1965,963,411,1149,964,21,15,9,186,553,62,2043,0,0
1966,986,419,1183,1010,21,15,9,197,591,63,2043,0,0
1967,997,429,1197,1037,21,15,9,200,608,64,2043,0,0
1968,1003,434,1202,1044,21,15,9,199,610,65,2043,0,0
1969,1002,442,1199,1046,21,15,9,197,604,66,2043,0,0
1970,1001,453,1202,1062,21,15,9,201,609,67,2043,0,0
1971,998,464,1205,1070,21,15,9,207,606,68,2043,0,0
1972,1013,466,1226,1074,21,15,9,213,608,69,2043,0,0
1973,1045,476,1259,1077,21,15,9,214,601,70,2043,0,0
1974,1092,472,1306,1078,21,15,9,214,606,71,2043,0,0
1975,1121,471,1330,1072,21,15,9,209,601,72,2043,0,0
1976,1136,475,1342,1075,21,15,9,206,600,73,2043,0,0
1977,1144,485,1343,1069,21,15,9,199,584,74,2043,0,0
1978,1147,489,1343,1068,21,15,9,196,579,75,2043,0,0
1979,1152,485,1348,1069,21,15,9,196,584,76,2043,0,0
1980,1154,484,1350,1070,21,15,9,196,586,77,2043,0,0
1981,1158,484,1356,1071,21,15,9,198,587,78,2043,0,0
1982,1157,482,1355,1071,21,15,9,198,589,79,2043,0,0
1983,1152,482,1351,1071,21,15,9,199,589,80,2043,0,0
1984,1147,483,1348,1073,21,15,9,201,590,81,2043,0,0
1985,1144,485,1347,1074,21,15,9,203,589,82,2043,0,0
1986,1146,492,1348,1072,21,15,9,202,580,83,2043,0,0
1987,1151,495,1354,1071,21,15,9,203,576,84,2043,0,0
1988,1148,498,1354,1074,21,15,9,206,576,85,2043,0,0
1989,1146,504,1353,1073,21,15,9,207,569,86,2043,0,0
1990,1132,515,1341,1076,21,15,9,209,561,87,2043,0,0
1991,1129,519,1342,1075,21,15,9,213,556,88,2043,0,0
1992,1127,526,1341,1069,21,15,9,214,543,89,2043,0,0
1993,1125,530,1344,1072,21,15,9,219,542,90,2043,0,0
1994,1121,529,1346,1070,21,15,9,225,541,91,2043,0,0
1995,1131,524,1360,1068,21,15,9,229,544,92,2043,0,0
1996,1160,531,1387,1069,21,15,9,227,538,93,2043,0,0
1997,1189,533,1410,1062,21,15,9,221,529,94,2043,0,0
1998,1207,533,1428,1063,21,15,9,221,530,95,2043,0,0
1999,1216,533,1438,1066,21,15,9,222,533,96,2043,0,0
2000,1217,533,1442,1066,21,15,9,225,533,97,2043,0,0
2001,1212,538,1439,1068,21,15,9,227,530,98,2043,0,0
2002,1210,546,1440,1069,21,15,9,230,523,99,2043,0,0
2003,1207,552,1441,1070,21,15,9,234,518,100,2043,0,0
2004,1201,554,1439,1070,21,15,9,238,516,101,2043,0,0
2005,1184,557,1426,1072,21,15,9,242,515,102,2043,0,0
2006,1167,559,1408,1065,21,15,9,241,506,103,2043,0,0
2007,1140,552,1386,1067,21,15,9,246,515,104,2043,0,0
2008,1103,540,1355,1067,21,15,9,252,527,105,2043,0,0
2009,1065,533,1319,1063,21,15,9,254,530,106,2043,0,0
2010,1030,521,1291,1066,21,15,9,261,545,107,2043,0,0
2011,1011,505,1277,1064,21,15,9,266,559,108,2043,0,0
2012,997,494,1268,1067,21,15,9,271,573,109,2043,0,0
2013,996,490,1266,1070,21,15,9,270,580,110,2043,0,0
2014,988,474,1263,1070,21,15,9,275,596,111,2043,0,0
2015,986,463,1259,1064,21,15,9,273,601,112,2043,0,0
2016,978,454,1250,1059,21,15,9,272,605,113,2043,0,0
2017,959,439,1232,1060,21,15,9,273,621,114,2043,0,0
2018,944,432,1210,1047,21,15,9,266,615,115,2043,0,0
2019,929,424,1178,1009,21,15,9,249,585,116,2043,0,0
2020,907,412,1147,988,21,15,9,240,576,117,2043,0,0
2021,892,405,1129,985,21,15,9,237,580,118,2043,0,0
2022,884,395,1118,978,21,15,9,234,583,119,2043,0,0
2023,885,388,1111,960,21,15,9,226,572,120,2043,0,0
2024,894,380,1102,912,21,15,9,208,532,121,2043,0,0
2025,895,368,1098,890,21,15,9,203,522,122,2043,0,0
2026,889,363,1089,880,21,15,9,200,517,123,2043,0,0
2027,880,357,1078,874,21,15,9,198,517,124,2043,0,0
2028,861,349,1055,865,21,15,9,194,516,125,2043,0,0
2029,843,339,1031,847,21,15,9,188,508,126,2043,0,0
2030,832,334,1013,831,21,15,9,181,497,127,2043,0,0
2031,826,331,1005,827,21,15,9,179,496,128,2043,0,0
2032,831,329,1008,821,21,15,9,177,492,129,2043,0,0
2033,840,323,1012,798,21,15,9,172,475,130,2043,0,0
2034,856,319,1022,785,21,15,9,166,466,131,2043,0,0
2035,865,319,1026,781,21,15,9,161,462,132,2043,0,0
2036,869,322,1024,779,21,15,9,155,457,133,2043,0,0
2037,869,323,1022,778,21,15,9,153,455,134,2043,0,0
2038,861,321,1014,785,21,15,9,153,464,135,2043,0,0
2039,857,322,1009,788,21,15,9,152,466,136,2043,0,0
2040,855,323,1005,789,21,15,9,150,466,137,2043,0,0
2041,851,325,1002,796,21,15,9,151,471,138,2043,0,0
2042,849,327,999,797,21,15,9,150,470,139,2043,0,0
2043,849,330,1000,803,21,15,9,151,473,140,2043,0,0
2044,847,331,998,805,21,15,9,151,474,141,2043,0,0
2045,846,331,1000,809,21,15,9,154,478,142,2043,0,0
2046,855,331,1009,806,21,15,9,154,475,143,2043,0,0
2047,868,333,1020,802,21,15,9,152,469,144,2043,0,0
2048,878,333,1028,800,21,15,9,150,467,145,2043,0,0
2049,899,334,1053,802,21,15,9,154,468,146,2043,0,0
2050,912,331,1067,794,21,15,9,155,463,147,2043,0,0
2051,916,328,1070,790,21,15,9,154,462,148,2043,0,0
2052,918,328,1073,789,21,15,9,155,461,149,2043,0,0
2053,925,327,1083,788,21,15,9,158,461,150,2043,0,0
2054,921,328,1080,790,21,15,9,159,462,151,2043,0,0
2055,915,330,1074,789,21,15,9,159,459,152,2043,0,0
2056,915,331,1074,789,21,15,9,159,458,153,2043,0,0
2057,913,331,1073,790,21,15,9,160,459,154,2043,0,0
2058,915,331,1074,789,21,15,9,159,458,155,2043,0,0
2059,912,333,1069,792,21,15,9,157,459,156,2043,0,0
2060,921,331,1081,791,21,15,9,160,460,157,2043,0,0
2061,927,339,1086,792,21,15,9,159,453,158,2043,0,0
2062,918,334,1079,791,21,15,9,161,457,159,2043,0,0
2063,913,334,1072,791,21,15,9,159,457,160,2043,0,0
2064,909,334,1067,791,21,15,9,158,457,161,2043,0,0
2065,910,333,1067,791,21,15,9,157,458,162,2043,0,0
2066,914,335,1069,789,21,15,9,155,454,163,2043,0,0
2067,911,338,1065,791,21,15,9,154,453,164,2043,0,0
2068,908,336,1061,792,21,15,9,153,456,165,2043,0,0
2069,928,338,1083,787,21,15,9,155,449,166,2043,0,0
2070,921,336,1079,790,21,15,9,158,454,167,2043,0,0
2071,917,332,1076,791,21,15,9,159,459,168,2043,0,0
2072,915,330,1075,791,21,15,9,160,461,169,2043,0,0
2073,915,330,1074,792,21,15,9,159,462,170,2043,0,0
2074,917,330,1075,792,21,15,9,158,462,171,2043,0,0
2075,918,329,1076,792,21,15,9,158,463,172,2043,0,0
2076,918,330,1075,790,21,15,9,157,460,173,2043,0,0
2077,918,331,1075,789,21,15,9,157,458,174,2043,0,0
2078,918,331,1076,788,21,15,9,158,457,175,2043,0,0
2079,920,332,1078,787,21,15,9,158,455,176,2043,0,0
2080,920,332,1079,789,21,15,9,159,457,177,2043,0,0
2081,921,335,1079,792,21,15,9,158,457,178,2043,0,0
2082,921,335,1078,793,21,15,9,157,458,179,2043,0,0
2083,919,331,1078,792,21,15,9,159,461,180,2043,0,0
2084,918,331,1076,790,21,15,9,158,459,181,2043,0,0
2085,915,330,1073,795,21,15,9,158,465,182,2043,0,0
2086,917,331,1073,793,21,15,9,156,462,183,2043,0,0
2087,918,332,1074,791,21,15,9,156,459,184,2043,0,0
2088,917,329,1074,791,21,15,9,157,462,185,2043,0,0
2089,911,327,1067,792,21,15,9,156,465,186,2043,0,0
2090,909,329,1063,789,21,15,9,154,460,187,2043,0,0
2091,902,328,1055,790,21,15,9,153,462,188,2043,0,0
2092,905,328,1057,790,21,15,9,152,462,189,2043,0,0
2093,903,327,1055,793,21,15,9,152,466,190,2043,0,0
2094,900,327,1053,797,21,15,9,153,470,191,2043,0,0
2095,909,328,1062,797,21,15,9,153,469,192,2043,0,0
2096,911,331,1067,805,21,15,9,156,474,193,2043,0,0
2097,915,333,1074,812,21,15,9,159,479,194,2043,0,0
2098,920,338,1083,826,21,15,9,163,488,195,2043,0,0
2099,919,343,1079,824,21,15,9,160,481,196,2043,0,0
2100,917,348,1076,827,21,15,9,159,479,197,2043,0,0
2101,911,350,1070,836,21,15,9,159,486,198,2043,0,0
2102,909,351,1068,840,21,15,9,159,489,199,2043,0,0
2103,914,351,1072,838,21,15,9,158,487,200,2043,0,0
2104,918,353,1074,837,21,15,9,156,484,201,2043,0,0
2105,919,354,1073,837,21,15,9,154,483,202,2043,0,0
2106,918,351,1072,836,21,15,9,154,485,203,2043,0,0
2107,918,349,1069,832,21,15,9,151,483,204,2043,0,0
2108,915,345,1066,832,21,15,9,151,487,205,2043,0,0
2109,912,342,1063,832,21,15,9,151,490,206,2043,0,0
2110,913,336,1065,825,21,15,9,152,489,207,2043,0,0
2111,912,334,1064,826,21,15,9,152,492,208,2043,0,0
2112,916,335,1068,822,21,15,9,152,487,209,2043,0,0
2113,915,333,1068,821,21,15,9,153,488,210,2043,0,0
2114,914,332,1070,824,21,15,9,156,492,211,2043,0,0
2115,923,333,1082,823,21,15,9,159,490,212,2043,0,0
2116,933,339,1093,821,21,15,9,160,482,213,2043,0,0
2117,927,335,1090,816,21,15,9,163,481,214,2043,0,0
2118,921,335,1084,818,21,15,9,163,483,215,2043,0,0
2119,920,340,1081,819,21,15,9,161,479,216,2043,0,0
2120,915,340,1075,824,21,15,9,160,484,217,2043,0,0
2121,917,346,1072,825,21,15,9,155,479,218,2043,0,0
2122,918,349,1071,828,21,15,9,153,479,219,2043,0,0
2123,920,350,1072,829,21,15,9,152,479,220,2043,0,0
2124,921,351,1072,829,21,15,9,151,478,221,2043,0,0
2125,919,350,1069,829,21,15,9,150,479,222,2043,0,0
2126,917,351,1066,828,21,15,9,149,477,223,2043,0,0
2127,916,352,1064,827,21,15,9,148,475,224,2043,0,0
2128,916,352,1064,829,21,15,9,148,477,225,2043,0,0
2129,917,351,1064,829,21,15,9,147,478,226,2043,0,0
2130,918,352,1066,830,21,15,9,148,478,227,2043,0,0
2131,917,352,1064,829,21,15,9,147,477,228,2043,0,0
2132,919,352,1065,829,21,15,9,146,477,229,2043,0,0
2133,920,352,1066,830,21,15,9,146,478,230,2043,0,0
2134,921,350,1067,830,21,15,9,146,480,231,2043,0,0
2135,919,351,1065,830,21,15,9,146,479,232,2043,0,0
2136,921,351,1067,830,21,15,9,146,479,233,2043,0,0
2137,924,350,1068,828,21,15,9,144,478,234,2043,0,0
2138,927,350,1072,828,21,15,9,145,478,235,2043,0,0
2139,927,352,1071,828,21,15,9,144,476,236,2043,0,0
2140,925,352,1069,828,21,15,9,144,476,237,2043,0,0
2141,925,352,1070,829,21,15,9,145,477,238,2043,0,0
2142,921,352,1066,830,21,15,9,145,478,239,2043,0,0
2143,920,353,1064,832,21,15,9,144,479,240,2043,0,0
2144,921,351,1065,831,21,15,9,144,480,241,2043,0,0
2145,921,353,1064,830,21,15,9,143,477,242,2043,0,0
2146,942,356,1087,823,21,15,9,145,467,243,2043,0,0
2147,938,354,1086,824,21,15,9,148,470,244,2043,0,0
2148,929,352,1077,825,21,15,9,148,473,245,2043,0,0
2149,925,354,1072,827,21,15,9,147,473,246,2043,0,0
2150,923,353,1071,826,21,15,9,148,473,247,2043,0,0
2151,923,353,1070,826,21,15,9,147,473,248,2043,0,0
2152,925,354,1071,825,21,15,9,146,471,249,2043,0,0
2153,924,355,1070,826,21,15,9,146,471,250,2043,0,0
2154,930,354,1078,826,21,15,9,148,472,251,2043,0,0
2155,926,353,1073,825,21,15,9,147,472,252,2043,0,0
2156,927,351,1073,823,21,15,9,146,472,253,2043,0,0
2157,931,344,1082,821,21,15,9,151,477,254,2043,0,0
2158,922,339,1074,823,21,15,9,152,484,255,2043,0,0
2159,918,334,1070,819,21,15,9,152,485,256,2043,0,0
2160,915,333,1068,817,21,15,9,153,484,257,2043,0,0
2161,914,333,1069,820,21,15,9,155,487,258,2043,0,0
2162,913,332,1069,821,21,15,9,156,489,259,2043,0,0
2163,914,329,1071,821,21,15,9,157,492,260,2043,0,0
2164,913,328,1072,820,21,15,9,159,492,261,2043,0,0
2165,914,328,1075,820,21,15,9,161,492,262,2043,0,0
2166,914,328,1075,820,21,15,9,161,492,263,2043,0,0
2167,914,329,1074,817,21,15,9,160,488,264,2043,0,0
2168,912,331,1071,816,21,15,9,159,485,265,2043,0,0
2169,914,330,1076,819,21,15,9,162,489,266,2043,0,0
2170,928,336,1089,808,21,15,9,161,472,267,2043,0,0
2171,934,338,1097,805,21,15,9,163,467,268,2043,0,0
2172,930,340,1094,807,21,15,9,164,467,269,2043,0,0
2173,937,341,1106,814,21,15,9,169,473,270,2043,0,0
2174,935,343,1104,812,21,15,9,169,469,271,2043,0,0
2175,920,344,1089,818,21,15,9,169,474,272,2043,0,0
2176,917,344,1084,818,21,15,9,167,474,273,2043,0,0
2177,927,343,1096,819,21,15,9,169,476,274,2043,0,0
2178,927,342,1096,818,21,15,9,169,476,275,2043,0,0
2179,928,339,1098,816,21,15,9,170,477,276,2043,0,0
2180,924,339,1094,816,21,15,9,170,477,277,2043,0,0
2181,919,333,1091,818,21,15,9,172,485,278,2043,0,0
2182,915,331,1086,819,21,15,9,171,488,279,2043,0,0
2183,913,330,1080,816,21,15,9,167,486,280,2043,0,0
2184,911,330,1075,816,21,15,9,164,486,281,2043,0,0
2185,909,331,1071,814,21,15,9,162,483,282,2043,0,0
2186,909,330,1069,814,21,15,9,160,484,283,2043,0,0
2187,908,331,1066,813,21,15,9,158,482,284,2043,0,0
2188,916,329,1075,809,21,15,9,159,480,285,2043,0,0
2189,924,328,1086,808,21,15,9,162,480,286,2043,0,0
2190,928,330,1093,810,21,15,9,165,480,287,2043,0,0
2191,928,331,1097,813,21,15,9,169,482,288,2043,0,0
2192,933,333,1106,817,21,15,9,173,484,289,2043,0,0
2193,934,333,1108,812,21,15,9,174,479,290,2043,0,0
2194,934,333,1110,807,21,15,9,176,474,291,2043,0,0
2195,932,335,1110,812,21,15,9,178,477,292,2043,0,0
2196,923,341,1097,814,21,15,9,174,473,293,2043,0,0
2197,912,340,1084,820,21,15,9,172,480,294,2043,0,0
2198,915,337,1087,819,21,15,9,172,482,295,2043,0,0
2199,917,338,1086,818,21,15,9,169,480,296,2043,0,0
2200,919,336,1087,816,21,15,9,168,480,297,2043,0,0
2201,919,337,1087,820,21,15,9,168,483,298,2043,0,0
2202,922,335,1089,818,21,15,9,167,483,299,2043,0,0
2203,922,334,1089,817,21,15,9,167,483,300,2043,0,0
2204,926,334,1092,817,21,15,9,166,483,301,2043,0,0
2205,930,334,1098,816,21,15,9,168,482,302,2043,0,0
2206,934,334,1104,817,21,15,9,170,483,303,2043,0,0
2207,936,335,1107,819,21,15,9,171,484,304,2043,0,0
2208,936,335,1108,820,21,15,9,172,485,305,2043,0,0
2209,936,334,1110,818,21,15,9,174,484,306,2043,0,0
2210,936,334,1110,815,21,15,9,174,481,307,2043,0,0
2211,941,341,1114,811,21,15,9,173,470,308,2043,0,0
2212,940,338,1117,812,21,15,9,177,474,309,2043,0,0
2213,927,339,1102,813,21,15,9,175,474,310,2043,0,0
2214,921,340,1094,814,21,15,9,173,474,311,2043,0,0
2215,919,338,1090,816,21,15,9,171,478,312,2043,0,0
2216,920,339,1089,816,21,15,9,169,477,313,2043,0,0
2217,917,339,1085,815,21,15,9,168,476,314,2043,0,0
2218,915,337,1081,817,21,15,9,166,480,315,2043,0,0
2219,914,334,1079,815,21,15,9,165,481,316,2043,0,0
2220,913,336,1074,813,21,15,9,161,477,317,2043,0,0
2221,911,335,1071,811,21,15,9,160,476,318,2043,0,0
2222,914,333,1074,806,21,15,9,160,473,319,2043,0,0
2223,917,335,1077,805,21,15,9,160,470,320,2043,0,0
2224,922,338,1080,802,21,15,9,158,464,321,2043,0,0
2225,932,333,1098,808,21,15,9,166,475,322,2043,0,0
2226,938,336,1110,814,21,15,9,172,478,323,2043,0,0
2227,930,340,1100,812,21,15,9,170,472,324,2043,0,0
2228,928,345,1094,811,21,15,9,166,466,325,2043,0,0
2229,930,346,1096,810,21,15,9,166,464,326,2043,0,0
2230,925,348,1090,811,21,15,9,165,463,327,2043,0,0
2231,936,348,1103,811,21,15,9,167,463,328,2043,0,0
2232,941,348,1112,814,21,15,9,171,466,329,2043,0,0
2233,943,347,1116,813,21,15,9,173,466,330,2043,0,0
2234,941,349,1119,817,21,15,9,178,468,331,2043,0,0
2235,941,348,1123,820,21,15,9,182,472,332,2043,0,0
2236,940,349,1124,818,21,15,9,184,469,333,2043,0,0
2237,940,349,1127,818,21,15,9,187,469,334,2043,0,0
2238,939,350,1128,819,21,15,9,189,469,335,2043,0,0
2239,937,353,1128,818,21,15,9,191,465,336,2043,0,0
2240,937,353,1130,818,21,15,9,193,465,337,2043,0,0
2241,939,353,1133,815,21,15,9,194,462,338,2043,0,0
2242,939,353,1133,811,21,15,9,194,458,339,2043,0,0
2243,938,353,1133,811,21,15,9,195,458,340,2043,0,0
2244,938,353,1134,811,21,15,9,196,458,341,2043,0,0
2245,936,352,1134,811,21,15,9,198,459,342,2043,0,0
2246,934,354,1133,815,21,15,9,199,461,343,2043,0,0
2247,933,353,1134,816,21,15,9,201,463,344,2043,0,0
2248,934,352,1136,816,21,15,9,202,464,345,2043,0,0
2249,932,352,1136,817,21,15,9,204,465,346,2043,0,0
2250,930,351,1134,817,21,15,9,204,466,347,2043,0,0
2251,931,351,1136,816,21,15,9,205,465,348,2043,0,0
2252,931,351,1137,815,21,15,9,206,464,349,2043,0,0
2253,930,351,1137,816,21,15,9,207,465,350,2043,0,0
2254,931,351,1139,816,21,15,9,208,465,351,2043,0,0
2255,932,352,1139,814,21,15,9,207,462,352,2043,0,0
2256,935,353,1144,814,21,15,9,209,461,353,2043,0,0
2257,936,354,1147,815,21,15,9,211,461,354,2043,0,0
2258,933,352,1146,813,21,15,9,213,461,355,2043,0,0
2259,930,352,1144,813,21,15,9,214,461,356,2043,0,0
2260,930,350,1145,811,21,15,9,215,461,357,2043,0,0
2261,928,349,1144,813,21,15,9,216,464,358,2043,0,0
2262,929,350,1145,812,21,15,9,216,462,359,2043,0,0
2263,931,352,1145,810,21,15,9,214,458,360,2043,0,0
2264,932,351,1146,810,21,15,9,214,459,361,2043,0,0
2265,934,351,1147,809,21,15,9,213,458,362,2043,0,0
2266,934,350,1147,807,21,15,9,213,457,363,2043,0,0
2267,936,353,1148,808,21,15,9,212,455,364,2043,0,0
2268,937,353,1151,810,21,15,9,214,457,365,2043,0,0
2269,937,353,1153,812,21,15,9,216,459,366,2043,0,0
2270,936,352,1155,816,21,15,9,219,464,367,2043,0,0
2271,937,353,1156,815,21,15,9,219,462,368,2043,0,0
2272,942,353,1160,809,21,15,9,218,456,369,2043,0,0
2273,941,353,1162,810,21,15,9,221,457,370,2043,0,0
2274,944,357,1164,809,21,15,9,220,452,371,2043,0,0
2275,944,353,1166,807,21,15,9,222,454,372,2043,0,0
2276,941,354,1164,810,21,15,9,223,456,373,2043,0,0
2277,938,353,1164,812,21,15,9,226,459,374,2043,0,0
2278,938,353,1166,815,21,15,9,228,462,375,2043,0,0
2279,937,352,1166,814,21,15,9,229,462,376,2043,0,0
2280,921,354,1145,816,21,15,9,224,462,377,2043,0,0
2281,913,347,1132,812,21,15,9,219,465,378,2043,0,0
2282,904,343,1118,812,21,15,9,214,469,379,2043,0,0
2283,896,336,1108,817,21,15,9,212,481,380,2043,0,0
2284,892,332,1100,818,21,15,9,208,486,381,2043,0,0
2285,888,330,1091,817,21,15,9,203,487,382,2043,0,0
2286,889,331,1088,816,21,15,9,199,485,383,2043,0,0
2287,890,331,1084,814,21,15,9,194,483,384,2043,0,0
2288,890,331,1079,814,21,15,9,189,483,385,2043,0,0
2289,888,336,1070,812,21,15,9,182,476,386,2043,0,0
2290,893,337,1074,811,21,15,9,181,474,387,2043,0,0
2291,895,340,1077,812,21,15,9,182,472,388,2043,0,0
2292,896,340,1076,812,21,15,9,180,472,389,2043,0,0
2293,878,338,1058,819,21,15,9,180,481,390,2043,0,0
2294,876,340,1053,821,21,15,9,177,481,391,2043,0,0
2295,870,346,1043,826,21,15,9,173,480,392,2043,0,0
2296,866,347,1037,827,21,15,9,171,480,393,2043,0,0
2297,858,347,1031,837,21,15,9,173,490,394,2043,0,0
2298,859,351,1037,857,21,15,9,178,506,395,2043,0,0
2299,864,358,1046,870,21,15,9,182,512,396,2043,0,0
2300,881,363,1064,873,21,15,9,183,510,397,2043,0,0
2301,907,367,1088,873,21,15,9,181,506,398,2043,0,0
2302,920,371,1108,897,21,15,9,188,526,399,2043,0,0
2303,931,377,1125,927,21,15,9,194,550,400,2043,0,0
2304,933,387,1130,951,21,15,9,197,564,401,2043,0,0
2305,933,395,1127,956,21,15,9,194,561,402,2043,0,0
2306,925,400,1117,961,21,15,9,192,561,403,2043,0,0
2307,918,399,1112,963,21,15,9,194,564,404,2043,0,0
2308,923,406,1117,961,21,15,9,194,555,405,2043,0,0
2309,940,414,1135,968,21,15,9,195,554,406,2043,0,0
2310,970,420,1162,966,21,15,9,192,546,407,2043,0,0
2311,998,425,1195,995,21,15,9,197,570,408,2043,0,0
2312,1017,433,1210,1002,21,15,9,193,569,409,2043,0,0
2313,1031,431,1231,1015,21,15,9,200,584,410,2043,0,0
2314,1040,431,1244,1026,21,15,9,204,595,411,2043,0,0
2315,1047,442,1247,1027,21,15,9,200,585,412,2043,0,0
2316,1054,448,1253,1022,21,15,9,199,574,413,2043,0,0
2317,1057,449,1260,1029,21,15,9,203,580,414,2043,0,0
2318,1057,451,1261,1029,21,15,9,204,578,415,2043,0,0
2319,1055,454,1259,1029,21,15,9,204,575,416,2043,0,0
2320,1046,448,1256,1033,21,15,9,210,585,417,2043,0,0
2321,1028,441,1243,1033,21,15,9,215,592,418,2043,0,0
2322,1009,431,1224,1021,21,15,9,215,590,419,2043,0,0
2323,983,422,1202,1020,21,15,9,219,598,420,2043,0,0
2324,951,414,1164,1000,21,15,9,213,586,421,2043,0,0
2325,934,411,1138,980,21,15,9,204,569,422,2043,0,0
2326,918,403,1121,972,21,15,9,203,569,423,2043,0,0
2327,906,398,1106,964,21,15,9,200,566,424,2043,0,0
2328,901,390,1096,946,21,15,9,195,556,425,2043,0,0
2329,901,379,1091,921,21,15,9,190,542,426,2043,0,0
2330,898,370,1081,889,21,15,9,183,519,427,2043,0,0
2331,887,366,1069,882,21,15,9,182,516,428,2043,0,0
2332,871,357,1055,880,21,15,9,184,523,429,2043,0,0
2333,853,352,1035,874,21,15,9,182,522,430,2043,0,0
2334,836,342,1015,859,21,15,9,179,517,431,2043,0,0
2335,823,333,998,841,21,15,9,175,508,432,2043,0,0
2336,816,330,987,835,21,15,9,171,505,433,2043,0,0
2337,814,330,983,833,21,15,9,169,503,434,2043,0,0
2338,817,327,985,826,21,15,9,168,499,435,2043,0,0
2339,827,322,994,813,21,15,9,167,491,436,2043,0,0
2340,845,322,1008,797,21,15,9,163,475,437,2043,0,0
2341,862,325,1018,776,21,15,9,156,451,438,2043,0,0
2342,874,326,1027,773,21,15,9,153,447,439,2043,0,0
2343,881,325,1033,773,21,15,9,152,448,440,2043,0,0
2344,883,322,1033,772,21,15,9,150,450,441,2043,0,0
2345,882,317,1031,770,21,15,9,149,453,442,2043,0,0
2346,878,310,1025,765,21,15,9,147,455,443,2043,0,0
2347,872,304,1018,766,21,15,9,146,462,444,2043,0,0
2348,871,309,1014,767,21,15,9,143,458,445,2043,0,0
2349,867,309,1009,770,21,15,9,142,461,446,2043,0,0
2350,864,314,1004,776,21,15,9,140,462,447,2043,0,0
2351,863,316,1001,778,21,15,9,138,462,448,2043,0,0
2352,860,316,997,780,21,15,9,137,464,449,2043,0,0
2353,859,318,995,783,21,15,9,136,465,450,2043,0,0
2354,860,321,994,786,21,15,9,134,465,451,2043,0,0
2355,860,324,993,787,21,15,9,133,463,452,2043,0,0
2356,863,327,999,792,21,15,9,136,465,453,2043,0,0
2357,865,328,1001,792,21,15,9,136,464,454,2043,0,0
2358,868,330,1006,793,21,15,9,138,463,455,2043,0,0
2359,875,330,1015,795,21,15,9,140,465,456,2043,0,0
2360,889,339,1032,816,21,15,9,143,477,457,2043,0,0
2361,900,350,1045,837,21,15,9,145,487,458,2043,0,0
2362,904,360,1049,851,21,15,9,145,491,459,2043,0,0
2363,903,362,1053,866,21,15,9,150,504,460,2043,0,0
2364,895,365,1050,872,21,15,9,155,507,461,2043,0,0
2365,896,367,1055,882,21,15,9,159,515,462,2043,0,0
2366,903,373,1064,887,21,15,9,161,514,463,2043,0,0
2367,914,377,1078,895,21,15,9,164,518,464,2043,0,0
2368,936,384,1098,896,21,15,9,162,512,465,2043,0,0
2369,956,388,1117,904,21,15,9,161,516,466,2043,0,0
2370,973,388,1139,929,21,15,9,166,541,467,2043,0,0
2371,984,390,1150,934,21,15,9,166,544,468,2043,0,0
2372,989,386,1155,933,21,15,9,166,547,469,2043,0,0
2373,989,388,1156,938,21,15,9,167,550,470,2043,0,0
2374,991,391,1159,943,21,15,9,168,552,471,2043,0,0
2375,992,392,1159,937,21,15,9,167,545,472,2043,0,0
2376,990,397,1159,940,21,15,9,169,543,473,2043,0,0
2377,986,397,1159,943,21,15,9,173,546,474,2043,0,0
2378,977,393,1151,939,21,15,9,174,546,475,2043,0,0
2379,960,393,1139,939,21,15,9,179,546,476,2043,0,0
2380,939,390,1122,938,21,15,9,183,548,477,2043,0,0
2381,915,384,1101,938,21,15,9,186,554,478,2043,0,0
2382,894,382,1077,928,21,15,9,183,546,479,2043,0,0
2383,863,376,1046,921,21,15,9,183,545,480,2043,0,0
2384,848,371,1030,911,21,15,9,182,540,481,2043,0,0
2385,846,369,1026,906,21,15,9,180,537,482,2043,0,0
2386,854,368,1032,898,21,15,9,178,530,483,2043,0,0
2387,865,361,1039,878,21,15,9,174,517,484,2043,0,0
2388,880,356,1047,852,21,15,9,167,496,485,2043,0,0
2389,897,354,1060,840,21,15,9,163,486,486,2043,0,0
2390,902,346,1062,832,21,15,9,160,486,487,2043,0,0
2391,906,341,1066,826,21,15,9,160,485,488,2043,0,0
2392,912,337,1069,814,21,15,9,157,477,489,2043,0,0
2393,911,336,1067,803,21,15,9,156,467,490,2043,0,0
2394,910,337,1064,799,21,15,9,154,462,491,2043,0,0
2395,910,337,1065,796,21,15,9,155,459,492,2043,0,0
2396,908,337,1065,800,21,15,9,157,463,493,2043,0,0
2397,907,335,1066,801,21,15,9,159,466,494,2043,0,0
2398,907,335,1068,805,21,15,9,161,470,495,2043,0,0
2399,898,333,1060,810,21,15,9,162,477,496,2043,0,0
2400,903,334,1064,809,21,15,9,161,475,497,2043,0,0
2401,907,333,1068,809,21,15,9,161,476,498,2043,0,0
2402,909,337,1067,810,21,15,9,158,473,499,2043,0,0
2403,913,340,1069,810,21,15,9,156,470,500,2043,0,0
2404,918,341,1072,808,21,15,9,154,467,501,2043,0,0
2405,916,342,1070,814,21,15,9,154,472,502,2043,0,0
2406,916,346,1068,815,21,15,9,152,469,503,2043,0,0
2407,917,348,1067,817,21,15,9,150,469,504,2043,0,0
2408,916,348,1067,821,21,15,9,151,473,505,2043,0,0
2409,916,350,1065,820,21,15,9,149,470,506,2043,0,0
2410,916,351,1064,820,21,15,9,148,469,507,2043,0,0
2411,915,352,1061,818,21,15,9,146,466,508,2043,0,0
2412,907,350,1055,817,21,15,9,148,467,509,2043,0,0
2413,904,351,1055,824,21,15,9,151,473,510,2043,0,0
2414,896,350,1051,828,21,15,9,155,478,511,2043,0,0
2415,890,350,1049,830,21,15,9,159,480,512,2043,0,0
2416,889,350,1050,831,21,15,9,161,481,513,2043,0,0
2417,886,348,1050,832,21,15,9,164,484,514,2043,0,0
2418,886,352,1050,835,21,15,9,164,483,515,2043,0,0
2419,885,348,1051,836,21,15,9,166,488,516,2043,0,0
2420,884,347,1051,834,21,15,9,167,487,517,2043,0,0
2421,883,347,1051,831,21,15,9,168,484,518,2043,0,0
2422,882,346,1051,830,21,15,9,169,484,519,2043,0,0
2423,882,346,1052,832,21,15,9,170,486,520,2043,0,0
2424,884,347,1053,832,21,15,9,169,485,521,2043,0,0
2425,888,348,1058,829,21,15,9,170,481,522,2043,0,0
2426,893,348,1065,829,21,15,9,172,481,523,2043,0,0
2427,890,350,1063,830,21,15,9,173,480,524,2043,0,0
2428,895,351,1071,829,21,15,9,176,478,525,2043,0,0
2429,888,353,1064,827,21,15,9,176,474,526,2043,0,0
2430,886,352,1062,826,21,15,9,176,474,527,2043,0,0
2431,888,354,1066,828,21,15,9,178,474,528,2043,0,0
2432,888,352,1067,826,21,15,9,179,474,529,2043,0,0
2433,890,352,1071,830,21,15,9,181,478,530,2043,0,0
2434,889,351,1073,832,21,15,9,184,481,531,2043,0,0
2435,889,351,1074,832,21,15,9,185,481,532,2043,0,0
2436,889,350,1075,830,21,15,9,186,480,533,2043,0,0
2437,885,351,1070,829,21,15,9,185,478,534,2043,0,0
2438,885,350,1072,830,21,15,9,187,480,535,2043,0,0
2439,885,350,1071,829,21,15,9,186,479,536,2043,0,0
2440,884,352,1071,833,21,15,9,187,481,537,2043,0,0
2441,887,353,1073,830,21,15,9,186,477,538,2043,0,0
2442,887,353,1074,831,21,15,9,187,478,539,2043,0,0
2443,886,352,1073,827,21,15,9,187,475,540,2043,0,0
2444,886,351,1073,825,21,15,9,187,474,541,2043,0,0
2445,885,350,1072,826,21,15,9,187,476,542,2043,0,0
2446,882,348,1071,828,21,15,9,189,480,543,2043,0,0
2447,884,346,1075,828,21,15,9,191,482,544,2043,0,0
2448,886,348,1078,829,21,15,9,192,481,545,2043,0,0
2449,886,350,1078,830,21,15,9,192,480,546,2043,0,0
2450,885,350,1076,830,21,15,9,191,480,547,2043,0,0
2451,888,347,1080,826,21,15,9,192,479,548,2043,0,0
2452,890,350,1082,826,21,15,9,192,476,549,2043,0,0
2453,891,351,1084,825,21,15,9,193,474,550,2043,0,0
2454,888,346,1083,826,21,15,9,195,480,551,2043,0,0
2455,883,344,1079,826,21,15,9,196,482,552,2043,0,0
2456,884,350,1078,827,21,15,9,194,477,553,2043,0,0
2457,886,351,1080,826,21,15,9,194,475,554,2043,0,0
2458,887,348,1082,826,21,15,9,195,478,555,2043,0,0
2459,888,350,1082,823,21,15,9,194,473,556,2043,0,0
2460,884,347,1081,828,21,15,9,197,481,557,2043,0,0
2461,880,347,1078,828,21,15,9,198,481,558,2043,0,0
2462,879,347,1077,828,21,15,9,198,481,559,2043,0,0
2463,878,347,1076,829,21,15,9,198,482,560,2043,0,0
2464,879,347,1076,827,21,15,9,197,480,561,2043,0,0
2465,881,351,1076,827,21,15,9,195,476,562,2043,0,0
2466,882,349,1077,827,21,15,9,195,478,563,2043,0,0
2467,883,351,1078,828,21,15,9,195,477,564,2043,0,0
2468,884,351,1078,828,21,15,9,194,477,565,2043,0,0
2469,884,351,1078,828,21,15,9,194,477,566,2043,0,0
2470,882,350,1077,827,21,15,9,195,477,567,2043,0,0
2471,884,350,1079,828,21,15,9,195,478,568,2043,0,0
2472,885,350,1079,829,21,15,9,194,479,569,2043,0,0
2473,886,350,1080,828,21,15,9,194,478,570,2043,0,0
2474,884,350,1077,829,21,15,9,193,479,571,2043,0,0
2475,883,348,1078,831,21,15,9,195,483,572,2043,0,0
2476,881,344,1078,830,21,15,9,197,486,573,2043,0,0
2477,881,343,1078,830,21,15,9,197,487,574,2043,0,0
2478,882,347,1078,830,21,15,9,196,483,575,2043,0,0
2479,882,347,1076,827,21,15,9,194,480,576,2043,0,0
2480,884,348,1077,824,21,15,9,193,476,577,2043,0,0
2481,881,345,1077,829,21,15,9,196,484,578,2043,0,0
2482,882,343,1078,828,21,15,9,196,485,579,2043,0,0
2483,882,345,1078,830,21,15,9,196,485,580,2043,0,0
2484,883,344,1079,828,21,15,9,196,484,581,2043,0,0
2485,885,345,1080,828,21,15,9,195,483,582,2043,0,0
2486,886,350,1080,827,21,15,9,194,477,583,2043,0,0
2487,885,348,1080,827,21,15,9,195,479,584,2043,0,0
2488,885,347,1081,827,21,15,9,196,480,585,2043,0,0
2489,885,347,1081,827,21,15,9,196,480,586,2043,0,0
2490,885,346,1082,827,21,15,9,197,481,587,2043,0,0
2491,885,348,1080,829,21,15,9,195,481,588,2043,0,0
2492,883,350,1078,831,21,15,9,195,481,589,2043,0,0
2493,883,350,1078,829,21,15,9,195,479,590,2043,0,0
2494,882,349,1078,830,21,15,9,196,481,591,2043,0,0
2495,881,345,1079,831,21,15,9,198,486,592,2043,0,0
2496,883,346,1079,829,21,15,9,196,483,593,2043,0,0
2497,882,346,1078,830,21,15,9,196,484,594,2043,0,0
2498,884,346,1079,826,21,15,9,195,480,595,2043,0,0
2499,884,347,1078,827,21,15,9,194,480,596,2043,0,0
2500,886,351,1079,827,21,15,9,193,476,597,2043,0,0
2501,886,352,1080,827,21,15,9,194,475,598,2043,0,0
2502,885,353,1080,829,21,15,9,195,476,599,2043,0,0
2503,885,351,1081,830,21,15,9,196,479,600,2043,0,0
2504,885,349,1082,828,21,15,9,197,479,601,2043,0,0
2505,881,351,1077,828,21,15,9,196,477,602,2043,0,0
2506,886,353,1080,826,21,15,9,194,473,603,2043,0,0
2507,884,350,1081,829,21,15,9,197,479,604,2043,0,0
2508,882,351,1079,829,21,15,9,197,478,605,2043,0,0
2509,884,355,1078,829,21,15,9,194,474,606,2043,0,0
2510,885,356,1079,828,21,15,9,194,472,607,2043,0,0
2511,886,350,1082,824,21,15,9,196,474,608,2043,0,0
2512,887,352,1083,824,21,15,9,196,472,609,2043,0,0
2513,883,352,1082,830,21,15,9,199,478,610,2043,0,0
2514,881,352,1081,830,21,15,9,200,478,611,2043,0,0
2515,880,350,1081,831,21,15,9,201,481,612,2043,0,0
2516,881,350,1081,830,21,15,9,200,480,613,2043,0,0
2517,884,352,1084,829,21,15,9,200,477,614,2043,0,0
2518,883,354,1080,825,21,15,9,197,471,615,2043,0,0
2519,899,358,1092,822,21,15,9,193,464,616,2043,0,0
2520,904,350,1096,816,21,15,9,192,466,617,2043,0,0
2521,909,349,1100,817,21,15,9,191,468,618,2043,0,0
2522,898,347,1086,815,21,15,9,188,468,619,2043,0,0
2523,891,348,1072,812,21,15,9,181,464,620,2043,0,0
2524,890,345,1068,815,21,15,9,178,470,621,2043,0,0
2525,899,348,1074,816,21,15,9,175,468,622,2043,0,0
2526,912,351,1087,817,21,15,9,175,466,623,2043,0,0
2527,920,351,1093,813,21,15,9,173,462,624,2043,0,0
2528,919,351,1092,814,21,15,9,173,463,625,2043,0,0
2529,924,349,1097,812,21,15,9,173,463,626,2043,0,0
2530,932,345,1113,816,21,15,9,181,471,627,2043,0,0
2531,927,347,1107,816,21,15,9,180,469,628,2043,0,0
2532,920,351,1099,816,21,15,9,179,465,629,2043,0,0
2533,914,349,1094,820,21,15,9,180,471,630,2043,0,0
2534,914,353,1090,818,21,15,9,176,465,631,2043,0,0
2535,918,352,1094,819,21,15,9,176,467,632,2043,0,0
2536,928,345,1109,817,21,15,9,181,472,633,2043,0,0
2537,919,346,1097,815,21,15,9,178,469,634,2043,0,0
2538,915,344,1090,813,21,15,9,175,469,635,2043,0,0
2539,908,341,1080,806,21,15,9,172,465,636,2043,0,0
2540,905,340,1076,808,21,15,9,171,468,637,2043,0,0
2541,896,341,1063,808,21,15,9,167,467,638,2043,0,0
2542,895,334,1059,803,21,15,9,164,469,639,2043,0,0
2543,895,335,1060,806,21,15,9,165,471,640,2043,0,0
2544,893,332,1061,812,21,15,9,168,480,641,2043,0,0
2545,894,335,1057,806,21,15,9,163,471,642,2043,0,0
2546,896,338,1058,804,21,15,9,162,466,643,2043,0,0
2547,898,340,1057,802,21,15,9,159,462,644,2043,0,0
2548,895,339,1054,804,21,15,9,159,465,645,2043,0,0
2549,898,337,1056,805,21,15,9,158,468,646,2043,0,0
2550,900,336,1059,805,21,15,9,159,469,647,2043,0,0
2551,899,337,1057,806,21,15,9,158,469,648,2043,0,0
2552,898,337,1055,805,21,15,9,157,468,649,2043,0,0
2553,900,339,1056,804,21,15,9,156,465,650,2043,0,0
2554,900,338,1056,802,21,15,9,156,464,651,2043,0,0
2555,905,340,1060,802,21,15,9,155,462,652,2043,0,0
2556,900,340,1053,804,21,15,9,153,464,653,2043,0,0
2557,901,342,1051,799,21,15,9,150,457,654,2043,0,0
2558,897,339,1048,800,21,15,9,151,461,655,2043,0,0
2559,897,340,1047,803,21,15,9,150,463,656,2043,0,0
2560,898,340,1047,805,21,15,9,149,465,657,2043,0,0
2561,901,340,1050,805,21,15,9,149,465,658,2043,0,0
2562,910,339,1062,804,21,15,9,152,465,659,2043,0,0
2563,907,338,1059,807,21,15,9,152,469,660,2043,0,0
2564,902,338,1052,809,21,15,9,150,471,661,2043,0,0
2565,904,340,1053,808,21,15,9,149,468,662,2043,0,0
2566,902,338,1051,808,21,15,9,149,470,663,2043,0,0
2567,900,338,1047,808,21,15,9,147,470,664,2043,0,0
2568,908,340,1054,804,21,15,9,146,464,665,2043,0,0
2569,904,340,1050,804,21,15,9,146,464,666,2043,0,0
2570,909,341,1054,802,21,15,9,145,461,667,2043,0,0
2571,903,343,1047,803,21,15,9,144,460,668,2043,0,0
2572,903,339,1048,803,21,15,9,145,464,669,2043,0,0
2573,901,343,1041,793,21,15,9,140,450,670,2043,0,0
2574,903,345,1043,787,21,15,9,140,442,671,2043,0,0
2575,895,339,1040,795,21,15,9,145,456,672,2043,0,0
2576,903,343,1046,790,21,15,9,143,447,673,2043,0,0
2577,896,345,1041,794,21,15,9,145,449,674,2043,0,0
2578,890,346,1037,799,21,15,9,147,453,675,2043,0,0
2579,890,349,1033,791,21,15,9,143,442,676,2043,0,0
2580,891,349,1033,791,21,15,9,142,442,677,2043,0,0
2581,890,349,1034,794,21,15,9,144,445,678,2043,0,0
2582,894,342,1039,795,21,15,9,145,453,679,2043,0,0
2583,899,341,1049,814,21,15,9,150,473,680,2043,0,0
2584,902,340,1054,827,21,15,9,152,487,681,2043,0,0
2585,905,338,1059,831,21,15,9,154,493,682,2043,0,0
2586,912,340,1066,836,21,15,9,154,496,683,2043,0,0
2587,916,343,1069,836,21,15,9,153,493,684,2043,0,0
2588,913,347,1066,834,21,15,9,153,487,685,2043,0,0
2589,910,346,1062,826,21,15,9,152,480,686,2043,0,0
2590,906,346,1060,830,21,15,9,154,484,687,2043,0,0
2591,895,340,1055,835,21,15,9,160,495,688,2043,0,0
2592,884,338,1045,829,21,15,9,161,491,689,2043,0,0
2593,866,335,1029,829,21,15,9,163,494,690,2043,0,0
2594,853,333,1016,826,21,15,9,163,493,691,2043,0,0
2595,846,326,1013,826,21,15,9,167,500,692,2043,0,0
2596,845,323,1011,821,21,15,9,166,498,693,2043,0,0
2597,846,321,1009,815,21,15,9,163,494,694,2043,0,0
2598,855,325,1013,810,21,15,9,158,485,695,2043,0,0
2599,862,328,1019,810,21,15,9,157,482,696,2043,0,0
2600,874,331,1030,813,21,15,9,156,482,697,2043,0,0
2601,883,334,1039,812,21,15,9,156,478,698,2043,0,0
2602,887,338,1040,810,21,15,9,153,472,699,2043,0,0
2603,895,339,1046,810,21,15,9,151,471,700,2043,0,0
2604,894,338,1046,813,21,15,9,152,475,701,2043,0,0
2605,895,342,1042,809,21,15,9,147,467,702,2043,0,0
2606,897,345,1041,808,21,15,9,144,463,703,2043,0,0
2607,897,346,1040,810,21,15,9,143,464,704,2043,0,0
2608,905,341,1050,807,21,15,9,145,466,705,2043,0,0
2609,907,339,1053,804,21,15,9,146,465,706,2043,0,0
2610,904,337,1053,809,21,15,9,149,472,707,2043,0,0
2611,905,335,1055,808,21,15,9,150,473,708,2043,0,0
2612,901,336,1051,808,21,15,9,150,472,709,2043,0,0
2613,901,334,1053,807,21,15,9,152,473,710,2043,0,0
2614,899,334,1050,807,21,15,9,151,473,711,2043,0,0
2615,900,335,1053,809,21,15,9,153,474,712,2043,0,0
2616,894,335,1046,812,21,15,9,152,477,713,2043,0,0
2617,891,334,1041,813,21,15,9,150,479,714,2043,0,0
2618,891,332,1040,811,21,15,9,149,479,715,2043,0,0
2619,895,330,1043,808,21,15,9,148,478,716,2043,0,0
2620,901,330,1050,805,21,15,9,149,475,717,2043,0,0
2621,898,331,1047,805,21,15,9,149,474,718,2043,0,0
2622,891,332,1037,806,21,15,9,146,474,719,2043,0,0
2623,890,334,1036,809,21,15,9,146,475,720,2043,0,0
2624,896,338,1046,827,21,15,9,150,489,721,2043,0,0
2625,902,339,1056,838,21,15,9,154,499,722,2043,0,0
2626,911,344,1067,841,21,15,9,156,497,723,2043,0,0
2627,907,349,1069,850,21,15,9,162,501,724,2043,0,0
2628,898,360,1062,855,21,15,9,164,495,725,2043,0,0
2629,904,369,1077,876,21,15,9,173,507,726,2043,0,0
2630,915,373,1102,898,21,15,9,187,525,727,2043,0,0
2631,930,378,1122,881,21,15,9,192,503,728,2043,0,0
2632,964,393,1160,894,21,15,9,196,501,729,2043,0,0
2633,983,397,1195,938,21,15,9,212,541,730,2043,0,0
2634,994,404,1213,965,21,15,9,219,561,731,2043,0,0
2635,1000,412,1218,972,21,15,9,218,560,732,2043,0,0
2636,996,412,1210,974,21,15,9,214,562,733,2043,0,0
2637,997,419,1210,977,21,15,9,213,558,734,2043,0,0
2638,1005,429,1209,965,21,15,9,204,536,735,2043,0,0
2639,1006,427,1210,968,21,15,9,204,541,736,2043,0,0
2640,1005,428,1209,971,21,15,9,204,543,737,2043,0,0
2641,1005,429,1205,969,21,15,9,200,540,738,2043,0,0
2642,1006,425,1206,967,21,15,9,200,542,739,2043,0,0
2643,1008,424,1206,964,21,15,9,198,540,740,2043,0,0
2644,1005,423,1206,968,21,15,9,201,545,741,2043,0,0
2645,1006,422,1207,968,21,15,9,201,546,742,2043,0,0
2646,1008,422,1214,976,21,15,9,206,554,743,2043,0,0
2647,1008,420,1214,976,21,15,9,206,556,744,2043,0,0
2648,1007,418,1215,979,21,15,9,208,561,745,2043,0,0
2649,1009,415,1219,980,21,15,9,210,565,746,2043,0,0
2650,1002,417,1213,994,21,15,9,211,577,747,2043,0,0
2651,1003,420,1211,994,21,15,9,208,574,748,2043,0,0
2652,1002,421,1208,994,21,15,9,206,573,749,2043,0,0
2653,1002,420,1205,988,21,15,9,203,568,750,2043,0,0
2654,1003,423,1201,981,21,15,9,198,558,751,2043,0,0
2655,1002,424,1198,981,21,15,9,196,557,752,2043,0,0
2656,997,425,1190,976,21,15,9,193,551,753,2043,0,0
2657,994,428,1185,979,21,15,9,191,551,754,2043,0,0
2658,996,427,1187,982,21,15,9,191,555,755,2043,0,0
2659,998,427,1187,980,21,15,9,189,553,756,2043,0,0
2660,1002,428,1190,980,21,15,9,188,552,757,2043,0,0
2661,1003,429,1190,979,21,15,9,187,550,758,2043,0,0
2662,1006,429,1192,984,21,15,9,186,555,759,2043,0,0
2663,1006,430,1191,984,21,15,9,185,554,760,2043,0,0
2664,1008,430,1192,983,21,15,9,184,553,761,2043,0,0
2665,1007,431,1189,984,21,15,9,182,553,762,2043,0,0
2666,1004,428,1186,980,21,15,9,182,552,763,2043,0,0
2667,1002,425,1184,981,21,15,9,182,556,764,2043,0,0
2668,1005,429,1188,986,21,15,9,183,557,765,2043,0,0
2669,1005,425,1187,981,21,15,9,182,556,766,2043,0,0
2670,1005,426,1186,981,21,15,9,181,555,767,2043,0,0
2671,1006,426,1189,986,21,15,9,183,560,768,2043,0,0
2672,1006,427,1189,987,21,15,9,183,560,769,2043,0,0
2673,1006,426,1188,983,21,15,9,182,557,770,2043,0,0
2674,1006,426,1186,981,21,15,9,180,555,771,2043,0,0
2675,1006,424,1186,983,21,15,9,180,559,772,2043,0,0
2676,1007,425,1182,966,21,15,9,175,541,773,2043,0,0
2677,1009,426,1181,960,21,15,9,172,534,774,2043,0,0
2678,1010,426,1183,962,21,15,9,173,536,775,2043,0,0
2679,1011,428,1185,964,21,15,9,174,536,776,2043,0,0
2680,1013,420,1189,966,21,15,9,176,546,777,2043,0,0
2681,1014,409,1191,959,21,15,9,177,550,778,2043,0,0
2682,1017,407,1199,967,21,15,9,182,560,779,2043,0,0
2683,1018,405,1202,969,21,15,9,184,564,780,2043,0,0
2684,1016,405,1201,971,21,15,9,185,566,781,2043,0,0
2685,1014,407,1197,973,21,15,9,183,566,782,2043,0,0
2686,1011,406,1191,969,21,15,9,180,563,783,2043,0,0
2687,1012,402,1194,971,21,15,9,182,569,784,2043,0,0
2688,1016,403,1194,959,21,15,9,178,556,785,2043,0,0
2689,1017,403,1192,953,21,15,9,175,550,786,2043,0,0
2690,1022,407,1199,957,21,15,9,177,550,787,2043,0,0
2691,1016,410,1191,959,21,15,9,175,549,788,2043,0,0
2692,1013,411,1188,962,21,15,9,175,551,789,2043,0,0
2693,1021,407,1198,958,21,15,9,177,551,790,2043,0,0
2694,1016,406,1194,961,21,15,9,178,555,791,2043,0,0
2695,1013,407,1191,964,21,15,9,178,557,792,2043,0,0
2696,1016,405,1196,969,21,15,9,180,564,793,2043,0,0
2697,1028,405,1214,976,21,15,9,186,571,794,2043,0,0
2698,1034,414,1221,979,21,15,9,187,565,795,2043,0,0
2699,1034,414,1225,984,21,15,9,191,570,796,2043,0,0
2700,1040,421,1231,979,21,15,9,191,558,797,2043,0,0
2701,1036,421,1229,985,21,15,9,193,564,798,2043,0,0
2702,1035,421,1227,981,21,15,9,192,560,799,2043,0,0
2703,1038,422,1229,979,21,15,9,191,557,800,2043,0,0
2704,1035,423,1229,982,21,15,9,194,559,801,2043,0,0
2705,1031,419,1226,983,21,15,9,195,564,802,2043,0,0
2706,1022,421,1216,979,21,15,9,194,558,803,2043,0,0
2707,1018,417,1216,987,21,15,9,198,570,804,2043,0,0
2708,1007,406,1210,987,21,15,9,203,581,805,2043,0,0
2709,1002,398,1209,986,21,15,9,207,588,806,2043,0,0
2710,995,392,1206,983,21,15,9,211,591,807,2043,0,0
2711,989,388,1201,980,21,15,9,212,592,808,2043,0,0
2712,987,385,1198,976,21,15,9,211,591,809,2043,0,0
2713,984,386,1195,975,21,15,9,211,589,810,2043,0,0
2714,982,387,1191,973,21,15,9,209,586,811,2043,0,0
2715,981,385,1186,959,21,15,9,205,574,812,2043,0,0
2716,984,390,1187,959,21,15,9,203,569,813,2043,0,0
2717,990,396,1189,958,21,15,9,199,562,814,2043,0,0
2718,995,396,1193,956,21,15,9,198,560,815,2043,0,0
2719,999,404,1194,960,21,15,9,195,556,816,2043,0,0
2720,999,413,1193,963,21,15,9,194,550,817,2043,0,0
2721,1003,414,1197,966,21,15,9,194,552,818,2043,0,0
2722,1007,422,1198,966,21,15,9,191,544,819,2043,0,0
2723,1009,426,1198,963,21,15,9,189,537,820,2043,0,0
2724,1011,429,1199,964,21,15,9,188,535,821,2043,0,0
2725,1013,430,1199,959,21,15,9,186,529,822,2043,0,0
2726,1018,432,1202,956,21,15,9,184,524,823,2043,0,0
2727,1020,432,1205,955,21,15,9,185,523,824,2043,0,0
2728,1019,430,1204,954,21,15,9,185,524,825,2043,0,0
2729,1017,428,1203,954,21,15,9,186,526,826,2043,0,0
2730,1016,428,1203,959,21,15,9,187,531,827,2043,0,0
2731,1018,427,1205,958,21,15,9,187,531,828,2043,0,0
2732,1019,430,1206,956,21,15,9,187,526,829,2043,0,0
2733,1020,430,1206,954,21,15,9,186,524,830,2043,0,0
2734,1019,430,1206,953,21,15,9,187,523,831,2043,0,0
2735,1017,429,1205,955,21,15,9,188,526,832,2043,0,0
2736,1016,427,1207,963,21,15,9,191,536,833,2043,0,0
2737,1017,425,1207,960,21,15,9,190,535,834,2043,0,0
2738,1016,426,1205,960,21,15,9,189,534,835,2043,0,0
2739,1015,427,1205,962,21,15,9,190,535,836,2043,0,0
2740,1018,425,1208,962,21,15,9,190,537,837,2043,0,0
2741,1018,426,1208,962,21,15,9,190,536,838,2043,0,0
2742,1020,425,1209,960,21,15,9,189,535,839,2043,0,0
2743,1022,425,1210,957,21,15,9,188,532,840,2043,0,0
2744,1022,425,1210,957,21,15,9,188,532,841,2043,0,0
2745,1023,424,1211,959,21,15,9,188,535,842,2043,0,0
2746,1022,423,1212,964,21,15,9,190,541,843,2043,0,0
2747,1022,423,1212,965,21,15,9,190,542,844,2043,0,0
2748,1023,423,1213,966,21,15,9,190,543,845,2043,0,0
2749,1024,422,1213,966,21,15,9,189,544,846,2043,0,0
2750,1023,423,1210,960,21,15,9,187,537,847,2043,0,0
2751,1022,422,1207,957,21,15,9,185,535,848,2043,0,0
2752,1014,417,1203,961,21,15,9,189,544,849,2043,0,0
2753,1010,412,1204,967,21,15,9,194,555,850,2043,0,0
2754,1001,402,1199,964,21,15,9,198,562,851,2043,0,0
2755,1004,398,1201,953,21,15,9,197,555,852,2043,0,0
2756,994,390,1195,953,21,15,9,201,563,853,2043,0,0
2757,986,387,1191,961,21,15,9,205,574,854,2043,0,0
2758,989,386,1197,966,21,15,9,208,580,855,2043,0,0
2759,993,386,1200,961,21,15,9,207,575,856,2043,0,0
2760,991,387,1196,961,21,15,9,205,574,857,2043,0,0
2761,989,385,1192,952,21,15,9,203,567,858,2043,0,0
2762,990,389,1192,951,21,15,9,202,562,859,2043,0,0
2763,995,395,1195,952,21,15,9,200,557,860,2043,0,0
2764,999,400,1198,957,21,15,9,199,557,861,2043,0,0
2765,1001,404,1200,963,21,15,9,199,559,862,2043,0,0
2766,1003,410,1200,965,21,15,9,197,555,863,2043,0,0
2767,1004,409,1198,957,21,15,9,194,548,864,2043,0,0
2768,1003,396,1199,953,21,15,9,196,557,865,2043,0,0
2769,1001,391,1200,960,21,15,9,199,569,866,2043,0,0
2770,1004,395,1203,959,21,15,9,199,564,867,2043,0,0
2771,993,390,1196,962,21,15,9,203,572,868,2043,0,0
2772,995,391,1197,958,21,15,9,202,567,869,2043,0,0
2773,996,390,1199,956,21,15,9,203,566,870,2043,0,0
2774,994,390,1196,954,21,15,9,202,564,871,2043,0,0
2775,997,393,1197,953,21,15,9,200,560,872,2043,0,0
2776,995,394,1194,954,21,15,9,199,560,873,2043,0,0
2777,999,395,1197,947,21,15,9,198,552,874,2043,0,0
2778,999,401,1197,956,21,15,9,198,555,875,2043,0,0
2779,1000,406,1194,956,21,15,9,194,550,876,2043,0,0
2780,1001,411,1195,966,21,15,9,194,555,877,2043,0,0
2781,1005,410,1200,966,21,15,9,195,556,878,2043,0,0
2782,1007,408,1202,969,21,15,9,195,561,879,2043,0,0
2783,1010,413,1202,963,21,15,9,192,550,880,2043,0,0
2784,1005,407,1197,962,21,15,9,192,555,881,2043,0,0
2785,1004,399,1198,961,21,15,9,194,562,882,2043,0,0
2786,1003,398,1194,954,21,15,9,191,556,883,2043,0,0
2787,1003,395,1196,956,21,15,9,193,561,884,2043,0,0
2788,999,391,1193,956,21,15,9,194,565,885,2043,0,0
2789,996,388,1192,951,21,15,9,196,563,886,2043,0,0
2790,994,386,1189,948,21,15,9,195,562,887,2043,0,0
2791,991,388,1187,951,21,15,9,196,563,888,2043,0,0
2792,986,387,1179,951,21,15,9,193,564,889,2043,0,0
2793,987,388,1178,950,21,15,9,191,562,890,2043,0,0
2794,992,388,1182,948,21,15,9,190,560,891,2043,0,0
2795,989,391,1177,949,21,15,9,188,558,892,2043,0,0
2796,988,394,1174,949,21,15,9,186,555,893,2043,0,0
2797,987,395,1171,949,21,15,9,184,554,894,2043,0,0
2798,985,391,1168,945,21,15,9,183,554,895,2043,0,0
2799,985,388,1165,942,21,15,9,180,554,896,2043,0,0
2800,984,387,1161,937,21,15,9,177,550,897,2043,0,0
2801,985,389,1163,942,21,15,9,178,553,898,2043,0,0
2802,987,395,1164,941,21,15,9,177,546,899,2043,0,0
2803,991,404,1170,949,21,15,9,179,545,900,2043,0,0
2804,995,420,1174,948,21,15,9,179,528,901,2043,0,0
2805,993,425,1173,942,21,15,9,180,517,902,2043,0,0
2806,994,426,1177,935,21,15,9,183,509,903,2043,0,0
2807,994,424,1182,938,21,15,9,188,514,904,2043,0,0
2808,993,424,1184,937,21,15,9,191,513,905,2043,0,0
2809,992,425,1185,936,21,15,9,193,511,906,2043,0,0
2810,990,426,1187,937,21,15,9,197,511,907,2043,0,0
2811,988,425,1187,938,21,15,9,199,513,908,2043,0,0
2812,985,424,1188,938,21,15,9,203,514,909,2043,0,0
2813,984,423,1189,936,21,15,9,205,513,910,2043,0,0
2814,983,424,1190,937,21,15,9,207,513,911,2043,0,0
2815,982,426,1191,938,21,15,9,209,512,912,2043,0,0
2816,981,425,1193,939,21,15,9,212,514,913,2043,0,0
2817,981,426,1195,941,21,15,9,214,515,914,2043,0,0
2818,980,425,1196,942,21,15,9,216,517,915,2043,0,0
2819,980,423,1197,940,21,15,9,217,517,916,2043,0,0
2820,983,428,1201,943,21,15,9,218,515,917,2043,0,0
2821,980,425,1200,943,21,15,9,220,518,918,2043,0,0
2822,978,424,1199,941,21,15,9,221,517,919,2043,0,0
2823,975,422,1196,940,21,15,9,221,518,920,2043,0,0
2824,973,421,1195,940,21,15,9,222,519,921,2043,0,0
2825,973,419,1195,938,21,15,9,222,519,922,2043,0,0
2826,972,413,1197,943,21,15,9,225,530,923,2043,0,0
2827,971,407,1199,945,21,15,9,228,538,924,2043,0,0
2828,968,397,1198,945,21,15,9,230,548,925,2043,0,0
2829,963,398,1192,954,21,15,9,229,556,926,2043,0,0
2830,961,395,1185,942,21,15,9,224,547,927,2043,0,0
2831,960,398,1188,945,21,15,9,228,547,928,2043,0,0
2832,928,398,1151,948,21,15,9,223,550,929,2043,0,0
2833,909,397,1133,954,21,15,9,224,557,930,2043,0,0
2834,900,398,1124,955,21,15,9,224,557,931,2043,0,0
2835,905,404,1140,983,21,15,9,235,579,932,2043,0,0
2836,913,407,1162,1008,21,15,9,249,601,933,2043,0,0
2837,932,413,1190,1018,21,15,9,258,605,934,2043,0,0
2838,945,418,1210,1023,21,15,9,265,605,935,2043,0,0
2839,942,418,1212,1024,21,15,9,270,606,936,2043,0,0
2840,915,422,1179,1030,21,15,9,264,608,937,2043,0,0
2841,909,425,1168,1034,21,15,9,259,609,938,2043,0,0
2842,906,424,1159,1030,21,15,9,253,606,939,2043,0,0
2843,899,426,1144,1025,21,15,9,245,599,940,2043,0,0
2844,897,426,1134,1023,21,15,9,237,597,941,2043,0,0
2845,895,420,1128,1021,21,15,9,233,601,942,2043,0,0
2846,890,415,1121,1020,21,15,9,231,605,943,2043,0,0
2847,891,409,1117,1013,21,15,9,226,604,944,2043,0,0
2848,892,402,1108,991,21,15,9,216,589,945,2043,0,0
2849,898,397,1104,966,21,15,9,206,569,946,2043,0,0
2850,909,393,1108,951,21,15,9,199,558,947,2043,0,0
2851,917,389,1114,940,21,15,9,197,551,948,2043,0,0
2852,936,385,1125,919,21,15,9,189,534,949,2043,0,0
2853,951,380,1134,901,21,15,9,183,521,950,2043,0,0
2854,957,378,1137,896,21,15,9,180,518,951,2043,0,0
2855,967,374,1148,895,21,15,9,181,521,952,2043,0,0
2856,969,374,1149,901,21,15,9,180,527,953,2043,0,0
2857,969,375,1147,897,21,15,9,178,522,954,2043,0,0
2858,959,370,1136,888,21,15,9,177,518,955,2043,0,0
2859,962,373,1139,892,21,15,9,177,519,956,2043,0,0
2860,959,373,1137,895,21,15,9,178,522,957,2043,0,0
2861,971,375,1151,894,21,15,9,180,519,958,2043,0,0
2862,969,376,1150,900,21,15,9,181,524,959,2043,0,0
2863,970,379,1151,901,21,15,9,181,522,960,2043,0,0
2864,977,378,1157,897,21,15,9,180,519,961,2043,0,0
2865,978,386,1157,899,21,15,9,179,513,962,2043,0,0
2866,978,381,1156,895,21,15,9,178,514,963,2043,0,0
2867,978,385,1153,897,21,15,9,175,512,964,2043,0,0
2868,979,391,1151,898,21,15,9,172,507,965,2043,0,0
2869,981,393,1151,898,21,15,9,170,505,966,2043,0,0
2870,983,389,1154,900,21,15,9,171,511,967,2043,0,0
2871,988,390,1161,903,21,15,9,173,513,968,2043,0,0
2872,990,391,1162,902,21,15,9,172,511,969,2043,0,0
2873,992,392,1163,896,21,15,9,171,504,970,2043,0,0
2874,993,392,1164,896,21,15,9,171,504,971,2043,0,0
2875,991,392,1162,895,21,15,9,171,503,972,2043,0,0
2876,991,392,1162,894,21,15,9,171,502,973,2043,0,0
2877,990,392,1160,894,21,15,9,170,502,974,2043,0,0
2878,990,392,1160,894,21,15,9,170,502,975,2043,0,0
2879,990,392,1159,894,21,15,9,169,502,976,2043,0,0
2880,990,392,1159,893,21,15,9,169,501,977,2043,0,0
2881,990,391,1160,898,21,15,9,170,507,978,2043,0,0
2882,989,391,1158,897,21,15,9,169,506,979,2043,0,0
2883,990,391,1159,895,21,15,9,169,504,980,2043,0,0
2884,993,393,1161,894,21,15,9,168,501,981,2043,0,0
2885,993,391,1161,897,21,15,9,168,506,982,2043,0,0
2886,991,391,1158,901,21,15,9,167,510,983,2043,0,0
2887,993,388,1161,897,21,15,9,168,509,984,2043,0,0
2888,992,386,1162,899,21,15,9,170,513,985,2043,0,0
2889,991,385,1162,901,21,15,9,171,516,986,2043,0,0
2890,991,388,1163,907,21,15,9,172,519,987,2043,0,0
2891,994,387,1163,899,21,15,9,169,512,988,2043,0,0
2892,992,382,1160,895,21,15,9,168,513,989,2043,0,0
2893,994,387,1161,894,21,15,9,167,507,990,2043,0,0
2894,985,386,1150,893,21,15,9,165,507,991,2043,0,0
2895,988,390,1156,903,21,15,9,168,513,992,2043,0,0
2896,994,392,1162,899,21,15,9,168,507,993,2043,0,0
2897,980,386,1148,899,21,15,9,168,513,994,2043,0,0
2898,971,386,1140,903,21,15,9,169,517,995,2043,0,0
2899,970,389,1139,903,21,15,9,169,514,996,2043,0,0
2900,975,388,1145,901,21,15,9,170,513,997,2043,0,0
2901,984,391,1159,908,21,15,9,175,517,998,2043,0,0
2902,991,397,1168,906,21,15,9,177,509,999,2043,0,0
2903,982,386,1160,901,21,15,9,178,515,1000,2043,0,0
2904,981,387,1156,898,21,15,9,175,511,1001,2043,0,0
2905,991,395,1163,894,21,15,9,172,499,1002,2043,0,0
2906,993,388,1167,892,21,15,9,174,504,1003,2043,0,0
2907,986,393,1160,898,21,15,9,174,505,1004,2043,0,0
2908,990,393,1160,891,21,15,9,170,498,1005,2043,0,0
2909,997,396,1171,902,21,15,9,174,506,1006,2043,0,0
2910,993,394,1169,908,21,15,9,176,514,1007,2043,0,0
2911,990,389,1164,901,21,15,9,174,512,1008,2043,0,0
2912,989,385,1161,898,21,15,9,172,513,1009,2043,0,0
2913,985,387,1155,895,21,15,9,170,508,1010,2043,0,0
2914,985,391,1151,889,21,15,9,166,498,1011,2043,0,0
2915,981,391,1148,898,21,15,9,167,507,1012,2043,0,0
2916,979,394,1145,900,21,15,9,166,506,1013,2043,0,0
2917,981,393,1147,902,21,15,9,166,509,1014,2043,0,0
2918,989,392,1155,900,21,15,9,166,508,1015,2043,0,0
2919,994,393,1161,902,21,15,9,167,509,1016,2043,0,0
2920,997,398,1162,901,21,15,9,165,503,1017,2043,0,0
2921,998,397,1163,899,21,15,9,165,502,1018,2043,0,0
2922,996,399,1163,905,21,15,9,167,506,1019,2043,0,0
2923,998,399,1165,907,21,15,9,167,508,1020,2043,0,0
2924,996,400,1163,905,21,15,9,167,505,1021,2043,0,0
2925,1001,402,1169,907,21,15,9,168,505,1022,2043,0,0
2926,1001,403,1166,904,21,15,9,165,501,1023,2043,0,0
2927,998,401,1165,903,21,15,9,167,502,1024,2043,0,0
2928,997,404,1162,899,21,15,9,165,495,1025,2043,0,0
2929,995,397,1162,894,21,15,9,167,497,1026,2043,0,0
2930,989,394,1160,898,21,15,9,171,504,1027,2043,0,0
2931,973,382,1148,902,21,15,9,175,520,1028,2043,0,0
2932,963,376,1137,898,21,15,9,174,522,1029,2043,0,0
2933,949,366,1123,898,21,15,9,174,532,1030,2043,0,0
2934,941,363,1113,895,21,15,9,172,532,1031,2043,0,0
2935,937,361,1106,889,21,15,9,169,528,1032,2043,0,0
2936,937,360,1104,888,21,15,9,167,528,1033,2043,0,0
2937,940,359,1105,889,21,15,9,165,530,1034,2043,0,0
2938,942,360,1104,889,21,15,9,162,529,1035,2043,0,0
2939,944,360,1106,897,21,15,9,162,537,1036,2043,0,0
2940,946,360,1108,903,21,15,9,162,543,1037,2043,0,0
2941,953,370,1112,910,21,15,9,159,540,1038,2043,0,0
2942,960,377,1116,906,21,15,9,156,529,1039,2043,0,0
2943,970,380,1126,910,21,15,9,156,530,1040,2043,0,0
2944,982,389,1135,907,21,15,9,153,518,1041,2043,0,0
2945,995,391,1147,900,21,15,9,152,509,1042,2043,0,0
2946,1000,395,1156,910,21,15,9,156,515,1043,2043,0,0
2947,1004,400,1163,919,21,15,9,159,519,1044,2043,0,0
2948,1006,401,1166,917,21,15,9,160,516,1045,2043,0,0
2949,1007,404,1164,906,21,15,9,157,502,1046,2043,0,0
2950,1004,407,1165,917,21,15,9,161,510,1047,2043,0,0
2951,1005,404,1166,911,21,15,9,161,507,1048,2043,0,0
2952,1005,413,1163,905,21,15,9,158,492,1049,2043,0,0
2953,1004,409,1163,903,21,15,9,159,494,1050,2043,0,0
2954,1002,403,1164,904,21,15,9,162,501,1051,2043,0,0
2955,998,399,1162,906,21,15,9,164,507,1052,2043,0,0
2956,992,392,1155,902,21,15,9,163,510,1053,2043,0,0
2957,993,390,1156,899,21,15,9,163,509,1054,2043,0,0
2958,992,384,1156,896,21,15,9,164,512,1055,2043,0,0
2959,990,386,1150,893,21,15,9,160,507,1056,2043,0,0
2960,987,381,1145,893,21,15,9,158,512,1057,2043,0,0
2961,986,381,1143,895,21,15,9,157,514,1058,2043,0,0
2962,988,382,1142,891,21,15,9,154,509,1059,2043,0,0
2963,989,383,1142,894,21,15,9,153,511,1060,2043,0,0
2964,988,388,1141,901,21,15,9,153,513,1061,2043,0,0
2965,987,388,1140,901,21,15,9,153,513,1062,2043,0,0
2966,988,390,1142,907,21,15,9,154,517,1063,2043,0,0
2967,988,390,1143,910,21,15,9,155,520,1064,2043,0,0
2968,992,387,1145,904,21,15,9,153,517,1065,2043,0,0
2969,995,390,1148,907,21,15,9,153,517,1066,2043,0,0
2970,996,392,1149,906,21,15,9,153,514,1067,2043,0,0
2971,994,389,1148,908,21,15,9,154,519,1068,2043,0,0
2972,992,383,1145,902,21,15,9,153,519,1069,2043,0,0
2973,992,382,1143,900,21,15,9,151,518,1070,2043,0,0
2974,993,385,1142,897,21,15,9,149,512,1071,2043,0,0
2975,992,388,1142,902,21,15,9,150,514,1072,2043,0,0
2976,991,389,1141,904,21,15,9,150,515,1073,2043,0,0
2977,990,389,1139,901,21,15,9,149,512,1074,2043,0,0
2978,990,391,1139,905,21,15,9,149,514,1075,2043,0,0
2979,991,392,1140,905,21,15,9,149,513,1076,2043,0,0
2980,990,393,1140,908,21,15,9,150,515,1077,2043,0,0
2981,992,393,1141,905,21,15,9,149,512,1078,2043,0,0
2982,993,395,1144,906,21,15,9,151,511,1079,2043,0,0
2983,993,398,1142,901,21,15,9,149,503,1080,2043,0,0
2984,982,397,1136,911,21,15,9,154,514,1081,2043,0,0
2985,965,394,1123,911,21,15,9,158,517,1082,2043,0,0
2986,948,393,1111,918,21,15,9,163,525,1083,2043,0,0
2987,932,396,1096,920,21,15,9,164,524,1084,2043,0,0
2988,920,406,1083,924,21,15,9,163,518,1085,2043,0,0
2989,910,414,1077,933,21,15,9,167,519,1086,2043,0,0
2990,911,423,1081,942,21,15,9,170,519,1087,2043,0,0
2991,918,420,1093,945,21,15,9,175,525,1088,2043,0,0
2992,942,417,1120,948,21,15,9,178,531,1089,2043,0,0
2993,980,424,1166,983,21,15,9,186,559,1090,2043,0,0
2994,1007,426,1195,991,21,15,9,188,565,1091,2043,0,0
2995,1027,428,1217,993,21,15,9,190,565,1092,2043,0,0
2996,1036,429,1231,993,21,15,9,195,564,1093,2043,0,0
2997,1040,434,1238,998,21,15,9,198,564,1094,2043,0,0
2998,1042,435,1247,1011,21,15,9,205,576,1095,2043,0,0
2999,1042,435,1252,1018,21,15,9,210,583,1096,2043,0,0
3000,1047,445,1253,1009,21,15,9,206,564,1097,2043,0,0
3001,1046,444,1253,1009,21,15,9,207,565,1098,2043,0,0
3002,1046,447,1254,1009,21,15,9,208,562,1099,2043,0,0
3003,1042,444,1253,1014,21,15,9,211,570,1100,2043,0,0
3004,1039,448,1248,1010,21,15,9,209,562,1101,2043,0,0
3005,1037,442,1251,1017,21,15,9,214,575,1102,2043,0,0
3006,1035,437,1251,1013,21,15,9,216,576,1103,2043,0,0
3007,1022,433,1243,1014,21,15,9,221,581,1104,2043,0,0
3008,1000,434,1219,1005,21,15,9,219,571,1105,2043,0,0
3009,976,420,1198,999,21,15,9,222,579,1106,2043,0,0
3010,951,409,1174,991,21,15,9,223,582,1107,2043,0,0
3011,930,403,1147,973,21,15,9,217,570,1108,2043,0,0
3012,922,396,1137,961,21,15,9,215,565,1109,2043,0,0
3013,931,393,1144,952,21,15,9,213,559,1110,2043,0,0
3014,948,393,1157,935,21,15,9,209,542,1111,2043,0,0
3015,957,386,1162,916,21,15,9,205,530,1112,2043,0,0
3016,963,389,1158,901,21,15,9,195,512,1113,2043,0,0
3017,962,381,1156,898,21,15,9,194,517,1114,2043,0,0
3018,959,380,1146,892,21,15,9,187,512,1115,2043,0,0
3019,952,379,1137,897,21,15,9,185,518,1116,2043,0,0
3020,941,373,1127,905,21,15,9,186,532,1117,2043,0,0
3021,944,370,1128,910,21,15,9,184,540,1118,2043,0,0
3022,949,370,1127,907,21,15,9,178,537,1119,2043,0,0
3023,951,372,1124,904,21,15,9,173,532,1120,2043,0,0
3024,956,374,1126,903,21,15,9,170,529,1121,2043,0,0
3025,959,373,1129,907,21,15,9,170,534,1122,2043,0,0
3026,968,379,1134,907,21,15,9,166,528,1123,2043,0,0
3027,980,382,1144,904,21,15,9,164,522,1124,2043,0,0
3028,988,391,1149,903,21,15,9,161,512,1125,2043,0,0
3029,997,394,1158,905,21,15,9,161,511,1126,2043,0,0
3030,1001,400,1164,913,21,15,9,163,513,1127,2043,0,0
3031,1006,401,1169,910,21,15,9,163,509,1128,2043,0,0
3032,1005,403,1167,905,21,15,9,162,502,1129,2043,0,0
3033,1000,401,1164,906,21,15,9,164,505,1130,2043,0,0
3034,998,398,1163,908,21,15,9,165,510,1131,2043,0,0
3035,995,399,1161,911,21,15,9,166,512,1132,2043,0,0
3036,996,397,1162,909,21,15,9,166,512,1133,2043,0,0
3037,996,400,1162,913,21,15,9,166,513,1134,2043,0,0
3038,996,399,1162,908,21,15,9,166,509,1135,2043,0,0
3039,996,399,1162,908,21,15,9,166,509,1136,2043,0,0
3040,996,400,1165,912,21,15,9,169,512,1137,2043,0,0
3041,998,400,1165,910,21,15,9,167,510,1138,2043,0,0
3042,998,400,1165,908,21,15,9,167,508,1139,2043,0,0
3043,996,400,1163,910,21,15,9,167,510,1140,2043,0,0
3044,995,399,1163,912,21,15,9,168,513,1141,2043,0,0
3045,995,399,1162,913,21,15,9,167,514,1142,2043,0,0
3046,993,400,1160,914,21,15,9,167,514,1143,2043,0,0
3047,993,400,1159,914,21,15,9,166,514,1144,2043,0,0
3048,992,401,1158,915,21,15,9,166,514,1145,2043,0,0
3049,996,401,1160,910,21,15,9,164,509,1146,2043,0,0
3050,996,400,1161,910,21,15,9,165,510,1147,2043,0,0
3051,999,400,1162,904,21,15,9,163,504,1148,2043,0,0
3052,998,398,1162,905,21,15,9,164,507,1149,2043,0,0
3053,1002,402,1165,908,21,15,9,163,506,1150,2043,0,0
3054,1000,402,1161,904,21,15,9,161,502,1151,2043,0,0
3055,997,397,1155,898,21,15,9,158,501,1152,2043,0,0
3056,989,391,1148,898,21,15,9,159,507,1153,2043,0,0
3057,987,387,1145,897,21,15,9,158,510,1154,2043,0,0
3058,986,385,1146,904,21,15,9,160,519,1155,2043,0,0
3059,985,385,1149,917,21,15,9,164,532,1156,2043,0,0
3060,978,389,1147,929,21,15,9,169,540,1157,2043,0,0
3061,961,386,1132,933,21,15,9,171,547,1158,2043,0,0
3062,954,391,1127,939,21,15,9,173,548,1159,2043,0,0
3063,947,394,1121,944,21,15,9,174,550,1160,2043,0,0
3064,940,396,1117,951,21,15,9,177,555,1161,2043,0,0
3065,940,401,1118,953,21,15,9,178,552,1162,2043,0,0
3066,937,400,1122,966,21,15,9,185,566,1163,2043,0,0
3067,945,402,1133,971,21,15,9,188,569,1164,2043,0,0
3068,962,407,1155,976,21,15,9,193,569,1165,2043,0,0
3069,981,410,1174,973,21,15,9,193,563,1166,2043,0,0
3070,1000,422,1191,985,21,15,9,191,563,1167,2043,0,0
3071,1015,420,1209,1007,21,15,9,194,587,1168,2043,0,0
3072,1021,420,1215,1016,21,15,9,194,596,1169,2043,0,0
3073,1028,418,1221,1014,21,15,9,193,596,1170,2043,0,0
3074,1034,412,1230,1015,21,15,9,196,603,1171,2043,0,0
3075,1042,417,1237,1016,21,15,9,195,599,1172,2043,0,0
3076,1043,418,1240,1014,21,15,9,197,596,1173,2043,0,0
3077,1052,421,1248,1012,21,15,9,196,591,1174,2043,0,0
3078,1057,432,1251,1012,21,15,9,194,580,1175,2043,0,0
3079,1066,442,1260,1016,21,15,9,194,574,1176,2043,0,0
3080,1070,441,1263,1005,21,15,9,193,564,1177,2043,0,0
3081,1056,440,1254,1011,21,15,9,198,571,1178,2043,0,0
3082,1040,434,1247,1016,21,15,9,207,582,1179,2043,0,0
3083,1023,432,1235,1018,21,15,9,212,586,1180,2043,0,0
3084,996,423,1210,1012,21,15,9,214,589,1181,2043,0,0
3085,971,414,1186,1006,21,15,9,215,592,1182,2043,0,0
3086,950,402,1162,981,21,15,9,212,579,1183,2043,0,0
3087,937,396,1146,968,21,15,9,209,572,1184,2043,0,0
3088,932,398,1136,957,21,15,9,204,559,1185,2043,0,0
3089,933,389,1138,952,21,15,9,205,563,1186,2043,0,0
3090,940,391,1140,932,21,15,9,200,541,1187,2043,0,0
3091,959,384,1158,917,21,15,9,199,533,1188,2043,0,0
3092,972,385,1161,895,21,15,9,189,510,1189,2043,0,0
3093,976,381,1165,897,21,15,9,189,516,1190,2043,0,0
3094,966,375,1153,897,21,15,9,187,522,1191,2043,0,0
3095,968,377,1143,876,21,15,9,175,499,1192,2043,0,0
3096,962,375,1135,876,21,15,9,173,501,1193,2043,0,0
3097,955,372,1127,876,21,15,9,172,504,1194,2043,0,0
3098,952,365,1127,887,21,15,9,175,522,1195,2043,0,0
3099,955,372,1128,893,21,15,9,173,521,1196,2043,0,0
3100,966,381,1137,895,21,15,9,171,514,1197,2043,0,0
3101,985,388,1161,903,21,15,9,176,515,1198,2043,0,0
3102,997,397,1176,906,21,15,9,179,509,1199,2043,0,0
3103,1002,412,1179,895,21,15,9,177,483,1200,2043,0,0
3104,1000,421,1176,883,21,15,9,176,462,1201,2043,0,0
3105,991,420,1174,885,21,15,9,183,465,1202,2043,0,0
3106,981,421,1173,892,21,15,9,192,471,1203,2043,0,0
3107,973,423,1170,892,21,15,9,197,469,1204,2043,0,0
3108,966,423,1168,891,21,15,9,202,468,1205,2043,0,0
3109,962,422,1168,886,21,15,9,206,464,1206,2043,0,0
3110,960,424,1167,879,21,15,9,207,455,1207,2043,0,0
3111,953,423,1168,885,21,15,9,215,462,1208,2043,0,0
3112,953,425,1169,879,21,15,9,216,454,1209,2043,0,0
3113,953,426,1170,874,21,15,9,217,448,1210,2043,0,0
3114,952,425,1176,879,21,15,9,224,454,1211,2043,0,0
3115,954,432,1180,884,21,15,9,226,452,1212,2043,0,0
3116,950,430,1181,889,21,15,9,231,459,1213,2043,0,0
3117,947,428,1182,890,21,15,9,235,462,1214,2043,0,0
3118,946,425,1184,890,21,15,9,238,465,1215,2043,0,0
3119,944,424,1185,892,21,15,9,241,468,1216,2043,0,0
3120,949,426,1188,887,21,15,9,239,461,1217,2043,0,0
3121,949,426,1189,886,21,15,9,240,460,1218,2043,0,0
3122,948,427,1187,882,21,15,9,239,455,1219,2043,0,0
3123,945,427,1187,883,21,15,9,242,456,1220,2043,0,0
3124,944,426,1187,882,21,15,9,243,456,1221,2043,0,0
3125,943,426,1187,883,21,15,9,244,457,1222,2043,0,0
3126,945,428,1188,877,21,15,9,243,449,1223,2043,0,0
3127,944,426,1191,881,21,15,9,247,455,1224,2043,0,0
3128,947,429,1192,879,21,15,9,245,450,1225,2043,0,0
3129,946,427,1194,883,21,15,9,248,456,1226,2043,0,0
3130,945,426,1195,887,21,15,9,250,461,1227,2043,0,0
3131,947,428,1196,884,21,15,9,249,456,1228,2043,0,0
3132,948,428,1196,881,21,15,9,248,453,1229,2043,0,0
3133,947,427,1197,885,21,15,9,250,458,1230,2043,0,0
3134,947,427,1196,884,21,15,9,249,457,1231,2043,0,0
3135,945,425,1195,886,21,15,9,250,461,1232,2043,0,0
3136,948,429,1193,879,21,15,9,245,450,1233,2043,0,0
3137,944,427,1193,883,21,15,9,249,456,1234,2043,0,0
3138,943,427,1193,884,21,15,9,250,457,1235,2043,0,0
3139,944,427,1193,880,21,15,9,249,453,1236,2043,0,0
3140,942,426,1193,883,21,15,9,251,457,1237,2043,0,0
3141,941,427,1193,885,21,15,9,252,458,1238,2043,0,0
3142,941,427,1195,887,21,15,9,254,460,1239,2043,0,0
3143,944,431,1191,881,21,15,9,247,450,1240,2043,0,0
3144,943,429,1193,883,21,15,9,250,454,1241,2043,0,0
3145,943,428,1194,883,21,15,9,251,455,1242,2043,0,0
3146,946,430,1195,882,21,15,9,249,452,1243,2043,0,0
3147,945,428,1195,883,21,15,9,250,455,1244,2043,0,0
3148,946,430,1196,884,21,15,9,250,454,1245,2043,0,0
3149,945,428,1196,885,21,15,9,251,457,1246,2043,0,0
3150,947,429,1197,884,21,15,9,250,455,1247,2043,0,0
3151,942,426,1194,887,21,15,9,252,461,1248,2043,0,0
3152,940,424,1194,889,21,15,9,254,465,1249,2043,0,0
3153,939,424,1194,889,21,15,9,255,465,1250,2043,0,0
3154,939,425,1194,892,21,15,9,255,467,1251,2043,0,0
3155,940,425,1195,891,21,15,9,255,466,1252,2043,0,0
3156,944,427,1191,881,21,15,9,247,454,1253,2043,0,0
3157,937,409,1193,884,21,15,9,256,475,1254,2043,0,0
3158,937,397,1199,886,21,15,9,262,489,1255,2043,0,0
3159,937,393,1211,913,21,15,9,274,520,1256,2043,0,0
3160,941,395,1220,932,21,15,9,279,537,1257,2043,0,0
3161,945,397,1225,942,21,15,9,280,545,1258,2043,0,0
3162,947,401,1225,949,21,15,9,278,548,1259,2043,0,0
3163,950,403,1223,948,21,15,9,273,545,1260,2043,0,0
3164,957,405,1223,943,21,15,9,266,538,1261,2043,0,0
3165,957,400,1221,941,21,15,9,264,541,1262,2043,0,0
3166,955,393,1214,931,21,15,9,259,538,1263,2043,0,0
3167,957,389,1210,921,21,15,9,253,532,1264,2043,0,0
3168,959,393,1201,902,21,15,9,242,509,1265,2043,0,0
3169,959,400,1196,898,21,15,9,237,498,1266,2043,0,0
3170,957,412,1189,897,21,15,9,232,485,1267,2043,0,0
3171,956,421,1185,897,21,15,9,229,476,1268,2043,0,0
3172,958,427,1185,894,21,15,9,227,467,1269,2043,0,0
3173,961,429,1189,897,21,15,9,228,468,1270,2043,0,0
3174,966,430,1191,891,21,15,9,225,461,1271,2043,0,0
3175,967,430,1193,891,21,15,9,226,461,1272,2043,0,0
3176,966,428,1194,891,21,15,9,228,463,1273,2043,0,0
3177,964,428,1192,889,21,15,9,228,461,1274,2043,0,0
3178,962,428,1191,891,21,15,9,229,463,1275,2043,0,0
3179,962,428,1192,891,21,15,9,230,463,1276,2043,0,0
3180,960,428,1191,892,21,15,9,231,464,1277,2043,0,0
3181,961,429,1191,887,21,15,9,230,458,1278,2043,0,0
3182,958,429,1191,889,21,15,9,233,460,1279,2043,0,0
3183,959,428,1191,886,21,15,9,232,458,1280,2043,0,0
3184,956,429,1192,892,21,15,9,236,463,1281,2043,0,0
3185,954,428,1194,896,21,15,9,240,468,1282,2043,0,0
3186,958,430,1194,892,21,15,9,236,462,1283,2043,0,0
3187,956,429,1195,895,21,15,9,239,466,1284,2043,0,0
3188,955,434,1190,892,21,15,9,235,458,1285,2043,0,0
3189,954,435,1188,890,21,15,9,234,455,1286,2043,0,0
3190,951,430,1191,895,21,15,9,240,465,1287,2043,0,0
3191,951,431,1192,895,21,15,9,241,464,1288,2043,0,0
3192,951,431,1193,896,21,15,9,242,465,1289,2043,0,0
3193,954,431,1194,892,21,15,9,240,461,1290,2043,0,0
3194,951,430,1195,897,21,15,9,244,467,1291,2043,0,0
3195,954,428,1196,894,21,15,9,242,466,1292,2043,0,0
3196,955,427,1197,893,21,15,9,242,466,1293,2043,0,0
3197,952,425,1197,895,21,15,9,245,470,1294,2043,0,0
3198,952,426,1198,898,21,15,9,246,472,1295,2043,0,0
3199,951,430,1194,893,21,15,9,243,463,1296,2043,0,0
3200,947,432,1189,889,21,15,9,242,457,1297,2043,0,0
3201,928,432,1181,900,21,15,9,253,468,1298,2043,0,0
3202,922,428,1183,900,21,15,9,261,472,1299,2043,0,0
3203,927,426,1188,894,21,15,9,261,468,1300,2043,0,0
3204,928,426,1191,894,21,15,9,263,468,1301,2043,0,0
3205,927,426,1194,895,21,15,9,267,469,1302,2043,0,0
3206,936,430,1199,892,21,15,9,263,462,1303,2043,0,0
3207,948,431,1204,882,21,15,9,256,451,1304,2043,0,0
3208,949,432,1205,882,21,15,9,256,450,1305,2043,0,0
3209,945,432,1203,887,21,15,9,258,455,1306,2043,0,0
3210,940,432,1202,890,21,15,9,262,458,1307,2043,0,0
3211,936,431,1197,886,21,15,9,261,455,1308,2043,0,0
3212,929,430,1195,889,21,15,9,266,459,1309,2043,0,0
3213,925,429,1195,896,21,15,9,270,467,1310,2043,0,0
3214,922,429,1196,900,21,15,9,274,471,1311,2043,0,0
3215,922,430,1196,900,21,15,9,274,470,1312,2043,0,0
3216,920,430,1198,904,21,15,9,278,474,1313,2043,0,0
3217,919,429,1198,903,21,15,9,279,474,1314,2043,0,0
3218,920,429,1197,899,21,15,9,277,470,1315,2043,0,0
3219,919,427,1200,902,21,15,9,281,475,1316,2043,0,0
3220,920,428,1199,898,21,15,9,279,470,1317,2043,0,0
3221,927,427,1203,895,21,15,9,276,468,1318,2043,0,0
3222,936,427,1212,903,21,15,9,276,476,1319,2043,0,0
3223,940,428,1212,901,21,15,9,272,473,1320,2043,0,0
3224,944,428,1211,898,21,15,9,267,470,1321,2043,0,0
3225,945,426,1211,896,21,15,9,266,470,1322,2043,0,0
3226,945,429,1210,902,21,15,9,265,473,1323,2043,0,0
3227,948,430,1209,898,21,15,9,261,468,1324,2043,0,0
3228,950,432,1207,894,21,15,9,257,462,1325,2043,0,0
3229,952,435,1206,892,21,15,9,254,457,1326,2043,0,0
3230,951,435,1204,891,21,15,9,253,456,1327,2043,0,0
3231,951,434,1205,893,21,15,9,254,459,1328,2043,0,0
3232,945,429,1204,900,21,15,9,259,471,1329,2043,0,0
3233,944,424,1204,902,21,15,9,260,478,1330,2043,0,0
3234,945,414,1207,901,21,15,9,262,487,1331,2043,0,0
3235,945,403,1212,905,21,15,9,267,502,1332,2043,0,0
3236,942,392,1222,927,21,15,9,280,535,1333,2043,0,0
3237,941,387,1224,939,21,15,9,283,552,1334,2043,0,0
3238,942,392,1224,947,21,15,9,282,555,1335,2043,0,0
3239,941,389,1224,953,21,15,9,283,564,1336,2043,0,0
3240,940,398,1221,959,21,15,9,281,561,1337,2043,0,0
3241,935,397,1215,959,21,15,9,280,562,1338,2043,0,0
3242,933,401,1213,966,21,15,9,280,565,1339,2043,0,0
3243,933,404,1210,966,21,15,9,277,562,1340,2043,0,0
3244,936,405,1209,960,21,15,9,273,555,1341,2043,0,0
3245,934,399,1209,957,21,15,9,275,558,1342,2043,0,0
3246,937,398,1211,957,21,15,9,274,559,1343,2043,0,0
3247,940,398,1210,955,21,15,9,270,557,1344,2043,0,0
3248,940,401,1210,957,21,15,9,270,556,1345,2043,0,0
3249,938,401,1208,959,21,15,9,270,558,1346,2043,0,0
3250,941,408,1208,961,21,15,9,267,553,1347,2043,0,0
3251,936,408,1206,973,21,15,9,270,565,1348,2043,0,0
3252,938,414,1205,974,21,15,9,267,560,1349,2043,0,0
3253,941,418,1201,971,21,15,9,260,553,1350,2043,0,0
3254,938,418,1190,965,21,15,9,252,547,1351,2043,0,0
3255,957,419,1202,959,21,15,9,245,540,1352,2043,0,0
3256,973,425,1212,957,21,15,9,239,532,1353,2043,0,0
3257,984,430,1222,978,21,15,9,238,548,1354,2043,0,0
3258,997,432,1234,992,21,15,9,237,560,1355,2043,0,0
3259,1007,427,1248,1004,21,15,9,241,577,1356,2043,0,0
3260,1014,426,1256,1013,21,15,9,242,587,1357,2043,0,0
3261,1026,433,1264,1014,21,15,9,238,581,1358,2043,0,0
3262,1036,442,1266,1007,21,15,9,230,565,1359,2043,0,0
3263,1042,438,1273,1008,21,15,9,231,570,1360,2043,0,0
3264,1042,431,1276,1007,21,15,9,234,576,1361,2043,0,0
3265,1034,430,1271,1009,21,15,9,237,579,1362,2043,0,0
3266,1012,428,1253,1015,21,15,9,241,587,1363,2043,0,0
3267,994,419,1234,1006,21,15,9,240,587,1364,2043,0,0
3268,976,415,1215,1004,21,15,9,239,589,1365,2043,0,0
3269,960,412,1196,999,21,15,9,236,587,1366,2043,0,0
3270,942,411,1171,989,21,15,9,229,578,1367,2043,0,0
3271,935,408,1158,970,21,15,9,223,562,1368,2043,0,0
3272,933,405,1152,964,21,15,9,219,559,1369,2043,0,0
3273,933,397,1154,967,21,15,9,221,570,1370,2043,0,0
3274,941,392,1157,953,21,15,9,216,561,1371,2043,0,0
3275,950,386,1156,926,21,15,9,206,540,1372,2043,0,0
3276,948,379,1153,916,21,15,9,205,537,1373,2043,0,0
3277,939,374,1144,916,21,15,9,205,542,1374,2043,0,0
3278,929,368,1133,910,21,15,9,204,542,1375,2043,0,0
3279,917,366,1116,904,21,15,9,199,538,1376,2043,0,0
3280,906,363,1102,896,21,15,9,196,533,1377,2043,0,0
3281,899,358,1090,888,21,15,9,191,530,1378,2043,0,0
3282,894,356,1082,882,21,15,9,188,526,1379,2043,0,0
3283,894,356,1081,884,21,15,9,187,528,1380,2043,0,0
3284,898,356,1082,884,21,15,9,184,528,1381,2043,0,0
3285,906,359,1089,887,21,15,9,183,528,1382,2043,0,0
3286,918,364,1098,888,21,15,9,180,524,1383,2043,0,0
3287,934,376,1110,887,21,15,9,176,511,1384,2043,0,0
3288,945,384,1119,888,21,15,9,174,504,1385,2043,0,0
3289,948,384,1124,888,21,15,9,176,504,1386,2043,0,0
3290,947,385,1125,890,21,15,9,178,505,1387,2043,0,0
3291,945,386,1125,892,21,15,9,180,506,1388,2043,0,0
3292,945,384,1126,890,21,15,9,181,506,1389,2043,0,0
3293,943,384,1126,892,21,15,9,183,508,1390,2043,0,0
3294,939,384,1120,890,21,15,9,181,506,1391,2043,0,0
3295,938,381,1117,891,21,15,9,179,510,1392,2043,0,0
3296,934,375,1112,890,21,15,9,178,515,1393,2043,0,0
3297,927,372,1104,887,21,15,9,177,515,1394,2043,0,0
3298,920,370,1096,891,21,15,9,176,521,1395,2043,0,0
3299,919,369,1096,901,21,15,9,177,532,1396,2043,0,0
3300,914,363,1093,909,21,15,9,179,546,1397,2043,0,0
3301,910,367,1086,913,21,15,9,176,546,1398,2043,0,0
3302,907,368,1079,914,21,15,9,172,546,1399,2043,0,0
3303,906,374,1072,909,21,15,9,166,535,1400,2043,0,0
3304,899,374,1063,909,21,15,9,164,535,1401,2043,0,0
3305,896,377,1056,911,21,15,9,160,534,1402,2043,0,0
3306,897,385,1053,909,21,15,9,156,524,1403,2043,0,0
3307,896,388,1051,912,21,15,9,155,524,1404,2043,0,0
3308,902,391,1056,909,21,15,9,154,518,1405,2043,0,0
3309,913,396,1066,911,21,15,9,153,515,1406,2043,0,0
3310,921,392,1075,909,21,15,9,154,517,1407,2043,0,0
3311,931,390,1086,910,21,15,9,155,520,1408,2043,0,0
3312,942,390,1094,907,21,15,9,152,517,1409,2043,0,0
3313,949,391,1102,907,21,15,9,153,516,1410,2043,0,0
3314,958,395,1111,904,21,15,9,153,509,1411,2043,0,0
3315,972,394,1125,910,21,15,9,153,516,1412,2043,0,0
3316,982,391,1138,923,21,15,9,156,532,1413,2043,0,0
3317,984,390,1138,923,21,15,9,154,533,1414,2043,0,0
3318,985,388,1140,928,21,15,9,155,540,1415,2043,0,0
3319,988,391,1143,931,21,15,9,155,540,1416,2043,0,0
3320,991,395,1146,933,21,15,9,155,538,1417,2043,0,0
3321,993,392,1148,935,21,15,9,155,543,1418,2043,0,0
3322,998,396,1154,938,21,15,9,156,542,1419,2043,0,0
3323,1005,400,1159,938,21,15,9,154,538,1420,2043,0,0
3324,1011,407,1164,937,21,15,9,153,530,1421,2043,0,0
3325,1012,407,1165,933,21,15,9,153,526,1422,2043,0,0
3326,1015,411,1167,930,21,15,9,152,519,1423,2043,0,0
3327,1014,413,1170,942,21,15,9,156,529,1424,2043,0,0
3328,1015,415,1171,945,21,15,9,156,530,1425,2043,0,0
3329,1012,415,1170,946,21,15,9,158,531,1426,2043,0,0
3330,1009,416,1169,946,21,15,9,160,530,1427,2043,0,0
3331,1010,412,1171,945,21,15,9,161,533,1428,2043,0,0
3332,1008,411,1171,947,21,15,9,163,536,1429,2043,0,0
3333,1006,412,1168,941,21,15,9,162,529,1430,2043,0,0
3334,1006,412,1167,937,21,15,9,161,525,1431,2043,0,0
3335,1007,413,1169,936,21,15,9,162,523,1432,2043,0,0
3336,1007,413,1170,936,21,15,9,163,523,1433,2043,0,0
3337,1009,412,1173,939,21,15,9,164,527,1434,2043,0,0
3338,1008,413,1174,946,21,15,9,166,533,1435,2043,0,0
3339,1008,412,1175,948,21,15,9,167,536,1436,2043,0,0
3340,1009,412,1175,945,21,15,9,166,533,1437,2043,0,0
3341,1011,414,1176,942,21,15,9,165,528,1438,2043,0,0
3342,1012,414,1176,938,21,15,9,164,524,1439,2043,0,0
3343,1011,416,1175,936,21,15,9,164,520,1440,2043,0,0
3344,1010,416,1174,938,21,15,9,164,522,1441,2043,0,0
3345,1010,414,1176,946,21,15,9,166,532,1442,2043,0,0
3346,1008,415,1173,942,21,15,9,165,527,1443,2043,0,0
3347,1009,415,1173,938,21,15,9,164,523,1444,2043,0,0
3348,1009,416,1172,936,21,15,9,163,520,1445,2043,0,0
3349,1007,412,1170,932,21,15,9,163,520,1446,2043,0,0
3350,1009,412,1174,938,21,15,9,165,526,1447,2043,0,0
3351,1007,409,1172,931,21,15,9,165,522,1448,2043,0,0
3352,1009,413,1174,934,21,15,9,165,521,1449,2043,0,0
3353,1003,409,1166,930,21,15,9,163,521,1450,2043,0,0
3354,992,408,1161,943,21,15,9,169,535,1451,2043,0,0
3355,986,409,1160,956,21,15,9,174,547,1452,2043,0,0
3356,974,411,1150,960,21,15,9,176,549,1453,2043,0,0
3357,970,408,1150,961,21,15,9,180,553,1454,2043,0,0
3358,967,411,1148,961,21,15,9,181,550,1455,2043,0,0
3359,957,413,1140,969,21,15,9,183,556,1456,2043,0,0
3360,955,416,1140,968,21,15,9,185,552,1457,2043,0,0
3361,940,415,1131,973,21,15,9,191,558,1458,2043,0,0
3362,932,413,1127,972,21,15,9,195,559,1459,2043,0,0
3363,934,412,1130,972,21,15,9,196,560,1460,2043,0,0
3364,939,408,1136,972,21,15,9,197,564,1461,2043,0,0
3365,941,412,1138,975,21,15,9,197,563,1462,2043,0,0
3366,946,417,1140,969,21,15,9,194,552,1463,2043,0,0
3367,943,417,1140,976,21,15,9,197,559,1464,2043,0,0
3368,940,414,1139,974,21,15,9,199,560,1465,2043,0,0
3369,936,414,1137,976,21,15,9,201,562,1466,2043,0,0
3370,938,412,1139,974,21,15,9,201,562,1467,2043,0,0
3371,935,412,1137,974,21,15,9,202,562,1468,2043,0,0
3372,936,408,1138,973,21,15,9,202,565,1469,2043,0,0
3373,934,408,1137,975,21,15,9,203,567,1470,2043,0,0
3374,933,408,1138,977,21,15,9,205,569,1471,2043,0,0
3375,931,407,1136,977,21,15,9,205,570,1472,2043,0,0
3376,930,409,1135,975,21,15,9,205,566,1473,2043,0,0
3377,930,410,1137,976,21,15,9,207,566,1474,2043,0,0
3378,929,408,1136,975,21,15,9,207,567,1475,2043,0,0
3379,928,408,1135,971,21,15,9,207,563,1476,2043,0,0
3380,927,408,1136,973,21,15,9,209,565,1477,2043,0,0
3381,929,409,1138,973,21,15,9,209,564,1478,2043,0,0
3382,930,413,1137,970,21,15,9,207,557,1479,2043,0,0
3383,935,417,1145,977,21,15,9,210,560,1480,2043,0,0
3384,943,421,1153,977,21,15,9,210,556,1481,2043,0,0
3385,951,418,1168,985,21,15,9,217,567,1482,2043,0,0
3386,970,421,1185,982,21,15,9,215,561,1483,2043,0,0
3387,984,425,1197,980,21,15,9,213,555,1484,2043,0,0
3388,996,432,1210,987,21,15,9,214,555,1485,2043,0,0
3389,1006,436,1221,996,21,15,9,215,560,1486,2043,0,0
3390,1012,434,1238,1029,21,15,9,226,595,1487,2043,0,0
3391,1018,435,1244,1038,21,15,9,226,603,1488,2043,0,0
3392,1019,432,1245,1036,21,15,9,226,604,1489,2043,0,0
3393,1020,436,1247,1041,21,15,9,227,605,1490,2043,0,0
3394,1019,439,1248,1045,21,15,9,229,606,1491,2043,0,0
3395,1018,445,1254,1065,21,15,9,236,620,1492,2043,0,0
3396,1019,445,1260,1073,21,15,9,241,628,1493,2043,0,0
3397,1021,445,1264,1075,21,15,9,243,630,1494,2043,0,0
3398,1030,450,1270,1075,21,15,9,240,625,1495,2043,0,0
3399,1038,454,1272,1075,21,15,9,234,621,1496,2043,0,0
3400,1036,452,1266,1078,21,15,9,230,626,1497,2043,0,0
3401,1031,449,1257,1080,21,15,9,226,631,1498,2043,0,0
3402,1022,445,1244,1078,21,15,9,222,633,1499,2043,0,0
3403,996,435,1214,1057,21,15,9,218,622,1500,2043,0,0
3404,965,428,1184,1045,21,15,9,219,617,1501,2043,0,0
3405,953,423,1173,1031,21,15,9,220,608,1502,2043,0,0
3406,934,409,1153,1016,21,15,9,219,607,1503,2043,0,0
3407,909,399,1125,1002,21,15,9,216,603,1504,2043,0,0
3408,895,395,1105,984,21,15,9,210,589,1505,2043,0,0
3409,897,387,1103,966,21,15,9,206,579,1506,2043,0,0
3410,909,389,1119,968,21,15,9,210,579,1507,2043,0,0
3411,928,387,1137,959,21,15,9,209,572,1508,2043,0,0
3412,946,395,1149,949,21,15,9,203,554,1509,2043,0,0
3413,968,391,1168,938,21,15,9,200,547,1510,2043,0,0
3414,974,391,1173,938,21,15,9,199,547,1511,2043,0,0
3415,975,390,1172,937,21,15,9,197,547,1512,2043,0,0
3416,976,386,1171,933,21,15,9,195,547,1513,2043,0,0
3417,978,385,1171,929,21,15,9,193,544,1514,2043,0,0
3418,979,382,1175,938,21,15,9,196,556,1515,2043,0,0
3419,976,380,1174,937,21,15,9,198,557,1516,2043,0,0
3420,964,382,1162,944,21,15,9,198,562,1517,2043,0,0
3421,968,392,1171,959,21,15,9,203,567,1518,2043,0,0
3422,947,399,1145,961,21,15,9,198,562,1519,2043,0,0
3423,934,405,1125,961,21,15,9,191,556,1520,2043,0,0
3424,926,407,1117,963,21,15,9,191,556,1521,2043,0,0
3425,928,408,1122,979,21,15,9,194,571,1522,2043,0,0
3426,929,415,1135,1021,21,15,9,206,606,1523,2043,0,0
3427,940,424,1154,1044,21,15,9,214,620,1524,2043,0,0
3428,956,432,1176,1054,21,15,9,220,622,1525,2043,0,0
3429,985,441,1205,1052,21,15,9,220,611,1526,2043,0,0
3430,1002,457,1221,1055,21,15,9,219,598,1527,2043,0,0
3431,1000,468,1224,1069,21,15,9,224,601,1528,2043,0,0
3432,994,478,1220,1073,21,15,9,226,595,1529,2043,0,0
3433,982,488,1208,1070,21,15,9,226,582,1530,2043,0,0
3434,967,502,1191,1067,21,15,9,224,565,1531,2043,0,0
3435,955,508,1182,1070,21,15,9,227,562,1532,2043,0,0
3436,945,516,1178,1071,21,15,9,233,555,1533,2043,0,0
3437,946,531,1186,1075,21,15,9,240,544,1534,2043,0,0
3438,968,546,1212,1072,21,15,9,244,526,1535,2043,0,0
3439,1018,559,1257,1074,21,15,9,239,515,1536,2043,0,0
3440,1055,568,1288,1077,21,15,9,233,509,1537,2043,0,0
3441,1098,585,1322,1080,21,15,9,224,495,1538,2043,0,0
3442,1134,594,1353,1077,21,15,9,219,483,1539,2043,0,0
3443,1162,609,1374,1073,21,15,9,212,464,1540,2043,0,0
3444,1184,626,1390,1066,21,15,9,206,440,1541,2043,0,0
3445,1200,635,1408,1065,21,15,9,208,430,1542,2043,0,0
3446,1200,639,1413,1065,21,15,9,213,426,1543,2043,0,0
3447,1192,637,1412,1066,21,15,9,220,429,1544,2043,0,0
3448,1179,627,1411,1066,21,15,9,232,439,1545,2043,0,0
3449,1159,613,1402,1066,21,15,9,243,453,1546,2043,0,0
3450,1126,594,1382,1068,21,15,9,256,474,1547,2043,0,0
3451,1098,585,1353,1059,21,15,9,255,474,1548,2043,0,0
3452,1070,571,1337,1066,21,15,9,267,495,1549,2043,0,0
3453,1051,558,1323,1063,21,15,9,272,505,1550,2043,0,0
3454,1040,540,1319,1061,21,15,9,279,521,1551,2043,0,0
3455,1036,520,1324,1068,21,15,9,288,548,1552,2043,0,0
3456,1033,504,1325,1072,21,15,9,292,568,1553,2043,0,0
3457,1022,489,1320,1076,21,15,9,298,587,1554,2043,0,0
3458,999,473,1298,1072,21,15,9,299,599,1555,2043,0,0
3459,967,474,1262,1071,21,15,9,295,597,1556,2043,0,0
3460,939,465,1234,1073,21,15,9,295,608,1557,2043,0,0
3461,902,450,1196,1074,21,15,9,294,624,1558,2043,0,0
3462,872,444,1159,1072,21,15,9,287,628,1559,2043,0,0
3463,850,437,1128,1067,21,15,9,278,630,1560,2043,0,0
3464,831,423,1104,1060,21,15,9,273,637,1561,2043,0,0
3465,820,418,1079,1038,21,15,9,259,620,1562,2043,0,0
3466,814,405,1055,990,21,15,9,241,585,1563,2043,0,0
3467,808,395,1043,974,21,15,9,235,579,1564,2043,0,0
3468,797,388,1029,975,21,15,9,232,587,1565,2043,0,0
3469,785,378,1010,958,21,15,9,225,580,1566,2043,0,0
3470,779,370,987,914,21,15,9,208,544,1567,2043,0,0
3471,775,358,975,891,21,15,9,200,533,1568,2043,0,0
3472,768,351,968,886,21,15,9,200,535,1569,2043,0,0
3473,770,340,970,882,21,15,9,200,542,1570,2043,0,0
3474,788,334,981,860,21,15,9,193,526,1571,2043,0,0
3475,814,327,997,833,21,15,9,183,506,1572,2043,0,0
3476,832,327,1008,823,21,15,9,176,496,1573,2043,0,0
3477,839,324,1011,813,21,15,9,172,489,1574,2043,0,0
3478,841,317,1007,805,21,15,9,166,488,1575,2043,0,0
3479,843,321,1003,804,21,15,9,160,483,1576,2043,0,0
3480,844,321,1000,804,21,15,9,156,483,1577,2043,0,0
3481,847,326,999,804,21,15,9,152,478,1578,2043,0,0
3482,848,330,998,810,21,15,9,150,480,1579,2043,0,0
3483,847,328,997,815,21,15,9,150,487,1580,2043,0,0
3484,847,328,995,815,21,15,9,148,487,1581,2043,0,0
3485,851,330,999,819,21,15,9,148,489,1582,2043,0,0
3486,848,332,999,824,21,15,9,151,492,1583,2043,0,0
3487,848,331,1000,826,21,15,9,152,495,1584,2043,0,0
3488,846,338,1001,835,21,15,9,155,497,1585,2043,0,0
3489,850,346,1006,842,21,15,9,156,496,1586,2043,0,0
3490,860,350,1017,847,21,15,9,157,497,1587,2043,0,0
3491,877,351,1031,847,21,15,9,154,496,1588,2043,0,0
3492,896,356,1047,847,21,15,9,151,491,1589,2043,0,0
3493,913,358,1067,867,21,15,9,154,509,1590,2043,0,0
3494,927,356,1082,872,21,15,9,155,516,1591,2043,0,0
3495,938,358,1095,877,21,15,9,157,519,1592,2043,0,0
3496,944,360,1102,880,21,15,9,158,520,1593,2043,0,0
3497,948,366,1106,885,21,15,9,158,519,1594,2043,0,0
3498,950,365,1108,882,21,15,9,158,517,1595,2043,0,0
3499,953,364,1111,880,21,15,9,158,516,1596,2043,0,0
3500,953,367,1114,885,21,15,9,161,518,1597,2043,0,0
3501,950,370,1114,887,21,15,9,164,517,1598,2043,0,0
3502,941,369,1108,886,21,15,9,167,517,1599,2043,0,0
3503,928,369,1097,882,21,15,9,169,513,1600,2043,0,0
3504,915,370,1087,881,21,15,9,172,511,1601,2043,0,0
3505,896,364,1073,882,21,15,9,177,518,1602,2043,0,0
3506,874,358,1052,879,21,15,9,178,521,1603,2043,0,0
3507,853,350,1032,870,21,15,9,179,520,1604,2043,0,0
3508,832,346,1007,858,21,15,9,175,512,1605,2043,0,0
3509,818,341,992,851,21,15,9,174,510,1606,2043,0,0
3510,812,340,987,855,21,15,9,175,515,1607,2043,0,0
3511,817,336,991,842,21,15,9,174,506,1608,2043,0,0
3512,837,336,1005,825,21,15,9,168,489,1609,2043,0,0
3513,855,330,1018,803,21,15,9,163,473,1610,2043,0,0
3514,871,329,1030,797,21,15,9,159,468,1611,2043,0,0
3515,877,325,1035,794,21,15,9,158,469,1612,2043,0,0
3516,878,321,1034,793,21,15,9,156,472,1613,2043,0,0
3517,877,320,1031,790,21,15,9,154,470,1614,2043,0,0
3518,874,319,1023,783,21,15,9,149,464,1615,2043,0,0
3519,869,316,1016,782,21,15,9,147,466,1616,2043,0,0
3520,870,318,1013,778,21,15,9,143,460,1617,2043,0,0
3521,872,320,1010,770,21,15,9,138,450,1618,2043,0,0
3522,866,322,1007,789,21,15,9,141,467,1619,2043,0,0
3523,863,325,1004,796,21,15,9,141,471,1620,2043,0,0
3524,863,326,1003,799,21,15,9,140,473,1621,2043,0,0
3525,862,329,1002,801,21,15,9,140,472,1622,2043,0,0
3526,861,328,1002,805,21,15,9,141,477,1623,2043,0,0
3527,861,330,1004,811,21,15,9,143,481,1624,2043,0,0
3528,858,334,1006,829,21,15,9,148,495,1625,2043,0,0
3529,858,342,1015,853,21,15,9,157,511,1626,2043,0,0
3530,864,345,1026,862,21,15,9,162,517,1627,2043,0,0
3531,886,350,1049,864,21,15,9,163,514,1628,2043,0,0
3532,902,359,1064,865,21,15,9,162,506,1629,2043,0,0
3533,911,372,1080,891,21,15,9,169,519,1630,2043,0,0
3534,914,377,1094,930,21,15,9,180,553,1631,2043,0,0
3535,916,381,1100,943,21,15,9,184,562,1632,2043,0,0
3536,916,392,1099,951,21,15,9,183,559,1633,2043,0,0
3537,910,398,1093,947,21,15,9,183,549,1634,2043,0,0
3538,909,410,1099,969,21,15,9,190,559,1635,2043,0,0
3539,914,417,1114,991,21,15,9,200,574,1636,2043,0,0
3540,937,422,1143,1003,21,15,9,206,581,1637,2043,0,0
3541,971,429,1178,1006,21,15,9,207,577,1638,2043,0,0
3542,999,435,1215,1047,21,15,9,216,612,1639,2043,0,0
3543,1022,445,1238,1065,21,15,9,216,620,1640,2043,0,0
3544,1039,449,1254,1071,21,15,9,215,622,1641,2043,0,0
3545,1044,445,1260,1071,21,15,9,216,626,1642,2043,0,0
3546,1047,448,1260,1071,21,15,9,213,623,1643,2043,0,0
3547,1050,454,1261,1070,21,15,9,211,616,1644,2043,0,0
3548,1055,457,1264,1067,21,15,9,209,610,1645,2043,0,0
3549,1056,458,1264,1066,21,15,9,208,608,1646,2043,0,0
3550,1060,462,1268,1066,21,15,9,208,604,1647,2043,0,0
3551,1059,457,1270,1068,21,15,9,211,611,1648,2043,0,0
3552,1064,465,1270,1060,21,15,9,206,595,1649,2043,0,0
3553,1065,467,1273,1062,21,15,9,208,595,1650,2043,0,0
3554,1066,470,1273,1062,21,15,9,207,592,1651,2043,0,0
3555,1063,469,1271,1060,21,15,9,208,591,1652,2043,0,0
3556,1054,468,1266,1064,21,15,9,212,596,1653,2043,0,0
3557,1035,461,1252,1063,21,15,9,217,602,1654,2043,0,0
3558,1020,458,1240,1065,21,15,9,220,607,1655,2043,0,0
3559,994,442,1219,1070,21,15,9,225,628,1656,2043,0,0
3560,973,441,1193,1058,21,15,9,220,617,1657,2043,0,0
3561,950,431,1165,1034,21,15,9,215,603,1658,2043,0,0
3562,935,421,1149,1031,21,15,9,214,610,1659,2043,0,0
3563,928,417,1139,1024,21,15,9,211,607,1660,2043,0,0
3564,928,409,1135,1009,21,15,9,207,600,1661,2043,0,0
3565,932,395,1130,973,21,15,9,198,578,1662,2043,0,0
3566,938,392,1126,939,21,15,9,188,547,1663,2043,0,0
3567,925,386,1113,927,21,15,9,188,541,1664,2043,0,0
3568,915,380,1103,913,21,15,9,188,533,1665,2043,0,0
3569,894,373,1082,909,21,15,9,188,536,1666,2043,0,0
3570,873,364,1054,887,21,15,9,181,523,1667,2043,0,0
3571,851,359,1029,875,21,15,9,178,516,1668,2043,0,0
3572,841,358,1016,867,21,15,9,175,509,1669,2043,0,0
3573,841,353,1015,857,21,15,9,174,504,1670,2043,0,0
3574,848,346,1020,837,21,15,9,172,491,1671,2043,0,0
3575,863,340,1028,812,21,15,9,165,472,1672,2043,0,0
3576,874,335,1038,810,21,15,9,164,475,1673,2043,0,0
3577,880,330,1043,806,21,15,9,163,476,1674,2043,0,0
3578,881,328,1040,796,21,15,9,159,468,1675,2043,0,0
3579,876,323,1035,794,21,15,9,159,471,1676,2043,0,0
3580,869,319,1026,786,21,15,9,157,467,1677,2043,0,0
3581,862,318,1019,785,21,15,9,157,467,1678,2043,0,0
3582,864,322,1018,787,21,15,9,154,465,1679,2043,0,0
3583,867,323,1018,786,21,15,9,151,463,1680,2043,0,0
3584,871,326,1020,791,21,15,9,149,465,1681,2043,0,0
3585,869,330,1017,800,21,15,9,148,470,1682,2043,0,0
3586,867,329,1013,799,21,15,9,146,470,1683,2043,0,0
3587,866,334,1009,798,21,15,9,143,464,1684,2043,0,0
3588,868,338,1012,801,21,15,9,144,463,1685,2043,0,0
3589,872,338,1022,818,21,15,9,150,480,1686,2043,0,0
3590,867,343,1028,852,21,15,9,161,509,1687,2043,0,0
3591,871,350,1039,875,21,15,9,168,525,1688,2043,0,0
3592,890,355,1060,877,21,15,9,170,522,1689,2043,0,0
3593,907,360,1077,879,21,15,9,170,519,1690,2043,0,0
3594,918,370,1096,913,21,15,9,178,543,1691,2043,0,0
3595,925,385,1108,946,21,15,9,183,561,1692,2043,0,0
3596,926,388,1113,961,21,15,9,187,573,1693,2043,0,0
3597,927,391,1115,968,21,15,9,188,577,1694,2043,0,0
3598,925,402,1111,969,21,15,9,186,567,1695,2043,0,0
3599,915,411,1108,998,21,15,9,193,587,1696,2043,0,0
3600,914,413,1118,1019,21,15,9,204,606,1697,2043,0,0
3601,929,424,1140,1032,21,15,9,211,608,1698,2043,0,0
3602,962,432,1176,1041,21,15,9,214,609,1699,2043,0,0
3603,988,449,1197,1034,21,15,9,209,585,1700,2043,0,0
3604,1024,456,1236,1048,21,15,9,212,592,1701,2043,0,0
3605,1035,459,1251,1069,21,15,9,216,610,1702,2043,0,0
3606,1045,467,1256,1071,21,15,9,211,604,1703,2043,0,0
3607,1059,468,1270,1071,21,15,9,211,603,1704,2043,0,0
3608,1071,472,1283,1073,21,15,9,212,601,1705,2043,0,0
3609,1073,477,1286,1074,21,15,9,213,597,1706,2043,0,0
3610,1081,484,1294,1070,21,15,9,213,586,1707,2043,0,0
3611,1082,480,1302,1071,21,15,9,220,591,1708,2043,0,0
3612,1094,495,1313,1071,21,15,9,219,576,1709,2043,0,0
3613,1088,491,1313,1073,21,15,9,225,582,1710,2043,0,0
3614,1069,480,1299,1073,21,15,9,230,593,1711,2043,0,0
3615,1041,466,1278,1076,21,15,9,237,610,1712,2043,0,0
3616,1015,460,1249,1071,21,15,9,234,611,1713,2043,0,0
3617,990,454,1220,1061,21,15,9,230,607,1714,2043,0,0
3618,980,449,1205,1049,21,15,9,225,600,1715,2043,0,0
3619,969,440,1193,1044,21,15,9,224,604,1716,2043,0,0
3620,958,434,1180,1035,21,15,9,222,601,1717,2043,0,0
3621,954,426,1169,1017,21,15,9,215,591,1718,2043,0,0
3622,958,419,1164,989,21,15,9,206,570,1719,2043,0,0
3623,952,408,1152,961,21,15,9,200,553,1720,2043,0,0
3624,927,399,1128,951,21,15,9,201,552,1721,2043,0,0
3625,907,396,1105,940,21,15,9,198,544,1722,2043,0,0
3626,893,379,1090,922,21,15,9,197,543,1723,2043,0,0
3627,870,368,1059,899,21,15,9,189,531,1724,2043,0,0
3628,846,365,1031,889,21,15,9,185,524,1725,2043,0,0
3629,831,358,1016,887,21,15,9,185,529,1726,2043,0,0
3630,822,350,1007,883,21,15,9,185,533,1727,2043,0,0
3631,821,341,1005,874,21,15,9,184,533,1728,2043,0,0
3632,831,333,1004,834,21,15,9,173,501,1729,2043,0,0
3633,841,328,1008,810,21,15,9,167,482,1730,2043,0,0
3634,838,325,1002,805,21,15,9,164,480,1731,2043,0,0
3635,829,317,993,800,21,15,9,164,483,1732,2043,0,0
3636,810,307,973,788,21,15,9,163,481,1733,2043,0,0
3637,798,301,961,786,21,15,9,163,485,1734,2043,0,0
3638,793,300,955,783,21,15,9,162,483,1735,2043,0,0
3639,792,298,954,785,21,15,9,162,487,1736,2043,0,0
3640,802,302,962,784,21,15,9,160,482,1737,2043,0,0
3641,814,303,970,783,21,15,9,156,480,1738,2043,0,0
3642,820,299,977,785,21,15,9,157,486,1739,2043,0,0
3643,831,311,983,788,21,15,9,152,477,1740,2043,0,0
3644,842,319,989,786,21,15,9,147,467,1741,2043,0,0
3645,852,326,996,786,21,15,9,144,460,1742,2043,0,0
3646,860,326,1003,788,21,15,9,143,462,1743,2043,0,0
3647,868,329,1010,788,21,15,9,142,459,1744,2043,0,0
3648,873,326,1015,787,21,15,9,142,461,1745,2043,0,0
3649,881,330,1021,786,21,15,9,140,456,1746,2043,0,0
3650,884,331,1029,806,21,15,9,145,475,1747,2043,0,0
3651,885,334,1033,819,21,15,9,148,485,1748,2043,0,0
3652,881,335,1031,828,21,15,9,150,493,1749,2043,0,0
3653,877,342,1028,835,21,15,9,151,493,1750,2043,0,0
3654,863,346,1016,837,21,15,9,153,491,1751,2043,0,0
3655,853,349,1013,850,21,15,9,160,501,1752,2043,0,0
3656,850,356,1018,872,21,15,9,168,516,1753,2043,0,0
3657,853,365,1027,885,21,15,9,174,520,1754,2043,0,0
3658,875,371,1049,885,21,15,9,174,514,1755,2043,0,0
3659,894,375,1071,891,21,15,9,177,516,1756,2043,0,0
3660,915,380,1098,918,21,15,9,183,538,1757,2043,0,0
3661,947,388,1135,942,21,15,9,188,554,1758,2043,0,0
3662,961,390,1143,934,21,15,9,182,544,1759,2043,0,0
3663,968,389,1144,925,21,15,9,176,536,1760,2043,0,0
3664,975,390,1149,923,21,15,9,174,533,1761,2043,0,0
3665,978,391,1152,927,21,15,9,174,536,1762,2043,0,0
3666,984,396,1158,935,21,15,9,174,539,1763,2043,0,0
3667,983,398,1159,938,21,15,9,176,540,1764,2043,0,0
3668,988,390,1167,940,21,15,9,179,550,1765,2043,0,0
3669,988,389,1168,939,21,15,9,180,550,1766,2043,0,0
3670,988,389,1168,938,21,15,9,180,549,1767,2043,0,0
3671,982,393,1161,939,21,15,9,179,546,1768,2043,0,0
3672,977,392,1157,939,21,15,9,180,547,1769,2043,0,0
3673,975,397,1153,940,21,15,9,178,543,1770,2043,0,0
3674,976,397,1152,937,21,15,9,176,540,1771,2043,0,0
3675,977,398,1151,936,21,15,9,174,538,1772,2043,0,0
3676,977,397,1150,935,21,15,9,173,538,1773,2043,0,0
3677,976,400,1149,937,21,15,9,173,537,1774,2043,0,0
3678,974,401,1147,939,21,15,9,173,538,1775,2043,0,0
3679,973,401,1147,940,21,15,9,174,539,1776,2043,0,0
3680,973,402,1145,937,21,15,9,172,535,1777,2043,0,0
3681,972,398,1145,933,21,15,9,173,535,1778,2043,0,0
3682,970,393,1145,936,21,15,9,175,543,1779,2043,0,0
3683,969,392,1144,937,21,15,9,175,545,1780,2043,0,0
3684,968,398,1137,929,21,15,9,169,531,1781,2043,0,0
3685,967,398,1134,927,21,15,9,167,529,1782,2043,0,0
3686,964,397,1131,932,21,15,9,167,535,1783,2043,0,0
3687,963,396,1128,931,21,15,9,165,535,1784,2043,0,0
3688,961,393,1125,930,21,15,9,164,537,1785,2043,0,0
3689,958,389,1123,936,21,15,9,165,547,1786,2043,0,0
3690,957,391,1124,951,21,15,9,167,560,1787,2043,0,0
3691,952,393,1119,963,21,15,9,167,570,1788,2043,0,0
3692,954,399,1120,970,21,15,9,166,571,1789,2043,0,0
3693,955,406,1120,978,21,15,9,165,572,1790,2043,0,0
3694,959,412,1125,986,21,15,9,166,574,1791,2043,0,0
3695,963,420,1127,983,21,15,9,164,563,1792,2043,0,0
3696,968,426,1137,997,21,15,9,169,571,1793,2043,0,0
3697,974,431,1147,1006,21,15,9,173,575,1794,2043,0,0
3698,983,438,1162,1015,21,15,9,179,577,1795,2043,0,0
3699,1000,445,1181,1020,21,15,9,181,575,1796,2043,0,0
3700,1020,452,1202,1028,21,15,9,182,576,1797,2043,0,0
3701,1047,455,1234,1032,21,15,9,187,577,1798,2043,0,0
3702,1066,457,1260,1053,21,15,9,194,596,1799,2043,0,0
3703,1074,458,1271,1060,21,15,9,197,602,1800,2043,0,0
3704,1078,453,1279,1062,21,15,9,201,609,1801,2043,0,0
3705,1081,456,1285,1068,21,15,9,204,612,1802,2043,0,0
3706,1088,457,1294,1069,21,15,9,206,612,1803,2043,0,0
3707,1093,460,1301,1069,21,15,9,208,609,1804,2043,0,0
3708,1097,459,1308,1068,21,15,9,211,609,1805,2043,0,0
3709,1106,462,1318,1065,21,15,9,212,603,1806,2043,0,0
3710,1109,466,1323,1068,21,15,9,214,602,1807,2043,0,0
3711,1109,481,1320,1068,21,15,9,211,587,1808,2043,0,0
3712,1103,474,1321,1074,21,15,9,218,600,1809,2043,0,0
3713,1084,485,1302,1074,21,15,9,218,589,1810,2043,0,0
3714,1055,479,1279,1071,21,15,9,224,592,1811,2043,0,0
3715,1027,468,1257,1073,21,15,9,230,605,1812,2043,0,0
3716,999,455,1230,1067,21,15,9,231,612,1813,2043,0,0
3717,973,443,1204,1059,21,15,9,231,616,1814,2043,0,0
3718,957,436,1180,1036,21,15,9,223,600,1815,2043,0,0
3719,949,428,1171,1032,21,15,9,222,604,1816,2043,0,0
3720,946,425,1165,1026,21,15,9,219,601,1817,2043,0,0
3721,943,416,1158,1012,21,15,9,215,596,1818,2043,0,0
3722,948,405,1151,971,21,15,9,203,566,1819,2043,0,0
3723,942,396,1141,950,21,15,9,199,554,1820,2043,0,0
3724,924,384,1125,943,21,15,9,201,559,1821,2043,0,0
3725,908,383,1108,938,21,15,9,200,555,1822,2043,0,0
3726,889,373,1083,911,21,15,9,194,538,1823,2043,0,0
3727,867,363,1053,887,21,15,9,186,524,1824,2043,0,0
3728,848,354,1032,881,21,15,9,184,527,1825,2043,0,0
3729,833,351,1014,873,21,15,9,181,522,1826,2043,0,0
3730,827,348,1004,862,21,15,9,177,514,1827,2043,0,0
3731,822,340,997,852,21,15,9,175,512,1828,2043,0,0
3732,822,335,988,824,21,15,9,166,489,1829,2043,0,0
3733,822,327,985,807,21,15,9,163,480,1830,2043,0,0
3734,826,323,985,797,21,15,9,159,474,1831,2043,0,0
3735,821,317,982,799,21,15,9,161,482,1832,2043,0,0
3736,816,311,975,792,21,15,9,159,481,1833,2043,0,0
3737,808,305,965,788,21,15,9,157,483,1834,2043,0,0
3738,803,305,957,785,21,15,9,154,480,1835,2043,0,0
3739,801,301,954,785,21,15,9,153,484,1836,2043,0,0
3740,804,302,954,784,21,15,9,150,482,1837,2043,0,0
3741,806,304,951,780,21,15,9,145,476,1838,2043,0,0
3742,809,308,953,787,21,15,9,144,479,1839,2043,0,0
3743,814,321,953,788,21,15,9,139,467,1840,2043,0,0
3744,821,325,959,789,21,15,9,138,464,1841,2043,0,0
3745,829,336,964,791,21,15,9,135,455,1842,2043,0,0
3746,839,336,976,792,21,15,9,137,456,1843,2043,0,0
3747,847,338,987,804,21,15,9,140,466,1844,2043,0,0
3748,850,337,995,807,21,15,9,145,470,1845,2043,0,0
3749,863,339,1009,808,21,15,9,146,469,1846,2043,0,0
3750,883,337,1031,811,21,15,9,148,474,1847,2043,0,0
3751,899,343,1055,841,21,15,9,156,498,1848,2043,0,0
3752,904,356,1064,869,21,15,9,160,513,1849,2043,0,0
3753,907,363,1072,891,21,15,9,165,528,1850,2043,0,0
3754,904,370,1068,893,21,15,9,164,523,1851,2043,0,0
3755,893,377,1061,902,21,15,9,168,525,1852,2043,0,0
3756,896,388,1069,922,21,15,9,173,534,1853,2043,0,0
3757,898,396,1078,942,21,15,9,180,546,1854,2043,0,0
3758,915,398,1102,948,21,15,9,187,550,1855,2043,0,0
3759,945,414,1131,954,21,15,9,186,540,1856,2043,0,0
3760,968,421,1160,974,21,15,9,192,553,1857,2043,0,0
3761,987,430,1189,1018,21,15,9,202,588,1858,2043,0,0
3762,999,447,1204,1045,21,15,9,205,598,1859,2043,0,0
3763,1002,455,1208,1058,21,15,9,206,603,1860,2043,0,0
3764,1006,465,1209,1054,21,15,9,203,589,1861,2043,0,0
3765,1006,468,1217,1073,21,15,9,211,605,1862,2043,0,0
3766,1016,480,1230,1078,21,15,9,214,598,1863,2043,0,0
3767,1028,484,1247,1076,21,15,9,219,592,1864,2043,0,0
3768,1066,502,1283,1074,21,15,9,217,572,1865,2043,0,0
3769,1109,512,1323,1074,21,15,9,214,562,1866,2043,0,0
3770,1137,522,1349,1071,21,15,9,212,549,1867,2043,0,0
3771,1145,529,1358,1073,21,15,9,213,544,1868,2043,0,0
3772,1156,533,1372,1072,21,15,9,216,539,1869,2043,0,0
3773,1174,537,1389,1074,21,15,9,215,537,1870,2043,0,0
3774,1184,547,1397,1070,21,15,9,213,523,1871,2043,0,0
3775,1190,552,1405,1071,21,15,9,215,519,1872,2043,0,0
3776,1183,558,1400,1073,21,15,9,217,515,1873,2043,0,0
3777,1177,549,1400,1074,21,15,9,223,525,1874,2043,0,0
3778,1167,539,1396,1073,21,15,9,229,534,1875,2043,0,0
3779,1150,533,1381,1070,21,15,9,231,537,1876,2043,0,0
3780,1129,524,1365,1074,21,15,9,236,550,1877,2043,0,0
3781,1105,512,1345,1073,21,15,9,240,561,1878,2043,0,0
3782,1084,504,1327,1072,21,15,9,243,568,1879,2043,0,0
3783,1072,497,1319,1073,21,15,9,247,576,1880,2043,0,0
3784,1073,497,1320,1069,21,15,9,247,572,1881,2043,0,0
3785,1071,490,1326,1076,21,15,9,255,586,1882,2043,0,0
3786,1072,481,1327,1070,21,15,9,255,589,1883,2043,0,0
3787,1079,478,1332,1068,21,15,9,253,590,1884,2043,0,0
3788,1064,470,1321,1065,21,15,9,257,595,1885,2043,0,0
3789,1029,457,1292,1065,21,15,9,263,608,1886,2043,0,0
3790,1010,451,1272,1058,21,15,9,262,607,1887,2043,0,0
3791,990,446,1249,1057,21,15,9,259,611,1888,2043,0,0
3792,969,443,1215,1035,21,15,9,246,592,1889,2043,0,0
3793,947,434,1189,1029,21,15,9,242,595,1890,2043,0,0
3794,927,424,1166,1026,21,15,9,239,602,1891,2043,0,0
3795,915,411,1150,1021,21,15,9,235,610,1892,2043,0,0
3796,907,400,1135,1009,21,15,9,228,609,1893,2043,0,0
3797,905,392,1116,965,21,15,9,211,573,1894,2043,0,0
3798,887,385,1090,940,21,15,9,203,555,1895,2043,0,0
3799,865,379,1066,925,21,15,9,201,546,1896,2043,0,0
3800,846,368,1045,915,21,15,9,199,547,1897,2043,0,0
3801,823,354,1017,892,21,15,9,194,538,1898,2043,0,0
3802,805,343,994,876,21,15,9,189,533,1899,2043,0,0
3803,793,338,977,868,21,15,9,184,530,1900,2043,0,0
3804,788,336,970,866,21,15,9,182,530,1901,2043,0,0
3805,788,331,969,859,21,15,9,181,528,1902,2043,0,0
3806,796,325,974,853,21,15,9,178,528,1903,2043,0,0
3807,807,323,977,827,21,15,9,170,504,1904,2043,0,0
3808,818,319,983,809,21,15,9,165,490,1905,2043,0,0
3809,827,319,987,802,21,15,9,160,483,1906,2043,0,0
3810,837,322,995,800,21,15,9,158,478,1907,2043,0,0
3811,844,320,1000,796,21,15,9,156,476,1908,2043,0,0
3812,847,319,1001,790,21,15,9,154,471,1909,2043,0,0
3813,844,313,995,785,21,15,9,151,472,1910,2043,0,0
3814,841,312,990,781,21,15,9,149,469,1911,2043,0,0
3815,845,312,993,782,21,15,9,148,470,1912,2043,0,0
3816,848,315,994,791,21,15,9,146,476,1913,2043,0,0
3817,848,316,995,797,21,15,9,147,481,1914,2043,0,0
3818,842,319,989,800,21,15,9,147,481,1915,2043,0,0
3819,835,323,981,804,21,15,9,146,481,1916,2043,0,0
3820,834,326,980,806,21,15,9,146,480,1917,2043,0,0
3821,835,329,984,816,21,15,9,149,487,1918,2043,0,0
3822,840,336,995,837,21,15,9,155,501,1919,2043,0,0
3823,838,347,996,849,21,15,9,158,502,1920,2043,0,0
3824,858,353,1018,856,21,15,9,160,503,1921,2043,0,0
3825,878,359,1038,858,21,15,9,160,499,1922,2043,0,0
3826,893,370,1058,879,21,15,9,165,509,1923,2043,0,0
3827,902,371,1075,909,21,15,9,173,538,1924,2043,0,0
3828,914,376,1093,935,21,15,9,179,559,1925,2043,0,0
3829,926,389,1102,938,21,15,9,176,549,1926,2043,0,0
3830,932,397,1107,945,21,15,9,175,548,1927,2043,0,0
3831,936,405,1115,957,21,15,9,179,552,1928,2043,0,0
3832,942,411,1128,971,21,15,9,186,560,1929,2043,0,0
3833,962,412,1153,978,21,15,9,191,566,1930,2043,0,0
3834,988,428,1178,978,21,15,9,190,550,1931,2043,0,0
3835,1015,430,1215,1014,21,15,9,200,584,1932,2043,0,0
3836,1029,441,1237,1050,21,15,9,208,609,1933,2043,0,0
3837,1036,448,1246,1067,21,15,9,210,619,1934,2043,0,0
3838,1039,452,1247,1068,21,15,9,208,616,1935,2043,0,0
3839,1031,467,1237,1071,21,15,9,206,604,1936,2043,0,0
3840,1023,467,1235,1080,21,15,9,212,613,1937,2043,0,0
3841,1024,474,1237,1080,21,15,9,213,606,1938,2043,0,0
3842,1032,484,1246,1078,21,15,9,214,594,1939,2043,0,0
3843,1054,496,1268,1073,21,15,9,214,577,1940,2043,0,0
3844,1086,492,1304,1069,21,15,9,218,577,1941,2043,0,0
3845,1136,501,1353,1072,21,15,9,217,571,1942,2043,0,0
3846,1168,508,1380,1068,21,15,9,212,560,1943,2043,0,0
3847,1177,505,1391,1071,21,15,9,214,566,1944,2043,0,0
3848,1191,510,1405,1070,21,15,9,214,560,1945,2043,0,0
3849,1205,518,1419,1068,21,15,9,214,550,1946,2043,0,0
3850,1214,528,1430,1069,21,15,9,216,541,1947,2043,0,0
3851,1229,532,1448,1068,21,15,9,219,536,1948,2043,0,0
3852,1233,542,1453,1069,21,15,9,220,527,1949,2043,0,0
3853,1219,545,1445,1070,21,15,9,226,525,1950,2043,0,0
3854,1187,537,1424,1072,21,15,9,237,535,1951,2043,0,0
3855,1164,532,1403,1064,21,15,9,239,532,1952,2043,0,0
3856,1124,518,1373,1073,21,15,9,249,555,1953,2043,0,0
3857,1092,515,1342,1073,21,15,9,250,558,1954,2043,0,0
3858,1062,503,1315,1071,21,15,9,253,568,1955,2043,0,0
3859,1043,496,1296,1070,21,15,9,253,574,1956,2043,0,0
3860,1031,482,1287,1069,21,15,9,256,587,1957,2043,0,0
3861,1025,472,1283,1067,21,15,9,258,595,1958,2043,0,0
3862,1020,461,1277,1061,21,15,9,257,600,1959,2043,0,0
3863,1007,451,1260,1046,21,15,9,253,595,1960,2043,0,0
3864,994,445,1247,1042,21,15,9,253,597,1961,2043,0,0
3865,970,434,1222,1036,21,15,9,252,602,1962,2043,0,0
3866,948,424,1185,999,21,15,9,237,575,1963,2043,0,0
3867,922,411,1152,979,21,15,9,230,568,1964,2043,0,0
3868,903,402,1131,975,21,15,9,228,573,1965,2043,0,0
3869,894,394,1118,970,21,15,9,224,576,1966,2043,0,0
3870,891,387,1108,955,21,15,9,217,568,1967,2043,0,0
3871,891,380,1099,934,21,15,9,208,554,1968,2043,0,0
3872,892,373,1089,901,21,15,9,197,528,1969,2043,0,0
3873,887,365,1082,886,21,15,9,195,521,1970,2043,0,0
3874,872,361,1065,880,21,15,9,193,519,1971,2043,0,0
3875,856,358,1045,873,21,15,9,189,515,1972,2043,0,0
3876,835,345,1025,868,21,15,9,190,523,1973,2043,0,0
3877,821,334,1004,848,21,15,9,183,514,1974,2043,0,0
3878,814,327,993,840,21,15,9,179,513,1975,2043,0,0
3879,809,328,982,833,21,15,9,173,505,1976,2043,0,0
3880,806,323,977,827,21,15,9,171,504,1977,2043,0,0
3881,810,320,978,817,21,15,9,168,497,1978,2043,0,0
3882,825,320,985,791,21,15,9,160,471,1979,2043,0,0
3883,844,321,999,777,21,15,9,155,456,1980,2043,0,0
3884,860,323,1010,768,21,15,9,150,445,1981,2043,0,0
3885,866,317,1015,767,21,15,9,149,450,1982,2043,0,0
3886,867,315,1014,765,21,15,9,147,450,1983,2043,0,0
3887,866,316,1010,763,21,15,9,144,447,1984,2043,0,0
3888,866,318,1006,758,21,15,9,140,440,1985,2043,0,0
3889,863,320,1004,765,21,15,9,141,445,1986,2043,0,0
3890,858,319,1003,777,21,15,9,145,458,1987,2043,0,0
3891,853,320,1001,787,21,15,9,148,467,1988,2043,0,0
3892,854,320,1003,789,21,15,9,149,469,1989,2043,0,0
3893,850,323,1001,793,21,15,9,151,470,1990,2043,0,0
3894,841,325,992,793,21,15,9,151,468,1991,2043,0,0
3895,834,327,991,807,21,15,9,157,480,1992,2043,0,0
3896,833,331,1001,836,21,15,9,168,505,1993,2043,0,0
3897,837,337,1009,847,21,15,9,172,510,1994,2043,0,0
3898,859,341,1032,855,21,15,9,173,514,1995,2043,0,0
3899,884,350,1055,856,21,15,9,171,506,1996,2043,0,0
3900,899,360,1076,888,21,15,9,177,528,1997,2043,0,0
3901,904,367,1087,921,21,15,9,183,554,1998,2043,0,0
3902,908,374,1096,942,21,15,9,188,568,1999,2043,0,0
3903,914,386,1100,946,21,15,9,186,560,2000,2043,0,0
3904,910,396,1095,949,21,15,9,185,553,2001,2043,0,0
3905,913,398,1105,963,21,15,9,192,565,2002,2043,0,0
3906,923,412,1118,977,21,15,9,195,565,2003,2043,0,0
3907,942,421,1138,986,21,15,9,196,565,2004,2043,0,0
3908,972,427,1170,992,21,15,9,198,565,2005,2043,0,0
3909,1000,427,1204,1017,21,15,9,204,590,2006,2043,0,0
3910,1021,425,1224,1029,21,15,9,203,604,2007,2043,0,0
3911,1036,428,1236,1022,21,15,9,200,594,2008,2043,0,0
3912,1042,425,1243,1018,21,15,9,201,593,2009,2043,0,0
3913,1047,421,1251,1022,21,15,9,204,601,2010,2043,0,0
3914,1053,429,1254,1021,21,15,9,201,592,2011,2043,0,0
3915,1056,423,1258,1020,21,15,9,202,597,2012,2043,0,0
3916,1057,431,1256,1019,21,15,9,199,588,2013,2043,0,0
3917,1057,429,1256,1014,21,15,9,199,585,2014,2043,0,0
3918,1054,432,1257,1031,21,15,9,203,599,2015,2043,0,0
3919,1052,435,1258,1048,21,15,9,206,613,2016,2043,0,0
3920,1053,440,1264,1064,21,15,9,211,624,2017,2043,0,0
3921,1055,450,1264,1068,21,15,9,209,618,2018,2043,0,0
3922,1054,458,1264,1074,21,15,9,210,616,2019,2043,0,0
3923,1054,464,1266,1073,21,15,9,212,609,2020,2043,0,0
3924,1058,480,1271,1077,21,15,9,213,597,2021,2043,0,0
3925,1069,494,1284,1072,21,15,9,215,578,2022,2043,0,0
3926,1085,495,1308,1073,21,15,9,223,578,2023,2043,0,0
3927,1123,507,1348,1074,21,15,9,225,567,2024,2043,0,0
3928,1171,526,1390,1071,21,15,9,219,545,2025,2043,0,0
3929,1202,550,1414,1070,21,15,9,212,520,2026,2043,0,0
3930,1229,576,1434,1069,21,15,9,205,493,2027,2043,0,0
3931,1246,595,1455,1074,21,15,9,209,479,2028,2043,0,0
3932,1259,620,1467,1076,21,15,9,208,456,2029,2043,0,0
3933,1277,643,1485,1071,21,15,9,208,428,2030,2043,0,0
3934,1304,666,1512,1066,21,15,9,208,400,2031,2043,0,0
3935,1344,694,1547,1070,21,15,9,203,376,2032,2043,0,0
3936,1403,715,1600,1069,21,15,9,197,354,2033,2043,0,0
3937,1455,739,1647,1069,21,15,9,192,330,2034,2043,0,0
3938,1501,751,1689,1065,21,15,9,188,314,2035,2043,0,0
3939,1535,772,1721,1070,21,15,9,186,298,2036,2043,0,0
3940,1567,799,1747,1073,21,15,9,180,274,2037,2043,0,0
3941,1594,825,1766,1071,21,15,9,172,246,2038,2043,0,0
3942,1621,867,1779,1074,21,15,9,158,207,2039,2043,0,0
3943,1649,888,1807,1075,21,15,9,158,187,2040,2043,0,0
3944,1673,903,1830,1076,21,15,9,157,173,2041,2043,0,0
3945,1699,911,1859,1077,21,15,9,160,166,2042,2043,0,0
3946,1735,930,1878,1077,21,15,9,143,147,2043,2043,1,0
1961,1493,654,1530,724,22,15,9,37,70,0,0,0,0
2695,1158,507,1278,634,25,15,9,120,127,0,0,0,0
3103,1113,413,1199,620,27,15,9,86,207,0,1,0,0
3104,1117,419,1199,614,27,15,9,82,195,1,1,0,0
3110,1107,433,1191,621,28,15,9,84,188,0,1,0,0
3111,1112,438,1193,620,28,15,9,81,182,1,1,0,0
3113,1110,425,1189,621,29,15,9,79,196,0,0,0,0
3115,1105,430,1195,624,30,15,9,90,194,0,1,0,0
3116,1106,430,1195,621,30,15,9,89,191,1,1,0,0
3191,1120,424,1194,623,31,15,9,74,199,0,1,0,0
3192,1121,425,1195,624,31,15,9,74,199,1,1,0,0
3214,1133,429,1211,625,32,15,9,78,196,0,1,0,0
3215,1134,429,1213,625,32,15,9,79,196,1,1,0,0
3931,432,355,725,1015,34,15,9,293,660,0,77,0,1
3932,412,351,702,1004,34,15,9,290,653,1,77,0,0
3933,419,328,686,931,34,15,9,267,603,2,77,0,0
3934,412,300,671,890,34,15,9,259,590,3,77,0,0
3935,413,290,660,852,34,15,9,247,562,4,77,0,0
3936,420,269,646,787,34,15,9,226,518,5,77,0,0
3937,415,262,632,759,34,15,9,217,497,6,77,0,0
3938,416,257,619,727,34,15,9,203,470,7,77,0,0
3939,419,237,611,686,34,15,9,192,449,8,77,0,0
3940,419,234,607,675,34,15,9,188,441,9,77,0,0
3941,426,225,600,635,34,15,9,174,410,10,77,0,0
3942,424,218,592,614,34,15,9,168,396,11,77,0,0
3943,421,217,580,589,34,15,9,159,372,12,77,0,0
3944,426,205,576,561,34,15,9,150,356,13,77,0,0
3945,428,195,576,551,34,15,9,148,356,14,77,0,0
3946,437,192,579,536,34,15,9,142,344,15,77,0,0
3947,437,182,576,520,34,15,9,139,338,16,77,0,0
3948,431,181,565,511,34,15,9,134,330,17,77,0,0
3949,437,177,561,486,34,15,9,124,309,18,77,0,0
3950,438,171,557,471,34,15,9,119,300,19,77,0,0
3951,441,170,557,462,34,15,9,116,292,20,77,0,0
3952,443,163,554,444,34,15,9,111,281,21,77,0,0
3953,434,161,544,440,34,15,9,110,279,22,77,0,0
3954,435,162,537,424,34,15,9,102,262,23,77,0,0
3955,430,155,529,410,34,15,9,99,255,24,77,0,0
3956,429,156,526,408,34,15,9,97,252,25,77,0,0
3957,433,152,526,394,34,15,9,93,242,26,77,0,0
3958,431,148,523,389,34,15,9,92,241,27,77,0,0
3959,428,147,518,383,34,15,9,90,236,28,77,0,0
3960,424,141,511,372,34,15,9,87,231,29,77,0,0
3961,422,141,508,369,34,15,9,86,228,30,77,0,0
3962,428,141,510,358,34,15,9,82,217,31,77,0,0
3963,425,139,506,352,34,15,9,81,213,32,77,0,0
3964,421,140,499,348,34,15,9,78,208,33,77,0,0
3965,418,137,494,340,34,15,9,76,203,34,77,0,0
3966,416,135,491,335,34,15,9,75,200,35,77,0,0
3967,415,133,489,331,34,15,9,74,198,36,77,0,0
3968,415,127,488,321,34,15,9,73,194,37,77,0,0
3969,415,128,487,319,34,15,9,72,191,38,77,0,0
3970,413,122,485,314,34,15,9,72,192,39,77,0,0
3971,414,120,484,308,34,15,9,70,188,40,77,0,0
3972,413,112,484,305,34,15,9,71,193,41,77,0,0
3973,417,109,486,300,34,15,9,69,191,42,77,0,0
3974,419,108,487,296,34,15,9,68,188,43,77,0,0
3975,419,113,483,291,34,15,9,64,178,44,77,0,0
3976,420,113,482,285,34,15,9,62,172,45,77,0,0
3977,422,111,484,282,34,15,9,62,171,46,77,0,0
3978,426,105,489,278,34,15,9,63,173,47,77,0,0
3979,427,95,492,275,34,15,9,65,180,48,77,0,0
3980,427,89,493,272,34,15,9,66,183,49,77,0,0
3981,428,86,493,268,34,15,9,65,182,50,77,0,0
3982,429,86,492,264,34,15,9,63,178,51,77,0,0
3983,430,88,493,263,34,15,9,63,175,52,77,0,0
3984,434,85,496,260,34,15,9,62,175,53,77,0,0
3985,435,93,493,256,34,15,9,58,163,54,77,0,0
3986,435,87,494,255,34,15,9,59,168,55,77,0,0
3987,436,85,495,253,34,15,9,59,168,56,77,0,0
3988,435,85,495,254,34,15,9,60,169,57,77,0,0
3989,435,85,494,253,34,15,9,59,168,58,77,0,0
3990,433,85,492,251,34,15,9,59,166,59,77,0,0
3991,432,82,489,245,34,15,9,57,163,60,77,0,0
3992,432,85,486,239,34,15,9,54,154,61,77,0,0
3993,432,85,484,236,34,15,9,52,151,62,77,0,0
3994,432,84,483,232,34,15,9,51,148,63,77,0,0
3995,431,87,481,229,34,15,9,50,142,64,77,0,0
3996,429,91,477,226,34,15,9,48,135,65,77,0,0
3997,428,89,474,221,34,15,9,46,132,66,77,0,0
3998,429,92,473,220,34,15,9,44,128,67,77,0,0
3999,429,90,474,217,34,15,9,45,127,68,77,0,0
4000,429,89,474,217,34,15,9,45,128,69,77,0,0
4001,427,91,471,216,34,15,9,44,125,70,77,0,0
4002,427,88,470,213,34,15,9,43,125,71,77,0,0
4003,427,88,469,210,34,15,9,42,122,72,77,0,0
4004,428,87,468,205,34,15,9,40,118,73,77,0,0
4005,428,85,469,205,34,15,9,41,120,74,77,0,0
4006,427,89,466,204,34,15,9,39,115,75,77,0,0
4007,427,91,463,197,34,15,9,36,106,76,77,0,0
4008,426,89,463,199,34,15,9,37,110,77,77,1,0
4010,428,88,464,193,34,15,9,36,105,0,77,0,0
4011,428,87,463,191,34,15,9,35,104,1,77,0,0
4018,432,83,467,186,34,15,9,35,103,0,77,0,0
4022,434,82,469,184,34,15,9,35,102,0,77,0,0
4023,434,80,469,182,34,15,9,35,102,1,77,0,0
3961,1736,906,1900,1078,35,15,9,164,172,0,98,0,1
3962,1708,888,1886,1075,35,15,9,178,187,1,98,0,0
3963,1658,869,1853,1074,35,15,9,195,205,2,98,0,0
3964,1582,837,1809,1076,35,15,9,227,239,3,98,0,0
3965,1507,799,1769,1078,35,15,9,262,279,4,98,0,0
3966,1427,764,1721,1075,35,15,9,294,311,5,98,0,0
3967,1380,732,1693,1068,35,15,9,313,336,6,98,0,0
3968,1338,712,1666,1069,35,15,9,328,357,7,98,0,0
3969,1280,690,1626,1071,35,15,9,346,381,8,98,0,0
3970,1217,668,1581,1076,35,15,9,364,408,9,98,0,0
3971,1161,644,1538,1072,35,15,9,377,428,10,98,0,0
3972,1112,624,1495,1069,35,15,9,383,445,11,98,0,0
3973,1080,612,1461,1067,35,15,9,381,455,12,98,0,0
3974,1049,587,1440,1067,35,15,9,391,480,13,98,0,0
3975,1031,567,1429,1071,35,15,9,398,504,14,98,0,0
3976,1015,549,1414,1071,35,15,9,399,522,15,98,0,0
3977,1002,529,1400,1069,35,15,9,398,540,16,98,0,0
3978,972,517,1369,1068,35,15,9,397,551,17,98,0,0
3979,948,501,1343,1068,35,15,9,395,567,18,98,0,0
3980,925,491,1313,1070,35,15,9,388,579,19,98,0,0
3981,895,478,1279,1071,35,15,9,384,593,20,98,0,0
3982,870,464,1248,1068,35,15,9,378,604,21,98,0,0
3983,860,455,1231,1070,35,15,9,371,615,22,98,0,0
3984,856,440,1219,1068,35,15,9,363,628,23,98,0,0
3985,860,424,1206,1046,35,15,9,346,622,24,98,0,0
3986,860,416,1181,1010,35,15,9,321,594,25,98,0,0
3987,845,404,1159,1003,35,15,9,314,599,26,98,0,0
3988,838,394,1137,982,35,15,9,299,588,27,98,0,0
3989,822,383,1100,947,35,15,9,278,564,28,98,0,0
3990,807,371,1066,914,35,15,9,259,543,29,98,0,0
3991,795,365,1046,907,35,15,9,251,542,30,98,0,0
3992,790,357,1033,900,35,15,9,243,543,31,98,0,0
3993,795,348,1028,885,35,15,9,233,537,32,98,0,0
3994,805,339,1020,847,35,15,9,215,508,33,98,0,0
3995,803,331,1013,835,35,15,9,210,504,34,98,0,0
3996,792,324,998,832,35,15,9,206,508,35,98,0,0
3997,780,316,976,809,35,15,9,196,493,36,98,0,0
3998,775,309,958,781,35,15,9,183,472,37,98,0,0
3999,772,304,946,762,35,15,9,174,458,38,98,0,0
4000,773,304,943,760,35,15,9,170,456,39,98,0,0
4001,777,300,946,762,35,15,9,169,462,40,98,0,0
4002,789,298,950,741,35,15,9,161,443,41,98,0,0
4003,806,297,957,715,35,15,9,151,418,42,98,0,0
4004,819,298,966,715,35,15,9,147,417,43,98,0,0
4005,825,294,971,716,35,15,9,146,422,44,98,0,0
4006,828,292,970,713,35,15,9,142,421,45,98,0,0
4007,826,291,966,713,35,15,9,140,422,46,98,0,0
4008,823,290,961,713,35,15,9,138,423,47,98,0,0
4009,823,291,958,711,35,15,9,135,420,48,98,0,0
4010,825,289,959,711,35,15,9,134,422,49,98,0,0
4011,823,289,956,718,35,15,9,133,429,50,98,0,0
4012,819,293,952,724,35,15,9,133,431,51,98,0,0
4013,813,289,948,727,35,15,9,135,438,52,98,0,0
4014,809,289,945,729,35,15,9,136,440,53,98,0,0
4015,805,295,940,730,35,15,9,135,435,54,98,0,0
4016,799,297,938,740,35,15,9,139,443,55,98,0,0
4017,799,300,943,757,35,15,9,144,457,56,98,0,0
4018,804,304,954,770,35,15,9,150,466,57,98,0,0
4019,814,310,965,774,35,15,9,151,464,58,98,0,0
4020,836,316,986,779,35,15,9,150,463,59,98,0,0
4021,849,323,1006,804,35,15,9,157,481,60,98,0,0
4022,863,331,1024,831,35,15,9,161,500,61,98,0,0
4023,881,344,1043,850,35,15,9,162,506,62,98,0,0
4024,885,351,1048,859,35,15,9,163,508,63,98,0,0
4025,887,354,1050,867,35,15,9,163,513,64,98,0,0
4026,893,360,1063,889,35,15,9,170,529,65,98,0,0
4027,898,372,1073,901,35,15,9,175,529,66,98,0,0
4028,910,374,1089,905,35,15,9,179,531,67,98,0,0
4029,936,381,1117,915,35,15,9,181,534,68,98,0,0
4030,959,393,1147,955,35,15,9,188,562,69,98,0,0
4031,976,408,1169,989,35,15,9,193,581,70,98,0,0
4032,986,416,1180,1004,35,15,9,194,588,71,98,0,0
4033,992,422,1183,1006,35,15,9,191,584,72,98,0,0
4034,991,431,1184,1012,35,15,9,193,581,73,98,0,0
4035,990,445,1194,1047,35,15,9,204,602,74,98,0,0
4036,993,460,1207,1073,35,15,9,214,613,75,98,0,0
4037,1016,470,1235,1076,35,15,9,219,606,76,98,0,0
4038,1061,480,1280,1079,35,15,9,219,599,77,98,0,0
4039,1104,491,1318,1080,35,15,9,214,589,78,98,0,0
4040,1138,507,1347,1075,35,15,9,209,568,79,98,0,0
4041,1161,529,1367,1080,35,15,9,206,551,80,98,0,0
4042,1176,550,1379,1080,35,15,9,203,530,81,98,0,0
4043,1184,570,1388,1080,35,15,9,204,510,82,98,0,0
4044,1207,594,1411,1076,35,15,9,204,482,83,98,0,0
4045,1257,618,1466,1078,35,15,9,209,460,84,98,0,0
4046,1309,634,1519,1080,35,15,9,210,446,85,98,0,0
4047,1344,647,1552,1077,35,15,9,208,430,86,98,0,0
4048,1377,659,1586,1077,35,15,9,209,418,87,98,0,0
4049,1406,670,1615,1073,35,15,9,209,403,88,98,0,0
4050,1429,694,1636,1077,35,15,9,207,383,89,98,0,0
4051,1461,714,1664,1075,35,15,9,203,361,90,98,0,0
4052,1486,744,1677,1073,35,15,9,191,329,91,98,0,0
4053,1506,759,1699,1074,35,15,9,193,315,92,98,0,0
4054,1532,782,1720,1075,35,15,9,188,293,93,98,0,0
4055,1570,811,1748,1072,35,15,9,178,261,94,98,0,0
4056,1603,833,1775,1072,35,15,9,172,239,95,98,0,0
4057,1647,843,1823,1075,35,15,9,176,232,96,98,0,0
4058,1679,854,1854,1074,35,15,9,175,220,97,98,0,0
4059,1717,871,1878,1074,35,15,9,161,203,98,98,1,0
3965,1437,980,1505,1078,36,15,9,68,98,0,0,0,0
4080,1004,581,1483,1072,38,15,9,479,491,0,1920,0,1
4081,977,561,1453,1069,38,15,9,476,508,1,1920,0,0
4082,956,539,1433,1069,38,15,9,477,530,2,1920,0,0
4083,943,520,1416,1069,38,15,9,473,549,3,1920,0,0
4084,930,504,1400,1073,38,15,9,470,569,4,1920,0,0
4085,921,493,1378,1068,38,15,9,457,575,5,1920,0,0
4086,920,487,1368,1071,38,15,9,448,584,6,1920,0,0
4087,915,480,1350,1073,38,15,9,435,593,7,1920,0,0
4088,898,468,1319,1070,38,15,9,421,602,8,1920,0,0
4089,875,457,1286,1069,38,15,9,411,612,9,1920,0,0
4090,856,449,1256,1069,38,15,9,400,620,10,1920,0,0
4091,858,438,1240,1056,38,15,9,382,618,11,1920,0,0
4092,867,423,1234,1044,38,15,9,367,621,12,1920,0,0
4093,881,414,1212,997,38,15,9,331,583,13,1920,0,0
4094,867,398,1183,972,38,15,9,316,574,14,1920,0,0
4095,837,384,1152,967,38,15,9,315,583,15,1920,0,0
4096,824,375,1128,952,38,15,9,304,577,16,1920,0,0
4097,800,366,1082,923,38,15,9,282,557,17,1920,0,0
4098,774,356,1044,912,38,15,9,270,556,18,1920,0,0
4099,757,352,1015,905,38,15,9,258,553,19,1920,0,0
4100,744,342,992,891,38,15,9,248,549,20,1920,0,0
4101,742,331,975,866,38,15,9,233,535,21,1920,0,0
4102,733,321,951,833,38,15,9,218,512,22,1920,0,0
4103,717,319,926,818,38,15,9,209,499,23,1920,0,0
4104,707,318,910,810,38,15,9,203,492,24,1920,0,0
4105,691,310,886,790,38,15,9,195,480,25,1920,0,0
4106,677,307,864,779,38,15,9,187,472,26,1920,0,0
4107,669,305,853,775,38,15,9,184,470,27,1920,0,0
4108,668,295,852,772,38,15,9,184,477,28,1920,0,0
4109,682,292,859,753,38,15,9,177,461,29,1920,0,0
4110,704,289,870,731,38,15,9,166,442,30,1920,0,0
4111,721,288,882,724,38,15,9,161,436,31,1920,0,0
4112,730,286,888,722,38,15,9,158,436,32,1920,0,0
4113,733,280,888,720,38,15,9,155,440,33,1920,0,0
4114,730,277,883,716,38,15,9,153,439,34,1920,0,0
4115,727,272,875,707,38,15,9,148,435,35,1920,0,0
4116,720,265,864,693,38,15,9,144,428,36,1920,0,0
4117,720,264,860,681,38,15,9,140,417,37,1920,0,0
4118,723,263,862,679,38,15,9,139,416,38,1920,0,0
4119,732,266,866,673,38,15,9,134,407,39,1920,0,0
4120,746,267,878,668,38,15,9,132,401,40,1920,0,0
4121,757,264,888,667,38,15,9,131,403,41,1920,0,0
4122,768,261,897,662,38,15,9,129,401,42,1920,0,0
4123,780,265,905,662,38,15,9,125,397,43,1920,0,0
4124,785,268,908,663,38,15,9,123,395,44,1920,0,0
4125,788,271,908,663,38,15,9,120,392,45,1920,0,0
4126,787,275,905,662,38,15,9,118,387,46,1920,0,0
4127,783,274,901,667,38,15,9,118,393,47,1920,0,0
4128,774,270,894,672,38,15,9,120,402,48,1920,0,0
4129,766,266,888,672,38,15,9,122,406,49,1920,0,0
4130,762,269,883,674,38,15,9,121,405,50,1920,0,0
4131,758,273,878,671,38,15,9,120,398,51,1920,0,0
4132,756,279,876,673,38,15,9,120,394,52,1920,0,0
4133,754,278,881,686,38,15,9,127,408,53,1920,0,0
4134,754,278,888,698,38,15,9,134,420,54,1920,0,0
4135,764,281,901,704,38,15,9,137,423,55,1920,0,0
4136,785,286,924,711,38,15,9,139,425,56,1920,0,0
4137,802,293,942,726,38,15,9,140,433,57,1920,0,0
4138,809,301,956,754,38,15,9,147,453,58,1920,0,0
4139,804,305,954,768,38,15,9,150,463,59,1920,0,0
4140,793,308,944,775,38,15,9,151,467,60,1920,0,0
4141,787,314,940,784,38,15,9,153,470,61,1920,0,0
4142,785,330,941,804,38,15,9,156,474,62,1920,0,0
4143,787,331,951,816,38,15,9,164,485,63,1920,0,0
4144,807,335,974,820,38,15,9,167,485,64,1920,0,0
4145,835,344,1003,834,38,15,9,168,490,65,1920,0,0
4146,859,354,1036,876,38,15,9,177,522,66,1920,0,0
4147,871,365,1051,905,38,15,9,180,540,67,1920,0,0
4148,879,369,1060,920,38,15,9,181,551,68,1920,0,0
4149,882,379,1059,923,38,15,9,177,544,69,1920,0,0
4150,884,390,1064,933,38,15,9,180,543,70,1920,0,0
4151,895,399,1080,949,38,15,9,185,550,71,1920,0,0
4152,902,403,1091,958,38,15,9,189,555,72,1920,0,0
4153,924,414,1114,965,38,15,9,190,551,73,1920,0,0
4154,952,423,1140,965,38,15,9,188,542,74,1920,0,0
4155,978,426,1175,1003,38,15,9,197,577,75,1920,0,0
4156,998,432,1202,1038,38,15,9,204,606,76,1920,0,0
4157,1010,434,1216,1058,38,15,9,206,624,77,1920,0,0
4158,1020,445,1222,1064,38,15,9,202,619,78,1920,0,0
4159,1024,452,1226,1067,38,15,9,202,615,79,1920,0,0
4160,1023,459,1224,1067,38,15,9,201,608,80,1920,0,0
4161,1025,468,1229,1076,38,15,9,204,608,81,1920,0,0
4162,1022,481,1228,1076,38,15,9,206,595,82,1920,0,0
4163,1028,487,1238,1074,38,15,9,210,587,83,1920,0,0
4164,1059,505,1268,1073,38,15,9,209,568,84,1920,0,0
4165,1093,516,1303,1075,38,15,9,210,559,85,1920,0,0
4166,1139,523,1347,1074,38,15,9,208,551,86,1920,0,0
4167,1168,544,1367,1066,38,15,9,199,522,87,1920,0,0
4168,1182,561,1381,1073,38,15,9,199,512,88,1920,0,0
4169,1189,580,1385,1074,38,15,9,196,494,89,1920,0,0
4170,1188,591,1386,1074,38,15,9,198,483,90,1920,0,0
4171,1188,597,1389,1072,38,15,9,201,475,91,1920,0,0
4172,1196,598,1400,1071,38,15,9,204,473,92,1920,0,0
4173,1197,592,1405,1072,38,15,9,208,480,93,1920,0,0
4174,1191,581,1408,1072,38,15,9,217,491,94,1920,0,0
4175,1179,563,1404,1070,38,15,9,225,507,95,1920,0,0
4176,1169,552,1400,1070,38,15,9,231,518,96,1920,0,0
4177,1156,545,1393,1071,38,15,9,237,526,97,1920,0,0
4178,1149,541,1389,1071,38,15,9,240,530,98,1920,0,0
4179,1146,537,1390,1070,38,15,9,244,533,99,1920,0,0
4180,1149,535,1398,1067,38,15,9,249,532,100,1920,0,0
4181,1155,538,1407,1068,38,15,9,252,530,101,1920,0,0
4182,1162,535,1416,1062,38,15,9,254,527,102,1920,0,0
4183,1151,536,1408,1064,38,15,9,257,528,103,1920,0,0
4184,1138,528,1400,1070,38,15,9,262,542,104,1920,0,0
4185,1103,511,1370,1070,38,15,9,267,559,105,1920,0,0
4186,1063,498,1333,1071,38,15,9,270,573,106,1920,0,0
4187,1025,491,1296,1069,38,15,9,271,578,107,1920,0,0
4188,998,479,1275,1076,38,15,9,277,597,108,1920,0,0
4189,990,472,1266,1074,38,15,9,276,602,109,1920,0,0
4190,989,462,1265,1069,38,15,9,276,607,110,1920,0,0
4191,996,456,1269,1065,38,15,9,273,609,111,1920,0,0
4192,996,439,1262,1038,38,15,9,266,599,112,1920,0,0
4193,999,429,1263,1030,38,15,9,264,601,113,1920,0,0
4194,996,427,1252,1019,38,15,9,256,592,114,1920,0,0
4195,988,418,1233,997,38,15,9,245,579,115,1920,0,0
4196,987,417,1223,982,38,15,9,236,565,116,1920,0,0
4197,968,405,1205,983,38,15,9,237,578,117,1920,0,0
4198,965,400,1201,986,38,15,9,236,586,118,1920,0,0
4199,976,398,1202,974,38,15,9,226,576,119,1920,0,0
4200,986,404,1205,972,38,15,9,219,568,120,1920,0,0
4201,993,411,1206,974,38,15,9,213,563,121,1920,0,0
4202,998,416,1208,976,38,15,9,210,560,122,1920,0,0
4203,1004,421,1209,976,38,15,9,205,555,123,1920,0,0
4204,1008,422,1210,973,38,15,9,202,551,124,1920,0,0
4205,1010,422,1209,970,38,15,9,199,548,125,1920,0,0
4206,1013,427,1208,968,38,15,9,195,541,126,1920,0,0
4207,1016,430,1207,964,38,15,9,191,534,127,1920,0,0
4208,1017,432,1206,963,38,15,9,189,531,128,1920,0,0
4209,1018,430,1207,965,38,15,9,189,535,129,1920,0,0
4210,1020,429,1208,966,38,15,9,188,537,130,1920,0,0
4211,1021,429,1209,966,38,15,9,188,537,131,1920,0,0
4212,1022,435,1211,975,38,15,9,189,540,132,1920,0,0
4213,1023,438,1212,978,38,15,9,189,540,133,1920,0,0
4214,1025,440,1209,968,38,15,9,184,528,134,1920,0,0
4215,1023,431,1212,974,38,15,9,189,543,135,1920,0,0
4216,1025,438,1214,977,38,15,9,189,539,136,1920,0,0
4217,1026,439,1215,980,38,15,9,189,541,137,1920,0,0
4218,1024,439,1215,982,38,15,9,191,543,138,1920,0,0
4219,1023,430,1212,975,38,15,9,189,545,139,1920,0,0
4220,1024,429,1212,971,38,15,9,188,542,140,1920,0,0
4221,1029,437,1214,971,38,15,9,185,534,141,1920,0,0
4222,1028,444,1213,973,38,15,9,185,529,142,1920,0,0
4223,1036,451,1218,972,38,15,9,182,521,143,1920,0,0
4224,1038,452,1220,974,38,15,9,182,522,144,1920,0,0
4225,1040,452,1220,972,38,15,9,180,520,145,1920,0,0
4226,1040,451,1220,971,38,15,9,180,520,146,1920,0,0
4227,1038,449,1217,969,38,15,9,179,520,147,1920,0,0
4228,1032,445,1216,973,38,15,9,184,528,148,1920,0,0
4229,1034,442,1218,969,38,15,9,184,527,149,1920,0,0
4230,1036,445,1222,978,38,15,9,186,533,150,1920,0,0
4231,1037,446,1223,974,38,15,9,186,528,151,1920,0,0
4232,1035,443,1223,973,38,15,9,188,530,152,1920,0,0
4233,1030,444,1220,976,38,15,9,190,532,153,1920,0,0
4234,1016,440,1212,982,38,15,9,196,542,154,1920,0,0
4235,1009,434,1207,976,38,15,9,198,542,155,1920,0,0
4236,1007,437,1209,979,38,15,9,202,542,156,1920,0,0
4237,1006,436,1208,974,38,15,9,202,538,157,1920,0,0
4238,1010,439,1214,980,38,15,9,204,541,158,1920,0,0
4239,1005,437,1209,978,38,15,9,204,541,159,1920,0,0
4240,1001,433,1205,976,38,15,9,204,543,160,1920,0,0
4241,1003,422,1206,969,38,15,9,203,547,161,1920,0,0
4242,1002,413,1210,975,38,15,9,208,562,162,1920,0,0
4243,991,406,1198,977,38,15,9,207,571,163,1920,0,0
4244,985,408,1189,984,38,15,9,204,576,164,1920,0,0
4245,969,409,1171,982,38,15,9,202,573,165,1920,0,0
4246,961,404,1165,972,38,15,9,204,568,166,1920,0,0
4247,948,405,1149,966,38,15,9,201,561,167,1920,0,0
4248,930,400,1133,966,38,15,9,203,566,168,1920,0,0
4249,917,401,1121,970,38,15,9,204,569,169,1920,0,0
4250,901,406,1106,974,38,15,9,205,568,170,1920,0,0
4251,892,410,1101,984,38,15,9,209,574,171,1920,0,0
4252,890,417,1102,989,38,15,9,212,572,172,1920,0,0
4253,909,420,1121,986,38,15,9,212,566,173,1920,0,0
4254,953,426,1168,989,38,15,9,215,563,174,1920,0,0
4255,990,437,1211,1009,38,15,9,221,572,175,1920,0,0
4256,995,429,1214,1007,38,15,9,219,578,176,1920,0,0
4257,997,424,1215,1007,38,15,9,218,583,177,1920,0,0
4258,1000,419,1215,1002,38,15,9,215,583,178,1920,0,0
4259,1004,428,1216,1002,38,15,9,212,574,179,1920,0,0
4260,1008,431,1219,1005,38,15,9,211,574,180,1920,0,0
4261,1013,437,1220,1005,38,15,9,207,568,181,1920,0,0
4262,1019,441,1224,1006,38,15,9,205,565,182,1920,0,0
4263,1023,442,1226,1004,38,15,9,203,562,183,1920,0,0
4264,1025,444,1228,1005,38,15,9,203,561,184,1920,0,0
4265,1026,445,1228,1004,38,15,9,202,559,185,1920,0,0
4266,1026,439,1230,1005,38,15,9,204,566,186,1920,0,0
4267,1031,448,1230,999,38,15,9,199,551,187,1920,0,0
4268,1033,443,1237,1004,38,15,9,204,561,188,1920,0,0
4269,1031,445,1238,1008,38,15,9,207,563,189,1920,0,0
4270,1022,443,1231,1007,38,15,9,209,564,190,1920,0,0
4271,1002,436,1215,1005,38,15,9,213,569,191,1920,0,0
4272,980,423,1198,1009,38,15,9,218,586,192,1920,0,0
4273,954,412,1174,1005,38,15,9,220,593,193,1920,0,0
4274,932,404,1148,986,38,15,9,216,582,194,1920,0,0
4275,915,397,1128,969,38,15,9,213,572,195,1920,0,0
4276,905,395,1115,958,38,15,9,210,563,196,1920,0,0
4277,901,396,1109,951,38,15,9,208,555,197,1920,0,0
4278,899,389,1110,954,38,15,9,211,565,198,1920,0,0
4279,907,386,1114,937,38,15,9,207,551,199,1920,0,0
4280,913,382,1113,913,38,15,9,200,531,200,1920,0,0
4281,913,376,1111,900,38,15,9,198,524,201,1920,0,0
4282,912,374,1110,889,38,15,9,198,515,202,1920,0,0
4283,901,370,1098,883,38,15,9,197,513,203,1920,0,0
4284,892,362,1090,881,38,15,9,198,519,204,1920,0,0
4285,884,357,1080,875,38,15,9,196,518,205,1920,0,0
4286,878,354,1070,868,38,15,9,192,514,206,1920,0,0
4287,875,355,1064,866,38,15,9,189,511,207,1920,0,0
4288,874,355,1062,874,38,15,9,188,519,208,1920,0,0
4289,875,354,1067,894,38,15,9,192,540,209,1920,0,0
4290,874,356,1064,904,38,15,9,190,548,210,1920,0,0
4291,879,365,1061,903,38,15,9,182,538,211,1920,0,0
4292,881,372,1057,907,38,15,9,176,535,212,1920,0,0
4293,876,379,1047,906,38,15,9,171,527,213,1920,0,0
4294,876,388,1041,908,38,15,9,165,520,214,1920,0,0
4295,881,390,1045,910,38,15,9,164,520,215,1920,0,0
4296,890,396,1055,912,38,15,9,165,516,216,1920,0,0
4297,892,401,1060,917,38,15,9,168,516,217,1920,0,0
4298,903,401,1074,918,38,15,9,171,517,218,1920,0,0
4299,914,404,1085,917,38,15,9,171,513,219,1920,0,0
4300,942,406,1110,910,38,15,9,168,504,220,1920,0,0
4301,970,412,1135,914,38,15,9,165,502,221,1920,0,0
4302,988,412,1161,951,38,15,9,173,539,222,1920,0,0
4303,1001,414,1179,972,38,15,9,178,558,223,1920,0,0
4304,1012,418,1192,974,38,15,9,180,556,224,1920,0,0
4305,1018,420,1198,978,38,15,9,180,558,225,1920,0,0
4306,1029,424,1209,979,38,15,9,180,555,226,1920,0,0
4307,1038,431,1220,982,38,15,9,182,551,227,1920,0,0
4308,1044,436,1224,979,38,15,9,180,543,228,1920,0,0
4309,1043,435,1226,978,38,15,9,183,543,229,1920,0,0
4310,1042,434,1229,983,38,15,9,187,549,230,1920,0,0
4311,1042,430,1231,980,38,15,9,189,550,231,1920,0,0
4312,1040,424,1233,983,38,15,9,193,559,232,1920,0,0
4313,1036,421,1230,984,38,15,9,194,563,233,1920,0,0
4314,1029,420,1223,981,38,15,9,194,561,234,1920,0,0
4315,1017,408,1215,984,38,15,9,198,576,235,1920,0,0
4316,1010,398,1211,981,38,15,9,201,583,236,1920,0,0
4317,1007,395,1208,975,38,15,9,201,580,237,1920,0,0
4318,1004,395,1202,968,38,15,9,198,573,238,1920,0,0
4319,1017,403,1214,969,38,15,9,197,566,239,1920,0,0
4320,1017,400,1216,973,38,15,9,199,573,240,1920,0,0
4321,1020,402,1219,974,38,15,9,199,572,241,1920,0,0
4322,1025,405,1223,975,38,15,9,198,570,242,1920,0,0
4323,1033,411,1229,969,38,15,9,196,558,243,1920,0,0
4324,1039,414,1235,970,38,15,9,196,556,244,1920,0,0
4325,1039,421,1234,975,38,15,9,195,554,245,1920,0,0
4326,1038,426,1231,976,38,15,9,193,550,246,1920,0,0
4327,1037,429,1229,974,38,15,9,192,545,247,1920,0,0
4328,1037,430,1229,976,38,15,9,192,546,248,1920,0,0
4329,1036,431,1229,980,38,15,9,193,549,249,1920,0,0
4330,1037,431,1230,981,38,15,9,193,550,250,1920,0,0
4331,1039,432,1232,982,38,15,9,193,550,251,1920,0,0
4332,1040,432,1230,978,38,15,9,190,546,252,1920,0,0
4333,1042,432,1229,968,38,15,9,187,536,253,1920,0,0
4334,1039,433,1225,964,38,15,9,186,531,254,1920,0,0
4335,1033,434,1219,962,38,15,9,186,528,255,1920,0,0
4336,1027,435,1215,963,38,15,9,188,528,256,1920,0,0
4337,1025,434,1213,962,38,15,9,188,528,257,1920,0,0
4338,1023,437,1212,964,38,15,9,189,527,258,1920,0,0
4339,1025,439,1215,969,38,15,9,190,530,259,1920,0,0
4340,1027,438,1216,966,38,15,9,189,528,260,1920,0,0
4341,1028,429,1218,966,38,15,9,190,537,261,1920,0,0
4342,1024,427,1214,970,38,15,9,190,543,262,1920,0,0
4343,1024,431,1218,979,38,15,9,194,548,263,1920,0,0
4344,1017,424,1214,979,38,15,9,197,555,264,1920,0,0
4345,1015,424,1215,977,38,15,9,200,553,265,1920,0,0
4346,1002,415,1208,985,38,15,9,206,570,266,1920,0,0
4347,983,412,1190,981,38,15,9,207,569,267,1920,0,0
4348,978,415,1185,979,38,15,9,207,564,268,1920,0,0
4349,967,411,1173,974,38,15,9,206,563,269,1920,0,0
4350,984,420,1196,979,38,15,9,212,559,270,1920,0,0
4351,975,420,1194,986,38,15,9,219,566,271,1920,0,0
4352,951,422,1171,987,38,15,9,220,565,272,1920,0,0
4353,931,419,1150,988,38,15,9,219,569,273,1920,0,0
4354,947,420,1162,983,38,15,9,215,563,274,1920,0,0
4355,959,410,1174,981,38,15,9,215,571,275,1920,0,0
4356,965,414,1179,982,38,15,9,214,568,276,1920,0,0
4357,977,411,1192,989,38,15,9,215,578,277,1920,0,0
4358,994,411,1203,986,38,15,9,209,575,278,1920,0,0
4359,1012,421,1217,989,38,15,9,205,568,279,1920,0,0
4360,1022,425,1226,990,38,15,9,204,565,280,1920,0,0
4361,1026,419,1231,983,38,15,9,205,564,281,1920,0,0
4362,1027,419,1234,988,38,15,9,207,569,282,1920,0,0
4363,1033,423,1242,994,38,15,9,209,571,283,1920,0,0
4364,1033,426,1240,987,38,15,9,207,561,284,1920,0,0
4365,1023,423,1235,993,38,15,9,212,570,285,1920,0,0
4366,1026,420,1240,996,38,15,9,214,576,286,1920,0,0
4367,1028,422,1240,993,38,15,9,212,571,287,1920,0,0
4368,1027,430,1234,987,38,15,9,207,557,288,1920,0,0
4369,1028,435,1234,990,38,15,9,206,555,289,1920,0,0
4370,1029,432,1237,993,38,15,9,208,561,290,1920,0,0
4371,1028,430,1236,991,38,15,9,208,561,291,1920,0,0
4372,1025,431,1234,997,38,15,9,209,566,292,1920,0,0
4373,1024,430,1233,997,38,15,9,209,567,293,1920,0,0
4374,1026,436,1229,991,38,15,9,203,555,294,1920,0,0
4375,1027,429,1234,996,38,15,9,207,567,295,1920,0,0
4376,1030,425,1238,996,38,15,9,208,571,296,1920,0,0
4377,1032,421,1240,994,38,15,9,208,573,297,1920,0,0
4378,1032,424,1239,991,38,15,9,207,567,298,1920,0,0
4379,1032,422,1239,991,38,15,9,207,569,299,1920,0,0
4380,1030,418,1237,981,38,15,9,207,563,300,1920,0,0
4381,1023,418,1232,980,38,15,9,209,562,301,1920,0,0
4382,1007,412,1221,986,38,15,9,214,574,302,1920,0,0
4383,992,407,1209,985,38,15,9,217,578,303,1920,0,0
4384,971,404,1190,988,38,15,9,219,584,304,1920,0,0
4385,946,400,1165,985,38,15,9,219,585,305,1920,0,0
4386,923,389,1141,977,38,15,9,218,588,306,1920,0,0
4387,912,384,1131,973,38,15,9,219,589,307,1920,0,0
4388,911,382,1128,968,38,15,9,217,586,308,1920,0,0
4389,922,386,1138,967,38,15,9,216,581,309,1920,0,0
4390,948,389,1167,971,38,15,9,219,582,310,1920,0,0
4391,960,397,1174,966,38,15,9,214,569,311,1920,0,0
4392,968,399,1184,973,38,15,9,216,574,312,1920,0,0
4393,975,403,1186,964,38,15,9,211,561,313,1920,0,0
4394,980,409,1190,963,38,15,9,210,554,314,1920,0,0
4395,989,418,1194,965,38,15,9,205,547,315,1920,0,0
4396,1001,426,1201,966,38,15,9,200,540,316,1920,0,0
4397,1005,425,1203,965,38,15,9,198,540,317,1920,0,0
4398,1005,413,1204,969,38,15,9,199,556,318,1920,0,0
4399,1005,410,1204,975,38,15,9,199,565,319,1920,0,0
4400,1005,404,1204,975,38,15,9,199,571,320,1920,0,0
4401,1004,403,1203,982,38,15,9,199,579,321,1920,0,0
4402,1002,399,1198,972,38,15,9,196,573,322,1920,0,0
4403,1002,399,1195,970,38,15,9,193,571,323,1920,0,0
4404,1007,397,1198,967,38,15,9,191,570,324,1920,0,0
4405,1008,400,1193,959,38,15,9,185,559,325,1920,0,0
4406,1006,409,1196,986,38,15,9,190,577,326,1920,0,0
4407,1004,415,1198,1002,38,15,9,194,587,327,1920,0,0
4408,997,414,1195,1012,38,15,9,198,598,328,1920,0,0
4409,990,418,1189,1017,38,15,9,199,599,329,1920,0,0
4410,991,430,1185,1013,38,15,9,194,583,330,1920,0,0
4411,997,439,1189,1009,38,15,9,192,570,331,1920,0,0
4412,1002,449,1193,1011,38,15,9,191,562,332,1920,0,0
4413,999,457,1189,1015,38,15,9,190,558,333,1920,0,0
4414,999,460,1191,1018,38,15,9,192,558,334,1920,0,0
4415,996,454,1190,1011,38,15,9,194,557,335,1920,0,0
4416,985,453,1178,1007,38,15,9,193,554,336,1920,0,0
4417,980,452,1175,1006,38,15,9,195,554,337,1920,0,0
4418,977,448,1174,1015,38,15,9,197,567,338,1920,0,0
4419,980,444,1178,1020,38,15,9,198,576,339,1920,0,0
4420,985,436,1182,1021,38,15,9,197,585,340,1920,0,0
4421,987,421,1187,1022,38,15,9,200,601,341,1920,0,0
4422,994,416,1193,1021,38,15,9,199,605,342,1920,0,0
4423,998,410,1198,1019,38,15,9,200,609,343,1920,0,0
4424,999,407,1201,1027,38,15,9,202,620,344,1920,0,0
4425,1001,406,1202,1024,38,15,9,201,618,345,1920,0,0
4426,1004,409,1205,1024,38,15,9,201,615,346,1920,0,0
4427,1007,408,1206,1023,38,15,9,199,615,347,1920,0,0
4428,1011,408,1209,1022,38,15,9,198,614,348,1920,0,0
4429,1013,408,1209,1021,38,15,9,196,613,349,1920,0,0
4430,1012,412,1205,1015,38,15,9,193,603,350,1920,0,0
4431,1015,412,1205,1011,38,15,9,190,599,351,1920,0,0
4432,1024,409,1207,989,38,15,9,183,580,352,1920,0,0
4433,1026,415,1205,984,38,15,9,179,569,353,1920,0,0
4434,1031,414,1209,980,38,15,9,178,566,354,1920,0,0
4435,1036,409,1217,983,38,15,9,181,574,355,1920,0,0
4436,1041,412,1224,985,38,15,9,183,573,356,1920,0,0
4437,1048,419,1230,983,38,15,9,182,564,357,1920,0,0
4438,1051,420,1234,983,38,15,9,183,563,358,1920,0,0
4439,1056,426,1238,975,38,15,9,182,549,359,1920,0,0
4440,1056,427,1240,979,38,15,9,184,552,360,1920,0,0
4441,1055,429,1241,979,38,15,9,186,550,361,1920,0,0
4442,1054,422,1246,985,38,15,9,192,563,362,1920,0,0
4443,1053,422,1247,986,38,15,9,194,564,363,1920,0,0
4444,1051,424,1247,989,38,15,9,196,565,364,1920,0,0
4445,1049,432,1246,996,38,15,9,197,564,365,1920,0,0
4446,1050,436,1242,988,38,15,9,192,552,366,1920,0,0
4447,1049,437,1241,986,38,15,9,192,549,367,1920,0,0
4448,1050,439,1242,987,38,15,9,192,548,368,1920,0,0
4449,1052,438,1245,991,38,15,9,193,553,369,1920,0,0
4450,1054,436,1248,989,38,15,9,194,553,370,1920,0,0
4451,1049,431,1245,992,38,15,9,196,561,371,1920,0,0
4452,1042,432,1240,992,38,15,9,198,560,372,1920,0,0
4453,1036,428,1237,997,38,15,9,201,569,373,1920,0,0
4454,1029,421,1234,997,38,15,9,205,576,374,1920,0,0
4455,1018,417,1221,987,38,15,9,203,570,375,1920,0,0
4456,1008,409,1210,975,38,15,9,202,566,376,1920,0,0
4457,996,395,1202,977,38,15,9,206,582,377,1920,0,0
4458,997,394,1201,967,38,15,9,204,573,378,1920,0,0
4459,991,391,1198,972,38,15,9,207,581,379,1920,0,0
4460,987,389,1191,976,38,15,9,204,587,380,1920,0,0
4461,997,397,1198,979,38,15,9,201,582,381,1920,0,0
4462,1007,404,1205,977,38,15,9,198,573,382,1920,0,0
4463,1010,408,1205,976,38,15,9,195,568,383,1920,0,0
4464,1017,410,1208,972,38,15,9,191,562,384,1920,0,0
4465,1017,411,1205,972,38,15,9,188,561,385,1920,0,0
4466,1021,418,1205,969,38,15,9,184,551,386,1920,0,0
4467,1024,425,1207,974,38,15,9,183,549,387,1920,0,0
4468,1027,426,1208,968,38,15,9,181,542,388,1920,0,0
4469,1028,424,1208,965,38,15,9,180,541,389,1920,0,0
4470,1029,419,1210,971,38,15,9,181,552,390,1920,0,0
4471,1032,426,1208,965,38,15,9,176,539,391,1920,0,0
4472,1031,431,1206,969,38,15,9,175,538,392,1920,0,0
4473,1031,437,1202,965,38,15,9,171,528,393,1920,0,0
4474,1030,436,1201,965,38,15,9,171,529,394,1920,0,0
4475,1030,435,1200,966,38,15,9,170,531,395,1920,0,0
4476,1032,431,1201,963,38,15,9,169,532,396,1920,0,0
4477,1034,427,1202,962,38,15,9,168,535,397,1920,0,0
4478,1034,423,1204,962,38,15,9,170,539,398,1920,0,0
4479,1036,419,1206,963,38,15,9,170,544,399,1920,0,0
4480,1030,421,1202,967,38,15,9,172,546,400,1920,0,0
4481,1024,422,1202,985,38,15,9,178,563,401,1920,0,0
4482,1019,421,1203,986,38,15,9,184,565,402,1920,0,0
4483,1010,419,1202,993,38,15,9,192,574,403,1920,0,0
4484,1005,423,1202,992,38,15,9,197,569,404,1920,0,0
4485,999,423,1205,1006,38,15,9,206,583,405,1920,0,0
4486,999,432,1206,1005,38,15,9,207,573,406,1920,0,0
4487,993,433,1203,1012,38,15,9,210,579,407,1920,0,0
4488,994,442,1208,1022,38,15,9,214,580,408,1920,0,0
4489,990,451,1213,1045,38,15,9,223,594,409,1920,0,0
4490,981,456,1211,1063,38,15,9,230,607,410,1920,0,0
4491,990,457,1226,1073,38,15,9,236,616,411,1920,0,0
4492,1016,465,1252,1077,38,15,9,236,612,412,1920,0,0
4493,1041,478,1273,1076,38,15,9,232,598,413,1920,0,0
4494,1059,484,1289,1076,38,15,9,230,592,414,1920,0,0
4495,1065,492,1294,1076,38,15,9,229,584,415,1920,0,0
4496,1068,501,1294,1078,38,15,9,226,577,416,1920,0,0
4497,1061,504,1287,1076,38,15,9,226,572,417,1920,0,0
4498,1051,507,1279,1075,38,15,9,228,568,418,1920,0,0
4499,1038,512,1268,1074,38,15,9,230,562,419,1920,0,0
4500,1034,520,1263,1074,38,15,9,229,554,420,1920,0,0
4501,1036,530,1263,1072,38,15,9,227,542,421,1920,0,0
4502,1036,542,1260,1071,38,15,9,224,529,422,1920,0,0
4503,1044,559,1260,1064,38,15,9,216,505,423,1920,0,0
4504,1042,556,1260,1066,38,15,9,218,510,424,1920,0,0
4505,1044,555,1263,1069,38,15,9,219,514,425,1920,0,0
4506,1051,549,1273,1072,38,15,9,222,523,426,1920,0,0
4507,1049,534,1276,1071,38,15,9,227,537,427,1920,0,0
4508,1043,523,1275,1069,38,15,9,232,546,428,1920,0,0
4509,1045,519,1280,1068,38,15,9,235,549,429,1920,0,0
4510,1045,517,1283,1070,38,15,9,238,553,430,1920,0,0
4511,1023,513,1266,1072,38,15,9,243,559,431,1920,0,0
4512,1012,496,1261,1067,38,15,9,249,571,432,1920,0,0
4513,1003,493,1250,1066,38,15,9,247,573,433,1920,0,0
4514,978,476,1230,1067,38,15,9,252,591,434,1920,0,0
4515,950,462,1205,1064,38,15,9,255,602,435,1920,0,0
4516,931,450,1189,1062,38,15,9,258,612,436,1920,0,0
4517,933,446,1192,1057,38,15,9,259,611,437,1920,0,0
4518,946,431,1199,1030,38,15,9,253,599,438,1920,0,0
4519,974,434,1211,997,38,15,9,237,563,439,1920,0,0
4520,992,428,1227,996,38,15,9,235,568,440,1920,0,0
4521,1004,427,1235,990,38,15,9,231,563,441,1920,0,0
4522,1009,417,1237,981,38,15,9,228,564,442,1920,0,0
4523,1005,411,1229,977,38,15,9,224,566,443,1920,0,0
4524,999,403,1216,962,38,15,9,217,559,444,1920,0,0
4525,988,393,1206,959,38,15,9,218,566,445,1920,0,0
4526,991,397,1203,958,38,15,9,212,561,446,1920,0,0
4527,997,396,1207,962,38,15,9,210,566,447,1920,0,0
4528,1002,401,1208,965,38,15,9,206,564,448,1920,0,0
4529,1006,401,1206,957,38,15,9,200,556,449,1920,0,0
4530,1002,400,1203,964,38,15,9,201,564,450,1920,0,0
4531,993,395,1196,974,38,15,9,203,579,451,1920,0,0
4532,991,399,1191,978,38,15,9,200,579,452,1920,0,0
4533,996,406,1189,977,38,15,9,193,571,453,1920,0,0
4534,998,414,1190,985,38,15,9,192,571,454,1920,0,0
4535,1001,415,1187,978,38,15,9,186,563,455,1920,0,0
4536,1003,423,1185,979,38,15,9,182,556,456,1920,0,0
4537,1007,436,1186,983,38,15,9,179,547,457,1920,0,0
4538,1008,433,1184,979,38,15,9,176,546,458,1920,0,0
4539,1008,429,1185,987,38,15,9,177,558,459,1920,0,0
4540,1010,428,1187,984,38,15,9,177,556,460,1920,0,0
4541,1013,427,1191,979,38,15,9,178,552,461,1920,0,0
4542,1017,427,1198,975,38,15,9,181,548,462,1920,0,0
4543,1013,424,1199,984,38,15,9,186,560,463,1920,0,0
4544,1010,424,1198,985,38,15,9,188,561,464,1920,0,0
4545,1012,421,1205,982,38,15,9,193,561,465,1920,0,0
4546,1007,416,1206,985,38,15,9,199,569,466,1920,0,0
4547,997,415,1205,1006,38,15,9,208,591,467,1920,0,0
4548,987,419,1197,1012,38,15,9,210,593,468,1920,0,0
4549,973,419,1181,1006,38,15,9,208,587,469,1920,0,0
4550,960,427,1166,1008,38,15,9,206,581,470,1920,0,0
4551,951,430,1158,1011,38,15,9,207,581,471,1920,0,0
4552,941,427,1151,1013,38,15,9,210,586,472,1920,0,0
4553,937,427,1148,1012,38,15,9,211,585,473,1920,0,0
4554,940,431,1148,1011,38,15,9,208,580,474,1920,0,0
4555,944,431,1151,1010,38,15,9,207,579,475,1920,0,0
4556,942,428,1149,1009,38,15,9,207,581,476,1920,0,0
4557,939,430,1145,1011,38,15,9,206,581,477,1920,0,0
4558,939,432,1146,1012,38,15,9,207,580,478,1920,0,0
4559,940,432,1146,1008,38,15,9,206,576,479,1920,0,0
4560,944,430,1150,1008,38,15,9,206,578,480,1920,0,0
4561,949,430,1153,1004,38,15,9,204,574,481,1920,0,0
4562,954,431,1158,1006,38,15,9,204,575,482,1920,0,0
4563,962,429,1165,1002,38,15,9,203,573,483,1920,0,0
4564,970,428,1173,1007,38,15,9,203,579,484,1920,0,0
4565,980,432,1183,1009,38,15,9,203,577,485,1920,0,0
4566,995,436,1194,1007,38,15,9,199,571,486,1920,0,0
4567,1006,435,1210,1023,38,15,9,204,588,487,1920,0,0
4568,1014,435,1214,1023,38,15,9,200,588,488,1920,0,0
4569,1024,435,1221,1014,38,15,9,197,579,489,1920,0,0
4570,1030,425,1229,1007,38,15,9,199,582,490,1920,0,0
4571,1034,423,1237,1008,38,15,9,203,585,491,1920,0,0
4572,1040,431,1243,1012,38,15,9,203,581,492,1920,0,0
4573,1042,437,1244,1011,38,15,9,202,574,493,1920,0,0
4574,1042,440,1243,1010,38,15,9,201,570,494,1920,0,0
4575,1043,435,1247,1010,38,15,9,204,575,495,1920,0,0
4576,1044,435,1248,1009,38,15,9,204,574,496,1920,0,0
4577,1045,436,1251,1011,38,15,9,206,575,497,1920,0,0
4578,1046,438,1253,1011,38,15,9,207,573,498,1920,0,0
4579,1045,449,1249,1012,38,15,9,204,563,499,1920,0,0
4580,1047,450,1253,1016,38,15,9,206,566,500,1920,0,0
4581,1046,446,1254,1014,38,15,9,208,568,501,1920,0,0
4582,1047,443,1255,1013,38,15,9,208,570,502,1920,0,0
4583,1047,448,1257,1018,38,15,9,210,570,503,1920,0,0
4584,1047,444,1258,1015,38,15,9,211,571,504,1920,0,0
4585,1046,452,1255,1014,38,15,9,209,562,505,1920,0,0
4586,1050,446,1259,1011,38,15,9,209,565,506,1920,0,0
4587,1052,446,1260,1009,38,15,9,208,563,507,1920,0,0
4588,1039,439,1252,1013,38,15,9,213,574,508,1920,0,0
4589,1011,431,1229,1009,38,15,9,218,578,509,1920,0,0
4590,988,432,1209,1013,38,15,9,221,581,510,1920,0,0
4591,964,421,1189,1017,38,15,9,225,596,511,1920,0,0
4592,944,414,1165,1006,38,15,9,221,592,512,1920,0,0
4593,932,410,1148,993,38,15,9,216,583,513,1920,0,0
4594,929,409,1141,981,38,15,9,212,572,514,1920,0,0
4595,931,405,1141,978,38,15,9,210,573,515,1920,0,0
4596,940,409,1146,977,38,15,9,206,568,516,1920,0,0
4597,954,409,1157,966,38,15,9,203,557,517,1920,0,0
4598,972,407,1172,956,38,15,9,200,549,518,1920,0,0
4599,989,414,1180,938,38,15,9,191,524,519,1920,0,0
4600,1000,413,1191,936,38,15,9,191,523,520,1920,0,0
4601,1002,414,1193,935,38,15,9,191,521,521,1920,0,0
4602,1001,414,1193,938,38,15,9,192,524,522,1920,0,0
4603,1002,414,1197,946,38,15,9,195,532,523,1920,0,0
4604,1002,413,1198,950,38,15,9,196,537,524,1920,0,0
4605,1000,414,1197,951,38,15,9,197,537,525,1920,0,0
4606,1000,414,1196,948,38,15,9,196,534,526,1920,0,0
4607,1001,413,1197,945,38,15,9,196,532,527,1920,0,0
4608,1000,415,1193,943,38,15,9,193,528,528,1920,0,0
4609,999,415,1193,943,38,15,9,194,528,529,1920,0,0
4610,1001,414,1197,948,38,15,9,196,534,530,1920,0,0
4611,1000,414,1194,945,38,15,9,194,531,531,1920,0,0
4612,1000,414,1194,944,38,15,9,194,530,532,1920,0,0
4613,999,414,1192,940,38,15,9,193,526,533,1920,0,0
4614,999,414,1191,939,38,15,9,192,525,534,1920,0,0
4615,999,414,1192,942,38,15,9,193,528,535,1920,0,0
4616,1002,415,1197,946,38,15,9,195,531,536,1920,0,0
4617,1000,411,1199,950,38,15,9,199,539,537,1920,0,0
4618,1001,412,1199,950,38,15,9,198,538,538,1920,0,0
4619,1003,413,1202,952,38,15,9,199,539,539,1920,0,0
4620,1003,416,1202,952,38,15,9,199,536,540,1920,0,0
4621,1002,416,1202,951,38,15,9,200,535,541,1920,0,0
4622,1002,419,1201,949,38,15,9,199,530,542,1920,0,0
4623,1001,417,1201,949,38,15,9,200,532,543,1920,0,0
4624,1001,417,1201,948,38,15,9,200,531,544,1920,0,0
4625,999,416,1200,950,38,15,9,201,534,545,1920,0,0
4626,997,417,1195,945,38,15,9,198,528,546,1920,0,0
4627,994,411,1198,953,38,15,9,204,542,547,1920,0,0
4628,996,409,1200,953,38,15,9,204,544,548,1920,0,0
4629,999,409,1202,954,38,15,9,203,545,549,1920,0,0
4630,999,409,1203,955,38,15,9,204,546,550,1920,0,0
4631,1001,411,1204,958,38,15,9,203,547,551,1920,0,0
4632,1002,411,1205,956,38,15,9,203,545,552,1920,0,0
4633,1002,411,1205,955,38,15,9,203,544,553,1920,0,0
4634,1005,420,1203,948,38,15,9,198,528,554,1920,0,0
4635,1004,419,1203,945,38,15,9,199,526,555,1920,0,0
4636,1002,419,1202,946,38,15,9,200,527,556,1920,0,0
4637,994,409,1200,955,38,15,9,206,546,557,1920,0,0
4638,991,406,1195,954,38,15,9,204,548,558,1920,0,0
4639,991,401,1187,941,38,15,9,196,540,559,1920,0,0
4640,989,394,1184,946,38,15,9,195,552,560,1920,0,0
4641,986,399,1173,940,38,15,9,187,541,561,1920,0,0
4642,985,401,1169,945,38,15,9,184,544,562,1920,0,0
4643,989,406,1178,955,38,15,9,189,549,563,1920,0,0
4644,992,409,1184,954,38,15,9,192,545,564,1920,0,0
4645,978,407,1171,955,38,15,9,193,548,565,1920,0,0
4646,966,405,1156,946,38,15,9,190,541,566,1920,0,0
4647,951,400,1142,947,38,15,9,191,547,567,1920,0,0
4648,944,401,1136,951,38,15,9,192,550,568,1920,0,0
4649,939,404,1135,961,38,15,9,196,557,569,1920,0,0
4650,937,408,1135,966,38,15,9,198,558,570,1920,0,0
4651,936,408,1134,965,38,15,9,198,557,571,1920,0,0
4652,935,408,1137,966,38,15,9,202,558,572,1920,0,0
4653,929,406,1131,965,38,15,9,202,559,573,1920,0,0
4654,928,406,1127,962,38,15,9,199,556,574,1920,0,0
4655,935,410,1134,965,38,15,9,199,555,575,1920,0,0
4656,945,422,1143,974,38,15,9,198,552,576,1920,0,0
4657,951,423,1150,977,38,15,9,199,554,577,1920,0,0
4658,964,422,1165,977,38,15,9,201,555,578,1920,0,0
4659,978,427,1177,978,38,15,9,199,551,579,1920,0,0
4660,986,425,1186,972,38,15,9,200,547,580,1920,0,0
4661,1013,424,1213,968,38,15,9,200,544,581,1920,0,0
4662,1022,435,1224,986,38,15,9,202,551,582,1920,0,0
4663,1015,433,1222,1001,38,15,9,207,568,583,1920,0,0
4664,1012,431,1216,1002,38,15,9,204,571,584,1920,0,0
4665,1008,434,1209,1000,38,15,9,201,566,585,1920,0,0
4666,1005,432,1209,1011,38,15,9,204,579,586,1920,0,0
4667,1001,430,1206,1011,38,15,9,205,581,587,1920,0,0
4668,1000,432,1202,1005,38,15,9,202,573,588,1920,0,0
4669,998,432,1199,1010,38,15,9,201,578,589,1920,0,0
4670,993,426,1192,1004,38,15,9,199,578,590,1920,0,0
4671,986,415,1189,1007,38,15,9,203,592,591,1920,0,0
4672,977,407,1175,997,38,15,9,198,590,592,1920,0,0
4673,976,395,1167,971,38,15,9,191,576,593,1920,0,0
4674,974,392,1155,947,38,15,9,181,555,594,1920,0,0
4675,972,389,1150,943,38,15,9,178,554,595,1920,0,0
4676,969,392,1144,938,38,15,9,175,546,596,1920,0,0
4677,967,392,1139,932,38,15,9,172,540,597,1920,0,0
4678,968,390,1142,939,38,15,9,174,549,598,1920,0,0
4679,964,394,1142,959,38,15,9,178,565,599,1920,0,0
4680,961,401,1142,977,38,15,9,181,576,600,1920,0,0
4681,959,407,1139,984,38,15,9,180,577,601,1920,0,0
4682,960,412,1139,987,38,15,9,179,575,602,1920,0,0
4683,960,422,1134,981,38,15,9,174,559,603,1920,0,0
4684,961,420,1132,979,38,15,9,171,559,604,1920,0,0
4685,959,423,1129,979,38,15,9,170,556,605,1920,0,0
4686,958,423,1128,980,38,15,9,170,557,606,1920,0,0
4687,962,419,1132,979,38,15,9,170,560,607,1920,0,0
4688,963,409,1138,977,38,15,9,175,568,608,1920,0,0
4689,966,402,1141,972,38,15,9,175,570,609,1920,0,0
4690,976,397,1150,960,38,15,9,174,563,610,1920,0,0
4691,987,395,1157,951,38,15,9,170,556,611,1920,0,0
4692,989,393,1157,944,38,15,9,168,551,612,1920,0,0
4693,992,386,1158,944,38,15,9,166,558,613,1920,0,0
4694,992,392,1153,937,38,15,9,161,545,614,1920,0,0
4695,991,394,1149,934,38,15,9,158,540,615,1920,0,0
4696,989,392,1151,943,38,15,9,162,551,616,1920,0,0
4697,988,392,1148,938,38,15,9,160,546,617,1920,0,0
4698,988,393,1147,938,38,15,9,159,545,618,1920,0,0
4699,990,394,1147,935,38,15,9,157,541,619,1920,0,0
4700,991,394,1147,935,38,15,9,156,541,620,1920,0,0
4701,993,394,1150,939,38,15,9,157,545,621,1920,0,0
4702,994,394,1151,942,38,15,9,157,548,622,1920,0,0
4703,994,395,1150,943,38,15,9,156,548,623,1920,0,0
4704,993,396,1147,938,38,15,9,154,542,624,1920,0,0
4705,993,396,1147,938,38,15,9,154,542,625,1920,0,0
4706,994,397,1148,939,38,15,9,154,542,626,1920,0,0
4707,994,396,1150,943,38,15,9,156,547,627,1920,0,0
4708,999,396,1156,950,38,15,9,157,554,628,1920,0,0
4709,1001,396,1161,964,38,15,9,160,568,629,1920,0,0
4710,1001,400,1161,970,38,15,9,160,570,630,1920,0,0
4711,1011,411,1172,982,38,15,9,161,571,631,1920,0,0
4712,1013,413,1172,978,38,15,9,159,565,632,1920,0,0
4713,1017,419,1179,986,38,15,9,162,567,633,1920,0,0
4714,1018,425,1181,986,38,15,9,163,561,634,1920,0,0
4715,1018,433,1180,985,38,15,9,162,552,635,1920,0,0
4716,1019,440,1181,985,38,15,9,162,545,636,1920,0,0
4717,1022,443,1183,981,38,15,9,161,538,637,1920,0,0
4718,1023,444,1184,976,38,15,9,161,532,638,1920,0,0
4719,1020,441,1183,978,38,15,9,163,537,639,1920,0,0
4720,1020,436,1184,974,38,15,9,164,538,640,1920,0,0
4721,1016,429,1181,977,38,15,9,165,548,641,1920,0,0
4722,1012,416,1178,973,38,15,9,166,557,642,1920,0,0
4723,1007,411,1177,985,38,15,9,170,574,643,1920,0,0
4724,1001,404,1172,990,38,15,9,171,586,644,1920,0,0
4725,999,402,1167,979,38,15,9,168,577,645,1920,0,0
4726,1007,401,1179,982,38,15,9,172,581,646,1920,0,0
4727,1009,398,1182,970,38,15,9,173,572,647,1920,0,0
4728,1008,396,1185,971,38,15,9,177,575,648,1920,0,0
4729,993,400,1173,979,38,15,9,180,579,649,1920,0,0
4730,985,401,1162,976,38,15,9,177,575,650,1920,0,0
4731,979,403,1155,977,38,15,9,176,574,651,1920,0,0
4732,978,407,1154,981,38,15,9,176,574,652,1920,0,0
4733,977,419,1151,979,38,15,9,174,560,653,1920,0,0
4734,978,424,1151,978,38,15,9,173,554,654,1920,0,0
4735,983,427,1158,984,38,15,9,175,557,655,1920,0,0
4736,986,429,1166,994,38,15,9,180,565,656,1920,0,0
4737,987,429,1173,1006,38,15,9,186,577,657,1920,0,0
4738,997,433,1185,1007,38,15,9,188,574,658,1920,0,0
4739,1014,439,1202,1006,38,15,9,188,567,659,1920,0,0
4740,1025,440,1217,1009,38,15,9,192,569,660,1920,0,0
4741,1044,452,1233,1006,38,15,9,189,554,661,1920,0,0
4742,1056,451,1253,1028,38,15,9,197,577,662,1920,0,0
4743,1061,456,1264,1051,38,15,9,203,595,663,1920,0,0
4744,1059,462,1265,1062,38,15,9,206,600,664,1920,0,0
4745,1056,465,1266,1072,38,15,9,210,607,665,1920,0,0
4746,1043,461,1259,1077,38,15,9,216,616,666,1920,0,0
4747,1036,463,1253,1074,38,15,9,217,611,667,1920,0,0
4748,1035,469,1254,1075,38,15,9,219,606,668,1920,0,0
4749,1040,472,1263,1075,38,15,9,223,603,669,1920,0,0
4750,1050,479,1273,1073,38,15,9,223,594,670,1920,0,0
4751,1062,493,1286,1075,38,15,9,224,582,671,1920,0,0
4752,1069,500,1293,1071,38,15,9,224,571,672,1920,0,0
4753,1071,499,1297,1066,38,15,9,226,567,673,1920,0,0
4754,1074,507,1301,1070,38,15,9,227,563,674,1920,0,0
4755,1077,506,1306,1074,38,15,9,229,568,675,1920,0,0
4756,1084,496,1312,1070,38,15,9,228,574,676,1920,0,0
4757,1078,484,1309,1074,38,15,9,231,590,677,1920,0,0
4758,1074,479,1302,1071,38,15,9,228,592,678,1920,0,0
4759,1066,469,1297,1074,38,15,9,231,605,679,1920,0,0
4760,1048,466,1282,1073,38,15,9,234,607,680,1920,0,0
4761,1020,459,1257,1065,38,15,9,237,606,681,1920,0,0
4762,1015,455,1253,1063,38,15,9,238,608,682,1920,0,0
4763,1012,461,1245,1054,38,15,9,233,593,683,1920,0,0
4764,989,445,1223,1049,38,15,9,234,604,684,1920,0,0
4765,968,428,1200,1034,38,15,9,232,606,685,1920,0,0
4766,954,420,1179,1012,38,15,9,225,592,686,1920,0,0
4767,944,411,1169,1006,38,15,9,225,595,687,1920,0,0
4768,944,407,1169,1002,38,15,9,225,595,688,1920,0,0
4769,956,404,1182,995,38,15,9,226,591,689,1920,0,0
4770,959,393,1180,975,38,15,9,221,582,690,1920,0,0
4771,969,391,1179,947,38,15,9,210,556,691,1920,0,0
4772,979,387,1181,923,38,15,9,202,536,692,1920,0,0
4773,981,384,1182,924,38,15,9,201,540,693,1920,0,0
4774,979,384,1178,923,38,15,9,199,539,694,1920,0,0
4775,972,376,1166,917,38,15,9,194,541,695,1920,0,0
4776,966,376,1152,906,38,15,9,186,530,696,1920,0,0
4777,958,376,1144,915,38,15,9,186,539,697,1920,0,0
4778,953,380,1137,922,38,15,9,184,542,698,1920,0,0
4779,951,379,1135,933,38,15,9,184,554,699,1920,0,0
4780,951,384,1134,940,38,15,9,183,556,700,1920,0,0
4781,954,392,1133,942,38,15,9,179,550,701,1920,0,0
4782,955,400,1128,939,38,15,9,173,539,702,1920,0,0
4783,958,398,1129,939,38,15,9,171,541,703,1920,0,0
4784,962,399,1132,943,38,15,9,170,544,704,1920,0,0
4785,965,399,1134,948,38,15,9,169,549,705,1920,0,0
4786,967,399,1134,946,38,15,9,167,547,706,1920,0,0
4787,968,399,1133,946,38,15,9,165,547,707,1920,0,0
4788,972,406,1135,948,38,15,9,163,542,708,1920,0,0
4789,972,407,1134,942,38,15,9,162,535,709,1920,0,0
4790,978,410,1142,947,38,15,9,164,537,710,1920,0,0
4791,983,409,1152,950,38,15,9,169,541,711,1920,0,0
4792,982,409,1155,952,38,15,9,173,543,712,1920,0,0
4793,983,406,1160,949,38,15,9,177,543,713,1920,0,0
4794,979,402,1159,947,38,15,9,180,545,714,1920,0,0
4795,990,402,1174,950,38,15,9,184,548,715,1920,0,0
4796,1000,410,1184,947,38,15,9,184,537,716,1920,0,0
4797,1001,405,1191,953,38,15,9,190,548,717,1920,0,0
4798,999,410,1193,966,38,15,9,194,556,718,1920,0,0
4799,994,409,1190,976,38,15,9,196,567,719,1920,0,0
4800,991,415,1186,976,38,15,9,195,561,720,1920,0,0
4801,985,414,1183,985,38,15,9,198,571,721,1920,0,0
4802,979,418,1177,993,38,15,9,198,575,722,1920,0,0
4803,975,421,1174,996,38,15,9,199,575,723,1920,0,0
4804,970,425,1168,992,38,15,9,198,567,724,1920,0,0
4805,973,432,1165,987,38,15,9,192,555,725,1920,0,0
4806,980,437,1169,986,38,15,9,189,549,726,1920,0,0
4807,985,437,1174,985,38,15,9,189,548,727,1920,0,0
4808,982,437,1172,986,38,15,9,190,549,728,1920,0,0
4809,987,437,1179,986,38,15,9,192,549,729,1920,0,0
4810,981,439,1172,985,38,15,9,191,546,730,1920,0,0
4811,980,440,1171,988,38,15,9,191,548,731,1920,0,0
4812,985,440,1176,988,38,15,9,191,548,732,1920,0,0
4813,978,433,1169,985,38,15,9,191,552,733,1920,0,0
4814,995,437,1190,985,38,15,9,195,548,734,1920,0,0
4815,994,438,1192,986,38,15,9,198,548,735,1920,0,0
4816,989,437,1188,985,38,15,9,199,548,736,1920,0,0
4817,977,436,1174,987,38,15,9,197,551,737,1920,0,0
4818,980,431,1178,988,38,15,9,198,557,738,1920,0,0
4819,977,422,1177,995,38,15,9,200,573,739,1920,0,0
4820,979,413,1176,985,38,15,9,197,572,740,1920,0,0
4821,979,403,1174,981,38,15,9,195,578,741,1920,0,0
4822,987,400,1177,976,38,15,9,190,576,742,1920,0,0
4823,995,394,1182,972,38,15,9,187,578,743,1920,0,0
4824,1004,391,1188,967,38,15,9,184,576,744,1920,0,0
4825,1008,394,1189,968,38,15,9,181,574,745,1920,0,0
4826,1012,394,1189,967,38,15,9,177,573,746,1920,0,0
4827,1016,394,1192,968,38,15,9,176,574,747,1920,0,0
4828,1016,400,1192,971,38,15,9,176,571,748,1920,0,0
4829,1018,404,1195,975,38,15,9,177,571,749,1920,0,0
4830,1020,409,1195,970,38,15,9,175,561,750,1920,0,0
4831,1024,413,1199,975,38,15,9,175,562,751,1920,0,0
4832,1026,415,1200,976,38,15,9,174,561,752,1920,0,0
4833,1027,420,1199,973,38,15,9,172,553,753,1920,0,0
4834,1027,423,1197,967,38,15,9,170,544,754,1920,0,0
4835,1028,423,1199,972,38,15,9,171,549,755,1920,0,0
4836,1027,426,1197,970,38,15,9,170,544,756,1920,0,0
4837,1027,428,1196,969,38,15,9,169,541,757,1920,0,0
4838,1027,430,1195,968,38,15,9,168,538,758,1920,0,0
4839,1026,429,1194,968,38,15,9,168,539,759,1920,0,0
4840,1027,426,1196,965,38,15,9,169,539,760,1920,0,0
4841,1027,422,1199,973,38,15,9,172,551,761,1920,0,0
4842,1026,427,1196,967,38,15,9,170,540,762,1920,0,0
4843,1026,429,1195,964,38,15,9,169,535,763,1920,0,0
4844,1025,432,1194,969,38,15,9,169,537,764,1920,0,0
4845,1023,433,1193,970,38,15,9,170,537,765,1920,0,0
4846,1023,433,1193,968,38,15,9,170,535,766,1920,0,0
4847,1023,432,1192,964,38,15,9,169,532,767,1920,0,0
4848,1023,432,1193,966,38,15,9,170,534,768,1920,0,0
4849,1022,433,1193,967,38,15,9,171,534,769,1920,0,0
4850,1021,433,1192,967,38,15,9,171,534,770,1920,0,0
4851,1020,433,1193,972,38,15,9,173,539,771,1920,0,0
4852,1021,433,1194,974,38,15,9,173,541,772,1920,0,0
4853,1022,430,1197,975,38,15,9,175,545,773,1920,0,0
4854,1023,431,1197,970,38,15,9,174,539,774,1920,0,0
4855,1022,430,1196,968,38,15,9,174,538,775,1920,0,0
4856,1021,424,1197,968,38,15,9,176,544,776,1920,0,0
4857,1015,409,1198,975,38,15,9,183,566,777,1920,0,0
4858,1007,399,1193,978,38,15,9,186,579,778,1920,0,0
4859,1001,394,1182,968,38,15,9,181,574,779,1920,0,0
4860,988,389,1168,964,38,15,9,180,575,780,1920,0,0
4861,985,385,1163,960,38,15,9,178,575,781,1920,0,0
4862,986,381,1162,958,38,15,9,176,577,782,1920,0,0
4863,985,377,1156,949,38,15,9,171,572,783,1920,0,0
4864,984,377,1152,948,38,15,9,168,571,784,1920,0,0
4865,982,379,1149,947,38,15,9,167,568,785,1920,0,0
4866,981,377,1148,951,38,15,9,167,574,786,1920,0,0
4867,985,381,1148,943,38,15,9,163,562,787,1920,0,0
4868,987,386,1148,939,38,15,9,161,553,788,1920,0,0
4869,993,387,1153,944,38,15,9,160,557,789,1920,0,0
4870,1001,394,1163,955,38,15,9,162,561,790,1920,0,0
4871,1007,394,1169,955,38,15,9,162,561,791,1920,0,0
4872,1012,399,1176,963,38,15,9,164,564,792,1920,0,0
4873,1017,403,1179,960,38,15,9,162,557,793,1920,0,0
4874,1020,412,1183,967,38,15,9,163,555,794,1920,0,0
4875,1027,416,1188,958,38,15,9,161,542,795,1920,0,0
4876,1028,424,1188,952,38,15,9,160,528,796,1920,0,0
4877,1027,420,1189,953,38,15,9,162,533,797,1920,0,0
4878,1026,415,1192,960,38,15,9,166,545,798,1920,0,0
4879,1023,410,1191,961,38,15,9,168,551,799,1920,0,0
4880,1018,408,1188,966,38,15,9,170,558,800,1920,0,0
4881,1014,404,1185,967,38,15,9,171,563,801,1920,0,0
4882,1005,398,1177,967,38,15,9,172,569,802,1920,0,0
4883,998,397,1167,962,38,15,9,169,565,803,1920,0,0
4884,999,398,1163,952,38,15,9,164,554,804,1920,0,0
4885,1003,399,1164,944,38,15,9,161,545,805,1920,0,0
4886,1001,398,1164,955,38,15,9,163,557,806,1920,0,0
4887,999,397,1164,964,38,15,9,165,567,807,1920,0,0
4888,998,396,1162,965,38,15,9,164,569,808,1920,0,0
4889,999,401,1162,967,38,15,9,163,566,809,1920,0,0
4890,1000,409,1164,975,38,15,9,164,566,810,1920,0,0
4891,1002,413,1167,979,38,15,9,165,566,811,1920,0,0
4892,1007,412,1172,978,38,15,9,165,566,812,1920,0,0
4893,1008,416,1172,976,38,15,9,164,560,813,1920,0,0
4894,1012,422,1174,975,38,15,9,162,553,814,1920,0,0
4895,1011,422,1174,976,38,15,9,163,554,815,1920,0,0
4896,1009,422,1173,978,38,15,9,164,556,816,1920,0,0
4897,1004,415,1174,985,38,15,9,170,570,817,1920,0,0
4898,1001,412,1173,983,38,15,9,172,571,818,1920,0,0
4899,1000,410,1175,980,38,15,9,175,570,819,1920,0,0
4900,997,412,1175,986,38,15,9,178,574,820,1920,0,0
4901,995,402,1177,978,38,15,9,182,576,821,1920,0,0
4902,982,402,1161,960,38,15,9,179,558,822,1920,0,0
4903,969,402,1148,952,38,15,9,179,550,823,1920,0,0
4904,955,401,1140,954,38,15,9,185,553,824,1920,0,0
4905,942,401,1131,957,38,15,9,189,556,825,1920,0,0
4906,928,404,1119,957,38,15,9,191,553,826,1920,0,0
4907,910,402,1103,961,38,15,9,193,559,827,1920,0,0
4908,900,407,1092,958,38,15,9,192,551,828,1920,0,0
4909,900,416,1092,954,38,15,9,192,538,829,1920,0,0
4910,907,417,1109,965,38,15,9,202,548,830,1920,0,0
4911,922,419,1123,964,38,15,9,201,545,831,1920,0,0
4912,942,421,1143,968,38,15,9,201,547,832,1920,0,0
4913,969,413,1172,982,38,15,9,203,569,833,1920,0,0
4914,994,414,1196,987,38,15,9,202,573,834,1920,0,0
4915,1004,416,1204,991,38,15,9,200,575,835,1920,0,0
4916,1010,423,1210,998,38,15,9,200,575,836,1920,0,0
4917,1016,426,1217,1003,38,15,9,201,577,837,1920,0,0
4918,1026,434,1227,1009,38,15,9,201,575,838,1920,0,0
4919,1032,427,1234,1008,38,15,9,202,581,839,1920,0,0
4920,1037,427,1240,1011,38,15,9,203,584,840,1920,0,0
4921,1038,424,1243,1014,38,15,9,205,590,841,1920,0,0
4922,1038,421,1242,1007,38,15,9,204,586,842,1920,0,0
4923,1033,428,1235,1003,38,15,9,202,575,843,1920,0,0
4924,1032,421,1236,998,38,15,9,204,577,844,1920,0,0
4925,1030,417,1238,1000,38,15,9,208,583,845,1920,0,0
4926,1026,423,1232,1005,38,15,9,206,582,846,1920,0,0
4927,1023,423,1227,1007,38,15,9,204,584,847,1920,0,0
4928,1015,418,1218,1004,38,15,9,203,586,848,1920,0,0
4929,1001,404,1205,999,38,15,9,204,595,849,1920,0,0
4930,989,395,1194,993,38,15,9,205,598,850,1920,0,0
4931,986,389,1191,992,38,15,9,205,603,851,1920,0,0
4932,984,388,1186,988,38,15,9,202,600,852,1920,0,0
4933,986,385,1189,990,38,15,9,203,605,853,1920,0,0
4934,990,385,1192,991,38,15,9,202,606,854,1920,0,0
4935,991,385,1192,988,38,15,9,201,603,855,1920,0,0
4936,989,383,1189,987,38,15,9,200,604,856,1920,0,0
4937,990,383,1189,988,38,15,9,199,605,857,1920,0,0
4938,989,382,1188,989,38,15,9,199,607,858,1920,0,0
4939,990,382,1187,990,38,15,9,197,608,859,1920,0,0
4940,991,386,1183,985,38,15,9,192,599,860,1920,0,0
4941,993,385,1185,988,38,15,9,192,603,861,1920,0,0
4942,993,386,1185,989,38,15,9,192,603,862,1920,0,0
4943,992,389,1181,986,38,15,9,189,597,863,1920,0,0
4944,992,390,1180,985,38,15,9,188,595,864,1920,0,0
4945,992,391,1180,985,38,15,9,188,594,865,1920,0,0
4946,992,391,1178,984,38,15,9,186,593,866,1920,0,0
4947,991,390,1177,984,38,15,9,186,594,867,1920,0,0
4948,992,389,1180,989,38,15,9,188,600,868,1920,0,0
4949,993,389,1181,991,38,15,9,188,602,869,1920,0,0
4950,993,388,1182,991,38,15,9,189,603,870,1920,0,0
4951,993,387,1182,991,38,15,9,189,604,871,1920,0,0
4952,993,388,1181,991,38,15,9,188,603,872,1920,0,0
4953,991,388,1179,991,38,15,9,188,603,873,1920,0,0
4954,992,388,1178,990,38,15,9,186,602,874,1920,0,0
4955,992,388,1179,990,38,15,9,187,602,875,1920,0,0
4956,991,386,1178,991,38,15,9,187,605,876,1920,0,0
4957,991,385,1178,992,38,15,9,187,607,877,1920,0,0
4958,991,385,1177,992,38,15,9,186,607,878,1920,0,0
4959,992,385,1177,992,38,15,9,185,607,879,1920,0,0
4960,992,385,1178,992,38,15,9,186,607,880,1920,0,0
4961,993,386,1178,991,38,15,9,185,605,881,1920,0,0
4962,993,387,1178,990,38,15,9,185,603,882,1920,0,0
4963,993,387,1178,990,38,15,9,185,603,883,1920,0,0
4964,994,387,1178,991,38,15,9,184,604,884,1920,0,0
4965,994,391,1175,986,38,15,9,181,595,885,1920,0,0
4966,993,389,1175,988,38,15,9,182,599,886,1920,0,0
4967,994,390,1176,988,38,15,9,182,598,887,1920,0,0
4968,994,389,1175,985,38,15,9,181,596,888,1920,0,0
4969,993,388,1175,984,38,15,9,182,596,889,1920,0,0
4970,994,387,1175,984,38,15,9,181,597,890,1920,0,0
4971,993,385,1177,990,38,15,9,184,605,891,1920,0,0
4972,993,386,1177,990,38,15,9,184,604,892,1920,0,0
4973,994,388,1176,989,38,15,9,182,601,893,1920,0,0
4974,993,390,1175,988,38,15,9,182,598,894,1920,0,0
4975,994,389,1176,987,38,15,9,182,598,895,1920,0,0
4976,995,390,1176,987,38,15,9,181,597,896,1920,0,0
4977,997,393,1174,980,38,15,9,177,587,897,1920,0,0
4978,999,393,1177,985,38,15,9,178,592,898,1920,0,0
4979,999,393,1176,982,38,15,9,177,589,899,1920,0,0
4980,999,392,1176,980,38,15,9,177,588,900,1920,0,0
4981,996,390,1174,980,38,15,9,178,590,901,1920,0,0
4982,997,391,1174,979,38,15,9,177,588,902,1920,0,0
4983,996,393,1174,980,38,15,9,178,587,903,1920,0,0
4984,994,398,1166,964,38,15,9,172,566,904,1920,0,0
4985,991,402,1157,945,38,15,9,166,543,905,1920,0,0
4986,984,404,1151,947,38,15,9,167,543,906,1920,0,0
4987,976,406,1148,958,38,15,9,172,552,907,1920,0,0
4988,976,409,1151,956,38,15,9,175,547,908,1920,0,0
4989,982,411,1166,962,38,15,9,184,551,909,1920,0,0
4990,986,413,1178,962,38,15,9,192,549,910,1920,0,0
4991,977,409,1176,961,38,15,9,199,552,911,1920,0,0
4992,964,407,1166,959,38,15,9,202,552,912,1920,0,0
4993,955,409,1160,960,38,15,9,205,551,913,1920,0,0
4994,952,408,1158,956,38,15,9,206,548,914,1920,0,0
4995,932,405,1134,955,38,15,9,202,550,915,1920,0,0
4996,928,404,1125,953,38,15,9,197,549,916,1920,0,0
4997,934,407,1127,954,38,15,9,193,547,917,1920,0,0
4998,931,411,1121,954,38,15,9,190,543,918,1920,0,0
4999,930,417,1116,955,38,15,9,186,538,919,1920,0,0
5000,936,417,1121,953,38,15,9,185,536,920,1920,0,0
5001,940,418,1122,951,38,15,9,182,533,921,1920,0,0
5002,939,417,1120,954,38,15,9,181,537,922,1920,0,0
5003,939,416,1119,955,38,15,9,180,539,923,1920,0,0
5004,942,413,1121,957,38,15,9,179,544,924,1920,0,0
5005,944,412,1123,963,38,15,9,179,551,925,1920,0,0
5006,947,409,1123,958,38,15,9,176,549,926,1920,0,0
5007,952,404,1130,963,38,15,9,178,559,927,1920,0,0
5008,958,400,1136,966,38,15,9,178,566,928,1920,0,0
5009,973,405,1150,964,38,15,9,177,559,929,1920,0,0
5010,983,399,1159,955,38,15,9,176,556,930,1920,0,0
5011,995,396,1172,960,38,15,9,177,564,931,1920,0,0
5012,1001,390,1182,966,38,15,9,181,576,932,1920,0,0
5013,1010,398,1192,965,38,15,9,182,567,933,1920,0,0
5014,1018,402,1202,972,38,15,9,184,570,934,1920,0,0
5015,1026,410,1209,973,38,15,9,183,563,935,1920,0,0
5016,1036,420,1218,969,38,15,9,182,549,936,1920,0,0
5017,1043,421,1227,972,38,15,9,184,551,937,1920,0,0
5018,1044,420,1234,982,38,15,9,190,562,938,1920,0,0
5019,1037,425,1227,974,38,15,9,190,549,939,1920,0,0
5020,1023,422,1217,975,38,15,9,194,553,940,1920,0,0
5021,1000,415,1204,987,38,15,9,204,572,941,1920,0,0
5022,986,412,1198,1000,38,15,9,212,588,942,1920,0,0
5023,977,415,1196,1007,38,15,9,219,592,943,1920,0,0
5024,950,417,1165,1003,38,15,9,215,586,944,1920,0,0
5025,924,416,1138,1001,38,15,9,214,585,945,1920,0,0
5026,915,420,1127,998,38,15,9,212,578,946,1920,0,0
5027,912,416,1123,996,38,15,9,211,580,947,1920,0,0
5028,915,410,1128,999,38,15,9,213,589,948,1920,0,0
5029,920,406,1131,991,38,15,9,211,585,949,1920,0,0
5030,937,404,1144,973,38,15,9,207,569,950,1920,0,0
5031,958,401,1158,949,38,15,9,200,548,951,1920,0,0
5032,977,396,1177,947,38,15,9,200,551,952,1920,0,0
5033,980,392,1178,946,38,15,9,198,554,953,1920,0,0
5034,983,392,1179,944,38,15,9,196,552,954,1920,0,0
5035,977,388,1171,939,38,15,9,194,551,955,1920,0,0
5036,972,384,1164,934,38,15,9,192,550,956,1920,0,0
5037,967,382,1152,921,38,15,9,185,539,957,1920,0,0
5038,963,378,1145,917,38,15,9,182,539,958,1920,0,0
5039,971,380,1144,900,38,15,9,173,520,959,1920,0,0
5040,977,381,1148,899,38,15,9,171,518,960,1920,0,0
5041,990,391,1172,934,38,15,9,182,543,961,1920,0,0
5042,989,395,1180,956,38,15,9,191,561,962,1920,0,0
5043,979,394,1169,955,38,15,9,190,561,963,1920,0,0
5044,974,399,1163,961,38,15,9,189,562,964,1920,0,0
5045,974,397,1163,964,38,15,9,189,567,965,1920,0,0
5046,984,400,1169,963,38,15,9,185,563,966,1920,0,0
5047,995,407,1181,973,38,15,9,186,566,967,1920,0,0
5048,1001,416,1183,973,38,15,9,182,557,968,1920,0,0
5049,1006,422,1188,975,38,15,9,182,553,969,1920,0,0
5050,1011,419,1193,970,38,15,9,182,551,970,1920,0,0
5051,1017,423,1200,965,38,15,9,183,542,971,1920,0,0
5052,1021,432,1205,962,38,15,9,184,530,972,1920,0,0
5053,1022,435,1210,963,38,15,9,188,528,973,1920,0,0
5054,1016,438,1207,968,38,15,9,191,530,974,1920,0,0
5055,1017,453,1209,971,38,15,9,192,518,975,1920,0,0
5056,1016,458,1210,967,38,15,9,194,509,976,1920,0,0
5057,1014,454,1213,964,38,15,9,199,510,977,1920,0,0
5058,1004,439,1210,964,38,15,9,206,525,978,1920,0,0
5059,1003,432,1212,959,38,15,9,209,527,979,1920,0,0
5060,1000,424,1215,964,38,15,9,215,540,980,1920,0,0
5061,1004,416,1224,968,38,15,9,220,552,981,1920,0,0
5062,1003,412,1226,974,38,15,9,223,562,982,1920,0,0
5063,1003,415,1221,968,38,15,9,218,553,983,1920,0,0
5064,1000,410,1218,967,38,15,9,218,557,984,1920,0,0
5065,1001,414,1219,972,38,15,9,218,558,985,1920,0,0
5066,1003,417,1218,967,38,15,9,215,550,986,1920,0,0
5067,1008,419,1221,965,38,15,9,213,546,987,1920,0,0
5068,1009,421,1220,960,38,15,9,211,539,988,1920,0,0
5069,1009,421,1220,959,38,15,9,211,538,989,1920,0,0
5070,1005,421,1218,964,38,15,9,213,543,990,1920,0,0
5071,1002,420,1218,970,38,15,9,216,550,991,1920,0,0
5072,999,420,1216,970,38,15,9,217,550,992,1920,0,0
5073,1000,419,1215,966,38,15,9,215,547,993,1920,0,0
5074,1000,418,1216,968,38,15,9,216,550,994,1920,0,0
5075,1002,420,1217,968,38,15,9,215,548,995,1920,0,0
5076,1001,421,1215,969,38,15,9,214,548,996,1920,0,0
5077,1003,419,1216,967,38,15,9,213,548,997,1920,0,0
5078,1007,422,1217,958,38,15,9,210,536,998,1920,0,0
5079,1010,424,1220,957,38,15,9,210,533,999,1920,0,0
5080,1004,420,1218,965,38,15,9,214,545,1000,1920,0,0
5081,999,416,1216,973,38,15,9,217,557,1001,1920,0,0
5082,1001,414,1217,971,38,15,9,216,557,1002,1920,0,0
5083,1009,420,1220,962,38,15,9,211,542,1003,1920,0,0
5084,1013,423,1222,957,38,15,9,209,534,1004,1920,0,0
5085,1014,424,1223,959,38,15,9,209,535,1005,1920,0,0
5086,1014,423,1223,958,38,15,9,209,535,1006,1920,0,0
5087,1015,429,1223,960,38,15,9,208,531,1007,1920,0,0
5088,1012,429,1220,958,38,15,9,208,529,1008,1920,0,0
5089,1009,426,1221,964,38,15,9,212,538,1009,1920,0,0
5090,1007,423,1221,968,38,15,9,214,545,1010,1920,0,0
5091,1007,422,1221,968,38,15,9,214,546,1011,1920,0,0
5092,1009,426,1221,963,38,15,9,212,537,1012,1920,0,0
5093,1008,422,1222,966,38,15,9,214,544,1013,1920,0,0
5094,1007,422,1222,967,38,15,9,215,545,1014,1920,0,0
5095,1006,420,1222,969,38,15,9,216,549,1015,1920,0,0
5096,1006,422,1222,972,38,15,9,216,550,1016,1920,0,0
5097,1007,427,1220,969,38,15,9,213,542,1017,1920,0,0
5098,1005,424,1220,971,38,15,9,215,547,1018,1920,0,0
5099,1006,426,1220,969,38,15,9,214,543,1019,1920,0,0
5100,1006,423,1221,969,38,15,9,215,546,1020,1920,0,0
5101,1006,426,1217,964,38,15,9,211,538,1021,1920,0,0
5102,1008,426,1219,964,38,15,9,211,538,1022,1920,0,0
5103,1008,427,1219,962,38,15,9,211,535,1023,1920,0,0
5104,1009,427,1219,962,38,15,9,210,535,1024,1920,0,0
5105,1007,428,1216,962,38,15,9,209,534,1025,1920,0,0
5106,1007,428,1215,960,38,15,9,208,532,1026,1920,0,0
5107,1009,426,1217,957,38,15,9,208,531,1027,1920,0,0
5108,1010,426,1218,957,38,15,9,208,531,1028,1920,0,0
5109,1008,427,1216,960,38,15,9,208,533,1029,1920,0,0
5110,1008,427,1216,962,38,15,9,208,535,1030,1920,0,0
5111,1007,427,1215,963,38,15,9,208,536,1031,1920,0,0
5112,1004,426,1213,967,38,15,9,209,541,1032,1920,0,0
5113,1008,426,1216,965,38,15,9,208,539,1033,1920,0,0
5114,1007,424,1217,968,38,15,9,210,544,1034,1920,0,0
5115,1005,421,1215,966,38,15,9,210,545,1035,1920,0,0
5116,1005,421,1215,967,38,15,9,210,546,1036,1920,0,0
5117,1005,421,1214,966,38,15,9,209,545,1037,1920,0,0
5118,1009,423,1216,962,38,15,9,207,539,1038,1920,0,0
5119,1011,425,1217,960,38,15,9,206,535,1039,1920,0,0
5120,1010,423,1218,965,38,15,9,208,542,1040,1920,0,0
5121,1011,425,1219,963,38,15,9,208,538,1041,1920,0,0
5122,1007,425,1213,962,38,15,9,206,537,1042,1920,0,0
5123,1005,423,1213,963,38,15,9,208,540,1043,1920,0,0
5124,1003,421,1214,969,38,15,9,211,548,1044,1920,0,0
5125,995,419,1207,971,38,15,9,212,552,1045,1920,0,0
5126,982,420,1188,967,38,15,9,206,547,1046,1920,0,0
5127,973,412,1177,965,38,15,9,204,553,1047,1920,0,0
5128,967,409,1167,960,38,15,9,200,551,1048,1920,0,0
5129,965,405,1166,969,38,15,9,201,564,1049,1920,0,0
5130,963,403,1161,964,38,15,9,198,561,1050,1920,0,0
5131,964,399,1155,942,38,15,9,191,543,1051,1920,0,0
5132,961,400,1145,929,38,15,9,184,529,1052,1920,0,0
5133,957,394,1141,925,38,15,9,184,531,1053,1920,0,0
5134,959,395,1142,923,38,15,9,183,528,1054,1920,0,0
5135,956,396,1140,928,38,15,9,184,532,1055,1920,0,0
5136,959,396,1145,929,38,15,9,186,533,1056,1920,0,0
5137,961,396,1146,929,38,15,9,185,533,1057,1920,0,0
5138,968,391,1160,934,38,15,9,192,543,1058,1920,0,0
5139,980,391,1175,930,38,15,9,195,539,1059,1920,0,0
5140,982,398,1181,932,38,15,9,199,534,1060,1920,0,0
5141,990,404,1190,925,38,15,9,200,521,1061,1920,0,0
5142,991,402,1196,925,38,15,9,205,523,1062,1920,0,0
5143,985,403,1190,924,38,15,9,205,521,1063,1920,0,0
5144,993,411,1195,912,38,15,9,202,501,1064,1920,0,0
5145,1002,406,1208,910,38,15,9,206,504,1065,1920,0,0
5146,1002,411,1204,905,38,15,9,202,494,1066,1920,0,0
5147,1002,408,1205,900,38,15,9,203,492,1067,1920,0,0
5148,1001,407,1206,902,38,15,9,205,495,1068,1920,0,0
5149,993,408,1202,909,38,15,9,209,501,1069,1920,0,0
5150,993,411,1201,904,38,15,9,208,493,1070,1920,0,0
5151,991,407,1203,906,38,15,9,212,499,1071,1920,0,0
5152,978,399,1198,910,38,15,9,220,511,1072,1920,0,0
5153,966,399,1183,906,38,15,9,217,507,1073,1920,0,0
5154,945,394,1170,930,38,15,9,225,536,1074,1920,0,0
5155,935,397,1162,948,38,15,9,227,551,1075,1920,0,0
5156,943,398,1174,958,38,15,9,231,560,1076,1920,0,0
5157,944,408,1177,968,38,15,9,233,560,1077,1920,0,0
5158,959,412,1197,975,38,15,9,238,563,1078,1920,0,0
5159,962,414,1209,994,38,15,9,247,580,1079,1920,0,0
5160,956,420,1209,1005,38,15,9,253,585,1080,1920,0,0
5161,946,424,1194,985,38,15,9,248,561,1081,1920,0,0
5162,944,422,1192,977,38,15,9,248,555,1082,1920,0,0
5163,952,426,1198,968,38,15,9,246,542,1083,1920,0,0
5164,966,426,1212,966,38,15,9,246,540,1084,1920,0,0
5165,968,427,1216,970,38,15,9,248,543,1085,1920,0,0
5166,967,426,1217,968,38,15,9,250,542,1086,1920,0,0
5167,961,426,1213,967,38,15,9,252,541,1087,1920,0,0
5168,958,423,1215,971,38,15,9,257,548,1088,1920,0,0
5169,956,423,1214,970,38,15,9,258,547,1089,1920,0,0
5170,955,427,1213,967,38,15,9,258,540,1090,1920,0,0
5171,953,426,1216,973,38,15,9,263,547,1091,1920,0,0
5172,952,425,1221,978,38,15,9,269,553,1092,1920,0,0
5173,956,423,1224,976,38,15,9,268,553,1093,1920,0,0
5174,957,422,1225,974,38,15,9,268,552,1094,1920,0,0
5175,956,422,1225,974,38,15,9,269,552,1095,1920,0,0
5176,957,426,1225,972,38,15,9,268,546,1096,1920,0,0
5177,961,426,1227,965,38,15,9,266,539,1097,1920,0,0
5178,957,424,1226,967,38,15,9,269,543,1098,1920,0,0
5179,955,424,1225,968,38,15,9,270,544,1099,1920,0,0
5180,955,424,1226,971,38,15,9,271,547,1100,1920,0,0
5181,954,424,1226,973,38,15,9,272,549,1101,1920,0,0
5182,955,423,1228,973,38,15,9,273,550,1102,1920,0,0
5183,955,423,1227,973,38,15,9,272,550,1103,1920,0,0
5184,961,427,1228,965,38,15,9,267,538,1104,1920,0,0
5185,953,423,1227,974,38,15,9,274,551,1105,1920,0,0
5186,957,427,1226,968,38,15,9,269,541,1106,1920,0,0
5187,961,429,1228,965,38,15,9,267,536,1107,1920,0,0
5188,960,430,1230,973,38,15,9,270,543,1108,1920,0,0
5189,957,428,1227,974,38,15,9,270,546,1109,1920,0,0
5190,958,426,1228,974,38,15,9,270,548,1110,1920,0,0
5191,961,428,1230,970,38,15,9,269,542,1111,1920,0,0
5192,963,430,1232,969,38,15,9,269,539,1112,1920,0,0
5193,961,426,1233,971,38,15,9,272,545,1113,1920,0,0
5194,964,428,1235,967,38,15,9,271,539,1114,1920,0,0
5195,966,429,1235,964,38,15,9,269,535,1115,1920,0,0
5196,956,428,1228,969,38,15,9,272,541,1116,1920,0,0
5197,953,431,1225,973,38,15,9,272,542,1117,1920,0,0
5198,922,423,1188,970,38,15,9,266,547,1118,1920,0,0
5199,917,425,1173,965,38,15,9,256,540,1119,1920,0,0
5200,915,424,1165,967,38,15,9,250,543,1120,1920,0,0
5201,918,428,1158,961,38,15,9,240,533,1121,1920,0,0
5202,918,424,1156,967,38,15,9,238,543,1122,1920,0,0
5203,922,424,1154,969,38,15,9,232,545,1123,1920,0,0
5204,928,422,1154,966,38,15,9,226,544,1124,1920,0,0
5205,941,422,1167,970,38,15,9,226,548,1125,1920,0,0
5206,956,424,1180,971,38,15,9,224,547,1126,1920,0,0
5207,959,423,1179,967,38,15,9,220,544,1127,1920,0,0
5208,972,424,1191,958,38,15,9,219,534,1128,1920,0,0
5209,980,416,1201,955,38,15,9,221,539,1129,1920,0,0
5210,987,413,1212,962,38,15,9,225,549,1130,1920,0,0
5211,997,414,1217,950,38,15,9,220,536,1131,1920,0,0
5212,998,417,1216,947,38,15,9,218,530,1132,1920,0,0
5213,1001,413,1225,959,38,15,9,224,546,1133,1920,0,0
5214,1002,414,1222,952,38,15,9,220,538,1134,1920,0,0
5215,1008,408,1222,929,38,15,9,214,521,1135,1920,0,0
5216,1008,403,1219,918,38,15,9,211,515,1136,1920,0,0
5217,1005,404,1216,916,38,15,9,211,512,1137,1920,0,0
5218,1003,404,1216,914,38,15,9,213,510,1138,1920,0,0
5219,1004,409,1216,913,38,15,9,212,504,1139,1920,0,0
5220,1002,414,1215,915,38,15,9,213,501,1140,1920,0,0
5221,999,416,1212,916,38,15,9,213,500,1141,1920,0,0
5222,998,418,1213,915,38,15,9,215,497,1142,1920,0,0
5223,998,414,1217,920,38,15,9,219,506,1143,1920,0,0
5224,998,412,1217,918,38,15,9,219,506,1144,1920,0,0
5225,999,419,1219,920,38,15,9,220,501,1145,1920,0,0
5226,998,421,1217,917,38,15,9,219,496,1146,1920,0,0
5227,995,418,1216,916,38,15,9,221,498,1147,1920,0,0
5228,994,418,1218,920,38,15,9,224,502,1148,1920,0,0
5229,994,419,1219,920,38,15,9,225,501,1149,1920,0,0
5230,993,419,1218,920,38,15,9,225,501,1150,1920,0,0
5231,993,418,1219,918,38,15,9,226,500,1151,1920,0,0
5232,990,408,1220,921,38,15,9,230,513,1152,1920,0,0
5233,991,402,1221,918,38,15,9,230,516,1153,1920,0,0
5234,990,403,1228,942,38,15,9,238,539,1154,1920,0,0
5235,977,408,1223,963,38,15,9,246,555,1155,1920,0,0
5236,970,410,1219,966,38,15,9,249,556,1156,1920,0,0
5237,942,410,1190,976,38,15,9,248,566,1157,1920,0,0
5238,929,408,1172,980,38,15,9,243,572,1158,1920,0,0
5239,926,410,1160,978,38,15,9,234,568,1159,1920,0,0
5240,927,413,1151,977,38,15,9,224,564,1160,1920,0,0
5241,932,418,1151,985,38,15,9,219,567,1161,1920,0,0
5242,933,421,1145,984,38,15,9,212,563,1162,1920,0,0
5243,934,423,1140,982,38,15,9,206,559,1163,1920,0,0
5244,939,430,1137,976,38,15,9,198,546,1164,1920,0,0
5245,941,431,1135,974,38,15,9,194,543,1165,1920,0,0
5246,941,427,1134,979,38,15,9,193,552,1166,1920,0,0
5247,942,426,1131,979,38,15,9,189,553,1167,1920,0,0
5248,943,427,1129,981,38,15,9,186,554,1168,1920,0,0
5249,944,427,1128,985,38,15,9,184,558,1169,1920,0,0
5250,945,426,1127,987,38,15,9,182,561,1170,1920,0,0
5251,949,429,1125,981,38,15,9,176,552,1171,1920,0,0
5252,951,429,1125,979,38,15,9,174,550,1172,1920,0,0
5253,952,428,1123,978,38,15,9,171,550,1173,1920,0,0
5254,953,428,1122,978,38,15,9,169,550,1174,1920,0,0
5255,954,428,1123,980,38,15,9,169,552,1175,1920,0,0
5256,954,423,1122,980,38,15,9,168,557,1176,1920,0,0
5257,958,422,1127,984,38,15,9,169,562,1177,1920,0,0
5258,971,425,1143,984,38,15,9,172,559,1178,1920,0,0
5259,967,419,1143,989,38,15,9,176,570,1179,1920,0,0
5260,968,411,1146,982,38,15,9,178,571,1180,1920,0,0
5261,980,403,1166,983,38,15,9,186,580,1181,1920,0,0
5262,978,399,1169,982,38,15,9,191,583,1182,1920,0,0
5263,988,402,1180,973,38,15,9,192,571,1183,1920,0,0
5264,990,403,1184,975,38,15,9,194,572,1184,1920,0,0
5265,994,405,1186,967,38,15,9,192,562,1185,1920,0,0
5266,986,408,1181,977,38,15,9,195,569,1186,1920,0,0
5267,969,402,1166,979,38,15,9,197,577,1187,1920,0,0
5268,970,406,1165,980,38,15,9,195,574,1188,1920,0,0
5269,980,414,1178,978,38,15,9,198,564,1189,1920,0,0
5270,991,418,1195,977,38,15,9,204,559,1190,1920,0,0
5271,988,428,1194,974,38,15,9,206,546,1191,1920,0,0
5272,972,426,1187,980,38,15,9,215,554,1192,1920,0,0
5273,965,427,1184,995,38,15,9,219,568,1193,1920,0,0
5274,973,429,1193,997,38,15,9,220,568,1194,1920,0,0
5275,987,427,1214,1013,38,15,9,227,586,1195,1920,0,0
5276,1007,426,1234,1006,38,15,9,227,580,1196,1920,0,0
5277,1025,443,1249,1010,38,15,9,224,567,1197,1920,0,0
5278,1034,447,1269,1043,38,15,9,235,596,1198,1920,0,0
5279,1037,452,1276,1056,38,15,9,239,604,1199,1920,0,0
5280,1034,454,1275,1062,38,15,9,241,608,1200,1920,0,0
5281,1019,465,1260,1067,38,15,9,241,602,1201,1920,0,0
5282,995,464,1242,1070,38,15,9,247,606,1202,1920,0,0
5283,991,475,1241,1078,38,15,9,250,603,1203,1920,0,0
5284,989,483,1244,1077,38,15,9,255,594,1204,1920,0,0
5285,1006,501,1258,1075,38,15,9,252,574,1205,1920,0,0
5286,1027,505,1280,1069,38,15,9,253,564,1206,1920,0,0
5287,1045,512,1301,1071,38,15,9,256,559,1207,1920,0,0
5288,1065,528,1322,1076,38,15,9,257,548,1208,1920,0,0
5289,1083,539,1338,1071,38,15,9,255,532,1209,1920,0,0
5290,1094,558,1346,1075,38,15,9,252,517,1210,1920,0,0
5291,1099,577,1343,1074,38,15,9,244,497,1211,1920,0,0
5292,1102,589,1344,1074,38,15,9,242,485,1212,1920,0,0
5293,1107,619,1336,1070,38,15,9,229,451,1213,1920,0,0
5294,1141,646,1359,1066,38,15,9,218,420,1214,1920,0,0
5295,1170,652,1393,1071,38,15,9,223,419,1215,1920,0,0
5296,1223,653,1447,1066,38,15,9,224,413,1216,1920,0,0
5297,1271,655,1498,1068,38,15,9,227,413,1217,1920,0,0
5298,1296,652,1531,1069,38,15,9,235,417,1218,1920,0,0
5299,1318,656,1555,1066,38,15,9,237,410,1219,1920,0,0
5300,1334,660,1578,1066,38,15,9,244,406,1220,1920,0,0
5301,1354,668,1603,1067,38,15,9,249,399,1221,1920,0,0
5302,1369,678,1621,1067,38,15,9,252,389,1222,1920,0,0
5303,1376,682,1634,1068,38,15,9,258,386,1223,1920,0,0
5304,1370,674,1640,1069,38,15,9,270,395,1224,1920,0,0
5305,1344,664,1623,1069,38,15,9,279,405,1225,1920,0,0
5306,1301,658,1586,1069,38,15,9,285,411,1226,1920,0,0
5307,1255,641,1554,1070,38,15,9,299,429,1227,1920,0,0
5308,1211,626,1517,1069,38,15,9,306,443,1228,1920,0,0
5309,1178,616,1486,1068,38,15,9,308,452,1229,1920,0,0
5310,1151,601,1464,1068,38,15,9,313,467,1230,1920,0,0
5311,1122,581,1441,1068,38,15,9,319,487,1231,1920,0,0
5312,1097,559,1419,1064,38,15,9,322,505,1232,1920,0,0
5313,1064,536,1394,1067,38,15,9,330,531,1233,1920,0,0
5314,1018,517,1356,1069,38,15,9,338,552,1234,1920,0,0
5315,981,503,1317,1066,38,15,9,336,563,1235,1920,0,0
5316,947,484,1285,1066,38,15,9,338,582,1236,1920,0,0
5317,915,475,1249,1069,38,15,9,334,594,1237,1920,0,0
5318,895,466,1220,1061,38,15,9,325,595,1238,1920,0,0
5319,883,460,1204,1064,38,15,9,321,604,1239,1920,0,0
5320,880,449,1198,1068,38,15,9,318,619,1240,1920,0,0
5321,887,435,1192,1045,38,15,9,305,610,1241,1920,0,0
5322,900,422,1187,1011,38,15,9,287,589,1242,1920,0,0
5323,900,414,1176,990,38,15,9,276,576,1243,1920,0,0
5324,894,405,1167,988,38,15,9,273,583,1244,1920,0,0
5325,875,392,1141,976,38,15,9,266,584,1245,1920,0,0
5326,856,384,1106,948,38,15,9,250,564,1246,1920,0,0
5327,844,376,1084,931,38,15,9,240,555,1247,1920,0,0
5328,839,379,1068,917,38,15,9,229,538,1248,1920,0,0
5329,835,373,1061,915,38,15,9,226,542,1249,1920,0,0
5330,844,366,1064,902,38,15,9,220,536,1250,1920,0,0
5331,858,361,1068,876,38,15,9,210,515,1251,1920,0,0
5332,874,358,1075,859,38,15,9,201,501,1252,1920,0,0
5333,888,356,1083,853,38,15,9,195,497,1253,1920,0,0
5334,897,354,1088,850,38,15,9,191,496,1254,1920,0,0
5335,901,355,1087,845,38,15,9,186,490,1255,1920,0,0
5336,906,354,1086,841,38,15,9,180,487,1256,1920,0,0
5337,905,358,1080,839,38,15,9,175,481,1257,1920,0,0
5338,903,357,1078,837,38,15,9,175,480,1258,1920,0,0
5339,906,357,1083,839,38,15,9,177,482,1259,1920,0,0
5340,902,362,1080,845,38,15,9,178,483,1260,1920,0,0
5341,896,364,1077,857,38,15,9,181,493,1261,1920,0,0
5342,890,361,1073,866,38,15,9,183,505,1262,1920,0,0
5343,884,363,1067,875,38,15,9,183,512,1263,1920,0,0
5344,875,365,1059,883,38,15,9,184,518,1264,1920,0,0
5345,870,370,1053,880,38,15,9,183,510,1265,1920,0,0
5346,859,371,1052,901,38,15,9,193,530,1266,1920,0,0
5347,865,376,1063,915,38,15,9,198,539,1267,1920,0,0
5348,875,378,1076,925,38,15,9,201,547,1268,1920,0,0
5349,894,387,1091,921,38,15,9,197,534,1269,1920,0,0
5350,923,396,1117,926,38,15,9,194,530,1270,1920,0,0
5351,940,403,1138,957,38,15,9,198,554,1271,1920,0,0
5352,953,409,1154,985,38,15,9,201,576,1272,1920,0,0
5353,962,414,1160,992,38,15,9,198,578,1273,1920,0,0
5354,968,416,1160,993,38,15,9,192,577,1274,1920,0,0
5355,974,417,1162,991,38,15,9,188,574,1275,1920,0,0
5356,983,421,1168,992,38,15,9,185,571,1276,1920,0,0
5357,985,427,1168,989,38,15,9,183,562,1277,1920,0,0
5358,986,428,1168,992,38,15,9,182,564,1278,1920,0,0
5359,987,430,1167,990,38,15,9,180,560,1279,1920,0,0
5360,987,432,1167,988,38,15,9,180,556,1280,1920,0,0
5361,984,430,1166,985,38,15,9,182,555,1281,1920,0,0
5362,978,431,1161,988,38,15,9,183,557,1282,1920,0,0
5363,973,427,1157,984,38,15,9,184,557,1283,1920,0,0
5364,963,420,1151,987,38,15,9,188,567,1284,1920,0,0
5365,951,411,1143,991,38,15,9,192,580,1285,1920,0,0
5366,940,402,1133,986,38,15,9,193,584,1286,1920,0,0
5367,927,393,1119,972,38,15,9,192,579,1287,1920,0,0
5368,914,388,1103,961,38,15,9,189,573,1288,1920,0,0
5369,904,387,1090,948,38,15,9,186,561,1289,1920,0,0
5370,892,386,1077,941,38,15,9,185,555,1290,1920,0,0
5371,882,378,1068,933,38,15,9,186,555,1291,1920,0,0
5372,881,370,1064,922,38,15,9,183,552,1292,1920,0,0
5373,880,363,1057,901,38,15,9,177,538,1293,1920,0,0
5374,872,355,1044,881,38,15,9,172,526,1294,1920,0,0
5375,854,352,1026,870,38,15,9,172,518,1295,1920,0,0
5376,839,346,1011,862,38,15,9,172,516,1296,1920,0,0
5377,825,336,999,861,38,15,9,174,525,1297,1920,0,0
5378,810,329,984,854,38,15,9,174,525,1298,1920,0,0
5379,794,321,968,844,38,15,9,174,523,1299,1920,0,0
5380,782,322,951,829,38,15,9,169,507,1300,1920,0,0
5381,775,322,941,823,38,15,9,166,501,1301,1920,0,0
5382,772,320,939,823,38,15,9,167,503,1302,1920,0,0
5383,773,315,941,821,38,15,9,168,506,1303,1920,0,0
5384,783,313,949,814,38,15,9,166,501,1304,1920,0,0
5385,800,313,959,793,38,15,9,159,480,1305,1920,0,0
5386,811,312,965,777,38,15,9,154,465,1306,1920,0,0
5387,820,312,971,772,38,15,9,151,460,1307,1920,0,0
5388,825,308,975,769,38,15,9,150,461,1308,1920,0,0
5389,828,303,977,769,38,15,9,149,466,1309,1920,0,0
5390,826,300,975,770,38,15,9,149,470,1310,1920,0,0
5391,820,299,965,760,38,15,9,145,461,1311,1920,0,0
5392,821,300,961,753,38,15,9,140,453,1312,1920,0,0
5393,820,300,959,751,38,15,9,139,451,1313,1920,0,0
5394,819,307,955,760,38,15,9,136,453,1314,1920,0,0
5395,819,305,955,768,38,15,9,136,463,1315,1920,0,0
5396,820,308,955,767,38,15,9,135,459,1316,1920,0,0
5397,823,311,955,768,38,15,9,132,457,1317,1920,0,0
5398,826,315,958,770,38,15,9,132,455,1318,1920,0,0
5399,827,316,961,776,38,15,9,134,460,1319,1920,0,0
5400,831,316,971,789,38,15,9,140,473,1320,1920,0,0
5401,833,321,977,798,38,15,9,144,477,1321,1920,0,0
5402,838,328,986,805,38,15,9,148,477,1322,1920,0,0
5403,856,334,1004,812,38,15,9,148,478,1323,1920,0,0
5404,871,338,1018,817,38,15,9,147,479,1324,1920,0,0
5405,876,346,1029,852,38,15,9,153,506,1325,1920,0,0
5406,874,350,1033,877,38,15,9,159,527,1326,1920,0,0
5407,871,358,1032,889,38,15,9,161,531,1327,1920,0,0
5408,858,363,1021,892,38,15,9,163,529,1328,1920,0,0
5409,857,368,1024,897,38,15,9,167,529,1329,1920,0,0
5410,868,369,1034,899,38,15,9,166,530,1330,1920,0,0
5411,875,376,1043,902,38,15,9,168,526,1331,1920,0,0
5412,886,382,1058,907,38,15,9,172,525,1332,1920,0,0
5413,913,386,1085,908,38,15,9,172,522,1333,1920,0,0
5414,942,396,1115,922,38,15,9,173,526,1334,1920,0,0
5415,964,398,1139,944,38,15,9,175,546,1335,1920,0,0
5416,981,402,1156,952,38,15,9,175,550,1336,1920,0,0
5417,987,403,1163,957,38,15,9,176,554,1337,1920,0,0
5418,995,406,1171,962,38,15,9,176,556,1338,1920,0,0
5419,1004,412,1179,968,38,15,9,175,556,1339,1920,0,0
5420,1014,417,1187,967,38,15,9,173,550,1340,1920,0,0
5421,1021,425,1191,964,38,15,9,170,539,1341,1920,0,0
5422,1025,425,1194,962,38,15,9,169,537,1342,1920,0,0
5423,1028,425,1196,959,38,15,9,168,534,1343,1920,0,0
5424,1028,421,1198,958,38,15,9,170,537,1344,1920,0,0
5425,1029,422,1198,956,38,15,9,169,534,1345,1920,0,0
5426,1029,425,1199,957,38,15,9,170,532,1346,1920,0,0
5427,1034,429,1208,966,38,15,9,174,537,1347,1920,0,0
5428,1030,428,1212,975,38,15,9,182,547,1348,1920,0,0
5429,1024,428,1210,970,38,15,9,186,542,1349,1920,0,0
5430,1026,429,1212,958,38,15,9,186,529,1350,1920,0,0
5431,1020,428,1212,956,38,15,9,192,528,1351,1920,0,0
5432,1020,427,1217,959,38,15,9,197,532,1352,1920,0,0
5433,1021,424,1221,959,38,15,9,200,535,1353,1920,0,0
5434,1024,423,1225,954,38,15,9,201,531,1354,1920,0,0
5435,1022,411,1229,960,38,15,9,207,549,1355,1920,0,0
5436,1019,407,1229,961,38,15,9,210,554,1356,1920,0,0
5437,1015,406,1224,960,38,15,9,209,554,1357,1920,0,0
5438,1007,405,1218,964,38,15,9,211,559,1358,1920,0,0
5439,1006,407,1216,967,38,15,9,210,560,1359,1920,0,0
5440,1007,407,1216,967,38,15,9,209,560,1360,1920,0,0
5441,1009,414,1215,961,38,15,9,206,547,1361,1920,0,0
5442,1009,417,1214,956,38,15,9,205,539,1362,1920,0,0
5443,1005,417,1212,959,38,15,9,207,542,1363,1920,0,0
5444,1000,414,1211,965,38,15,9,211,551,1364,1920,0,0
5445,998,416,1208,968,38,15,9,210,552,1365,1920,0,0
5446,994,415,1200,967,38,15,9,206,552,1366,1920,0,0
5447,999,413,1206,966,38,15,9,207,553,1367,1920,0,0
5448,997,409,1206,971,38,15,9,209,562,1368,1920,0,0
5449,997,407,1207,971,38,15,9,210,564,1369,1920,0,0
5450,991,411,1205,979,38,15,9,214,568,1370,1920,0,0
5451,981,412,1203,994,38,15,9,222,582,1371,1920,0,0
5452,968,411,1197,1004,38,15,9,229,593,1372,1920,0,0
5453,961,413,1193,1005,38,15,9,232,592,1373,1920,0,0
5454,955,415,1191,1011,38,15,9,236,596,1374,1920,0,0
5455,944,414,1183,1013,38,15,9,239,599,1375,1920,0,0
5456,934,418,1174,1012,38,15,9,240,594,1376,1920,0,0
5457,934,422,1171,1007,38,15,9,237,585,1377,1920,0,0
5458,943,424,1180,1006,38,15,9,237,582,1378,1920,0,0
5459,954,425,1190,1004,38,15,9,236,579,1379,1920,0,0
5460,967,426,1198,999,38,15,9,231,573,1380,1920,0,0
5461,985,428,1214,995,38,15,9,229,567,1381,1920,0,0
5462,994,429,1224,1004,38,15,9,230,575,1382,1920,0,0
5463,1005,430,1234,1007,38,15,9,229,577,1383,1920,0,0
5464,1016,425,1248,1015,38,15,9,232,590,1384,1920,0,0
5465,1022,428,1251,1019,38,15,9,229,591,1385,1920,0,0
5466,1021,424,1251,1025,38,15,9,230,601,1386,1920,0,0
5467,1020,426,1248,1029,38,15,9,228,603,1387,1920,0,0
5468,1023,430,1245,1024,38,15,9,222,594,1388,1920,0,0
5469,1027,436,1247,1031,38,15,9,220,595,1389,1920,0,0
5470,1030,439,1250,1035,38,15,9,220,596,1390,1920,0,0
5471,1033,438,1254,1038,38,15,9,221,600,1391,1920,0,0
5472,1036,437,1254,1036,38,15,9,218,599,1392,1920,0,0
5473,1041,437,1257,1034,38,15,9,216,597,1393,1920,0,0
5474,1039,437,1254,1034,38,15,9,215,597,1394,1920,0,0
5475,1038,438,1251,1034,38,15,9,213,596,1395,1920,0,0
5476,1039,441,1251,1033,38,15,9,212,592,1396,1920,0,0
5477,1039,442,1251,1034,38,15,9,212,592,1397,1920,0,0
5478,1039,442,1251,1035,38,15,9,212,593,1398,1920,0,0
5479,1040,442,1251,1035,38,15,9,211,593,1399,1920,0,0
5480,1040,442,1251,1036,38,15,9,211,594,1400,1920,0,0
5481,1041,452,1246,1030,38,15,9,205,578,1401,1920,0,0
5482,1039,445,1247,1033,38,15,9,208,588,1402,1920,0,0
5483,1039,453,1244,1030,38,15,9,205,577,1403,1920,0,0
5484,1038,447,1246,1032,38,15,9,208,585,1404,1920,0,0
5485,1037,446,1246,1033,38,15,9,209,587,1405,1920,0,0
5486,1039,454,1244,1031,38,15,9,205,577,1406,1920,0,0
5487,1038,447,1246,1033,38,15,9,208,586,1407,1920,0,0
5488,1040,454,1244,1029,38,15,9,204,575,1408,1920,0,0
5489,1039,447,1247,1032,38,15,9,208,585,1409,1920,0,0
5490,1038,444,1247,1034,38,15,9,209,590,1410,1920,0,0
5491,1041,454,1244,1028,38,15,9,203,574,1411,1920,0,0
5492,1038,451,1243,1032,38,15,9,205,581,1412,1920,0,0
5493,1036,448,1243,1035,38,15,9,207,587,1413,1920,0,0
5494,1035,446,1243,1037,38,15,9,208,591,1414,1920,0,0
5495,1035,448,1242,1037,38,15,9,207,589,1415,1920,0,0
5496,1036,448,1243,1038,38,15,9,207,590,1416,1920,0,0
5497,1036,449,1242,1037,38,15,9,206,588,1417,1920,0,0
5498,1036,449,1241,1038,38,15,9,205,589,1418,1920,0,0
5499,1037,448,1242,1037,38,15,9,205,589,1419,1920,0,0
5500,1036,449,1242,1037,38,15,9,206,588,1420,1920,0,0
5501,1036,447,1242,1037,38,15,9,206,590,1421,1920,0,0
5502,1035,447,1240,1037,38,15,9,205,590,1422,1920,0,0
5503,1037,449,1241,1036,38,15,9,204,587,1423,1920,0,0
5504,1037,447,1241,1036,38,15,9,204,589,1424,1920,0,0
5505,1037,447,1242,1036,38,15,9,205,589,1425,1920,0,0
5506,1037,446,1242,1036,38,15,9,205,590,1426,1920,0,0
5507,1037,446,1241,1036,38,15,9,204,590,1427,1920,0,0
5508,1037,448,1241,1036,38,15,9,204,588,1428,1920,0,0
5509,1040,445,1244,1036,38,15,9,204,591,1429,1920,0,0
5510,1037,437,1244,1034,38,15,9,207,597,1430,1920,0,0
5511,1018,440,1229,1031,38,15,9,211,591,1431,1920,0,0
5512,998,433,1213,1029,38,15,9,215,596,1432,1920,0,0
5513,975,423,1197,1031,38,15,9,222,608,1433,1920,0,0
5514,962,424,1186,1034,38,15,9,224,610,1434,1920,0,0
5515,942,425,1162,1026,38,15,9,220,601,1435,1920,0,0
5516,928,423,1147,1019,38,15,9,219,596,1436,1920,0,0
5517,920,422,1140,1017,38,15,9,220,595,1437,1920,0,0
5518,919,418,1142,1019,38,15,9,223,601,1438,1920,0,0
5519,920,413,1147,1021,38,15,9,227,608,1439,1920,0,0
5520,935,408,1161,1018,38,15,9,226,610,1440,1920,0,0
5521,951,408,1173,1011,38,15,9,222,603,1441,1920,0,0
5522,969,408,1181,984,38,15,9,212,576,1442,1920,0,0
5523,982,404,1192,975,38,15,9,210,571,1443,1920,0,0
5524,987,404,1192,971,38,15,9,205,567,1444,1920,0,0
5525,992,400,1196,971,38,15,9,204,571,1445,1920,0,0
5526,991,402,1191,969,38,15,9,200,567,1446,1920,0,0
5527,982,395,1178,959,38,15,9,196,564,1447,1920,0,0
5528,976,395,1169,958,38,15,9,193,563,1448,1920,0,0
5529,967,391,1160,966,38,15,9,193,575,1449,1920,0,0
5530,974,399,1168,977,38,15,9,194,578,1450,1920,0,0
5531,991,407,1188,984,38,15,9,197,577,1451,1920,0,0
5532,989,408,1191,990,38,15,9,202,582,1452,1920,0,0
5533,989,416,1195,992,38,15,9,206,576,1453,1920,0,0
5534,989,422,1200,995,38,15,9,211,573,1454,1920,0,0
5535,991,430,1204,1002,38,15,9,213,572,1455,1920,0,0
5536,988,434,1196,1000,38,15,9,208,566,1456,1920,0,0
5537,989,435,1200,1003,38,15,9,211,568,1457,1920,0,0
5538,993,436,1206,1009,38,15,9,213,573,1458,1920,0,0
5539,996,444,1204,1007,38,15,9,208,563,1459,1920,0,0
5540,995,444,1200,1003,38,15,9,205,559,1460,1920,0,0
5541,995,445,1198,1003,38,15,9,203,558,1461,1920,0,0
5542,994,440,1199,1002,38,15,9,205,562,1462,1920,0,0
5543,996,438,1202,1003,38,15,9,206,565,1463,1920,0,0
5544,998,434,1208,1004,38,15,9,210,570,1464,1920,0,0
5545,1004,433,1211,993,38,15,9,207,560,1465,1920,0,0
5546,1006,435,1215,995,38,15,9,209,560,1466,1920,0,0
5547,1007,427,1220,999,38,15,9,213,572,1467,1920,0,0
5548,1011,419,1224,988,38,15,9,213,569,1468,1920,0,0
5549,1007,406,1223,989,38,15,9,216,583,1469,1920,0,0
5550,1011,404,1225,986,38,15,9,214,582,1470,1920,0,0
5551,1011,403,1223,979,38,15,9,212,576,1471,1920,0,0
5552,1008,408,1217,981,38,15,9,209,573,1472,1920,0,0
5553,1013,410,1223,986,38,15,9,210,576,1473,1920,0,0
5554,1004,405,1214,987,38,15,9,210,582,1474,1920,0,0
5555,993,403,1202,993,38,15,9,209,590,1475,1920,0,0
5556,989,405,1198,997,38,15,9,209,592,1476,1920,0,0
5557,990,406,1197,999,38,15,9,207,593,1477,1920,0,0
5558,993,407,1196,994,38,15,9,203,587,1478,1920,0,0
5559,994,411,1193,989,38,15,9,199,578,1479,1920,0,0
5560,995,411,1193,993,38,15,9,198,582,1480,1920,0,0
5561,995,412,1192,995,38,15,9,197,583,1481,1920,0,0
5562,997,414,1190,988,38,15,9,193,574,1482,1920,0,0
5563,996,414,1190,992,38,15,9,194,578,1483,1920,0,0
5564,997,415,1190,993,38,15,9,193,578,1484,1920,0,0
5565,999,417,1191,995,38,15,9,192,578,1485,1920,0,0
5566,1001,411,1194,995,38,15,9,193,584,1486,1920,0,0
5567,1001,415,1194,998,38,15,9,193,583,1487,1920,0,0
5568,1001,411,1192,996,38,15,9,191,585,1488,1920,0,0
5569,1002,415,1193,998,38,15,9,191,583,1489,1920,0,0
5570,1002,418,1191,999,38,15,9,189,581,1490,1920,0,0
5571,1000,420,1188,1000,38,15,9,188,580,1491,1920,0,0
5572,1000,420,1187,998,38,15,9,187,578,1492,1920,0,0
5573,999,413,1185,997,38,15,9,186,584,1493,1920,0,0
5574,999,410,1184,995,38,15,9,185,585,1494,1920,0,0
5575,1001,409,1184,994,38,15,9,183,585,1495,1920,0,0
5576,1008,410,1189,992,38,15,9,181,582,1496,1920,0,0
5577,1009,417,1189,994,38,15,9,180,577,1497,1920,0,0
5578,1009,419,1188,996,38,15,9,179,577,1498,1920,0,0
5579,1007,418,1187,996,38,15,9,180,578,1499,1920,0,0
5580,1008,420,1187,996,38,15,9,179,576,1500,1920,0,0
5581,1005,418,1185,995,38,15,9,180,577,1501,1920,0,0
5582,1003,416,1183,995,38,15,9,180,579,1502,1920,0,0
5583,1003,418,1183,996,38,15,9,180,578,1503,1920,0,0
5584,1002,416,1182,996,38,15,9,180,580,1504,1920,0,0
5585,1001,418,1181,998,38,15,9,180,580,1505,1920,0,0
5586,1007,423,1186,992,38,15,9,179,569,1506,1920,0,0
5587,1014,425,1195,988,38,15,9,181,563,1507,1920,0,0
5588,1015,426,1197,986,38,15,9,182,560,1508,1920,0,0
5589,1011,427,1196,988,38,15,9,185,561,1509,1920,0,0
5590,1007,425,1197,995,38,15,9,190,570,1510,1920,0,0
5591,1007,421,1201,998,38,15,9,194,577,1511,1920,0,0
5592,1009,414,1207,1004,38,15,9,198,590,1512,1920,0,0
5593,1008,417,1205,1002,38,15,9,197,585,1513,1920,0,0
5594,1005,418,1201,997,38,15,9,196,579,1514,1920,0,0
5595,1007,420,1204,1000,38,15,9,197,580,1515,1920,0,0
5596,1007,423,1203,997,38,15,9,196,574,1516,1920,0,0
5597,1005,424,1197,986,38,15,9,192,562,1517,1920,0,0
5598,1004,420,1196,981,38,15,9,192,561,1518,1920,0,0
5599,1001,421,1195,984,38,15,9,194,563,1519,1920,0,0
5600,999,421,1193,982,38,15,9,194,561,1520,1920,0,0
5601,997,420,1195,991,38,15,9,198,571,1521,1920,0,0
5602,1001,420,1203,994,38,15,9,202,574,1522,1920,0,0
5603,1004,421,1206,994,38,15,9,202,573,1523,1920,0,0
5604,1006,425,1208,991,38,15,9,202,566,1524,1920,0,0
5605,1006,422,1209,986,38,15,9,203,564,1525,1920,0,0
5606,1003,421,1200,956,38,15,9,197,535,1526,1920,0,0
5607,1002,421,1197,941,38,15,9,195,520,1527,1920,0,0
5608,997,419,1196,940,38,15,9,199,521,1528,1920,0,0
5609,999,417,1203,945,38,15,9,204,528,1529,1920,0,0
5610,996,419,1202,944,38,15,9,206,525,1530,1920,0,0
5611,992,422,1199,945,38,15,9,207,523,1531,1920,0,0
5612,991,424,1201,947,38,15,9,210,523,1532,1920,0,0
5613,994,425,1206,947,38,15,9,212,522,1533,1920,0,0
5614,997,429,1215,961,38,15,9,218,532,1534,1920,0,0
5615,989,425,1215,989,38,15,9,226,564,1535,1920,0,0
5616,991,427,1220,1002,38,15,9,229,575,1536,1920,0,0
5617,1001,426,1227,995,38,15,9,226,569,1537,1920,0,0
5618,1008,424,1234,994,38,15,9,226,570,1538,1920,0,0
5619,1014,430,1240,1005,38,15,9,226,575,1539,1920,0,0
5620,1023,433,1247,1007,38,15,9,224,574,1540,1920,0,0
5621,1028,439,1249,1007,38,15,9,221,568,1541,1920,0,0
5622,1031,442,1250,1008,38,15,9,219,566,1542,1920,0,0
5623,1028,447,1245,1014,38,15,9,217,567,1543,1920,0,0
5624,1033,441,1253,1020,38,15,9,220,579,1544,1920,0,0
5625,1027,432,1248,1018,38,15,9,221,586,1545,1920,0,0
5626,1022,428,1244,1019,38,15,9,222,591,1546,1920,0,0
5627,1013,418,1231,1014,38,15,9,218,596,1547,1920,0,0
5628,1014,413,1222,995,38,15,9,208,582,1548,1920,0,0
5629,1014,408,1220,997,38,15,9,206,589,1549,1920,0,0
5630,1016,407,1217,994,38,15,9,201,587,1550,1920,0,0
5631,1016,411,1214,993,38,15,9,198,582,1551,1920,0,0
5632,1015,414,1211,994,38,15,9,196,580,1552,1920,0,0
5633,1015,416,1209,995,38,15,9,194,579,1553,1920,0,0
5634,1014,410,1210,993,38,15,9,196,583,1554,1920,0,0
5635,1019,418,1212,990,38,15,9,193,572,1555,1920,0,0
5636,1019,412,1212,991,38,15,9,193,579,1556,1920,0,0
5637,1019,408,1216,1002,38,15,9,197,594,1557,1920,0,0
5638,1024,413,1215,994,38,15,9,191,581,1558,1920,0,0
5639,1026,411,1215,990,38,15,9,189,579,1559,1920,0,0
5640,1025,415,1211,991,38,15,9,186,576,1560,1920,0,0
5641,1024,415,1211,997,38,15,9,187,582,1561,1920,0,0
5642,1023,415,1210,997,38,15,9,187,582,1562,1920,0,0
5643,1023,413,1208,994,38,15,9,185,581,1563,1920,0,0
5644,1023,412,1206,992,38,15,9,183,580,1564,1920,0,0
5645,1024,413,1206,990,38,15,9,182,577,1565,1920,0,0
5646,1025,409,1208,991,38,15,9,183,582,1566,1920,0,0
5647,1030,413,1211,985,38,15,9,181,572,1567,1920,0,0
5648,1026,409,1210,994,38,15,9,184,585,1568,1920,0,0
5649,1021,407,1206,997,38,15,9,185,590,1569,1920,0,0
5650,1018,409,1202,1000,38,15,9,184,591,1570,1920,0,0
5651,1025,409,1207,997,38,15,9,182,588,1571,1920,0,0
5652,1026,410,1207,1001,38,15,9,181,591,1572,1920,0,0
5653,1027,412,1207,1003,38,15,9,180,591,1573,1920,0,0
5654,1029,412,1209,1004,38,15,9,180,592,1574,1920,0,0
5655,1029,413,1207,997,38,15,9,178,584,1575,1920,0,0
5656,1026,416,1203,991,38,15,9,177,575,1576,1920,0,0
5657,1026,415,1203,986,38,15,9,177,571,1577,1920,0,0
5658,1023,410,1204,997,38,15,9,181,587,1578,1920,0,0
5659,1025,410,1204,996,38,15,9,179,586,1579,1920,0,0
5660,1029,412,1208,1001,38,15,9,179,589,1580,1920,0,0
5661,1033,414,1209,997,38,15,9,176,583,1581,1920,0,0
5662,1040,420,1217,991,38,15,9,177,571,1582,1920,0,0
5663,1040,425,1223,997,38,15,9,183,572,1583,1920,0,0
5664,1033,414,1222,996,38,15,9,189,582,1584,1920,0,0
5665,1017,410,1208,994,38,15,9,191,584,1585,1920,0,0
5666,1018,410,1206,992,38,15,9,188,582,1586,1920,0,0
5667,1022,406,1211,997,38,15,9,189,591,1587,1920,0,0
5668,1025,403,1213,1000,38,15,9,188,597,1588,1920,0,0
5669,1032,410,1216,995,38,15,9,184,585,1589,1920,0,0
5670,1034,416,1216,992,38,15,9,182,576,1590,1920,0,0
5671,1029,420,1211,989,38,15,9,182,569,1591,1920,0,0
5672,1022,416,1206,990,38,15,9,184,574,1592,1920,0,0
5673,1019,419,1203,987,38,15,9,184,568,1593,1920,0,0
5674,1016,412,1204,991,38,15,9,188,579,1594,1920,0,0
5675,1018,413,1205,987,38,15,9,187,574,1595,1920,0,0
5676,1020,413,1209,991,38,15,9,189,578,1596,1920,0,0
5677,1020,415,1208,992,38,15,9,188,577,1597,1920,0,0
5678,1030,420,1217,987,38,15,9,187,567,1598,1920,0,0
5679,1031,425,1220,989,38,15,9,189,564,1599,1920,0,0
5680,1020,415,1213,994,38,15,9,193,579,1600,1920,0,0
5681,1017,418,1208,991,38,15,9,191,573,1601,1920,0,0
5682,1022,424,1213,987,38,15,9,191,563,1602,1920,0,0
5683,1015,415,1210,992,38,15,9,195,577,1603,1920,0,0
5684,1013,411,1209,996,38,15,9,196,585,1604,1920,0,0
5685,1015,417,1209,995,38,15,9,194,578,1605,1920,0,0
5686,1014,417,1207,992,38,15,9,193,575,1606,1920,0,0
5687,1020,416,1215,998,38,15,9,195,582,1607,1920,0,0
5688,1017,412,1211,999,38,15,9,194,587,1608,1920,0,0
5689,1017,412,1210,1001,38,15,9,193,589,1609,1920,0,0
5690,1013,410,1206,998,38,15,9,193,588,1610,1920,0,0
5691,1013,408,1206,999,38,15,9,193,591,1611,1920,0,0
5692,1020,417,1209,996,38,15,9,189,579,1612,1920,0,0
5693,1021,415,1211,1002,38,15,9,190,587,1613,1920,0,0
5694,1021,413,1211,1008,38,15,9,190,595,1614,1920,0,0
5695,1019,411,1206,1002,38,15,9,187,591,1615,1920,0,0
5696,1020,411,1205,1004,38,15,9,185,593,1616,1920,0,0
5697,1022,414,1203,999,38,15,9,181,585,1617,1920,0,0
5698,1025,414,1204,992,38,15,9,179,578,1618,1920,0,0
5699,1022,415,1201,993,38,15,9,179,578,1619,1920,0,0
5700,1022,415,1198,986,38,15,9,176,571,1620,1920,0,0
5701,1023,415,1198,983,38,15,9,175,568,1621,1920,0,0
5702,1025,413,1206,1002,38,15,9,181,589,1622,1920,0,0
5703,1023,415,1201,997,38,15,9,178,582,1623,1920,0,0
5704,1024,413,1204,1004,38,15,9,180,591,1624,1920,0,0
5705,1026,412,1205,1007,38,15,9,179,595,1625,1920,0,0
5706,1028,409,1208,1011,38,15,9,180,602,1626,1920,0,0
5707,1030,408,1209,1011,38,15,9,179,603,1627,1920,0,0
5708,1029,407,1207,1013,38,15,9,178,606,1628,1920,0,0
5709,1028,413,1201,999,38,15,9,173,586,1629,1920,0,0
5710,1029,414,1201,995,38,15,9,172,581,1630,1920,0,0
5711,1028,415,1200,990,38,15,9,172,575,1631,1920,0,0
5712,1027,409,1202,995,38,15,9,175,586,1632,1920,0,0
5713,1027,412,1201,995,38,15,9,174,583,1633,1920,0,0
5714,1029,408,1206,1005,38,15,9,177,597,1634,1920,0,0
5715,1031,409,1208,1004,38,15,9,177,595,1635,1920,0,0
5716,1033,421,1206,998,38,15,9,173,577,1636,1920,0,0
5717,1037,424,1209,988,38,15,9,172,564,1637,1920,0,0
5718,1037,424,1212,986,38,15,9,175,562,1638,1920,0,0
5719,1035,425,1211,985,38,15,9,176,560,1639,1920,0,0
5720,1029,414,1211,994,38,15,9,182,580,1640,1920,0,0
5721,1025,412,1208,996,38,15,9,183,584,1641,1920,0,0
5722,1026,413,1207,994,38,15,9,181,581,1642,1920,0,0
5723,1027,412,1209,1001,38,15,9,182,589,1643,1920,0,0
5724,1026,413,1205,991,38,15,9,179,578,1644,1920,0,0
5725,1029,422,1209,996,38,15,9,180,574,1645,1920,0,0
5726,1030,417,1212,996,38,15,9,182,579,1646,1920,0,0
5727,1029,415,1210,996,38,15,9,181,581,1647,1920,0,0
5728,1029,414,1211,996,38,15,9,182,582,1648,1920,0,0
5729,1035,419,1220,999,38,15,9,185,580,1649,1920,0,0
5730,1030,420,1214,995,38,15,9,184,575,1650,1920,0,0
5731,1028,420,1210,993,38,15,9,182,573,1651,1920,0,0
5732,1027,424,1209,990,38,15,9,182,566,1652,1920,0,0
5733,1029,428,1211,983,38,15,9,182,555,1653,1920,0,0
5734,1024,430,1207,982,38,15,9,183,552,1654,1920,0,0
5735,1018,425,1204,990,38,15,9,186,565,1655,1920,0,0
5736,1016,421,1206,997,38,15,9,190,576,1656,1920,0,0
5737,1018,423,1204,988,38,15,9,186,565,1657,1920,0,0
5738,1020,421,1205,984,38,15,9,185,563,1658,1920,0,0
5739,1021,419,1206,983,38,15,9,185,564,1659,1920,0,0
5740,1021,418,1207,990,38,15,9,186,572,1660,1920,0,0
5741,1017,412,1208,996,38,15,9,191,584,1661,1920,0,0
5742,1020,420,1210,989,38,15,9,190,569,1662,1920,0,0
5743,1023,428,1212,991,38,15,9,189,563,1663,1920,0,0
5744,1019,418,1210,991,38,15,9,191,573,1664,1920,0,0
5745,1020,413,1209,990,38,15,9,189,577,1665,1920,0,0
5746,1029,417,1212,974,38,15,9,183,557,1666,1920,0,0
5747,1041,418,1228,981,38,15,9,187,563,1667,1920,0,0
5748,1044,420,1233,986,38,15,9,189,566,1668,1920,0,0
5749,1044,421,1233,986,38,15,9,189,565,1669,1920,0,0
5750,1050,427,1234,977,38,15,9,184,550,1670,1920,0,0
5751,1051,431,1235,976,38,15,9,184,545,1671,1920,0,0
5752,1049,425,1239,984,38,15,9,190,559,1672,1920,0,0
5753,1042,422,1236,982,38,15,9,194,560,1673,1920,0,0
5754,1041,419,1238,984,38,15,9,197,565,1674,1920,0,0
5755,1043,420,1244,986,38,15,9,201,566,1675,1920,0,0
5756,1037,418,1241,988,38,15,9,204,570,1676,1920,0,0
5757,1031,414,1237,983,38,15,9,206,569,1677,1920,0,0
5758,1017,411,1222,977,38,15,9,205,566,1678,1920,0,0
5759,1004,409,1207,963,38,15,9,203,554,1679,1920,0,0
5760,1013,414,1220,959,38,15,9,207,545,1680,1920,0,0
5761,1013,424,1219,951,38,15,9,206,527,1681,1920,0,0
5762,1016,435,1223,948,38,15,9,207,513,1682,1920,0,0
5763,1016,445,1230,956,38,15,9,214,511,1683,1920,0,0
5764,1026,446,1244,954,38,15,9,218,508,1684,1920,0,0
5765,1032,448,1254,959,38,15,9,222,511,1685,1920,0,0
5766,1036,451,1261,962,38,15,9,225,511,1686,1920,0,0
5767,1034,449,1262,961,38,15,9,228,512,1687,1920,0,0
5768,1030,449,1262,963,38,15,9,232,514,1688,1920,0,0
5769,1026,449,1259,960,38,15,9,233,511,1689,1920,0,0
5770,1020,450,1257,961,38,15,9,237,511,1690,1920,0,0
5771,1016,452,1255,960,38,15,9,239,508,1691,1920,0,0
5772,1013,452,1254,959,38,15,9,241,507,1692,1920,0,0
5773,1014,452,1257,956,38,15,9,243,504,1693,1920,0,0
5774,1017,452,1260,954,38,15,9,243,502,1694,1920,0,0
5775,1018,451,1262,955,38,15,9,244,504,1695,1920,0,0
5776,1016,451,1262,958,38,15,9,246,507,1696,1920,0,0
5777,1016,451,1265,959,38,15,9,249,508,1697,1920,0,0
5778,1015,451,1266,962,38,15,9,251,511,1698,1920,0,0
5779,1014,452,1265,962,38,15,9,251,510,1699,1920,0,0
5780,1013,451,1264,962,38,15,9,251,511,1700,1920,0,0
5781,1013,450,1264,961,38,15,9,251,511,1701,1920,0,0
5782,1013,451,1263,957,38,15,9,250,506,1702,1920,0,0
5783,1012,449,1263,956,38,15,9,251,507,1703,1920,0,0
5784,1014,452,1265,957,38,15,9,251,505,1704,1920,0,0
5785,1013,452,1265,957,38,15,9,252,505,1705,1920,0,0
5786,1014,454,1269,965,38,15,9,255,511,1706,1920,0,0
5787,1014,453,1268,961,38,15,9,254,508,1707,1920,0,0
5788,1014,454,1267,961,38,15,9,253,507,1708,1920,0,0
5789,1014,454,1267,961,38,15,9,253,507,1709,1920,0,0
5790,1014,455,1266,959,38,15,9,252,504,1710,1920,0,0
5791,1011,451,1267,963,38,15,9,256,512,1711,1920,0,0
5792,1011,456,1262,957,38,15,9,251,501,1712,1920,0,0
5793,1014,457,1264,955,38,15,9,250,498,1713,1920,0,0
5794,1016,457,1265,953,38,15,9,249,496,1714,1920,0,0
5795,1015,457,1265,954,38,15,9,250,497,1715,1920,0,0
5796,1015,455,1271,965,38,15,9,256,510,1716,1920,0,0
5797,1015,454,1273,967,38,15,9,258,513,1717,1920,0,0
5798,1015,454,1273,967,38,15,9,258,513,1718,1920,0,0
5799,1015,453,1273,967,38,15,9,258,514,1719,1920,0,0
5800,1015,453,1269,958,38,15,9,254,505,1720,1920,0,0
5801,1012,452,1268,962,38,15,9,256,510,1721,1920,0,0
5802,1013,451,1270,960,38,15,9,257,509,1722,1920,0,0
5803,1015,453,1268,955,38,15,9,253,502,1723,1920,0,0
5804,1015,453,1267,953,38,15,9,252,500,1724,1920,0,0
5805,1015,452,1268,953,38,15,9,253,501,1725,1920,0,0
5806,1012,451,1269,962,38,15,9,257,511,1726,1920,0,0
5807,1013,450,1271,963,38,15,9,258,513,1727,1920,0,0
5808,1014,450,1271,963,38,15,9,257,513,1728,1920,0,0
5809,1014,456,1268,962,38,15,9,254,506,1729,1920,0,0
5810,1014,453,1268,958,38,15,9,254,505,1730,1920,0,0
5811,1011,451,1268,963,38,15,9,257,512,1731,1920,0,0
5812,1010,450,1268,965,38,15,9,258,515,1732,1920,0,0
5813,1010,452,1266,962,38,15,9,256,510,1733,1920,0,0
5814,1010,452,1265,962,38,15,9,255,510,1734,1920,0,0
5815,1011,452,1266,960,38,15,9,255,508,1735,1920,0,0
5816,1013,452,1266,957,38,15,9,253,505,1736,1920,0,0
5817,1013,452,1265,955,38,15,9,252,503,1737,1920,0,0
5818,1014,452,1266,954,38,15,9,252,502,1738,1920,0,0
5819,1014,452,1265,953,38,15,9,251,501,1739,1920,0,0
5820,1014,453,1265,953,38,15,9,251,500,1740,1920,0,0
5821,1014,451,1267,957,38,15,9,253,506,1741,1920,0,0
5822,1013,451,1267,958,38,15,9,254,507,1742,1920,0,0
5823,1013,451,1267,959,38,15,9,254,508,1743,1920,0,0
5824,1013,450,1267,959,38,15,9,254,509,1744,1920,0,0
5825,1013,450,1267,959,38,15,9,254,509,1745,1920,0,0
5826,1015,454,1266,957,38,15,9,251,503,1746,1920,0,0
5827,1015,456,1265,955,38,15,9,250,499,1747,1920,0,0
5828,1015,457,1266,955,38,15,9,251,498,1748,1920,0,0
5829,1014,457,1265,955,38,15,9,251,498,1749,1920,0,0
5830,1014,457,1265,956,38,15,9,251,499,1750,1920,0,0
5831,1013,453,1266,956,38,15,9,253,503,1751,1920,0,0
5832,1012,452,1266,957,38,15,9,254,505,1752,1920,0,0
5833,1012,451,1266,957,38,15,9,254,506,1753,1920,0,0
5834,1012,451,1266,956,38,15,9,254,505,1754,1920,0,0
5835,1012,452,1265,955,38,15,9,253,503,1755,1920,0,0
5836,1011,452,1267,959,38,15,9,256,507,1756,1920,0,0
5837,1012,453,1271,967,38,15,9,259,514,1757,1920,0,0
5838,1013,453,1269,961,38,15,9,256,508,1758,1920,0,0
5839,1012,452,1267,959,38,15,9,255,507,1759,1920,0,0
5840,1014,456,1267,958,38,15,9,253,502,1760,1920,0,0
5841,1013,453,1267,956,38,15,9,254,503,1761,1920,0,0
5842,1014,456,1266,958,38,15,9,252,502,1762,1920,0,0
5843,1014,453,1268,959,38,15,9,254,506,1763,1920,0,0
5844,1013,452,1268,960,38,15,9,255,508,1764,1920,0,0
5845,1011,451,1266,958,38,15,9,255,507,1765,1920,0,0
5846,1007,450,1266,968,38,15,9,259,518,1766,1920,0,0
5847,1006,451,1267,970,38,15,9,261,519,1767,1920,0,0
5848,1004,451,1263,965,38,15,9,259,514,1768,1920,0,0
5849,1003,451,1261,964,38,15,9,258,513,1769,1920,0,0
5850,1004,451,1263,964,38,15,9,259,513,1770,1920,0,0
5851,1008,452,1266,962,38,15,9,258,510,1771,1920,0,0
5852,1007,451,1266,962,38,15,9,259,511,1772,1920,0,0
5853,1007,450,1266,962,38,15,9,259,512,1773,1920,0,0
5854,1008,449,1267,962,38,15,9,259,513,1774,1920,0,0
5855,1009,449,1267,961,38,15,9,258,512,1775,1920,0,0
5856,1008,449,1266,959,38,15,9,258,510,1776,1920,0,0
5857,1008,450,1266,961,38,15,9,258,511,1777,1920,0,0
5858,1009,451,1266,960,38,15,9,257,509,1778,1920,0,0
5859,1010,451,1268,962,38,15,9,258,511,1779,1920,0,0
5860,1010,451,1269,964,38,15,9,259,513,1780,1920,0,0
5861,1010,452,1269,965,38,15,9,259,513,1781,1920,0,0
5862,1009,450,1269,968,38,15,9,260,518,1782,1920,0,0
5863,1009,451,1269,968,38,15,9,260,517,1783,1920,0,0
5864,1010,451,1268,967,38,15,9,258,516,1784,1920,0,0
5865,1012,452,1268,963,38,15,9,256,511,1785,1920,0,0
5866,1014,456,1267,961,38,15,9,253,505,1786,1920,0,0
5867,1017,456,1267,958,38,15,9,250,502,1787,1920,0,0
5868,1016,455,1267,959,38,15,9,251,504,1788,1920,0,0
5869,1017,456,1267,958,38,15,9,250,502,1789,1920,0,0
5870,1017,457,1266,957,38,15,9,249,500,1790,1920,0,0
5871,1015,455,1266,961,38,15,9,251,506,1791,1920,0,0
5872,1014,454,1266,961,38,15,9,252,507,1792,1920,0,0
5873,1014,454,1266,961,38,15,9,252,507,1793,1920,0,0
5874,1014,455,1265,961,38,15,9,251,506,1794,1920,0,0
5875,1013,456,1264,960,38,15,9,251,504,1795,1920,0,0
5876,1012,455,1264,962,38,15,9,252,507,1796,1920,0,0
5877,1010,456,1262,963,38,15,9,252,507,1797,1920,0,0
5878,1009,454,1262,965,38,15,9,253,511,1798,1920,0,0
5879,1010,452,1263,964,38,15,9,253,512,1799,1920,0,0
5880,1011,452,1265,965,38,15,9,254,513,1800,1920,0,0
5881,1012,454,1264,964,38,15,9,252,510,1801,1920,0,0
5882,1008,452,1263,969,38,15,9,255,517,1802,1920,0,0
5883,1009,453,1263,968,38,15,9,254,515,1803,1920,0,0
5884,1010,453,1264,966,38,15,9,254,513,1804,1920,0,0
5885,1011,453,1265,966,38,15,9,254,513,1805,1920,0,0
5886,1013,453,1264,961,38,15,9,251,508,1806,1920,0,0
5887,1010,456,1261,960,38,15,9,251,504,1807,1920,0,0
5888,1007,459,1254,956,38,15,9,247,497,1808,1920,0,0
5889,1010,458,1258,956,38,15,9,248,498,1809,1920,0,0
5890,1013,459,1259,951,38,15,9,246,492,1810,1920,0,0
5891,1015,459,1262,956,38,15,9,247,497,1811,1920,0,0
5892,1010,457,1259,956,38,15,9,249,499,1812,1920,0,0
5893,1002,451,1256,963,38,15,9,254,512,1813,1920,0,0
5894,1000,447,1257,970,38,15,9,257,523,1814,1920,0,0
5895,1010,450,1259,961,38,15,9,249,511,1815,1920,0,0
5896,1011,448,1259,961,38,15,9,248,513,1816,1920,0,0
5897,1017,449,1265,964,38,15,9,248,515,1817,1920,0,0
5898,1016,446,1261,959,38,15,9,245,513,1818,1920,0,0
5899,1012,445,1256,959,38,15,9,244,514,1819,1920,0,0
5900,1015,444,1256,957,38,15,9,241,513,1820,1920,0,0
5901,1018,445,1258,958,38,15,9,240,513,1821,1920,0,0
5902,1022,451,1258,956,38,15,9,236,505,1822,1920,0,0
5903,1019,447,1255,957,38,15,9,236,510,1823,1920,0,0
5904,1021,447,1257,957,38,15,9,236,510,1824,1920,0,0
5905,1022,446,1257,956,38,15,9,235,510,1825,1920,0,0
5906,1027,445,1262,956,38,15,9,235,511,1826,1920,0,0
5907,1023,447,1260,960,38,15,9,237,513,1827,1920,0,0
5908,1023,447,1260,960,38,15,9,237,513,1828,1920,0,0
5909,1025,447,1263,960,38,15,9,238,513,1829,1920,0,0
5910,1024,447,1263,962,38,15,9,239,515,1830,1920,0,0
5911,1027,450,1267,968,38,15,9,240,518,1831,1920,0,0
5912,1026,448,1266,965,38,15,9,240,517,1832,1920,0,0
5913,1027,448,1265,961,38,15,9,238,513,1833,1920,0,0
5914,1026,446,1268,968,38,15,9,242,522,1834,1920,0,0
5915,1027,446,1267,961,38,15,9,240,515,1835,1920,0,0
5916,1027,448,1264,958,38,15,9,237,510,1836,1920,0,0
5917,1025,448,1264,959,38,15,9,239,511,1837,1920,0,0
5918,1024,450,1265,966,38,15,9,241,516,1838,1920,0,0
5919,1021,450,1264,968,38,15,9,243,518,1839,1920,0,0
5920,1018,451,1259,968,38,15,9,241,517,1840,1920,0,0
5921,1019,446,1262,970,38,15,9,243,524,1841,1920,0,0
5922,1019,447,1260,969,38,15,9,241,522,1842,1920,0,0
5923,1010,437,1252,963,38,15,9,242,526,1843,1920,0,0
5924,996,420,1237,954,38,15,9,241,534,1844,1920,0,0
5925,986,411,1224,957,38,15,9,238,546,1845,1920,0,0
5926,982,406,1217,965,38,15,9,235,559,1846,1920,0,0
5927,979,409,1209,976,38,15,9,230,567,1847,1920,0,0
5928,974,410,1202,984,38,15,9,228,574,1848,1920,0,0
5929,978,413,1201,981,38,15,9,223,568,1849,1920,0,0
5930,980,413,1201,981,38,15,9,221,568,1850,1920,0,0
5931,976,410,1196,984,38,15,9,220,574,1851,1920,0,0
5932,1001,414,1223,980,38,15,9,222,566,1852,1920,0,0
5933,1004,419,1224,981,38,15,9,220,562,1853,1920,0,0
5934,1005,418,1226,981,38,15,9,221,563,1854,1920,0,0
5935,1007,413,1224,960,38,15,9,217,547,1855,1920,0,0
5936,1016,413,1230,943,38,15,9,214,530,1856,1920,0,0
5937,1019,408,1240,944,38,15,9,221,536,1857,1920,0,0
5938,1009,410,1228,941,38,15,9,219,531,1858,1920,0,0
5939,1009,413,1230,944,38,15,9,221,531,1859,1920,0,0
5940,1011,415,1234,939,38,15,9,223,524,1860,1920,0,0
5941,1018,414,1246,943,38,15,9,228,529,1861,1920,0,0
5942,1019,415,1251,943,38,15,9,232,528,1862,1920,0,0
5943,1016,416,1249,941,38,15,9,233,525,1863,1920,0,0
5944,1010,421,1244,948,38,15,9,234,527,1864,1920,0,0
5945,1008,422,1244,948,38,15,9,236,526,1865,1920,0,0
5946,1010,416,1250,946,38,15,9,240,530,1866,1920,0,0
5947,1011,423,1248,943,38,15,9,237,520,1867,1920,0,0
5948,1006,423,1246,942,38,15,9,240,519,1868,1920,0,0
5949,999,423,1244,945,38,15,9,245,522,1869,1920,0,0
5950,996,422,1244,945,38,15,9,248,523,1870,1920,0,0
5951,996,414,1250,949,38,15,9,254,535,1871,1920,0,0
5952,996,415,1250,947,38,15,9,254,532,1872,1920,0,0
5953,996,418,1248,941,38,15,9,252,523,1873,1920,0,0
5954,993,423,1242,940,38,15,9,249,517,1874,1920,0,0
5955,984,417,1234,943,38,15,9,250,526,1875,1920,0,0
5956,982,413,1233,944,38,15,9,251,531,1876,1920,0,0
5957,983,413,1231,945,38,15,9,248,532,1877,1920,0,0
5958,984,417,1230,948,38,15,9,246,531,1878,1920,0,0
5959,990,418,1239,950,38,15,9,249,532,1879,1920,0,0
5960,996,418,1248,956,38,15,9,252,538,1880,1920,0,0
5961,998,418,1249,951,38,15,9,251,533,1881,1920,0,0
5962,993,422,1243,954,38,15,9,250,532,1882,1920,0,0
5963,988,420,1237,951,38,15,9,249,531,1883,1920,0,0
5964,995,419,1247,954,38,15,9,252,535,1884,1920,0,0
5965,991,419,1238,947,38,15,9,247,528,1885,1920,0,0
5966,996,419,1243,939,38,15,9,247,520,1886,1920,0,0
5967,1002,420,1248,936,38,15,9,246,516,1887,1920,0,0
5968,1004,415,1253,937,38,15,9,249,522,1888,1920,0,0
5969,1003,415,1249,933,38,15,9,246,518,1889,1920,0,0
5970,999,422,1244,935,38,15,9,245,513,1890,1920,0,0
5971,1004,426,1249,939,38,15,9,245,513,1891,1920,0,0
5972,1008,426,1255,945,38,15,9,247,519,1892,1920,0,0
5973,1008,427,1253,946,38,15,9,245,519,1893,1920,0,0
5974,1004,419,1250,950,38,15,9,246,531,1894,1920,0,0
5975,1005,422,1246,942,38,15,9,241,520,1895,1920,0,0
5976,988,416,1229,949,38,15,9,241,533,1896,1920,0,0
5977,985,412,1220,946,38,15,9,235,534,1897,1920,0,0
5978,991,415,1220,946,38,15,9,229,531,1898,1920,0,0
5979,1002,417,1233,944,38,15,9,231,527,1899,1920,0,0
5980,1006,417,1239,949,38,15,9,233,532,1900,1920,0,0
5981,1007,423,1248,969,38,15,9,241,546,1901,1920,0,0
5982,1004,420,1251,986,38,15,9,247,566,1902,1920,0,0
5983,994,421,1240,991,38,15,9,246,570,1903,1920,0,0
5984,981,420,1224,994,38,15,9,243,574,1904,1920,0,0
5985,974,418,1213,992,38,15,9,239,574,1905,1920,0,0
5986,976,427,1208,988,38,15,9,232,561,1906,1920,0,0
5987,978,426,1210,988,38,15,9,232,562,1907,1920,0,0
5988,987,422,1218,982,38,15,9,231,560,1908,1920,0,0
5989,995,422,1227,983,38,15,9,232,561,1909,1920,0,0
5990,999,421,1231,982,38,15,9,232,561,1910,1920,0,0
5991,1000,425,1232,985,38,15,9,232,560,1911,1920,0,0
5992,990,424,1223,988,38,15,9,233,564,1912,1920,0,0
5993,981,423,1213,990,38,15,9,232,567,1913,1920,0,0
5994,982,430,1211,990,38,15,9,229,560,1914,1920,0,0
5995,992,428,1224,983,38,15,9,232,555,1915,1920,0,0
5996,1010,425,1248,987,38,15,9,238,562,1916,1920,0,0
5997,1006,418,1248,988,38,15,9,242,570,1917,1920,0,0
5998,986,416,1223,984,38,15,9,237,568,1918,1920,0,0
5999,975,414,1207,985,38,15,9,232,571,1919,1920,0,0
6000,992,415,1218,968,38,15,9,226,553,1920,1920,1,0
4196,1165,489,1246,598,39,15,9,81,109,0,0,0,0
5511,434,87,469,188,41,15,9,35,101,0,29,0,0
5512,432,89,467,190,41,15,9,35,101,1,29,0,0
5514,429,86,465,193,41,15,9,36,107,0,29,0,0
5515,430,86,466,193,41,15,9,36,107,1,29,0,0
5517,431,91,466,196,41,15,9,35,105,0,29,0,0
5518,431,93,466,197,41,15,9,35,104,1,29,0,0
5520,431,95,467,202,41,15,9,36,107,0,29,0,1
5521,433,94,470,204,41,15,9,37,110,1,29,0,0
5522,435,94,471,200,41,15,9,36,106,2,29,0,0
5523,435,90,474,208,41,15,9,39,118,3,29,0,0
5524,435,92,474,210,41,15,9,39,118,4,29,0,0
5525,434,91,473,210,41,15,9,39,119,5,29,0,0
5526,433,89,473,214,41,15,9,40,125,6,29,0,0
5527,433,86,475,218,41,15,9,42,132,7,29,0,0
5528,435,88,477,219,41,15,9,42,131,8,29,0,0
5529,435,91,477,222,41,15,9,42,131,9,29,0,0
5530,435,95,474,220,41,15,9,39,125,10,29,0,0
5531,431,94,472,223,41,15,9,41,129,11,29,0,0
5532,430,94,471,224,41,15,9,41,130,12,29,0,0
5533,431,93,473,227,41,15,9,42,134,13,29,0,0
5534,431,94,473,228,41,15,9,42,134,14,29,0,0
5535,429,97,471,232,41,15,9,42,135,15,29,0,0
5536,428,106,467,231,41,15,9,39,125,16,29,0,0
5537,428,106,466,228,41,15,9,38,122,17,29,0,0
5538,426,103,468,239,41,15,9,42,136,18,29,0,0
5539,428,102,470,240,41,15,9,42,138,19,29,0,0
5540,429,98,473,243,41,15,9,44,145,20,29,0,0
5541,431,107,473,247,41,15,9,42,140,21,29,0,0
5542,430,100,475,250,41,15,9,45,150,22,29,0,0
5543,429,100,476,253,41,15,9,47,153,23,29,0,0
5544,431,90,480,253,41,15,9,49,163,24,29,0,0
5545,436,91,485,254,41,15,9,49,163,25,29,0,0
5546,439,91,489,258,41,15,9,50,167,26,29,0,0
5547,439,90,491,260,41,15,9,52,170,27,29,0,0
5548,438,90,489,259,41,15,9,51,169,28,29,0,0
5549,438,90,490,261,41,15,9,52,171,29,29,1,0
5551,446,104,495,266,41,15,9,49,162,0,29,0,0
5552,452,109,499,263,41,15,9,47,154,1,29,0,0
5553,454,94,506,254,41,15,9,52,160,2,29,0,0
5554,457,93,510,251,41,15,9,53,158,3,29,0,0
5555,453,91,509,255,41,15,9,56,164,4,29,0,0
5556,455,90,510,255,41,15,9,55,165,5,29,0,0
5557,463,113,512,256,41,15,9,49,143,6,29,0,0
5558,473,117,512,220,41,15,9,39,103,7,29,0,0
5559,474,118,513,215,41,15,9,39,97,8,29,0,0
5560,468,105,521,230,41,15,9,53,125,9,29,0,0
5561,470,104,523,229,41,15,9,53,125,10,29,0,0
5570,494,129,539,226,41,15,9,45,97,0,29,0,0
5571,490,134,539,231,41,15,9,49,97,1,29,0,0
5572,492,136,541,231,41,15,9,49,95,2,29,0,0
5529,476,97,511,221,44,15,9,35,124,0,52,0,0
5531,480,99,515,224,44,15,9,35,125,0,52,0,1
5532,482,101,517,224,44,15,9,35,123,1,52,0,0
5533,482,98,519,228,44,15,9,37,130,2,52,0,0
5534,484,97,521,228,44,15,9,37,131,3,52,0,0
5535,486,97,523,231,44,15,9,37,134,4,52,0,0
5536,488,104,524,234,44,15,9,36,130,5,52,0,0
5537,489,109,524,234,44,15,9,35,125,6,52,0,0
5538,490,108,526,236,44,15,9,36,128,7,52,0,0
5539,489,108,527,243,44,15,9,38,135,8,52,0,0
5540,491,110,528,244,44,15,9,37,134,9,52,0,0
5541,492,114,528,244,44,15,9,36,130,10,52,0,0
5542,492,110,530,249,44,15,9,38,139,11,52,0,0
5543,493,114,529,247,44,15,9,36,133,12,52,0,0
5544,495,111,533,249,44,15,9,38,138,13,52,0,0
5545,496,108,536,255,44,15,9,40,147,14,52,0,0
5546,498,108,539,257,44,15,9,41,149,15,52,0,0
5547,502,112,541,256,44,15,9,39,144,16,52,0,0
5548,505,111,546,259,44,15,9,41,148,17,52,0,0
5549,508,111,549,255,44,15,9,41,144,18,52,0,0
5550,512,114,551,252,44,15,9,39,138,19,52,0,0
5551,517,113,555,243,44,15,9,38,130,20,52,0,0
5552,521,116,561,248,44,15,9,40,132,21,52,0,0
5553,522,114,569,271,44,15,9,47,157,22,52,0,0
5554,527,117,573,273,44,15,9,46,156,23,52,0,0
5555,528,116,577,281,44,15,9,49,165,24,52,0,0
5556,529,119,577,277,44,15,9,48,158,25,52,0,0
5557,528,118,575,273,44,15,9,47,155,26,52,0,0
5558,528,121,574,269,44,15,9,46,148,27,52,0,0
5559,530,120,578,274,44,15,9,48,154,28,52,0,0
5560,530,119,581,282,44,15,9,51,163,29,52,0,0
5561,530,120,585,301,44,15,9,55,181,30,52,0,0
5562,530,121,585,307,44,15,9,55,186,31,52,0,0
5563,529,120,585,310,44,15,9,56,190,32,52,0,0
5564,527,123,585,315,44,15,9,58,192,33,52,0,0
5565,527,123,586,324,44,15,9,59,201,34,52,0,0
5566,528,125,588,325,44,15,9,60,200,35,52,0,0
5567,532,124,593,330,44,15,9,61,206,36,52,0,0
5568,533,124,595,335,44,15,9,62,211,37,52,0,0
5571,559,128,625,346,44,15,9,66,218,0,52,0,1
5572,569,130,636,352,44,15,9,67,222,1,52,0,0
5573,579,132,645,352,44,15,9,66,220,2,52,0,0
5574,590,138,653,347,44,15,9,63,209,3,52,0,0
5575,593,141,659,357,44,15,9,66,216,4,52,0,0
5576,596,140,664,362,44,15,9,68,222,5,52,0,0
5577,599,141,669,371,44,15,9,70,230,6,52,0,0
5578,600,141,674,381,44,15,9,74,240,7,52,0,0
5579,602,138,678,385,44,15,9,76,247,8,52,0,0
5580,602,141,679,392,44,15,9,77,251,9,52,0,0
5581,602,143,681,403,44,15,9,79,260,10,52,0,0
5582,606,143,686,405,44,15,9,80,262,11,52,0,0
5583,607,144,687,405,44,15,9,80,261,12,52,0,0
5584,607,147,688,413,44,15,9,81,266,13,52,0,0
5585,608,148,692,419,44,15,9,84,271,14,52,0,0
5586,611,150,696,425,44,15,9,85,275,15,52,0,0
5587,615,153,701,432,44,15,9,86,279,16,52,0,0
5588,615,153,704,449,44,15,9,89,296,17,52,0,0
5589,615,151,707,458,44,15,9,92,307,18,52,0,0
5590,617,151,712,468,44,15,9,95,317,19,52,0,0
5591,622,156,717,476,44,15,9,95,320,20,52,0,0
5592,626,157,724,483,44,15,9,98,326,21,52,0,0
5593,629,161,729,498,44,15,9,100,337,22,52,0,0
5594,629,167,733,518,44,15,9,104,351,23,52,0,0
5595,630,175,735,531,44,15,9,105,356,24,52,0,0
5596,630,178,736,536,44,15,9,106,358,25,52,0,0
5597,628,179,740,554,44,15,9,112,375,26,52,0,0
5598,633,185,749,576,44,15,9,116,391,27,52,0,0
5599,634,189,752,584,44,15,9,118,395,28,52,0,0
5600,636,197,760,613,44,15,9,124,416,29,52,0,0
5601,636,205,767,641,44,15,9,131,436,30,52,0,0
5602,638,205,771,647,44,15,9,133,442,31,52,0,0
5603,636,212,776,673,44,15,9,140,461,32,52,0,0
5604,640,222,786,701,44,15,9,146,479,33,52,0,0
5605,647,226,797,715,44,15,9,150,489,34,52,0,0
5606,647,234,807,757,44,15,9,160,523,35,52,0,0
5607,645,243,812,793,44,15,9,167,550,36,52,0,0
5608,647,247,818,810,44,15,9,171,563,37,52,0,0
5609,646,251,822,834,44,15,9,176,583,38,52,0,0
5610,643,267,829,883,44,15,9,186,616,39,52,0,0
5611,644,281,833,906,44,15,9,189,625,40,52,0,0
5612,642,290,837,937,44,15,9,195,647,41,52,0,0
5613,639,316,847,1009,44,15,9,208,693,42,52,0,0
5614,638,329,853,1039,44,15,9,215,710,43,52,0,0
5615,634,342,852,1060,44,15,9,218,718,44,52,0,0
5616,629,367,847,1074,44,15,9,218,707,45,52,0,0
5617,624,386,843,1080,44,15,9,219,694,46,52,0,0
5618,614,409,835,1080,44,15,9,221,671,47,52,0,0
5619,565,437,786,1080,44,15,9,221,643,48,52,0,0
5620,482,455,704,1080,44,15,9,222,625,49,52,0,0
5621,389,472,611,1077,44,15,9,222,605,50,52,0,0
5622,275,516,493,1077,44,15,9,218,561,51,52,0,0
5623,242,534,458,1080,44,15,9,216,546,52,52,1,0
5489,454,83,489,172,48,15,9,35,89,0,0,0,0
5509,453,89,497,189,50,15,9,44,100,0,0,0,0
5531,0,884,148,1074,54,15,9,148,190,0,59,0,1
5532,0,624,240,1079,54,15,9,240,455,1,59,0,0
5533,0,544,287,1066,54,15,9,287,522,2,59,0,0
5534,0,511,331,1067,54,15,9,331,556,3,59,0,0
5535,0,497,417,1071,54,15,9,417,574,4,59,0,0
5536,70,476,499,1067,54,15,9,429,591,5,59,0,0
5537,161,461,593,1066,54,15,9,432,605,6,59,0,0
5538,231,435,675,1071,54,15,9,444,636,7,59,0,0
5539,296,412,742,1071,54,15,9,446,659,8,59,0,0
5540,354,396,793,1068,54,15,9,439,672,9,59,0,0
5541,381,360,829,1066,54,15,9,448,706,10,59,0,0
5542,455,354,875,1042,54,15,9,420,688,11,59,0,0
5543,499,352,903,1042,54,15,9,404,690,12,59,0,0
5544,549,346,923,1009,54,15,9,374,663,13,59,0,0
5545,589,327,931,954,54,15,9,342,627,14,59,0,0
5546,612,315,933,922,54,15,9,321,607,15,59,0,0
5547,641,317,940,901,54,15,9,299,584,16,59,0,0
5548,663,294,934,842,54,15,9,271,548,17,59,0,0
5549,678,278,931,805,54,15,9,253,527,18,59,0,0
5550,685,275,925,791,54,15,9,240,516,19,59,0,0
5551,699,266,920,758,54,15,9,221,492,20,59,0,0
5552,708,256,912,717,54,15,9,204,461,21,59,0,0
5553,705,249,902,699,54,15,9,197,450,22,59,0,0
5554,697,246,882,677,54,15,9,185,431,23,59,0,0
5555,688,235,862,641,54,15,9,174,406,24,59,0,0
5556,680,231,846,625,54,15,9,166,394,25,59,0,0
5557,673,227,836,621,54,15,9,163,394,26,59,0,0
5558,671,218,820,583,54,15,9,149,365,27,59,0,0
5559,666,209,808,555,54,15,9,142,346,28,59,0,0
5560,653,210,793,551,54,15,9,140,341,29,59,0,0
5561,640,198,776,534,54,15,9,136,336,30,59,0,0
5562,629,194,760,523,54,15,9,131,329,31,59,0,0
5563,620,193,750,521,54,15,9,130,328,32,59,0,0
5564,615,190,740,512,54,15,9,125,322,33,59,0,0
5565,604,182,725,496,54,15,9,121,314,34,59,0,0
5566,582,179,703,490,54,15,9,121,311,35,59,0,0
5567,566,180,687,485,54,15,9,121,305,36,59,0,0
5568,538,168,659,472,54,15,9,121,304,37,59,0,0
5569,516,161,635,465,54,15,9,119,304,38,59,0,0
5570,499,173,613,463,54,15,9,114,290,39,59,0,0
5571,488,169,600,458,54,15,9,112,289,40,59,0,0
5572,471,155,585,452,54,15,9,114,297,41,59,0,0
5573,459,144,574,447,54,15,9,115,303,42,59,0,0
5574,447,151,555,439,54,15,9,108,288,43,59,0,0
5575,428,157,532,433,54,15,9,104,276,44,59,0,0
5576,415,156,516,423,54,15,9,101,267,45,59,0,0
5577,409,155,510,421,54,15,9,101,266,46,59,0,0
5578,407,150,506,416,54,15,9,99,266,47,59,0,0
5579,409,148,504,406,54,15,9,95,258,48,59,0,0
5580,410,149,502,400,54,15,9,92,251,49,59,0,0
5581,407,146,497,393,54,15,9,90,247,50,59,0,0
5582,407,145,492,382,54,15,9,85,237,51,59,0,0
5583,412,142,494,374,54,15,9,82,232,52,59,0,0
5584,414,139,496,372,54,15,9,82,233,53,59,0,0
5585,420,140,499,362,54,15,9,79,222,54,59,0,0
5586,433,141,507,355,54,15,9,74,214,55,59,0,0
5587,443,144,514,352,54,15,9,71,208,56,59,0,0
5588,457,145,518,326,54,15,9,61,181,57,59,0,0
5589,474,145,520,279,54,15,9,46,134,58,59,0,0
5590,478,144,520,263,54,15,9,42,119,59,59,1,0
5596,504,137,543,241,54,15,9,39,104,0,59,0,0
5597,509,135,545,234,54,15,9,36,99,1,59,0,0
5535,32,435,233,987,55,15,9,201,552,0,1,0,0
5536,110,434,284,911,55,15,9,174,477,1,1,0,0
5537,230,401,372,797,56,15,9,142,396,0,53,0,1
5538,283,389,432,805,56,15,9,149,416,1,53,0,0
5539,317,387,516,949,56,15,9,199,562,2,53,0,0
5540,391,358,555,816,56,15,9,164,458,3,53,0,0
5541,439,343,585,748,56,15,9,146,405,4,53,0,0
5542,447,332,643,882,56,15,9,196,550,5,53,0,0
5543,461,311,671,908,56,15,9,210,597,6,53,0,0
5544,480,299,690,901,56,15,9,210,602,7,53,0,0
5545,497,283,696,851,56,15,9,199,568,8,53,0,0
5546,497,273,688,813,56,15,9,191,540,9,53,0,0
5547,496,267,679,784,56,15,9,183,517,10,53,0,0
5548,492,257,665,747,56,15,9,173,490,11,53,0,0
5549,481,243,653,732,56,15,9,172,489,12,53,0,0
5550,473,231,640,714,56,15,9,167,483,13,53,0,0
5551,468,224,624,679,56,15,9,156,455,14,53,0,0
5552,458,223,608,661,56,15,9,150,438,15,53,0,0
5553,450,216,592,633,56,15,9,142,417,16,53,0,0
5554,447,213,584,614,56,15,9,137,401,17,53,0,0
5555,448,207,582,604,56,15,9,134,397,18,53,0,0
5556,452,197,581,579,56,15,9,129,382,19,53,0,0
5557,456,191,580,562,56,15,9,124,371,20,53,0,0
5558,453,185,573,552,56,15,9,120,367,21,53,0,0
5559,452,178,569,534,56,15,9,117,356,22,53,0,0
5560,452,177,567,530,56,15,9,115,353,23,53,0,0
5561,452,166,563,515,56,15,9,111,349,24,53,0,0
5562,448,140,560,499,56,15,9,112,359,25,53,0,0
5563,447,156,550,488,56,15,9,103,332,26,53,0,0
5564,440,154,540,477,56,15,9,100,323,27,53,0,0
5565,435,164,528,467,56,15,9,93,303,28,53,0,0
5566,434,170,522,459,56,15,9,88,289,29,53,0,0
5567,435,167,521,447,56,15,9,86,280,30,53,0,0
5568,432,165,517,443,56,15,9,85,278,31,53,0,0
5569,426,167,509,436,56,15,9,83,269,32,53,0,0
5570,419,164,501,428,56,15,9,82,264,33,53,0,0
5571,415,163,495,425,56,15,9,80,262,34,53,0,0
5572,414,162,492,416,56,15,9,78,254,35,53,0,0
5573,413,159,490,408,56,15,9,77,249,36,53,0,0
5574,408,162,480,399,56,15,9,72,237,37,53,0,0
5575,403,166,469,391,56,15,9,66,225,38,53,0,0
5576,400,166,463,382,56,15,9,63,216,39,53,0,0
5586,416,137,474,337,56,15,9,58,200,0,53,0,1
5587,417,135,473,332,56,15,9,56,197,1,53,0,0
5588,421,137,475,327,56,15,9,54,190,2,53,0,0
5589,428,134,482,329,56,15,9,54,195,3,53,0,0
5590,428,129,485,330,56,15,9,57,201,4,53,0,0
5591,426,127,482,324,56,15,9,56,197,5,53,0,0
5592,424,124,482,320,56,15,9,58,196,6,53,0,0
5593,424,122,480,311,56,15,9,56,189,7,53,0,0
5594,426,120,481,306,56,15,9,55,186,8,53,0,0
5595,429,117,484,304,56,15,9,55,187,9,53,0,0
5596,431,115,486,302,56,15,9,55,187,10,53,0,0
5597,433,117,486,300,56,15,9,53,183,11,53,0,0
5598,433,120,484,295,56,15,9,51,175,12,53,0,0
5599,433,116,485,293,56,15,9,52,177,13,53,0,0
5600,435,117,486,291,56,15,9,51,174,14,53,0,0
5601,440,117,489,283,56,15,9,49,166,15,53,0,0
5602,443,116,492,279,56,15,9,49,163,16,53,0,0
5603,440,115,490,278,56,15,9,50,163,17,53,0,0
5604,441,116,488,272,56,15,9,47,156,18,53,0,0
5605,439,111,487,269,56,15,9,48,158,19,53,0,0
5606,441,110,487,263,56,15,9,46,153,20,53,0,0
5607,441,107,488,263,56,15,9,47,156,21,53,0,0
5608,440,109,486,261,56,15,9,46,152,22,53,0,0
5609,438,110,483,257,56,15,9,45,147,23,53,0,0
5610,435,111,480,255,56,15,9,45,144,24,53,0,0
5611,434,111,479,254,56,15,9,45,143,25,53,0,0
5612,432,100,480,255,56,15,9,48,155,26,53,0,0
5613,433,107,477,251,56,15,9,44,144,27,53,0,0
5614,430,102,476,250,56,15,9,46,148,28,53,0,0
5615,429,103,475,247,56,15,9,46,144,29,53,0,0
5616,429,106,472,243,56,15,9,43,137,30,53,0,0
5617,431,103,475,243,56,15,9,44,140,31,53,0,0
5618,430,96,475,241,56,15,9,45,145,32,53,0,0
5619,430,100,474,241,56,15,9,44,141,33,53,0,0
5620,430,100,472,237,56,15,9,42,137,34,53,0,0
5621,431,102,471,233,56,15,9,40,131,35,53,0,0
5622,433,102,472,231,56,15,9,39,129,36,53,0,0
5623,434,102,472,227,56,15,9,38,125,37,53,0,0
5624,434,101,472,226,56,15,9,38,125,38,53,0,0
5625,433,100,471,224,56,15,9,38,124,39,53,0,0
5626,433,102,470,221,56,15,9,37,119,40,53,0,0
5627,436,102,472,218,56,15,9,36,116,41,53,0,0
5628,438,99,474,217,56,15,9,36,118,42,53,0,0
5629,437,98,473,218,56,15,9,36,120,43,53,0,0
5630,436,98,472,216,56,15,9,36,118,44,53,0,0
5631,434,100,469,214,56,15,9,35,114,45,53,0,0
5632,435,100,470,212,56,15,9,35,112,46,53,0,0
5633,435,93,473,212,56,15,9,38,119,47,53,0,0
5634,436,95,473,211,56,15,9,37,116,48,53,0,0
5635,435,95,471,208,56,15,9,36,113,49,53,0,0
5636,434,94,470,206,56,15,9,36,112,50,53,0,0
5637,435,94,471,205,56,15,9,36,111,51,53,0,0
5638,436,93,471,203,56,15,9,35,110,52,53,0,0
5639,437,94,472,201,56,15,9,35,107,53,53,1,0
5569,540,123,613,235,57,15,9,73,112,0,1,0,0
5570,540,123,632,267,57,15,9,92,144,1,1,0,0
5569,481,137,534,316,58,15,9,53,179,0,0,0,0
5575,502,133,567,371,59,15,9,65,238,0,51,0,1
5576,512,132,577,368,59,15,9,65,236,1,51,0,0
5577,520,132,584,365,59,15,9,64,233,2,51,0,0
5578,521,137,586,376,59,15,9,65,239,3,51,0,0
5579,521,139,588,382,59,15,9,67,243,4,51,0,0
5580,520,139,589,388,59,15,9,69,249,5,51,0,0
5581,520,144,591,398,59,15,9,71,254,6,51,0,0
5582,523,143,596,401,59,15,9,73,258,7,51,0,0
5583,523,141,600,408,59,15,9,77,267,8,51,0,0
5584,519,149,597,416,59,15,9,78,267,9,51,0,0
5585,508,149,589,428,59,15,9,81,279,10,51,0,0
5586,500,152,582,432,59,15,9,82,280,11,51,0,0
5587,492,152,579,448,59,15,9,87,296,12,51,0,0
5588,494,155,582,454,59,15,9,88,299,13,51,0,0
5589,495,155,586,461,59,15,9,91,306,14,51,0,0
5590,494,162,588,474,59,15,9,94,312,15,51,0,0
5591,488,163,585,484,59,15,9,97,321,16,51,0,0
5592,484,160,584,492,59,15,9,100,332,17,51,0,0
5593,483,164,587,510,59,15,9,104,346,18,51,0,0
5594,487,169,592,522,59,15,9,105,353,19,51,0,0
5595,490,170,597,531,59,15,9,107,361,20,51,0,0
5596,489,173,599,547,59,15,9,110,374,21,51,0,0
5597,479,174,594,562,59,15,9,115,388,22,51,0,0
5598,470,179,586,571,59,15,9,116,392,23,51,0,0
5599,463,188,583,593,59,15,9,120,405,24,51,0,0
5600,459,192,584,617,59,15,9,125,425,25,51,0,0
5601,460,201,585,624,59,15,9,125,423,26,51,0,0
5602,457,215,586,649,59,15,9,129,434,27,51,0,0
5603,446,224,579,671,59,15,9,133,447,28,51,0,0
5604,434,225,573,685,59,15,9,139,460,29,51,0,0
5605,427,232,571,704,59,15,9,144,472,30,51,0,0
5606,427,246,576,731,59,15,9,149,485,31,51,0,0
5607,430,249,585,747,59,15,9,155,498,32,51,0,0
5608,428,258,594,788,59,15,9,166,530,33,51,0,0
5609,421,269,591,811,59,15,9,170,542,34,51,0,0
5610,414,275,590,829,59,15,9,176,554,35,51,0,0
5611,407,281,598,878,59,15,9,191,597,36,51,0,0
5612,408,293,611,924,59,15,9,203,631,37,51,0,0
5613,415,305,622,943,59,15,9,207,638,38,51,0,0
5614,409,315,627,992,59,15,9,218,677,39,51,0,0
5615,392,326,616,1015,59,15,9,224,689,40,51,0,0
5616,370,337,597,1025,59,15,9,227,688,41,51,0,0
5617,336,351,565,1038,59,15,9,229,687,42,51,0,0
5618,303,380,539,1068,59,15,9,236,688,43,51,0,0
5619,263,400,502,1074,59,15,9,239,674,44,51,0,0
5620,205,415,450,1080,59,15,9,245,665,45,51,0,0
5621,150,448,400,1080,59,15,9,250,632,46,51,0,0
5622,50,452,300,1080,59,15,9,250,628,47,51,0,0
5623,63,533,295,1080,59,15,9,232,547,48,51,0,0
5624,29,569,252,1080,59,15,9,223,511,49,51,0,0
5625,0,667,177,1080,59,15,9,177,413,50,51,0,0
5626,0,701,142,1080,59,15,9,142,379,51,51,1,0
5594,494,140,543,254,60,15,9,49,114,0,1,0,0
5595,496,133,544,247,60,15,9,48,114,1,1,0,0
5604,508,118,556,231,61,15,9,48,113,0,0,0,0
5606,505,115,549,253,62,15,9,44,138,0,19,0,1
5607,506,117,546,240,62,15,9,40,123,1,19,0,0
5608,502,115,545,250,62,15,9,43,135,2,19,0,0
5609,502,116,546,255,62,15,9,44,139,3,19,0,0
5610,504,112,549,255,62,15,9,45,143,4,19,0,0
5611,505,113,550,253,62,15,9,45,140,5,19,0,0
5612,506,112,551,255,62,15,9,45,143,6,19,0,0
5613,502,113,545,249,62,15,9,43,136,7,19,0,0
5614,500,115,543,248,62,15,9,43,133,8,19,0,0
5615,498,114,539,245,62,15,9,41,131,9,19,0,0
5616,498,115,539,243,62,15,9,41,128,10,19,0,0
5617,495,110,537,242,62,15,9,42,132,11,19,0,0
5618,494,111,535,242,62,15,9,41,131,12,19,0,0
5619,491,112,530,241,62,15,9,39,129,13,19,0,0
5620,490,114,527,235,62,15,9,37,121,14,19,0,0
5621,489,114,526,236,62,15,9,37,122,15,19,0,0
5622,487,110,525,237,62,15,9,38,127,16,19,0,0
5623,489,111,525,230,62,15,9,36,119,17,19,0,0
5624,489,111,524,228,62,15,9,35,117,18,19,0,0
5625,487,109,522,227,62,15,9,35,118,19,19,0,0
5623,2,574,126,1072,63,15,9,124,498,0,0,0,0
5766,1188,446,1274,654,66,15,9,86,208,0,0,0,0
5771,1190,453,1266,655,67,15,9,76,202,0,14,0,0
5772,1190,453,1266,655,67,15,9,76,202,1,14,0,0
5773,1190,452,1266,654,67,15,9,76,202,2,14,0,0
5774,1190,451,1266,654,67,15,9,76,203,3,14,0,0
5775,1190,449,1266,654,67,15,9,76,205,4,14,0,0
5776,1190,447,1267,654,67,15,9,77,207,5,14,0,0
5777,1194,455,1268,652,67,15,9,74,197,6,14,0,0
5778,1196,460,1267,649,67,15,9,71,189,7,14,0,0
5779,1197,459,1268,652,67,15,9,71,193,8,14,0,0
5780,1192,460,1263,651,67,15,9,71,191,9,14,0,0
5781,1190,452,1264,652,67,15,9,74,200,10,14,0,0
5782,1192,457,1264,652,67,15,9,72,195,11,14,0,0
5783,1191,449,1266,652,67,15,9,75,203,12,14,0,0
5784,1187,444,1265,653,67,15,9,78,209,13,14,0,0
5785,1187,443,1265,654,67,15,9,78,211,14,14,0,0
5811,1188,461,1260,649,67,15,9,72,188,0,14,0,0
5812,1187,461,1261,649,67,15,9,74,188,1,14,0,0
5813,1187,462,1260,649,67,15,9,73,187,2,14,0,0
5861,1189,471,1263,650,68,15,9,74,179,0,0,0,0
5866,1192,461,1261,648,69,15,9,69,187,0,6,0,0
5867,1191,461,1261,648,69,15,9,70,187,1,6,0,0
5868,1192,460,1261,649,69,15,9,69,189,2,6,0,0
5869,1192,467,1260,649,69,15,9,68,182,3,6,0,0
5870,1193,470,1259,649,69,15,9,66,179,4,6,0,0
5871,1193,473,1259,649,69,15,9,66,176,5,6,0,0
5875,1189,464,1259,650,69,15,9,70,186,0,6,0,0
5876,1190,459,1261,649,69,15,9,71,190,1,6,0,0
5877,1190,463,1260,647,69,15,9,70,184,2,6,0,0
5878,1189,455,1261,649,69,15,9,72,194,3,6,0,0
5879,1188,455,1261,650,69,15,9,73,195,4,6,0,0
5880,1186,450,1261,652,69,15,9,75,202,5,6,0,0
5881,1185,448,1261,652,69,15,9,76,204,6,6,0,0
5886,1190,453,1261,644,69,15,9,71,191,0,6,0,0
5887,1185,445,1261,647,69,15,9,76,202,1,6,0,0
5888,1180,444,1256,645,69,15,9,76,201,2,6,0,0
5889,1179,443,1255,645,69,15,9,76,202,3,6,0,0
4606,1620,161,1658,280,1,17,1,38,119,0,67,0,1
4607,1605,157,1646,282,1,17,1,41,125,1,67,0,0
4608,1594,156,1635,284,1,17,1,41,128,2,67,0,0
4609,1572,152,1616,288,1,17,1,44,136,3,67,0,0
4610,1565,152,1612,292,1,17,1,47,140,4,67,0,0
4611,1561,155,1607,293,1,17,1,46,138,5,67,0,0
4612,1551,156,1598,298,1,17,1,47,142,6,67,0,0
4613,1542,158,1589,297,1,17,1,47,139,7,67,0,0
4614,1531,156,1581,303,1,17,1,50,147,8,67,0,0
4615,1526,158,1577,309,1,17,1,51,151,9,67,0,0
4616,1522,158,1574,309,1,17,1,52,151,10,67,0,0
4617,1516,157,1569,313,1,17,1,53,156,11,67,0,0
4618,1508,155,1563,318,1,17,1,55,163,12,67,0,0
4619,1499,155,1555,321,1,17,1,56,166,13,67,0,0
4620,1495,158,1552,327,1,17,1,57,169,14,67,0,0
4621,1490,160,1549,330,1,17,1,59,170,15,67,0,0
4622,1484,160,1543,333,1,17,1,59,173,16,67,0,0
4623,1476,164,1536,338,1,17,1,60,174,17,67,0,0
4624,1465,165,1524,337,1,17,1,59,172,18,67,0,0
4625,1453,166,1514,342,1,17,1,61,176,19,67,0,0
4626,1445,166,1506,344,1,17,1,61,178,20,67,0,0
4627,1431,167,1492,345,1,17,1,61,178,21,67,0,0
4628,1413,167,1477,352,1,17,1,64,185,22,67,0,0
4629,1400,166,1466,355,1,17,1,66,189,23,67,0,0
4630,1385,167,1450,355,1,17,1,65,188,24,67,0,0
4631,1372,171,1437,358,1,17,1,65,187,25,67,0,0
4632,1361,172,1427,359,1,17,1,66,187,26,67,0,0
4633,1353,173,1418,358,1,17,1,65,185,27,67,0,0
4634,1340,174,1407,365,1,17,1,67,191,28,67,0,0
4635,1326,174,1396,370,1,17,1,70,196,29,67,0,0
4636,1317,173,1393,380,1,17,1,76,207,30,67,0,0
4637,1315,174,1392,384,1,17,1,77,210,31,67,0,0
4638,1314,175,1393,388,1,17,1,79,213,32,67,0,0
4639,1312,178,1393,395,1,17,1,81,217,33,67,0,0
4640,1311,183,1392,399,1,17,1,81,216,34,67,0,0
4641,1312,185,1395,407,1,17,1,83,222,35,67,0,0
4642,1319,188,1405,416,1,17,1,86,228,36,67,0,0
4643,1330,192,1416,421,1,17,1,86,229,37,67,0,0
4644,1336,193,1424,432,1,17,1,88,239,38,67,0,0
4645,1340,196,1429,439,1,17,1,89,243,39,67,0,0
4646,1342,196,1431,442,1,17,1,89,246,40,67,0,0
4647,1344,199,1438,457,1,17,1,94,258,41,67,0,0
4648,1346,201,1442,463,1,17,1,96,262,42,67,0,0
4649,1340,205,1436,469,1,17,1,96,264,43,67,0,0
4650,1333,207,1430,474,1,17,1,97,267,44,67,0,0
4651,1316,207,1414,479,1,17,1,98,272,45,67,0,0
4652,1309,208,1406,480,1,17,1,97,272,46,67,0,0
4653,1306,208,1402,481,1,17,1,96,273,47,67,0,0
4654,1304,208,1400,481,1,17,1,96,273,48,67,0,0
4655,1302,208,1399,481,1,17,1,97,273,49,67,0,0
4656,1301,208,1398,481,1,17,1,97,273,50,67,0,0
4657,1300,207,1396,479,1,17,1,96,272,51,67,0,0
4658,1299,208,1396,480,1,17,1,97,272,52,67,0,0
4659,1298,207,1395,480,1,17,1,97,273,53,67,0,0
4660,1297,207,1394,480,1,17,1,97,273,54,67,0,0
4661,1299,206,1395,478,1,17,1,96,272,55,67,0,0
4662,1304,206,1397,475,1,17,1,93,269,56,67,0,0
4663,1304,206,1395,469,1,17,1,91,263,57,67,0,0
4664,1300,206,1389,462,1,17,1,89,256,58,67,0,0
4665,1290,207,1379,458,1,17,1,89,251,59,67,0,0
4666,1276,207,1362,447,1,17,1,86,240,60,67,0,0
4667,1264,202,1351,447,1,17,1,87,245,61,67,0,0
4668,1259,202,1344,445,1,17,1,85,243,62,67,0,0
4669,1255,199,1340,444,1,17,1,85,245,63,67,0,0
4670,1255,197,1336,434,1,17,1,81,237,64,67,0,0
4671,1252,196,1332,435,1,17,1,80,239,65,67,0,0
4672,1250,197,1327,433,1,17,1,77,236,66,67,0,0
4673,1246,197,1322,431,1,17,1,76,234,67,67,1,0
5224,1579,158,1616,288,2,17,1,37,130,0,23,0,1
5225,1568,161,1604,287,2,17,1,36,126,1,23,0,0
5226,1554,161,1594,295,2,17,1,40,134,2,23,0,0
5227,1543,160,1584,297,2,17,1,41,137,3,23,0,0
5228,1534,164,1576,303,2,17,1,42,139,4,23,0,0
5229,1525,163,1569,303,2,17,1,44,140,5,23,0,0
5230,1516,164,1561,308,2,17,1,45,144,6,23,0,0
5231,1507,168,1553,310,2,17,1,46,142,7,23,0,0
5232,1499,168,1546,311,2,17,1,47,143,8,23,0,0
5233,1491,169,1541,320,2,17,1,50,151,9,23,0,0
5234,1478,169,1531,324,2,17,1,53,155,10,23,0,0
5235,1466,169,1520,329,2,17,1,54,160,11,23,0,0
5236,1454,171,1507,328,2,17,1,53,157,12,23,0,0
5237,1439,169,1495,332,2,17,1,56,163,13,23,0,0
5238,1426,172,1482,336,2,17,1,56,164,14,23,0,0
5239,1406,179,1462,340,2,17,1,56,161,15,23,0,0
5240,1387,175,1446,344,2,17,1,59,169,16,23,0,0
5241,1365,174,1423,343,2,17,1,58,169,17,23,0,0
5242,1344,173,1401,341,2,17,1,57,168,18,23,0,0
5243,1319,176,1376,340,2,17,1,57,164,19,23,0,0
5244,1298,178,1355,341,2,17,1,57,163,20,23,0,0
5245,1271,177,1329,343,2,17,1,58,166,21,23,0,0
5246,1257,181,1314,347,2,17,1,57,166,22,23,0,0
5247,1240,182,1298,350,2,17,1,58,168,23,23,1,0
5657,1262,189,1333,405,3,17,1,71,216,0,47,0,1
5658,1262,185,1334,405,3,17,1,72,220,1,47,0,0
5659,1272,187,1343,400,3,17,1,71,213,2,47,0,0
5660,1292,191,1364,408,3,17,1,72,217,3,47,0,0
5661,1301,193,1377,421,3,17,1,76,228,4,47,0,0
5662,1307,193,1386,425,3,17,1,79,232,5,47,0,0
5663,1322,196,1403,433,3,17,1,81,237,6,47,0,0
5664,1330,199,1414,443,3,17,1,84,244,7,47,0,0
5665,1347,198,1434,452,3,17,1,87,254,8,47,0,0
5666,1361,199,1451,458,3,17,1,90,259,9,47,0,0
5667,1368,204,1465,480,3,17,1,97,276,10,47,0,0
5668,1373,206,1473,488,3,17,1,100,282,11,47,0,0
5669,1377,209,1480,499,3,17,1,103,290,12,47,0,0
5670,1386,216,1491,511,3,17,1,105,295,13,47,0,0
5671,1397,218,1505,516,3,17,1,108,298,14,47,0,0
5672,1403,220,1514,525,3,17,1,111,305,15,47,0,0
5673,1403,226,1519,544,3,17,1,116,318,16,47,0,0
5674,1398,227,1517,554,3,17,1,119,327,17,47,0,0
5675,1395,230,1517,560,3,17,1,122,330,18,47,0,0
5676,1394,234,1521,575,3,17,1,127,341,19,47,0,0
5677,1395,239,1527,593,3,17,1,132,354,20,47,0,0
5678,1398,240,1533,604,3,17,1,135,364,21,47,0,0
5679,1395,248,1533,616,3,17,1,138,368,22,47,0,0
5680,1383,257,1526,637,3,17,1,143,380,23,47,0,0
5681,1370,258,1518,651,3,17,1,148,393,24,47,0,0
5682,1362,265,1516,671,3,17,1,154,406,25,47,0,0
5683,1354,277,1513,696,3,17,1,159,419,26,47,0,0
5684,1352,283,1514,708,3,17,1,162,425,27,47,0,0
5685,1336,293,1505,729,3,17,1,169,436,28,47,0,0
5686,1317,305,1492,756,3,17,1,175,451,29,47,0,0
5687,1294,311,1473,770,3,17,1,179,459,30,47,0,0
5688,1272,320,1465,814,3,17,1,193,494,31,47,0,0
5689,1257,331,1465,861,3,17,1,208,530,32,47,0,0
5690,1249,338,1463,880,3,17,1,214,542,33,47,0,0
5691,1235,351,1457,910,3,17,1,222,559,34,47,0,0
5692,1207,377,1442,969,3,17,1,235,592,35,47,0,0
5693,1176,395,1419,1009,3,17,1,243,614,36,47,0,0
5694,1139,414,1391,1053,3,17,1,252,639,37,47,0,0
5695,1119,443,1368,1074,3,17,1,249,631,38,47,0,0
5696,1105,473,1352,1080,3,17,1,247,607,39,47,0,0
5697,1086,500,1330,1080,3,17,1,244,580,40,47,0,0
5698,1048,542,1283,1080,3,17,1,235,538,41,47,0,0
5699,991,575,1222,1080,3,17,1,231,505,42,47,0,0
5700,948,622,1172,1080,3,17,1,224,458,43,47,0,0
5701,920,696,1127,1080,3,17,1,207,384,44,47,0,0
5702,879,762,1073,1080,3,17,1,194,318,45,47,0,0
5703,834,835,1009,1080,3,17,1,175,245,46,47,0,0
5704,812,877,963,1080,3,17,1,151,203,47,47,1,0
408,29,292,99,567,1,17,10,70,275,0,46,0,1
409,24,273,101,575,1,17,10,77,302,1,46,0,0
410,35,272,110,569,1,17,10,75,297,2,46,0,0
411,57,274,120,522,1,17,10,63,248,3,46,0,0
412,71,266,138,526,1,17,10,67,260,4,46,0,0
413,83,266,152,530,1,17,10,69,264,5,46,0,0
414,95,265,158,503,1,17,10,63,238,6,46,0,0
415,101,260,166,506,1,17,10,65,246,7,46,0,0
416,111,260,174,501,1,17,10,63,241,8,46,0,0
417,120,253,185,494,1,17,10,65,241,9,46,0,0
418,128,251,192,488,1,17,10,64,237,10,46,0,0
419,131,248,198,490,1,17,10,67,242,11,46,0,0
420,137,243,202,478,1,17,10,65,235,12,46,0,0
421,142,244,206,477,1,17,10,64,233,13,46,0,0
422,149,240,211,466,1,17,10,62,226,14,46,0,0
423,153,237,214,457,1,17,10,61,220,15,46,0,0
424,155,234,216,453,1,17,10,61,219,16,46,0,0
425,157,231,216,440,1,17,10,59,209,17,46,0,0
426,160,232,217,436,1,17,10,57,204,18,46,0,0
427,164,231,221,430,1,17,10,57,199,19,46,0,0
428,168,228,223,421,1,17,10,55,193,20,46,0,0
429,168,228,223,417,1,17,10,55,189,21,46,0,0
430,169,226,221,404,1,17,10,52,178,22,46,0,0
431,169,225,220,401,1,17,10,51,176,23,46,0,0
432,170,225,220,400,1,17,10,50,175,24,46,0,0
433,171,223,220,394,1,17,10,49,171,25,46,0,0
434,171,224,219,390,1,17,10,48,166,26,46,0,0
435,170,220,218,387,1,17,10,48,167,27,46,0,0
436,170,219,217,384,1,17,10,47,165,28,46,0,0
437,170,220,216,381,1,17,10,46,161,29,46,0,0
438,170,216,215,374,1,17,10,45,158,30,46,0,0
439,168,216,214,377,1,17,10,46,161,31,46,0,0
440,166,213,211,373,1,17,10,45,160,32,46,0,0
441,164,211,208,366,1,17,10,44,155,33,46,0,0
442,162,211,206,362,1,17,10,44,151,34,46,0,0
443,161,211,204,358,1,17,10,43,147,35,46,0,0
444,161,210,203,354,1,17,10,42,144,36,46,0,0
445,158,211,201,355,1,17,10,43,144,37,46,0,0
446,156,210,197,350,1,17,10,41,140,38,46,0,0
447,154,211,193,341,1,17,10,39,130,39,46,0,0
448,154,211,192,340,1,17,10,38,129,40,46,0,0
449,153,210,191,336,1,17,10,38,126,41,46,0,0
450,154,212,190,328,1,17,10,36,116,42,46,0,0
451,152,210,189,330,1,17,10,37,120,43,46,0,0
452,151,211,187,328,1,17,10,36,117,44,46,0,0
453,151,210,188,329,1,17,10,37,119,45,46,0,0
454,150,208,187,327,1,17,10,37,119,46,46,1,0
456,146,208,182,318,1,17,10,36,110,0,46,0,0
458,144,204,179,312,1,17,10,35,108,0,46,0,0
459,142,201,179,319,1,17,10,37,118,1,46,0,0
462,139,199,175,313,1,17,10,36,114,0,46,0,0
2011,890,412,1009,739,2,17,10,119,327,0,56,0,1
2012,885,405,1008,745,2,17,10,123,340,1,56,0,0
2013,843,410,977,777,2,17,10,134,367,2,56,0,0
2014,796,406,934,785,2,17,10,138,379,3,56,0,0
2015,723,402,866,789,2,17,10,143,387,4,56,0,0
2016,671,398,819,791,2,17,10,148,393,5,56,0,0
2017,607,384,754,782,2,17,10,147,398,6,56,0,0
2018,538,384,686,771,2,17,10,148,387,7,56,0,0
2019,486,377,630,753,2,17,10,144,376,8,56,0,0
2020,406,365,553,744,2,17,10,147,379,9,56,0,0
2021,353,360,501,735,2,17,10,148,375,10,56,0,0
2022,320,347,462,715,2,17,10,142,368,11,56,0,0
2023,288,346,426,702,2,17,10,138,356,12,56,0,0
2024,256,333,389,685,2,17,10,133,352,13,56,0,0
2025,207,327,341,675,2,17,10,134,348,14,56,0,0
2026,181,321,312,653,2,17,10,131,332,15,56,0,0
2027,175,311,298,630,2,17,10,123,319,16,56,0,0
2028,164,311,278,612,2,17,10,114,301,17,56,0,0
2029,143,303,252,589,2,17,10,109,286,18,56,0,0
2030,125,301,234,586,2,17,10,109,285,19,56,0,0
2031,120,296,222,565,2,17,10,102,269,20,56,0,0
2032,121,293,218,554,2,17,10,97,261,21,56,0,0
2033,112,285,204,536,2,17,10,92,251,22,56,0,0
2034,98,283,186,522,2,17,10,88,239,23,56,0,0
2035,94,285,178,513,2,17,10,84,228,24,56,0,0
2036,93,274,175,502,2,17,10,82,228,25,56,0,0
2037,91,274,169,493,2,17,10,78,219,26,56,0,0
2038,83,268,157,480,2,17,10,74,212,27,56,0,0
2039,77,268,148,474,2,17,10,71,206,28,56,0,0
2040,76,265,144,462,2,17,10,68,197,29,56,0,0
2041,78,266,142,455,2,17,10,64,189,30,56,0,0
2042,75,262,138,449,2,17,10,63,187,31,56,0,0
2043,72,258,133,439,2,17,10,61,181,32,56,0,0
2044,72,257,132,437,2,17,10,60,180,33,56,0,0
2045,72,252,130,426,2,17,10,58,174,34,56,0,0
2046,72,255,128,424,2,17,10,56,169,35,56,0,0
2047,69,246,125,416,2,17,10,56,170,36,56,0,0
2048,71,244,125,409,2,17,10,54,165,37,56,0,0
2049,73,243,125,399,2,17,10,52,156,38,56,0,0
2050,75,240,126,394,2,17,10,51,154,39,56,0,0
2051,77,240,126,391,2,17,10,49,151,40,56,0,0
2052,77,238,125,383,2,17,10,48,145,41,56,0,0
2053,78,238,125,380,2,17,10,47,142,42,56,0,0
2054,81,238,125,373,2,17,10,44,135,43,56,0,0
2055,84,238,127,371,2,17,10,43,133,44,56,0,0
2056,83,237,125,367,2,17,10,42,130,45,56,0,0
2057,82,236,122,358,2,17,10,40,122,46,56,0,0
2058,81,234,120,353,2,17,10,39,119,47,56,0,0
2059,81,230,120,351,2,17,10,39,121,48,56,0,0
2060,81,231,119,348,2,17,10,38,117,49,56,0,0
2061,81,230,118,342,2,17,10,37,112,50,56,0,0
2062,84,229,120,338,2,17,10,36,109,51,56,0,0
2063,86,220,124,336,2,17,10,38,116,52,56,0,0
2064,89,218,126,330,2,17,10,37,112,53,56,0,0
2065,92,216,128,326,2,17,10,36,110,54,56,0,0
2066,93,213,129,321,2,17,10,36,108,55,56,0,0
2067,96,210,132,317,2,17,10,36,107,56,56,1,0
2164,546,276,635,501,4,17,10,89,225,0,41,0,1
2165,535,271,623,495,4,17,10,88,224,1,41,0,0
2166,499,273,589,501,4,17,10,90,228,2,41,0,0
2167,478,272,567,497,4,17,10,89,225,3,41,0,0
2168,449,265,538,493,4,17,10,89,228,4,41,0,0
2169,409,265,499,492,4,17,10,90,227,5,41,0,0
2170,386,263,478,492,4,17,10,92,229,6,41,0,0
2171,368,258,457,485,4,17,10,89,227,7,41,0,0
2172,349,258,435,480,4,17,10,86,222,8,41,0,0
2173,327,254,408,469,4,17,10,81,215,9,41,0,0
2174,303,252,385,469,4,17,10,82,217,10,41,0,0
2175,280,253,363,466,4,17,10,83,213,11,41,0,0
2176,263,249,346,465,4,17,10,83,216,12,41,0,0
2177,249,247,330,460,4,17,10,81,213,13,41,0,0
2178,237,241,317,455,4,17,10,80,214,14,41,0,0
2179,223,241,298,443,4,17,10,75,202,15,41,0,0
2180,205,238,280,438,4,17,10,75,200,16,41,0,0
2181,194,238,268,438,4,17,10,74,200,17,41,0,0
2182,183,234,257,432,4,17,10,74,198,18,41,0,0
2183,179,233,250,426,4,17,10,71,193,19,41,0,0
2184,173,233,244,426,4,17,10,71,193,20,41,0,0
2185,164,229,234,421,4,17,10,70,192,21,41,0,0
2186,155,228,223,416,4,17,10,68,188,22,41,0,0
2187,147,232,212,414,4,17,10,65,182,23,41,0,0
2188,145,232,209,409,4,17,10,64,177,24,41,0,0
2189,143,234,204,406,4,17,10,61,172,25,41,0,0
2190,141,233,201,401,4,17,10,60,168,26,41,0,0
2191,134,230,193,396,4,17,10,59,166,27,41,0,0
2192,128,231,186,394,4,17,10,58,163,28,41,0,0
2193,122,230,177,389,4,17,10,55,159,29,41,0,0
2194,119,230,174,387,4,17,10,55,157,30,41,0,0
2195,116,233,167,379,4,17,10,51,146,31,41,0,0
2196,110,230,160,374,4,17,10,50,144,32,41,0,0
2197,101,225,153,377,4,17,10,52,152,33,41,0,0
2198,94,226,144,372,4,17,10,50,146,34,41,0,0
2199,87,225,135,369,4,17,10,48,144,35,41,0,0
2200,83,218,132,361,4,17,10,49,143,36,41,0,0
2201,77,222,125,361,4,17,10,48,139,37,41,0,0
2202,68,221,115,360,4,17,10,47,139,38,41,0,0
2203,57,224,104,361,4,17,10,47,137,39,41,0,0
2204,50,222,95,360,4,17,10,45,138,40,41,0,0
2205,42,221,87,357,4,17,10,45,136,41,41,1,0
2939,77,223,112,364,5,17,10,35,141,0,35,0,0
2943,112,226,149,368,5,17,10,37,142,0,35,0,1
2944,120,233,155,370,5,17,10,35,137,1,35,0,0
2945,126,227,165,376,5,17,10,39,149,2,35,0,0
2946,130,226,173,384,5,17,10,43,158,3,35,0,0
2947,134,230,178,388,5,17,10,44,158,4,35,0,0
2948,139,229,184,390,5,17,10,45,161,5,35,0,0
2949,144,229,190,395,5,17,10,46,166,6,35,0,0
2950,149,231,197,400,5,17,10,48,169,7,35,0,0
2951,157,230,205,402,5,17,10,48,172,8,35,0,0
2952,161,230,213,407,5,17,10,52,177,9,35,0,0
2953,166,232,218,408,5,17,10,52,176,10,35,0,0
2954,170,230,223,411,5,17,10,53,181,11,35,0,0
2955,176,235,230,418,5,17,10,54,183,12,35,0,0
2956,181,237,236,422,5,17,10,55,185,13,35,0,0
2957,191,239,246,425,5,17,10,55,186,14,35,0,0
2958,198,240,254,428,5,17,10,56,188,15,35,0,0
2959,207,243,263,430,5,17,10,56,187,16,35,0,0
2960,214,242,272,435,5,17,10,58,193,17,35,0,0
2961,221,243,282,444,5,17,10,61,201,18,35,0,0
2962,231,241,294,449,5,17,10,63,208,19,35,0,0
2963,240,244,304,456,5,17,10,64,212,20,35,0,0
2964,252,252,318,464,5,17,10,66,212,21,35,0,0
2965,272,253,336,466,5,17,10,64,213,22,35,0,0
2966,286,253,356,477,5,17,10,70,224,23,35,0,0
2967,297,254,371,482,5,17,10,74,228,24,35,0,0
2968,325,255,397,480,5,17,10,72,225,25,35,0,0
2969,348,257,424,490,5,17,10,76,233,26,35,0,0
2970,378,262,451,491,5,17,10,73,229,27,35,0,0
2971,405,264,478,492,5,17,10,73,228,28,35,0,0
2972,425,271,503,499,5,17,10,78,228,29,35,0,0
2973,456,275,535,502,5,17,10,79,227,30,35,0,0
2974,487,277,566,507,5,17,10,79,230,31,35,0,0
2975,508,279,591,512,5,17,10,83,233,32,35,0,0
2976,546,280,628,515,5,17,10,82,235,33,35,0,0
2977,567,279,649,520,5,17,10,82,241,34,35,0,0
2978,588,281,671,524,5,17,10,83,243,35,35,1,0
4122,1789,883,1920,1080,6,17,10,131,197,0,1,0,0
4123,1753,889,1878,1075,6,17,10,125,186,1,1,0,0
4124,1625,898,1797,1073,7,17,10,172,175,0,0,0,0
4125,1522,860,1682,1072,8,17,10,160,212,0,0,0,0
4126,1371,826,1559,1068,9,17,10,188,242,0,0,0,0
4127,1163,789,1417,1074,10,17,10,254,285,0,27,0,1
4128,1048,742,1344,1076,10,17,10,296,334,1,27,0,0
4129,921,698,1252,1074,10,17,10,331,376,2,27,0,0
4130,797,681,1138,1074,10,17,10,341,393,3,27,0,0
4131,662,634,1038,1074,10,17,10,376,440,4,27,0,0
4132,555,592,958,1074,10,17,10,403,482,5,27,0,0
4133,471,562,886,1071,10,17,10,415,509,6,27,0,0
4134,394,523,826,1071,10,17,10,432,548,7,27,0,0
4135,309,490,755,1072,10,17,10,446,582,8,27,0,0
4136,249,471,693,1071,10,17,10,444,600,9,27,0,0
4137,198,448,632,1060,10,17,10,434,612,10,27,0,0
4138,154,430,577,1055,10,17,10,423,625,11,27,0,0
4139,139,416,525,1015,10,17,10,386,599,12,27,0,0
4140,130,395,479,964,10,17,10,349,569,13,27,0,0
4141,118,382,446,941,10,17,10,328,559,14,27,0,0
4142,107,374,408,906,10,17,10,301,532,15,27,0,0
4143,88,365,363,870,10,17,10,275,505,16,27,0,0
4144,73,354,335,855,10,17,10,262,501,17,27,0,0
4145,67,352,308,828,10,17,10,241,476,18,27,0,0
4146,62,339,283,789,10,17,10,221,450,19,27,0,0
4147,55,340,259,770,10,17,10,204,430,20,27,0,0
4148,44,338,231,744,10,17,10,187,406,21,27,0,0
4149,33,330,211,727,10,17,10,178,397,22,27,0,0
4150,21,327,192,720,10,17,10,171,393,23,27,0,0
4151,12,322,175,709,10,17,10,163,387,24,27,0,0
4152,4,310,157,687,10,17,10,153,377,25,27,0,0
4153,0,316,143,686,10,17,10,143,370,26,27,0,0
4154,0,308,118,670,10,17,10,118,362,27,27,1,0
4127,1850,908,1920,1075,11,17,10,70,167,0,0,0,0
4128,1767,824,1916,1080,12,17,10,149,256,0,36,0,1
4129,1666,813,1822,1077,12,17,10,156,264,1,36,0,0
4130,1554,798,1719,1068,12,17,10,165,270,2,36,0,0
4131,1488,760,1676,1069,12,17,10,188,309,3,36,0,0
4132,1388,732,1594,1071,12,17,10,206,339,4,36,0,0
4133,1277,702,1498,1066,12,17,10,221,364,5,36,0,0
4134,1172,672,1409,1064,12,17,10,237,392,6,36,0,0
4135,1072,743,1276,1067,12,17,10,204,324,7,36,0,0
4136,887,729,1113,1069,12,17,10,226,340,8,36,0,0
4137,799,679,1061,1074,12,17,10,262,395,9,36,0,0
4138,713,645,991,1074,12,17,10,278,429,10,36,0,0
4139,611,605,908,1075,12,17,10,297,470,11,36,0,0
4140,489,563,811,1073,12,17,10,322,510,12,36,0,0
4141,397,548,723,1069,12,17,10,326,521,13,36,0,0
4142,324,519,665,1074,12,17,10,341,555,14,36,0,0
4143,288,488,633,1076,12,17,10,345,588,15,36,0,0
4144,255,479,590,1073,12,17,10,335,594,16,36,0,0
4145,219,458,546,1059,12,17,10,327,601,17,36,0,0
4146,181,439,486,1018,12,17,10,305,579,18,36,0,0
4147,151,428,437,993,12,17,10,286,565,19,36,0,0
4148,131,410,394,943,12,17,10,263,533,20,36,0,0
4149,125,380,378,911,12,17,10,253,531,21,36,0,0
4150,117,378,358,905,12,17,10,241,527,22,36,0,0
4151,112,374,331,865,12,17,10,219,491,23,36,0,0
4152,101,367,304,831,12,17,10,203,464,24,36,0,0
4153,95,363,289,819,12,17,10,194,456,25,36,0,0
4154,99,349,276,775,12,17,10,177,426,26,36,0,0
4155,98,339,267,758,12,17,10,169,419,27,36,0,0
4156,95,339,253,741,12,17,10,158,402,28,36,0,0
4157,82,332,233,723,12,17,10,151,391,29,36,0,0
4158,68,329,204,687,12,17,10,136,358,30,36,0,0
4159,45,326,181,686,12,17,10,136,360,31,36,0,0
4160,31,321,164,680,12,17,10,133,359,32,36,0,0
4161,23,319,150,670,12,17,10,127,351,33,36,0,0
4162,15,316,137,662,12,17,10,122,346,34,36,0,0
4163,8,313,111,617,12,17,10,103,304,35,36,0,0
4164,0,306,88,598,12,17,10,88,292,36,36,1,0
4136,982,604,1164,886,17,17,10,182,282,0,24,0,1
4137,928,565,1113,854,17,17,10,185,289,1,24,0,0
4138,860,542,1049,838,17,17,10,189,296,2,24,0,0
4139,734,517,1021,976,17,17,10,287,459,3,24,0,0
4140,649,493,984,1043,17,17,10,335,550,4,24,0,0
4141,575,469,936,1080,17,17,10,361,611,5,24,0,0
4142,513,453,881,1080,17,17,10,368,627,6,24,0,0
4143,473,435,814,1047,17,17,10,341,612,7,24,0,0
4144,437,421,765,1028,17,17,10,328,607,8,24,0,0
4145,401,410,706,989,17,17,10,305,579,9,24,0,0
4146,390,389,668,935,17,17,10,278,546,10,24,0,0
4147,369,374,630,903,17,17,10,261,529,11,24,0,0
4148,350,369,593,871,17,17,10,243,502,12,24,0,0
4149,330,356,555,837,17,17,10,225,481,13,24,0,0
4150,306,351,522,823,17,17,10,216,472,14,24,0,0
4151,280,345,486,806,17,17,10,206,461,15,24,0,0
4152,260,335,450,774,17,17,10,190,439,16,24,0,0
4153,249,335,422,747,17,17,10,173,412,17,24,0,0
4154,237,329,405,736,17,17,10,168,407,18,24,0,0
4155,213,317,371,713,17,17,10,158,396,19,24,0,0
4156,192,310,350,715,17,17,10,158,405,20,24,0,0
4157,171,306,326,709,17,17,10,155,403,21,24,0,0
4158,151,301,286,667,17,17,10,135,366,22,24,0,0
4159,132,302,255,647,17,17,10,123,345,23,24,0,0
4160,105,294,225,632,17,17,10,120,338,24,24,1,0
4162,78,295,186,605,17,17,10,108,310,0,24,0,0
4163,43,295,157,629,17,17,10,114,334,1,24,0,0
4164,21,290,121,594,17,17,10,100,304,2,24,0,0
4165,0,285,92,582,17,17,10,92,297,3,24,0,0
4160,136,302,196,491,18,17,10,60,189,0,1,0,0
4161,106,299,186,551,18,17,10,80,252,1,1,0,0
4165,34,300,74,497,19,17,10,40,197,0,0,0,0
4487,710,613,1158,1072,20,17,10,448,459,0,25,0,1
4488,618,586,1076,1073,20,17,10,458,487,1,25,0,0
4489,554,547,1029,1075,20,17,10,475,528,2,25,0,0
4490,505,525,976,1075,20,17,10,471,550,3,25,0,0
4491,467,498,933,1072,20,17,10,466,574,4,25,0,0
4492,451,474,881,1032,20,17,10,430,558,5,25,0,0
4493,436,462,834,1003,20,17,10,398,541,6,25,0,0
4494,417,447,777,960,20,17,10,360,513,7,25,0,0
4495,406,421,738,920,20,17,10,332,499,8,25,0,0
4496,403,411,705,888,20,17,10,302,477,9,25,0,0
4497,401,396,676,853,20,17,10,275,457,10,25,0,0
4498,385,382,639,822,20,17,10,254,440,11,25,0,0
4499,362,374,599,797,20,17,10,237,423,12,25,0,0
4500,340,364,556,762,20,17,10,216,398,13,25,0,0
4501,321,353,526,746,20,17,10,205,393,14,25,0,0
4502,300,343,490,722,20,17,10,190,379,15,25,0,0
4503,270,339,449,705,20,17,10,179,366,16,25,0,0
4504,242,341,417,701,20,17,10,175,360,17,25,0,0
4505,202,333,367,683,20,17,10,165,350,18,25,0,0
4506,170,333,329,677,20,17,10,159,344,19,25,0,0
4507,135,328,290,670,20,17,10,155,342,20,25,0,0
4508,102,324,249,655,20,17,10,147,331,21,25,0,0
4509,72,326,216,649,20,17,10,144,323,22,25,0,0
4510,30,319,167,632,20,17,10,137,313,23,25,0,0
4511,4,315,140,636,20,17,10,136,321,24,25,0,0
4512,0,308,101,624,20,17,10,101,316,25,25,1,0
4625,107,230,142,347,23,17,10,35,117,0,43,0,0
4627,110,233,146,353,23,17,10,36,120,0,43,0,1
4628,111,233,146,351,23,17,10,35,118,1,43,0,0
4629,112,232,150,357,23,17,10,38,125,2,43,0,0
4630,116,232,154,360,23,17,10,38,128,3,43,0,0
4631,120,232,159,364,23,17,10,39,132,4,43,0,0
4632,123,230,164,368,23,17,10,41,138,5,43,0,0
4633,126,231,166,371,23,17,10,40,140,6,43,0,0
4634,128,230,169,371,23,17,10,41,141,7,43,0,0
4635,130,230,174,379,23,17,10,44,149,8,43,0,0
4636,133,231,177,383,23,17,10,44,152,9,43,0,0
4637,136,228,182,387,23,17,10,46,159,10,43,0,0
4638,138,230,185,390,23,17,10,47,160,11,43,0,0
4639,141,231,188,391,23,17,10,47,160,12,43,0,0
4640,145,232,192,394,23,17,10,47,162,13,43,0,0
4641,149,234,198,402,23,17,10,49,168,14,43,0,0
4642,155,233,204,402,23,17,10,49,169,15,43,0,0
4643,161,234,210,404,23,17,10,49,170,16,43,0,0
4644,166,236,215,405,23,17,10,49,169,17,43,0,0
4645,171,238,221,413,23,17,10,50,175,18,43,0,0
4646,176,237,229,420,23,17,10,53,183,19,43,0,0
4647,183,241,237,424,23,17,10,54,183,20,43,0,0
4648,191,239,248,432,23,17,10,57,193,21,43,0,0
4649,197,240,255,438,23,17,10,58,198,22,43,0,0
4650,205,248,261,437,23,17,10,56,189,23,43,0,0
4651,214,246,272,442,23,17,10,58,196,24,43,0,0
4652,221,245,282,448,23,17,10,61,203,25,43,0,0
4653,232,249,292,450,23,17,10,60,201,26,43,0,0
4654,242,252,305,458,23,17,10,63,206,27,43,0,0
4655,251,256,315,464,23,17,10,64,208,28,43,0,0
4656,267,257,332,471,23,17,10,65,214,29,43,0,0
4657,282,258,350,478,23,17,10,68,220,30,43,0,0
4658,294,260,362,483,23,17,10,68,223,31,43,0,0
4659,316,262,383,484,23,17,10,67,222,32,43,0,0
4660,329,266,400,494,23,17,10,71,228,33,43,0,0
4661,352,269,423,500,23,17,10,71,231,34,43,0,0
4662,379,272,452,504,23,17,10,73,232,35,43,0,0
4663,397,273,472,506,23,17,10,75,233,36,43,0,0
4664,425,281,497,510,23,17,10,72,229,37,43,0,0
4665,450,284,526,515,23,17,10,76,231,38,43,0,0
4666,478,291,553,519,23,17,10,75,228,39,43,0,0
4667,506,285,583,522,23,17,10,77,237,40,43,0,0
4668,525,287,608,527,23,17,10,83,240,41,43,0,0
4669,548,292,631,533,23,17,10,83,241,42,43,0,0
4670,568,294,651,537,23,17,10,83,243,43,43,1,0
5017,113,204,148,318,24,17,10,35,114,0,71,0,1
5018,112,202,148,324,24,17,10,36,122,1,71,0,0
5019,113,207,149,327,24,17,10,36,120,2,71,0,0
5020,115,208,151,329,24,17,10,36,121,3,71,0,0
5021,117,209,154,337,24,17,10,37,128,4,71,0,0
5022,119,210,156,337,24,17,10,37,127,5,71,0,0
5023,121,213,157,340,24,17,10,36,127,6,71,0,0
5024,125,219,160,342,24,17,10,35,123,7,71,0,0
5025,129,218,166,347,24,17,10,37,129,8,71,0,0
5026,134,221,170,346,24,17,10,36,125,9,71,0,0
5027,137,223,172,347,24,17,10,35,124,10,71,0,0
5028,138,221,176,355,24,17,10,38,134,11,71,0,0
5029,141,222,181,359,24,17,10,40,137,12,71,0,0
5030,146,222,186,363,24,17,10,40,141,13,71,0,0
5031,150,223,190,364,24,17,10,40,141,14,71,0,0
5032,152,226,192,367,24,17,10,40,141,15,71,0,0
5033,153,223,196,374,24,17,10,43,151,16,71,0,0
5034,157,225,202,382,24,17,10,45,157,17,71,0,0
5035,161,226,206,385,24,17,10,45,159,18,71,0,0
5036,167,229,213,389,24,17,10,46,160,19,71,0,0
5037,172,230,217,391,24,17,10,45,161,20,71,0,0
5038,176,231,223,393,24,17,10,47,162,21,71,0,0
5039,180,232,229,402,24,17,10,49,170,22,71,0,0
5040,186,232,237,408,24,17,10,51,176,23,71,0,0
5041,191,235,244,414,24,17,10,53,179,24,71,0,0
5042,195,237,249,421,24,17,10,54,184,25,71,0,0
5043,199,236,255,426,24,17,10,56,190,26,71,0,0
5044,201,235,260,431,24,17,10,59,196,27,71,0,0
5045,206,236,267,435,24,17,10,61,199,28,71,0,0
5046,212,239,275,441,24,17,10,63,202,29,71,0,0
5047,218,243,282,450,24,17,10,64,207,30,71,0,0
5048,221,240,287,453,24,17,10,66,213,31,71,0,0
5049,227,251,291,460,24,17,10,64,209,32,71,0,0
5050,232,253,297,464,24,17,10,65,211,33,71,0,0
5051,235,254,305,480,24,17,10,70,226,34,71,0,0
5052,238,258,309,490,24,17,10,71,232,35,71,0,0
5053,240,258,313,495,24,17,10,73,237,36,71,0,0
5054,244,261,320,507,24,17,10,76,246,37,71,0,0
5055,252,265,329,516,24,17,10,77,251,38,71,0,0
5056,257,269,339,532,24,17,10,82,263,39,71,0,0
5057,262,274,346,543,24,17,10,84,269,40,71,0,0
5058,267,273,356,555,24,17,10,89,282,41,71,0,0
5059,277,280,370,572,24,17,10,93,292,42,71,0,0
5060,290,285,385,584,24,17,10,95,299,43,71,0,0
5061,305,293,403,599,24,17,10,98,306,44,71,0,0
5062,316,298,418,618,24,17,10,102,320,45,71,0,0
5063,329,300,432,627,24,17,10,103,327,46,71,0,0
5064,344,305,452,649,24,17,10,108,344,47,71,0,0
5065,365,310,477,664,24,17,10,112,354,48,71,0,0
5066,381,320,498,692,24,17,10,117,372,49,71,0,0
5067,402,331,522,713,24,17,10,120,382,50,71,0,0
5068,419,334,542,727,24,17,10,123,393,51,71,0,0
5069,438,348,567,759,24,17,10,129,411,52,71,0,0
5070,462,357,596,781,24,17,10,134,424,53,71,0,0
5071,486,369,630,825,24,17,10,144,456,54,71,0,0
5072,510,387,658,856,24,17,10,148,469,55,71,0,0
5073,536,398,686,872,24,17,10,150,474,56,71,0,0
5074,570,420,731,919,24,17,10,161,499,57,71,0,0
5075,602,437,771,953,24,17,10,169,516,58,71,0,0
5076,647,458,830,1015,24,17,10,183,557,59,71,0,0
5077,692,484,881,1056,24,17,10,189,572,60,71,0,0
5078,750,510,939,1079,24,17,10,189,569,61,71,0,0
5079,814,548,1000,1080,24,17,10,186,532,62,71,0,0
5080,901,580,1087,1080,24,17,10,186,500,63,71,0,0
5081,1010,614,1194,1080,24,17,10,184,466,64,71,0,0
5082,1123,658,1299,1079,24,17,10,176,421,65,71,0,0
5083,1242,698,1412,1077,24,17,10,170,379,66,71,0,0
5084,1379,739,1543,1079,24,17,10,164,340,67,71,0,0
5085,1523,788,1676,1080,24,17,10,153,292,68,71,0,0
5086,1663,824,1806,1080,24,17,10,143,256,69,71,0,0
5087,1769,867,1893,1077,24,17,10,124,210,70,71,0,0
5088,1871,901,1920,1080,24,17,10,49,179,71,71,1,0
5034,245,224,289,335,25,17,10,44,111,0,12,0,0
5035,236,230,272,322,25,17,10,36,92,1,12,0,0
5036,222,227,263,331,25,17,10,41,104,2,12,0,0
5037,212,225,254,333,25,17,10,42,108,3,12,0,0
5038,204,224,247,335,25,17,10,43,111,4,12,0,0
5042,170,219,209,320,25,17,10,39,101,0,12,0,0
5043,165,210,206,316,25,17,10,41,106,1,12,0,0
5044,162,208,202,317,25,17,10,40,109,2,12,0,0
5045,158,208,199,319,25,17,10,41,111,3,12,0,0
5046,153,208,194,319,25,17,10,41,111,4,12,0,0
5047,150,208,190,318,25,17,10,40,110,5,12,0,0
5048,146,209,184,316,25,17,10,38,107,6,12,0,0
5049,143,208,183,317,25,17,10,40,109,7,12,0,0
5050,140,205,180,315,25,17,10,40,110,8,12,0,0
5051,137,207,175,310,25,17,10,38,103,9,12,0,0
5052,133,203,170,308,25,17,10,37,105,10,12,0,0
5053,130,200,168,307,25,17,10,38,107,11,12,0,0
5054,127,198,163,301,25,17,10,36,103,12,12,0,0
5041,251,240,287,337,26,17,10,36,97,0,0,0,0
5046,187,219,223,330,27,17,10,36,111,0,13,0,0
5047,182,217,219,331,27,17,10,37,114,1,13,0,0
5048,182,214,220,330,27,17,10,38,116,2,13,0,0
5049,179,213,217,329,27,17,10,38,116,3,13,0,0
5050,175,212,213,327,27,17,10,38,115,4,13,0,0
5051,172,209,210,321,27,17,10,38,112,5,13,0,0
5052,169,205,207,318,27,17,10,38,113,6,13,0,0
5053,168,204,206,318,27,17,10,38,114,7,13,0,0
5054,167,204,204,317,27,17,10,37,113,8,13,0,0
5055,167,204,203,314,27,17,10,36,110,9,13,0,0
5056,165,202,202,312,27,17,10,37,110,10,13,0,0
5057,163,200,198,306,27,17,10,35,106,11,13,0,0
5058,162,199,197,304,27,17,10,35,105,12,13,0,0
5059,159,198,194,300,27,17,10,35,102,13,13,0,0
5461,32,290,74,544,28,17,10,42,254,0,70,0,1
5462,45,290,87,543,28,17,10,42,253,1,70,0,0
5463,62,292,104,537,28,17,10,42,245,2,70,0,0
5464,87,293,129,531,28,17,10,42,238,3,70,0,0
5465,110,294,158,557,28,17,10,48,263,4,70,0,0
5466,131,292,182,557,28,17,10,51,265,5,70,0,0
5467,157,291,209,559,28,17,10,52,268,6,70,0,0
5468,182,295,238,573,28,17,10,56,278,7,70,0,0
5469,202,295,261,578,28,17,10,59,283,8,70,0,0
5470,225,294,285,578,28,17,10,60,284,9,70,0,0
5471,252,301,317,586,28,17,10,65,285,10,70,0,0
5472,269,306,337,595,28,17,10,68,289,11,70,0,0
5473,290,310,361,604,28,17,10,71,294,12,70,0,0
5474,313,313,389,620,28,17,10,76,307,13,70,0,0
5475,334,315,412,623,28,17,10,78,308,14,70,0,0
5476,355,317,437,634,28,17,10,82,317,15,70,0,0
5477,376,320,464,648,28,17,10,88,328,16,70,0,0
5478,400,325,491,657,28,17,10,91,332,17,70,0,0
5479,417,331,512,677,28,17,10,95,346,18,70,0,0
5480,436,341,534,692,28,17,10,98,351,19,70,0,0
5481,450,345,550,700,28,17,10,100,355,20,70,0,0
5482,467,354,571,719,28,17,10,104,365,21,70,0,0
5483,485,362,593,737,28,17,10,108,375,22,70,0,0
5484,507,367,620,754,28,17,10,113,387,23,70,0,0
5485,528,377,646,778,28,17,10,118,401,24,70,0,0
5486,541,383,661,789,28,17,10,120,406,25,70,0,0
5487,559,394,681,804,28,17,10,122,410,26,70,0,0
5488,581,407,706,823,28,17,10,125,416,27,70,0,0
5489,609,419,736,837,28,17,10,127,418,28,70,0,0
5490,634,426,773,882,28,17,10,139,456,29,70,0,0
5491,662,439,802,901,28,17,10,140,462,30,70,0,0
5492,692,449,835,916,28,17,10,143,467,31,70,0,0
5493,724,457,875,935,28,17,10,151,478,32,70,0,0
5494,748,468,904,947,28,17,10,156,479,33,70,0,0
5495,779,477,941,965,28,17,10,162,488,34,70,0,0
5496,808,479,974,979,28,17,10,166,500,35,70,0,0
5497,820,486,986,987,28,17,10,166,501,36,70,0,0
5498,826,485,996,999,28,17,10,170,514,37,70,0,0
5499,833,487,1002,996,28,17,10,169,509,38,70,0,0
5500,835,489,1003,994,28,17,10,168,505,39,70,0,0
5501,829,488,1000,998,28,17,10,171,510,40,70,0,0
5502,824,488,995,999,28,17,10,171,511,41,70,0,0
5503,821,485,994,1000,28,17,10,173,515,42,70,0,0
5504,826,483,997,992,28,17,10,171,509,43,70,0,0
5505,825,480,999,998,28,17,10,174,518,44,70,0,0
5506,827,477,999,988,28,17,10,172,511,45,70,0,0
5507,829,478,999,986,28,17,10,170,508,46,70,0,0
5508,830,480,998,985,28,17,10,168,505,47,70,0,0
5509,821,480,990,986,28,17,10,169,506,48,70,0,0
5510,804,487,974,983,28,17,10,170,496,49,70,0,0
5511,792,487,965,986,28,17,10,173,499,50,70,0,0
5512,776,487,948,985,28,17,10,172,498,51,70,0,0
5513,764,491,935,988,28,17,10,171,497,52,70,0,0
5514,754,493,930,1006,28,17,10,176,513,53,70,0,0
5515,755,501,940,1042,28,17,10,185,541,54,70,0,0
5516,763,511,953,1062,28,17,10,190,551,55,70,0,0
5517,781,521,974,1075,28,17,10,193,554,56,70,0,0
5518,803,540,991,1075,28,17,10,188,535,57,70,0,0
5519,816,562,1000,1077,28,17,10,184,515,58,70,0,0
5520,831,585,1010,1077,28,17,10,179,492,59,70,0,0
5521,854,604,1031,1078,28,17,10,177,474,60,70,0,0
5522,890,633,1062,1079,28,17,10,172,446,61,70,0,0
5523,945,659,1112,1076,28,17,10,167,417,62,70,0,0
5524,995,685,1161,1074,28,17,10,166,389,63,70,0,0
5525,1054,732,1214,1076,28,17,10,160,344,64,70,0,0
5526,1116,773,1274,1076,28,17,10,158,303,65,70,0,0
5527,1182,803,1343,1079,28,17,10,161,276,66,70,0,0
5528,1264,839,1423,1079,28,17,10,159,240,67,70,0,0
5529,1381,883,1524,1075,28,17,10,143,192,68,70,0,0
5530,1512,925,1634,1074,28,17,10,122,149,69,70,0,0
5531,1626,963,1731,1078,28,17,10,105,115,70,70,1,0
5468,33,347,83,566,29,17,10,50,219,0,68,0,1
5469,32,297,94,571,29,17,10,62,274,1,68,0,0
5470,35,288,99,571,29,17,10,64,283,2,68,0,0
5471,42,287,107,573,29,17,10,65,286,3,68,0,0
5472,48,286,117,594,29,17,10,69,308,4,68,0,0
5473,39,294,113,620,29,17,10,74,326,5,68,0,0
5474,35,294,115,652,29,17,10,80,358,6,68,0,0
5475,37,294,119,654,29,17,10,82,360,7,68,0,0
5476,39,292,121,654,29,17,10,82,362,8,68,0,0
5477,39,291,122,657,29,17,10,83,366,9,68,0,0
5478,41,290,125,657,29,17,10,84,367,10,68,0,0
5479,41,290,127,657,29,17,10,86,367,11,68,0,0
5480,41,290,128,657,29,17,10,87,367,12,68,0,0
5481,41,291,128,658,29,17,10,87,367,13,68,0,0
5482,40,291,128,657,29,17,10,88,366,14,68,0,0
5483,37,293,125,655,29,17,10,88,362,15,68,0,0
5484,37,296,124,656,29,17,10,87,360,16,68,0,0
5485,37,297,124,656,29,17,10,87,359,17,68,0,0
5486,37,297,124,657,29,17,10,87,360,18,68,0,0
5487,38,296,125,658,29,17,10,87,362,19,68,0,0
5488,38,296,125,657,29,17,10,87,361,20,68,0,0
5489,38,296,126,655,29,17,10,88,359,21,68,0,0
5490,38,297,125,656,29,17,10,87,359,22,68,0,0
5491,38,297,125,654,29,17,10,87,357,23,68,0,0
5492,38,297,125,654,29,17,10,87,357,24,68,0,0
5493,38,297,125,653,29,17,10,87,356,25,68,0,0
5494,38,294,125,650,29,17,10,87,356,26,68,0,0
5495,38,293,125,650,29,17,10,87,357,27,68,0,0
5496,37,292,125,651,29,17,10,88,359,28,68,0,0
5497,37,291,127,652,29,17,10,90,361,29,68,0,0
5498,35,296,123,651,29,17,10,88,355,30,68,0,0
5499,35,298,122,651,29,17,10,87,353,31,68,0,0
5500,35,297,123,652,29,17,10,88,355,32,68,0,0
5501,35,295,123,653,29,17,10,88,358,33,68,0,0
5502,35,297,123,652,29,17,10,88,355,34,68,0,0
5503,38,293,127,649,29,17,10,89,356,35,68,0,0
5504,38,295,126,643,29,17,10,88,348,36,68,0,0
5505,45,292,134,636,29,17,10,89,344,37,68,0,0
5506,53,295,144,632,29,17,10,91,337,38,68,0,0
5507,75,292,169,619,29,17,10,94,327,39,68,0,0
5508,100,292,195,614,29,17,10,95,322,40,68,0,0
5509,115,291,212,613,29,17,10,97,322,41,68,0,0
5510,128,289,224,603,29,17,10,96,314,42,68,0,0
5511,140,283,234,595,29,17,10,94,312,43,68,0,0
5512,154,279,250,599,29,17,10,96,320,44,68,0,0
5513,172,277,264,581,29,17,10,92,304,45,68,0,0
5514,190,269,277,558,29,17,10,87,289,46,68,0,0
5515,205,267,285,534,29,17,10,80,267,47,68,0,0
5516,213,268,292,531,29,17,10,79,263,48,68,0,0
5517,219,262,297,526,29,17,10,78,264,49,68,0,0
5518,226,259,304,521,29,17,10,78,262,50,68,0,0
5519,236,260,311,509,29,17,10,75,249,51,68,0,0
5520,247,256,320,497,29,17,10,73,241,52,68,0,0
5521,252,254,325,491,29,17,10,73,237,53,68,0,0
5522,255,252,326,485,29,17,10,71,233,54,68,0,0
5523,254,250,325,477,29,17,10,71,227,55,68,0,0
5524,255,253,325,474,29,17,10,70,221,56,68,0,0
5525,262,247,330,463,29,17,10,68,216,57,68,0,0
5526,267,243,334,457,29,17,10,67,214,58,68,0,0
5527,271,240,339,452,29,17,10,68,212,59,68,0,0
5528,273,242,337,431,29,17,10,64,189,60,68,0,0
5529,268,240,336,443,29,17,10,68,203,61,68,0,0
5530,274,239,344,443,29,17,10,70,204,62,68,0,0
5531,273,239,341,441,29,17,10,68,202,63,68,0,0
5532,271,237,338,434,29,17,10,67,197,64,68,0,0
5533,268,237,330,422,29,17,10,62,185,65,68,0,0
5534,273,236,333,414,29,17,10,60,178,66,68,0,0
5535,275,231,337,419,29,17,10,62,188,67,68,0,0
5536,278,229,339,415,29,17,10,61,186,68,68,1,0
5498,84,290,123,364,30,17,10,39,74,0,0,0,0
5507,36,289,119,586,31,17,10,83,297,0,248,0,1
5508,36,302,113,579,31,17,10,77,277,1,248,0,0
5509,36,297,115,581,31,17,10,79,284,2,248,0,0
5510,39,288,121,581,31,17,10,82,293,3,248,0,0
5511,42,285,124,578,31,17,10,82,293,4,248,0,0
5512,42,291,120,569,31,17,10,78,278,5,248,0,0
5513,43,288,123,572,31,17,10,80,284,6,248,0,0
5514,42,288,124,573,31,17,10,82,285,7,248,0,0
5515,43,289,124,574,31,17,10,81,285,8,248,0,0
5516,41,288,123,574,31,17,10,82,286,9,248,0,0
5517,41,287,123,574,31,17,10,82,287,10,248,0,0
5518,41,286,123,574,31,17,10,82,288,11,248,0,0
5519,42,287,123,574,31,17,10,81,287,12,248,0,0
5520,43,288,124,572,31,17,10,81,284,13,248,0,0
5521,41,287,123,575,31,17,10,82,288,14,248,0,0
5522,39,287,121,575,31,17,10,82,288,15,248,0,0
5523,39,282,123,576,31,17,10,84,294,16,248,0,0
5524,40,283,125,576,31,17,10,85,293,17,248,0,0
5525,40,284,124,578,31,17,10,84,294,18,248,0,0
5526,40,287,125,580,31,17,10,85,293,19,248,0,0
5527,43,290,129,581,31,17,10,86,291,20,248,0,0
5528,51,294,138,582,31,17,10,87,288,21,248,0,0
5529,58,295,146,582,31,17,10,88,287,22,248,0,0
5530,65,298,154,590,31,17,10,89,292,23,248,0,0
5531,76,301,165,591,31,17,10,89,290,24,248,0,0
5532,90,304,183,598,31,17,10,93,294,25,248,0,0
5533,103,305,200,604,31,17,10,97,299,26,248,0,0
5534,124,303,220,599,31,17,10,96,296,27,248,0,0
5535,142,300,243,609,31,17,10,101,309,28,248,0,0
5536,165,301,269,612,31,17,10,104,311,29,248,0,0
5537,183,300,292,616,31,17,10,109,316,30,248,0,0
5538,201,297,312,617,31,17,10,111,320,31,248,0,0
5539,224,298,335,621,31,17,10,111,323,32,248,0,0
5540,247,302,362,631,31,17,10,115,329,33,248,0,0
5541,262,305,380,638,31,17,10,118,333,34,248,0,0
5542,281,310,394,634,31,17,10,113,324,35,248,0,0
5543,297,311,416,653,31,17,10,119,342,36,248,0,0
5544,315,316,434,662,31,17,10,119,346,37,248,0,0
5545,334,313,455,665,31,17,10,121,352,38,248,0,0
5546,350,315,472,669,31,17,10,122,354,39,248,0,0
5547,365,318,490,674,31,17,10,125,356,40,248,0,0
5548,379,321,505,678,31,17,10,126,357,41,248,0,0
5549,391,324,518,680,31,17,10,127,356,42,248,0,0
5550,402,327,529,679,31,17,10,127,352,43,248,0,0
5551,414,329,543,687,31,17,10,129,358,44,248,0,0
5552,421,331,552,693,31,17,10,131,362,45,248,0,0
5553,421,333,550,694,31,17,10,129,361,46,248,0,0
5554,416,333,544,696,31,17,10,128,363,47,248,0,0
5555,415,331,543,697,31,17,10,128,366,48,248,0,0
5556,409,332,536,699,31,17,10,127,367,49,248,0,0
5557,403,333,528,700,31,17,10,125,367,50,248,0,0
5558,400,335,523,699,31,17,10,123,364,51,248,0,0
5559,398,337,519,699,31,17,10,121,362,52,248,0,0
5560,399,340,518,699,31,17,10,119,359,53,248,0,0
5561,398,341,516,699,31,17,10,118,358,54,248,0,0
5562,398,343,515,699,31,17,10,117,356,55,248,0,0
5563,396,343,513,699,31,17,10,117,356,56,248,0,0
5564,395,344,511,699,31,17,10,116,355,57,248,0,0
5565,394,343,510,699,31,17,10,116,356,58,248,0,0
5566,394,345,510,698,31,17,10,116,353,59,248,0,0
5567,393,345,509,699,31,17,10,116,354,60,248,0,0
5568,392,344,508,698,31,17,10,116,354,61,248,0,0
5569,392,344,508,697,31,17,10,116,353,62,248,0,0
5570,393,344,508,697,31,17,10,115,353,63,248,0,0
5571,393,343,508,696,31,17,10,115,353,64,248,0,0
5572,392,343,507,696,31,17,10,115,353,65,248,0,0
5573,392,343,507,696,31,17,10,115,353,66,248,0,0
5574,391,342,504,689,31,17,10,113,347,67,248,0,0
5575,390,342,502,691,31,17,10,112,349,68,248,0,0
5576,387,343,501,693,31,17,10,114,350,69,248,0,0
5577,388,341,501,695,31,17,10,113,354,70,248,0,0
5578,389,341,504,701,31,17,10,115,360,71,248,0,0
5579,387,340,502,701,31,17,10,115,361,72,248,0,0
5580,387,341,501,700,31,17,10,114,359,73,248,0,0
5581,386,341,501,703,31,17,10,115,362,74,248,0,0
5582,386,341,501,704,31,17,10,115,363,75,248,0,0
5583,387,342,501,705,31,17,10,114,363,76,248,0,0
5584,387,342,501,706,31,17,10,114,364,77,248,0,0
5585,386,342,500,706,31,17,10,114,364,78,248,0,0
5586,387,342,500,707,31,17,10,113,365,79,248,0,0
5587,387,342,500,707,31,17,10,113,365,80,248,0,0
5588,387,340,500,706,31,17,10,113,366,81,248,0,0
5589,387,340,500,707,31,17,10,113,367,82,248,0,0
5590,388,340,500,705,31,17,10,112,365,83,248,0,0
5591,387,340,500,706,31,17,10,113,366,84,248,0,0
5592,387,341,499,707,31,17,10,112,366,85,248,0,0
5593,387,341,499,707,31,17,10,112,366,86,248,0,0
5594,387,341,500,708,31,17,10,113,367,87,248,0,0
5595,387,341,500,708,31,17,10,113,367,88,248,0,0
5596,388,342,501,708,31,17,10,113,366,89,248,0,0
5597,388,342,501,707,31,17,10,113,365,90,248,0,0
5598,389,343,501,707,31,17,10,112,364,91,248,0,0
5599,389,343,501,706,31,17,10,112,363,92,248,0,0
5600,389,343,500,705,31,17,10,111,362,93,248,0,0
5601,389,343,501,705,31,17,10,112,362,94,248,0,0
5602,390,343,501,705,31,17,10,111,362,95,248,0,0
5603,391,344,502,704,31,17,10,111,360,96,248,0,0
5604,391,344,503,704,31,17,10,112,360,97,248,0,0
5605,392,345,503,704,31,17,10,111,359,98,248,0,0
5606,393,346,504,702,31,17,10,111,356,99,248,0,0
5607,394,346,506,702,31,17,10,112,356,100,248,0,0
5608,396,345,509,701,31,17,10,113,356,101,248,0,0
5609,397,344,510,702,31,17,10,113,358,102,248,0,0
5610,397,344,511,702,31,17,10,114,358,103,248,0,0
5611,399,344,513,703,31,17,10,114,359,104,248,0,0
5612,400,346,516,707,31,17,10,116,361,105,248,0,0
5613,400,346,518,716,31,17,10,118,370,106,248,0,0
5614,401,349,520,721,31,17,10,119,372,107,248,0,0
5615,404,353,523,726,31,17,10,119,373,108,248,0,0
5616,414,358,532,730,31,17,10,118,372,109,248,0,0
5617,423,362,542,736,31,17,10,119,374,110,248,0,0
5618,433,365,554,745,31,17,10,121,380,111,248,0,0
5619,445,375,568,762,31,17,10,123,387,112,248,0,0
5620,462,379,591,780,31,17,10,129,401,113,248,0,0
5621,477,382,609,790,31,17,10,132,408,114,248,0,0
5622,494,382,630,802,31,17,10,136,420,115,248,0,0
5623,510,390,648,813,31,17,10,138,423,116,248,0,0
5624,529,398,667,820,31,17,10,138,422,117,248,0,0
5625,540,404,686,855,31,17,10,146,451,118,248,0,0
5626,553,417,704,884,31,17,10,151,467,119,248,0,0
5627,561,421,716,900,31,17,10,155,479,120,248,0,0
5628,577,428,734,908,31,17,10,157,480,121,248,0,0
5629,594,434,759,931,31,17,10,165,497,122,248,0,0
5630,616,453,792,966,31,17,10,176,513,123,248,0,0
5631,653,454,832,981,31,17,10,179,527,124,248,0,0
5632,687,472,870,1008,31,17,10,183,536,125,248,0,0
5633,722,491,915,1048,31,17,10,193,557,126,248,0,0
5634,751,521,952,1069,31,17,10,201,548,127,248,0,0
5635,788,536,995,1072,31,17,10,207,536,128,248,0,0
5636,794,544,1015,1078,31,17,10,221,534,129,248,0,0
5637,791,541,1024,1079,31,17,10,233,538,130,248,0,0
5638,786,535,1030,1078,31,17,10,244,543,131,248,0,0
5639,777,531,1029,1080,31,17,10,252,549,132,248,0,0
5640,762,525,1017,1079,31,17,10,255,554,133,248,0,0
5641,738,505,996,1073,31,17,10,258,568,134,248,0,0
5642,718,491,976,1072,31,17,10,258,581,135,248,0,0
5643,694,471,952,1065,31,17,10,258,594,136,248,0,0
5644,675,454,930,1053,31,17,10,255,599,137,248,0,0
5645,658,450,906,1044,31,17,10,248,594,138,248,0,0
5646,662,464,895,1034,31,17,10,233,570,139,248,0,0
5647,664,467,889,1027,31,17,10,225,560,140,248,0,0
5648,645,451,867,1018,31,17,10,222,567,141,248,0,0
5649,640,445,853,1000,31,17,10,213,555,142,248,0,0
5650,628,440,836,988,31,17,10,208,548,143,248,0,0
5651,597,432,810,982,31,17,10,213,550,144,248,0,0
5652,584,439,793,978,31,17,10,209,539,145,248,0,0
5653,565,434,777,979,31,17,10,212,545,146,248,0,0
5654,547,437,759,979,31,17,10,212,542,147,248,0,0
5655,534,436,745,979,31,17,10,211,543,148,248,0,0
5656,532,435,743,978,31,17,10,211,543,149,248,0,0
5657,534,431,746,979,31,17,10,212,548,150,248,0,0
5658,534,431,748,981,31,17,10,214,550,151,248,0,0
5659,545,425,762,981,31,17,10,217,556,152,248,0,0
5660,539,436,749,974,31,17,10,210,538,153,248,0,0
5661,537,443,743,974,31,17,10,206,531,154,248,0,0
5662,534,444,740,977,31,17,10,206,533,155,248,0,0
5663,535,446,740,976,31,17,10,205,530,156,248,0,0
5664,536,446,741,977,31,17,10,205,531,157,248,0,0
5665,535,446,740,978,31,17,10,205,532,158,248,0,0
5666,532,444,737,976,31,17,10,205,532,159,248,0,0
5667,531,443,737,975,31,17,10,206,532,160,248,0,0
5668,531,447,734,973,31,17,10,203,526,161,248,0,0
5669,532,445,736,975,31,17,10,204,530,162,248,0,0
5670,529,447,733,977,31,17,10,204,530,163,248,0,0
5671,529,445,735,980,31,17,10,206,535,164,248,0,0
5672,530,445,736,979,31,17,10,206,534,165,248,0,0
5673,530,445,735,979,31,17,10,205,534,166,248,0,0
5674,530,444,735,976,31,17,10,205,532,167,248,0,0
5675,534,443,739,977,31,17,10,205,534,168,248,0,0
5676,539,443,744,979,31,17,10,205,536,169,248,0,0
5677,542,443,746,979,31,17,10,204,536,170,248,0,0
5678,542,444,746,979,31,17,10,204,535,171,248,0,0
5679,540,444,744,979,31,17,10,204,535,172,248,0,0
5680,538,444,742,980,31,17,10,204,536,173,248,0,0
5681,534,444,738,978,31,17,10,204,534,174,248,0,0
5682,531,443,735,977,31,17,10,204,534,175,248,0,0
5683,530,445,734,977,31,17,10,204,532,176,248,0,0
5684,528,447,731,975,31,17,10,203,528,177,248,0,0
5685,526,447,729,973,31,17,10,203,526,178,248,0,0
5686,525,446,730,976,31,17,10,205,530,179,248,0,0
5687,526,446,731,978,31,17,10,205,532,180,248,0,0
5688,528,446,732,979,31,17,10,204,533,181,248,0,0
5689,528,447,732,979,31,17,10,204,532,182,248,0,0
5690,530,449,733,979,31,17,10,203,530,183,248,0,0
5691,529,450,731,977,31,17,10,202,527,184,248,0,0
5692,529,451,730,977,31,17,10,201,526,185,248,0,0
5693,529,451,730,977,31,17,10,201,526,186,248,0,0
5694,529,451,730,977,31,17,10,201,526,187,248,0,0
5695,527,451,728,974,31,17,10,201,523,188,248,0,0
5696,528,450,730,976,31,17,10,202,526,189,248,0,0
5697,529,449,730,976,31,17,10,201,527,190,248,0,0
5698,529,449,730,977,31,17,10,201,528,191,248,0,0
5699,528,450,728,975,31,17,10,200,525,192,248,0,0
5700,521,446,721,976,31,17,10,200,530,193,248,0,0
5701,517,444,713,972,31,17,10,196,528,194,248,0,0
5702,514,438,710,971,31,17,10,196,533,195,248,0,0
5703,513,438,705,969,31,17,10,192,531,196,248,0,0
5704,504,425,697,963,31,17,10,193,538,197,248,0,0
5705,500,414,684,929,31,17,10,184,515,198,248,0,0
5706,493,411,668,901,31,17,10,175,490,199,248,0,0
5707,479,408,650,888,31,17,10,171,480,200,248,0,0
5708,461,399,625,861,31,17,10,164,462,201,248,0,0
5709,434,387,597,843,31,17,10,163,456,202,248,0,0
5710,414,382,571,821,31,17,10,157,439,203,248,0,0
5711,396,373,552,809,31,17,10,156,436,204,248,0,0
5712,386,363,536,787,31,17,10,150,424,205,248,0,0
5713,374,356,522,775,31,17,10,148,419,206,248,0,0
5714,361,354,506,767,31,17,10,145,413,207,248,0,0
5715,348,345,488,751,31,17,10,140,406,208,248,0,0
5716,338,341,472,729,31,17,10,134,388,209,248,0,0
5717,330,339,461,723,31,17,10,131,384,210,248,0,0
5718,325,332,454,714,31,17,10,129,382,211,248,0,0
5719,323,323,447,690,31,17,10,124,367,212,248,0,0
5720,322,319,441,674,31,17,10,119,355,213,248,0,0
5721,315,320,432,671,31,17,10,117,351,214,248,0,0
5722,311,312,425,652,31,17,10,114,340,215,248,0,0
5723,309,308,420,642,31,17,10,111,334,216,248,0,0
5724,306,307,415,640,31,17,10,109,333,217,248,0,0
5725,303,304,408,628,31,17,10,105,324,218,248,0,0
5726,302,300,404,615,31,17,10,102,315,219,248,0,0
5727,295,298,393,600,31,17,10,98,302,220,248,0,0
5728,283,297,379,592,31,17,10,96,295,221,248,0,0
5729,273,289,366,577,31,17,10,93,288,222,248,0,0
5730,267,287,357,567,31,17,10,90,280,223,248,0,0
5731,265,285,350,549,31,17,10,85,264,224,248,0,0
5732,264,279,346,536,31,17,10,82,257,225,248,0,0
5733,262,275,342,525,31,17,10,80,250,226,248,0,0
5734,254,271,337,530,31,17,10,83,259,227,248,0,0
5735,249,265,330,522,31,17,10,81,257,228,248,0,0
5736,248,265,326,513,31,17,10,78,248,229,248,0,0
5737,250,264,326,505,31,17,10,76,241,230,248,0,0
5738,251,261,325,496,31,17,10,74,235,231,248,0,0
5739,250,262,322,488,31,17,10,72,226,232,248,0,0
5740,246,259,317,486,31,17,10,71,227,233,248,0,0
5741,244,255,313,476,31,17,10,69,221,234,248,0,0
5742,244,258,309,470,31,17,10,65,212,235,248,0,0
5743,244,256,309,466,31,17,10,65,210,236,248,0,0
5744,246,250,310,455,31,17,10,64,205,237,248,0,0
5745,251,251,315,451,31,17,10,64,200,238,248,0,0
5746,252,247,319,451,31,17,10,67,204,239,248,0,0
5747,255,243,322,444,31,17,10,67,201,240,248,0,0
5748,260,247,328,439,31,17,10,68,192,241,248,0,0
5749,260,242,334,443,31,17,10,74,201,242,248,0,0
5750,261,240,335,436,31,17,10,74,196,243,248,0,0
5751,260,239,336,438,31,17,10,76,199,244,248,0,0
5752,260,239,334,432,31,17,10,74,193,245,248,0,0
5753,255,240,326,427,31,17,10,71,187,246,248,0,0
5754,258,245,323,421,31,17,10,65,176,247,248,0,0
5755,259,244,322,416,31,17,10,63,172,248,248,1,0
5564,1321,832,1511,1072,35,17,10,190,240,0,0,0,0
5565,1211,783,1421,1072,36,17,10,210,289,0,86,0,1
5566,1111,761,1338,1073,36,17,10,227,312,1,86,0,0
5567,985,728,1237,1073,36,17,10,252,345,2,86,0,0
5568,888,684,1169,1071,36,17,10,281,387,3,86,0,0
5569,784,654,1087,1073,36,17,10,303,419,4,86,0,0
5570,695,619,1018,1071,36,17,10,323,452,5,86,0,0
5571,626,589,965,1073,36,17,10,339,484,6,86,0,0
5572,562,565,911,1074,36,17,10,349,509,7,86,0,0
5573,500,534,860,1075,36,17,10,360,541,8,86,0,0
5574,457,510,818,1074,36,17,10,361,564,9,86,0,0
5575,422,489,781,1071,36,17,10,359,582,10,86,0,0
5576,411,473,742,1030,36,17,10,331,557,11,86,0,0
5577,403,462,713,1002,36,17,10,310,540,12,86,0,0
5578,397,454,686,976,36,17,10,289,522,13,86,0,0
5579,402,432,668,931,36,17,10,266,499,14,86,0,0
5580,408,421,652,892,36,17,10,244,471,15,86,0,0
5581,418,415,649,877,36,17,10,231,462,16,86,0,0
5582,428,409,648,862,36,17,10,220,453,17,86,0,0
5583,435,410,644,852,36,17,10,209,442,18,86,0,0
5584,438,405,640,845,36,17,10,202,440,19,86,0,0
5585,439,402,637,847,36,17,10,198,445,20,86,0,0
5586,441,400,635,847,36,17,10,194,447,21,86,0,0
5587,444,399,633,847,36,17,10,189,448,22,86,0,0
5588,448,400,632,847,36,17,10,184,447,23,86,0,0
5589,451,401,631,848,36,17,10,180,447,24,86,0,0
5590,453,401,630,849,36,17,10,177,448,25,86,0,0
5591,456,404,629,849,36,17,10,173,445,26,86,0,0
5592,455,401,628,850,36,17,10,173,449,27,86,0,0
5593,459,402,628,850,36,17,10,169,448,28,86,0,0
5594,461,400,628,850,36,17,10,167,450,29,86,0,0
5595,464,405,628,851,36,17,10,164,446,30,86,0,0
5596,466,403,628,851,36,17,10,162,448,31,86,0,0
5597,467,400,627,847,36,17,10,160,447,32,86,0,0
5598,470,405,628,852,36,17,10,158,447,33,86,0,0
5599,472,402,628,847,36,17,10,156,445,34,86,0,0
5600,475,405,630,851,36,17,10,155,446,35,86,0,0
5601,477,401,630,847,36,17,10,153,446,36,86,0,0
5602,479,404,632,854,36,17,10,153,450,37,86,0,0
5603,483,403,636,853,36,17,10,153,450,38,86,0,0
5604,489,409,641,854,36,17,10,152,445,39,86,0,0
5605,497,410,646,849,36,17,10,149,439,40,86,0,0
5606,505,413,654,852,36,17,10,149,439,41,86,0,0
5607,511,407,661,849,36,17,10,150,442,42,86,0,0
5608,520,403,669,844,36,17,10,149,441,43,86,0,0
5609,530,400,673,828,36,17,10,143,428,44,86,0,0
5610,545,400,685,817,36,17,10,140,417,45,86,0,0
5611,557,398,696,812,36,17,10,139,414,46,86,0,0
5612,568,399,706,806,36,17,10,138,407,47,86,0,0
5613,574,398,713,806,36,17,10,139,408,48,86,0,0
5614,580,398,719,805,36,17,10,139,407,49,86,0,0
5615,593,398,732,805,36,17,10,139,407,50,86,0,0
5616,605,399,744,803,36,17,10,139,404,51,86,0,0
5617,617,400,756,799,36,17,10,139,399,52,86,0,0
5618,624,395,767,794,36,17,10,143,399,53,86,0,0
5619,637,391,781,787,36,17,10,144,396,54,86,0,0
5620,642,386,787,789,36,17,10,145,403,55,86,0,0
5621,643,387,787,792,36,17,10,144,405,56,86,0,0
5622,646,396,785,786,36,17,10,139,390,57,86,0,0
5623,649,401,789,798,36,17,10,140,397,58,86,0,0
5624,655,404,796,803,36,17,10,141,399,59,86,0,0
5625,662,407,803,806,36,17,10,141,399,60,86,0,0
5626,668,411,810,808,36,17,10,142,397,61,86,0,0
5627,676,414,816,807,36,17,10,140,393,62,86,0,0
5628,689,418,826,810,36,17,10,137,392,63,86,0,0
5629,706,417,833,786,36,17,10,127,369,64,86,0,0
5630,714,418,839,784,36,17,10,125,366,65,86,0,0
5632,674,419,806,806,36,17,10,132,387,0,86,0,1
5633,660,415,797,811,36,17,10,137,396,1,86,0,0
5634,650,414,789,816,36,17,10,139,402,2,86,0,0
5635,641,412,783,827,36,17,10,142,415,3,86,0,0
5636,637,413,780,831,36,17,10,143,418,4,86,0,0
5637,637,413,779,832,36,17,10,142,419,5,86,0,0
5638,637,412,781,838,36,17,10,144,426,6,86,0,0
5639,637,412,782,839,36,17,10,145,427,7,86,0,0
5640,638,412,782,837,36,17,10,144,425,8,86,0,0
5641,638,414,781,836,36,17,10,143,422,9,86,0,0
5642,638,414,780,835,36,17,10,142,421,10,86,0,0
5643,637,414,778,835,36,17,10,141,421,11,86,0,0
5644,634,414,772,832,36,17,10,138,418,12,86,0,0
5645,633,415,768,829,36,17,10,135,414,13,86,0,0
5646,630,416,762,827,36,17,10,132,411,14,86,0,0
5647,629,416,758,825,36,17,10,129,409,15,86,0,0
5648,628,419,755,831,36,17,10,127,412,16,86,0,0
5649,636,417,741,756,36,17,10,105,339,17,86,0,0
5650,639,418,735,725,36,17,10,96,307,18,86,0,0
5651,639,419,731,715,36,17,10,92,296,19,86,0,0
5654,657,421,770,786,36,17,10,113,365,0,86,0,0
5655,656,419,778,818,36,17,10,122,399,1,86,0,0
5656,655,417,780,832,36,17,10,125,415,2,86,0,0
5657,659,415,764,754,36,17,10,105,339,3,86,0,0
5658,655,417,762,760,36,17,10,107,343,4,86,0,0
5659,656,417,763,759,36,17,10,107,342,5,86,0,0
5661,708,417,843,834,36,17,10,135,417,0,86,0,1
5662,726,416,869,847,36,17,10,143,431,1,86,0,0
5663,743,422,890,852,36,17,10,147,430,2,86,0,0
5664,760,427,910,861,36,17,10,150,434,3,86,0,0
5665,777,435,929,863,36,17,10,152,428,4,86,0,0
5666,794,439,948,866,36,17,10,154,427,5,86,0,0
5667,806,445,963,874,36,17,10,157,429,6,86,0,0
5668,812,448,973,881,36,17,10,161,433,7,86,0,0
5669,815,449,981,884,36,17,10,166,435,8,86,0,0
5670,812,445,984,885,36,17,10,172,440,9,86,0,0
5671,807,448,982,887,36,17,10,175,439,10,86,0,0
5672,799,452,972,885,36,17,10,173,433,11,86,0,0
5673,794,454,966,883,36,17,10,172,429,12,86,0,0
5674,797,454,971,884,36,17,10,174,430,13,86,0,0
5675,799,453,977,884,36,17,10,178,431,14,86,0,0
5676,800,452,981,883,36,17,10,181,431,15,86,0,0
5677,798,451,984,885,36,17,10,186,434,16,86,0,0
5678,797,448,987,884,36,17,10,190,436,17,86,0,0
5679,786,447,977,883,36,17,10,191,436,18,86,0,0
5680,773,450,961,885,36,17,10,188,435,19,86,0,0
5681,771,448,958,890,36,17,10,187,442,20,86,0,0
5682,778,445,964,890,36,17,10,186,445,21,86,0,0
5683,794,445,971,878,36,17,10,177,433,22,86,0,0
5684,802,442,974,870,36,17,10,172,428,23,86,0,0
5685,809,437,980,870,36,17,10,171,433,24,86,0,0
5686,818,439,985,865,36,17,10,167,426,25,86,0,0
5687,816,438,986,870,36,17,10,170,432,26,86,0,0
5688,816,437,986,870,36,17,10,170,433,27,86,0,0
5689,804,436,976,869,36,17,10,172,433,28,86,0,0
5690,793,438,966,870,36,17,10,173,432,29,86,0,0
5691,784,438,959,870,36,17,10,175,432,30,86,0,0
5692,779,438,953,868,36,17,10,174,430,31,86,0,0
5693,775,438,951,869,36,17,10,176,431,32,86,0,0
5694,773,438,950,869,36,17,10,177,431,33,86,0,0
5695,772,437,951,869,36,17,10,179,432,34,86,0,0
5696,772,437,952,871,36,17,10,180,434,35,86,0,0
5697,774,440,951,868,36,17,10,177,428,36,86,0,0
5698,772,440,950,865,36,17,10,178,425,37,86,0,0
5699,776,440,952,862,36,17,10,176,422,38,86,0,0
5700,780,441,953,862,36,17,10,173,421,39,86,0,0
5701,791,438,960,855,36,17,10,169,417,40,86,0,0
5702,803,433,965,836,36,17,10,162,403,41,86,0,0
5703,810,430,970,835,36,17,10,160,405,42,86,0,0
5704,818,426,977,836,36,17,10,159,410,43,86,0,0
5705,828,422,983,828,36,17,10,155,406,44,86,0,0
5706,838,414,982,797,36,17,10,144,383,45,86,0,0
5707,841,409,980,786,36,17,10,139,377,46,86,0,0
5708,844,408,980,779,36,17,10,136,371,47,86,0,0
5709,848,404,980,768,36,17,10,132,364,48,86,0,0
5710,859,395,983,738,36,17,10,124,343,49,86,0,0
5711,861,390,982,724,36,17,10,121,334,50,86,0,0
5712,860,388,979,718,36,17,10,119,330,51,86,0,0
5713,859,386,977,714,36,17,10,118,328,52,86,0,0
5714,861,384,977,705,36,17,10,116,321,53,86,0,0
5715,866,381,982,701,36,17,10,116,320,54,86,0,0
5716,869,379,989,706,36,17,10,120,327,55,86,0,0
5717,878,382,1001,718,36,17,10,123,336,56,86,0,0
5718,872,381,1000,725,36,17,10,128,344,57,86,0,0
5719,867,386,996,726,36,17,10,129,340,58,86,0,0
5720,867,395,995,723,36,17,10,128,328,59,86,0,0
5721,867,396,996,720,36,17,10,129,324,60,86,0,0
5722,869,396,999,718,36,17,10,130,322,61,86,0,0
5723,873,396,1002,719,36,17,10,129,323,62,86,0,0
5724,873,395,1003,718,36,17,10,130,323,63,86,0,0
5725,871,396,1001,718,36,17,10,130,322,64,86,0,0
5726,865,396,999,722,36,17,10,134,326,65,86,0,0
5727,863,395,999,723,36,17,10,136,328,66,86,0,0
5728,861,395,999,723,36,17,10,138,328,67,86,0,0
5729,860,393,1001,724,36,17,10,141,331,68,86,0,0
5730,859,391,1002,725,36,17,10,143,334,69,86,0,0
5731,855,386,1001,726,36,17,10,146,340,70,86,0,0
5732,862,389,1005,726,36,17,10,143,337,71,86,0,0
5733,861,388,1005,728,36,17,10,144,340,72,86,0,0
5734,860,387,1005,729,36,17,10,145,342,73,86,0,0
5735,862,388,1005,729,36,17,10,143,341,74,86,0,0
5736,862,387,1004,729,36,17,10,142,342,75,86,0,0
5737,868,389,1007,727,36,17,10,139,338,76,86,0,0
5738,880,391,1015,726,36,17,10,135,335,77,86,0,0
5739,880,393,1013,728,36,17,10,133,335,78,86,0,0
5740,880,395,1010,726,36,17,10,130,331,79,86,0,0
5741,876,396,1006,725,36,17,10,130,329,80,86,0,0
5742,892,394,1017,719,36,17,10,125,325,81,86,0,0
5743,902,388,1021,711,36,17,10,119,323,82,86,0,0
5744,908,383,1022,694,36,17,10,114,311,83,86,0,0
5745,915,379,1025,692,36,17,10,110,313,84,86,0,0
5746,923,380,1026,685,36,17,10,103,305,85,86,0,0
5747,927,378,1029,681,36,17,10,102,303,86,86,1,0
5630,698,411,816,543,37,17,10,118,132,0,0,0,0
5631,645,417,794,685,38,17,10,149,268,0,0,0,0
5652,688,413,775,564,39,17,10,87,151,0,1,0,0
5653,683,415,769,564,39,17,10,86,149,1,1,0,0
5660,655,412,837,859,40,17,10,182,447,0,0,0,0
5697,236,239,303,339,41,17,10,67,100,0,303,0,1
5698,196,237,323,429,41,17,10,127,192,1,303,0,0
5699,184,235,322,446,41,17,10,138,211,2,303,0,0
5700,177,236,316,450,41,17,10,139,214,3,303,0,0
5701,174,245,303,449,41,17,10,129,204,4,303,0,0
5702,161,246,295,463,41,17,10,134,217,5,303,0,0
5703,156,245,290,469,41,17,10,134,224,6,303,0,0
5704,153,249,286,478,41,17,10,133,229,7,303,0,0
5705,153,250,283,482,41,17,10,130,232,8,303,0,0
5706,153,252,282,490,41,17,10,129,238,9,303,0,0
5707,153,258,279,497,41,17,10,126,239,10,303,0,0
5708,151,259,277,504,41,17,10,126,245,11,303,0,0
5709,149,261,278,518,41,17,10,129,257,12,303,0,0
5710,148,263,279,528,41,17,10,131,265,13,303,0,0
5711,153,264,280,532,41,17,10,127,268,14,303,0,0
5712,154,268,286,551,41,17,10,132,283,15,303,0,0
5713,154,273,282,555,41,17,10,128,282,16,303,0,0
5714,158,274,284,560,41,17,10,126,286,17,303,0,0
5715,163,278,290,575,41,17,10,127,297,18,303,0,0
5716,174,277,303,585,41,17,10,129,308,19,303,0,0
5717,181,278,312,598,41,17,10,131,320,20,303,0,0
5718,185,288,318,613,41,17,10,133,325,21,303,0,0
5719,191,291,330,627,41,17,10,139,336,22,303,0,0
5720,186,292,325,631,41,17,10,139,339,23,303,0,0
5721,184,294,326,644,41,17,10,142,350,24,303,0,0
5722,185,293,328,655,41,17,10,143,362,25,303,0,0
5723,187,295,328,659,41,17,10,141,364,26,303,0,0
5724,185,295,328,670,41,17,10,143,375,27,303,0,0
5725,181,302,325,682,41,17,10,144,380,28,303,0,0
5726,172,308,313,688,41,17,10,141,380,29,303,0,0
5727,167,308,303,684,41,17,10,136,376,30,303,0,0
5728,161,312,293,684,41,17,10,132,372,31,303,0,0
5729,159,313,288,684,41,17,10,129,371,32,303,0,0
5730,156,315,283,684,41,17,10,127,369,33,303,0,0
5731,155,313,280,685,41,17,10,125,372,34,303,0,0
5732,156,314,280,686,41,17,10,124,372,35,303,0,0
5733,156,314,279,686,41,17,10,123,372,36,303,0,0
5734,155,315,277,683,41,17,10,122,368,37,303,0,0
5735,156,317,276,683,41,17,10,120,366,38,303,0,0
5736,157,317,276,683,41,17,10,119,366,39,303,0,0
5737,156,318,274,683,41,17,10,118,365,40,303,0,0
5738,155,318,273,683,41,17,10,118,365,41,303,0,0
5739,154,319,271,681,41,17,10,117,362,42,303,0,0
5740,154,319,271,682,41,17,10,117,363,43,303,0,0
5741,154,320,271,686,41,17,10,117,366,44,303,0,0
5742,155,321,272,686,41,17,10,117,365,45,303,0,0
5743,156,322,273,686,41,17,10,117,364,46,303,0,0
5744,158,321,275,685,41,17,10,117,364,47,303,0,0
5745,159,322,274,684,41,17,10,115,362,48,303,0,0
5746,159,323,273,683,41,17,10,114,360,49,303,0,0
5747,159,325,272,682,41,17,10,113,357,50,303,0,0
5748,157,324,272,683,41,17,10,115,359,51,303,0,0
5749,156,322,271,684,41,17,10,115,362,52,303,0,0
5750,156,324,270,683,41,17,10,114,359,53,303,0,0
5751,157,324,271,683,41,17,10,114,359,54,303,0,0
5752,156,323,270,683,41,17,10,114,360,55,303,0,0
5753,156,324,270,683,41,17,10,114,359,56,303,0,0
5754,155,324,270,682,41,17,10,115,358,57,303,0,0
5755,155,324,269,681,41,17,10,114,357,58,303,0,0
5756,155,323,270,683,41,17,10,115,360,59,303,0,0
5757,156,321,272,685,41,17,10,116,364,60,303,0,0
5758,170,319,288,687,41,17,10,118,368,61,303,0,0
5759,187,316,310,689,41,17,10,123,373,62,303,0,0
5760,202,313,332,693,41,17,10,130,380,63,303,0,0
5761,210,314,343,694,41,17,10,133,380,64,303,0,0
5762,227,316,359,691,41,17,10,132,375,65,303,0,0
5763,249,312,380,692,41,17,10,131,380,66,303,0,0
5764,270,313,400,692,41,17,10,130,379,67,303,0,0
5765,295,318,425,690,41,17,10,130,372,68,303,0,0
5766,308,318,442,692,41,17,10,134,374,69,303,0,0
5767,320,317,458,695,41,17,10,138,378,70,303,0,0
5768,345,317,483,694,41,17,10,138,377,71,303,0,0
5769,368,317,502,690,41,17,10,134,373,72,303,0,0
5770,389,318,524,690,41,17,10,135,372,73,303,0,0
5771,402,321,538,691,41,17,10,136,370,74,303,0,0
5772,411,318,549,690,41,17,10,138,372,75,303,0,0
5773,427,322,562,685,41,17,10,135,363,76,303,0,0
5774,449,320,586,697,41,17,10,137,377,77,303,0,0
5775,457,322,593,698,41,17,10,136,376,78,303,0,0
5776,458,324,592,700,41,17,10,134,376,79,303,0,0
5777,461,326,593,699,41,17,10,132,373,80,303,0,0
5778,464,324,595,700,41,17,10,131,376,81,303,0,0
5779,465,322,595,700,41,17,10,130,378,82,303,0,0
5780,466,326,593,697,41,17,10,127,371,83,303,0,0
5781,471,324,600,701,41,17,10,129,377,84,303,0,0
5782,473,323,603,704,41,17,10,130,381,85,303,0,0
5783,477,323,606,704,41,17,10,129,381,86,303,0,0
5784,475,325,603,704,41,17,10,128,379,87,303,0,0
5785,473,325,600,703,41,17,10,127,378,88,303,0,0
5786,471,326,596,703,41,17,10,125,377,89,303,0,0
5787,470,324,594,703,41,17,10,124,379,90,303,0,0
5788,468,324,592,702,41,17,10,124,378,91,303,0,0
5789,468,325,591,702,41,17,10,123,377,92,303,0,0
5790,468,325,590,702,41,17,10,122,377,93,303,0,0
5791,468,326,589,703,41,17,10,121,377,94,303,0,0
5792,468,326,588,703,41,17,10,120,377,95,303,0,0
5793,469,326,589,703,41,17,10,120,377,96,303,0,0
5794,470,326,589,703,41,17,10,119,377,97,303,0,0
5795,471,326,589,703,41,17,10,118,377,98,303,0,0
5796,472,326,590,703,41,17,10,118,377,99,303,0,0
5797,472,326,590,703,41,17,10,118,377,100,303,0,0
5798,473,326,590,703,41,17,10,117,377,101,303,0,0
5799,474,326,591,703,41,17,10,117,377,102,303,0,0
5800,474,326,590,703,41,17,10,116,377,103,303,0,0
5801,475,325,591,703,41,17,10,116,378,104,303,0,0
5802,474,324,591,703,41,17,10,117,379,105,303,0,0
5803,474,324,590,703,41,17,10,116,379,106,303,0,0
5804,475,324,590,703,41,17,10,115,379,107,303,0,0
5805,475,325,591,703,41,17,10,116,378,108,303,0,0
5806,475,325,590,703,41,17,10,115,378,109,303,0,0
5807,475,325,590,703,41,17,10,115,378,110,303,0,0
5808,474,326,589,704,41,17,10,115,378,111,303,0,0
5809,474,326,589,704,41,17,10,115,378,112,303,0,0
5810,474,327,588,704,41,17,10,114,377,113,303,0,0
5811,475,326,590,705,41,17,10,115,379,114,303,0,0
5812,476,326,590,704,41,17,10,114,378,115,303,0,0
5813,475,326,589,704,41,17,10,114,378,116,303,0,0
5814,476,326,590,704,41,17,10,114,378,117,303,0,0
5815,475,325,589,704,41,17,10,114,379,118,303,0,0
5816,474,325,588,704,41,17,10,114,379,119,303,0,0
5817,474,326,588,703,41,17,10,114,377,120,303,0,0
5818,474,326,587,703,41,17,10,113,377,121,303,0,0
5819,474,326,587,703,41,17,10,113,377,122,303,0,0
5820,474,327,588,703,41,17,10,114,376,123,303,0,0
5821,473,327,587,703,41,17,10,114,376,124,303,0,0
5822,473,327,586,702,41,17,10,113,375,125,303,0,0
5823,473,328,586,702,41,17,10,113,374,126,303,0,0
5824,473,328,587,702,41,17,10,114,374,127,303,0,0
5825,473,327,587,702,41,17,10,114,375,128,303,0,0
5826,474,326,588,702,41,17,10,114,376,129,303,0,0
5827,473,326,588,702,41,17,10,115,376,130,303,0,0
5828,473,326,588,702,41,17,10,115,376,131,303,0,0
5829,473,325,588,702,41,17,10,115,377,132,303,0,0
5830,473,325,588,703,41,17,10,115,378,133,303,0,0
5831,473,327,588,703,41,17,10,115,376,134,303,0,0
5832,473,327,587,703,41,17,10,114,376,135,303,0,0
5833,472,327,587,703,41,17,10,115,376,136,303,0,0
5834,472,327,587,703,41,17,10,115,376,137,303,0,0
5835,472,328,586,703,41,17,10,114,375,138,303,0,0
5836,472,328,587,703,41,17,10,115,375,139,303,0,0
5837,473,327,588,702,41,17,10,115,375,140,303,0,0
5838,473,327,588,702,41,17,10,115,375,141,303,0,0
5839,473,327,588,702,41,17,10,115,375,142,303,0,0
5840,473,327,588,702,41,17,10,115,375,143,303,0,0
5841,473,326,588,702,41,17,10,115,376,144,303,0,0
5842,473,326,588,702,41,17,10,115,376,145,303,0,0
5843,473,326,588,702,41,17,10,115,376,146,303,0,0
5844,473,327,588,702,41,17,10,115,375,147,303,0,0
5845,473,327,588,702,41,17,10,115,375,148,303,0,0
5846,472,327,586,702,41,17,10,114,375,149,303,0,0
5847,471,328,586,702,41,17,10,115,374,150,303,0,0
5848,471,327,586,702,41,17,10,115,375,151,303,0,0
5849,471,327,586,702,41,17,10,115,375,152,303,0,0
5850,472,327,586,702,41,17,10,114,375,153,303,0,0
5851,473,327,587,702,41,17,10,114,375,154,303,0,0
5852,473,328,587,702,41,17,10,114,374,155,303,0,0
5853,473,328,587,702,41,17,10,114,374,156,303,0,0
5854,473,328,587,702,41,17,10,114,374,157,303,0,0
5855,473,327,587,702,41,17,10,114,375,158,303,0,0
5856,472,327,586,702,41,17,10,114,375,159,303,0,0
5857,472,327,586,702,41,17,10,114,375,160,303,0,0
5858,472,328,586,702,41,17,10,114,374,161,303,0,0
5859,472,328,585,702,41,17,10,113,374,162,303,0,0
5860,472,328,585,702,41,17,10,113,374,163,303,0,0
5861,470,329,583,702,41,17,10,113,373,164,303,0,0
5862,470,329,582,701,41,17,10,112,372,165,303,0,0
5863,470,330,582,701,41,17,10,112,371,166,303,0,0
5864,470,330,582,701,41,17,10,112,371,167,303,0,0
5865,470,330,582,701,41,17,10,112,371,168,303,0,0
5866,471,329,583,701,41,17,10,112,372,169,303,0,0
5867,472,329,584,702,41,17,10,112,373,170,303,0,0
5868,472,328,585,702,41,17,10,113,374,171,303,0,0
5869,472,328,585,702,41,17,10,113,374,172,303,0,0
5870,473,328,586,703,41,17,10,113,375,173,303,0,0
5871,473,328,586,703,41,17,10,113,375,174,303,0,0
5872,472,328,586,703,41,17,10,114,375,175,303,0,0
5873,473,328,587,703,41,17,10,114,375,176,303,0,0
5874,473,328,587,703,41,17,10,114,375,177,303,0,0
5875,473,328,587,703,41,17,10,114,375,178,303,0,0
5876,472,329,586,703,41,17,10,114,374,179,303,0,0
5877,472,329,586,703,41,17,10,114,374,180,303,0,0
5878,472,329,586,703,41,17,10,114,374,181,303,0,0
5879,473,330,587,703,41,17,10,114,373,182,303,0,0
5880,472,330,587,703,41,17,10,115,373,183,303,0,0
5881,473,329,588,703,41,17,10,115,374,184,303,0,0
5882,473,329,588,703,41,17,10,115,374,185,303,0,0
5883,473,329,588,703,41,17,10,115,374,186,303,0,0
5884,473,329,588,703,41,17,10,115,374,187,303,0,0
5885,473,328,588,703,41,17,10,115,375,188,303,0,0
5886,470,329,585,702,41,17,10,115,373,189,303,0,0
5887,470,330,583,701,41,17,10,113,371,190,303,0,0
5888,471,329,584,701,41,17,10,113,372,191,303,0,0
5889,470,328,584,701,41,17,10,114,373,192,303,0,0
5890,470,328,585,702,41,17,10,115,374,193,303,0,0
5891,468,328,583,702,41,17,10,115,374,194,303,0,0
5892,469,328,584,702,41,17,10,115,374,195,303,0,0
5893,470,328,585,702,41,17,10,115,374,196,303,0,0
5894,469,327,585,702,41,17,10,116,375,197,303,0,0
5895,470,327,585,702,41,17,10,115,375,198,303,0,0
5896,469,326,585,703,41,17,10,116,377,199,303,0,0
5897,469,326,585,703,41,17,10,116,377,200,303,0,0
5898,469,326,585,704,41,17,10,116,378,201,303,0,0
5899,468,326,584,703,41,17,10,116,377,202,303,0,0
5900,468,327,582,702,41,17,10,114,375,203,303,0,0
5901,469,328,582,702,41,17,10,113,374,204,303,0,0
5902,469,328,582,702,41,17,10,113,374,205,303,0,0
5903,469,328,581,701,41,17,10,112,373,206,303,0,0
5904,469,329,581,701,41,17,10,112,372,207,303,0,0
5905,470,329,581,701,41,17,10,111,372,208,303,0,0
5906,470,329,581,701,41,17,10,111,372,209,303,0,0
5907,470,329,581,701,41,17,10,111,372,210,303,0,0
5908,471,329,582,701,41,17,10,111,372,211,303,0,0
5909,472,329,582,701,41,17,10,110,372,212,303,0,0
5910,472,329,582,701,41,17,10,110,372,213,303,0,0
5911,473,329,582,700,41,17,10,109,371,214,303,0,0
5912,473,329,582,701,41,17,10,109,372,215,303,0,0
5913,475,330,584,701,41,17,10,109,371,216,303,0,0
5914,475,331,584,702,41,17,10,109,371,217,303,0,0
5915,475,330,584,702,41,17,10,109,372,218,303,0,0
5916,474,329,584,702,41,17,10,110,373,219,303,0,0
5917,473,329,585,702,41,17,10,112,373,220,303,0,0
5918,474,329,585,703,41,17,10,111,374,221,303,0,0
5919,474,329,586,703,41,17,10,112,374,222,303,0,0
5920,473,328,585,703,41,17,10,112,375,223,303,0,0
5921,472,330,585,703,41,17,10,113,373,224,303,0,0
5922,472,331,584,703,41,17,10,112,372,225,303,0,0
5923,472,331,585,704,41,17,10,113,373,226,303,0,0
5924,472,330,585,704,41,17,10,113,374,227,303,0,0
5925,472,330,585,703,41,17,10,113,373,228,303,0,0
5926,472,331,586,703,41,17,10,114,372,229,303,0,0
5927,472,331,586,703,41,17,10,114,372,230,303,0,0
5928,473,331,587,704,41,17,10,114,373,231,303,0,0
5929,473,331,587,704,41,17,10,114,373,232,303,0,0
5930,473,330,587,704,41,17,10,114,374,233,303,0,0
5931,473,329,587,703,41,17,10,114,374,234,303,0,0
5932,473,329,587,703,41,17,10,114,374,235,303,0,0
5933,473,328,588,703,41,17,10,115,375,236,303,0,0
5934,473,328,588,703,41,17,10,115,375,237,303,0,0
5935,473,327,588,703,41,17,10,115,376,238,303,0,0
5936,474,327,588,703,41,17,10,114,376,239,303,0,0
5937,475,328,588,703,41,17,10,113,375,240,303,0,0
5938,474,328,588,703,41,17,10,114,375,241,303,0,0
5939,474,328,588,704,41,17,10,114,376,242,303,0,0
5940,474,328,588,704,41,17,10,114,376,243,303,0,0
5941,473,329,587,704,41,17,10,114,375,244,303,0,0
5942,472,329,586,704,41,17,10,114,375,245,303,0,0
5943,472,329,586,704,41,17,10,114,375,246,303,0,0
5944,471,329,586,704,41,17,10,115,375,247,303,0,0
5945,472,328,586,704,41,17,10,114,376,248,303,0,0
5946,472,329,586,703,41,17,10,114,374,249,303,0,0
5947,472,330,585,703,41,17,10,113,373,250,303,0,0
5948,472,330,585,703,41,17,10,113,373,251,303,0,0
5949,472,330,585,702,41,17,10,113,372,252,303,0,0
5950,472,330,585,702,41,17,10,113,372,253,303,0,0
5951,472,329,586,702,41,17,10,114,373,254,303,0,0
5952,473,329,587,702,41,17,10,114,373,255,303,0,0
5953,474,329,587,702,41,17,10,113,373,256,303,0,0
5954,474,330,587,702,41,17,10,113,372,257,303,0,0
5955,473,330,587,702,41,17,10,114,372,258,303,0,0
5956,472,330,586,703,41,17,10,114,373,259,303,0,0
5957,473,330,585,703,41,17,10,112,373,260,303,0,0
5958,472,330,585,703,41,17,10,113,373,261,303,0,0
5959,472,330,585,703,41,17,10,113,373,262,303,0,0
5960,472,330,585,703,41,17,10,113,373,263,303,0,0
5961,472,330,585,703,41,17,10,113,373,264,303,0,0
5962,472,330,585,703,41,17,10,113,373,265,303,0,0
5963,472,330,585,702,41,17,10,113,372,266,303,0,0
5964,472,330,585,702,41,17,10,113,372,267,303,0,0
5965,472,330,586,702,41,17,10,114,372,268,303,0,0
5966,472,330,586,702,41,17,10,114,372,269,303,0,0
5967,472,330,585,702,41,17,10,113,372,270,303,0,0
5968,472,331,586,702,41,17,10,114,371,271,303,0,0
5969,472,331,585,702,41,17,10,113,371,272,303,0,0
5970,472,331,586,702,41,17,10,114,371,273,303,0,0
5971,473,330,587,702,41,17,10,114,372,274,303,0,0
5972,474,331,586,702,41,17,10,112,371,275,303,0,0
5973,474,330,586,702,41,17,10,112,372,276,303,0,0
5974,475,330,587,702,41,17,10,112,372,277,303,0,0
5975,475,330,586,702,41,17,10,111,372,278,303,0,0
5976,475,329,586,703,41,17,10,111,374,279,303,0,0
5977,475,329,586,703,41,17,10,111,374,280,303,0,0
5978,475,329,586,703,41,17,10,111,374,281,303,0,0
5979,475,330,586,704,41,17,10,111,374,282,303,0,0
5980,475,330,585,704,41,17,10,110,374,283,303,0,0
5981,474,332,584,703,41,17,10,110,371,284,303,0,0
5982,474,332,584,703,41,17,10,110,371,285,303,0,0
5983,474,333,584,703,41,17,10,110,370,286,303,0,0
5984,474,332,584,702,41,17,10,110,370,287,303,0,0
5985,473,332,584,703,41,17,10,111,371,288,303,0,0
5986,474,332,585,703,41,17,10,111,371,289,303,0,0
5987,474,332,585,701,41,17,10,111,369,290,303,0,0
5988,473,329,584,701,41,17,10,111,372,291,303,0,0
5989,476,327,588,701,41,17,10,112,374,292,303,0,0
5990,482,326,594,702,41,17,10,112,376,293,303,0,0
5991,486,328,598,704,41,17,10,112,376,294,303,0,0
5992,483,325,597,703,41,17,10,114,378,295,303,0,0
5993,469,325,585,700,41,17,10,116,375,296,303,0,0
5994,459,324,576,698,41,17,10,117,374,297,303,0,0
5995,449,322,565,692,41,17,10,116,370,298,303,0,0
5996,441,319,556,685,41,17,10,115,366,299,303,0,0
5997,439,318,551,678,41,17,10,112,360,300,303,0,0
5998,439,315,551,675,41,17,10,112,360,301,303,0,0
5999,440,314,552,676,41,17,10,112,362,302,303,0,0
6000,440,312,552,673,41,17,10,112,361,303,303,1,0
5975,238,242,294,437,42,17,10,56,195,0,25,0,1
5976,235,241,290,430,42,17,10,55,189,1,25,0,0
5977,233,242,287,427,42,17,10,54,185,2,25,0,0
5978,226,244,282,439,42,17,10,56,195,3,25,0,0
5979,220,249,276,444,42,17,10,56,195,4,25,0,0
5980,216,249,272,442,42,17,10,56,193,5,25,0,0
5981,213,251,272,449,42,17,10,59,198,6,25,0,0
5982,208,255,271,463,42,17,10,63,208,7,25,0,0
5983,213,253,275,458,42,17,10,62,205,8,25,0,0
5984,217,255,281,465,42,17,10,64,210,9,25,0,0
5985,222,257,288,477,42,17,10,66,220,10,25,0,0
5986,232,257,300,482,42,17,10,68,225,11,25,0,0
5987,243,259,312,485,42,17,10,69,226,12,25,0,0
5988,252,267,324,497,42,17,10,72,230,13,25,0,0
5989,263,266,335,497,42,17,10,72,231,14,25,0,0
5990,272,266,344,499,42,17,10,72,233,15,25,0,0
5991,281,270,355,509,42,17,10,74,239,16,25,0,0
5992,291,270,367,516,42,17,10,76,246,17,25,0,0
5993,302,271,379,521,42,17,10,77,250,18,25,0,0
5994,309,276,390,536,42,17,10,81,260,19,25,0,0
5995,319,279,400,537,42,17,10,81,258,20,25,0,0
5996,324,281,406,545,42,17,10,82,264,21,25,0,0
5997,332,284,415,552,42,17,10,83,268,22,25,0,0
5998,342,287,428,567,42,17,10,86,280,23,25,0,0
5999,353,288,442,578,42,17,10,89,290,24,25,0,0
6000,365,294,457,594,42,17,10,92,300,25,25,1,0
4122,1461,572,1920,1068,2,17,11,459,496,0,1,0,0
4123,1475,533,1920,1067,2,17,11,445,534,1,1,0,0
4123,1724,687,1919,1074,6,17,11,195,387,0,1,0,0
4124,1747,618,1920,1073,6,17,11,173,455,1,1,0,0
4125,1864,993,1920,1080,7,17,11,56,87,0,0,0,0
4127,1341,423,1596,1063,9,17,11,255,640,0,6,0,0
4128,1430,390,1697,1059,9,17,11,267,669,1,6,0,0
4129,1509,386,1784,1068,9,17,11,275,682,2,6,0,0
4130,1592,359,1879,1068,9,17,11,287,709,3,6,0,0
4131,1697,443,1920,1068,9,17,11,223,625,4,6,0,0
4132,1767,606,1920,1067,9,17,11,153,461,5,6,0,0
4133,1836,653,1920,1068,9,17,11,84,415,6,6,0,0
4129,1846,897,1918,1077,10,17,11,72,180,0,0,0,0
4132,1848,662,1920,765,12,17,11,72,103,0,0,0,0
5087,1820,885,1915,1080,14,17,11,95,195,0,0,0,0
5529,1878,962,1919,1076,15,17,11,41,114,0,0,0,0
5530,1763,865,1919,1078,16,17,11,156,213,0,32,0,1
5531,1692,700,1920,1068,16,17,11,228,368,1,32,0,0
5532,1607,541,1920,1073,16,17,11,313,532,2,32,0,0
5533,1524,453,1920,1067,16,17,11,396,614,3,32,0,0
5534,1433,407,1898,1065,16,17,11,465,658,4,32,0,0
5535,1332,399,1799,1066,16,17,11,467,667,5,32,0,0
5536,1226,400,1686,1062,16,17,11,460,662,6,32,0,0
5537,1118,401,1574,1062,16,17,11,456,661,7,32,0,0
5538,1004,416,1449,1067,16,17,11,445,651,8,32,0,0
5539,869,423,1298,1062,16,17,11,429,639,9,32,0,0
5540,777,431,1204,1072,16,17,11,427,641,10,32,0,0
5541,701,452,1116,1074,16,17,11,415,622,11,32,0,0
5542,614,462,1024,1075,16,17,11,410,613,12,32,0,0
5543,544,467,938,1052,16,17,11,394,585,13,32,0,0
5544,503,473,862,998,16,17,11,359,525,14,32,0,0
5545,455,468,844,1036,16,17,11,389,568,15,32,0,0
5546,426,458,834,1052,16,17,11,408,594,16,32,0,0
5547,420,457,836,1058,16,17,11,416,601,17,32,0,0
5548,429,465,847,1062,16,17,11,418,597,18,32,0,0
5549,438,475,853,1064,16,17,11,415,589,19,32,0,0
5550,472,485,882,1074,16,17,11,410,589,20,32,0,0
5551,516,505,903,1066,16,17,11,387,561,21,32,0,0
5552,573,528,940,1069,16,17,11,367,541,22,32,0,0
5553,640,550,992,1068,16,17,11,352,518,23,32,0,0
5554,729,563,1077,1069,16,17,11,348,506,24,32,0,0
5555,850,590,1188,1070,16,17,11,338,480,25,32,0,0
5556,991,567,1345,1063,16,17,11,354,496,26,32,0,0
5557,1116,553,1486,1061,16,17,11,370,508,27,32,0,0
5558,1268,549,1649,1067,16,17,11,381,518,28,32,0,0
5559,1399,536,1793,1071,16,17,11,394,535,29,32,0,0
5560,1503,525,1904,1074,16,17,11,401,549,30,32,0,0
5561,1628,600,1920,1078,16,17,11,292,478,31,32,0,0
5562,1706,605,1920,1079,16,17,11,214,474,32,32,1,0
5712,583,818,711,1068,19,17,11,128,250,0,0,0,0
5718,935,180,1206,1008,20,17,11,271,828,0,23,0,1
5719,1004,129,1245,865,20,17,11,241,736,1,23,0,0
5720,1068,96,1309,827,20,17,11,241,731,2,23,0,0
5721,1114,68,1330,721,20,17,11,216,653,3,23,0,0
5722,1149,41,1357,670,20,17,11,208,629,4,23,0,0
5723,1184,31,1379,623,20,17,11,195,592,5,23,0,0
5724,1216,10,1392,541,20,17,11,176,531,6,23,0,0
5725,1243,4,1412,510,20,17,11,169,506,7,23,0,0
5726,1270,2,1420,443,20,17,11,150,441,8,23,0,0
5727,1286,0,1429,416,20,17,11,143,416,9,23,0,0
5728,1297,0,1433,389,20,17,11,136,389,10,23,0,0
5729,1314,0,1438,350,20,17,11,124,350,11,23,0,0
5730,1326,0,1444,333,20,17,11,118,333,12,23,0,0
5731,1340,0,1446,290,20,17,11,106,290,13,23,0,0
5732,1347,0,1449,274,20,17,11,102,274,14,23,0,0
5733,1352,0,1446,247,20,17,11,94,247,15,23,0,0
5734,1360,0,1448,225,20,17,11,88,225,16,23,0,0
5735,1369,0,1454,218,20,17,11,85,218,17,23,0,0
5736,1375,0,1452,196,20,17,11,77,196,18,23,0,0
5737,1376,3,1448,183,20,17,11,72,180,19,23,0,0
5738,1383,2,1446,159,20,17,11,63,157,20,23,0,0
5739,1388,4,1447,145,20,17,11,59,141,21,23,0,0
5740,1390,1,1447,135,20,17,11,57,134,22,23,0,0
5741,1398,0,1447,116,20,17,11,49,116,23,23,1,0
3834,1847,383,1920,663,2,17,12,73,280,0,32,0,1
3835,1840,390,1919,694,2,17,12,79,304,1,32,0,0
3836,1830,392,1915,719,2,17,12,85,327,2,32,0,0
3837,1820,391,1907,721,2,17,12,87,330,3,32,0,0
3838,1796,399,1886,734,2,17,12,90,335,4,32,0,0
3839,1782,397,1878,740,2,17,12,96,343,5,32,0,0
3840,1774,396,1873,743,2,17,12,99,347,6,32,0,0
3841,1761,404,1863,753,2,17,12,102,349,7,32,0,0
3842,1740,412,1851,782,2,17,12,111,370,8,32,0,0
3843,1729,417,1841,779,2,17,12,112,362,9,32,0,0
3844,1702,424,1824,803,2,17,12,122,379,10,32,0,0
3845,1672,417,1807,822,2,17,12,135,405,11,32,0,0
3846,1655,416,1796,829,2,17,12,141,413,12,32,0,0
3847,1633,426,1781,852,2,17,12,148,426,13,32,0,0
3848,1604,437,1766,894,2,17,12,162,457,14,32,0,0
3849,1581,448,1747,906,2,17,12,166,458,15,32,0,0
3850,1540,449,1718,922,2,17,12,178,473,16,32,0,0
3851,1492,449,1686,950,2,17,12,194,501,17,32,0,0
3852,1460,441,1669,971,2,17,12,209,530,18,32,0,0
3853,1439,454,1653,995,2,17,12,214,541,19,32,0,0
3854,1399,471,1629,1042,2,17,12,230,571,20,32,0,0
3855,1373,477,1612,1060,2,17,12,239,583,21,32,0,0
3856,1339,494,1584,1074,2,17,12,245,580,22,32,0,0
3857,1309,508,1557,1080,2,17,12,248,572,23,32,0,0
3858,1285,517,1535,1080,2,17,12,250,563,24,32,0,0
3859,1269,541,1515,1080,2,17,12,246,539,25,32,0,0
3860,1259,599,1490,1077,2,17,12,231,478,26,32,0,0
3861,1248,636,1477,1080,2,17,12,229,444,27,32,0,0
3862,1239,675,1462,1078,2,17,12,223,403,28,32,0,0
3863,1216,758,1420,1080,2,17,12,204,322,29,32,0,0
3864,1198,829,1379,1080,2,17,12,181,251,30,32,0,0
3865,1271,907,1410,1080,2,17,12,139,173,31,32,0,0
3866,1281,953,1388,1080,2,17,12,107,127,32,32,1,0
3838,1852,398,1919,682,3,17,12,67,284,0,0,0,0
3840,1857,389,1919,696,4,17,12,62,307,0,29,0,1
3841,1864,398,1920,688,4,17,12,56,290,1,29,0,0
3842,1845,396,1912,731,4,17,12,67,335,2,29,0,0
3843,1841,394,1916,762,4,17,12,75,368,3,29,0,0
3844,1831,401,1909,781,4,17,12,78,380,4,29,0,0
3845,1828,401,1909,795,4,17,12,81,394,5,29,0,0
3846,1819,429,1900,813,4,17,12,81,384,6,29,0,0
3847,1797,412,1888,826,4,17,12,91,414,7,29,0,0
3848,1793,416,1889,837,4,17,12,96,421,8,29,0,0
3849,1770,424,1874,847,4,17,12,104,423,9,29,0,0
3850,1762,442,1873,867,4,17,12,111,425,10,29,0,0
3851,1752,444,1872,887,4,17,12,120,443,11,29,0,0
3852,1741,451,1875,931,4,17,12,134,480,12,29,0,0
3853,1732,482,1872,958,4,17,12,140,476,13,29,0,0
3854,1713,491,1862,978,4,17,12,149,487,14,29,0,0
3855,1683,495,1849,1004,4,17,12,166,509,15,29,0,0
3856,1641,492,1829,1041,4,17,12,188,549,16,29,0,0
3857,1622,505,1816,1050,4,17,12,194,545,17,29,0,0
3858,1604,513,1806,1067,4,17,12,202,554,18,29,0,0
3859,1577,535,1782,1074,4,17,12,205,539,19,29,0,0
3860,1559,545,1770,1079,4,17,12,211,534,20,29,0,0
3861,1540,560,1756,1080,4,17,12,216,520,21,29,0,0
3862,1535,590,1748,1080,4,17,12,213,490,22,29,0,0
3863,1518,607,1732,1080,4,17,12,214,473,23,29,0,0
3864,1503,629,1720,1080,4,17,12,217,451,24,29,0,0
3865,1514,678,1725,1080,4,17,12,211,402,25,29,0,0
3866,1541,723,1748,1080,4,17,12,207,357,26,29,0,0
3867,1602,774,1795,1078,4,17,12,193,304,27,29,0,0
3868,1652,833,1827,1080,4,17,12,175,247,28,29,0,0
3869,1672,865,1828,1080,4,17,12,156,215,29,29,1,0
3846,1803,403,1884,614,5,17,12,81,211,0,0,0,0
3848,1759,389,1859,630,6,17,12,100,241,0,0,0,0
3852,1624,414,1788,839,7,17,12,164,425,0,18,0,0
3853,1594,407,1762,843,7,17,12,168,436,1,18,0,0
3854,1577,408,1750,858,7,17,12,173,450,2,18,0,0
3855,1577,416,1733,821,7,17,12,156,405,3,18,0,0
3856,1551,415,1713,840,7,17,12,162,425,4,18,0,0
3857,1511,422,1694,903,7,17,12,183,481,5,18,0,0
3858,1483,434,1670,930,7,17,12,187,496,6,18,0,0
3859,1457,439,1633,913,7,17,12,176,474,7,18,0,0
3860,1379,444,1542,848,7,17,12,163,404,8,18,0,0
3861,1332,466,1491,829,7,17,12,159,363,9,18,0,0
3862,1292,475,1465,847,7,17,12,173,372,10,18,0,0
3863,1276,487,1466,883,7,17,12,190,396,11,18,0,0
3864,1230,521,1444,954,7,17,12,214,433,12,18,0,0
3865,1148,546,1396,1029,7,17,12,248,483,13,18,0,0
3866,1085,568,1353,1062,7,17,12,268,494,14,18,0,0
3867,1078,617,1339,1073,7,17,12,261,456,15,18,0,0
3868,1098,670,1348,1080,7,17,12,250,410,16,18,0,0
3869,1157,750,1377,1077,7,17,12,220,327,17,18,0,0
3870,1140,778,1354,1080,7,17,12,214,302,18,18,0,0
4153,1851,497,1919,738,10,17,12,68,241,0,0,0,0
4155,1837,465,1919,773,11,17,12,82,308,0,24,0,1
4156,1823,427,1917,780,11,17,12,94,353,1,24,0,0
4157,1800,439,1897,799,11,17,12,97,360,2,24,0,0
4158,1796,444,1892,789,11,17,12,96,345,3,24,0,0
4159,1785,434,1895,824,11,17,12,110,390,4,24,0,0
4160,1777,447,1900,876,11,17,12,123,429,5,24,0,0
4161,1771,449,1902,906,11,17,12,131,457,6,24,0,0
4162,1759,441,1898,915,11,17,12,139,474,7,24,0,0
4163,1744,471,1890,952,11,17,12,146,481,8,24,0,0
4164,1730,484,1888,992,11,17,12,158,508,9,24,0,0
4165,1724,494,1891,1019,11,17,12,167,525,10,24,0,0
4166,1719,513,1891,1045,11,17,12,172,532,11,24,0,0
4167,1715,536,1887,1049,11,17,12,172,513,12,24,0,0
4168,1678,542,1866,1074,11,17,12,188,532,13,24,0,0
4169,1640,563,1834,1080,11,17,12,194,517,14,24,0,0
4170,1604,576,1802,1080,11,17,12,198,504,15,24,0,0
4171,1587,590,1788,1080,11,17,12,201,490,16,24,0,0
4172,1553,613,1750,1078,11,17,12,197,465,17,24,0,0
4173,1498,643,1693,1078,11,17,12,195,435,18,24,0,0
4174,1437,651,1638,1075,11,17,12,201,424,19,24,0,0
4175,1358,687,1555,1075,11,17,12,197,388,20,24,0,0
4176,1238,708,1440,1077,11,17,12,202,369,21,24,0,0
4177,1109,709,1327,1080,11,17,12,218,371,22,24,0,0
4178,967,746,1184,1080,11,17,12,217,334,23,24,0,0
4179,902,764,1112,1080,11,17,12,210,316,24,24,1,0
4230,1861,539,1918,794,16,17,12,57,255,0,0,0,0
4233,1847,514,1920,841,17,17,12,73,327,0,17,0,0
4234,1826,487,1907,847,17,17,12,81,360,1,17,0,0
4235,1795,494,1885,885,17,17,12,90,391,2,17,0,0
4236,1781,474,1881,898,17,17,12,100,424,3,17,0,0
4237,1767,455,1883,936,17,17,12,116,481,4,17,0,0
4238,1756,491,1872,954,17,17,12,116,463,5,17,0,0
4239,1732,502,1852,957,17,17,12,120,455,6,17,0,0
4240,1682,513,1814,985,17,17,12,132,472,7,17,0,0
4241,1640,525,1788,1019,17,17,12,148,494,8,17,0,0
4242,1622,535,1782,1052,17,17,12,160,517,9,17,0,0
4243,1610,565,1776,1077,17,17,12,166,512,10,17,0,0
4244,1587,584,1757,1080,17,17,12,170,496,11,17,0,0
4245,1565,612,1739,1080,17,17,12,174,468,12,17,0,0
4246,1550,646,1723,1080,17,17,12,173,434,13,17,0,0
4247,1547,684,1719,1080,17,17,12,172,396,14,17,0,0
4248,1549,749,1711,1077,17,17,12,162,328,15,17,0,0
4249,1592,829,1736,1077,17,17,12,144,248,16,17,0,0
4250,1593,862,1724,1080,17,17,12,131,218,17,17,0,0
4264,1858,619,1920,769,18,17,12,62,150,0,33,0,1
4265,1824,524,1920,786,18,17,12,96,262,1,33,0,0
4266,1820,512,1920,793,18,17,12,100,281,2,33,0,0
4267,1809,496,1920,831,18,17,12,111,335,3,33,0,0
4268,1805,489,1920,847,18,17,12,115,358,4,33,0,0
4269,1806,557,1920,855,18,17,12,114,298,5,33,0,0
4270,1770,498,1917,865,18,17,12,147,367,6,33,0,0
4271,1753,460,1920,877,18,17,12,167,417,7,33,0,0
4272,1746,470,1920,913,18,17,12,174,443,8,33,0,0
4273,1739,482,1920,953,18,17,12,181,471,9,33,0,0
4274,1732,494,1917,961,18,17,12,185,467,10,33,0,0
4275,1695,498,1890,975,18,17,12,195,477,11,33,0,0
4276,1667,506,1873,992,18,17,12,206,486,12,33,0,0
4277,1647,503,1869,1022,18,17,12,222,519,13,33,0,0
4278,1619,517,1855,1062,18,17,12,236,545,14,33,0,0
4279,1597,524,1839,1074,18,17,12,242,550,15,33,0,0
4280,1550,534,1800,1080,18,17,12,250,546,16,33,0,0
4281,1504,553,1754,1080,18,17,12,250,527,17,33,0,0
4282,1462,561,1714,1080,18,17,12,252,519,18,33,0,0
4283,1405,572,1662,1079,18,17,12,257,507,19,33,0,0
4284,1353,580,1613,1078,18,17,12,260,498,20,33,0,0
4285,1300,587,1566,1080,18,17,12,266,493,21,33,0,0
4286,1243,603,1504,1074,18,17,12,261,471,22,33,0,0
4287,1161,617,1422,1079,18,17,12,261,462,23,33,0,0
4288,1049,634,1313,1078,18,17,12,264,444,24,33,0,0
4289,927,668,1190,1076,18,17,12,263,408,25,33,0,0
4290,841,681,1098,1073,18,17,12,257,392,26,33,0,0
4291,747,701,996,1079,18,17,12,249,378,27,33,0,0
4292,619,716,860,1079,18,17,12,241,363,28,33,0,0
4293,478,725,717,1080,18,17,12,239,355,29,33,0,0
4294,336,742,569,1080,18,17,12,233,338,30,33,0,0
4295,193,775,411,1079,18,17,12,218,304,31,33,0,0
4296,58,785,272,1072,18,17,12,214,287,32,33,0,0
4297,0,799,160,1073,18,17,12,160,274,33,33,1,0
4349,10,539,263,1051,19,17,12,253,512,0,1,0,0
4350,0,523,241,1054,19,17,12,241,531,1,1,0,0
4350,120,586,305,1052,20,17,12,185,466,0,101,0,1
4351,120,511,341,1065,20,17,12,221,554,1,101,0,0
4352,189,473,429,1066,20,17,12,240,593,2,101,0,0
4353,227,448,479,1068,20,17,12,252,620,3,101,0,0
4354,256,417,509,1036,20,17,12,253,619,4,101,0,0
4355,266,397,521,1020,20,17,12,255,623,5,101,0,0
4356,278,389,527,998,20,17,12,249,609,6,101,0,0
4357,309,370,544,939,20,17,12,235,569,7,101,0,0
4358,312,351,537,897,20,17,12,225,546,8,101,0,0
4359,300,338,521,877,20,17,12,221,539,9,101,0,0
4360,289,321,497,829,20,17,12,208,508,10,101,0,0
4361,288,319,487,804,20,17,12,199,485,11,101,0,0
4362,301,307,494,779,20,17,12,193,472,12,101,0,0
4363,304,290,484,734,20,17,12,180,444,13,101,0,0
4364,299,279,474,715,20,17,12,175,436,14,101,0,0
4365,294,272,457,682,20,17,12,163,410,15,101,0,0
4366,292,264,451,661,20,17,12,159,397,16,101,0,0
4367,298,262,454,653,20,17,12,156,391,17,101,0,0
4368,304,252,450,620,20,17,12,146,368,18,101,0,0
4369,303,244,441,598,20,17,12,138,354,19,101,0,0
4370,298,241,430,583,20,17,12,132,342,20,101,0,0
4371,292,234,418,561,20,17,12,126,327,21,101,0,0
4372,291,232,416,556,20,17,12,125,324,22,101,0,0
4373,296,226,415,538,20,17,12,119,312,23,101,0,0
4374,296,220,410,521,20,17,12,114,301,24,101,0,0
4375,294,219,403,509,20,17,12,109,290,25,101,0,0
4376,291,213,397,496,20,17,12,106,283,26,101,0,0
4377,289,212,392,487,20,17,12,103,275,27,101,0,0
4378,293,215,391,480,20,17,12,98,265,28,101,0,0
4379,295,206,390,466,20,17,12,95,260,29,101,0,0
4380,295,203,388,457,20,17,12,93,254,30,101,0,0
4381,292,200,382,451,20,17,12,90,251,31,101,0,0
4382,289,198,376,439,20,17,12,87,241,32,101,0,0
4383,292,198,376,435,20,17,12,84,237,33,101,0,0
4384,294,194,375,422,20,17,12,81,228,34,101,0,0
4385,295,189,373,412,20,17,12,78,223,35,101,0,0
4386,293,189,369,407,20,17,12,76,218,36,101,0,0
4387,291,184,365,398,20,17,12,74,214,37,101,0,0
4388,289,183,363,394,20,17,12,74,211,38,101,0,0
4389,293,183,365,389,20,17,12,72,206,39,101,0,0
4390,294,179,365,380,20,17,12,71,201,40,101,0,0
4391,292,178,360,373,20,17,12,68,195,41,101,0,0
4392,287,177,354,367,20,17,12,67,190,42,101,0,0
4393,284,173,351,361,20,17,12,67,188,43,101,0,0
4394,284,172,350,360,20,17,12,66,188,44,101,0,0
4395,287,172,351,350,20,17,12,64,178,45,101,0,0
4396,286,170,349,347,20,17,12,63,177,46,101,0,0
4397,284,172,345,346,20,17,12,61,174,47,101,0,0
4398,281,167,343,338,20,17,12,62,171,48,101,0,0
4399,280,163,342,335,20,17,12,62,172,49,101,0,0
4400,283,163,345,332,20,17,12,62,169,50,101,0,0
4401,285,161,345,327,20,17,12,60,166,51,101,0,0
4402,285,161,343,322,20,17,12,58,161,52,101,0,0
4403,283,159,342,319,20,17,12,59,160,53,101,0,0
4404,281,157,340,316,20,17,12,59,159,54,101,0,0
4405,284,157,341,311,20,17,12,57,154,55,101,0,0
4406,286,156,342,307,20,17,12,56,151,56,101,0,0
4407,283,156,338,304,20,17,12,55,148,57,101,0,0
4408,281,154,334,301,20,17,12,53,147,58,101,0,0
4409,279,152,332,297,20,17,12,53,145,59,101,0,0
4410,279,153,332,296,20,17,12,53,143,60,101,0,0
4411,281,150,332,291,20,17,12,51,141,61,101,0,0
4412,281,149,331,289,20,17,12,50,140,62,101,0,0
4413,280,150,329,285,20,17,12,49,135,63,101,0,0
4414,280,149,327,280,20,17,12,47,131,64,101,0,0
4415,279,148,327,278,20,17,12,48,130,65,101,0,0
4416,282,149,329,279,20,17,12,47,130,66,101,0,0
4417,282,146,330,277,20,17,12,48,131,67,101,0,0
4418,283,148,328,274,20,17,12,45,126,68,101,0,0
4419,282,147,326,269,20,17,12,44,122,69,101,0,0
4420,282,145,326,267,20,17,12,44,122,70,101,0,0
4421,284,146,327,264,20,17,12,43,118,71,101,0,0
4422,284,145,326,261,20,17,12,42,116,72,101,0,0
4423,285,145,326,260,20,17,12,41,115,73,101,0,0
4424,284,146,324,258,20,17,12,40,112,74,101,0,0
4425,283,144,323,255,20,17,12,40,111,75,101,0,0
4426,283,144,323,254,20,17,12,40,110,76,101,0,0
4427,284,142,324,253,20,17,12,40,111,77,101,0,0
4428,285,141,325,252,20,17,12,40,111,78,101,0,0
4429,284,141,323,252,20,17,12,39,111,79,101,0,0
4430,284,138,323,248,20,17,12,39,110,80,101,0,0
4431,285,137,323,246,20,17,12,38,109,81,101,0,0
4432,288,141,325,244,20,17,12,37,103,82,101,0,0
4433,290,137,327,242,20,17,12,37,105,83,101,0,0
4434,290,136,327,239,20,17,12,37,103,84,101,0,0
4435,290,135,327,239,20,17,12,37,104,85,101,0,0
4436,289,132,327,237,20,17,12,38,105,86,101,0,0
4437,290,133,328,237,20,17,12,38,104,87,101,0,0
4438,292,126,331,234,20,17,12,39,108,88,101,0,0
4439,293,129,330,234,20,17,12,37,105,89,101,0,0
4440,291,126,329,232,20,17,12,38,106,90,101,0,0
4441,290,123,328,231,20,17,12,38,108,91,101,0,0
4442,290,123,328,230,20,17,12,38,107,92,101,0,0
4443,292,124,329,226,20,17,12,37,102,93,101,0,0
4444,293,124,329,225,20,17,12,36,101,94,101,0,0
4445,292,123,328,224,20,17,12,36,101,95,101,0,0
4446,292,122,327,221,20,17,12,35,99,96,101,0,0
4447,291,122,327,221,20,17,12,36,99,97,101,0,0
4448,293,122,328,220,20,17,12,35,98,98,101,0,0
4449,294,121,329,217,20,17,12,35,96,99,101,0,0
4450,294,121,329,218,20,17,12,35,97,100,101,0,0
4451,293,122,328,216,20,17,12,35,94,101,101,1,0
4564,275,118,311,238,20,17,12,36,120,0,101,0,0
4576,288,143,323,264,20,17,12,35,121,0,101,0,1
4577,287,143,322,266,20,17,12,35,123,1,101,0,0
4578,287,147,322,270,20,17,12,35,123,2,101,0,0
4579,284,148,320,272,20,17,12,36,124,3,101,0,0
4580,281,149,319,277,20,17,12,38,128,4,101,0,0
4581,282,148,320,279,20,17,12,38,131,5,101,0,0
4582,281,148,321,281,20,17,12,40,133,6,101,0,0
4583,280,149,320,284,20,17,12,40,135,7,101,0,0
4584,278,149,319,284,20,17,12,41,135,8,101,0,0
4585,276,149,318,288,20,17,12,42,139,9,101,0,0
4586,277,151,319,291,20,17,12,42,140,10,101,0,0
4587,279,150,323,293,20,17,12,44,143,11,101,0,0
4588,282,154,327,298,20,17,12,45,144,12,101,0,0
4589,283,155,328,299,20,17,12,45,144,13,101,0,0
4590,281,154,327,301,20,17,12,46,147,14,101,0,0
4591,281,156,329,308,20,17,12,48,152,15,101,0,0
4592,282,157,330,311,20,17,12,48,154,16,101,0,0
4593,282,158,331,314,20,17,12,49,156,17,101,0,0
4594,281,158,331,317,20,17,12,50,159,18,101,0,0
4595,278,157,329,319,20,17,12,51,162,19,101,0,0
4596,276,155,332,332,20,17,12,56,177,20,101,0,0
4597,276,155,334,338,20,17,12,58,183,21,101,0,0
4598,276,156,334,338,20,17,12,58,182,22,101,0,0
4599,275,158,332,339,20,17,12,57,181,23,101,0,0
4600,274,165,329,342,20,17,12,55,177,24,101,0,0
4601,273,170,328,346,20,17,12,55,176,25,101,0,0
4602,273,172,330,356,20,17,12,57,184,26,101,0,0
4603,275,174,334,361,20,17,12,59,187,27,101,0,0
4604,276,174,336,365,20,17,12,60,191,28,101,0,0
4605,275,177,337,374,20,17,12,62,197,29,101,0,0
4606,274,178,338,379,20,17,12,64,201,30,101,0,0
4607,276,178,342,384,20,17,12,66,206,31,101,0,0
4608,280,182,348,391,20,17,12,68,209,32,101,0,0
4609,282,182,351,394,20,17,12,69,212,33,101,0,0
4610,283,183,354,403,20,17,12,71,220,34,101,0,0
4611,281,186,354,411,20,17,12,73,225,35,101,0,0
4612,280,187,353,413,20,17,12,73,226,36,101,0,0
4613,279,192,354,421,20,17,12,75,229,37,101,0,0
4614,281,194,356,425,20,17,12,75,231,38,101,0,0
4615,282,195,360,433,20,17,12,78,238,39,101,0,0
4616,280,198,363,449,20,17,12,83,251,40,101,0,0
4617,277,199,363,457,20,17,12,86,258,41,101,0,0
4618,278,204,363,460,20,17,12,85,256,42,101,0,0
4619,279,211,366,473,20,17,12,87,262,43,101,0,0
4620,283,209,374,480,20,17,12,91,271,44,101,0,0
4621,284,213,379,498,20,17,12,95,285,45,101,0,0
4622,288,222,383,507,20,17,12,95,285,46,101,0,0
4623,290,223,386,513,20,17,12,96,290,47,101,0,0
4624,299,228,394,519,20,17,12,95,291,48,101,0,0
4625,309,227,409,534,20,17,12,100,307,49,101,0,0
4626,315,230,419,546,20,17,12,104,316,50,101,0,0
4627,311,241,419,567,20,17,12,108,326,51,101,0,0
4628,307,243,419,577,20,17,12,112,334,52,101,0,0
4629,308,247,421,584,20,17,12,113,337,53,101,0,0
4630,308,254,428,611,20,17,12,120,357,54,101,0,0
4631,309,256,433,625,20,17,12,124,369,55,101,0,0
4632,304,262,436,653,20,17,12,132,391,56,101,0,0
4633,301,276,438,679,20,17,12,137,403,57,101,0,0
4634,302,283,442,692,20,17,12,140,409,58,101,0,0
4635,306,290,451,715,20,17,12,145,425,59,101,0,0
4636,311,299,461,740,20,17,12,150,441,60,101,0,0
4637,315,306,466,751,20,17,12,151,445,61,101,0,0
4638,309,315,473,804,20,17,12,164,489,62,101,0,0
4639,309,324,479,830,20,17,12,170,506,63,101,0,0
4640,311,335,485,844,20,17,12,174,509,64,101,0,0
4641,305,356,489,893,20,17,12,184,537,65,101,0,0
4642,307,368,497,915,20,17,12,190,547,66,101,0,0
4643,300,386,500,964,20,17,12,200,578,67,101,0,0
4644,289,407,496,1006,20,17,12,207,599,68,101,0,0
4645,278,422,491,1033,20,17,12,213,611,69,101,0,0
4646,260,442,481,1065,20,17,12,221,623,70,101,0,0
4647,248,463,469,1074,20,17,12,221,611,71,101,0,0
4648,230,485,452,1080,20,17,12,222,595,72,101,0,0
4649,203,523,419,1080,20,17,12,216,557,73,101,0,0
4650,138,552,356,1079,20,17,12,218,527,74,101,0,0
4651,95,592,307,1073,20,17,12,212,481,75,101,0,0
4652,80,611,290,1080,20,17,12,210,469,76,101,0,0
4375,1860,405,1920,664,21,17,12,60,259,0,25,0,1
4376,1858,425,1916,677,21,17,12,58,252,1,25,0,0
4377,1857,434,1914,680,21,17,12,57,246,2,25,0,0
4378,1854,426,1916,693,21,17,12,62,267,3,25,0,0
4379,1851,440,1912,695,21,17,12,61,255,4,25,0,0
4380,1845,434,1910,702,21,17,12,65,268,5,25,0,0
4381,1837,432,1906,706,21,17,12,69,274,6,25,0,0
4382,1823,426,1898,714,21,17,12,75,288,7,25,0,0
4383,1811,421,1892,717,21,17,12,81,296,8,25,0,0
4384,1805,421,1888,717,21,17,12,83,296,9,25,0,0
4385,1798,425,1884,722,21,17,12,86,297,10,25,0,0
4386,1791,430,1881,731,21,17,12,90,301,11,25,0,0
4387,1781,429,1877,740,21,17,12,96,311,12,25,0,0
4388,1776,426,1876,742,21,17,12,100,316,13,25,0,0
4389,1767,424,1871,744,21,17,12,104,320,14,25,0,0
4390,1757,424,1865,744,21,17,12,108,320,15,25,0,0
4391,1754,416,1869,747,21,17,12,115,331,16,25,0,0
4392,1751,432,1859,730,21,17,12,108,298,17,25,0,0
4393,1755,429,1866,724,21,17,12,111,295,18,25,0,0
4394,1763,423,1878,717,21,17,12,115,294,19,25,0,0
4395,1776,427,1890,716,21,17,12,114,289,20,25,0,0
4396,1782,425,1899,714,21,17,12,117,289,21,25,0,0
4397,1789,414,1911,716,21,17,12,122,302,22,25,0,0
4398,1818,438,1920,712,21,17,12,102,274,23,25,0,0
4399,1839,450,1920,706,21,17,12,81,256,24,25,0,0
4400,1845,453,1920,705,21,17,12,75,252,25,25,1,0
4444,1851,427,1920,713,22,17,12,69,286,0,59,0,1
4445,1851,390,1920,710,22,17,12,69,320,1,59,0,0
4446,1847,380,1920,726,22,17,12,73,346,2,59,0,0
4447,1845,371,1920,732,22,17,12,75,361,3,59,0,0
4448,1825,384,1915,758,22,17,12,90,374,4,59,0,0
4449,1798,383,1894,766,22,17,12,96,383,5,59,0,0
4450,1772,394,1875,784,22,17,12,103,390,6,59,0,0
4451,1758,391,1870,791,22,17,12,112,400,7,59,0,0
4452,1755,394,1877,813,22,17,12,122,419,8,59,0,0
4453,1735,404,1868,839,22,17,12,133,435,9,59,0,0
4454,1713,413,1851,853,22,17,12,138,440,10,59,0,0
4455,1686,416,1831,859,22,17,12,145,443,11,59,0,0
4456,1650,442,1806,896,22,17,12,156,454,12,59,0,0
4457,1632,441,1801,922,22,17,12,169,481,13,59,0,0
4458,1617,445,1796,944,22,17,12,179,499,14,59,0,0
4459,1601,458,1792,984,22,17,12,191,526,15,59,0,0
4460,1583,477,1786,1026,22,17,12,203,549,16,59,0,0
4461,1556,490,1766,1040,22,17,12,210,550,17,59,0,0
4462,1513,516,1734,1060,22,17,12,221,544,18,59,0,0
4463,1492,534,1714,1064,22,17,12,222,530,19,59,0,0
4464,1474,536,1707,1075,22,17,12,233,539,20,59,0,0
4465,1468,559,1698,1077,22,17,12,230,518,21,59,0,0
4466,1470,586,1695,1074,22,17,12,225,488,22,59,0,0
4467,1451,596,1683,1077,22,17,12,232,481,23,59,0,0
4468,1429,614,1665,1076,22,17,12,236,462,24,59,0,0
4469,1403,619,1642,1073,22,17,12,239,454,25,59,0,0
4470,1370,612,1620,1073,22,17,12,250,461,26,59,0,0
4471,1340,607,1599,1073,22,17,12,259,466,27,59,0,0
4472,1321,614,1582,1074,22,17,12,261,460,28,59,0,0
4473,1286,615,1551,1073,22,17,12,265,458,29,59,0,0
4474,1219,600,1496,1074,22,17,12,277,474,30,59,0,0
4475,1161,572,1455,1073,22,17,12,294,501,31,59,0,0
4476,1116,561,1416,1074,22,17,12,300,513,32,59,0,0
4477,1101,571,1400,1072,22,17,12,299,501,33,59,0,0
4478,1115,590,1409,1073,22,17,12,294,483,34,59,0,0
4479,1146,595,1441,1073,22,17,12,295,478,35,59,0,0
4480,1180,606,1473,1071,22,17,12,293,465,36,59,0,0
4481,1212,611,1508,1074,22,17,12,296,463,37,59,0,0
4482,1232,618,1532,1076,22,17,12,300,458,38,59,0,0
4483,1244,620,1546,1073,22,17,12,302,453,39,59,0,0
4484,1260,624,1566,1073,22,17,12,306,449,40,59,0,0
4485,1290,629,1601,1075,22,17,12,311,446,41,59,0,0
4486,1323,632,1639,1075,22,17,12,316,443,42,59,0,0
4487,1359,630,1685,1077,22,17,12,326,447,43,59,0,0
4488,1414,637,1738,1073,22,17,12,324,436,44,59,0,0
4489,1460,626,1795,1071,22,17,12,335,445,45,59,0,0
4490,1480,611,1827,1072,22,17,12,347,461,46,59,0,0
4491,1484,601,1835,1072,22,17,12,351,471,47,59,0,0
4492,1475,579,1840,1073,22,17,12,365,494,48,59,0,0
4493,1468,570,1835,1072,22,17,12,367,502,49,59,0,0
4494,1459,566,1826,1071,22,17,12,367,505,50,59,0,0
4495,1440,568,1808,1073,22,17,12,368,505,51,59,0,0
4496,1417,581,1778,1074,22,17,12,361,493,52,59,0,0
4497,1383,605,1722,1072,22,17,12,339,467,53,59,0,0
4498,1337,604,1673,1072,22,17,12,336,468,54,59,0,0
4499,1302,631,1615,1069,22,17,12,313,438,55,59,0,0
4500,1244,676,1526,1068,22,17,12,282,392,56,59,0,0
4501,1158,687,1441,1075,22,17,12,283,388,57,59,0,0
4502,1070,732,1332,1078,22,17,12,262,346,58,59,0,0
4503,1038,747,1291,1080,22,17,12,253,333,59,59,1,0
4500,316,117,359,188,27,17,12,43,71,0,97,0,0
4505,301,117,339,187,27,17,12,38,70,0,97,0,0
4506,298,117,335,189,27,17,12,37,72,1,97,0,0
4507,290,116,329,193,27,17,12,39,77,2,97,0,0
4508,287,115,326,193,27,17,12,39,78,3,97,0,0
4509,287,115,324,191,27,17,12,37,76,4,97,0,0
4510,283,112,322,194,27,17,12,39,82,5,97,0,0
4511,282,112,319,193,27,17,12,37,81,6,97,0,0
4512,281,112,318,195,27,17,12,37,83,7,97,0,0
4513,280,112,317,198,27,17,12,37,86,8,97,0,0
4514,279,112,316,200,27,17,12,37,88,9,97,0,0
4515,279,113,314,198,27,17,12,35,85,10,97,0,0
4556,307,122,342,228,27,17,12,35,106,0,97,0,0
4557,305,126,340,230,27,17,12,35,104,1,97,0,0
4560,307,126,342,232,27,17,12,35,106,0,97,0,1
4561,309,125,345,234,27,17,12,36,109,1,97,0,0
4562,309,127,345,237,27,17,12,36,110,2,97,0,0
4563,309,129,344,237,27,17,12,35,108,3,97,0,0
4564,308,127,345,241,27,17,12,37,114,4,97,0,0
4565,310,128,346,242,27,17,12,36,114,5,97,0,0
4566,311,129,346,243,27,17,12,35,114,6,97,0,0
4567,311,128,347,244,27,17,12,36,116,7,97,0,0
4568,310,127,347,247,27,17,12,37,120,8,97,0,0
4569,310,129,347,249,27,17,12,37,120,9,97,0,0
4570,313,128,350,250,27,17,12,37,122,10,97,0,0
4571,316,128,353,250,27,17,12,37,122,11,97,0,0
4572,317,129,354,252,27,17,12,37,123,12,97,0,0
4573,316,132,352,252,27,17,12,36,120,13,97,0,0
4574,314,136,350,253,27,17,12,36,117,14,97,0,0
4575,313,135,350,259,27,17,12,37,124,15,97,0,0
4576,313,135,350,262,27,17,12,37,127,16,97,0,0
4577,312,139,349,263,27,17,12,37,124,17,97,0,0
4578,313,136,350,267,27,17,12,37,131,18,97,0,0
4579,312,138,349,266,27,17,12,37,128,19,97,0,0
4580,313,139,350,271,27,17,12,37,132,20,97,0,0
4581,313,144,349,270,27,17,12,36,126,21,97,0,0
4582,314,146,349,272,27,17,12,35,126,22,97,0,0
4583,315,147,351,275,27,17,12,36,128,23,97,0,0
4584,315,146,352,277,27,17,12,37,131,24,97,0,0
4585,314,147,353,282,27,17,12,39,135,25,97,0,0
4586,318,151,355,283,27,17,12,37,132,26,97,0,0
4587,321,151,360,285,27,17,12,39,134,27,97,0,0
4588,322,152,362,288,27,17,12,40,136,28,97,0,0
4589,321,156,360,288,27,17,12,39,132,29,97,0,0
4590,319,155,359,292,27,17,12,40,137,30,97,0,0
4591,319,157,360,297,27,17,12,41,140,31,97,0,0
4592,319,154,360,300,27,17,12,41,146,32,97,0,0
4593,318,155,361,306,27,17,12,43,151,33,97,0,0
4594,319,160,361,308,27,17,12,42,148,34,97,0,0
4595,320,162,362,311,27,17,12,42,149,35,97,0,0
4596,323,163,366,314,27,17,12,43,151,36,97,0,0
4597,323,163,368,319,27,17,12,45,156,37,97,0,0
4598,322,161,370,328,27,17,12,48,167,38,97,0,0
4599,321,159,369,332,27,17,12,48,173,39,97,0,0
4600,318,159,367,334,27,17,12,49,175,40,97,0,0
4601,318,167,367,340,27,17,12,49,173,41,97,0,0
4602,320,169,368,341,27,17,12,48,172,42,97,0,0
4603,321,174,370,348,27,17,12,49,174,43,97,0,0
4604,324,170,374,351,27,17,12,50,181,44,97,0,0
4605,325,169,377,356,27,17,12,52,187,45,97,0,0
4606,325,165,380,364,27,17,12,55,199,46,97,0,0
4607,329,169,384,369,27,17,12,55,200,47,97,0,0
4608,331,168,386,371,27,17,12,55,203,48,97,0,0
4609,334,169,391,374,27,17,12,57,205,49,97,0,0
4610,336,167,394,379,27,17,12,58,212,50,97,0,0
4611,334,170,395,389,27,17,12,61,219,51,97,0,0
4612,333,173,395,396,27,17,12,62,223,52,97,0,0
4613,334,173,397,401,27,17,12,63,228,53,97,0,0
4614,334,174,400,410,27,17,12,66,236,54,97,0,0
4615,336,173,401,410,27,17,12,65,237,55,97,0,0
4616,338,173,407,424,27,17,12,69,251,56,97,0,0
4617,343,174,414,431,27,17,12,71,257,57,97,0,0
4618,347,171,420,436,27,17,12,73,265,58,97,0,0
4619,352,185,424,444,27,17,12,72,259,59,97,0,0
4620,353,190,424,447,27,17,12,71,257,60,97,0,0
4621,351,182,426,458,27,17,12,75,276,61,97,0,0
4622,354,183,431,471,27,17,12,77,288,62,97,0,0
4623,357,187,437,480,27,17,12,80,293,63,97,0,0
4624,362,192,441,483,27,17,12,79,291,64,97,0,0
4625,366,187,448,493,27,17,12,82,306,65,97,0,0
4626,373,193,453,497,27,17,12,80,304,66,97,0,0
4627,380,195,466,523,27,17,12,86,328,67,97,0,0
4628,386,205,471,531,27,17,12,85,326,68,97,0,0
4629,390,211,476,537,27,17,12,86,326,69,97,0,0
4630,394,219,480,552,27,17,12,86,333,70,97,0,0
4631,399,223,487,557,27,17,12,88,334,71,97,0,0
4632,404,228,496,577,27,17,12,92,349,72,97,0,0
4633,408,235,504,597,27,17,12,96,362,73,97,0,0
4634,411,235,509,607,27,17,12,98,372,74,97,0,0
4635,412,243,512,631,27,17,12,100,388,75,97,0,0
4636,410,246,514,646,27,17,12,104,400,76,97,0,0
4637,413,251,520,661,27,17,12,107,410,77,97,0,0
4638,417,261,528,687,27,17,12,111,426,78,97,0,0
4639,422,266,536,699,27,17,12,114,433,79,97,0,0
4640,426,271,547,729,27,17,12,121,458,80,97,0,0
4641,431,278,557,751,27,17,12,126,473,81,97,0,0
4642,432,279,565,771,27,17,12,133,492,82,97,0,0
4643,432,295,574,812,27,17,12,142,517,83,97,0,0
4644,436,308,580,826,27,17,12,144,518,84,97,0,0
4645,434,318,584,852,27,17,12,150,534,85,97,0,0
4646,422,332,579,890,27,17,12,157,558,86,97,0,0
4647,407,347,570,910,27,17,12,163,563,87,97,0,0
4648,395,366,569,956,27,17,12,174,590,88,97,0,0
4649,376,377,562,1001,27,17,12,186,624,89,97,0,0
4650,349,388,541,1026,27,17,12,192,638,90,97,0,0
4651,319,404,519,1066,27,17,12,200,662,91,97,0,0
4652,293,420,498,1080,27,17,12,205,660,92,97,0,0
4653,269,438,477,1080,27,17,12,208,642,93,97,0,0
4654,217,462,424,1080,27,17,12,207,618,94,97,0,0
4655,144,494,350,1080,27,17,12,206,586,95,97,0,0
4656,64,516,265,1080,27,17,12,201,564,96,97,0,0
4657,39,531,241,1080,27,17,12,202,549,97,97,1,0
4565,351,121,387,237,30,17,12,36,116,0,94,0,1
4566,352,121,389,242,30,17,12,37,121,1,94,0,0
4567,354,121,391,241,30,17,12,37,120,2,94,0,0
4568,355,122,391,242,30,17,12,36,120,3,94,0,0
4569,355,122,391,244,30,17,12,36,122,4,94,0,0
4570,355,122,392,247,30,17,12,37,125,5,94,0,0
4571,355,123,393,251,30,17,12,38,128,6,94,0,0
4572,356,123,395,254,30,17,12,39,131,7,94,0,0
4573,356,123,395,255,30,17,12,39,132,8,94,0,0
4574,356,127,394,255,30,17,12,38,128,9,94,0,0
4575,355,128,393,255,30,17,12,38,127,10,94,0,0
4576,355,126,394,260,30,17,12,39,134,11,94,0,0
4577,355,128,396,266,30,17,12,41,138,12,94,0,0
4578,357,130,397,269,30,17,12,40,139,13,94,0,0
4579,359,131,399,268,30,17,12,40,137,14,94,0,0
4580,360,135,398,266,30,17,12,38,131,15,94,0,0
4581,360,134,398,268,30,17,12,38,134,16,94,0,0
4582,361,134,400,272,30,17,12,39,138,17,94,0,0
4583,362,136,402,278,30,17,12,40,142,18,94,0,0
4584,364,136,405,280,30,17,12,41,144,19,94,0,0
4585,367,141,407,278,30,17,12,40,137,20,94,0,0
4586,368,141,408,276,30,17,12,40,135,21,94,0,0
4587,369,138,411,281,30,17,12,42,143,22,94,0,0
4588,368,137,413,288,30,17,12,45,151,23,94,0,0
4589,369,136,416,293,30,17,12,47,157,24,94,0,0
4590,370,136,418,294,30,17,12,48,158,25,94,0,0
4591,370,137,419,297,30,17,12,49,160,26,94,0,0
4592,372,138,421,299,30,17,12,49,161,27,94,0,0
4593,373,139,422,301,30,17,12,49,162,28,94,0,0
4594,375,140,426,307,30,17,12,51,167,29,94,0,0
4595,377,142,428,311,30,17,12,51,169,30,94,0,0
4596,380,142,431,311,30,17,12,51,169,31,94,0,0
4597,380,143,434,319,30,17,12,54,176,32,94,0,0
4598,381,144,436,323,30,17,12,55,179,33,94,0,0
4599,382,144,436,323,30,17,12,54,179,34,94,0,0
4600,382,147,437,332,30,17,12,55,185,35,94,0,0
4601,382,148,439,335,30,17,12,57,187,36,94,0,0
4602,382,147,440,338,30,17,12,58,191,37,94,0,0
4603,381,149,440,347,30,17,12,59,198,38,94,0,0
4604,379,149,439,350,30,17,12,60,201,39,94,0,0
4605,377,150,437,354,30,17,12,60,204,40,94,0,0
4606,376,151,437,361,30,17,12,61,210,41,94,0,0
4607,379,151,440,365,30,17,12,61,214,42,94,0,0
4608,380,152,442,368,30,17,12,62,216,43,94,0,0
4609,383,157,445,375,30,17,12,62,218,44,94,0,0
4610,385,157,447,377,30,17,12,62,220,45,94,0,0
4611,387,155,451,380,30,17,12,64,225,46,94,0,0
4612,392,159,459,392,30,17,12,67,233,47,94,0,0
4613,402,160,469,394,30,17,12,67,234,48,94,0,0
4614,409,161,477,399,30,17,12,68,238,49,94,0,0
4615,414,164,485,409,30,17,12,71,245,50,94,0,0
4616,419,165,489,408,30,17,12,70,243,51,94,0,0
4617,424,167,496,414,30,17,12,72,247,52,94,0,0
4618,429,170,503,426,30,17,12,74,256,53,94,0,0
4619,436,172,511,426,30,17,12,75,254,54,94,0,0
4620,441,177,516,433,30,17,12,75,256,55,94,0,0
4621,446,178,526,451,30,17,12,80,273,56,94,0,0
4622,453,180,533,450,30,17,12,80,270,57,94,0,0
4623,457,182,540,461,30,17,12,83,279,58,94,0,0
4624,463,184,549,472,30,17,12,86,288,59,94,0,0
4625,471,189,560,482,30,17,12,89,293,60,94,0,0
4626,479,193,569,494,30,17,12,90,301,61,94,0,0
4627,483,199,576,509,30,17,12,93,310,62,94,0,0
4628,481,203,575,513,30,17,12,94,310,63,94,0,0
4629,482,202,582,533,30,17,12,100,331,64,94,0,0
4630,484,210,587,548,30,17,12,103,338,65,94,0,0
4631,490,211,596,556,30,17,12,106,345,66,94,0,0
4632,493,218,606,587,30,17,12,113,369,67,94,0,0
4633,493,224,610,606,30,17,12,117,382,68,94,0,0
4634,494,224,615,618,30,17,12,121,394,69,94,0,0
4635,500,230,626,641,30,17,12,126,411,70,94,0,0
4636,506,233,637,657,30,17,12,131,424,71,94,0,0
4637,518,237,651,665,30,17,12,133,428,72,94,0,0
4638,524,246,667,704,30,17,12,143,458,73,94,0,0
4639,532,251,679,725,30,17,12,147,474,74,94,0,0
4640,543,256,692,732,30,17,12,149,476,75,94,0,0
4641,558,267,716,765,30,17,12,158,498,76,94,0,0
4642,573,271,736,785,30,17,12,163,514,77,94,0,0
4643,591,282,761,814,30,17,12,170,532,78,94,0,0
4644,602,302,785,878,30,17,12,183,576,79,94,0,0
4645,617,313,802,895,30,17,12,185,582,80,94,0,0
4646,625,330,818,928,30,17,12,193,598,81,94,0,0
4647,627,350,833,991,30,17,12,206,641,82,94,0,0
4648,633,363,842,1012,30,17,12,209,649,83,94,0,0
4649,624,384,842,1056,30,17,12,218,672,84,94,0,0
4650,605,407,823,1074,30,17,12,218,667,85,94,0,0
4651,577,429,791,1071,30,17,12,214,642,86,94,0,0
4652,538,444,753,1080,30,17,12,215,636,87,94,0,0
4653,503,477,716,1080,30,17,12,213,603,88,94,0,0
4654,449,508,664,1080,30,17,12,215,572,89,94,0,0
4655,385,547,602,1078,30,17,12,217,531,90,94,0,0
4656,281,588,505,1080,30,17,12,224,492,91,94,0,0
4657,177,609,415,1080,30,17,12,238,471,92,94,0,0
4658,103,687,317,1080,30,17,12,214,393,93,94,0,0
4659,65,717,268,1080,30,17,12,203,363,94,94,1,0
4588,348,149,384,284,38,17,12,36,135,0,0,0,0
4671,1846,363,1920,682,41,17,12,74,319,0,32,0,1
4672,1850,405,1918,696,41,17,12,68,291,1,32,0,0
4673,1843,413,1910,695,41,17,12,67,282,2,32,0,0
4674,1824,407,1896,704,41,17,12,72,297,3,32,0,0
4675,1804,412,1881,722,41,17,12,77,310,4,32,0,0
4676,1793,405,1880,744,41,17,12,87,339,5,32,0,0
4677,1774,384,1873,762,41,17,12,99,378,6,32,0,0
4678,1762,393,1862,768,41,17,12,100,375,7,32,0,0
4679,1733,408,1838,778,41,17,12,105,370,8,32,0,0
4680,1702,421,1813,793,41,17,12,111,372,9,32,0,0
4681,1683,421,1800,803,41,17,12,117,382,10,32,0,0
4682,1659,429,1787,836,41,17,12,128,407,11,32,0,0
4683,1637,436,1769,848,41,17,12,132,412,12,32,0,0
4684,1602,439,1744,864,41,17,12,142,425,13,32,0,0
4685,1551,452,1706,894,41,17,12,155,442,14,32,0,0
4686,1517,447,1683,912,41,17,12,166,465,15,32,0,0
4687,1476,454,1658,953,41,17,12,182,499,16,32,0,0
4688,1443,464,1626,956,41,17,12,183,492,17,32,0,0
4689,1396,467,1592,986,41,17,12,196,519,18,32,0,0
4690,1323,487,1530,1019,41,17,12,207,532,19,32,0,0
4691,1262,490,1482,1052,41,17,12,220,562,20,32,0,0
4692,1202,495,1428,1065,41,17,12,226,570,21,32,0,0
4693,1132,512,1366,1078,41,17,12,234,566,22,32,0,0
4694,1062,522,1292,1068,41,17,12,230,546,23,32,0,0
4695,971,538,1202,1079,41,17,12,231,541,24,32,0,0
4696,876,557,1102,1080,41,17,12,226,523,25,32,0,0
4697,766,565,991,1080,41,17,12,225,515,26,32,0,0
4698,643,601,868,1079,41,17,12,225,478,27,32,0,0
4699,510,613,731,1078,41,17,12,221,465,28,32,0,0
4700,390,642,597,1080,41,17,12,207,438,29,32,0,0
4701,254,674,446,1076,41,17,12,192,402,30,32,0,0
4702,90,687,287,1080,41,17,12,197,393,31,32,0,0
4703,0,703,186,1080,41,17,12,186,377,32,32,1,0
4717,1865,406,1917,703,42,17,12,52,297,0,33,0,1
4718,1838,382,1896,703,42,17,12,58,321,1,33,0,0
4719,1825,358,1891,719,42,17,12,66,361,2,33,0,0
4720,1817,345,1889,729,42,17,12,72,384,3,33,0,0
4721,1798,344,1877,741,42,17,12,79,397,4,33,0,0
4722,1782,350,1867,759,42,17,12,85,409,5,33,0,0
4723,1764,345,1859,768,42,17,12,95,423,6,33,0,0
4724,1726,354,1828,780,42,17,12,102,426,7,33,0,0
4725,1702,356,1814,800,42,17,12,112,444,8,33,0,0
4726,1680,352,1804,821,42,17,12,124,469,9,33,0,0
4727,1649,364,1783,850,42,17,12,134,486,10,33,0,0
4728,1618,374,1762,874,42,17,12,144,500,11,33,0,0
4729,1584,370,1738,879,42,17,12,154,509,12,33,0,0
4730,1528,375,1701,910,42,17,12,173,535,13,33,0,0
4731,1486,374,1675,936,42,17,12,189,562,14,33,0,0
4732,1448,365,1653,964,42,17,12,205,599,15,33,0,0
4733,1381,374,1608,1008,42,17,12,227,634,16,33,0,0
4734,1323,379,1567,1045,42,17,12,244,666,17,33,0,0
4735,1259,377,1516,1054,42,17,12,257,677,18,33,0,0
4736,1165,384,1443,1072,42,17,12,278,688,19,33,0,0
4737,1122,386,1405,1075,42,17,12,283,689,20,33,0,0
4738,1060,382,1353,1078,42,17,12,293,696,21,33,0,0
4739,976,391,1279,1080,42,17,12,303,689,22,33,0,0
4740,926,409,1231,1080,42,17,12,305,671,23,33,0,0
4741,896,416,1200,1077,42,17,12,304,661,24,33,0,0
4742,846,431,1149,1076,42,17,12,303,645,25,33,0,0
4743,798,457,1093,1075,42,17,12,295,618,26,33,0,0
4744,719,478,1012,1076,42,17,12,293,598,27,33,0,0
4745,592,495,890,1076,42,17,12,298,581,28,33,0,0
4746,471,528,762,1073,42,17,12,291,545,29,33,0,0
4747,324,560,608,1074,42,17,12,284,514,30,33,0,0
4748,153,572,450,1080,42,17,12,297,508,31,33,0,0
4749,54,599,340,1073,42,17,12,286,474,32,33,0,0
4750,0,615,245,1077,42,17,12,245,462,33,33,1,0
4985,13,600,269,1078,43,17,12,256,478,0,83,0,1
4986,48,560,325,1077,43,17,12,277,517,1,83,0,0
4987,143,535,432,1075,43,17,12,289,540,2,83,0,0
4988,210,501,515,1077,43,17,12,305,576,3,83,0,0
4989,260,463,569,1052,43,17,12,309,589,4,83,0,0
4990,299,443,603,1028,43,17,12,304,585,5,83,0,0
4991,343,410,628,967,43,17,12,285,557,6,83,0,0
4992,360,388,635,935,43,17,12,275,547,7,83,0,0
4993,376,370,628,880,43,17,12,252,510,8,83,0,0
4994,382,343,619,833,43,17,12,237,490,9,83,0,0
4995,379,334,603,809,43,17,12,224,475,10,83,0,0
4996,381,317,582,749,43,17,12,201,432,11,83,0,0
4997,374,305,567,726,43,17,12,193,421,12,83,0,0
4998,359,296,542,701,43,17,12,183,405,13,83,0,0
4999,348,284,517,667,43,17,12,169,383,14,83,0,0
5000,336,279,498,653,43,17,12,162,374,15,83,0,0
5001,332,266,480,615,43,17,12,148,349,16,83,0,0
5002,328,257,471,599,43,17,12,143,342,17,83,0,0
5003,321,252,455,575,43,17,12,134,323,18,83,0,0
5004,317,245,444,557,43,17,12,127,312,19,83,0,0
5005,313,242,436,545,43,17,12,123,303,20,83,0,0
5006,310,236,424,522,43,17,12,114,286,21,83,0,0
5007,309,234,418,508,43,17,12,109,274,22,83,0,0
5008,302,229,405,489,43,17,12,103,260,23,83,0,0
5009,296,223,398,480,43,17,12,102,257,24,83,0,0
5010,293,221,391,472,43,17,12,98,251,25,83,0,0
5011,294,213,387,452,43,17,12,93,239,26,83,0,0
5012,294,211,385,445,43,17,12,91,234,27,83,0,0
5013,292,206,379,434,43,17,12,87,228,28,83,0,0
5014,292,203,377,425,43,17,12,85,222,29,83,0,0
5015,293,200,376,417,43,17,12,83,217,30,83,0,0
5016,294,197,374,406,43,17,12,80,209,31,83,0,0
5017,293,198,372,402,43,17,12,79,204,32,83,0,0
5018,291,194,366,390,43,17,12,75,196,33,83,0,0
5019,288,191,362,386,43,17,12,74,195,34,83,0,0
5020,288,189,360,378,43,17,12,72,189,35,83,0,0
5021,285,183,357,372,43,17,12,72,189,36,83,0,0
5022,284,182,356,369,43,17,12,72,187,37,83,0,0
5023,285,181,353,359,43,17,12,68,178,38,83,0,0
5024,283,179,350,353,43,17,12,67,174,39,83,0,0
5025,283,178,349,349,43,17,12,66,171,40,83,0,0
5026,283,178,346,340,43,17,12,63,162,41,83,0,0
5027,282,177,343,336,43,17,12,61,159,42,83,0,0
5028,279,175,340,331,43,17,12,61,156,43,83,0,0
5029,278,173,338,327,43,17,12,60,154,44,83,0,0
5030,277,173,337,326,43,17,12,60,153,45,83,0,0
5031,277,166,338,320,43,17,12,61,154,46,83,0,0
5032,278,164,338,318,43,17,12,60,154,47,83,0,0
5033,278,162,336,308,43,17,12,58,146,48,83,0,0
5034,282,163,338,306,43,17,12,56,143,49,83,0,0
5035,285,164,340,303,43,17,12,55,139,50,83,0,0
5036,288,160,343,300,43,17,12,55,140,51,83,0,0
5037,291,160,345,297,43,17,12,54,137,52,83,0,0
5038,292,159,344,290,43,17,12,52,131,53,83,0,0
5039,293,158,343,284,43,17,12,50,126,54,83,0,0
5040,293,158,342,282,43,17,12,49,124,55,83,0,0
5041,293,156,341,279,43,17,12,48,123,56,83,0,0
5042,292,155,340,276,43,17,12,48,121,57,83,0,0
5043,288,156,335,275,43,17,12,47,119,58,83,0,0
5044,286,155,331,271,43,17,12,45,116,59,83,0,0
5045,284,154,330,271,43,17,12,46,117,60,83,0,0
5046,283,152,328,268,43,17,12,45,116,61,83,0,0
5047,281,151,327,269,43,17,12,46,118,62,83,0,0
5048,280,150,324,262,43,17,12,44,112,63,83,0,0
5049,281,151,323,256,43,17,12,42,105,64,83,0,0
5050,281,150,322,252,43,17,12,41,102,65,83,0,0
5051,282,149,323,249,43,17,12,41,100,66,83,0,0
5052,282,149,322,248,43,17,12,40,99,67,83,0,0
5053,282,150,321,243,43,17,12,39,93,68,83,0,0
5054,280,147,320,244,43,17,12,40,97,69,83,0,0
5055,283,148,321,238,43,17,12,38,90,70,83,0,0
5056,282,146,322,239,43,17,12,40,93,71,83,0,0
5057,283,145,323,240,43,17,12,40,95,72,83,0,0
5058,285,146,322,235,43,17,12,37,89,73,83,0,0
5059,285,145,323,235,43,17,12,38,90,74,83,0,0
5060,285,146,323,233,43,17,12,38,87,75,83,0,0
5061,287,143,324,230,43,17,12,37,87,76,83,0,0
5062,287,141,326,231,43,17,12,39,90,77,83,0,0
5063,289,140,326,226,43,17,12,37,86,78,83,0,0
5064,289,139,326,226,43,17,12,37,87,79,83,0,0
5065,291,139,327,225,43,17,12,36,86,80,83,0,0
5066,291,135,328,221,43,17,12,37,86,81,83,0,0
5067,292,134,328,219,43,17,12,36,85,82,83,0,0
5068,294,133,329,215,43,17,12,35,82,83,83,1,0
5277,1401,547,1920,1077,49,17,12,519,530,0,13,0,0
5278,1417,521,1920,1067,49,17,12,503,546,1,13,0,0
5279,1438,508,1920,1050,49,17,12,482,542,2,13,0,0
5280,1487,487,1920,1005,49,17,12,433,518,3,13,0,0
5281,1529,469,1920,983,49,17,12,391,514,4,13,0,0
5282,1568,452,1920,947,49,17,12,352,495,5,13,0,0
5283,1627,452,1920,888,49,17,12,293,436,6,13,0,0
5284,1658,456,1920,856,49,17,12,262,400,7,13,0,0
5285,1695,457,1920,830,49,17,12,225,373,8,13,0,0
5286,1722,458,1920,819,49,17,12,198,361,9,13,0,0
5287,1752,454,1920,789,49,17,12,168,335,10,13,0,0
5288,1772,446,1920,766,49,17,12,148,320,11,13,0,0
5289,1788,445,1920,745,49,17,12,132,300,12,13,0,0
5290,1801,434,1920,725,49,17,12,119,291,13,13,0,0
5497,1828,516,1920,835,50,17,12,92,319,0,16,0,0
5498,1828,541,1917,849,50,17,12,89,308,1,16,0,0
5499,1820,529,1920,897,50,17,12,100,368,2,16,0,0
5500,1814,534,1920,931,50,17,12,106,397,3,16,0,0
5501,1795,559,1907,944,50,17,12,112,385,4,16,0,0
5502,1759,539,1889,972,50,17,12,130,433,5,16,0,0
5503,1740,527,1884,993,50,17,12,144,466,6,16,0,0
5504,1719,491,1894,1049,50,17,12,175,558,7,16,0,0
5505,1709,517,1888,1073,50,17,12,179,556,8,16,0,0
5506,1680,527,1868,1080,50,17,12,188,553,9,16,0,0
5507,1657,549,1850,1080,50,17,12,193,531,10,16,0,0
5508,1638,569,1834,1080,50,17,12,196,511,11,16,0,0
5509,1636,605,1830,1080,50,17,12,194,475,12,16,0,0
5510,1640,653,1828,1080,50,17,12,188,427,13,16,0,0
5511,1654,703,1836,1080,50,17,12,182,377,14,16,0,0
5512,1684,800,1838,1080,50,17,12,154,280,15,16,0,0
5513,1685,829,1830,1080,50,17,12,145,251,16,16,0,0
320,300,383,341,717,1,17,13,41,334,0,115,0,0
321,312,298,365,718,1,17,13,53,420,1,115,0,0
322,346,285,402,703,1,17,13,56,418,2,115,0,0
323,371,273,427,669,1,17,13,56,396,3,115,0,0
324,388,269,446,655,1,17,13,58,386,4,115,0,0
325,406,262,465,632,1,17,13,59,370,5,115,0,0
326,421,246,483,609,1,17,13,62,363,6,115,0,0
327,425,239,492,602,1,17,13,67,363,7,115,0,0
328,420,232,486,570,1,17,13,66,338,8,115,0,0
329,413,227,481,556,1,17,13,68,329,9,115,0,0
330,414,223,477,516,1,17,13,63,293,10,115,0,0
331,423,214,483,494,1,17,13,60,280,11,115,0,0
334,378,191,442,477,1,17,13,64,286,0,115,0,0
335,375,186,440,466,1,17,13,65,280,1,115,0,0
336,375,188,439,453,1,17,13,64,265,2,115,0,0
337,373,194,437,444,1,17,13,64,250,3,115,0,0
338,366,187,430,431,1,17,13,64,244,4,115,0,0
339,363,184,426,420,1,17,13,63,236,5,115,0,0
340,364,183,427,417,1,17,13,63,234,6,115,0,0
341,367,177,429,403,1,17,13,62,226,7,115,0,0
342,369,177,430,400,1,17,13,61,223,8,115,0,0
343,373,173,433,390,1,17,13,60,217,9,115,0,0
344,374,168,432,379,1,17,13,58,211,10,115,0,0
364,466,144,507,294,1,17,13,41,150,0,115,0,0
365,469,144,508,289,1,17,13,39,145,1,115,0,0
366,470,146,509,288,1,17,13,39,142,2,115,0,0
367,473,145,514,290,1,17,13,41,145,3,115,0,0
368,476,145,518,289,1,17,13,42,144,4,115,0,0
369,480,144,523,287,1,17,13,43,143,5,115,0,0
370,482,147,524,288,1,17,13,42,141,6,115,0,0
371,485,150,525,288,1,17,13,40,138,7,115,0,0
372,487,154,525,286,1,17,13,38,132,8,115,0,0
373,487,150,525,285,1,17,13,38,135,9,115,0,0
374,487,147,524,283,1,17,13,37,136,10,115,0,0
375,488,150,524,283,1,17,13,36,133,11,115,0,0
394,490,144,525,280,1,17,13,35,136,0,115,0,0
398,490,145,525,284,1,17,13,35,139,0,115,0,0
424,495,148,531,284,1,17,13,36,136,0,115,0,1
425,498,148,536,287,1,17,13,38,139,1,115,0,0
426,501,149,541,291,1,17,13,40,142,2,115,0,0
427,505,150,545,290,1,17,13,40,140,3,115,0,0
428,509,150,548,291,1,17,13,39,141,4,115,0,0
429,510,151,549,291,1,17,13,39,140,5,115,0,0
430,510,153,549,292,1,17,13,39,139,6,115,0,0
431,510,151,549,293,1,17,13,39,142,7,115,0,0
432,510,150,550,293,1,17,13,40,143,8,115,0,0
433,510,150,550,293,1,17,13,40,143,9,115,0,0
434,510,149,550,293,1,17,13,40,144,10,115,0,0
435,510,150,550,292,1,17,13,40,142,11,115,0,0
436,511,150,551,292,1,17,13,40,142,12,115,0,0
437,511,149,551,293,1,17,13,40,144,13,115,0,0
438,511,150,551,293,1,17,13,40,143,14,115,0,0
439,510,150,550,292,1,17,13,40,142,15,115,0,0
440,511,150,551,292,1,17,13,40,142,16,115,0,0
441,512,152,551,292,1,17,13,39,140,17,115,0,0
442,512,153,551,292,1,17,13,39,139,18,115,0,0
443,512,154,552,292,1,17,13,40,138,19,115,0,0
444,512,154,552,292,1,17,13,40,138,20,115,0,0
445,511,154,551,292,1,17,13,40,138,21,115,0,0
446,511,154,551,291,1,17,13,40,137,22,115,0,0
447,511,154,551,291,1,17,13,40,137,23,115,0,0
448,511,154,551,291,1,17,13,40,137,24,115,0,0
449,511,154,551,290,1,17,13,40,136,25,115,0,0
450,511,154,551,290,1,17,13,40,136,26,115,0,0
451,511,152,552,291,1,17,13,41,139,27,115,0,0
452,510,152,552,291,1,17,13,42,139,28,115,0,0
453,510,152,552,291,1,17,13,42,139,29,115,0,0
454,510,151,552,292,1,17,13,42,141,30,115,0,0
455,510,151,552,291,1,17,13,42,140,31,115,0,0
456,511,151,553,291,1,17,13,42,140,32,115,0,0
457,511,151,553,291,1,17,13,42,140,33,115,0,0
458,510,152,552,291,1,17,13,42,139,34,115,0,0
459,510,152,553,292,1,17,13,43,140,35,115,0,0
460,510,152,553,293,1,17,13,43,141,36,115,0,0
461,510,153,553,293,1,17,13,43,140,37,115,0,0
462,510,153,552,292,1,17,13,42,139,38,115,0,0
463,510,154,552,293,1,17,13,42,139,39,115,0,0
464,510,154,553,294,1,17,13,43,140,40,115,0,0
465,510,154,554,294,1,17,13,44,140,41,115,0,0
466,510,154,553,294,1,17,13,43,140,42,115,0,0
467,509,154,553,294,1,17,13,44,140,43,115,0,0
468,510,155,554,293,1,17,13,44,138,44,115,0,0
469,511,154,555,293,1,17,13,44,139,45,115,0,0
470,511,150,556,294,1,17,13,45,144,46,115,0,0
471,511,149,556,294,1,17,13,45,145,47,115,0,0
472,510,148,556,294,1,17,13,46,146,48,115,0,0
473,510,148,555,292,1,17,13,45,144,49,115,0,0
474,510,148,554,292,1,17,13,44,144,50,115,0,0
475,509,147,554,293,1,17,13,45,146,51,115,0,0
476,509,145,555,292,1,17,13,46,147,52,115,0,0
477,509,144,555,292,1,17,13,46,148,53,115,0,0
478,510,143,555,292,1,17,13,45,149,54,115,0,0
479,510,143,555,291,1,17,13,45,148,55,115,0,0
480,509,143,554,291,1,17,13,45,148,56,115,0,0
481,509,144,553,291,1,17,13,44,147,57,115,0,0
482,509,145,553,291,1,17,13,44,146,58,115,0,0
483,509,145,553,291,1,17,13,44,146,59,115,0,0
484,509,145,552,291,1,17,13,43,146,60,115,0,0
485,509,145,553,291,1,17,13,44,146,61,115,0,0
486,509,144,553,292,1,17,13,44,148,62,115,0,0
487,509,144,553,292,1,17,13,44,148,63,115,0,0
488,509,144,554,292,1,17,13,45,148,64,115,0,0
489,510,144,553,292,1,17,13,43,148,65,115,0,0
490,510,145,553,291,1,17,13,43,146,66,115,0,0
491,510,147,552,292,1,17,13,42,145,67,115,0,0
492,510,147,552,292,1,17,13,42,145,68,115,0,0
493,510,147,552,292,1,17,13,42,145,69,115,0,0
494,510,147,552,292,1,17,13,42,145,70,115,0,0
495,510,146,552,291,1,17,13,42,145,71,115,0,0
496,510,146,552,291,1,17,13,42,145,72,115,0,0
497,510,144,553,292,1,17,13,43,148,73,115,0,0
498,510,143,552,288,1,17,13,42,145,74,115,0,0
499,510,142,552,284,1,17,13,42,142,75,115,0,0
500,510,142,552,284,1,17,13,42,142,76,115,0,0
501,510,142,552,283,1,17,13,42,141,77,115,0,0
505,511,148,550,284,1,17,13,39,136,0,115,0,1
506,510,146,550,284,1,17,13,40,138,1,115,0,0
507,510,147,549,285,1,17,13,39,138,2,115,0,0
508,510,149,549,287,1,17,13,39,138,3,115,0,0
509,510,148,551,291,1,17,13,41,143,4,115,0,0
510,511,151,551,290,1,17,13,40,139,5,115,0,0
511,513,153,552,290,1,17,13,39,137,6,115,0,0
512,515,152,554,292,1,17,13,39,140,7,115,0,0
513,516,151,555,290,1,17,13,39,139,8,115,0,0
514,516,151,555,290,1,17,13,39,139,9,115,0,0
515,517,148,556,289,1,17,13,39,141,10,115,0,0
516,516,148,556,291,1,17,13,40,143,11,115,0,0
517,516,146,556,290,1,17,13,40,144,12,115,0,0
518,516,146,556,290,1,17,13,40,144,13,115,0,0
519,516,146,556,290,1,17,13,40,144,14,115,0,0
520,517,146,556,289,1,17,13,39,143,15,115,0,0
521,517,146,556,289,1,17,13,39,143,16,115,0,0
522,517,145,556,289,1,17,13,39,144,17,115,0,0
523,517,145,556,288,1,17,13,39,143,18,115,0,0
524,517,146,556,291,1,17,13,39,145,19,115,0,0
525,517,146,556,289,1,17,13,39,143,20,115,0,0
526,518,148,558,291,1,17,13,40,143,21,115,0,0
527,519,150,557,289,1,17,13,38,139,22,115,0,0
528,518,150,558,290,1,17,13,40,140,23,115,0,0
529,518,150,558,291,1,17,13,40,141,24,115,0,0
530,517,148,557,289,1,17,13,40,141,25,115,0,0
531,515,146,557,291,1,17,13,42,145,26,115,0,0
532,514,146,556,292,1,17,13,42,146,27,115,0,0
533,513,145,555,292,1,17,13,42,147,28,115,0,0
534,513,145,555,291,1,17,13,42,146,29,115,0,0
535,513,147,555,292,1,17,13,42,145,30,115,0,0
536,513,151,554,292,1,17,13,41,141,31,115,0,0
537,513,155,553,292,1,17,13,40,137,32,115,0,0
538,513,155,553,292,1,17,13,40,137,33,115,0,0
539,513,154,553,292,1,17,13,40,138,34,115,0,0
540,513,155,553,291,1,17,13,40,136,35,115,0,0
541,513,155,553,291,1,17,13,40,136,36,115,0,0
542,514,157,552,289,1,17,13,38,132,37,115,0,0
543,513,156,553,290,1,17,13,40,134,38,115,0,0
544,512,156,552,291,1,17,13,40,135,39,115,0,0
545,512,156,551,291,1,17,13,39,135,40,115,0,0
546,512,154,552,291,1,17,13,40,137,41,115,0,0
547,512,154,552,292,1,17,13,40,138,42,115,0,0
548,512,153,552,292,1,17,13,40,139,43,115,0,0
549,512,152,552,292,1,17,13,40,140,44,115,0,0
550,512,152,552,292,1,17,13,40,140,45,115,0,0
551,513,151,553,292,1,17,13,40,141,46,115,0,0
552,514,151,553,292,1,17,13,39,141,47,115,0,0
553,513,151,553,293,1,17,13,40,142,48,115,0,0
554,513,151,553,293,1,17,13,40,142,49,115,0,0
555,513,152,552,292,1,17,13,39,140,50,115,0,0
556,513,151,552,292,1,17,13,39,141,51,115,0,0
557,514,151,553,292,1,17,13,39,141,52,115,0,0
558,514,150,553,292,1,17,13,39,142,53,115,0,0
559,514,151,552,292,1,17,13,38,141,54,115,0,0
560,514,151,552,291,1,17,13,38,140,55,115,0,0
561,514,152,552,291,1,17,13,38,139,56,115,0,0
562,514,152,552,291,1,17,13,38,139,57,115,0,0
563,514,153,552,291,1,17,13,38,138,58,115,0,0
564,514,153,552,291,1,17,13,38,138,59,115,0,0
565,514,154,552,291,1,17,13,38,137,60,115,0,0
566,514,154,552,290,1,17,13,38,136,61,115,0,0
567,514,153,552,290,1,17,13,38,137,62,115,0,0
568,515,154,551,287,1,17,13,36,133,63,115,0,0
569,515,152,551,289,1,17,13,36,137,64,115,0,0
570,514,151,551,289,1,17,13,37,138,65,115,0,0
571,517,153,552,283,1,17,13,35,130,66,115,0,0
575,518,148,553,287,1,17,13,35,139,0,115,0,0
576,518,148,554,287,1,17,13,36,139,1,115,0,0
582,519,149,554,285,1,17,13,35,136,0,115,0,1
583,516,147,553,289,1,17,13,37,142,1,115,0,0
584,508,146,548,289,1,17,13,40,143,2,115,0,0
585,500,145,541,287,1,17,13,41,142,3,115,0,0
586,495,149,537,287,1,17,13,42,138,4,115,0,0
587,489,147,531,285,1,17,13,42,138,5,115,0,0
588,484,144,526,285,1,17,13,42,141,6,115,0,0
589,478,143,521,286,1,17,13,43,143,7,115,0,0
590,474,143,517,285,1,17,13,43,142,8,115,0,0
591,468,140,513,287,1,17,13,45,147,9,115,0,0
592,465,138,510,285,1,17,13,45,147,10,115,0,0
593,462,139,507,284,1,17,13,45,145,11,115,0,0
594,461,140,506,286,1,17,13,45,146,12,115,0,0
595,459,139,504,284,1,17,13,45,145,13,115,0,0
596,458,139,501,277,1,17,13,43,138,14,115,0,0
597,455,141,496,275,1,17,13,41,134,15,115,0,0
598,450,139,491,271,1,17,13,41,132,16,115,0,0
599,448,141,487,266,1,17,13,39,125,17,115,0,0
600,446,140,486,267,1,17,13,40,127,18,115,0,0
601,446,140,486,266,1,17,13,40,126,19,115,0,0
602,449,145,484,260,1,17,13,35,115,20,115,0,0
603,451,143,486,262,1,17,13,35,119,21,115,0,0
604,452,145,487,266,1,17,13,35,121,22,115,0,0
605,453,140,491,269,1,17,13,38,129,23,115,0,0
606,456,140,495,268,1,17,13,39,128,24,115,0,0
607,457,138,498,270,1,17,13,41,132,25,115,0,0
608,459,139,500,270,1,17,13,41,131,26,115,0,0
609,461,140,501,269,1,17,13,40,129,27,115,0,0
610,462,138,503,269,1,17,13,41,131,28,115,0,0
611,464,138,507,274,1,17,13,43,136,29,115,0,0
612,468,140,512,278,1,17,13,44,138,30,115,0,0
613,473,142,517,279,1,17,13,44,137,31,115,0,0
614,479,142,523,278,1,17,13,44,136,32,115,0,0
615,481,141,526,281,1,17,13,45,140,33,115,0,0
616,482,141,526,278,1,17,13,44,137,34,115,0,0
617,483,142,526,276,1,17,13,43,134,35,115,0,0
618,483,142,526,274,1,17,13,43,132,36,115,0,0
619,484,140,528,278,1,17,13,44,138,37,115,0,0
620,486,139,529,278,1,17,13,43,139,38,115,0,0
621,487,143,529,279,1,17,13,42,136,39,115,0,0
622,488,143,529,279,1,17,13,41,136,40,115,0,0
623,487,143,528,281,1,17,13,41,138,41,115,0,0
624,487,143,528,281,1,17,13,41,138,42,115,0,0
625,487,146,528,281,1,17,13,41,135,43,115,0,0
626,483,146,524,283,1,17,13,41,137,44,115,0,0
627,480,141,523,282,1,17,13,43,141,45,115,0,0
628,480,140,524,283,1,17,13,44,143,46,115,0,0
629,479,140,523,282,1,17,13,44,142,47,115,0,0
630,478,138,523,281,1,17,13,45,143,48,115,0,0
631,478,139,522,280,1,17,13,44,141,49,115,0,0
632,478,139,522,278,1,17,13,44,139,50,115,0,0
633,476,141,519,279,1,17,13,43,138,51,115,0,0
634,477,146,518,279,1,17,13,41,133,52,115,0,0
635,478,150,517,279,1,17,13,39,129,53,115,0,0
636,479,151,517,279,1,17,13,38,128,54,115,0,0
637,480,153,517,278,1,17,13,37,125,55,115,0,0
638,480,155,517,279,1,17,13,37,124,56,115,0,0
639,483,158,519,279,1,17,13,36,121,57,115,0,0
640,483,150,525,284,1,17,13,42,134,58,115,0,0
641,487,150,531,284,1,17,13,44,134,59,115,0,0
642,498,151,543,283,1,17,13,45,132,60,115,0,0
643,513,153,556,284,1,17,13,43,131,61,115,0,0
644,522,151,567,289,1,17,13,45,138,62,115,0,0
645,529,155,574,289,1,17,13,45,134,63,115,0,0
646,535,160,578,285,1,17,13,43,125,64,115,0,0
647,540,161,582,286,1,17,13,42,125,65,115,0,0
648,545,157,587,285,1,17,13,42,128,66,115,0,0
649,545,154,590,288,1,17,13,45,134,67,115,0,0
650,546,152,592,290,1,17,13,46,138,68,115,0,0
651,548,152,594,288,1,17,13,46,136,69,115,0,0
652,548,151,594,286,1,17,13,46,135,70,115,0,0
653,548,150,594,286,1,17,13,46,136,71,115,0,0
654,548,152,592,284,1,17,13,44,132,72,115,0,0
655,548,149,593,283,1,17,13,45,134,73,115,0,0
656,547,152,591,284,1,17,13,44,132,74,115,0,0
657,547,154,590,284,1,17,13,43,130,75,115,0,0
658,546,154,590,284,1,17,13,44,130,76,115,0,0
659,547,154,591,284,1,17,13,44,130,77,115,0,0
660,547,157,590,284,1,17,13,43,127,78,115,0,0
661,546,159,588,285,1,17,13,42,126,79,115,0,0
662,547,160,588,285,1,17,13,41,125,80,115,0,0
663,545,153,590,289,1,17,13,45,136,81,115,0,0
664,543,146,599,319,1,17,13,56,173,82,115,0,0
665,543,148,604,335,1,17,13,61,187,83,115,0,0
666,540,146,603,341,1,17,13,63,195,84,115,0,0
667,528,146,593,344,1,17,13,65,198,85,115,0,0
668,515,149,581,350,1,17,13,66,201,86,115,0,0
669,508,152,575,351,1,17,13,67,199,87,115,0,0
670,499,154,568,354,1,17,13,69,200,88,115,0,0
671,496,158,565,358,1,17,13,69,200,89,115,0,0
672,500,161,571,362,1,17,13,71,201,90,115,0,0
673,506,159,580,366,1,17,13,74,207,91,115,0,0
674,511,159,586,367,1,17,13,75,208,92,115,0,0
675,515,158,592,371,1,17,13,77,213,93,115,0,0
676,519,154,598,375,1,17,13,79,221,94,115,0,0
677,532,160,613,381,1,17,13,81,221,95,115,0,0
678,541,163,623,384,1,17,13,82,221,96,115,0,0
679,562,170,641,380,1,17,13,79,210,97,115,0,0
680,580,171,659,378,1,17,13,79,207,98,115,0,0
681,593,175,675,386,1,17,13,82,211,99,115,0,0
682,610,176,692,392,1,17,13,82,216,100,115,0,0
683,627,177,708,394,1,17,13,81,217,101,115,0,0
684,640,181,721,399,1,17,13,81,218,102,115,0,0
685,659,181,741,402,1,17,13,82,221,103,115,0,0
686,676,179,760,406,1,17,13,84,227,104,115,0,0
687,691,188,775,414,1,17,13,84,226,105,115,0,0
688,708,189,793,420,1,17,13,85,231,106,115,0,0
689,722,193,809,425,1,17,13,87,232,107,115,0,0
690,734,193,822,426,1,17,13,88,233,108,115,0,0
691,760,194,847,425,1,17,13,87,231,109,115,0,0
692,788,200,876,428,1,17,13,88,228,110,115,0,0
693,803,207,894,437,1,17,13,91,230,111,115,0,0
694,824,206,919,440,1,17,13,95,234,112,115,0,0
695,850,211,940,436,1,17,13,90,225,113,115,0,0
696,857,220,947,442,1,17,13,90,222,114,115,0,0
697,873,224,963,445,1,17,13,90,221,115,115,1,0
327,297,288,354,682,2,17,13,57,394,0,125,0,1
328,323,275,383,682,2,17,13,60,407,1,125,0,0
329,341,266,396,628,2,17,13,55,362,2,125,0,0
330,357,268,420,672,2,17,13,63,404,3,125,0,0
331,383,232,453,666,2,17,13,70,434,4,125,0,0
332,402,231,474,659,2,17,13,72,428,5,125,0,0
333,414,234,490,651,2,17,13,76,417,6,125,0,0
334,417,223,496,623,2,17,13,79,400,7,125,0,0
335,413,214,502,637,2,17,13,89,423,8,125,0,0
336,422,221,507,606,2,17,13,85,385,9,125,0,0
337,430,222,510,572,2,17,13,80,350,10,125,0,0
338,427,223,507,556,2,17,13,80,333,11,125,0,0
339,421,210,504,541,2,17,13,83,331,12,125,0,0
340,413,203,495,522,2,17,13,82,319,13,125,0,0
341,406,198,490,515,2,17,13,84,317,14,125,0,0
342,413,197,491,485,2,17,13,78,288,15,125,0,0
343,409,190,488,481,2,17,13,79,291,16,125,0,0
344,400,192,478,469,2,17,13,78,277,17,125,0,0
345,393,180,473,451,2,17,13,80,271,18,125,0,0
346,393,174,475,446,2,17,13,82,272,19,125,0,0
347,394,170,473,428,2,17,13,79,258,20,125,0,0
348,392,167,472,421,2,17,13,80,254,21,125,0,0
349,394,165,473,410,2,17,13,79,245,22,125,0,0
350,400,163,478,402,2,17,13,78,239,23,125,0,0
351,406,161,483,397,2,17,13,77,236,24,125,0,0
352,412,158,487,383,2,17,13,75,225,25,125,0,0
353,414,156,489,380,2,17,13,75,224,26,125,0,0
354,412,154,491,385,2,17,13,79,231,27,125,0,0
355,416,151,493,372,2,17,13,77,221,28,125,0,0
356,429,152,504,368,2,17,13,75,216,29,125,0,0
357,441,158,509,355,2,17,13,68,197,30,125,0,0
358,441,157,511,353,2,17,13,70,196,31,125,0,0
359,441,156,511,350,2,17,13,70,194,32,125,0,0
360,449,155,516,339,2,17,13,67,184,33,125,0,0
361,455,149,524,336,2,17,13,69,187,34,125,0,0
362,463,145,531,329,2,17,13,68,184,35,125,0,0
363,475,146,541,327,2,17,13,66,181,36,125,0,0
364,485,149,548,323,2,17,13,63,174,37,125,0,0
365,493,149,553,317,2,17,13,60,168,38,125,0,0
366,497,148,556,315,2,17,13,59,167,39,125,0,0
367,508,149,566,310,2,17,13,58,161,40,125,0,0
368,515,148,572,306,2,17,13,57,158,41,125,0,0
369,520,149,576,306,2,17,13,56,157,42,125,0,0
370,522,148,578,306,2,17,13,56,158,43,125,0,0
371,525,148,580,304,2,17,13,55,156,44,125,0,0
372,529,153,583,303,2,17,13,54,150,45,125,0,0
373,532,156,583,302,2,17,13,51,146,46,125,0,0
374,531,157,583,301,2,17,13,52,144,47,125,0,0
375,531,156,585,302,2,17,13,54,146,48,125,0,0
376,532,156,586,302,2,17,13,54,146,49,125,0,0
377,534,157,587,302,2,17,13,53,145,50,125,0,0
378,533,153,586,302,2,17,13,53,149,51,125,0,0
379,532,148,585,301,2,17,13,53,153,52,125,0,0
380,531,143,585,299,2,17,13,54,156,53,125,0,0
381,531,138,585,297,2,17,13,54,159,54,125,0,0
382,534,146,585,297,2,17,13,51,151,55,125,0,0
383,537,143,586,292,2,17,13,49,149,56,125,0,0
384,540,149,587,292,2,17,13,47,143,57,125,0,0
385,540,149,587,294,2,17,13,47,145,58,125,0,0
386,541,149,588,293,2,17,13,47,144,59,125,0,0
388,541,147,590,297,2,17,13,49,150,0,125,0,0
389,542,145,590,292,2,17,13,48,147,1,125,0,0
390,544,145,591,288,2,17,13,47,143,2,125,0,0
391,542,145,590,290,2,17,13,48,145,3,125,0,0
392,541,144,590,295,2,17,13,49,151,4,125,0,0
393,541,143,589,292,2,17,13,48,149,5,125,0,0
394,540,141,589,292,2,17,13,49,151,6,125,0,0
395,539,142,587,291,2,17,13,48,149,7,125,0,0
396,541,159,583,291,2,17,13,42,132,8,125,0,0
397,539,153,584,295,2,17,13,45,142,9,125,0,0
398,538,149,584,294,2,17,13,46,145,10,125,0,0
399,537,142,584,293,2,17,13,47,151,11,125,0,0
400,537,141,584,293,2,17,13,47,152,12,125,0,0
401,539,150,584,295,2,17,13,45,145,13,125,0,0
402,539,150,584,295,2,17,13,45,145,14,125,0,0
404,538,142,587,297,2,17,13,49,155,0,125,0,0
405,536,144,584,295,2,17,13,48,151,1,125,0,0
406,536,140,583,294,2,17,13,47,154,2,125,0,0
407,536,139,583,294,2,17,13,47,155,3,125,0,0
408,536,142,582,294,2,17,13,46,152,4,125,0,0
409,537,144,582,294,2,17,13,45,150,5,125,0,0
410,537,144,582,293,2,17,13,45,149,6,125,0,0
414,537,144,581,293,2,17,13,44,149,0,125,0,1
415,536,147,580,295,2,17,13,44,148,1,125,0,0
416,538,145,582,296,2,17,13,44,151,2,125,0,0
417,540,146,585,298,2,17,13,45,152,3,125,0,0
418,542,144,588,299,2,17,13,46,155,4,125,0,0
419,544,144,590,296,2,17,13,46,152,5,125,0,0
420,542,144,588,294,2,17,13,46,150,6,125,0,0
421,542,143,587,292,2,17,13,45,149,7,125,0,0
422,540,144,585,293,2,17,13,45,149,8,125,0,0
423,538,144,584,295,2,17,13,46,151,9,125,0,0
424,538,146,583,295,2,17,13,45,149,10,125,0,0
425,538,144,583,295,2,17,13,45,151,11,125,0,0
426,537,147,582,298,2,17,13,45,151,12,125,0,0
427,537,143,583,299,2,17,13,46,156,13,125,0,0
428,538,147,582,297,2,17,13,44,150,14,125,0,0
429,538,148,582,297,2,17,13,44,149,15,125,0,0
430,539,148,582,297,2,17,13,43,149,16,125,0,0
431,539,147,583,297,2,17,13,44,150,17,125,0,0
432,540,146,584,297,2,17,13,44,151,18,125,0,0
433,540,146,584,296,2,17,13,44,150,19,125,0,0
434,540,144,584,296,2,17,13,44,152,20,125,0,0
435,541,144,584,296,2,17,13,43,152,21,125,0,0
436,541,144,585,297,2,17,13,44,153,22,125,0,0
437,541,144,585,298,2,17,13,44,154,23,125,0,0
438,541,144,585,298,2,17,13,44,154,24,125,0,0
439,541,144,585,297,2,17,13,44,153,25,125,0,0
440,541,144,585,297,2,17,13,44,153,26,125,0,0
441,542,145,585,296,2,17,13,43,151,27,125,0,0
442,542,145,586,295,2,17,13,44,150,28,125,0,0
443,542,145,586,295,2,17,13,44,150,29,125,0,0
444,542,146,586,295,2,17,13,44,149,30,125,0,0
445,542,146,586,295,2,17,13,44,149,31,125,0,0
446,542,146,586,295,2,17,13,44,149,32,125,0,0
447,542,146,586,295,2,17,13,44,149,33,125,0,0
448,542,146,585,294,2,17,13,43,148,34,125,0,0
449,542,146,586,294,2,17,13,44,148,35,125,0,0
450,542,146,586,294,2,17,13,44,148,36,125,0,0
451,542,144,586,294,2,17,13,44,150,37,125,0,0
452,542,144,586,294,2,17,13,44,150,38,125,0,0
453,542,144,586,294,2,17,13,44,150,39,125,0,0
454,542,144,586,294,2,17,13,44,150,40,125,0,0
455,542,144,586,294,2,17,13,44,150,41,125,0,0
456,541,144,586,295,2,17,13,45,151,42,125,0,0
457,542,145,587,296,2,17,13,45,151,43,125,0,0
458,541,146,586,296,2,17,13,45,150,44,125,0,0
459,540,145,585,297,2,17,13,45,152,45,125,0,0
460,541,146,586,299,2,17,13,45,153,46,125,0,0
461,541,146,587,301,2,17,13,46,155,47,125,0,0
462,541,146,588,303,2,17,13,47,157,48,125,0,0
463,541,148,588,306,2,17,13,47,158,49,125,0,0
464,537,151,582,300,2,17,13,45,149,50,125,0,0
465,535,151,579,298,2,17,13,44,147,51,125,0,0
466,538,150,583,300,2,17,13,45,150,52,125,0,0
467,539,150,584,301,2,17,13,45,151,53,125,0,0
468,537,150,581,298,2,17,13,44,148,54,125,0,0
469,537,150,581,298,2,17,13,44,148,55,125,0,0
471,537,168,575,299,2,17,13,38,131,0,125,0,1
472,536,152,580,305,2,17,13,44,153,1,125,0,0
473,538,151,582,304,2,17,13,44,153,2,125,0,0
474,541,145,590,314,2,17,13,49,169,3,125,0,0
475,541,141,592,313,2,17,13,51,172,4,125,0,0
476,542,140,591,304,2,17,13,49,164,5,125,0,0
477,543,140,590,301,2,17,13,47,161,6,125,0,0
478,542,140,590,300,2,17,13,48,160,7,125,0,0
479,543,140,591,300,2,17,13,48,160,8,125,0,0
480,543,140,591,299,2,17,13,48,159,9,125,0,0
481,543,141,590,297,2,17,13,47,156,10,125,0,0
482,543,141,590,296,2,17,13,47,155,11,125,0,0
483,543,141,590,296,2,17,13,47,155,12,125,0,0
484,543,141,590,296,2,17,13,47,155,13,125,0,0
485,543,142,590,296,2,17,13,47,154,14,125,0,0
486,543,142,590,296,2,17,13,47,154,15,125,0,0
487,543,143,590,298,2,17,13,47,155,16,125,0,0
488,544,143,591,298,2,17,13,47,155,17,125,0,0
489,544,141,592,298,2,17,13,48,157,18,125,0,0
490,544,145,591,298,2,17,13,47,153,19,125,0,0
491,544,149,590,298,2,17,13,46,149,20,125,0,0
492,545,149,591,298,2,17,13,46,149,21,125,0,0
493,545,150,590,298,2,17,13,45,148,22,125,0,0
494,545,149,591,298,2,17,13,46,149,23,125,0,0
495,545,148,591,298,2,17,13,46,150,24,125,0,0
496,545,146,592,299,2,17,13,47,153,25,125,0,0
497,546,146,593,299,2,17,13,47,153,26,125,0,0
498,546,144,592,298,2,17,13,46,154,27,125,0,0
499,545,145,591,295,2,17,13,46,150,28,125,0,0
500,540,141,586,293,2,17,13,46,152,29,125,0,0
501,530,134,580,298,2,17,13,50,164,30,125,0,0
502,528,134,579,297,2,17,13,51,163,31,125,0,0
503,525,131,577,294,2,17,13,52,163,32,125,0,0
504,521,138,570,290,2,17,13,49,152,33,125,0,0
505,530,145,574,284,2,17,13,44,139,34,125,0,0
506,534,147,576,284,2,17,13,42,137,35,125,0,0
507,535,147,578,285,2,17,13,43,138,36,125,0,0
508,535,149,577,286,2,17,13,42,137,37,125,0,0
509,536,149,577,285,2,17,13,41,136,38,125,0,0
510,538,150,579,290,2,17,13,41,140,39,125,0,0
511,540,153,581,294,2,17,13,41,141,40,125,0,0
512,540,151,583,298,2,17,13,43,147,41,125,0,0
513,547,148,589,292,2,17,13,42,144,42,125,0,0
514,551,149,592,287,2,17,13,41,138,43,125,0,0
515,556,146,598,289,2,17,13,42,143,44,125,0,0
516,557,144,602,298,2,17,13,45,154,45,125,0,0
517,557,142,604,301,2,17,13,47,159,46,125,0,0
518,557,143,605,303,2,17,13,48,160,47,125,0,0
519,557,143,605,305,2,17,13,48,162,48,125,0,0
520,557,143,605,305,2,17,13,48,162,49,125,0,0
521,557,144,604,304,2,17,13,47,160,50,125,0,0
522,557,144,604,304,2,17,13,47,160,51,125,0,0
523,557,143,604,303,2,17,13,47,160,52,125,0,0
524,556,143,604,304,2,17,13,48,161,53,125,0,0
525,556,144,604,305,2,17,13,48,161,54,125,0,0
526,556,147,603,303,2,17,13,47,156,55,125,0,0
527,556,149,602,300,2,17,13,46,151,56,125,0,0
528,556,150,602,302,2,17,13,46,152,57,125,0,0
529,557,151,601,294,2,17,13,44,143,58,125,0,0
530,556,146,601,295,2,17,13,45,149,59,125,0,0
531,553,140,602,302,2,17,13,49,162,60,125,0,0
532,552,139,603,305,2,17,13,51,166,61,125,0,0
533,552,143,602,304,2,17,13,50,161,62,125,0,0
534,552,145,601,302,2,17,13,49,157,63,125,0,0
535,551,144,600,303,2,17,13,49,159,64,125,0,0
536,549,146,598,304,2,17,13,49,158,65,125,0,0
537,549,152,595,298,2,17,13,46,146,66,125,0,0
538,547,151,593,297,2,17,13,46,146,67,125,0,0
539,545,149,592,298,2,17,13,47,149,68,125,0,0
540,545,149,592,298,2,17,13,47,149,69,125,0,0
541,545,150,592,298,2,17,13,47,148,70,125,0,0
542,545,150,592,299,2,17,13,47,149,71,125,0,0
543,544,150,592,301,2,17,13,48,151,72,125,0,0
544,542,155,587,299,2,17,13,45,144,73,125,0,0
545,541,158,584,299,2,17,13,43,141,74,125,0,0
546,540,155,584,298,2,17,13,44,143,75,125,0,0
547,539,154,583,298,2,17,13,44,144,76,125,0,0
548,539,152,584,298,2,17,13,45,146,77,125,0,0
549,539,151,584,298,2,17,13,45,147,78,125,0,0
550,540,151,584,297,2,17,13,44,146,79,125,0,0
551,539,151,583,297,2,17,13,44,146,80,125,0,0
552,539,152,583,297,2,17,13,44,145,81,125,0,0
553,539,152,582,298,2,17,13,43,146,82,125,0,0
554,539,152,582,298,2,17,13,43,146,83,125,0,0
555,539,152,582,298,2,17,13,43,146,84,125,0,0
556,539,148,583,297,2,17,13,44,149,85,125,0,0
557,539,146,583,297,2,17,13,44,151,86,125,0,0
558,539,147,583,296,2,17,13,44,149,87,125,0,0
559,539,149,582,297,2,17,13,43,148,88,125,0,0
560,539,148,582,296,2,17,13,43,148,89,125,0,0
561,540,153,580,296,2,17,13,40,143,90,125,0,0
562,538,149,580,297,2,17,13,42,148,91,125,0,0
563,539,150,580,297,2,17,13,41,147,92,125,0,0
564,539,154,578,295,2,17,13,39,141,93,125,0,0
565,540,156,578,292,2,17,13,38,136,94,125,0,0
566,540,155,579,293,2,17,13,39,138,95,125,0,0
567,540,153,579,291,2,17,13,39,138,96,125,0,0
568,540,153,578,291,2,17,13,38,138,97,125,0,0
569,540,152,578,290,2,17,13,38,138,98,125,0,0
570,540,151,578,289,2,17,13,38,138,99,125,0,0
571,540,151,578,289,2,17,13,38,138,100,125,0,0
572,538,148,578,295,2,17,13,40,147,101,125,0,0
573,538,148,578,295,2,17,13,40,147,102,125,0,0
574,537,146,578,294,2,17,13,41,148,103,125,0,0
575,535,143,577,296,2,17,13,42,153,104,125,0,0
576,533,143,574,293,2,17,13,41,150,105,125,0,0
577,527,140,570,290,2,17,13,43,150,106,125,0,0
578,526,138,571,290,2,17,13,45,152,107,125,0,0
579,527,138,573,290,2,17,13,46,152,108,125,0,0
580,526,139,572,287,2,17,13,46,148,109,125,0,0
581,527,139,573,288,2,17,13,46,149,110,125,0,0
582,533,144,577,288,2,17,13,44,144,111,125,0,0
583,534,142,580,294,2,17,13,46,152,112,125,0,0
584,536,144,581,294,2,17,13,45,150,113,125,0,0
585,532,136,580,295,2,17,13,48,159,114,125,0,0
586,536,147,580,294,2,17,13,44,147,115,125,0,0
587,538,152,581,294,2,17,13,43,142,116,125,0,0
588,538,153,581,295,2,17,13,43,142,117,125,0,0
589,541,155,582,291,2,17,13,41,136,118,125,0,0
590,541,155,583,293,2,17,13,42,138,119,125,0,0
591,541,160,582,295,2,17,13,41,135,120,125,0,0
592,540,159,581,294,2,17,13,41,135,121,125,0,0
593,540,156,580,294,2,17,13,40,138,122,125,0,0
594,539,156,580,294,2,17,13,41,138,123,125,0,0
595,540,154,580,293,2,17,13,40,139,124,125,0,0
596,540,154,580,293,2,17,13,40,139,125,125,1,0
600,538,137,583,297,2,17,13,45,160,0,125,0,0
601,538,143,582,296,2,17,13,44,153,1,125,0,0
602,538,142,582,296,2,17,13,44,154,2,125,0,0
603,538,141,582,296,2,17,13,44,155,3,125,0,0
604,538,143,582,297,2,17,13,44,154,4,125,0,0
605,539,142,582,297,2,17,13,43,155,5,125,0,0
606,540,146,582,294,2,17,13,42,148,6,125,0,0
607,543,145,585,294,2,17,13,42,149,7,125,0,0
608,547,141,589,294,2,17,13,42,153,8,125,0,0
609,550,145,591,292,2,17,13,41,147,9,125,0,0
610,553,142,597,294,2,17,13,44,152,10,125,0,0
611,556,143,603,302,2,17,13,47,159,11,125,0,0
612,557,143,605,303,2,17,13,48,160,12,125,0,0
333,375,200,464,383,3,17,13,89,183,0,0,0,0
363,465,150,501,297,5,17,13,36,147,0,0,0,0
446,914,202,949,355,10,17,13,35,153,0,0,0,0
447,857,203,938,426,11,17,13,81,223,0,27,0,1
448,850,201,931,424,11,17,13,81,223,1,27,0,0
449,829,198,910,423,11,17,13,81,225,2,27,0,0
450,790,194,874,425,11,17,13,84,231,3,27,0,0
451,772,192,857,423,11,17,13,85,231,4,27,0,0
452,751,192,836,425,11,17,13,85,233,5,27,0,0
453,725,190,810,423,11,17,13,85,233,6,27,0,0
454,708,186,792,416,11,17,13,84,230,7,27,0,0
455,685,179,767,407,11,17,13,82,228,8,27,0,0
456,653,178,737,406,11,17,13,84,228,9,27,0,0
457,635,174,719,401,11,17,13,84,227,10,27,0,0
458,621,170,704,397,11,17,13,83,227,11,27,0,0
459,607,171,688,394,11,17,13,81,223,12,27,0,0
460,595,169,675,388,11,17,13,80,219,13,27,0,0
461,586,166,665,383,11,17,13,79,217,14,27,0,0
462,576,165,656,386,11,17,13,80,221,15,27,0,0
463,564,161,645,387,11,17,13,81,226,16,27,0,0
464,555,158,634,375,11,17,13,79,217,17,27,0,0
465,553,159,631,368,11,17,13,78,209,18,27,0,0
466,558,157,635,363,11,17,13,77,206,19,27,0,0
467,564,155,642,357,11,17,13,78,202,20,27,0,0
468,567,156,647,355,11,17,13,80,199,21,27,0,0
469,563,156,645,351,11,17,13,82,195,22,27,0,0
470,559,154,642,345,11,17,13,83,191,23,27,0,0
471,559,151,641,336,11,17,13,82,185,24,27,0,0
472,553,150,632,336,11,17,13,79,186,25,27,0,0
473,549,153,624,335,11,17,13,75,182,26,27,0,0
474,543,151,618,331,11,17,13,75,180,27,27,1,0
550,567,158,602,302,12,17,13,35,144,0,1,0,0
551,568,159,603,303,12,17,13,35,144,1,1,0,0
559,566,157,601,298,12,17,13,35,141,0,1,0,0
671,559,156,594,288,16,17,13,35,132,0,1,0,0
672,562,159,597,291,16,17,13,35,132,1,1,0,0
679,546,150,589,306,17,17,13,43,156,0,355,0,0
680,548,154,587,295,17,17,13,39,141,1,355,0,0
681,550,159,587,292,17,17,13,37,133,2,355,0,0
683,551,163,587,285,17,17,13,36,122,0,355,0,1
684,551,161,587,282,17,17,13,36,121,1,355,0,0
685,551,156,589,284,17,17,13,38,128,2,355,0,0
686,551,155,589,282,17,17,13,38,127,3,355,0,0
687,550,159,587,284,17,17,13,37,125,4,355,0,0
688,547,159,585,284,17,17,13,38,125,5,355,0,0
689,548,157,587,283,17,17,13,39,126,6,355,0,0
690,547,160,585,283,17,17,13,38,123,7,355,0,0
691,547,160,585,282,17,17,13,38,122,8,355,0,0
692,545,161,583,284,17,17,13,38,123,9,355,0,0
693,544,163,581,285,17,17,13,37,122,10,355,0,0
694,540,167,578,288,17,17,13,38,121,11,355,0,0
695,537,167,574,285,17,17,13,37,118,12,355,0,0
696,534,166,573,286,17,17,13,39,120,13,355,0,0
697,532,161,573,286,17,17,13,41,125,14,355,0,0
698,531,156,573,287,17,17,13,42,131,15,355,0,0
699,530,151,575,289,17,17,13,45,138,16,355,0,0
700,529,148,575,290,17,17,13,46,142,17,355,0,0
701,529,147,575,290,17,17,13,46,143,18,355,0,0
702,529,145,576,290,17,17,13,47,145,19,355,0,0
703,530,143,577,291,17,17,13,47,148,20,355,0,0
704,530,143,578,293,17,17,13,48,150,21,355,0,0
705,530,149,576,292,17,17,13,46,143,22,355,0,0
706,531,159,573,288,17,17,13,42,129,23,355,0,0
707,530,158,571,288,17,17,13,41,130,24,355,0,0
708,529,158,570,288,17,17,13,41,130,25,355,0,0
709,531,160,571,285,17,17,13,40,125,26,355,0,0
710,530,153,574,288,17,17,13,44,135,27,355,0,0
711,530,147,575,288,17,17,13,45,141,28,355,0,0
712,530,145,575,289,17,17,13,45,144,29,355,0,0
713,529,146,574,289,17,17,13,45,143,30,355,0,0
714,529,149,573,289,17,17,13,44,140,31,355,0,0
715,529,151,573,289,17,17,13,44,138,32,355,0,0
716,529,147,574,291,17,17,13,45,144,33,355,0,0
717,528,144,575,293,17,17,13,47,149,34,355,0,0
718,529,144,575,293,17,17,13,46,149,35,355,0,0
719,529,147,574,291,17,17,13,45,144,36,355,0,0
720,529,146,574,292,17,17,13,45,146,37,355,0,0
721,530,159,571,291,17,17,13,41,132,38,355,0,0
722,531,163,571,291,17,17,13,40,128,39,355,0,0
723,530,162,571,293,17,17,13,41,131,40,355,0,0
724,530,165,570,291,17,17,13,40,126,41,355,0,0
725,529,160,571,293,17,17,13,42,133,42,355,0,0
726,530,158,572,290,17,17,13,42,132,43,355,0,0
727,530,158,572,289,17,17,13,42,131,44,355,0,0
728,530,158,572,289,17,17,13,42,131,45,355,0,0
729,530,157,573,288,17,17,13,43,131,46,355,0,0
730,530,157,573,288,17,17,13,43,131,47,355,0,0
731,529,153,574,290,17,17,13,45,137,48,355,0,0
732,529,149,575,291,17,17,13,46,142,49,355,0,0
733,529,149,575,291,17,17,13,46,142,50,355,0,0
734,529,150,575,292,17,17,13,46,142,51,355,0,0
735,529,150,574,292,17,17,13,45,142,52,355,0,0
736,531,151,576,291,17,17,13,45,140,53,355,0,0
737,531,152,576,291,17,17,13,45,139,54,355,0,0
738,532,152,576,291,17,17,13,44,139,55,355,0,0
739,532,152,576,291,17,17,13,44,139,56,355,0,0
740,532,152,576,291,17,17,13,44,139,57,355,0,0
741,531,152,576,292,17,17,13,45,140,58,355,0,0
742,530,152,576,293,17,17,13,46,141,59,355,0,0
743,530,151,576,294,17,17,13,46,143,60,355,0,0
744,530,151,576,294,17,17,13,46,143,61,355,0,0
745,530,151,576,295,17,17,13,46,144,62,355,0,0
746,530,149,577,294,17,17,13,47,145,63,355,0,0
747,530,148,577,294,17,17,13,47,146,64,355,0,0
748,530,147,577,293,17,17,13,47,146,65,355,0,0
749,530,146,577,292,17,17,13,47,146,66,355,0,0
750,530,146,577,292,17,17,13,47,146,67,355,0,0
751,530,145,578,294,17,17,13,48,149,68,355,0,0
752,531,140,580,296,17,17,13,49,156,69,355,0,0
753,533,149,578,290,17,17,13,45,141,70,355,0,0
754,533,162,575,290,17,17,13,42,128,71,355,0,0
755,533,157,578,290,17,17,13,45,133,72,355,0,0
756,540,155,583,288,17,17,13,43,133,73,355,0,0
757,542,160,584,288,17,17,13,42,128,74,355,0,0
758,543,160,583,286,17,17,13,40,126,75,355,0,0
759,542,161,583,288,17,17,13,41,127,76,355,0,0
760,543,160,583,287,17,17,13,40,127,77,355,0,0
761,542,156,585,289,17,17,13,43,133,78,355,0,0
762,542,154,585,290,17,17,13,43,136,79,355,0,0
763,542,152,585,290,17,17,13,43,138,80,355,0,0
764,542,153,586,290,17,17,13,44,137,81,355,0,0
765,542,154,585,290,17,17,13,43,136,82,355,0,0
766,542,154,585,289,17,17,13,43,135,83,355,0,0
767,543,155,585,289,17,17,13,42,134,84,355,0,0
768,543,156,585,288,17,17,13,42,132,85,355,0,0
769,543,156,585,288,17,17,13,42,132,86,355,0,0
770,543,157,584,287,17,17,13,41,130,87,355,0,0
771,543,156,585,287,17,17,13,42,131,88,355,0,0
772,544,155,586,287,17,17,13,42,132,89,355,0,0
773,544,155,585,287,17,17,13,41,132,90,355,0,0
774,543,155,585,287,17,17,13,42,132,91,355,0,0
775,543,156,585,287,17,17,13,42,131,92,355,0,0
776,543,156,585,289,17,17,13,42,133,93,355,0,0
777,543,157,585,290,17,17,13,42,133,94,355,0,0
778,542,157,585,291,17,17,13,43,134,95,355,0,0
779,543,157,585,291,17,17,13,42,134,96,355,0,0
780,543,157,585,291,17,17,13,42,134,97,355,0,0
781,543,157,584,290,17,17,13,41,133,98,355,0,0
782,543,157,585,290,17,17,13,42,133,99,355,0,0
783,543,155,585,290,17,17,13,42,135,100,355,0,0
784,543,154,585,290,17,17,13,42,136,101,355,0,0
785,543,153,585,291,17,17,13,42,138,102,355,0,0
786,543,156,584,289,17,17,13,41,133,103,355,0,0
787,544,157,585,289,17,17,13,41,132,104,355,0,0
788,543,153,585,290,17,17,13,42,137,105,355,0,0
789,544,154,585,289,17,17,13,41,135,106,355,0,0
790,544,154,585,289,17,17,13,41,135,107,355,0,0
791,544,155,585,289,17,17,13,41,134,108,355,0,0
792,543,154,585,289,17,17,13,42,135,109,355,0,0
793,543,154,585,289,17,17,13,42,135,110,355,0,0
794,543,155,584,288,17,17,13,41,133,111,355,0,0
795,543,156,584,288,17,17,13,41,132,112,355,0,0
796,544,160,583,286,17,17,13,39,126,113,355,0,0
797,544,158,584,286,17,17,13,40,128,114,355,0,0
798,544,156,584,286,17,17,13,40,130,115,355,0,0
799,544,158,584,286,17,17,13,40,128,116,355,0,0
800,544,157,584,285,17,17,13,40,128,117,355,0,0
801,544,156,585,287,17,17,13,41,131,118,355,0,0
802,544,156,586,287,17,17,13,42,131,119,355,0,0
803,544,155,586,287,17,17,13,42,132,120,355,0,0
804,544,155,586,287,17,17,13,42,132,121,355,0,0
805,543,154,586,287,17,17,13,43,133,122,355,0,0
806,543,156,585,288,17,17,13,42,132,123,355,0,0
807,543,156,585,289,17,17,13,42,133,124,355,0,0
808,543,156,585,289,17,17,13,42,133,125,355,0,0
809,543,156,585,289,17,17,13,42,133,126,355,0,0
810,542,156,585,289,17,17,13,43,133,127,355,0,0
811,542,154,586,290,17,17,13,44,136,128,355,0,0
812,542,153,587,290,17,17,13,45,137,129,355,0,0
813,542,152,587,291,17,17,13,45,139,130,355,0,0
814,542,152,586,291,17,17,13,44,139,131,355,0,0
815,542,156,585,291,17,17,13,43,135,132,355,0,0
816,534,152,581,296,17,17,13,47,144,133,355,0,0
817,531,159,575,293,17,17,13,44,134,134,355,0,0
818,529,153,574,289,17,17,13,45,136,135,355,0,0
819,527,152,574,291,17,17,13,47,139,136,355,0,0
820,526,150,575,295,17,17,13,49,145,137,355,0,0
821,526,154,573,293,17,17,13,47,139,138,355,0,0
822,527,156,574,293,17,17,13,47,137,139,355,0,0
823,523,160,567,291,17,17,13,44,131,140,355,0,0
824,519,161,561,287,17,17,13,42,126,141,355,0,0
825,516,160,558,287,17,17,13,42,127,142,355,0,0
826,515,159,557,286,17,17,13,42,127,143,355,0,0
827,512,162,554,288,17,17,13,42,126,144,355,0,0
828,511,161,552,289,17,17,13,41,128,145,355,0,0
829,510,159,552,291,17,17,13,42,132,146,355,0,0
830,509,164,550,290,17,17,13,41,126,147,355,0,0
831,508,156,551,291,17,17,13,43,135,148,355,0,0
832,507,152,551,291,17,17,13,44,139,149,355,0,0
833,507,151,551,292,17,17,13,44,141,150,355,0,0
834,508,151,552,292,17,17,13,44,141,151,355,0,0
835,508,152,552,293,17,17,13,44,141,152,355,0,0
836,508,150,552,293,17,17,13,44,143,153,355,0,0
837,508,150,551,294,17,17,13,43,144,154,355,0,0
838,508,151,551,294,17,17,13,43,143,155,355,0,0
839,508,151,550,294,17,17,13,42,143,156,355,0,0
840,508,151,551,294,17,17,13,43,143,157,355,0,0
841,509,150,551,294,17,17,13,42,144,158,355,0,0
842,509,149,551,294,17,17,13,42,145,159,355,0,0
843,509,149,551,294,17,17,13,42,145,160,355,0,0
844,509,149,551,294,17,17,13,42,145,161,355,0,0
845,509,150,551,294,17,17,13,42,144,162,355,0,0
846,509,152,551,294,17,17,13,42,142,163,355,0,0
847,510,152,551,294,17,17,13,41,142,164,355,0,0
848,510,153,551,294,17,17,13,41,141,165,355,0,0
849,510,153,551,294,17,17,13,41,141,166,355,0,0
850,510,153,551,294,17,17,13,41,141,167,355,0,0
851,511,153,551,291,17,17,13,40,138,168,355,0,0
852,512,153,551,290,17,17,13,39,137,169,355,0,0
853,511,155,551,292,17,17,13,40,137,170,355,0,0
854,511,155,551,293,17,17,13,40,138,171,355,0,0
855,511,156,551,293,17,17,13,40,137,172,355,0,0
856,510,152,551,294,17,17,13,41,142,173,355,0,0
857,510,151,552,294,17,17,13,42,143,174,355,0,0
858,510,151,552,295,17,17,13,42,144,175,355,0,0
859,510,150,551,295,17,17,13,41,145,176,355,0,0
860,510,150,552,294,17,17,13,42,144,177,355,0,0
861,510,151,551,294,17,17,13,41,143,178,355,0,0
862,510,152,550,294,17,17,13,40,142,179,355,0,0
863,510,153,551,294,17,17,13,41,141,180,355,0,0
864,510,153,551,294,17,17,13,41,141,181,355,0,0
865,510,154,551,294,17,17,13,41,140,182,355,0,0
866,510,155,551,294,17,17,13,41,139,183,355,0,0
867,510,155,550,294,17,17,13,40,139,184,355,0,0
868,511,156,550,295,17,17,13,39,139,185,355,0,0
869,510,155,551,295,17,17,13,41,140,186,355,0,0
870,510,155,550,295,17,17,13,40,140,187,355,0,0
871,510,154,551,294,17,17,13,41,140,188,355,0,0
872,510,153,551,294,17,17,13,41,141,189,355,0,0
873,510,153,551,294,17,17,13,41,141,190,355,0,0
874,510,152,551,294,17,17,13,41,142,191,355,0,0
875,510,152,551,293,17,17,13,41,141,192,355,0,0
876,510,152,551,293,17,17,13,41,141,193,355,0,0
877,510,152,551,293,17,17,13,41,141,194,355,0,0
878,510,152,552,293,17,17,13,42,141,195,355,0,0
879,510,152,552,293,17,17,13,42,141,196,355,0,0
880,511,153,551,293,17,17,13,40,140,197,355,0,0
881,511,151,552,293,17,17,13,41,142,198,355,0,0
882,510,151,552,292,17,17,13,42,141,199,355,0,0
883,511,151,552,292,17,17,13,41,141,200,355,0,0
884,510,151,552,291,17,17,13,42,140,201,355,0,0
885,510,150,552,292,17,17,13,42,142,202,355,0,0
886,511,152,552,291,17,17,13,41,139,203,355,0,0
887,510,152,552,291,17,17,13,42,139,204,355,0,0
888,510,153,552,292,17,17,13,42,139,205,355,0,0
889,510,153,552,291,17,17,13,42,138,206,355,0,0
890,510,154,552,292,17,17,13,42,138,207,355,0,0
891,510,153,552,291,17,17,13,42,138,208,355,0,0
892,511,155,552,291,17,17,13,41,136,209,355,0,0
893,510,154,552,290,17,17,13,42,136,210,355,0,0
894,510,154,552,292,17,17,13,42,138,211,355,0,0
895,510,154,552,293,17,17,13,42,139,212,355,0,0
896,509,154,552,294,17,17,13,43,140,213,355,0,0
897,509,154,552,294,17,17,13,43,140,214,355,0,0
898,509,154,552,295,17,17,13,43,141,215,355,0,0
899,509,154,552,295,17,17,13,43,141,216,355,0,0
900,509,154,552,295,17,17,13,43,141,217,355,0,0
901,510,152,552,293,17,17,13,42,141,218,355,0,0
902,510,151,553,293,17,17,13,43,142,219,355,0,0
903,510,151,553,293,17,17,13,43,142,220,355,0,0
904,510,150,553,293,17,17,13,43,143,221,355,0,0
905,510,150,552,293,17,17,13,42,143,222,355,0,0
906,510,152,552,294,17,17,13,42,142,223,355,0,0
907,510,152,552,294,17,17,13,42,142,224,355,0,0
908,510,152,552,294,17,17,13,42,142,225,355,0,0
909,510,153,552,294,17,17,13,42,141,226,355,0,0
910,510,153,552,294,17,17,13,42,141,227,355,0,0
911,511,153,553,294,17,17,13,42,141,228,355,0,0
912,511,153,553,294,17,17,13,42,141,229,355,0,0
913,511,153,553,294,17,17,13,42,141,230,355,0,0
914,511,153,553,294,17,17,13,42,141,231,355,0,0
915,511,153,553,294,17,17,13,42,141,232,355,0,0
916,510,153,552,293,17,17,13,42,140,233,355,0,0
917,510,153,552,293,17,17,13,42,140,234,355,0,0
918,510,153,552,293,17,17,13,42,140,235,355,0,0
919,510,153,552,292,17,17,13,42,139,236,355,0,0
920,510,152,552,293,17,17,13,42,141,237,355,0,0
921,510,153,552,293,17,17,13,42,140,238,355,0,0
922,510,153,552,294,17,17,13,42,141,239,355,0,0
923,510,153,552,294,17,17,13,42,141,240,355,0,0
924,510,154,552,294,17,17,13,42,140,241,355,0,0
925,510,153,552,293,17,17,13,42,140,242,355,0,0
926,510,153,551,293,17,17,13,41,140,243,355,0,0
927,510,153,552,293,17,17,13,42,140,244,355,0,0
928,510,153,551,292,17,17,13,41,139,245,355,0,0
929,510,152,551,292,17,17,13,41,140,246,355,0,0
930,511,153,551,291,17,17,13,40,138,247,355,0,0
931,510,153,552,293,17,17,13,42,140,248,355,0,0
932,510,153,552,293,17,17,13,42,140,249,355,0,0
933,510,153,552,293,17,17,13,42,140,250,355,0,0
934,510,153,552,294,17,17,13,42,141,251,355,0,0
935,510,153,552,294,17,17,13,42,141,252,355,0,0
936,511,155,552,294,17,17,13,41,139,253,355,0,0
937,511,155,552,294,17,17,13,41,139,254,355,0,0
938,511,156,552,294,17,17,13,41,138,255,355,0,0
939,511,156,552,294,17,17,13,41,138,256,355,0,0
940,511,156,552,294,17,17,13,41,138,257,355,0,0
941,511,155,551,291,17,17,13,40,136,258,355,0,0
942,511,155,551,290,17,17,13,40,135,259,355,0,0
943,511,155,551,290,17,17,13,40,135,260,355,0,0
944,511,155,551,289,17,17,13,40,134,261,355,0,0
945,511,155,551,289,17,17,13,40,134,262,355,0,0
946,510,154,552,291,17,17,13,42,137,263,355,0,0
947,510,154,552,292,17,17,13,42,138,264,355,0,0
948,510,154,552,292,17,17,13,42,138,265,355,0,0
949,510,154,552,292,17,17,13,42,138,266,355,0,0
950,510,154,552,293,17,17,13,42,139,267,355,0,0
951,510,154,551,292,17,17,13,41,138,268,355,0,0
952,510,154,551,292,17,17,13,41,138,269,355,0,0
953,510,154,551,292,17,17,13,41,138,270,355,0,0
954,510,154,551,291,17,17,13,41,137,271,355,0,0
955,510,154,551,291,17,17,13,41,137,272,355,0,0
956,511,155,551,290,17,17,13,40,135,273,355,0,0
957,511,155,551,290,17,17,13,40,135,274,355,0,0
958,511,155,551,290,17,17,13,40,135,275,355,0,0
959,511,155,551,290,17,17,13,40,135,276,355,0,0
960,511,155,551,290,17,17,13,40,135,277,355,0,0
961,511,154,551,290,17,17,13,40,136,278,355,0,0
962,511,154,552,290,17,17,13,41,136,279,355,0,0
963,511,154,552,290,17,17,13,41,136,280,355,0,0
964,511,153,552,290,17,17,13,41,137,281,355,0,0
965,511,153,551,290,17,17,13,40,137,282,355,0,0
966,510,155,551,290,17,17,13,41,135,283,355,0,0
967,510,155,550,290,17,17,13,40,135,284,355,0,0
968,510,155,550,290,17,17,13,40,135,285,355,0,0
969,510,156,550,290,17,17,13,40,134,286,355,0,0
970,510,156,550,290,17,17,13,40,134,287,355,0,0
971,510,155,551,291,17,17,13,41,136,288,355,0,0
972,510,155,551,291,17,17,13,41,136,289,355,0,0
973,510,155,551,291,17,17,13,41,136,290,355,0,0
974,510,155,551,292,17,17,13,41,137,291,355,0,0
975,510,155,552,292,17,17,13,42,137,292,355,0,0
976,510,153,552,292,17,17,13,42,139,293,355,0,0
977,509,153,552,292,17,17,13,43,139,294,355,0,0
978,509,152,552,292,17,17,13,43,140,295,355,0,0
979,509,152,552,292,17,17,13,43,140,296,355,0,0
980,509,152,552,292,17,17,13,43,140,297,355,0,0
981,510,153,551,291,17,17,13,41,138,298,355,0,0
982,510,153,551,291,17,17,13,41,138,299,355,0,0
983,510,153,551,291,17,17,13,41,138,300,355,0,0
984,510,153,551,290,17,17,13,41,137,301,355,0,0
985,510,153,551,290,17,17,13,41,137,302,355,0,0
986,510,155,551,291,17,17,13,41,136,303,355,0,0
987,510,155,551,291,17,17,13,41,136,304,355,0,0
988,510,155,551,291,17,17,13,41,136,305,355,0,0
989,509,156,551,292,17,17,13,42,136,306,355,0,0
990,510,156,551,292,17,17,13,41,136,307,355,0,0
991,510,154,552,291,17,17,13,42,137,308,355,0,0
992,510,154,552,291,17,17,13,42,137,309,355,0,0
993,510,154,552,291,17,17,13,42,137,310,355,0,0
994,510,153,552,290,17,17,13,42,137,311,355,0,0
995,510,153,552,290,17,17,13,42,137,312,355,0,0
996,510,155,552,290,17,17,13,42,135,313,355,0,0
997,511,155,552,290,17,17,13,41,135,314,355,0,0
998,511,155,551,290,17,17,13,40,135,315,355,0,0
999,511,156,551,290,17,17,13,40,134,316,355,0,0
1000,511,156,551,290,17,17,13,40,134,317,355,0,0
1001,510,154,552,290,17,17,13,42,136,318,355,0,0
1002,510,154,552,290,17,17,13,42,136,319,355,0,0
1003,510,154,552,290,17,17,13,42,136,320,355,0,0
1004,510,153,552,290,17,17,13,42,137,321,355,0,0
1005,510,153,552,290,17,17,13,42,137,322,355,0,0
1006,510,153,552,290,17,17,13,42,137,323,355,0,0
1007,510,153,552,290,17,17,13,42,137,324,355,0,0
1008,509,153,552,291,17,17,13,43,138,325,355,0,0
1009,509,153,551,291,17,17,13,42,138,326,355,0,0
1010,510,153,551,291,17,17,13,41,138,327,355,0,0
1011,510,153,552,291,17,17,13,42,138,328,355,0,0
1012,510,153,552,291,17,17,13,42,138,329,355,0,0
1013,510,153,552,291,17,17,13,42,138,330,355,0,0
1014,510,153,552,292,17,17,13,42,139,331,355,0,0
1015,510,153,552,292,17,17,13,42,139,332,355,0,0
1016,510,154,552,292,17,17,13,42,138,333,355,0,0
1017,510,154,552,291,17,17,13,42,137,334,355,0,0
1018,510,154,551,291,17,17,13,41,137,335,355,0,0
1019,510,154,552,291,17,17,13,42,137,336,355,0,0
1020,510,154,552,290,17,17,13,42,136,337,355,0,0
1021,510,153,552,290,17,17,13,42,137,338,355,0,0
1022,510,153,552,290,17,17,13,42,137,339,355,0,0
1023,510,152,552,290,17,17,13,42,138,340,355,0,0
1024,510,153,551,290,17,17,13,41,137,341,355,0,0
1025,510,153,551,290,17,17,13,41,137,342,355,0,0
1026,510,154,551,290,17,17,13,41,136,343,355,0,0
1027,510,154,550,290,17,17,13,40,136,344,355,0,0
1028,510,154,550,290,17,17,13,40,136,345,355,0,0
1029,510,153,551,290,17,17,13,41,137,346,355,0,0
1030,512,157,553,291,17,17,13,41,134,347,355,0,0
1031,518,157,559,289,17,17,13,41,132,348,355,0,0
1032,525,160,567,287,17,17,13,42,127,349,355,0,0
1033,533,159,576,286,17,17,13,43,127,350,355,0,0
1034,547,153,592,283,17,17,13,45,130,351,355,0,0
1035,558,156,602,282,17,17,13,44,126,352,355,0,0
1036,565,156,610,284,17,17,13,45,128,353,355,0,0
1037,568,158,615,295,17,17,13,47,137,354,355,0,0
1038,573,159,620,296,17,17,13,47,137,355,355,1,0
700,573,195,608,290,18,17,13,35,95,0,23,0,0
701,575,182,612,285,18,17,13,37,103,1,23,0,0
702,575,170,616,284,18,17,13,41,114,2,23,0,0
703,574,160,618,285,18,17,13,44,125,3,23,0,0
704,569,154,619,297,18,17,13,50,143,4,23,0,0
705,566,153,617,299,18,17,13,51,146,5,23,0,0
706,558,152,606,292,18,17,13,48,140,6,23,0,0
707,563,153,610,292,18,17,13,47,139,7,23,0,0
708,561,148,610,293,18,17,13,49,145,8,23,0,0
711,563,146,612,292,18,17,13,49,146,0,23,0,0
712,563,143,613,293,18,17,13,50,150,1,23,0,0
713,564,145,612,290,18,17,13,48,145,2,23,0,0
714,565,145,612,289,18,17,13,47,144,3,23,0,0
715,569,148,614,289,18,17,13,45,141,4,23,0,0
716,573,156,614,286,18,17,13,41,130,5,23,0,0
717,573,156,614,286,18,17,13,41,130,6,23,0,0
722,574,167,612,289,18,17,13,38,122,0,23,0,0
723,573,161,612,294,18,17,13,39,133,1,23,0,0
724,576,172,611,291,18,17,13,35,119,2,23,0,0
725,576,173,611,291,18,17,13,35,118,3,23,0,0
744,570,153,612,294,18,17,13,42,141,0,23,0,0
745,571,150,612,294,18,17,13,41,144,1,23,0,0
746,569,158,610,295,18,17,13,41,137,2,23,0,0
747,569,166,608,296,18,17,13,39,130,3,23,0,0
748,569,166,608,296,18,17,13,39,130,4,23,0,0
756,569,152,608,286,18,17,13,39,134,0,23,0,1
757,571,154,609,286,18,17,13,38,132,1,23,0,0
758,571,153,607,286,18,17,13,36,133,2,23,0,0
759,572,150,609,288,18,17,13,37,138,3,23,0,0
760,573,147,611,289,18,17,13,38,142,4,23,0,0
761,572,146,610,289,18,17,13,38,143,5,23,0,0
762,571,145,610,289,18,17,13,39,144,6,23,0,0
763,570,145,608,287,18,17,13,38,142,7,23,0,0
764,571,145,609,289,18,17,13,38,144,8,23,0,0
765,575,146,612,288,18,17,13,37,142,9,23,0,0
766,573,146,610,290,18,17,13,37,144,10,23,0,0
767,571,146,608,290,18,17,13,37,144,11,23,0,0
768,570,147,607,290,18,17,13,37,143,12,23,0,0
769,571,147,608,289,18,17,13,37,142,13,23,0,0
770,570,148,606,287,18,17,13,36,139,14,23,0,0
771,571,145,608,288,18,17,13,37,143,15,23,0,0
772,571,144,608,288,18,17,13,37,144,16,23,0,0
773,572,144,608,287,18,17,13,36,143,17,23,0,0
774,574,144,610,287,18,17,13,36,143,18,23,0,0
775,573,142,610,288,18,17,13,37,146,19,23,0,0
776,574,144,611,290,18,17,13,37,146,20,23,0,0
777,574,147,610,291,18,17,13,36,144,21,23,0,0
778,574,148,610,291,18,17,13,36,143,22,23,0,0
779,574,149,609,292,18,17,13,35,143,23,23,1,0
781,573,151,608,292,18,17,13,35,141,0,23,0,0
783,573,149,608,293,18,17,13,35,144,0,23,0,0
784,574,149,609,293,18,17,13,35,144,1,23,0,0
785,573,147,609,293,18,17,13,36,146,2,23,0,0
824,540,161,575,286,19,17,13,35,125,0,51,0,0
836,543,176,578,287,19,17,13,35,111,0,51,0,0
837,543,176,578,286,19,17,13,35,110,1,51,0,0
845,543,174,579,285,19,17,13,36,111,0,51,0,0
846,542,176,578,286,19,17,13,36,110,1,51,0,0
847,542,176,578,286,19,17,13,36,110,2,51,0,0
848,542,177,578,286,19,17,13,36,109,3,51,0,0
849,542,177,578,286,19,17,13,36,109,4,51,0,0
850,542,177,578,286,19,17,13,36,109,5,51,0,0
856,542,175,578,284,19,17,13,36,109,0,51,0,0
857,541,173,578,284,19,17,13,37,111,1,51,0,0
858,541,172,578,284,19,17,13,37,112,2,51,0,0
859,541,171,578,285,19,17,13,37,114,3,51,0,0
860,540,169,578,285,19,17,13,38,116,4,51,0,0
861,541,174,577,285,19,17,13,36,111,5,51,0,0
862,542,178,577,285,19,17,13,35,107,6,51,0,0
871,543,178,578,284,19,17,13,35,106,0,51,0,1
872,542,174,578,284,19,17,13,36,110,1,51,0,0
873,541,174,578,284,19,17,13,37,110,2,51,0,0
874,541,173,578,284,19,17,13,37,111,3,51,0,0
875,541,173,578,284,19,17,13,37,111,4,51,0,0
876,542,176,578,286,19,17,13,36,110,5,51,0,0
877,542,178,578,286,19,17,13,36,108,6,51,0,0
878,543,179,578,286,19,17,13,35,107,7,51,0,0
879,543,180,578,287,19,17,13,35,107,8,51,0,0
880,543,180,578,285,19,17,13,35,105,9,51,0,0
881,542,174,578,284,19,17,13,36,110,10,51,0,0
882,542,172,579,284,19,17,13,37,112,11,51,0,0
883,541,171,578,283,19,17,13,37,112,12,51,0,0
884,542,173,579,284,19,17,13,37,111,13,51,0,0
885,542,173,579,284,19,17,13,37,111,14,51,0,0
886,542,172,579,283,19,17,13,37,111,15,51,0,0
887,542,172,578,283,19,17,13,36,111,16,51,0,0
888,542,173,578,282,19,17,13,36,109,17,51,0,0
889,542,172,578,282,19,17,13,36,110,18,51,0,0
890,542,172,578,282,19,17,13,36,110,19,51,0,0
891,542,174,578,283,19,17,13,36,109,20,51,0,0
892,543,175,578,284,19,17,13,35,109,21,51,0,0
893,543,175,578,284,19,17,13,35,109,22,51,0,0
894,543,175,578,284,19,17,13,35,109,23,51,0,0
895,543,175,578,285,19,17,13,35,110,24,51,0,0
896,543,178,578,285,19,17,13,35,107,25,51,0,0
897,543,179,578,285,19,17,13,35,106,26,51,0,0
898,543,180,578,285,19,17,13,35,105,27,51,0,0
899,543,178,578,285,19,17,13,35,107,28,51,0,0
900,543,177,578,285,19,17,13,35,108,29,51,0,0
901,541,169,578,285,19,17,13,37,116,30,51,0,0
902,540,168,578,285,19,17,13,38,117,31,51,0,0
903,540,168,577,285,19,17,13,37,117,32,51,0,0
904,540,168,577,285,19,17,13,37,117,33,51,0,0
905,540,169,577,285,19,17,13,37,116,34,51,0,0
906,540,171,576,284,19,17,13,36,113,35,51,0,0
907,540,171,576,283,19,17,13,36,112,36,51,0,0
908,540,170,576,283,19,17,13,36,113,37,51,0,0
909,540,170,576,282,19,17,13,36,112,38,51,0,0
910,540,170,576,282,19,17,13,36,112,39,51,0,0
911,540,169,577,284,19,17,13,37,115,40,51,0,0
912,540,169,577,285,19,17,13,37,116,41,51,0,0
913,540,168,577,285,19,17,13,37,117,42,51,0,0
914,541,168,577,286,19,17,13,36,118,43,51,0,0
915,541,168,577,286,19,17,13,36,118,44,51,0,0
916,542,172,578,285,19,17,13,36,113,45,51,0,0
917,542,172,578,284,19,17,13,36,112,46,51,0,0
918,543,174,579,285,19,17,13,36,111,47,51,0,0
919,543,174,579,285,19,17,13,36,111,48,51,0,0
920,543,174,579,285,19,17,13,36,111,49,51,0,0
921,542,175,578,285,19,17,13,36,110,50,51,0,0
922,542,176,577,285,19,17,13,35,109,51,51,1,0
925,542,174,577,282,19,17,13,35,108,0,51,0,0
931,543,176,578,282,19,17,13,35,106,0,51,0,0
932,543,176,578,283,19,17,13,35,107,1,51,0,0
933,543,174,578,283,19,17,13,35,109,2,51,0,0
934,542,174,578,283,19,17,13,36,109,3,51,0,0
935,542,172,578,285,19,17,13,36,113,4,51,0,0
936,542,175,577,283,19,17,13,35,108,5,51,0,0
949,543,174,578,281,19,17,13,35,107,0,51,0,0
950,543,174,578,281,19,17,13,35,107,1,51,0,0
973,542,175,577,277,19,17,13,35,102,0,51,0,0
974,542,174,577,277,19,17,13,35,103,1,51,0,0
975,542,174,577,278,19,17,13,35,104,2,51,0,0
987,543,174,578,279,19,17,13,35,105,0,51,0,0
990,543,173,578,281,19,17,13,35,108,0,51,0,1
991,543,173,578,279,19,17,13,35,106,1,51,0,0
992,543,173,578,279,19,17,13,35,106,2,51,0,0
993,543,172,578,279,19,17,13,35,107,3,51,0,0
994,543,173,578,279,19,17,13,35,106,4,51,0,0
995,543,173,578,279,19,17,13,35,106,5,51,0,0
996,543,174,578,281,19,17,13,35,107,6,51,0,0
997,543,174,578,281,19,17,13,35,107,7,51,0,0
998,543,175,578,282,19,17,13,35,107,8,51,0,0
999,543,176,578,282,19,17,13,35,106,9,51,0,0
1000,543,176,578,282,19,17,13,35,106,10,51,0,0
1001,543,174,578,280,19,17,13,35,106,11,51,0,0
1002,543,173,578,279,19,17,13,35,106,12,51,0,0
1003,543,173,578,279,19,17,13,35,106,13,51,0,0
1004,543,172,578,278,19,17,13,35,106,14,51,0,0
1005,543,172,578,278,19,17,13,35,106,15,51,0,0
1006,543,173,578,279,19,17,13,35,106,16,51,0,0
1007,543,174,578,279,19,17,13,35,105,17,51,0,0
1008,543,174,578,281,19,17,13,35,107,18,51,0,0
1009,543,173,578,281,19,17,13,35,108,19,51,0,0
1010,543,173,578,281,19,17,13,35,108,20,51,0,0
1011,543,173,578,280,19,17,13,35,107,21,51,0,0
1012,542,171,578,281,19,17,13,36,110,22,51,0,0
1013,541,170,578,281,19,17,13,37,111,23,51,0,0
1014,542,172,578,280,19,17,13,36,108,24,51,0,0
1015,542,172,577,279,19,17,13,35,107,25,51,0,0
1862,561,149,612,285,22,17,13,51,136,0,14,0,0
1863,547,137,610,306,22,17,13,63,169,1,14,0,0
1864,548,145,606,297,22,17,13,58,152,2,14,0,0
1865,547,144,604,294,22,17,13,57,150,3,14,0,0
1866,547,145,603,293,22,17,13,56,148,4,14,0,0
1867,547,148,602,293,22,17,13,55,145,5,14,0,0
1868,549,151,603,294,22,17,13,54,143,6,14,0,0
1869,548,151,602,293,22,17,13,54,142,7,14,0,0
1870,548,150,602,293,22,17,13,54,143,8,14,0,0
1871,547,149,601,293,22,17,13,54,144,9,14,0,0
1872,546,151,600,292,22,17,13,54,141,10,14,0,0
1873,546,152,599,292,22,17,13,53,140,11,14,0,0
1874,546,153,599,291,22,17,13,53,138,12,14,0,0
1875,546,154,599,290,22,17,13,53,136,13,14,0,0
1876,546,155,598,290,22,17,13,52,135,14,14,0,0
1879,549,159,599,290,22,17,13,50,131,0,14,0,0
1880,549,158,600,291,22,17,13,51,133,1,14,0,0
1881,549,159,600,291,22,17,13,51,132,2,14,0,0
1884,549,159,601,291,22,17,13,52,132,0,14,0,0
1885,549,157,601,291,22,17,13,52,134,1,14,0,0
1886,549,156,602,291,22,17,13,53,135,2,14,0,0
1887,549,156,602,291,22,17,13,53,135,3,14,0,0
1888,549,155,602,291,22,17,13,53,136,4,14,0,0
1889,549,155,602,291,22,17,13,53,136,5,14,0,0
1890,548,152,603,293,22,17,13,55,141,6,14,0,0
1891,552,144,608,289,22,17,13,56,145,7,14,0,0
1892,552,143,609,289,22,17,13,57,146,8,14,0,0
2594,556,145,609,289,24,17,13,53,144,0,1,0,0
2595,552,153,602,289,24,17,13,50,136,1,1,0,0
2598,547,192,604,284,25,17,13,57,92,0,0,0,0
2618,547,186,606,285,26,17,13,59,99,0,0,0,0
2683,574,165,609,296,27,17,13,35,131,0,602,0,0
2684,567,162,605,299,27,17,13,38,137,1,602,0,0
2685,562,163,601,298,27,17,13,39,135,2,602,0,0
2686,558,165,598,300,27,17,13,40,135,3,602,0,0
2687,553,164,594,297,27,17,13,41,133,4,602,0,0
2688,554,169,595,297,27,17,13,41,128,5,602,0,0
2689,547,183,586,298,27,17,13,39,115,6,602,0,0
2690,542,188,580,295,27,17,13,38,107,7,602,0,0
2691,539,190,576,296,27,17,13,37,106,8,602,0,0
2692,535,193,572,292,27,17,13,37,99,9,602,0,0
2693,535,194,571,291,27,17,13,36,97,10,602,0,0
2694,532,189,572,294,27,17,13,40,105,11,602,0,0
2695,529,186,572,296,27,17,13,43,110,12,602,0,0
2696,527,186,569,297,27,17,13,42,111,13,602,0,0
2698,531,184,574,293,27,17,13,43,109,0,602,0,1
2699,529,188,570,293,27,17,13,41,105,1,602,0,0
2700,530,170,580,296,27,17,13,50,126,2,602,0,0
2701,527,182,570,295,27,17,13,43,113,3,602,0,0
2702,529,163,580,293,27,17,13,51,130,4,602,0,0
2703,529,156,583,293,27,17,13,54,137,5,602,0,0
2704,528,153,583,293,27,17,13,55,140,6,602,0,0
2705,529,151,585,296,27,17,13,56,145,7,602,0,0
2706,528,148,586,297,27,17,13,58,149,8,602,0,0
2707,525,147,582,296,27,17,13,57,149,9,602,0,0
2708,522,144,582,298,27,17,13,60,154,10,602,0,0
2709,521,140,581,298,27,17,13,60,158,11,602,0,0
2710,520,137,581,298,27,17,13,61,161,12,602,0,0
2711,523,158,573,289,27,17,13,50,131,13,602,0,0
2712,522,153,560,253,27,17,13,38,100,14,602,0,0
2713,511,150,557,274,27,17,13,46,124,15,602,0,0
2714,508,146,556,280,27,17,13,48,134,16,602,0,0
2715,511,142,565,292,27,17,13,54,150,17,602,0,0
2716,514,133,574,299,27,17,13,60,166,18,602,0,0
2717,512,135,572,300,27,17,13,60,165,19,602,0,0
2718,505,141,558,288,27,17,13,53,147,20,602,0,0
2719,496,140,547,281,27,17,13,51,141,21,602,0,0
2720,490,141,541,281,27,17,13,51,140,22,602,0,0
2721,487,150,532,279,27,17,13,45,129,23,602,0,0
2722,482,152,527,280,27,17,13,45,128,24,602,0,0
2723,477,146,523,278,27,17,13,46,132,25,602,0,0
2724,475,145,519,276,27,17,13,44,131,26,602,0,0
2725,472,144,516,274,27,17,13,44,130,27,602,0,0
2726,469,145,513,277,27,17,13,44,132,28,602,0,0
2727,467,147,511,279,27,17,13,44,132,29,602,0,0
2728,466,146,511,279,27,17,13,45,133,30,602,0,0
2729,465,148,510,281,27,17,13,45,133,31,602,0,0
2730,465,147,510,282,27,17,13,45,135,32,602,0,0
2731,464,146,509,280,27,17,13,45,134,33,602,0,0
2732,464,145,509,280,27,17,13,45,135,34,602,0,0
2733,464,145,509,280,27,17,13,45,135,35,602,0,0
2734,463,144,509,280,27,17,13,46,136,36,602,0,0
2735,463,143,509,281,27,17,13,46,138,37,602,0,0
2736,464,145,509,280,27,17,13,45,135,38,602,0,0
2737,464,145,509,280,27,17,13,45,135,39,602,0,0
2738,464,146,509,280,27,17,13,45,134,40,602,0,0
2739,464,146,508,280,27,17,13,44,134,41,602,0,0
2740,464,146,508,280,27,17,13,44,134,42,602,0,0
2741,464,146,508,279,27,17,13,44,133,43,602,0,0
2742,464,146,508,279,27,17,13,44,133,44,602,0,0
2743,464,146,508,279,27,17,13,44,133,45,602,0,0
2744,464,145,508,278,27,17,13,44,133,46,602,0,0
2745,464,145,508,278,27,17,13,44,133,47,602,0,0
2746,464,146,509,280,27,17,13,45,134,48,602,0,0
2747,465,147,510,281,27,17,13,45,134,49,602,0,0
2748,465,147,510,281,27,17,13,45,134,50,602,0,0
2749,465,148,509,281,27,17,13,44,133,51,602,0,0
2750,464,147,509,281,27,17,13,45,134,52,602,0,0
2751,465,147,509,279,27,17,13,44,132,53,602,0,0
2752,465,147,508,279,27,17,13,43,132,54,602,0,0
2753,465,148,509,279,27,17,13,44,131,55,602,0,0
2754,465,148,509,278,27,17,13,44,130,56,602,0,0
2755,465,147,508,278,27,17,13,43,131,57,602,0,0
2756,465,146,508,279,27,17,13,43,133,58,602,0,0
2757,464,145,508,279,27,17,13,44,134,59,602,0,0
2758,464,145,509,281,27,17,13,45,136,60,602,0,0
2759,465,144,509,280,27,17,13,44,136,61,602,0,0
2760,465,144,509,280,27,17,13,44,136,62,602,0,0
2761,465,146,508,279,27,17,13,43,133,63,602,0,0
2762,465,146,508,279,27,17,13,43,133,64,602,0,0
2763,465,146,508,279,27,17,13,43,133,65,602,0,0
2764,465,146,508,278,27,17,13,43,132,66,602,0,0
2765,465,147,508,278,27,17,13,43,131,67,602,0,0
2766,466,146,509,280,27,17,13,43,134,68,602,0,0
2767,466,146,510,280,27,17,13,44,134,69,602,0,0
2768,466,146,509,279,27,17,13,43,133,70,602,0,0
2769,466,146,509,279,27,17,13,43,133,71,602,0,0
2770,466,146,510,280,27,17,13,44,134,72,602,0,0
2771,466,146,510,279,27,17,13,44,133,73,602,0,0
2772,466,146,510,279,27,17,13,44,133,74,602,0,0
2773,466,146,510,279,27,17,13,44,133,75,602,0,0
2774,466,146,510,278,27,17,13,44,132,76,602,0,0
2775,466,146,510,278,27,17,13,44,132,77,602,0,0
2776,466,146,511,280,27,17,13,45,134,78,602,0,0
2777,465,146,511,280,27,17,13,46,134,79,602,0,0
2778,465,146,511,280,27,17,13,46,134,80,602,0,0
2779,465,146,510,281,27,17,13,45,135,81,602,0,0
2780,465,146,510,281,27,17,13,45,135,82,602,0,0
2781,465,146,510,280,27,17,13,45,134,83,602,0,0
2782,465,146,511,280,27,17,13,46,134,84,602,0,0
2783,465,147,510,280,27,17,13,45,133,85,602,0,0
2784,465,147,510,280,27,17,13,45,133,86,602,0,0
2785,465,148,510,280,27,17,13,45,132,87,602,0,0
2786,464,147,509,280,27,17,13,45,133,88,602,0,0
2787,465,147,509,279,27,17,13,44,132,89,602,0,0
2788,464,146,509,279,27,17,13,45,133,90,602,0,0
2789,464,146,509,279,27,17,13,45,133,91,602,0,0
2790,464,146,509,279,27,17,13,45,133,92,602,0,0
2791,465,147,509,279,27,17,13,44,132,93,602,0,0
2792,465,147,509,279,27,17,13,44,132,94,602,0,0
2793,465,147,509,280,27,17,13,44,133,95,602,0,0
2794,465,147,509,280,27,17,13,44,133,96,602,0,0
2795,464,147,510,281,27,17,13,46,134,97,602,0,0
2796,464,145,510,281,27,17,13,46,136,98,602,0,0
2797,464,145,510,282,27,17,13,46,137,99,602,0,0
2798,464,145,510,282,27,17,13,46,137,100,602,0,0
2799,464,145,510,282,27,17,13,46,137,101,602,0,0
2800,464,145,510,282,27,17,13,46,137,102,602,0,0
2801,465,147,509,280,27,17,13,44,133,103,602,0,0
2802,465,148,509,280,27,17,13,44,132,104,602,0,0
2803,465,148,510,280,27,17,13,45,132,105,602,0,0
2804,466,148,509,280,27,17,13,43,132,106,602,0,0
2805,466,149,509,280,27,17,13,43,131,107,602,0,0
2806,465,147,509,280,27,17,13,44,133,108,602,0,0
2807,465,147,509,280,27,17,13,44,133,109,602,0,0
2808,465,146,509,280,27,17,13,44,134,110,602,0,0
2809,465,146,509,280,27,17,13,44,134,111,602,0,0
2810,465,145,509,281,27,17,13,44,136,112,602,0,0
2811,465,147,509,280,27,17,13,44,133,113,602,0,0
2812,465,147,509,280,27,17,13,44,133,114,602,0,0
2813,465,147,509,280,27,17,13,44,133,115,602,0,0
2814,466,147,509,279,27,17,13,43,132,116,602,0,0
2815,466,148,509,279,27,17,13,43,131,117,602,0,0
2816,465,148,509,279,27,17,13,44,131,118,602,0,0
2817,465,147,509,280,27,17,13,44,133,119,602,0,0
2818,465,147,509,280,27,17,13,44,133,120,602,0,0
2819,465,147,509,280,27,17,13,44,133,121,602,0,0
2820,464,145,509,280,27,17,13,45,135,122,602,0,0
2821,464,142,509,282,27,17,13,45,140,123,602,0,0
2822,465,147,508,280,27,17,13,43,133,124,602,0,0
2823,465,143,511,283,27,17,13,46,140,125,602,0,0
2824,465,145,512,286,27,17,13,47,141,126,602,0,0
2825,469,144,518,288,27,17,13,49,144,127,602,0,0
2826,473,145,522,289,27,17,13,49,144,128,602,0,0
2827,478,148,527,290,27,17,13,49,142,129,602,0,0
2828,480,150,529,291,27,17,13,49,141,130,602,0,0
2829,481,152,529,291,27,17,13,48,139,131,602,0,0
2830,481,150,529,290,27,17,13,48,140,132,602,0,0
2831,482,149,531,292,27,17,13,49,143,133,602,0,0
2832,485,149,534,293,27,17,13,49,144,134,602,0,0
2833,489,149,539,293,27,17,13,50,144,135,602,0,0
2834,494,149,545,296,27,17,13,51,147,136,602,0,0
2835,499,150,549,297,27,17,13,50,147,137,602,0,0
2836,504,148,553,296,27,17,13,49,148,138,602,0,0
2837,509,147,559,297,27,17,13,50,150,139,602,0,0
2838,511,145,562,298,27,17,13,51,153,140,602,0,0
2839,510,147,559,297,27,17,13,49,150,141,602,0,0
2840,511,145,561,298,27,17,13,50,153,142,602,0,0
2841,511,144,561,298,27,17,13,50,154,143,602,0,0
2842,513,144,562,297,27,17,13,49,153,144,602,0,0
2843,511,144,559,297,27,17,13,48,153,145,602,0,0
2844,510,146,558,297,27,17,13,48,151,146,602,0,0
2845,510,147,558,298,27,17,13,48,151,147,602,0,0
2846,509,145,557,299,27,17,13,48,154,148,602,0,0
2847,509,145,557,300,27,17,13,48,155,149,602,0,0
2848,508,145,556,300,27,17,13,48,155,150,602,0,0
2849,508,145,555,300,27,17,13,47,155,151,602,0,0
2850,507,146,554,300,27,17,13,47,154,152,602,0,0
2851,507,148,553,300,27,17,13,46,152,153,602,0,0
2852,508,149,553,299,27,17,13,45,150,154,602,0,0
2853,508,149,554,299,27,17,13,46,150,155,602,0,0
2854,508,149,554,300,27,17,13,46,151,156,602,0,0
2855,508,147,554,300,27,17,13,46,153,157,602,0,0
2856,508,149,553,299,27,17,13,45,150,158,602,0,0
2857,508,149,553,299,27,17,13,45,150,159,602,0,0
2858,507,149,553,299,27,17,13,46,150,160,602,0,0
2859,507,149,553,299,27,17,13,46,150,161,602,0,0
2860,508,148,554,299,27,17,13,46,151,162,602,0,0
2861,507,149,553,300,27,17,13,46,151,163,602,0,0
2862,507,149,553,301,27,17,13,46,152,164,602,0,0
2863,507,150,553,300,27,17,13,46,150,165,602,0,0
2864,507,148,553,301,27,17,13,46,153,166,602,0,0
2865,506,148,552,301,27,17,13,46,153,167,602,0,0
2866,507,150,552,302,27,17,13,45,152,168,602,0,0
2867,507,150,552,302,27,17,13,45,152,169,602,0,0
2868,507,151,552,302,27,17,13,45,151,170,602,0,0
2869,507,151,551,302,27,17,13,44,151,171,602,0,0
2870,507,152,551,301,27,17,13,44,149,172,602,0,0
2871,508,152,552,300,27,17,13,44,148,173,602,0,0
2872,509,152,554,300,27,17,13,45,148,174,602,0,0
2873,509,152,554,300,27,17,13,45,148,175,602,0,0
2874,509,151,554,299,27,17,13,45,148,176,602,0,0
2875,509,151,554,299,27,17,13,45,148,177,602,0,0
2876,508,153,553,299,27,17,13,45,146,178,602,0,0
2877,508,154,552,299,27,17,13,44,145,179,602,0,0
2878,507,155,552,299,27,17,13,45,144,180,602,0,0
2879,508,156,551,299,27,17,13,43,143,181,602,0,0
2880,507,156,551,299,27,17,13,44,143,182,602,0,0
2881,507,153,552,299,27,17,13,45,146,183,602,0,0
2882,507,152,552,299,27,17,13,45,147,184,602,0,0
2883,507,152,552,299,27,17,13,45,147,185,602,0,0
2884,507,152,553,299,27,17,13,46,147,186,602,0,0
2885,507,152,553,299,27,17,13,46,147,187,602,0,0
2886,507,151,553,299,27,17,13,46,148,188,602,0,0
2887,508,151,553,299,27,17,13,45,148,189,602,0,0
2888,508,152,553,299,27,17,13,45,147,190,602,0,0
2889,507,152,553,299,27,17,13,46,147,191,602,0,0
2890,507,151,553,298,27,17,13,46,147,192,602,0,0
2891,507,151,553,299,27,17,13,46,148,193,602,0,0
2892,507,153,552,299,27,17,13,45,146,194,602,0,0
2893,510,155,554,299,27,17,13,44,144,195,602,0,0
2894,511,156,555,298,27,17,13,44,142,196,602,0,0
2895,514,162,555,296,27,17,13,41,134,197,602,0,0
2896,520,154,564,295,27,17,13,44,141,198,602,0,0
2897,523,154,568,295,27,17,13,45,141,199,602,0,0
2898,525,154,571,295,27,17,13,46,141,200,602,0,0
2899,527,156,573,296,27,17,13,46,140,201,602,0,0
2900,527,156,572,296,27,17,13,45,140,202,602,0,0
2901,525,156,572,297,27,17,13,47,141,203,602,0,0
2902,524,155,572,299,27,17,13,48,144,204,602,0,0
2903,524,155,572,301,27,17,13,48,146,205,602,0,0
2904,523,154,571,300,27,17,13,48,146,206,602,0,0
2905,524,154,571,297,27,17,13,47,143,207,602,0,0
2906,524,156,571,298,27,17,13,47,142,208,602,0,0
2907,524,157,570,296,27,17,13,46,139,209,602,0,0
2908,524,155,570,294,27,17,13,46,139,210,602,0,0
2909,524,154,571,296,27,17,13,47,142,211,602,0,0
2910,523,158,567,294,27,17,13,44,136,212,602,0,0
2911,522,159,565,295,27,17,13,43,136,213,602,0,0
2912,523,161,565,293,27,17,13,42,132,214,602,0,0
2913,524,161,565,292,27,17,13,41,131,215,602,0,0
2914,523,160,565,293,27,17,13,42,133,216,602,0,0
2915,524,160,564,287,27,17,13,40,127,217,602,0,0
2916,523,160,563,288,27,17,13,40,128,218,602,0,0
2917,523,160,564,290,27,17,13,41,130,219,602,0,0
2918,524,161,564,289,27,17,13,40,128,220,602,0,0
2919,524,159,565,287,27,17,13,41,128,221,602,0,0
2920,524,160,565,289,27,17,13,41,129,222,602,0,0
2921,524,161,565,291,27,17,13,41,130,223,602,0,0
2922,524,161,566,292,27,17,13,42,131,224,602,0,0
2923,524,162,566,292,27,17,13,42,130,225,602,0,0
2924,524,161,566,290,27,17,13,42,129,226,602,0,0
2925,524,161,566,290,27,17,13,42,129,227,602,0,0
2926,525,159,567,291,27,17,13,42,132,228,602,0,0
2927,525,157,568,293,27,17,13,43,136,229,602,0,0
2928,524,156,568,293,27,17,13,44,137,230,602,0,0
2929,523,154,568,293,27,17,13,45,139,231,602,0,0
2930,524,156,569,295,27,17,13,45,139,232,602,0,0
2931,524,158,568,293,27,17,13,44,135,233,602,0,0
2932,524,160,567,293,27,17,13,43,133,234,602,0,0
2933,524,159,567,293,27,17,13,43,134,235,602,0,0
2934,525,159,567,293,27,17,13,42,134,236,602,0,0
2935,524,160,567,293,27,17,13,43,133,237,602,0,0
2936,524,158,567,292,27,17,13,43,134,238,602,0,0
2937,524,159,567,293,27,17,13,43,134,239,602,0,0
2938,524,158,567,293,27,17,13,43,135,240,602,0,0
2939,524,157,568,293,27,17,13,44,136,241,602,0,0
2940,524,158,567,292,27,17,13,43,134,242,602,0,0
2941,525,156,567,288,27,17,13,42,132,243,602,0,0
2942,524,154,568,289,27,17,13,44,135,244,602,0,0
2943,524,151,569,289,27,17,13,45,138,245,602,0,0
2944,522,150,569,288,27,17,13,47,138,246,602,0,0
2945,516,150,561,288,27,17,13,45,138,247,602,0,0
2946,513,153,557,289,27,17,13,44,136,248,602,0,0
2947,511,154,555,290,27,17,13,44,136,249,602,0,0
2948,510,158,553,292,27,17,13,43,134,250,602,0,0
2949,510,160,552,292,27,17,13,42,132,251,602,0,0
2950,510,159,552,292,27,17,13,42,133,252,602,0,0
2951,510,162,552,291,27,17,13,42,129,253,602,0,0
2952,510,160,552,291,27,17,13,42,131,254,602,0,0
2953,509,158,551,291,27,17,13,42,133,255,602,0,0
2954,509,157,551,292,27,17,13,42,135,256,602,0,0
2955,510,157,551,291,27,17,13,41,134,257,602,0,0
2956,510,160,550,291,27,17,13,40,131,258,602,0,0
2957,510,160,550,290,27,17,13,40,130,259,602,0,0
2958,511,162,549,289,27,17,13,38,127,260,602,0,0
2959,510,159,550,290,27,17,13,40,131,261,602,0,0
2960,510,160,549,290,27,17,13,39,130,262,602,0,0
2961,511,159,549,290,27,17,13,38,131,263,602,0,0
2962,511,157,550,290,27,17,13,39,133,264,602,0,0
2963,511,162,549,290,27,17,13,38,128,265,602,0,0
2964,511,160,549,290,27,17,13,38,130,266,602,0,0
2965,511,160,549,291,27,17,13,38,131,267,602,0,0
2966,511,152,551,292,27,17,13,40,140,268,602,0,0
2967,511,151,552,292,27,17,13,41,141,269,602,0,0
2968,512,150,552,292,27,17,13,40,142,270,602,0,0
2969,512,149,552,292,27,17,13,40,143,271,602,0,0
2970,512,149,552,291,27,17,13,40,142,272,602,0,0
2971,512,153,551,289,27,17,13,39,136,273,602,0,0
2972,512,154,550,289,27,17,13,38,135,274,602,0,0
2973,512,154,550,289,27,17,13,38,135,275,602,0,0
2974,512,154,550,288,27,17,13,38,134,276,602,0,0
2975,512,154,551,288,27,17,13,39,134,277,602,0,0
2976,513,152,552,288,27,17,13,39,136,278,602,0,0
2977,511,150,551,290,27,17,13,40,140,279,602,0,0
2978,511,150,551,291,27,17,13,40,141,280,602,0,0
2979,511,150,551,291,27,17,13,40,141,281,602,0,0
2980,511,151,551,292,27,17,13,40,141,282,602,0,0
2981,511,150,551,292,27,17,13,40,142,283,602,0,0
2982,511,150,552,292,27,17,13,41,142,284,602,0,0
2983,511,148,552,292,27,17,13,41,144,285,602,0,0
2984,511,148,552,292,27,17,13,41,144,286,602,0,0
2985,511,147,552,292,27,17,13,41,145,287,602,0,0
2986,511,148,551,290,27,17,13,40,142,288,602,0,0
2987,511,148,551,290,27,17,13,40,142,289,602,0,0
2988,511,148,551,290,27,17,13,40,142,290,602,0,0
2989,511,149,551,289,27,17,13,40,140,291,602,0,0
2990,511,150,550,289,27,17,13,39,139,292,602,0,0
2991,512,145,552,291,27,17,13,40,146,293,602,0,0
2992,512,143,552,291,27,17,13,40,148,294,602,0,0
2993,512,144,552,291,27,17,13,40,147,295,602,0,0
2994,512,145,552,291,27,17,13,40,146,296,602,0,0
2995,512,142,553,291,27,17,13,41,149,297,602,0,0
2996,512,148,552,291,27,17,13,40,143,298,602,0,0
2997,513,149,552,290,27,17,13,39,141,299,602,0,0
2998,513,152,551,290,27,17,13,38,138,300,602,0,0
2999,513,159,550,291,27,17,13,37,132,301,602,0,0
3000,512,160,549,290,27,17,13,37,130,302,602,0,0
3001,513,161,550,290,27,17,13,37,129,303,602,0,0
3002,516,162,552,287,27,17,13,36,125,304,602,0,0
3003,516,159,554,288,27,17,13,38,129,305,602,0,0
3004,516,160,554,287,27,17,13,38,127,306,602,0,0
3005,516,160,553,287,27,17,13,37,127,307,602,0,0
3006,514,157,553,289,27,17,13,39,132,308,602,0,0
3007,516,158,553,287,27,17,13,37,129,309,602,0,0
3008,514,156,553,289,27,17,13,39,133,310,602,0,0
3009,514,157,553,288,27,17,13,39,131,311,602,0,0
3010,514,160,552,290,27,17,13,38,130,312,602,0,0
3011,515,160,552,288,27,17,13,37,128,313,602,0,0
3012,515,160,552,287,27,17,13,37,127,314,602,0,0
3013,513,156,552,289,27,17,13,39,133,315,602,0,0
3014,513,152,553,289,27,17,13,40,137,316,602,0,0
3015,512,150,552,289,27,17,13,40,139,317,602,0,0
3016,512,149,552,290,27,17,13,40,141,318,602,0,0
3017,512,151,552,289,27,17,13,40,138,319,602,0,0
3018,513,155,551,289,27,17,13,38,134,320,602,0,0
3019,513,157,551,289,27,17,13,38,132,321,602,0,0
3020,513,157,550,288,27,17,13,37,131,322,602,0,0
3021,513,160,550,287,27,17,13,37,127,323,602,0,0
3022,514,160,550,287,27,17,13,36,127,324,602,0,0
3023,514,159,550,287,27,17,13,36,128,325,602,0,0
3024,513,156,550,288,27,17,13,37,132,326,602,0,0
3025,512,154,550,288,27,17,13,38,134,327,602,0,0
3026,512,151,551,288,27,17,13,39,137,328,602,0,0
3027,512,150,551,288,27,17,13,39,138,329,602,0,0
3028,512,150,551,289,27,17,13,39,139,330,602,0,0
3029,512,151,550,289,27,17,13,38,138,331,602,0,0
3030,512,151,550,289,27,17,13,38,138,332,602,0,0
3031,513,155,550,288,27,17,13,37,133,333,602,0,0
3032,513,153,551,288,27,17,13,38,135,334,602,0,0
3033,513,153,551,288,27,17,13,38,135,335,602,0,0
3034,513,153,551,287,27,17,13,38,134,336,602,0,0
3035,513,156,550,287,27,17,13,37,131,337,602,0,0
3036,514,159,550,289,27,17,13,36,130,338,602,0,0
3037,514,162,550,289,27,17,13,36,127,339,602,0,0
3038,514,162,549,289,27,17,13,35,127,340,602,0,0
3039,513,161,549,292,27,17,13,36,131,341,602,0,0
3040,513,162,549,290,27,17,13,36,128,342,602,0,0
3041,513,163,549,291,27,17,13,36,128,343,602,0,0
3042,514,165,549,291,27,17,13,35,126,344,602,0,0
3043,514,163,550,291,27,17,13,36,128,345,602,0,0
3044,514,163,550,291,27,17,13,36,128,346,602,0,0
3045,513,160,550,291,27,17,13,37,131,347,602,0,0
3046,513,158,550,291,27,17,13,37,133,348,602,0,0
3047,513,158,551,290,27,17,13,38,132,349,602,0,0
3048,513,158,551,290,27,17,13,38,132,350,602,0,0
3049,514,158,550,290,27,17,13,36,132,351,602,0,0
3050,514,161,550,288,27,17,13,36,127,352,602,0,0
3051,514,162,549,287,27,17,13,35,125,353,602,0,0
3052,514,162,550,287,27,17,13,36,125,354,602,0,0
3053,514,162,550,286,27,17,13,36,124,355,602,0,0
3054,514,162,550,286,27,17,13,36,124,356,602,0,0
3055,514,163,550,286,27,17,13,36,123,357,602,0,0
3056,513,157,551,288,27,17,13,38,131,358,602,0,0
3057,514,155,552,288,27,17,13,38,133,359,602,0,0
3058,516,156,554,286,27,17,13,38,130,360,602,0,0
3059,520,152,559,286,27,17,13,39,134,361,602,0,0
3060,524,149,565,290,27,17,13,41,141,362,602,0,0
3061,525,149,567,291,27,17,13,42,142,363,602,0,0
3062,526,144,570,290,27,17,13,44,146,364,602,0,0
3063,528,144,573,291,27,17,13,45,147,365,602,0,0
3064,528,145,574,293,27,17,13,46,148,366,602,0,0
3065,528,148,573,293,27,17,13,45,145,367,602,0,0
3066,527,145,574,292,27,17,13,47,147,368,602,0,0
3067,527,144,575,291,27,17,13,48,147,369,602,0,0
3068,527,145,575,290,27,17,13,48,145,370,602,0,0
3069,527,144,575,290,27,17,13,48,146,371,602,0,0
3070,526,144,576,291,27,17,13,50,147,372,602,0,0
3071,528,147,576,289,27,17,13,48,142,373,602,0,0
3072,528,149,575,289,27,17,13,47,140,374,602,0,0
3073,528,149,576,289,27,17,13,48,140,375,602,0,0
3074,527,149,576,290,27,17,13,49,141,376,602,0,0
3075,527,149,577,290,27,17,13,50,141,377,602,0,0
3076,528,144,579,290,27,17,13,51,146,378,602,0,0
3077,527,144,579,292,27,17,13,52,148,379,602,0,0
3078,527,144,580,293,27,17,13,53,149,380,602,0,0
3079,527,144,580,293,27,17,13,53,149,381,602,0,0
3080,527,145,579,293,27,17,13,52,148,382,602,0,0
3081,526,148,577,290,27,17,13,51,142,383,602,0,0
3082,525,149,576,289,27,17,13,51,140,384,602,0,0
3083,525,149,575,289,27,17,13,50,140,385,602,0,0
3084,526,150,576,288,27,17,13,50,138,386,602,0,0
3085,525,150,576,288,27,17,13,51,138,387,602,0,0
3086,525,148,577,290,27,17,13,52,142,388,602,0,0
3087,525,147,578,290,27,17,13,53,143,389,602,0,0
3088,525,147,578,290,27,17,13,53,143,390,602,0,0
3089,526,147,578,290,27,17,13,52,143,391,602,0,0
3090,525,147,578,291,27,17,13,53,144,392,602,0,0
3091,525,145,579,291,27,17,13,54,146,393,602,0,0
3092,525,145,578,292,27,17,13,53,147,394,602,0,0
3093,525,144,578,292,27,17,13,53,148,395,602,0,0
3094,525,144,578,292,27,17,13,53,148,396,602,0,0
3095,525,144,578,292,27,17,13,53,148,397,602,0,0
3096,525,150,576,291,27,17,13,51,141,398,602,0,0
3097,525,151,576,291,27,17,13,51,140,399,602,0,0
3098,524,152,576,291,27,17,13,52,139,400,602,0,0
3099,524,152,576,290,27,17,13,52,138,401,602,0,0
3100,524,152,575,290,27,17,13,51,138,402,602,0,0
3101,524,150,577,292,27,17,13,53,142,403,602,0,0
3102,524,149,578,293,27,17,13,54,144,404,602,0,0
3103,523,147,579,295,27,17,13,56,148,405,602,0,0
3104,524,146,580,297,27,17,13,56,151,406,602,0,0
3105,525,147,581,298,27,17,13,56,151,407,602,0,0
3106,524,147,580,296,27,17,13,56,149,408,602,0,0
3107,524,147,579,295,27,17,13,55,148,409,602,0,0
3108,524,147,579,295,27,17,13,55,148,410,602,0,0
3109,524,147,580,295,27,17,13,56,148,411,602,0,0
3110,524,146,579,293,27,17,13,55,147,412,602,0,0
3111,524,148,578,293,27,17,13,54,145,413,602,0,0
3112,524,148,578,294,27,17,13,54,146,414,602,0,0
3113,524,150,577,294,27,17,13,53,144,415,602,0,0
3114,524,150,576,293,27,17,13,52,143,416,602,0,0
3115,524,151,576,291,27,17,13,52,140,417,602,0,0
3116,525,150,576,289,27,17,13,51,139,418,602,0,0
3117,525,150,576,289,27,17,13,51,139,419,602,0,0
3118,525,150,576,287,27,17,13,51,137,420,602,0,0
3119,526,150,576,286,27,17,13,50,136,421,602,0,0
3120,525,150,576,288,27,17,13,51,138,422,602,0,0
3121,525,150,576,286,27,17,13,51,136,423,602,0,0
3122,525,150,575,286,27,17,13,50,136,424,602,0,0
3123,525,150,576,286,27,17,13,51,136,425,602,0,0
3124,525,149,576,286,27,17,13,51,137,426,602,0,0
3125,525,149,576,286,27,17,13,51,137,427,602,0,0
3126,525,145,578,287,27,17,13,53,142,428,602,0,0
3127,525,143,578,288,27,17,13,53,145,429,602,0,0
3128,525,143,578,288,27,17,13,53,145,430,602,0,0
3129,525,143,578,288,27,17,13,53,145,431,602,0,0
3130,525,143,578,288,27,17,13,53,145,432,602,0,0
3131,526,145,579,290,27,17,13,53,145,433,602,0,0
3132,526,145,580,290,27,17,13,54,145,434,602,0,0
3133,526,145,580,290,27,17,13,54,145,435,602,0,0
3134,526,144,579,290,27,17,13,53,146,436,602,0,0
3135,526,144,580,290,27,17,13,54,146,437,602,0,0
3136,527,150,579,292,27,17,13,52,142,438,602,0,0
3137,526,151,578,292,27,17,13,52,141,439,602,0,0
3138,526,150,577,292,27,17,13,51,142,440,602,0,0
3139,526,151,576,290,27,17,13,50,139,441,602,0,0
3140,527,151,576,288,27,17,13,49,137,442,602,0,0
3141,528,148,577,284,27,17,13,49,136,443,602,0,0
3142,529,152,576,282,27,17,13,47,130,444,602,0,0
3143,528,149,577,285,27,17,13,49,136,445,602,0,0
3144,528,148,577,287,27,17,13,49,139,446,602,0,0
3145,526,146,577,287,27,17,13,51,141,447,602,0,0
3146,524,147,576,290,27,17,13,52,143,448,602,0,0
3147,523,149,575,290,27,17,13,52,141,449,602,0,0
3148,522,150,575,291,27,17,13,53,141,450,602,0,0
3149,523,152,575,288,27,17,13,52,136,451,602,0,0
3150,526,156,575,284,27,17,13,49,128,452,602,0,0
3151,526,155,575,285,27,17,13,49,130,453,602,0,0
3152,526,156,574,284,27,17,13,48,128,454,602,0,0
3153,525,153,574,284,27,17,13,49,131,455,602,0,0
3154,524,155,572,284,27,17,13,48,129,456,602,0,0
3155,525,156,573,285,27,17,13,48,129,457,602,0,0
3156,527,152,574,283,27,17,13,47,131,458,602,0,0
3157,528,151,576,285,27,17,13,48,134,459,602,0,0
3158,528,149,578,287,27,17,13,50,138,460,602,0,0
3159,529,148,579,288,27,17,13,50,140,461,602,0,0
3160,529,146,579,288,27,17,13,50,142,462,602,0,0
3161,528,148,578,289,27,17,13,50,141,463,602,0,0
3162,528,148,577,290,27,17,13,49,142,464,602,0,0
3163,528,148,577,290,27,17,13,49,142,465,602,0,0
3164,528,150,577,290,27,17,13,49,140,466,602,0,0
3165,528,150,577,291,27,17,13,49,141,467,602,0,0
3166,529,150,576,288,27,17,13,47,138,468,602,0,0
3167,530,150,577,287,27,17,13,47,137,469,602,0,0
3168,530,150,575,285,27,17,13,45,135,470,602,0,0
3169,529,149,575,285,27,17,13,46,136,471,602,0,0
3170,529,149,575,286,27,17,13,46,137,472,602,0,0
3171,529,148,575,284,27,17,13,46,136,473,602,0,0
3172,529,148,575,284,27,17,13,46,136,474,602,0,0
3173,529,147,575,284,27,17,13,46,137,475,602,0,0
3174,529,147,575,284,27,17,13,46,137,476,602,0,0
3175,529,147,574,284,27,17,13,45,137,477,602,0,0
3176,529,149,574,282,27,17,13,45,133,478,602,0,0
3177,529,149,574,282,27,17,13,45,133,479,602,0,0
3178,529,151,573,281,27,17,13,44,130,480,602,0,0
3179,529,152,574,281,27,17,13,45,129,481,602,0,0
3180,529,152,574,281,27,17,13,45,129,482,602,0,0
3181,528,151,573,283,27,17,13,45,132,483,602,0,0
3182,527,149,572,284,27,17,13,45,135,484,602,0,0
3183,527,151,572,285,27,17,13,45,134,485,602,0,0
3184,527,152,572,285,27,17,13,45,133,486,602,0,0
3185,527,154,571,285,27,17,13,44,131,487,602,0,0
3186,527,152,571,283,27,17,13,44,131,488,602,0,0
3187,528,152,572,282,27,17,13,44,130,489,602,0,0
3188,528,152,572,282,27,17,13,44,130,490,602,0,0
3189,527,150,572,282,27,17,13,45,132,491,602,0,0
3190,527,151,571,282,27,17,13,44,131,492,602,0,0
3191,528,151,571,281,27,17,13,43,130,493,602,0,0
3192,528,150,571,280,27,17,13,43,130,494,602,0,0
3193,528,150,571,278,27,17,13,43,128,495,602,0,0
3194,529,151,571,278,27,17,13,42,127,496,602,0,0
3195,528,149,572,279,27,17,13,44,130,497,602,0,0
3196,528,148,572,281,27,17,13,44,133,498,602,0,0
3197,528,148,572,281,27,17,13,44,133,499,602,0,0
3198,528,148,572,282,27,17,13,44,134,500,602,0,0
3199,528,148,572,282,27,17,13,44,134,501,602,0,0
3200,527,148,572,282,27,17,13,45,134,502,602,0,0
3201,527,149,572,283,27,17,13,45,134,503,602,0,0
3202,528,149,572,283,27,17,13,44,134,504,602,0,0
3203,527,149,572,283,27,17,13,45,134,505,602,0,0
3204,528,151,572,283,27,17,13,44,132,506,602,0,0
3205,528,151,572,283,27,17,13,44,132,507,602,0,0
3206,528,150,572,283,27,17,13,44,133,508,602,0,0
3207,528,150,572,283,27,17,13,44,133,509,602,0,0
3208,528,150,572,284,27,17,13,44,134,510,602,0,0
3209,528,150,572,284,27,17,13,44,134,511,602,0,0
3210,528,150,572,284,27,17,13,44,134,512,602,0,0
3211,529,150,573,282,27,17,13,44,132,513,602,0,0
3212,529,150,573,282,27,17,13,44,132,514,602,0,0
3213,530,152,573,280,27,17,13,43,128,515,602,0,0
3214,530,152,573,280,27,17,13,43,128,516,602,0,0
3215,530,152,573,279,27,17,13,43,127,517,602,0,0
3216,529,153,572,281,27,17,13,43,128,518,602,0,0
3217,529,154,571,281,27,17,13,42,127,519,602,0,0
3218,529,155,571,281,27,17,13,42,126,520,602,0,0
3219,529,156,571,281,27,17,13,42,125,521,602,0,0
3220,529,156,571,281,27,17,13,42,125,522,602,0,0
3221,528,154,571,281,27,17,13,43,127,523,602,0,0
3222,527,153,571,281,27,17,13,44,128,524,602,0,0
3223,527,151,571,282,27,17,13,44,131,525,602,0,0
3224,527,151,571,282,27,17,13,44,131,526,602,0,0
3225,527,151,571,282,27,17,13,44,131,527,602,0,0
3226,527,149,571,283,27,17,13,44,134,528,602,0,0
3227,527,149,572,283,27,17,13,45,134,529,602,0,0
3228,527,148,572,283,27,17,13,45,135,530,602,0,0
3229,527,148,572,283,27,17,13,45,135,531,602,0,0
3230,527,148,572,283,27,17,13,45,135,532,602,0,0
3231,528,149,572,282,27,17,13,44,133,533,602,0,0
3232,528,149,572,282,27,17,13,44,133,534,602,0,0
3233,528,149,572,282,27,17,13,44,133,535,602,0,0
3234,528,149,572,281,27,17,13,44,132,536,602,0,0
3235,528,149,572,281,27,17,13,44,132,537,602,0,0
3236,529,151,571,281,27,17,13,42,130,538,602,0,0
3237,529,152,571,281,27,17,13,42,129,539,602,0,0
3238,529,152,571,281,27,17,13,42,129,540,602,0,0
3239,529,152,571,281,27,17,13,42,129,541,602,0,0
3240,528,152,571,281,27,17,13,43,129,542,602,0,0
3241,528,150,571,281,27,17,13,43,131,543,602,0,0
3242,528,150,572,281,27,17,13,44,131,544,602,0,0
3243,528,150,571,281,27,17,13,43,131,545,602,0,0
3244,528,149,571,281,27,17,13,43,132,546,602,0,0
3245,528,149,571,281,27,17,13,43,132,547,602,0,0
3246,528,151,571,281,27,17,13,43,130,548,602,0,0
3247,528,152,571,281,27,17,13,43,129,549,602,0,0
3248,528,152,571,280,27,17,13,43,128,550,602,0,0
3249,528,152,571,280,27,17,13,43,128,551,602,0,0
3250,528,152,571,280,27,17,13,43,128,552,602,0,0
3251,529,152,571,281,27,17,13,42,129,553,602,0,0
3252,529,152,571,281,27,17,13,42,129,554,602,0,0
3253,529,152,571,281,27,17,13,42,129,555,602,0,0
3254,529,152,571,282,27,17,13,42,130,556,602,0,0
3255,529,151,572,282,27,17,13,43,131,557,602,0,0
3256,529,149,572,282,27,17,13,43,133,558,602,0,0
3257,529,149,572,282,27,17,13,43,133,559,602,0,0
3258,529,148,572,282,27,17,13,43,134,560,602,0,0
3259,528,148,573,282,27,17,13,45,134,561,602,0,0
3260,529,148,573,282,27,17,13,44,134,562,602,0,0
3261,529,148,572,282,27,17,13,43,134,563,602,0,0
3262,529,148,572,282,27,17,13,43,134,564,602,0,0
3263,529,148,572,282,27,17,13,43,134,565,602,0,0
3264,529,148,572,282,27,17,13,43,134,566,602,0,0
3265,529,150,572,282,27,17,13,43,132,567,602,0,0
3266,529,148,572,281,27,17,13,43,133,568,602,0,0
3267,529,147,572,281,27,17,13,43,134,569,602,0,0
3268,529,147,572,281,27,17,13,43,134,570,602,0,0
3269,529,146,572,280,27,17,13,43,134,571,602,0,0
3270,529,146,572,280,27,17,13,43,134,572,602,0,0
3271,528,149,571,282,27,17,13,43,133,573,602,0,0
3272,528,151,571,282,27,17,13,43,131,574,602,0,0
3273,528,151,570,282,27,17,13,42,131,575,602,0,0
3274,527,151,570,282,27,17,13,43,131,576,602,0,0
3275,528,151,570,282,27,17,13,42,131,577,602,0,0
3276,528,149,571,281,27,17,13,43,132,578,602,0,0
3277,528,149,571,281,27,17,13,43,132,579,602,0,0
3278,528,149,571,281,27,17,13,43,132,580,602,0,0
3279,528,149,571,281,27,17,13,43,132,581,602,0,0
3280,528,149,571,281,27,17,13,43,132,582,602,0,0
3281,529,149,572,281,27,17,13,43,132,583,602,0,0
3282,529,149,572,281,27,17,13,43,132,584,602,0,0
3283,529,149,572,282,27,17,13,43,133,585,602,0,0
3284,529,148,572,282,27,17,13,43,134,586,602,0,0
3285,529,148,572,282,27,17,13,43,134,587,602,0,0
3286,529,148,572,282,27,17,13,43,134,588,602,0,0
3287,529,148,572,282,27,17,13,43,134,589,602,0,0
3288,529,149,572,282,27,17,13,43,133,590,602,0,0
3289,528,147,572,281,27,17,13,44,134,591,602,0,0
3290,529,149,572,281,27,17,13,43,132,592,602,0,0
3291,529,151,572,280,27,17,13,43,129,593,602,0,0
3292,529,152,571,280,27,17,13,42,128,594,602,0,0
3293,528,151,571,281,27,17,13,43,130,595,602,0,0
3294,527,153,569,281,27,17,13,42,128,596,602,0,0
3295,527,155,569,281,27,17,13,42,126,597,602,0,0
3296,529,153,572,281,27,17,13,43,128,598,602,0,0
3297,530,149,575,283,27,17,13,45,134,599,602,0,0
3298,529,141,579,287,27,17,13,50,146,600,602,0,0
3299,532,148,578,284,27,17,13,46,136,601,602,0,0
3300,532,148,579,284,27,17,13,47,136,602,602,1,0
3311,534,163,575,285,27,17,13,41,122,0,602,0,0
3312,534,163,575,285,27,17,13,41,122,1,602,0,0
3313,534,164,576,284,27,17,13,42,120,2,602,0,0
3314,534,164,576,284,27,17,13,42,120,3,602,0,0
3315,534,164,576,284,27,17,13,42,120,4,602,0,0
3316,535,165,576,283,27,17,13,41,118,5,602,0,0
3322,535,166,575,282,27,17,13,40,116,0,602,0,0
3323,535,166,575,281,27,17,13,40,115,1,602,0,0
3343,534,141,588,292,27,17,13,54,151,0,602,0,1
3344,533,145,584,291,27,17,13,51,146,1,602,0,0
3345,533,148,580,286,27,17,13,47,138,2,602,0,0
3346,533,151,577,284,27,17,13,44,133,3,602,0,0
3347,534,153,576,283,27,17,13,42,130,4,602,0,0
3348,534,155,574,282,27,17,13,40,127,5,602,0,0
3349,535,154,574,281,27,17,13,39,127,6,602,0,0
3350,535,152,573,281,27,17,13,38,129,7,602,0,0
3351,536,153,574,282,27,17,13,38,129,8,602,0,0
3352,537,153,575,283,27,17,13,38,130,9,602,0,0
3353,537,154,575,283,27,17,13,38,129,10,602,0,0
3354,538,154,575,282,27,17,13,37,128,11,602,0,0
3355,537,155,574,282,27,17,13,37,127,12,602,0,0
3356,539,156,575,283,27,17,13,36,127,13,602,0,0
3357,538,158,573,282,27,17,13,35,124,14,602,0,0
3358,537,159,572,282,27,17,13,35,123,15,602,0,0
3359,537,156,573,282,27,17,13,36,126,16,602,0,0
3360,537,152,574,282,27,17,13,37,130,17,602,0,0
3361,538,150,577,286,27,17,13,39,136,18,602,0,0
3362,537,153,577,286,27,17,13,40,133,19,602,0,0
3363,537,153,577,287,27,17,13,40,134,20,602,0,0
3386,536,155,580,295,27,17,13,44,140,0,602,0,1
3387,535,153,579,289,27,17,13,44,136,1,602,0,0
3388,531,151,576,288,27,17,13,45,137,2,602,0,0
3389,528,150,573,285,27,17,13,45,135,3,602,0,0
3390,526,153,569,284,27,17,13,43,131,4,602,0,0
3391,524,151,569,283,27,17,13,45,132,5,602,0,0
3392,523,152,567,283,27,17,13,44,131,6,602,0,0
3393,522,153,565,282,27,17,13,43,129,7,602,0,0
3394,521,150,566,286,27,17,13,45,136,8,602,0,0
3395,520,151,565,286,27,17,13,45,135,9,602,0,0
3396,520,155,564,284,27,17,13,44,129,10,602,0,0
3397,520,157,563,283,27,17,13,43,126,11,602,0,0
3398,520,155,564,284,27,17,13,44,129,12,602,0,0
3399,520,155,563,284,27,17,13,43,129,13,602,0,0
3400,521,154,564,283,27,17,13,43,129,14,602,0,0
3401,520,153,564,284,27,17,13,44,131,15,602,0,0
3402,520,153,564,285,27,17,13,44,132,16,602,0,0
3403,521,152,565,285,27,17,13,44,133,17,602,0,0
3404,520,152,564,285,27,17,13,44,133,18,602,0,0
3405,520,151,564,285,27,17,13,44,134,19,602,0,0
3406,521,153,564,284,27,17,13,43,131,20,602,0,0
3407,521,154,564,283,27,17,13,43,129,21,602,0,0
3408,521,154,564,283,27,17,13,43,129,22,602,0,0
3409,521,155,564,282,27,17,13,43,127,23,602,0,0
3410,521,157,563,282,27,17,13,42,125,24,602,0,0
3411,521,155,564,284,27,17,13,43,129,25,602,0,0
3412,520,154,564,286,27,17,13,44,132,26,602,0,0
3413,521,154,565,286,27,17,13,44,132,27,602,0,0
3414,521,154,564,286,27,17,13,43,132,28,602,0,0
3415,520,153,565,286,27,17,13,45,133,29,602,0,0
3416,521,153,565,286,27,17,13,44,133,30,602,0,0
3417,521,153,565,286,27,17,13,44,133,31,602,0,0
3418,521,153,565,286,27,17,13,44,133,32,602,0,0
3419,521,153,565,286,27,17,13,44,133,33,602,0,0
3420,521,153,565,286,27,17,13,44,133,34,602,0,0
3421,522,154,565,286,27,17,13,43,132,35,602,0,0
3422,522,154,565,286,27,17,13,43,132,36,602,0,0
3423,522,154,565,287,27,17,13,43,133,37,602,0,0
3424,521,154,565,287,27,17,13,44,133,38,602,0,0
3425,521,154,564,287,27,17,13,43,133,39,602,0,0
3426,520,152,564,286,27,17,13,44,134,40,602,0,0
3427,520,151,564,286,27,17,13,44,135,41,602,0,0
3428,521,151,565,286,27,17,13,44,135,42,602,0,0
3429,521,150,565,286,27,17,13,44,136,43,602,0,0
3430,521,150,565,286,27,17,13,44,136,44,602,0,0
3431,521,153,564,286,27,17,13,43,133,45,602,0,0
3432,521,152,564,286,27,17,13,43,134,46,602,0,0
3433,521,154,563,286,27,17,13,42,132,47,602,0,0
3434,521,156,563,286,27,17,13,42,130,48,602,0,0
3435,522,156,563,285,27,17,13,41,129,49,602,0,0
3436,522,147,565,284,27,17,13,43,137,50,602,0,0
3437,522,145,567,284,27,17,13,45,139,51,602,0,0
3438,522,146,566,284,27,17,13,44,138,52,602,0,0
3439,522,144,566,282,27,17,13,44,138,53,602,0,0
3440,521,147,566,283,27,17,13,45,136,54,602,0,0
3441,520,148,565,285,27,17,13,45,137,55,602,0,0
3442,520,149,565,285,27,17,13,45,136,56,602,0,0
3443,522,150,565,284,27,17,13,43,134,57,602,0,0
3444,522,151,566,284,27,17,13,44,133,58,602,0,0
3445,522,152,565,284,27,17,13,43,132,59,602,0,0
3446,521,149,564,283,27,17,13,43,134,60,602,0,0
3447,520,151,564,283,27,17,13,44,132,61,602,0,0
3448,520,151,564,283,27,17,13,44,132,62,602,0,0
3449,520,151,564,283,27,17,13,44,132,63,602,0,0
3450,521,151,564,283,27,17,13,43,132,64,602,0,0
3451,521,150,565,283,27,17,13,44,133,65,602,0,0
3452,521,149,566,283,27,17,13,45,134,66,602,0,0
3453,521,149,566,283,27,17,13,45,134,67,602,0,0
3454,521,148,566,283,27,17,13,45,135,68,602,0,0
3455,521,148,566,283,27,17,13,45,135,69,602,0,0
3456,521,150,566,284,27,17,13,45,134,70,602,0,0
3457,521,150,566,284,27,17,13,45,134,71,602,0,0
3458,521,151,566,285,27,17,13,45,134,72,602,0,0
3459,522,150,567,285,27,17,13,45,135,73,602,0,0
3460,522,148,567,284,27,17,13,45,136,74,602,0,0
3461,521,148,567,284,27,17,13,46,136,75,602,0,0
3462,521,148,567,284,27,17,13,46,136,76,602,0,0
3463,522,148,567,284,27,17,13,45,136,77,602,0,0
3464,520,147,567,284,27,17,13,47,137,78,602,0,0
3465,520,147,567,286,27,17,13,47,139,79,602,0,0
3466,522,147,567,284,27,17,13,45,137,80,602,0,0
3467,522,147,568,283,27,17,13,46,136,81,602,0,0
3468,522,146,568,283,27,17,13,46,137,82,602,0,0
3469,522,146,568,282,27,17,13,46,136,83,602,0,0
3470,522,146,568,282,27,17,13,46,136,84,602,0,0
3471,522,146,568,282,27,17,13,46,136,85,602,0,0
3472,522,146,568,282,27,17,13,46,136,86,602,0,0
3473,522,145,568,283,27,17,13,46,138,87,602,0,0
3474,522,146,568,283,27,17,13,46,137,88,602,0,0
3475,522,146,568,283,27,17,13,46,137,89,602,0,0
3476,521,148,567,283,27,17,13,46,135,90,602,0,0
3477,522,149,567,283,27,17,13,45,134,91,602,0,0
3478,522,149,567,283,27,17,13,45,134,92,602,0,0
3479,521,150,566,282,27,17,13,45,132,93,602,0,0
3480,521,150,566,282,27,17,13,45,132,94,602,0,0
3481,520,149,566,284,27,17,13,46,135,95,602,0,0
3482,520,149,566,284,27,17,13,46,135,96,602,0,0
3483,520,149,565,284,27,17,13,45,135,97,602,0,0
3484,521,150,565,285,27,17,13,44,135,98,602,0,0
3485,521,150,565,285,27,17,13,44,135,99,602,0,0
3486,521,149,566,284,27,17,13,45,135,100,602,0,0
3487,521,148,566,284,27,17,13,45,136,101,602,0,0
3488,521,148,566,284,27,17,13,45,136,102,602,0,0
3489,521,148,566,284,27,17,13,45,136,103,602,0,0
3490,521,147,566,284,27,17,13,45,137,104,602,0,0
3491,521,151,564,283,27,17,13,43,132,105,602,0,0
3492,521,153,563,283,27,17,13,42,130,106,602,0,0
3493,521,153,563,283,27,17,13,42,130,107,602,0,0
3494,521,154,563,284,27,17,13,42,130,108,602,0,0
3495,521,154,563,284,27,17,13,42,130,109,602,0,0
3496,521,150,565,284,27,17,13,44,134,110,602,0,0
3497,522,148,565,283,27,17,13,43,135,111,602,0,0
3498,522,148,565,283,27,17,13,43,135,112,602,0,0
3499,522,147,565,282,27,17,13,43,135,113,602,0,0
3500,522,148,565,282,27,17,13,43,134,114,602,0,0
3501,522,155,564,283,27,17,13,42,128,115,602,0,0
3502,521,158,562,281,27,17,13,41,123,116,602,0,0
3503,520,157,561,282,27,17,13,41,125,117,602,0,0
3504,522,150,567,284,27,17,13,45,134,118,602,0,0
3505,525,151,572,287,27,17,13,47,136,119,602,0,0
3506,529,149,579,293,27,17,13,50,144,120,602,0,0
3507,534,149,587,298,27,17,13,53,149,121,602,0,0
3508,541,150,592,293,27,17,13,51,143,122,602,0,0
3509,542,154,592,294,27,17,13,50,140,123,602,0,0
3510,543,154,592,293,27,17,13,49,139,124,602,0,0
3511,544,151,593,290,27,17,13,49,139,125,602,0,0
3512,544,150,594,290,27,17,13,50,140,126,602,0,0
3513,542,149,592,290,27,17,13,50,141,127,602,0,0
3514,541,154,588,291,27,17,13,47,137,128,602,0,0
3515,540,155,586,291,27,17,13,46,136,129,602,0,0
3516,538,156,583,289,27,17,13,45,133,130,602,0,0
3517,536,152,582,290,27,17,13,46,138,131,602,0,0
3518,535,154,578,288,27,17,13,43,134,132,602,0,0
3519,534,155,576,285,27,17,13,42,130,133,602,0,0
3520,534,153,576,285,27,17,13,42,132,134,602,0,0
3521,535,155,577,287,27,17,13,42,132,135,602,0,0
3522,538,159,578,286,27,17,13,40,127,136,602,0,0
3523,538,157,579,288,27,17,13,41,131,137,602,0,0
3524,538,159,579,287,27,17,13,41,128,138,602,0,0
3525,539,160,579,287,27,17,13,40,127,139,602,0,0
3526,540,160,580,287,27,17,13,40,127,140,602,0,0
3527,540,158,581,291,27,17,13,41,133,141,602,0,0
3528,537,156,580,294,27,17,13,43,138,142,602,0,0
3529,536,154,577,291,27,17,13,41,137,143,602,0,0
3530,535,156,575,291,27,17,13,40,135,144,602,0,0
3531,535,152,575,289,27,17,13,40,137,145,602,0,0
3532,534,151,574,289,27,17,13,40,138,146,602,0,0
3533,535,150,574,286,27,17,13,39,136,147,602,0,0
3534,535,149,574,288,27,17,13,39,139,148,602,0,0
3535,534,148,573,288,27,17,13,39,140,149,602,0,0
3536,534,147,573,290,27,17,13,39,143,150,602,0,0
3537,534,146,573,291,27,17,13,39,145,151,602,0,0
3538,535,148,572,290,27,17,13,37,142,152,602,0,0
3539,535,152,572,290,27,17,13,37,138,153,602,0,0
3540,536,149,574,290,27,17,13,38,141,154,602,0,0
3541,536,148,573,291,27,17,13,37,143,155,602,0,0
3542,536,147,574,292,27,17,13,38,145,156,602,0,0
3543,536,145,576,294,27,17,13,40,149,157,602,0,0
3544,537,145,576,295,27,17,13,39,150,158,602,0,0
3545,537,145,576,295,27,17,13,39,150,159,602,0,0
3546,537,148,576,294,27,17,13,39,146,160,602,0,0
3547,537,150,575,294,27,17,13,38,144,161,602,0,0
3548,537,150,575,293,27,17,13,38,143,162,602,0,0
3549,536,151,574,293,27,17,13,38,142,163,602,0,0
3550,536,151,574,293,27,17,13,38,142,164,602,0,0
3559,565,147,603,292,27,17,13,38,145,0,602,0,1
3560,569,149,606,287,27,17,13,37,138,1,602,0,0
3561,550,145,591,291,27,17,13,41,146,2,602,0,0
3562,543,144,585,292,27,17,13,42,148,3,602,0,0
3563,540,144,583,292,27,17,13,43,148,4,602,0,0
3564,539,144,582,292,27,17,13,43,148,5,602,0,0
3565,538,144,581,293,27,17,13,43,149,6,602,0,0
3566,537,142,582,293,27,17,13,45,151,7,602,0,0
3567,537,142,581,292,27,17,13,44,150,8,602,0,0
3568,537,139,583,292,27,17,13,46,153,9,602,0,0
3569,538,139,585,294,27,17,13,47,155,10,602,0,0
3570,538,139,586,294,27,17,13,48,155,11,602,0,0
3571,537,142,584,293,27,17,13,47,151,12,602,0,0
3572,535,143,582,293,27,17,13,47,150,13,602,0,0
3573,534,143,581,294,27,17,13,47,151,14,602,0,0
3574,534,143,580,293,27,17,13,46,150,15,602,0,0
3575,533,145,578,292,27,17,13,45,147,16,602,0,0
3576,533,145,577,292,27,17,13,44,147,17,602,0,0
3577,533,143,578,293,27,17,13,45,150,18,602,0,0
3578,534,142,580,294,27,17,13,46,152,19,602,0,0
3579,537,143,583,294,27,17,13,46,151,20,602,0,0
3580,537,145,583,293,27,17,13,46,148,21,602,0,0
3581,538,146,584,291,27,17,13,46,145,22,602,0,0
3582,537,145,584,291,27,17,13,47,146,23,602,0,0
3583,538,143,586,293,27,17,13,48,150,24,602,0,0
3584,537,145,585,292,27,17,13,48,147,25,602,0,0
3585,536,147,583,291,27,17,13,47,144,26,602,0,0
3586,537,145,586,292,27,17,13,49,147,27,602,0,0
3587,537,143,588,292,27,17,13,51,149,28,602,0,0
3588,538,143,588,292,27,17,13,50,149,29,602,0,0
3589,536,141,588,292,27,17,13,52,151,30,602,0,0
3590,536,141,587,292,27,17,13,51,151,31,602,0,0
3591,536,141,587,292,27,17,13,51,151,32,602,0,0
3592,536,141,587,292,27,17,13,51,151,33,602,0,0
3593,535,142,586,291,27,17,13,51,149,34,602,0,0
3594,535,142,585,291,27,17,13,50,149,35,602,0,0
3595,535,141,586,292,27,17,13,51,151,36,602,0,0
3596,535,142,585,292,27,17,13,50,150,37,602,0,0
3597,533,143,582,292,27,17,13,49,149,38,602,0,0
3598,532,143,580,292,27,17,13,48,149,39,602,0,0
3599,536,143,584,292,27,17,13,48,149,40,602,0,0
3600,534,145,581,292,27,17,13,47,147,41,602,0,0
3601,533,147,579,291,27,17,13,46,144,42,602,0,0
3602,534,149,578,290,27,17,13,44,141,43,602,0,0
3603,534,148,578,290,27,17,13,44,142,44,602,0,0
3604,534,148,578,291,27,17,13,44,143,45,602,0,0
3605,534,148,577,291,27,17,13,43,143,46,602,0,0
3606,537,147,582,293,27,17,13,45,146,47,602,0,0
3607,536,146,581,292,27,17,13,45,146,48,602,0,0
3608,537,145,583,292,27,17,13,46,147,49,602,0,0
3609,537,145,584,292,27,17,13,47,147,50,602,0,0
3610,537,145,584,292,27,17,13,47,147,51,602,0,0
3611,536,142,583,292,27,17,13,47,150,52,602,0,0
3612,536,142,583,292,27,17,13,47,150,53,602,0,0
3613,535,141,583,292,27,17,13,48,151,54,602,0,0
3614,534,142,581,292,27,17,13,47,150,55,602,0,0
3615,536,140,585,294,27,17,13,49,154,56,602,0,0
3616,535,141,585,295,27,17,13,50,154,57,602,0,0
3617,535,142,585,295,27,17,13,50,153,58,602,0,0
3618,537,144,586,293,27,17,13,49,149,59,602,0,0
3619,536,143,586,294,27,17,13,50,151,60,602,0,0
3620,536,142,586,294,27,17,13,50,152,61,602,0,0
3621,536,146,585,293,27,17,13,49,147,62,602,0,0
3622,536,147,585,293,27,17,13,49,146,63,602,0,0
3623,535,147,584,293,27,17,13,49,146,64,602,0,0
3624,535,148,584,293,27,17,13,49,145,65,602,0,0
3625,535,148,584,292,27,17,13,49,144,66,602,0,0
3626,534,149,583,293,27,17,13,49,144,67,602,0,0
3627,534,147,583,293,27,17,13,49,146,68,602,0,0
3628,533,146,583,293,27,17,13,50,147,69,602,0,0
3629,534,148,583,290,27,17,13,49,142,70,602,0,0
3630,545,148,594,290,27,17,13,49,142,71,602,0,0
3631,543,146,594,290,27,17,13,51,144,72,602,0,0
3632,541,146,593,291,27,17,13,52,145,73,602,0,0
3633,539,145,592,291,27,17,13,53,146,74,602,0,0
3634,539,146,593,291,27,17,13,54,145,75,602,0,0
3635,540,142,597,293,27,17,13,57,151,76,602,0,0
3636,541,144,596,291,27,17,13,55,147,77,602,0,0
3637,539,146,594,291,27,17,13,55,145,78,602,0,0
3638,537,145,592,292,27,17,13,55,147,79,602,0,0
3639,536,145,590,292,27,17,13,54,147,80,602,0,0
3640,534,147,587,290,27,17,13,53,143,81,602,0,0
3641,533,145,586,290,27,17,13,53,145,82,602,0,0
3642,533,144,586,291,27,17,13,53,147,83,602,0,0
3643,531,144,582,291,27,17,13,51,147,84,602,0,0
3644,530,143,581,291,27,17,13,51,148,85,602,0,0
3645,532,143,583,291,27,17,13,51,148,86,602,0,0
3646,533,144,583,292,27,17,13,50,148,87,602,0,0
3647,534,146,584,292,27,17,13,50,146,88,602,0,0
3648,533,146,583,292,27,17,13,50,146,89,602,0,0
3649,534,148,582,292,27,17,13,48,144,90,602,0,0
3650,535,149,583,292,27,17,13,48,143,91,602,0,0
3651,535,147,584,292,27,17,13,49,145,92,602,0,0
3652,536,148,585,292,27,17,13,49,144,93,602,0,0
3653,536,147,585,292,27,17,13,49,145,94,602,0,0
3654,535,146,585,293,27,17,13,50,147,95,602,0,0
3655,533,145,584,294,27,17,13,51,149,96,602,0,0
3656,532,143,582,293,27,17,13,50,150,97,602,0,0
3657,531,145,579,291,27,17,13,48,146,98,602,0,0
3658,534,145,583,294,27,17,13,49,149,99,602,0,0
3659,535,147,583,293,27,17,13,48,146,100,602,0,0
3660,535,149,582,293,27,17,13,47,144,101,602,0,0
3661,533,152,580,294,27,17,13,47,142,102,602,0,0
3662,535,155,576,280,27,17,13,41,125,103,602,0,0
3663,534,156,578,289,27,17,13,44,133,104,602,0,0
3664,539,159,584,292,27,17,13,45,133,105,602,0,0
3665,539,153,589,297,27,17,13,50,144,106,602,0,0
3666,542,145,595,296,27,17,13,53,151,107,602,0,0
3667,538,154,586,289,27,17,13,48,135,108,602,0,0
3668,534,154,582,290,27,17,13,48,136,109,602,0,0
3669,533,155,581,291,27,17,13,48,136,110,602,0,0
3670,533,153,581,291,27,17,13,48,138,111,602,0,0
3671,533,155,579,290,27,17,13,46,135,112,602,0,0
3672,533,155,579,289,27,17,13,46,134,113,602,0,0
3673,532,153,579,291,27,17,13,47,138,114,602,0,0
3674,532,153,579,290,27,17,13,47,137,115,602,0,0
3675,533,153,579,290,27,17,13,46,137,116,602,0,0
3676,533,148,581,291,27,17,13,48,143,117,602,0,0
3677,533,146,582,293,27,17,13,49,147,118,602,0,0
3678,533,146,582,295,27,17,13,49,149,119,602,0,0
3679,534,145,583,293,27,17,13,49,148,120,602,0,0
3680,533,141,583,293,27,17,13,50,152,121,602,0,0
3681,532,142,581,290,27,17,13,49,148,122,602,0,0
3682,531,142,580,289,27,17,13,49,147,123,602,0,0
3683,529,147,575,285,27,17,13,46,138,124,602,0,0
3684,525,149,571,286,27,17,13,46,137,125,602,0,0
3685,519,148,567,286,27,17,13,48,138,126,602,0,0
3686,514,143,562,287,27,17,13,48,144,127,602,0,0
3687,509,144,556,287,27,17,13,47,143,128,602,0,0
3688,507,144,553,285,27,17,13,46,141,129,602,0,0
3689,502,143,549,287,27,17,13,47,144,130,602,0,0
3690,499,142,546,289,27,17,13,47,147,131,602,0,0
3691,497,141,544,290,27,17,13,47,149,132,602,0,0
3692,496,140,543,290,27,17,13,47,150,133,602,0,0
3693,497,141,542,289,27,17,13,45,148,134,602,0,0
3694,497,141,542,289,27,17,13,45,148,135,602,0,0
3695,498,141,543,289,27,17,13,45,148,136,602,0,0
3696,499,140,543,289,27,17,13,44,149,137,602,0,0
3697,499,140,543,289,27,17,13,44,149,138,602,0,0
3698,499,140,543,289,27,17,13,44,149,139,602,0,0
3699,500,140,543,290,27,17,13,43,150,140,602,0,0
3700,500,140,544,290,27,17,13,44,150,141,602,0,0
3701,500,140,543,288,27,17,13,43,148,142,602,0,0
3702,501,140,543,288,27,17,13,42,148,143,602,0,0
3703,501,139,543,288,27,17,13,42,149,144,602,0,0
3704,501,141,543,288,27,17,13,42,147,145,602,0,0
3705,501,141,543,288,27,17,13,42,147,146,602,0,0
3706,501,141,544,288,27,17,13,43,147,147,602,0,0
3707,502,141,544,288,27,17,13,42,147,148,602,0,0
3708,502,141,544,287,27,17,13,42,146,149,602,0,0
3709,502,141,544,287,27,17,13,42,146,150,602,0,0
3710,502,142,544,287,27,17,13,42,145,151,602,0,0
3711,502,143,544,287,27,17,13,42,144,152,602,0,0
3712,502,144,544,287,27,17,13,42,143,153,602,0,0
3713,502,144,544,287,27,17,13,42,143,154,602,0,0
3714,501,145,543,287,27,17,13,42,142,155,602,0,0
3715,502,145,544,287,27,17,13,42,142,156,602,0,0
3716,501,144,544,288,27,17,13,43,144,157,602,0,0
3717,501,144,544,288,27,17,13,43,144,158,602,0,0
3718,501,145,544,288,27,17,13,43,143,159,602,0,0
3719,501,145,544,289,27,17,13,43,144,160,602,0,0
3720,501,145,544,289,27,17,13,43,144,161,602,0,0
3721,501,144,545,288,27,17,13,44,144,162,602,0,0
3722,502,144,545,288,27,17,13,43,144,163,602,0,0
3723,502,144,545,288,27,17,13,43,144,164,602,0,0
3724,502,144,545,288,27,17,13,43,144,165,602,0,0
3725,502,144,545,287,27,17,13,43,143,166,602,0,0
3726,501,144,545,289,27,17,13,44,145,167,602,0,0
3727,501,144,545,289,27,17,13,44,145,168,602,0,0
3728,501,144,545,289,27,17,13,44,145,169,602,0,0
3729,501,144,545,289,27,17,13,44,145,170,602,0,0
3730,501,143,545,290,27,17,13,44,147,171,602,0,0
3731,501,143,545,288,27,17,13,44,145,172,602,0,0
3732,501,143,545,288,27,17,13,44,145,173,602,0,0
3733,501,143,545,288,27,17,13,44,145,174,602,0,0
3734,501,143,545,288,27,17,13,44,145,175,602,0,0
3735,502,143,545,288,27,17,13,43,145,176,602,0,0
3736,502,143,545,288,27,17,13,43,145,177,602,0,0
3737,502,143,545,288,27,17,13,43,145,178,602,0,0
3738,502,143,545,288,27,17,13,43,145,179,602,0,0
3739,502,143,545,288,27,17,13,43,145,180,602,0,0
3740,502,143,545,288,27,17,13,43,145,181,602,0,0
3741,502,144,545,288,27,17,13,43,144,182,602,0,0
3742,502,144,545,288,27,17,13,43,144,183,602,0,0
3743,502,144,545,289,27,17,13,43,145,184,602,0,0
3744,502,145,546,289,27,17,13,44,144,185,602,0,0
3745,503,145,545,289,27,17,13,42,144,186,602,0,0
3746,503,145,545,287,27,17,13,42,142,187,602,0,0
3747,503,146,546,287,27,17,13,43,141,188,602,0,0
3748,503,146,545,287,27,17,13,42,141,189,602,0,0
3749,503,146,546,286,27,17,13,43,140,190,602,0,0
3750,503,146,546,286,27,17,13,43,140,191,602,0,0
3751,502,146,545,287,27,17,13,43,141,192,602,0,0
3752,502,146,545,287,27,17,13,43,141,193,602,0,0
3753,501,145,545,287,27,17,13,44,142,194,602,0,0
3754,501,145,545,287,27,17,13,44,142,195,602,0,0
3755,501,145,545,287,27,17,13,44,142,196,602,0,0
3756,501,144,545,288,27,17,13,44,144,197,602,0,0
3757,501,144,545,288,27,17,13,44,144,198,602,0,0
3758,501,143,545,288,27,17,13,44,145,199,602,0,0
3759,500,143,545,288,27,17,13,45,145,200,602,0,0
3760,500,144,545,288,27,17,13,45,144,201,602,0,0
3761,501,147,544,287,27,17,13,43,140,202,602,0,0
3762,503,149,546,288,27,17,13,43,139,203,602,0,0
3763,507,153,551,290,27,17,13,44,137,204,602,0,0
3764,511,152,558,292,27,17,13,47,140,205,602,0,0
3765,523,153,571,290,27,17,13,48,137,206,602,0,0
3766,525,153,573,291,27,17,13,48,138,207,602,0,0
3781,562,147,605,284,27,17,13,43,137,0,602,0,0
3782,563,145,604,285,27,17,13,41,140,1,602,0,0
3783,565,145,606,285,27,17,13,41,140,2,602,0,0
2680,541,193,581,286,28,17,13,40,93,0,0,0,0
2683,543,187,583,302,29,17,13,40,115,0,0,0,0
2694,575,151,610,293,30,17,13,35,142,0,1,0,0
2695,572,148,608,296,30,17,13,36,148,1,1,0,0
2698,559,181,600,300,31,17,13,41,119,0,0,0,0
2713,534,173,577,293,33,17,13,43,120,0,1,0,0
2714,530,161,577,292,33,17,13,47,131,1,1,0,0
2714,561,171,597,293,34,17,13,36,122,0,0,0,0
2718,540,145,577,285,36,17,13,37,140,0,91,0,0
2719,540,135,581,291,36,17,13,41,156,1,91,0,0
2720,544,156,579,290,36,17,13,35,134,2,91,0,0
2727,548,154,587,295,36,17,13,39,141,0,91,0,1
2728,549,151,589,295,36,17,13,40,144,1,91,0,0
2729,550,152,591,297,36,17,13,41,145,2,91,0,0
2730,552,151,594,296,36,17,13,42,145,3,91,0,0
2731,553,149,597,295,36,17,13,44,146,4,91,0,0
2732,553,149,598,297,36,17,13,45,148,5,91,0,0
2733,554,150,599,294,36,17,13,45,144,6,91,0,0
2734,554,152,599,293,36,17,13,45,141,7,91,0,0
2735,553,151,599,292,36,17,13,46,141,8,91,0,0
2736,552,151,598,293,36,17,13,46,142,9,91,0,0
2737,551,150,599,293,36,17,13,48,143,10,91,0,0
2738,550,149,599,293,36,17,13,49,144,11,91,0,0
2739,549,157,595,294,36,17,13,46,137,12,91,0,0
2740,547,156,595,295,36,17,13,48,139,13,91,0,0
2741,547,161,593,295,36,17,13,46,134,14,91,0,0
2742,546,171,589,295,36,17,13,43,124,15,91,0,0
2743,544,168,589,297,36,17,13,45,129,16,91,0,0
2744,543,166,589,296,36,17,13,46,130,17,91,0,0
2745,545,175,586,293,36,17,13,41,118,18,91,0,0
2746,546,168,590,293,36,17,13,44,125,19,91,0,0
2747,545,172,589,294,36,17,13,44,122,20,91,0,0
2748,546,167,592,294,36,17,13,46,127,21,91,0,0
2749,546,165,591,292,36,17,13,45,127,22,91,0,0
2750,545,170,590,293,36,17,13,45,123,23,91,0,0
2751,546,168,591,292,36,17,13,45,124,24,91,0,0
2752,546,166,592,292,36,17,13,46,126,25,91,0,0
2753,546,162,594,293,36,17,13,48,131,26,91,0,0
2754,546,160,596,294,36,17,13,50,134,27,91,0,0
2755,545,163,594,292,36,17,13,49,129,28,91,0,0
2756,546,179,588,290,36,17,13,42,111,29,91,0,0
2757,547,186,586,290,36,17,13,39,104,30,91,0,0
2758,546,188,585,290,36,17,13,39,102,31,91,0,0
2759,545,185,586,295,36,17,13,41,110,32,91,0,0
2760,546,189,585,291,36,17,13,39,102,33,91,0,0
2761,545,182,587,296,36,17,13,42,114,34,91,0,0
2762,545,171,592,293,36,17,13,47,122,35,91,0,0
2763,546,162,595,293,36,17,13,49,131,36,91,0,0
2764,546,159,597,293,36,17,13,51,134,37,91,0,0
2765,546,157,597,292,36,17,13,51,135,38,91,0,0
2766,546,154,599,294,36,17,13,53,140,39,91,0,0
2767,546,154,600,294,36,17,13,54,140,40,91,0,0
2768,546,154,600,294,36,17,13,54,140,41,91,0,0
2769,546,153,600,295,36,17,13,54,142,42,91,0,0
2770,546,153,600,295,36,17,13,54,142,43,91,0,0
2771,548,176,591,287,36,17,13,43,111,44,91,0,0
2772,546,183,587,289,36,17,13,41,106,45,91,0,0
2773,548,188,587,286,36,17,13,39,98,46,91,0,0
2774,548,181,590,285,36,17,13,42,104,47,91,0,0
2775,548,179,591,284,36,17,13,43,105,48,91,0,0
2776,543,164,596,295,36,17,13,53,131,49,91,0,0
2777,541,159,597,299,36,17,13,56,140,50,91,0,0
2778,541,157,597,300,36,17,13,56,143,51,91,0,0
2779,541,157,597,301,36,17,13,56,144,52,91,0,0
2780,543,155,598,297,36,17,13,55,142,53,91,0,0
2781,545,158,596,290,36,17,13,51,132,54,91,0,0
2782,545,173,591,290,36,17,13,46,117,55,91,0,0
2783,545,166,594,291,36,17,13,49,125,56,91,0,0
2784,545,163,595,291,36,17,13,50,128,57,91,0,0
2785,544,175,590,293,36,17,13,46,118,58,91,0,0
2786,545,162,596,293,36,17,13,51,131,59,91,0,0
2787,545,157,599,293,36,17,13,54,136,60,91,0,0
2788,545,154,600,293,36,17,13,55,139,61,91,0,0
2789,546,154,601,293,36,17,13,55,139,62,91,0,0
2790,546,154,601,293,36,17,13,55,139,63,91,0,0
2791,548,155,603,293,36,17,13,55,138,64,91,0,0
2792,548,156,604,293,36,17,13,56,137,65,91,0,0
2793,548,156,604,294,36,17,13,56,138,66,91,0,0
2794,548,157,604,294,36,17,13,56,137,67,91,0,0
2795,548,156,604,294,36,17,13,56,138,68,91,0,0
2796,547,156,603,292,36,17,13,56,136,69,91,0,0
2797,547,156,602,292,36,17,13,55,136,70,91,0,0
2798,547,155,602,292,36,17,13,55,137,71,91,0,0
2799,547,155,602,291,36,17,13,55,136,72,91,0,0
2800,547,155,602,291,36,17,13,55,136,73,91,0,0
2801,547,157,602,293,36,17,13,55,136,74,91,0,0
2802,547,158,602,293,36,17,13,55,135,75,91,0,0
2803,546,159,601,293,36,17,13,55,134,76,91,0,0
2804,546,159,601,294,36,17,13,55,135,77,91,0,0
2805,546,159,601,294,36,17,13,55,135,78,91,0,0
2806,546,160,600,292,36,17,13,54,132,79,91,0,0
2807,546,160,600,292,36,17,13,54,132,80,91,0,0
2808,546,160,600,292,36,17,13,54,132,81,91,0,0
2809,546,160,600,291,36,17,13,54,131,82,91,0,0
2810,546,160,600,291,36,17,13,54,131,83,91,0,0
2811,548,155,603,289,36,17,13,55,134,84,91,0,0
2812,548,153,604,289,36,17,13,56,136,85,91,0,0
2813,547,154,601,288,36,17,13,54,134,86,91,0,0
2814,546,154,601,288,36,17,13,55,134,87,91,0,0
2815,543,169,590,286,36,17,13,47,117,88,91,0,0
2816,542,178,587,291,36,17,13,45,113,89,91,0,0
2817,541,180,584,292,36,17,13,43,112,90,91,0,0
2818,541,182,583,292,36,17,13,42,110,91,91,1,0
2820,536,161,586,298,36,17,13,50,137,0,91,0,0
2821,537,164,584,295,36,17,13,47,131,1,91,0,0
2822,539,171,582,292,36,17,13,43,121,2,91,0,0
2823,537,196,573,293,36,17,13,36,97,3,91,0,0
2825,537,208,572,297,36,17,13,35,89,0,91,0,0
2826,535,203,573,296,36,17,13,38,93,1,91,0,0
2827,535,203,573,294,36,17,13,38,91,2,91,0,0
2828,535,205,572,295,36,17,13,37,90,3,91,0,0
2830,538,205,575,293,36,17,13,37,88,0,91,0,1
2831,539,213,574,295,36,17,13,35,82,1,91,0,0
2832,539,213,575,294,36,17,13,36,81,2,91,0,0
2833,537,206,576,296,36,17,13,39,90,3,91,0,0
2834,535,185,584,297,36,17,13,49,112,4,91,0,0
2835,532,167,590,300,36,17,13,58,133,5,91,0,0
2836,527,157,587,299,36,17,13,60,142,6,91,0,0
2837,530,158,586,297,36,17,13,56,139,7,91,0,0
2838,531,156,584,292,36,17,13,53,136,8,91,0,0
2839,531,153,585,292,36,17,13,54,139,9,91,0,0
2840,533,154,584,292,36,17,13,51,138,10,91,0,0
2841,532,152,583,291,36,17,13,51,139,11,91,0,0
2842,534,149,583,289,36,17,13,49,140,12,91,0,0
2843,534,147,584,288,36,17,13,50,141,13,91,0,0
2844,530,148,580,292,36,17,13,50,144,14,91,0,0
2845,530,146,580,292,36,17,13,50,146,15,91,0,0
2846,529,146,581,300,36,17,13,52,154,16,91,0,0
2847,531,147,582,303,36,17,13,51,156,17,91,0,0
2848,532,147,584,307,36,17,13,52,160,18,91,0,0
2849,536,145,588,306,36,17,13,52,161,19,91,0,0
2850,540,148,591,307,36,17,13,51,159,20,91,0,0
2851,541,156,591,310,36,17,13,50,154,21,91,0,0
2852,541,168,586,308,36,17,13,45,140,22,91,0,0
2853,538,162,584,308,36,17,13,46,146,23,91,0,0
2854,538,158,584,304,36,17,13,46,146,24,91,0,0
2855,539,150,586,304,36,17,13,47,154,25,91,0,0
2856,540,147,589,305,36,17,13,49,158,26,91,0,0
2857,541,145,591,305,36,17,13,50,160,27,91,0,0
2858,538,147,587,305,36,17,13,49,158,28,91,0,0
2859,540,147,589,305,36,17,13,49,158,29,91,0,0
2860,542,144,590,299,36,17,13,48,155,30,91,0,0
2861,543,145,595,306,36,17,13,52,161,31,91,0,0
2862,547,147,599,308,36,17,13,52,161,32,91,0,0
2863,553,150,605,309,36,17,13,52,159,33,91,0,0
2864,546,151,593,297,36,17,13,47,146,34,91,0,0
2865,559,147,607,298,36,17,13,48,151,35,91,0,0
2866,564,148,612,301,36,17,13,48,153,36,91,0,0
2867,566,147,615,302,36,17,13,49,155,37,91,0,0
2868,566,149,615,308,36,17,13,49,159,38,91,0,0
2869,567,151,615,309,36,17,13,48,158,39,91,0,0
2870,569,174,611,311,36,17,13,42,137,40,91,0,0
2871,574,175,612,305,36,17,13,38,130,41,91,0,0
2872,576,177,614,305,36,17,13,38,128,42,91,0,0
2876,575,147,617,296,36,17,13,42,149,0,91,0,0
2877,576,146,618,295,36,17,13,42,149,1,91,0,0
2878,576,147,616,294,36,17,13,40,147,2,91,0,0
2879,577,145,617,294,36,17,13,40,149,3,91,0,0
2896,578,153,613,290,36,17,13,35,137,0,91,0,0
2897,575,156,610,291,36,17,13,35,135,1,91,0,0
2898,571,159,608,299,36,17,13,37,140,2,91,0,0
2899,572,158,609,302,36,17,13,37,144,3,91,0,0
2900,573,156,610,303,36,17,13,37,147,4,91,0,0
2901,575,154,611,299,36,17,13,36,145,5,91,0,0
2902,576,153,612,298,36,17,13,36,145,6,91,0,0
2903,576,153,611,297,36,17,13,35,144,7,91,0,0
2904,576,153,611,297,36,17,13,35,144,8,91,0,0
2905,575,150,611,298,36,17,13,36,148,9,91,0,0
2906,576,151,612,297,36,17,13,36,146,10,91,0,0
2807,264,465,366,1003,37,17,13,102,538,0,24,0,1
2808,302,470,402,988,37,17,13,100,518,1,24,0,0
2809,338,442,446,994,37,17,13,108,552,2,24,0,0
2810,397,424,507,966,37,17,13,110,542,3,24,0,0
2811,440,413,552,942,37,17,13,112,529,4,24,0,0
2812,487,396,602,918,37,17,13,115,522,5,24,0,0
2813,525,383,645,903,37,17,13,120,520,6,24,0,0
2814,554,362,673,851,37,17,13,119,489,7,24,0,0
2815,583,359,698,813,37,17,13,115,454,8,24,0,0
2816,614,344,727,771,37,17,13,113,427,9,24,0,0
2817,637,334,751,749,37,17,13,114,415,10,24,0,0
2818,654,329,769,734,37,17,13,115,405,11,24,0,0
2819,672,318,780,688,37,17,13,108,370,12,24,0,0
2820,686,314,794,673,37,17,13,108,359,13,24,0,0
2821,708,304,814,643,37,17,13,106,339,14,24,0,0
2822,724,297,831,631,37,17,13,107,334,15,24,0,0
2823,735,292,843,623,37,17,13,108,331,16,24,0,0
2824,751,283,856,599,37,17,13,105,316,17,24,0,0
2825,767,282,869,585,37,17,13,102,303,18,24,0,0
2826,791,277,891,567,37,17,13,100,290,19,24,0,0
2827,812,274,912,560,37,17,13,100,286,20,24,0,0
2828,832,274,930,552,37,17,13,98,278,21,24,0,0
2829,852,270,942,531,37,17,13,90,261,22,24,0,0
2830,868,302,942,521,37,17,13,74,219,23,24,0,0
2831,888,302,957,504,37,17,13,69,202,24,24,1,0
2840,562,158,598,294,38,17,13,36,136,0,23,0,0
2841,563,152,600,293,38,17,13,37,141,1,23,0,0
2842,561,147,600,297,38,17,13,39,150,2,23,0,0
2843,559,149,596,292,38,17,13,37,143,3,23,0,0
2844,558,147,596,297,38,17,13,38,150,4,23,0,0
2845,558,148,594,294,38,17,13,36,146,5,23,0,0
2846,559,145,595,291,38,17,13,36,146,6,23,0,0
2848,564,144,600,298,38,17,13,36,154,0,23,0,0
2849,564,142,601,298,38,17,13,37,156,1,23,0,0
2873,539,169,575,300,38,17,13,36,131,0,23,0,1
2874,537,165,576,302,38,17,13,39,137,1,23,0,0
2875,536,164,576,302,38,17,13,40,138,2,23,0,0
2876,538,169,577,301,38,17,13,39,132,3,23,0,0
2877,539,172,577,299,38,17,13,38,127,4,23,0,0
2878,540,173,577,299,38,17,13,37,126,5,23,0,0
2879,540,175,577,299,38,17,13,37,124,6,23,0,0
2880,540,174,578,299,38,17,13,38,125,7,23,0,0
2881,540,177,577,297,38,17,13,37,120,8,23,0,0
2882,540,178,577,297,38,17,13,37,119,9,23,0,0
2883,540,179,577,297,38,17,13,37,118,10,23,0,0
2884,540,179,578,297,38,17,13,38,118,11,23,0,0
2885,540,180,578,298,38,17,13,38,118,12,23,0,0
2886,539,173,579,299,38,17,13,40,126,13,23,0,0
2887,538,171,580,299,38,17,13,42,128,14,23,0,0
2888,538,171,580,299,38,17,13,42,128,15,23,0,0
2889,538,170,580,299,38,17,13,42,129,16,23,0,0
2890,538,169,580,299,38,17,13,42,130,17,23,0,0
2891,538,167,581,299,38,17,13,43,132,18,23,0,0
2892,539,168,581,298,38,17,13,42,130,19,23,0,0
2893,538,165,580,298,38,17,13,42,133,20,23,0,0
2894,537,167,578,299,38,17,13,41,132,21,23,0,0
2895,540,173,577,294,38,17,13,37,121,22,23,0,0
2896,539,173,577,294,38,17,13,38,121,23,23,1,0
2916,570,185,605,295,38,17,13,35,110,0,23,0,0
2917,573,177,610,297,38,17,13,37,120,1,23,0,0
2918,576,172,613,299,38,17,13,37,127,2,23,0,0
2919,577,171,615,299,38,17,13,38,128,3,23,0,0
2924,583,156,618,281,38,17,13,35,125,0,23,0,0
2925,584,155,619,280,38,17,13,35,125,1,23,0,0
2864,567,149,611,293,39,17,13,44,144,0,0,0,0
2946,542,160,577,288,40,17,13,35,128,0,11,0,0
2947,542,159,578,289,40,17,13,36,130,1,11,0,0
2966,541,166,577,284,40,17,13,36,118,0,11,0,0
2967,541,166,577,284,40,17,13,36,118,1,11,0,0
2968,541,166,577,284,40,17,13,36,118,2,11,0,0
2969,541,166,577,283,40,17,13,36,117,3,11,0,0
2970,541,165,578,283,40,17,13,37,118,4,11,0,0
2971,541,168,577,283,40,17,13,36,115,5,11,0,0
2972,541,169,576,283,40,17,13,35,114,6,11,0,0
2974,541,169,576,284,40,17,13,35,115,0,11,0,0
2975,541,169,576,283,40,17,13,35,114,1,11,0,0
2976,541,171,576,286,40,17,13,35,115,2,11,0,0
2977,540,172,576,287,40,17,13,36,115,3,11,0,0
2978,540,173,576,287,40,17,13,36,114,4,11,0,0
2979,540,173,576,288,40,17,13,36,115,5,11,0,0
2980,540,174,575,288,40,17,13,35,114,6,11,0,0
2981,541,173,576,285,40,17,13,35,112,7,11,0,0
2982,541,173,576,284,40,17,13,35,111,8,11,0,0
2983,541,172,576,284,40,17,13,35,112,9,11,0,0
2984,541,172,576,283,40,17,13,35,111,10,11,0,0
2985,540,169,577,285,40,17,13,37,116,11,11,0,0
2991,541,171,577,285,40,17,13,36,114,0,11,0,0
2992,541,169,577,285,40,17,13,36,116,1,11,0,0
2993,541,171,577,285,40,17,13,36,114,2,11,0,0
2994,541,172,577,285,40,17,13,36,113,3,11,0,0
2995,541,170,577,284,40,17,13,36,114,4,11,0,0
2996,541,169,577,282,40,17,13,36,113,5,11,0,0
2997,541,168,577,282,40,17,13,36,114,6,11,0,0
2998,542,171,577,283,40,17,13,35,112,7,11,0,0
2999,542,171,577,283,40,17,13,35,112,8,11,0,0
3072,574,166,612,294,40,17,13,38,128,0,11,0,0
3073,576,166,614,295,40,17,13,38,129,1,11,0,0
3074,575,169,613,298,40,17,13,38,129,2,11,0,0
3075,576,170,612,299,40,17,13,36,129,3,11,0,0
3076,577,170,614,300,40,17,13,37,130,4,11,0,0
3077,575,170,611,298,40,17,13,36,128,5,11,0,0
3078,576,173,611,298,40,17,13,35,125,6,11,0,0
3079,577,173,612,299,40,17,13,35,126,7,11,0,0
3201,579,154,615,284,41,17,13,36,130,0,1,0,0
3202,579,152,616,283,41,17,13,37,131,1,1,0,0
3344,566,127,610,292,42,17,13,44,165,0,19,0,1
3345,566,132,609,294,42,17,13,43,162,1,19,0,0
3346,566,126,611,294,42,17,13,45,168,2,19,0,0
3347,565,126,610,295,42,17,13,45,169,3,19,0,0
3348,564,127,609,296,42,17,13,45,169,4,19,0,0
3349,565,136,607,295,42,17,13,42,159,5,19,0,0
3350,564,140,605,293,42,17,13,41,153,6,19,0,0
3351,564,142,604,292,42,17,13,40,150,7,19,0,0
3352,564,143,604,291,42,17,13,40,148,8,19,0,0
3353,564,142,603,291,42,17,13,39,149,9,19,0,0
3354,563,142,603,291,42,17,13,40,149,10,19,0,0
3355,563,141,603,291,42,17,13,40,150,11,19,0,0
3356,563,142,602,291,42,17,13,39,149,12,19,0,0
3357,562,141,603,291,42,17,13,41,150,13,19,0,0
3358,562,140,603,290,42,17,13,41,150,14,19,0,0
3359,562,139,603,293,42,17,13,41,154,15,19,0,0
3360,562,135,606,295,42,17,13,44,160,16,19,0,0
3361,560,129,608,299,42,17,13,48,170,17,19,0,0
3362,564,138,608,296,42,17,13,44,158,18,19,0,0
3363,564,138,608,297,42,17,13,44,159,19,19,0,0
3393,570,199,605,304,43,17,13,35,105,0,24,0,0
3394,567,181,607,302,43,17,13,40,121,1,24,0,0
3395,566,168,610,301,43,17,13,44,133,2,24,0,0
3396,567,167,610,298,43,17,13,43,131,3,24,0,0
3397,569,177,609,296,43,17,13,40,119,4,24,0,0
3398,572,191,607,295,43,17,13,35,104,5,24,0,0
3402,574,188,609,293,43,17,13,35,105,0,24,0,0
3403,572,187,608,294,43,17,13,36,107,1,24,0,0
3404,572,188,607,293,43,17,13,35,105,2,24,0,0
3411,570,189,607,295,43,17,13,37,106,0,24,0,1
3412,568,176,609,293,43,17,13,41,117,1,24,0,0
3413,568,168,611,292,43,17,13,43,124,2,24,0,0
3414,567,156,613,295,43,17,13,46,139,3,24,0,0
3415,566,153,614,301,43,17,13,48,148,4,24,0,0
3416,566,149,614,301,43,17,13,48,152,5,24,0,0
3417,566,149,614,302,43,17,13,48,153,6,24,0,0
3418,566,150,614,303,43,17,13,48,153,7,24,0,0
3419,567,148,613,302,43,17,13,46,154,8,24,0,0
3420,567,149,613,300,43,17,13,46,151,9,24,0,0
3421,567,152,612,304,43,17,13,45,152,10,24,0,0
3422,567,153,612,306,43,17,13,45,153,11,24,0,0
3423,567,151,612,305,43,17,13,45,154,12,24,0,0
3424,567,153,611,306,43,17,13,44,153,13,24,0,0
3425,567,151,611,305,43,17,13,44,154,14,24,0,0
3426,569,152,611,301,43,17,13,42,149,15,24,0,0
3427,569,153,611,300,43,17,13,42,147,16,24,0,0
3428,569,152,611,300,43,17,13,42,148,17,24,0,0
3429,570,152,612,301,43,17,13,42,149,18,24,0,0
3430,569,152,611,300,43,17,13,42,148,19,24,0,0
3431,569,153,610,301,43,17,13,41,148,20,24,0,0
3432,569,153,610,301,43,17,13,41,148,21,24,0,0
3433,570,152,612,300,43,17,13,42,148,22,24,0,0
3434,569,154,610,299,43,17,13,41,145,23,24,0,0
3435,572,176,607,297,43,17,13,35,121,24,24,1,0
3527,571,156,606,295,45,17,13,35,139,0,322,0,1
3528,570,153,606,295,45,17,13,36,142,1,322,0,0
3529,567,147,605,295,45,17,13,38,148,2,322,0,0
3530,564,143,604,298,45,17,13,40,155,3,322,0,0
3531,562,140,605,301,45,17,13,43,161,4,322,0,0
3532,557,141,601,303,45,17,13,44,162,5,322,0,0
3533,556,142,600,300,45,17,13,44,158,6,322,0,0
3534,560,141,603,298,45,17,13,43,157,7,322,0,0
3535,561,140,604,297,45,17,13,43,157,8,322,0,0
3536,562,142,605,298,45,17,13,43,156,9,322,0,0
3537,561,141,604,298,45,17,13,43,157,10,322,0,0
3538,559,142,603,301,45,17,13,44,159,11,322,0,0
3539,555,145,600,301,45,17,13,45,156,12,322,0,0
3540,558,147,603,300,45,17,13,45,153,13,322,0,0
3541,560,147,605,299,45,17,13,45,152,14,322,0,0
3542,560,148,606,299,45,17,13,46,151,15,322,0,0
3543,561,147,607,300,45,17,13,46,153,16,322,0,0
3544,560,147,607,300,45,17,13,47,153,17,322,0,0
3545,561,145,608,301,45,17,13,47,156,18,322,0,0
3546,562,147,609,302,45,17,13,47,155,19,322,0,0
3547,561,149,608,303,45,17,13,47,154,20,322,0,0
3548,562,151,609,304,45,17,13,47,153,21,322,0,0
3549,556,149,605,306,45,17,13,49,157,22,322,0,0
3550,550,152,599,304,45,17,13,49,152,23,322,0,0
3551,545,150,595,301,45,17,13,50,151,24,322,0,0
3552,544,154,594,298,45,17,13,50,144,25,322,0,0
3553,544,162,593,296,45,17,13,49,134,26,322,0,0
3554,538,161,583,286,45,17,13,45,125,27,322,0,0
3555,536,162,579,284,45,17,13,43,122,28,322,0,0
3556,534,161,579,286,45,17,13,45,125,29,322,0,0
3557,537,159,584,289,45,17,13,47,130,30,322,0,0
3558,538,157,587,291,45,17,13,49,134,31,322,0,0
3559,535,149,587,292,45,17,13,52,143,32,322,0,0
3560,536,145,589,293,45,17,13,53,148,33,322,0,0
3561,553,147,604,291,45,17,13,51,144,34,322,0,0
3562,560,148,609,290,45,17,13,49,142,35,322,0,0
3563,564,149,611,289,45,17,13,47,140,36,322,0,0
3564,565,149,611,289,45,17,13,46,140,37,322,0,0
3565,565,149,611,289,45,17,13,46,140,38,322,0,0
3566,564,147,610,289,45,17,13,46,142,39,322,0,0
3567,566,146,610,287,45,17,13,44,141,40,322,0,0
3568,566,146,609,286,45,17,13,43,140,41,322,0,0
3569,567,148,609,283,45,17,13,42,135,42,322,0,0
3570,568,149,609,282,45,17,13,41,133,43,322,0,0
3571,566,149,608,284,45,17,13,42,135,44,322,0,0
3572,566,148,609,288,45,17,13,43,140,45,322,0,0
3573,566,148,609,290,45,17,13,43,142,46,322,0,0
3574,566,148,610,290,45,17,13,44,142,47,322,0,0
3575,566,148,610,290,45,17,13,44,142,48,322,0,0
3576,565,147,609,290,45,17,13,44,143,49,322,0,0
3577,564,146,608,291,45,17,13,44,145,50,322,0,0
3578,564,145,608,290,45,17,13,44,145,51,322,0,0
3579,564,147,606,289,45,17,13,42,142,52,322,0,0
3580,566,149,607,288,45,17,13,41,139,53,322,0,0
3581,567,149,606,286,45,17,13,39,137,54,322,0,0
3582,568,149,605,286,45,17,13,37,137,55,322,0,0
3583,568,149,604,286,45,17,13,36,137,56,322,0,0
3584,569,150,604,286,45,17,13,35,136,57,322,0,0
3585,569,148,604,287,45,17,13,35,139,58,322,0,0
3586,569,149,604,287,45,17,13,35,138,59,322,0,0
3588,570,147,605,285,45,17,13,35,138,0,322,0,1
3589,569,143,606,287,45,17,13,37,144,1,322,0,0
3590,569,144,605,288,45,17,13,36,144,2,322,0,0
3591,571,145,606,287,45,17,13,35,142,3,322,0,0
3592,570,147,606,287,45,17,13,36,140,4,322,0,0
3593,570,147,606,287,45,17,13,36,140,5,322,0,0
3594,567,143,605,290,45,17,13,38,147,6,322,0,0
3595,569,147,605,288,45,17,13,36,141,7,322,0,0
3596,568,147,605,289,45,17,13,37,142,8,322,0,0
3597,566,144,604,293,45,17,13,38,149,9,322,0,0
3598,566,142,604,293,45,17,13,38,151,10,322,0,0
3599,567,146,604,290,45,17,13,37,144,11,322,0,0
3600,566,148,603,290,45,17,13,37,142,12,322,0,0
3601,565,149,604,292,45,17,13,39,143,13,322,0,0
3602,566,149,606,292,45,17,13,40,143,14,322,0,0
3603,565,149,606,292,45,17,13,41,143,15,322,0,0
3604,565,150,606,293,45,17,13,41,143,16,322,0,0
3605,563,149,606,294,45,17,13,43,145,17,322,0,0
3606,565,149,607,291,45,17,13,42,142,18,322,0,0
3607,565,148,607,289,45,17,13,42,141,19,322,0,0
3608,566,149,607,288,45,17,13,41,139,20,322,0,0
3609,567,149,608,288,45,17,13,41,139,21,322,0,0
3610,567,149,608,287,45,17,13,41,138,22,322,0,0
3611,569,149,609,288,45,17,13,40,139,23,322,0,0
3612,570,149,610,289,45,17,13,40,140,24,322,0,0
3613,567,147,608,291,45,17,13,41,144,25,322,0,0
3614,565,147,607,290,45,17,13,42,143,26,322,0,0
3615,565,147,607,290,45,17,13,42,143,27,322,0,0
3616,565,149,606,288,45,17,13,41,139,28,322,0,0
3617,565,150,606,288,45,17,13,41,138,29,322,0,0
3618,567,150,606,285,45,17,13,39,135,30,322,0,0
3619,565,150,606,287,45,17,13,41,137,31,322,0,0
3620,566,150,606,285,45,17,13,40,135,32,322,0,0
3621,565,151,606,285,45,17,13,41,134,33,322,0,0
3622,565,151,605,285,45,17,13,40,134,34,322,0,0
3623,564,150,606,289,45,17,13,42,139,35,322,0,0
3624,563,149,607,290,45,17,13,44,141,36,322,0,0
3625,563,149,607,290,45,17,13,44,141,37,322,0,0
3626,563,149,607,288,45,17,13,44,139,38,322,0,0
3627,563,149,607,288,45,17,13,44,139,39,322,0,0
3628,563,149,607,288,45,17,13,44,139,40,322,0,0
3629,563,149,607,288,45,17,13,44,139,41,322,0,0
3638,565,147,608,287,45,17,13,43,140,0,322,0,1
3639,567,148,608,285,45,17,13,41,137,1,322,0,0
3640,568,148,608,285,45,17,13,40,137,2,322,0,0
3641,567,146,609,288,45,17,13,42,142,3,322,0,0
3642,567,144,608,290,45,17,13,41,146,4,322,0,0
3643,566,146,607,289,45,17,13,41,143,5,322,0,0
3644,565,148,606,291,45,17,13,41,143,6,322,0,0
3645,565,148,606,289,45,17,13,41,141,7,322,0,0
3646,565,151,605,288,45,17,13,40,137,8,322,0,0
3647,564,152,605,287,45,17,13,41,135,9,322,0,0
3648,563,152,605,287,45,17,13,42,135,10,322,0,0
3649,563,154,605,290,45,17,13,42,136,11,322,0,0
3650,564,155,606,289,45,17,13,42,134,12,322,0,0
3651,565,154,607,288,45,17,13,42,134,13,322,0,0
3652,565,153,607,287,45,17,13,42,134,14,322,0,0
3653,565,153,608,287,45,17,13,43,134,15,322,0,0
3654,564,153,608,291,45,17,13,44,138,16,322,0,0
3655,564,150,609,295,45,17,13,45,145,17,322,0,0
3656,563,149,609,296,45,17,13,46,147,18,322,0,0
3657,561,148,608,299,45,17,13,47,151,19,322,0,0
3658,566,151,609,294,45,17,13,43,143,20,322,0,0
3659,572,161,610,288,45,17,13,38,127,21,322,0,0
3667,565,151,606,293,45,17,13,41,142,0,322,0,0
3668,564,150,606,294,45,17,13,42,144,1,322,0,0
3673,573,157,610,289,45,17,13,37,132,0,322,0,1
3674,574,156,611,288,45,17,13,37,132,1,322,0,0
3675,573,153,610,288,45,17,13,37,135,2,322,0,0
3676,573,148,611,288,45,17,13,38,140,3,322,0,0
3677,572,147,610,288,45,17,13,38,141,4,322,0,0
3678,571,146,609,288,45,17,13,38,142,5,322,0,0
3679,570,147,608,288,45,17,13,38,141,6,322,0,0
3680,570,149,608,288,45,17,13,38,139,7,322,0,0
3681,571,151,608,288,45,17,13,37,137,8,322,0,0
3682,571,152,608,288,45,17,13,37,136,9,322,0,0
3683,570,150,608,290,45,17,13,38,140,10,322,0,0
3684,570,153,608,290,45,17,13,38,137,11,322,0,0
3685,569,155,607,291,45,17,13,38,136,12,322,0,0
3686,568,154,607,291,45,17,13,39,137,13,322,0,0
3687,569,156,608,291,45,17,13,39,135,14,322,0,0
3688,570,157,608,288,45,17,13,38,131,15,322,0,0
3689,572,157,609,286,45,17,13,37,129,16,322,0,0
3690,572,157,609,286,45,17,13,37,129,17,322,0,0
3691,573,158,610,285,45,17,13,37,127,18,322,0,0
3692,573,158,610,285,45,17,13,37,127,19,322,0,0
3693,573,159,609,285,45,17,13,36,126,20,322,0,0
3694,573,159,609,285,45,17,13,36,126,21,322,0,0
3696,572,158,608,286,45,17,13,36,128,0,322,0,1
3697,571,158,608,288,45,17,13,37,130,1,322,0,0
3698,571,159,607,287,45,17,13,36,128,2,322,0,0
3699,571,159,608,288,45,17,13,37,129,3,322,0,0
3700,571,159,608,288,45,17,13,37,129,4,322,0,0
3701,571,158,608,287,45,17,13,37,129,5,322,0,0
3702,570,156,607,285,45,17,13,37,129,6,322,0,0
3703,571,154,608,284,45,17,13,37,130,7,322,0,0
3704,571,150,609,284,45,17,13,38,134,8,322,0,0
3705,567,149,607,288,45,17,13,40,139,9,322,0,0
3706,563,148,605,290,45,17,13,42,142,10,322,0,0
3707,561,148,605,290,45,17,13,44,142,11,322,0,0
3708,559,147,604,291,45,17,13,45,144,12,322,0,0
3709,559,148,604,291,45,17,13,45,143,13,322,0,0
3710,558,147,605,291,45,17,13,47,144,14,322,0,0
3711,556,147,604,291,45,17,13,48,144,15,322,0,0
3712,555,148,604,292,45,17,13,49,144,16,322,0,0
3713,555,149,605,292,45,17,13,50,143,17,322,0,0
3714,553,148,604,293,45,17,13,51,145,18,322,0,0
3715,554,149,605,292,45,17,13,51,143,19,322,0,0
3716,553,149,605,292,45,17,13,52,143,20,322,0,0
3717,556,148,607,292,45,17,13,51,144,21,322,0,0
3718,555,148,608,292,45,17,13,53,144,22,322,0,0
3719,557,149,609,292,45,17,13,52,143,23,322,0,0
3720,558,150,610,292,45,17,13,52,142,24,322,0,0
3721,559,152,610,290,45,17,13,51,138,25,322,0,0
3722,560,152,610,290,45,17,13,50,138,26,322,0,0
3723,560,153,610,290,45,17,13,50,137,27,322,0,0
3724,560,152,610,289,45,17,13,50,137,28,322,0,0
3725,561,152,610,289,45,17,13,49,137,29,322,0,0
3726,560,152,610,291,45,17,13,50,139,30,322,0,0
3727,559,152,609,291,45,17,13,50,139,31,322,0,0
3728,558,153,607,291,45,17,13,49,138,32,322,0,0
3729,557,153,608,292,45,17,13,51,139,33,322,0,0
3730,558,154,607,290,45,17,13,49,136,34,322,0,0
3731,554,153,605,292,45,17,13,51,139,35,322,0,0
3732,556,155,607,292,45,17,13,51,137,36,322,0,0
3733,553,152,606,293,45,17,13,53,141,37,322,0,0
3734,555,156,606,291,45,17,13,51,135,38,322,0,0
3735,554,154,607,291,45,17,13,53,137,39,322,0,0
3736,553,154,607,292,45,17,13,54,138,40,322,0,0
3737,551,154,606,293,45,17,13,55,139,41,322,0,0
3738,551,152,607,293,45,17,13,56,141,42,322,0,0
3739,550,152,607,294,45,17,13,57,142,43,322,0,0
3740,551,152,607,294,45,17,13,56,142,44,322,0,0
3741,551,156,605,292,45,17,13,54,136,45,322,0,0
3742,552,159,605,290,45,17,13,53,131,46,322,0,0
3743,552,160,604,290,45,17,13,52,130,47,322,0,0
3744,552,159,604,289,45,17,13,52,130,48,322,0,0
3745,551,158,604,289,45,17,13,53,131,49,322,0,0
3746,553,159,605,288,45,17,13,52,129,50,322,0,0
3747,553,161,605,288,45,17,13,52,127,51,322,0,0
3748,553,159,605,289,45,17,13,52,130,52,322,0,0
3749,552,152,607,291,45,17,13,55,139,53,322,0,0
3750,553,148,609,292,45,17,13,56,144,54,322,0,0
3751,552,146,608,292,45,17,13,56,146,55,322,0,0
3752,552,147,607,292,45,17,13,55,145,56,322,0,0
3753,552,148,605,291,45,17,13,53,143,57,322,0,0
3754,551,148,604,291,45,17,13,53,143,58,322,0,0
3755,551,149,603,291,45,17,13,52,142,59,322,0,0
3756,551,148,604,291,45,17,13,53,143,60,322,0,0
3757,552,147,603,288,45,17,13,51,141,61,322,0,0
3758,552,143,605,288,45,17,13,53,145,62,322,0,0
3759,559,142,612,290,45,17,13,53,148,63,322,0,0
3760,566,144,615,287,45,17,13,49,143,64,322,0,0
3761,569,147,617,287,45,17,13,48,140,65,322,0,0
3762,572,147,618,284,45,17,13,46,137,66,322,0,0
3763,572,148,617,285,45,17,13,45,137,67,322,0,0
3764,569,148,615,288,45,17,13,46,140,68,322,0,0
3765,569,147,614,289,45,17,13,45,142,69,322,0,0
3766,570,147,615,289,45,17,13,45,142,70,322,0,0
3767,553,143,604,294,45,17,13,51,151,71,322,0,0
3768,554,146,605,293,45,17,13,51,147,72,322,0,0
3769,551,146,604,292,45,17,13,53,146,73,322,0,0
3770,551,148,604,295,45,17,13,53,147,74,322,0,0
3771,549,150,602,296,45,17,13,53,146,75,322,0,0
3772,548,153,601,297,45,17,13,53,144,76,322,0,0
3773,547,154,601,298,45,17,13,54,144,77,322,0,0
3774,546,157,600,297,45,17,13,54,140,78,322,0,0
3775,546,158,600,296,45,17,13,54,138,79,322,0,0
3776,546,158,604,302,45,17,13,58,144,80,322,0,0
3777,545,155,605,305,45,17,13,60,150,81,322,0,0
3778,543,156,603,302,45,17,13,60,146,82,322,0,0
3779,541,153,600,300,45,17,13,59,147,83,322,0,0
3780,539,151,598,299,45,17,13,59,148,84,322,0,0
3781,538,155,592,295,45,17,13,54,140,85,322,0,0
3782,537,153,591,297,45,17,13,54,144,86,322,0,0
3783,540,153,592,292,45,17,13,52,139,87,322,0,0
3784,541,152,593,295,45,17,13,52,143,88,322,0,0
3785,542,150,595,295,45,17,13,53,145,89,322,0,0
3786,544,152,596,295,45,17,13,52,143,90,322,0,0
3787,544,154,595,295,45,17,13,51,141,91,322,0,0
3788,544,155,595,294,45,17,13,51,139,92,322,0,0
3789,544,155,594,294,45,17,13,50,139,93,322,0,0
3790,544,156,594,294,45,17,13,50,138,94,322,0,0
3791,544,158,593,294,45,17,13,49,136,95,322,0,0
3792,544,160,592,294,45,17,13,48,134,96,322,0,0
3793,544,159,592,294,45,17,13,48,135,97,322,0,0
3794,545,160,593,294,45,17,13,48,134,98,322,0,0
3795,545,159,593,294,45,17,13,48,135,99,322,0,0
3796,548,158,597,292,45,17,13,49,134,100,322,0,0
3797,549,158,598,292,45,17,13,49,134,101,322,0,0
3798,549,157,598,291,45,17,13,49,134,102,322,0,0
3799,549,157,598,291,45,17,13,49,134,103,322,0,0
3800,549,157,599,291,45,17,13,50,134,104,322,0,0
3801,547,157,597,293,45,17,13,50,136,105,322,0,0
3802,545,159,595,293,45,17,13,50,134,106,322,0,0
3803,545,158,595,293,45,17,13,50,135,107,322,0,0
3804,546,157,596,294,45,17,13,50,137,108,322,0,0
3805,546,157,597,294,45,17,13,51,137,109,322,0,0
3806,546,155,598,294,45,17,13,52,139,110,322,0,0
3807,546,155,598,295,45,17,13,52,140,111,322,0,0
3808,546,155,598,295,45,17,13,52,140,112,322,0,0
3809,546,155,598,295,45,17,13,52,140,113,322,0,0
3810,546,154,598,295,45,17,13,52,141,114,322,0,0
3811,546,153,598,295,45,17,13,52,142,115,322,0,0
3812,545,153,598,295,45,17,13,53,142,116,322,0,0
3813,545,152,598,295,45,17,13,53,143,117,322,0,0
3814,545,152,598,295,45,17,13,53,143,118,322,0,0
3815,546,152,598,295,45,17,13,52,143,119,322,0,0
3816,545,155,597,295,45,17,13,52,140,120,322,0,0
3817,545,156,596,295,45,17,13,51,139,121,322,0,0
3818,545,154,596,295,45,17,13,51,141,122,322,0,0
3819,544,155,596,295,45,17,13,52,140,123,322,0,0
3820,544,155,596,295,45,17,13,52,140,124,322,0,0
3821,544,156,595,293,45,17,13,51,137,125,322,0,0
3822,544,156,594,292,45,17,13,50,136,126,322,0,0
3823,545,157,594,291,45,17,13,49,134,127,322,0,0
3824,544,156,594,292,45,17,13,50,136,128,322,0,0
3825,544,155,594,294,45,17,13,50,139,129,322,0,0
3826,544,154,594,293,45,17,13,50,139,130,322,0,0
3827,544,155,593,293,45,17,13,49,138,131,322,0,0
3828,544,155,593,293,45,17,13,49,138,132,322,0,0
3829,546,153,596,292,45,17,13,50,139,133,322,0,0
3830,546,153,596,292,45,17,13,50,139,134,322,0,0
3831,546,155,594,292,45,17,13,48,137,135,322,0,0
3832,545,155,594,292,45,17,13,49,137,136,322,0,0
3833,545,155,594,292,45,17,13,49,137,137,322,0,0
3834,545,155,594,292,45,17,13,49,137,138,322,0,0
3835,545,156,593,292,45,17,13,48,136,139,322,0,0
3836,545,156,593,291,45,17,13,48,135,140,322,0,0
3837,544,156,591,291,45,17,13,47,135,141,322,0,0
3838,543,156,589,290,45,17,13,46,134,142,322,0,0
3839,541,157,586,290,45,17,13,45,133,143,322,0,0
3840,542,159,586,289,45,17,13,44,130,144,322,0,0
3841,541,155,587,291,45,17,13,46,136,145,322,0,0
3842,542,153,587,291,45,17,13,45,138,146,322,0,0
3843,542,155,586,291,45,17,13,44,136,147,322,0,0
3844,542,155,586,292,45,17,13,44,137,148,322,0,0
3845,543,153,588,294,45,17,13,45,141,149,322,0,0
3846,543,154,587,292,45,17,13,44,138,150,322,0,0
3847,543,154,587,292,45,17,13,44,138,151,322,0,0
3848,543,156,586,291,45,17,13,43,135,152,322,0,0
3849,543,158,585,291,45,17,13,42,133,153,322,0,0
3850,543,159,584,291,45,17,13,41,132,154,322,0,0
3851,543,163,583,291,45,17,13,40,128,155,322,0,0
3852,543,166,581,291,45,17,13,38,125,156,322,0,0
3853,543,163,582,289,45,17,13,39,126,157,322,0,0
3854,543,164,582,291,45,17,13,39,127,158,322,0,0
3855,544,164,582,291,45,17,13,38,127,159,322,0,0
3856,544,158,584,292,45,17,13,40,134,160,322,0,0
3857,543,160,582,292,45,17,13,39,132,161,322,0,0
3858,543,158,584,293,45,17,13,41,135,162,322,0,0
3859,544,158,584,293,45,17,13,40,135,163,322,0,0
3860,543,160,583,293,45,17,13,40,133,164,322,0,0
3861,544,156,585,294,45,17,13,41,138,165,322,0,0
3862,544,156,586,293,45,17,13,42,137,166,322,0,0
3863,544,155,586,293,45,17,13,42,138,167,322,0,0
3864,544,154,587,294,45,17,13,43,140,168,322,0,0
3865,544,155,587,294,45,17,13,43,139,169,322,0,0
3866,545,159,586,293,45,17,13,41,134,170,322,0,0
3867,545,159,587,293,45,17,13,42,134,171,322,0,0
3868,545,157,588,294,45,17,13,43,137,172,322,0,0
3869,546,155,590,293,45,17,13,44,138,173,322,0,0
3870,547,154,592,293,45,17,13,45,139,174,322,0,0
3871,548,151,594,292,45,17,13,46,141,175,322,0,0
3872,548,150,595,292,45,17,13,47,142,176,322,0,0
3873,547,150,595,291,45,17,13,48,141,177,322,0,0
3874,547,151,595,291,45,17,13,48,140,178,322,0,0
3875,547,149,596,291,45,17,13,49,142,179,322,0,0
3876,546,153,594,292,45,17,13,48,139,180,322,0,0
3877,545,158,591,292,45,17,13,46,134,181,322,0,0
3878,544,159,590,293,45,17,13,46,134,182,322,0,0
3879,545,159,592,294,45,17,13,47,135,183,322,0,0
3880,544,158,591,294,45,17,13,47,136,184,322,0,0
3881,540,158,588,293,45,17,13,48,135,185,322,0,0
3882,534,163,583,297,45,17,13,49,134,186,322,0,0
3883,529,159,582,301,45,17,13,53,142,187,322,0,0
3884,528,162,581,302,45,17,13,53,140,188,322,0,0
3885,528,161,584,304,45,17,13,56,143,189,322,0,0
3886,527,163,582,302,45,17,13,55,139,190,322,0,0
3887,527,162,584,301,45,17,13,57,139,191,322,0,0
3888,528,159,587,301,45,17,13,59,142,192,322,0,0
3889,528,158,589,301,45,17,13,61,143,193,322,0,0
3890,526,157,589,302,45,17,13,63,145,194,322,0,0
3891,527,155,591,301,45,17,13,64,146,195,322,0,0
3892,528,154,592,298,45,17,13,64,144,196,322,0,0
3893,531,154,596,297,45,17,13,65,143,197,322,0,0
3894,536,153,601,296,45,17,13,65,143,198,322,0,0
3895,539,154,604,296,45,17,13,65,142,199,322,0,0
3896,537,154,603,300,45,17,13,66,146,200,322,0,0
3897,539,156,604,299,45,17,13,65,143,201,322,0,0
3898,542,157,606,297,45,17,13,64,140,202,322,0,0
3899,542,157,607,297,45,17,13,65,140,203,322,0,0
3900,543,157,607,296,45,17,13,64,139,204,322,0,0
3901,543,157,609,298,45,17,13,66,141,205,322,0,0
3902,544,159,609,299,45,17,13,65,140,206,322,0,0
3903,543,158,609,299,45,17,13,66,141,207,322,0,0
3904,543,158,610,299,45,17,13,67,141,208,322,0,0
3905,542,161,609,302,45,17,13,67,141,209,322,0,0
3906,543,159,609,300,45,17,13,66,141,210,322,0,0
3907,543,160,610,299,45,17,13,67,139,211,322,0,0
3908,544,158,612,300,45,17,13,68,142,212,322,0,0
3909,542,158,612,301,45,17,13,70,143,213,322,0,0
3910,541,156,612,302,45,17,13,71,146,214,322,0,0
3911,543,158,612,299,45,17,13,69,141,215,322,0,0
3912,542,159,610,298,45,17,13,68,139,216,322,0,0
3913,543,159,612,298,45,17,13,69,139,217,322,0,0
3914,541,160,610,297,45,17,13,69,137,218,322,0,0
3915,541,160,611,298,45,17,13,70,138,219,322,0,0
3916,539,159,610,298,45,17,13,71,139,220,322,0,0
3917,539,159,609,298,45,17,13,70,139,221,322,0,0
3918,539,159,609,298,45,17,13,70,139,222,322,0,0
3919,539,159,608,299,45,17,13,69,140,223,322,0,0
3920,540,161,609,299,45,17,13,69,138,224,322,0,0
3921,541,160,612,299,45,17,13,71,139,225,322,0,0
3922,541,160,613,299,45,17,13,72,139,226,322,0,0
3923,542,160,613,299,45,17,13,71,139,227,322,0,0
3924,542,162,614,299,45,17,13,72,137,228,322,0,0
3925,542,162,614,299,45,17,13,72,137,229,322,0,0
3926,541,161,612,297,45,17,13,71,136,230,322,0,0
3927,540,161,612,297,45,17,13,72,136,231,322,0,0
3928,540,161,612,296,45,17,13,72,135,232,322,0,0
3929,540,161,612,296,45,17,13,72,135,233,322,0,0
3930,540,161,612,296,45,17,13,72,135,234,322,0,0
3931,540,156,614,299,45,17,13,74,143,235,322,0,0
3932,538,155,615,301,45,17,13,77,146,236,322,0,0
3933,538,154,616,302,45,17,13,78,148,237,322,0,0
3934,538,154,616,303,45,17,13,78,149,238,322,0,0
3935,538,154,616,303,45,17,13,78,149,239,322,0,0
3936,540,159,614,299,45,17,13,74,140,240,322,0,0
3937,540,161,613,297,45,17,13,73,136,241,322,0,0
3938,539,158,614,299,45,17,13,75,141,242,322,0,0
3939,539,156,615,300,45,17,13,76,144,243,322,0,0
3940,538,155,615,300,45,17,13,77,145,244,322,0,0
3941,539,159,612,297,45,17,13,73,138,245,322,0,0
3942,540,159,611,297,45,17,13,71,138,246,322,0,0
3943,540,159,611,296,45,17,13,71,137,247,322,0,0
3944,540,159,610,296,45,17,13,70,137,248,322,0,0
3945,540,159,610,296,45,17,13,70,137,249,322,0,0
3946,541,160,611,297,45,17,13,70,137,250,322,0,0
3947,541,160,611,297,45,17,13,70,137,251,322,0,0
3948,541,161,611,297,45,17,13,70,136,252,322,0,0
3949,542,160,612,296,45,17,13,70,136,253,322,0,0
3950,541,160,611,296,45,17,13,70,136,254,322,0,0
3951,540,159,610,296,45,17,13,70,137,255,322,0,0
3952,540,159,610,296,45,17,13,70,137,256,322,0,0
3953,539,158,611,296,45,17,13,72,138,257,322,0,0
3954,539,158,610,296,45,17,13,71,138,258,322,0,0
3955,539,158,610,296,45,17,13,71,138,259,322,0,0
3956,540,157,611,296,45,17,13,71,139,260,322,0,0
3957,540,157,611,296,45,17,13,71,139,261,322,0,0
3958,540,156,611,296,45,17,13,71,140,262,322,0,0
3959,540,156,610,296,45,17,13,70,140,263,322,0,0
3960,540,156,610,296,45,17,13,70,140,264,322,0,0
3961,541,158,611,296,45,17,13,70,138,265,322,0,0
3962,542,158,611,295,45,17,13,69,137,266,322,0,0
3963,543,158,613,296,45,17,13,70,138,267,322,0,0
3964,542,158,612,296,45,17,13,70,138,268,322,0,0
3965,543,158,613,296,45,17,13,70,138,269,322,0,0
3966,542,160,612,298,45,17,13,70,138,270,322,0,0
3967,541,160,611,298,45,17,13,70,138,271,322,0,0
3968,541,160,611,298,45,17,13,70,138,272,322,0,0
3969,541,161,611,299,45,17,13,70,138,273,322,0,0
3970,541,161,611,299,45,17,13,70,138,274,322,0,0
3971,542,159,612,297,45,17,13,70,138,275,322,0,0
3972,543,159,612,297,45,17,13,69,138,276,322,0,0
3973,541,157,611,297,45,17,13,70,140,277,322,0,0
3974,540,156,611,297,45,17,13,71,141,278,322,0,0
3975,540,155,611,297,45,17,13,71,142,279,322,0,0
3976,540,156,611,298,45,17,13,71,142,280,322,0,0
3977,540,156,611,298,45,17,13,71,142,281,322,0,0
3978,540,156,611,299,45,17,13,71,143,282,322,0,0
3979,541,156,610,299,45,17,13,69,143,283,322,0,0
3980,541,157,610,298,45,17,13,69,141,284,322,0,0
3981,541,159,609,296,45,17,13,68,137,285,322,0,0
3982,542,159,610,296,45,17,13,68,137,286,322,0,0
3983,543,159,611,296,45,17,13,68,137,287,322,0,0
3984,542,160,609,294,45,17,13,67,134,288,322,0,0
3985,542,160,609,295,45,17,13,67,135,289,322,0,0
3986,538,161,603,294,45,17,13,65,133,290,322,0,0
3987,535,157,601,295,45,17,13,66,138,291,322,0,0
3988,533,151,601,297,45,17,13,68,146,292,322,0,0
3989,533,152,598,296,45,17,13,65,144,293,322,0,0
3990,532,154,594,294,45,17,13,62,140,294,322,0,0
3991,533,162,588,291,45,17,13,55,129,295,322,0,0
3992,535,162,588,289,45,17,13,53,127,296,322,0,0
3993,534,161,586,288,45,17,13,52,127,297,322,0,0
3994,535,162,585,289,45,17,13,50,127,298,322,0,0
3995,536,161,585,290,45,17,13,49,129,299,322,0,0
3996,537,163,585,294,45,17,13,48,131,300,322,0,0
3997,536,161,586,295,45,17,13,50,134,301,322,0,0
3998,536,160,586,296,45,17,13,50,136,302,322,0,0
3999,538,162,585,294,45,17,13,47,132,303,322,0,0
4000,537,160,585,295,45,17,13,48,135,304,322,0,0
4001,537,160,584,294,45,17,13,47,134,305,322,0,0
4002,538,159,585,294,45,17,13,47,135,306,322,0,0
4003,537,156,584,294,45,17,13,47,138,307,322,0,0
4004,538,156,587,296,45,17,13,49,140,308,322,0,0
4005,541,153,591,296,45,17,13,50,143,309,322,0,0
4006,542,150,594,298,45,17,13,52,148,310,322,0,0
4007,543,148,597,298,45,17,13,54,150,311,322,0,0
4008,543,151,597,297,45,17,13,54,146,312,322,0,0
4009,542,141,601,302,45,17,13,59,161,313,322,0,0
4010,545,143,603,297,45,17,13,58,154,314,322,0,0
4011,546,143,603,293,45,17,13,57,150,315,322,0,0
4012,546,142,603,293,45,17,13,57,151,316,322,0,0
4013,545,141,603,292,45,17,13,58,151,317,322,0,0
4014,545,142,604,293,45,17,13,59,151,318,322,0,0
4015,546,141,605,293,45,17,13,59,152,319,322,0,0
4016,546,141,604,291,45,17,13,58,150,320,322,0,0
4017,546,140,604,290,45,17,13,58,150,321,322,0,0
4018,546,140,605,289,45,17,13,59,149,322,322,1,0
4021,546,149,602,290,45,17,13,56,141,0,322,0,1
4022,547,149,602,290,45,17,13,55,141,1,322,0,0
4023,546,150,602,291,45,17,13,56,141,2,322,0,0
4024,547,145,607,294,45,17,13,60,149,3,322,0,0
4025,546,148,606,293,45,17,13,60,145,4,322,0,0
4026,549,146,610,293,45,17,13,61,147,5,322,0,0
4027,549,146,611,294,45,17,13,62,148,6,322,0,0
4028,549,147,611,294,45,17,13,62,147,7,322,0,0
4029,549,147,612,294,45,17,13,63,147,8,322,0,0
4030,549,147,612,294,45,17,13,63,147,9,322,0,0
4031,549,149,610,291,45,17,13,61,142,10,322,0,0
4032,548,150,609,290,45,17,13,61,140,11,322,0,0
4033,548,150,609,290,45,17,13,61,140,12,322,0,0
4034,548,150,610,289,45,17,13,62,139,13,322,0,0
4035,548,150,610,289,45,17,13,62,139,14,322,0,0
4036,547,146,612,293,45,17,13,65,147,15,322,0,0
4037,546,143,613,294,45,17,13,67,151,16,322,0,0
4038,546,143,613,294,45,17,13,67,151,17,322,0,0
4039,546,142,613,295,45,17,13,67,153,18,322,0,0
4040,546,141,613,295,45,17,13,67,154,19,322,0,0
4041,547,146,611,293,45,17,13,64,147,20,322,0,0
4042,547,148,611,292,45,17,13,64,144,21,322,0,0
4043,547,149,610,292,45,17,13,63,143,22,322,0,0
4044,547,149,610,292,45,17,13,63,143,23,322,0,0
4045,547,150,610,291,45,17,13,63,141,24,322,0,0
4046,546,148,610,292,45,17,13,64,144,25,322,0,0
4047,546,146,610,292,45,17,13,64,146,26,322,0,0
4048,546,146,610,292,45,17,13,64,146,27,322,0,0
4049,546,146,610,292,45,17,13,64,146,28,322,0,0
4050,545,144,610,293,45,17,13,65,149,29,322,0,0
4051,546,151,607,291,45,17,13,61,140,30,322,0,0
4052,546,153,606,290,45,17,13,60,137,31,322,0,0
4053,545,152,606,291,45,17,13,61,139,32,322,0,0
4054,545,152,607,291,45,17,13,62,139,33,322,0,0
4055,545,151,607,291,45,17,13,62,140,34,322,0,0
4056,546,148,608,289,45,17,13,62,141,35,322,0,0
4057,546,146,609,288,45,17,13,63,142,36,322,0,0
4058,546,145,609,287,45,17,13,63,142,37,322,0,0
4059,545,145,609,287,45,17,13,64,142,38,322,0,0
4060,545,145,610,287,45,17,13,65,142,39,322,0,0
4061,545,146,610,289,45,17,13,65,143,40,322,0,0
4062,546,148,609,289,45,17,13,63,141,41,322,0,0
4063,545,148,609,288,45,17,13,64,140,42,322,0,0
4064,545,148,609,288,45,17,13,64,140,43,322,0,0
4065,545,149,609,288,45,17,13,64,139,44,322,0,0
4066,545,147,610,289,45,17,13,65,142,45,322,0,0
4067,545,147,610,289,45,17,13,65,142,46,322,0,0
4068,545,147,610,289,45,17,13,65,142,47,322,0,0
4069,545,146,610,289,45,17,13,65,143,48,322,0,0
4070,545,146,610,290,45,17,13,65,144,49,322,0,0
4071,544,145,610,290,45,17,13,66,145,50,322,0,0
4072,544,144,610,290,45,17,13,66,146,51,322,0,0
4073,544,144,610,290,45,17,13,66,146,52,322,0,0
4074,544,143,610,290,45,17,13,66,147,53,322,0,0
4075,544,143,610,290,45,17,13,66,147,54,322,0,0
4076,545,147,610,290,45,17,13,65,143,55,322,0,0
4077,547,146,613,292,45,17,13,66,146,56,322,0,0
4078,547,146,615,293,45,17,13,68,147,57,322,0,0
4079,547,146,615,294,45,17,13,68,148,58,322,0,0
4080,547,146,615,294,45,17,13,68,148,59,322,0,0
4081,546,144,614,292,45,17,13,68,148,60,322,0,0
4082,546,143,614,292,45,17,13,68,149,61,322,0,0
4083,546,142,613,292,45,17,13,67,150,62,322,0,0
4084,546,142,613,292,45,17,13,67,150,63,322,0,0
4085,546,141,613,292,45,17,13,67,151,64,322,0,0
4086,545,145,610,292,45,17,13,65,147,65,322,0,0
4087,544,147,609,292,45,17,13,65,145,66,322,0,0
4088,544,147,609,292,45,17,13,65,145,67,322,0,0
4089,544,148,609,292,45,17,13,65,144,68,322,0,0
4090,544,148,609,292,45,17,13,65,144,69,322,0,0
4091,544,148,608,290,45,17,13,64,142,70,322,0,0
4092,544,148,608,289,45,17,13,64,141,71,322,0,0
4093,544,148,608,290,45,17,13,64,142,72,322,0,0
4094,544,148,608,290,45,17,13,64,142,73,322,0,0
4095,544,148,607,289,45,17,13,63,141,74,322,0,0
4096,545,146,608,288,45,17,13,63,142,75,322,0,0
4097,544,144,611,292,45,17,13,67,148,76,322,0,0
4098,545,145,609,289,45,17,13,64,144,77,322,0,0
4099,545,147,608,288,45,17,13,63,141,78,322,0,0
4100,546,148,609,288,45,17,13,63,140,79,322,0,0
4101,546,146,613,292,45,17,13,67,146,80,322,0,0
4102,544,142,614,297,45,17,13,70,155,81,322,0,0
4103,544,142,613,296,45,17,13,69,154,82,322,0,0
4104,542,145,610,295,45,17,13,68,150,83,322,0,0
4105,539,145,607,296,45,17,13,68,151,84,322,0,0
4106,536,148,605,300,45,17,13,69,152,85,322,0,0
4107,531,156,595,298,45,17,13,64,142,86,322,0,0
4108,531,165,589,296,45,17,13,58,131,87,322,0,0
4109,531,169,584,295,45,17,13,53,126,88,322,0,0
4110,530,167,582,293,45,17,13,52,126,89,322,0,0
4111,528,162,582,295,45,17,13,54,133,90,322,0,0
4112,529,157,584,297,45,17,13,55,140,91,322,0,0
4113,530,157,585,299,45,17,13,55,142,92,322,0,0
4114,530,159,583,299,45,17,13,53,140,93,322,0,0
4115,530,160,582,299,45,17,13,52,139,94,322,0,0
4116,532,167,579,296,45,17,13,47,129,95,322,0,0
4117,532,168,577,294,45,17,13,45,126,96,322,0,0
4118,533,170,576,294,45,17,13,43,124,97,322,0,0
4119,533,169,576,294,45,17,13,43,125,98,322,0,0
4120,533,168,576,293,45,17,13,43,125,99,322,0,0
4121,533,164,577,295,45,17,13,44,131,100,322,0,0
4122,532,163,577,297,45,17,13,45,134,101,322,0,0
4123,532,163,577,297,45,17,13,45,134,102,322,0,0
4124,533,162,577,297,45,17,13,44,135,103,322,0,0
4125,533,162,577,297,45,17,13,44,135,104,322,0,0
4126,533,161,578,300,45,17,13,45,139,105,322,0,0
4127,533,161,578,300,45,17,13,45,139,106,322,0,0
4128,533,162,576,299,45,17,13,43,137,107,322,0,0
4129,533,162,577,300,45,17,13,44,138,108,322,0,0
4130,533,162,576,299,45,17,13,43,137,109,322,0,0
4131,535,158,579,298,45,17,13,44,140,110,322,0,0
4132,536,156,580,298,45,17,13,44,142,111,322,0,0
4133,536,155,580,298,45,17,13,44,143,112,322,0,0
4134,536,155,580,298,45,17,13,44,143,113,322,0,0
4135,536,155,580,298,45,17,13,44,143,114,322,0,0
4136,536,159,578,295,45,17,13,42,136,115,322,0,0
4137,536,161,577,293,45,17,13,41,132,116,322,0,0
4138,536,161,577,293,45,17,13,41,132,117,322,0,0
4139,535,161,577,292,45,17,13,42,131,118,322,0,0
4140,535,162,576,292,45,17,13,41,130,119,322,0,0
4141,535,162,577,295,45,17,13,42,133,120,322,0,0
4142,536,162,578,296,45,17,13,42,134,121,322,0,0
4143,536,162,578,296,45,17,13,42,134,122,322,0,0
4144,536,162,578,296,45,17,13,42,134,123,322,0,0
4145,536,162,578,297,45,17,13,42,135,124,322,0,0
4146,535,162,578,298,45,17,13,43,136,125,322,0,0
4147,535,161,578,298,45,17,13,43,137,126,322,0,0
4148,535,161,578,298,45,17,13,43,137,127,322,0,0
4149,535,163,577,296,45,17,13,42,133,128,322,0,0
4150,535,161,578,297,45,17,13,43,136,129,322,0,0
4151,535,161,578,297,45,17,13,43,136,130,322,0,0
4152,535,161,578,297,45,17,13,43,136,131,322,0,0
4153,535,161,578,297,45,17,13,43,136,132,322,0,0
4154,536,160,578,296,45,17,13,42,136,133,322,0,0
4155,536,160,578,296,45,17,13,42,136,134,322,0,0
4157,534,156,577,293,45,17,13,43,137,0,322,0,0
4158,535,158,577,295,45,17,13,42,137,1,322,0,0
4159,535,157,578,296,45,17,13,43,139,2,322,0,0
4160,535,158,576,293,45,17,13,41,135,3,322,0,0
4161,534,156,577,296,45,17,13,43,140,4,322,0,0
4162,534,156,577,298,45,17,13,43,142,5,322,0,0
4163,534,155,577,298,45,17,13,43,143,6,322,0,0
4164,534,154,576,299,45,17,13,42,145,7,322,0,0
4165,534,154,576,299,45,17,13,42,145,8,322,0,0
4166,534,154,575,296,45,17,13,41,142,9,322,0,0
4167,534,153,574,295,45,17,13,40,142,10,322,0,0
4168,534,153,574,295,45,17,13,40,142,11,322,0,0
4169,534,153,575,296,45,17,13,41,143,12,322,0,0
4170,534,153,575,295,45,17,13,41,142,13,322,0,0
4171,534,153,575,295,45,17,13,41,142,14,322,0,0
4174,535,152,575,292,45,17,13,40,140,0,322,0,1
4175,536,152,575,291,45,17,13,39,139,1,322,0,0
4176,535,152,576,296,45,17,13,41,144,2,322,0,0
4177,535,151,577,296,45,17,13,42,145,3,322,0,0
4178,536,165,575,300,45,17,13,39,135,4,322,0,0
4179,538,165,576,298,45,17,13,38,133,5,322,0,0
4180,538,170,574,296,45,17,13,36,126,6,322,0,0
4181,537,163,576,294,45,17,13,39,131,7,322,0,0
4182,539,161,576,288,45,17,13,37,127,8,322,0,0
4183,539,161,576,288,45,17,13,37,127,9,322,0,0
4184,537,158,578,296,45,17,13,41,138,10,322,0,0
4185,537,158,578,296,45,17,13,41,138,11,322,0,0
4186,538,158,578,295,45,17,13,40,137,12,322,0,0
4187,537,158,577,295,45,17,13,40,137,13,322,0,0
4188,538,160,577,296,45,17,13,39,136,14,322,0,0
4189,538,164,576,296,45,17,13,38,132,15,322,0,0
4190,537,172,575,300,45,17,13,38,128,16,322,0,0
4191,537,172,574,296,45,17,13,37,124,17,322,0,0
4192,539,178,575,298,45,17,13,36,120,18,322,0,0
4193,539,179,575,298,45,17,13,36,119,19,322,0,0
4194,538,161,578,295,45,17,13,40,134,20,322,0,0
4195,537,153,578,293,45,17,13,41,140,21,322,0,0
4196,536,155,577,296,45,17,13,41,141,22,322,0,0
4197,536,156,577,294,45,17,13,41,138,23,322,0,0
4198,536,155,578,294,45,17,13,42,139,24,322,0,0
4199,535,146,579,294,45,17,13,44,148,25,322,0,0
4200,534,141,580,298,45,17,13,46,157,26,322,0,0
4201,535,146,580,299,45,17,13,45,153,27,322,0,0
4202,533,142,581,306,45,17,13,48,164,28,322,0,0
4203,534,145,580,303,45,17,13,46,158,29,322,0,0
4204,534,144,580,303,45,17,13,46,159,30,322,0,0
4205,536,145,580,300,45,17,13,44,155,31,322,0,0
4206,537,149,581,300,45,17,13,44,151,32,322,0,0
4207,537,153,580,299,45,17,13,43,146,33,322,0,0
4208,536,148,581,300,45,17,13,45,152,34,322,0,0
4209,537,149,581,300,45,17,13,44,151,35,322,0,0
4210,536,154,580,301,45,17,13,44,147,36,322,0,0
4211,536,148,582,302,45,17,13,46,154,37,322,0,0
4212,536,147,583,302,45,17,13,47,155,38,322,0,0
4215,534,138,582,299,45,17,13,48,161,0,322,0,0
4216,533,131,584,302,45,17,13,51,171,1,322,0,0
4217,534,135,583,300,45,17,13,49,165,2,322,0,0
4218,535,139,581,297,45,17,13,46,158,3,322,0,0
4219,535,138,581,299,45,17,13,46,161,4,322,0,0
4220,535,142,581,300,45,17,13,46,158,5,322,0,0
4221,536,143,582,301,45,17,13,46,158,6,322,0,0
4222,536,141,584,301,45,17,13,48,160,7,322,0,0
4223,537,141,584,302,45,17,13,47,161,8,322,0,0
4224,536,140,584,302,45,17,13,48,162,9,322,0,0
4225,536,146,582,301,45,17,13,46,155,10,322,0,0
4226,536,149,582,300,45,17,13,46,151,11,322,0,0
4227,536,151,582,300,45,17,13,46,149,12,322,0,0
4228,537,151,582,300,45,17,13,45,149,13,322,0,0
4230,538,154,582,297,45,17,13,44,143,0,322,0,0
4231,539,164,580,295,45,17,13,41,131,1,322,0,0
4232,539,166,580,295,45,17,13,41,129,2,322,0,0
4234,539,159,583,297,45,17,13,44,138,0,322,0,1
4235,539,162,582,297,45,17,13,43,135,1,322,0,0
4236,538,169,580,297,45,17,13,42,128,2,322,0,0
4237,538,170,579,297,45,17,13,41,127,3,322,0,0
4238,535,159,581,299,45,17,13,46,140,4,322,0,0
4239,534,153,582,300,45,17,13,48,147,5,322,0,0
4240,533,153,582,300,45,17,13,49,147,6,322,0,0
4241,534,156,579,294,45,17,13,45,138,7,322,0,0
4242,537,157,582,293,45,17,13,45,136,8,322,0,0
4243,538,161,582,291,45,17,13,44,130,9,322,0,0
4244,539,162,583,293,45,17,13,44,131,10,322,0,0
4245,539,164,583,293,45,17,13,44,129,11,322,0,0
4246,538,164,583,296,45,17,13,45,132,12,322,0,0
4247,538,164,584,296,45,17,13,46,132,13,322,0,0
4248,538,165,584,296,45,17,13,46,131,14,322,0,0
4249,539,165,584,295,45,17,13,45,130,15,322,0,0
4250,537,162,583,294,45,17,13,46,132,16,322,0,0
4251,537,160,582,291,45,17,13,45,131,17,322,0,0
4252,539,165,581,288,45,17,13,42,123,18,322,0,0
4253,538,161,582,289,45,17,13,44,128,19,322,0,0
4254,538,158,584,295,45,17,13,46,137,20,322,0,0
4255,537,156,584,295,45,17,13,47,139,21,322,0,0
4256,537,156,584,295,45,17,13,47,139,22,322,0,0
4257,536,155,585,299,45,17,13,49,144,23,322,0,0
4258,536,154,584,302,45,17,13,48,148,24,322,0,0
4259,536,156,584,300,45,17,13,48,144,25,322,0,0
4260,537,155,583,298,45,17,13,46,143,26,322,0,0
4261,536,151,582,297,45,17,13,46,146,27,322,0,0
4262,536,149,583,296,45,17,13,47,147,28,322,0,0
4263,537,148,583,296,45,17,13,46,148,29,322,0,0
4264,537,147,583,296,45,17,13,46,149,30,322,0,0
4265,537,148,583,296,45,17,13,46,148,31,322,0,0
4266,537,147,583,297,45,17,13,46,150,32,322,0,0
4267,536,148,582,297,45,17,13,46,149,33,322,0,0
4268,536,148,581,298,45,17,13,45,150,34,322,0,0
4269,536,148,581,298,45,17,13,45,150,35,322,0,0
4270,536,149,580,298,45,17,13,44,149,36,322,0,0
4271,537,151,580,297,45,17,13,43,146,37,322,0,0
4272,538,151,580,295,45,17,13,42,144,38,322,0,0
4273,537,150,580,295,45,17,13,43,145,39,322,0,0
4274,538,151,580,295,45,17,13,42,144,40,322,0,0
4275,538,150,580,295,45,17,13,42,145,41,322,0,0
4276,538,152,580,298,45,17,13,42,146,42,322,0,0
4277,537,153,580,299,45,17,13,43,146,43,322,0,0
4278,537,153,580,299,45,17,13,43,146,44,322,0,0
4279,537,154,579,300,45,17,13,42,146,45,322,0,0
4280,537,154,579,300,45,17,13,42,146,46,322,0,0
4281,538,153,580,297,45,17,13,42,144,47,322,0,0
4282,538,152,580,297,45,17,13,42,145,48,322,0,0
4283,538,153,581,300,45,17,13,43,147,49,322,0,0
4284,538,153,581,301,45,17,13,43,148,50,322,0,0
4285,537,153,582,301,45,17,13,45,148,51,322,0,0
4286,537,153,581,302,45,17,13,44,149,52,322,0,0
4287,536,153,580,302,45,17,13,44,149,53,322,0,0
4288,537,154,580,301,45,17,13,43,147,54,322,0,0
4289,537,154,580,299,45,17,13,43,145,55,322,0,0
4290,538,154,580,297,45,17,13,42,143,56,322,0,0
4291,538,152,579,295,45,17,13,41,143,57,322,0,0
4292,539,153,580,293,45,17,13,41,140,58,322,0,0
4293,539,153,579,294,45,17,13,40,141,59,322,0,0
4294,539,153,579,294,45,17,13,40,141,60,322,0,0
4295,539,154,579,296,45,17,13,40,142,61,322,0,0
4296,539,153,579,296,45,17,13,40,143,62,322,0,0
4297,539,153,580,296,45,17,13,41,143,63,322,0,0
4298,538,152,580,297,45,17,13,42,145,64,322,0,0
4299,539,154,580,295,45,17,13,41,141,65,322,0,0
4300,539,152,579,294,45,17,13,40,142,66,322,0,0
4301,537,149,580,297,45,17,13,43,148,67,322,0,0
4302,537,147,581,300,45,17,13,44,153,68,322,0,0
4303,537,146,581,300,45,17,13,44,154,69,322,0,0
4304,537,147,581,299,45,17,13,44,152,70,322,0,0
4305,536,148,580,299,45,17,13,44,151,71,322,0,0
4306,536,147,580,300,45,17,13,44,153,72,322,0,0
4308,537,157,578,298,45,17,13,41,141,0,322,0,0
4309,537,157,578,298,45,17,13,41,141,1,322,0,0
4311,538,154,579,297,45,17,13,41,143,0,322,0,0
4312,538,154,579,297,45,17,13,41,143,1,322,0,0
4316,538,155,579,294,45,17,13,41,139,0,322,0,0
4317,538,156,579,293,45,17,13,41,137,1,322,0,0
4318,539,156,579,293,45,17,13,40,137,2,322,0,0
4319,539,156,579,292,45,17,13,40,136,3,322,0,0
4320,539,158,579,293,45,17,13,40,135,4,322,0,0
4321,539,158,579,293,45,17,13,40,135,5,322,0,0
4326,538,153,581,296,45,17,13,43,143,0,322,0,0
4327,538,153,581,296,45,17,13,43,143,1,322,0,0
4328,538,153,581,296,45,17,13,43,143,2,322,0,0
4329,538,152,582,296,45,17,13,44,144,3,322,0,0
4330,537,151,582,297,45,17,13,45,146,4,322,0,0
4331,536,151,581,299,45,17,13,45,148,5,322,0,0
4332,535,150,581,300,45,17,13,46,150,6,322,0,0
4333,535,150,581,301,45,17,13,46,151,7,322,0,0
4334,536,150,581,301,45,17,13,45,151,8,322,0,0
4335,535,150,581,301,45,17,13,46,151,9,322,0,0
4336,536,151,582,301,45,17,13,46,150,10,322,0,0
4337,537,152,582,299,45,17,13,45,147,11,322,0,0
4338,537,152,582,298,45,17,13,45,146,12,322,0,0
4339,536,147,582,300,45,17,13,46,153,13,322,0,0
4340,537,150,582,298,45,17,13,45,148,14,322,0,0
4341,537,150,582,298,45,17,13,45,148,15,322,0,0
4346,537,149,582,298,45,17,13,45,149,0,322,0,0
4347,536,150,581,299,45,17,13,45,149,1,322,0,0
4348,536,151,581,301,45,17,13,45,150,2,322,0,0
4349,537,152,581,299,45,17,13,44,147,3,322,0,0
4350,537,152,580,297,45,17,13,43,145,4,322,0,0
4351,537,152,580,297,45,17,13,43,145,5,322,0,0
4354,536,152,579,296,45,17,13,43,144,0,322,0,1
4355,537,146,582,298,45,17,13,45,152,1,322,0,0
4356,538,149,581,294,45,17,13,43,145,2,322,0,0
4357,538,149,581,292,45,17,13,43,143,3,322,0,0
4358,539,149,581,292,45,17,13,42,143,4,322,0,0
4359,539,149,581,293,45,17,13,42,144,5,322,0,0
4360,538,149,581,293,45,17,13,43,144,6,322,0,0
4361,537,149,581,296,45,17,13,44,147,7,322,0,0
4362,537,149,581,297,45,17,13,44,148,8,322,0,0
4363,538,151,581,297,45,17,13,43,146,9,322,0,0
4364,537,152,581,297,45,17,13,44,145,10,322,0,0
4365,537,152,581,298,45,17,13,44,146,11,322,0,0
4366,538,153,581,296,45,17,13,43,143,12,322,0,0
4367,538,152,580,292,45,17,13,42,140,13,322,0,0
4368,538,150,580,293,45,17,13,42,143,14,322,0,0
4369,537,149,581,294,45,17,13,44,145,15,322,0,0
4370,538,149,581,295,45,17,13,43,146,16,322,0,0
4371,537,145,583,299,45,17,13,46,154,17,322,0,0
4372,536,144,583,302,45,17,13,47,158,18,322,0,0
4373,536,144,583,302,45,17,13,47,158,19,322,0,0
4374,536,144,583,303,45,17,13,47,159,20,322,0,0
4375,536,144,583,302,45,17,13,47,158,21,322,0,0
4376,537,147,582,297,45,17,13,45,150,22,322,0,0
4377,537,145,581,295,45,17,13,44,150,23,322,0,0
4378,537,147,581,295,45,17,13,44,148,24,322,0,0
4379,538,149,581,293,45,17,13,43,144,25,322,0,0
4380,538,149,581,293,45,17,13,43,144,26,322,0,0
4381,538,149,580,292,45,17,13,42,143,27,322,0,0
4390,538,143,582,295,45,17,13,44,152,0,322,0,0
4391,537,146,582,297,45,17,13,45,151,1,322,0,0
4392,537,146,582,296,45,17,13,45,150,2,322,0,0
4393,538,144,582,296,45,17,13,44,152,3,322,0,0
4394,538,143,582,296,45,17,13,44,153,4,322,0,0
4401,537,139,582,295,45,17,13,45,156,0,322,0,0
4402,537,138,582,295,45,17,13,45,157,1,322,0,0
4403,538,141,582,295,45,17,13,44,154,2,322,0,0
4404,538,140,582,295,45,17,13,44,155,3,322,0,0
4406,538,144,581,295,45,17,13,43,151,0,322,0,0
4407,538,145,581,295,45,17,13,43,150,1,322,0,0
4408,538,145,581,296,45,17,13,43,151,2,322,0,0
4409,538,146,581,296,45,17,13,43,150,3,322,0,0
4410,538,146,581,296,45,17,13,43,150,4,322,0,0
4411,537,146,581,298,45,17,13,44,152,5,322,0,0
4412,537,146,580,298,45,17,13,43,152,6,322,0,0
4413,537,148,581,299,45,17,13,44,151,7,322,0,0
4414,537,147,580,299,45,17,13,43,152,8,322,0,0
4415,537,147,580,299,45,17,13,43,152,9,322,0,0
4416,536,148,580,300,45,17,13,44,152,10,322,0,0
4419,537,150,580,297,45,17,13,43,147,0,322,0,1
4420,537,151,580,297,45,17,13,43,146,1,322,0,0
4421,538,147,580,293,45,17,13,42,146,2,322,0,0
4422,538,146,580,293,45,17,13,42,147,3,322,0,0
4423,538,146,580,293,45,17,13,42,147,4,322,0,0
4424,538,147,580,295,45,17,13,42,148,5,322,0,0
4425,537,151,577,291,45,17,13,40,140,6,322,0,0
4426,536,152,578,296,45,17,13,42,144,7,322,0,0
4427,534,151,577,299,45,17,13,43,148,8,322,0,0
4428,533,151,577,300,45,17,13,44,149,9,322,0,0
4429,530,147,574,293,45,17,13,44,146,10,322,0,0
4430,527,147,571,289,45,17,13,44,142,11,322,0,0
4431,527,147,571,286,45,17,13,44,139,12,322,0,0
4432,527,148,570,285,45,17,13,43,137,13,322,0,0
4433,524,148,567,284,45,17,13,43,136,14,322,0,0
4434,525,145,569,286,45,17,13,44,141,15,322,0,0
4435,524,144,569,285,45,17,13,45,141,16,322,0,0
4436,524,142,571,287,45,17,13,47,145,17,322,0,0
4437,523,145,569,288,45,17,13,46,143,18,322,0,0
4438,523,146,569,288,45,17,13,46,142,19,322,0,0
4439,522,147,568,288,45,17,13,46,141,20,322,0,0
4440,523,141,571,290,45,17,13,48,149,21,322,0,0
4441,525,144,571,286,45,17,13,46,142,22,322,0,0
4442,524,145,570,287,45,17,13,46,142,23,322,0,0
4443,525,146,570,285,45,17,13,45,139,24,322,0,0
4444,524,148,568,284,45,17,13,44,136,25,322,0,0
4445,524,148,568,283,45,17,13,44,135,26,322,0,0
4446,522,148,566,285,45,17,13,44,137,27,322,0,0
4447,523,148,566,285,45,17,13,43,137,28,322,0,0
4448,523,148,566,286,45,17,13,43,138,29,322,0,0
4449,523,148,566,286,45,17,13,43,138,30,322,0,0
4450,523,149,565,285,45,17,13,42,136,31,322,0,0
4451,524,149,566,285,45,17,13,42,136,32,322,0,0
4452,524,150,566,285,45,17,13,42,135,33,322,0,0
4453,524,149,566,285,45,17,13,42,136,34,322,0,0
4454,525,149,567,285,45,17,13,42,136,35,322,0,0
4455,524,149,566,284,45,17,13,42,135,36,322,0,0
4456,525,149,567,286,45,17,13,42,137,37,322,0,0
4457,525,148,568,286,45,17,13,43,138,38,322,0,0
4458,525,148,568,287,45,17,13,43,139,39,322,0,0
4459,525,148,569,288,45,17,13,44,140,40,322,0,0
4460,525,147,569,288,45,17,13,44,141,41,322,0,0
4461,525,150,568,286,45,17,13,43,136,42,322,0,0
4462,525,152,567,286,45,17,13,42,134,43,322,0,0
4463,525,152,567,285,45,17,13,42,133,44,322,0,0
4464,525,150,568,285,45,17,13,43,135,45,322,0,0
4465,524,150,566,284,45,17,13,42,134,46,322,0,0
4466,523,150,565,287,45,17,13,42,137,47,322,0,0
4467,522,151,564,287,45,17,13,42,136,48,322,0,0
4468,522,151,564,287,45,17,13,42,136,49,322,0,0
4469,522,151,564,287,45,17,13,42,136,50,322,0,0
4470,524,150,566,287,45,17,13,42,137,51,322,0,0
4471,524,149,565,285,45,17,13,41,136,52,322,0,0
4472,525,149,567,286,45,17,13,42,137,53,322,0,0
4473,525,148,567,285,45,17,13,42,137,54,322,0,0
4474,526,146,570,286,45,17,13,44,140,55,322,0,0
4475,527,146,572,286,45,17,13,45,140,56,322,0,0
4476,526,148,570,285,45,17,13,44,137,57,322,0,0
4477,526,149,569,285,45,17,13,43,136,58,322,0,0
4478,527,151,569,283,45,17,13,42,132,59,322,0,0
4479,526,150,569,283,45,17,13,43,133,60,322,0,0
4480,526,150,568,283,45,17,13,42,133,61,322,0,0
4481,524,149,567,285,45,17,13,43,136,62,322,0,0
4482,524,150,566,285,45,17,13,42,135,63,322,0,0
4483,523,150,566,285,45,17,13,43,135,64,322,0,0
4484,523,149,566,286,45,17,13,43,137,65,322,0,0
4485,524,150,567,286,45,17,13,43,136,66,322,0,0
4486,523,150,565,287,45,17,13,42,137,67,322,0,0
4487,523,150,565,286,45,17,13,42,136,68,322,0,0
4488,521,150,563,286,45,17,13,42,136,69,322,0,0
4489,521,151,562,285,45,17,13,41,134,70,322,0,0
4490,522,154,561,283,45,17,13,39,129,71,322,0,0
4491,522,157,561,284,45,17,13,39,127,72,322,0,0
4492,523,154,562,286,45,17,13,39,132,73,322,0,0
4493,523,152,564,286,45,17,13,41,134,74,322,0,0
4494,524,150,567,288,45,17,13,43,138,75,322,0,0
4495,525,150,568,288,45,17,13,43,138,76,322,0,0
4496,526,151,569,288,45,17,13,43,137,77,322,0,0
4497,526,151,570,287,45,17,13,44,136,78,322,0,0
4498,527,144,575,291,45,17,13,48,147,79,322,0,0
4499,525,147,571,288,45,17,13,46,141,80,322,0,0
4500,524,151,568,287,45,17,13,44,136,81,322,0,0
4501,523,151,567,286,45,17,13,44,135,82,322,0,0
4502,523,151,567,285,45,17,13,44,134,83,322,0,0
4503,521,149,565,286,45,17,13,44,137,84,322,0,0
4504,521,150,565,288,45,17,13,44,138,85,322,0,0
4505,523,153,566,287,45,17,13,43,134,86,322,0,0
4506,525,151,569,286,45,17,13,44,135,87,322,0,0
4507,526,151,571,286,45,17,13,45,135,88,322,0,0
4508,526,150,573,287,45,17,13,47,137,89,322,0,0
4509,526,148,574,287,45,17,13,48,139,90,322,0,0
4510,526,147,576,287,45,17,13,50,140,91,322,0,0
4511,525,147,575,286,45,17,13,50,139,92,322,0,0
4512,525,148,574,285,45,17,13,49,137,93,322,0,0
4513,524,146,574,287,45,17,13,50,141,94,322,0,0
4514,524,147,575,288,45,17,13,51,141,95,322,0,0
4515,523,148,574,287,45,17,13,51,139,96,322,0,0
4516,524,148,574,287,45,17,13,50,139,97,322,0,0
4517,524,144,575,287,45,17,13,51,143,98,322,0,0
4518,524,145,575,287,45,17,13,51,142,99,322,0,0
4519,524,145,576,287,45,17,13,52,142,100,322,0,0
4520,524,144,576,287,45,17,13,52,143,101,322,0,0
4521,525,146,578,289,45,17,13,53,143,102,322,0,0
4522,525,147,578,289,45,17,13,53,142,103,322,0,0
4523,524,146,578,290,45,17,13,54,144,104,322,0,0
4524,523,146,578,291,45,17,13,55,145,105,322,0,0
4525,523,147,577,291,45,17,13,54,144,106,322,0,0
4526,523,151,575,289,45,17,13,52,138,107,322,0,0
4527,523,153,574,289,45,17,13,51,136,108,322,0,0
4528,522,153,573,288,45,17,13,51,135,109,322,0,0
4529,524,153,574,287,45,17,13,50,134,110,322,0,0
4530,524,153,574,287,45,17,13,50,134,111,322,0,0
4531,524,155,574,287,45,17,13,50,132,112,322,0,0
4532,525,153,575,287,45,17,13,50,134,113,322,0,0
4533,525,155,575,286,45,17,13,50,131,114,322,0,0
4534,525,156,575,286,45,17,13,50,130,115,322,0,0
4535,525,155,576,287,45,17,13,51,132,116,322,0,0
4536,524,154,575,286,45,17,13,51,132,117,322,0,0
4537,524,156,574,287,45,17,13,50,131,118,322,0,0
4538,524,156,574,286,45,17,13,50,130,119,322,0,0
4539,524,155,574,285,45,17,13,50,130,120,322,0,0
4540,525,153,576,286,45,17,13,51,133,121,322,0,0
4541,524,152,575,285,45,17,13,51,133,122,322,0,0
4542,524,155,572,283,45,17,13,48,128,123,322,0,0
4543,523,154,571,285,45,17,13,48,131,124,322,0,0
4544,523,153,572,287,45,17,13,49,134,125,322,0,0
4545,524,155,572,287,45,17,13,48,132,126,322,0,0
4546,524,158,571,286,45,17,13,47,128,127,322,0,0
4547,524,157,571,286,45,17,13,47,129,128,322,0,0
4548,525,159,570,286,45,17,13,45,127,129,322,0,0
4549,525,159,571,285,45,17,13,46,126,130,322,0,0
4550,525,156,571,285,45,17,13,46,129,131,322,0,0
4551,526,157,572,286,45,17,13,46,129,132,322,0,0
4552,526,157,572,286,45,17,13,46,129,133,322,0,0
4553,525,155,573,287,45,17,13,48,132,134,322,0,0
4554,524,152,574,289,45,17,13,50,137,135,322,0,0
4555,524,150,574,289,45,17,13,50,139,136,322,0,0
4556,524,148,576,290,45,17,13,52,142,137,322,0,0
4557,524,147,576,290,45,17,13,52,143,138,322,0,0
4558,524,146,577,290,45,17,13,53,144,139,322,0,0
4559,524,146,576,290,45,17,13,52,144,140,322,0,0
4560,524,146,577,291,45,17,13,53,145,141,322,0,0
4561,524,147,576,290,45,17,13,52,143,142,322,0,0
4562,524,146,575,290,45,17,13,51,144,143,322,0,0
4563,524,147,575,290,45,17,13,51,143,144,322,0,0
4564,524,149,575,290,45,17,13,51,141,145,322,0,0
4565,524,149,575,289,45,17,13,51,140,146,322,0,0
4566,524,150,574,287,45,17,13,50,137,147,322,0,0
4567,524,150,574,287,45,17,13,50,137,148,322,0,0
4568,524,150,574,287,45,17,13,50,137,149,322,0,0
4569,524,150,574,287,45,17,13,50,137,150,322,0,0
4570,524,150,574,287,45,17,13,50,137,151,322,0,0
4571,524,148,574,287,45,17,13,50,139,152,322,0,0
4572,524,148,574,287,45,17,13,50,139,153,322,0,0
4573,523,148,574,287,45,17,13,51,139,154,322,0,0
4574,523,147,575,287,45,17,13,52,140,155,322,0,0
4575,523,146,574,287,45,17,13,51,141,156,322,0,0
4576,523,147,575,288,45,17,13,52,141,157,322,0,0
4577,523,147,575,288,45,17,13,52,141,158,322,0,0
4578,523,147,575,288,45,17,13,52,141,159,322,0,0
4579,523,147,575,289,45,17,13,52,142,160,322,0,0
4580,523,147,575,289,45,17,13,52,142,161,322,0,0
4581,524,147,576,289,45,17,13,52,142,162,322,0,0
4582,524,147,577,289,45,17,13,53,142,163,322,0,0
4583,524,147,577,290,45,17,13,53,143,164,322,0,0
4584,524,147,577,290,45,17,13,53,143,165,322,0,0
4585,524,147,577,290,45,17,13,53,143,166,322,0,0
4586,523,148,575,288,45,17,13,52,140,167,322,0,0
4587,523,148,574,288,45,17,13,51,140,168,322,0,0
4588,522,148,574,288,45,17,13,52,140,169,322,0,0
4589,522,149,573,287,45,17,13,51,138,170,322,0,0
4590,523,149,573,287,45,17,13,50,138,171,322,0,0
4591,523,149,573,287,45,17,13,50,138,172,322,0,0
4592,523,150,573,287,45,17,13,50,137,173,322,0,0
4593,523,150,573,287,45,17,13,50,137,174,322,0,0
4594,523,151,573,287,45,17,13,50,136,175,322,0,0
4595,523,150,573,287,45,17,13,50,137,176,322,0,0
4596,523,150,573,287,45,17,13,50,137,177,322,0,0
4597,523,151,573,287,45,17,13,50,136,178,322,0,0
4598,523,151,572,285,45,17,13,49,134,179,322,0,0
4599,524,153,571,284,45,17,13,47,131,180,322,0,0
4600,525,155,570,284,45,17,13,45,129,181,322,0,0
4601,524,155,570,283,45,17,13,46,128,182,322,0,0
4602,523,155,568,282,45,17,13,45,127,183,322,0,0
4603,521,157,565,282,45,17,13,44,125,184,322,0,0
4604,519,158,561,278,45,17,13,42,120,185,322,0,0
4605,518,156,560,279,45,17,13,42,123,186,322,0,0
4606,513,156,556,284,45,17,13,43,128,187,322,0,0
4607,511,157,554,286,45,17,13,43,129,188,322,0,0
4608,510,162,551,284,45,17,13,41,122,189,322,0,0
4609,509,160,549,284,45,17,13,40,124,190,322,0,0
4610,508,161,549,285,45,17,13,41,124,191,322,0,0
4611,508,163,547,285,45,17,13,39,122,192,322,0,0
4612,506,158,548,287,45,17,13,42,129,193,322,0,0
4613,506,158,548,289,45,17,13,42,131,194,322,0,0
4614,506,158,548,289,45,17,13,42,131,195,322,0,0
4615,506,154,548,290,45,17,13,42,136,196,322,0,0
4616,507,154,548,289,45,17,13,41,135,197,322,0,0
4617,507,154,549,289,45,17,13,42,135,198,322,0,0
4618,507,152,549,291,45,17,13,42,139,199,322,0,0
4619,507,152,549,291,45,17,13,42,139,200,322,0,0
4620,507,150,549,291,45,17,13,42,141,201,322,0,0
4621,507,151,549,291,45,17,13,42,140,202,322,0,0
4622,507,152,549,292,45,17,13,42,140,203,322,0,0
4623,507,152,548,291,45,17,13,41,139,204,322,0,0
4624,508,153,548,291,45,17,13,40,138,205,322,0,0
4625,507,153,547,291,45,17,13,40,138,206,322,0,0
4626,507,155,547,291,45,17,13,40,136,207,322,0,0
4627,507,157,546,292,45,17,13,39,135,208,322,0,0
4628,507,158,546,292,45,17,13,39,134,209,322,0,0
4629,507,159,546,292,45,17,13,39,133,210,322,0,0
4630,507,161,546,292,45,17,13,39,131,211,322,0,0
4631,507,155,548,292,45,17,13,41,137,212,322,0,0
4632,507,153,548,292,45,17,13,41,139,213,322,0,0
4633,506,151,548,293,45,17,13,42,142,214,322,0,0
4634,506,151,548,292,45,17,13,42,141,215,322,0,0
4635,506,151,549,292,45,17,13,43,141,216,322,0,0
4636,506,150,548,293,45,17,13,42,143,217,322,0,0
4637,507,150,549,293,45,17,13,42,143,218,322,0,0
4638,507,150,548,293,45,17,13,41,143,219,322,0,0
4639,507,150,548,293,45,17,13,41,143,220,322,0,0
4640,507,150,548,293,45,17,13,41,143,221,322,0,0
4641,507,150,548,292,45,17,13,41,142,222,322,0,0
4642,507,149,548,292,45,17,13,41,143,223,322,0,0
4643,507,149,548,292,45,17,13,41,143,224,322,0,0
4644,507,149,548,292,45,17,13,41,143,225,322,0,0
4645,507,149,548,291,45,17,13,41,142,226,322,0,0
4646,507,151,547,289,45,17,13,40,138,227,322,0,0
4647,507,150,547,291,45,17,13,40,141,228,322,0,0
4648,507,153,547,290,45,17,13,40,137,229,322,0,0
4649,507,149,547,291,45,17,13,40,142,230,322,0,0
4650,507,149,547,291,45,17,13,40,142,231,322,0,0
4651,506,150,546,291,45,17,13,40,141,232,322,0,0
4652,508,156,546,290,45,17,13,38,134,233,322,0,0
4653,508,156,546,290,45,17,13,38,134,234,322,0,0
4654,508,156,545,290,45,17,13,37,134,235,322,0,0
4655,507,152,546,292,45,17,13,39,140,236,322,0,0
4656,507,156,544,289,45,17,13,37,133,237,322,0,0
4657,507,157,544,289,45,17,13,37,132,238,322,0,0
4658,508,162,543,289,45,17,13,35,127,239,322,0,0
4659,507,160,543,289,45,17,13,36,129,240,322,0,0
4660,507,158,544,289,45,17,13,37,131,241,322,0,0
4661,507,149,547,291,45,17,13,40,142,242,322,0,0
4662,507,146,547,291,45,17,13,40,145,243,322,0,0
4663,507,145,548,291,45,17,13,41,146,244,322,0,0
4664,507,144,548,292,45,17,13,41,148,245,322,0,0
4665,508,144,548,292,45,17,13,40,148,246,322,0,0
4666,508,151,546,290,45,17,13,38,139,247,322,0,0
4667,508,154,545,290,45,17,13,37,136,248,322,0,0
4668,508,154,545,290,45,17,13,37,136,249,322,0,0
4669,508,155,545,289,45,17,13,37,134,250,322,0,0
4670,508,154,546,289,45,17,13,38,135,251,322,0,0
4671,508,156,546,290,45,17,13,38,134,252,322,0,0
4672,508,157,546,291,45,17,13,38,134,253,322,0,0
4673,508,157,546,291,45,17,13,38,134,254,322,0,0
4674,509,160,545,291,45,17,13,36,131,255,322,0,0
4675,509,161,545,291,45,17,13,36,130,256,322,0,0
4676,508,161,545,291,45,17,13,37,130,257,322,0,0
4677,508,157,545,291,45,17,13,37,134,258,322,0,0
4678,508,161,545,291,45,17,13,37,130,259,322,0,0
4679,508,158,545,291,45,17,13,37,133,260,322,0,0
4680,508,158,545,291,45,17,13,37,133,261,322,0,0
4681,508,152,547,292,45,17,13,39,140,262,322,0,0
4682,508,150,548,293,45,17,13,40,143,263,322,0,0
4683,508,150,548,295,45,17,13,40,145,264,322,0,0
4684,507,150,548,296,45,17,13,41,146,265,322,0,0
4685,508,156,547,295,45,17,13,39,139,266,322,0,0
4686,508,157,547,296,45,17,13,39,139,267,322,0,0
4698,510,168,545,290,45,17,13,35,122,0,322,0,1
4699,510,164,546,290,45,17,13,36,126,1,322,0,0
4700,508,154,547,292,45,17,13,39,138,2,322,0,0
4701,508,155,547,291,45,17,13,39,136,3,322,0,0
4702,508,151,547,291,45,17,13,39,140,4,322,0,0
4703,508,149,548,291,45,17,13,40,142,5,322,0,0
4704,508,148,548,291,45,17,13,40,143,6,322,0,0
4705,508,148,548,290,45,17,13,40,142,7,322,0,0
4706,507,149,548,291,45,17,13,41,142,8,322,0,0
4707,507,150,548,291,45,17,13,41,141,9,322,0,0
4708,507,149,548,291,45,17,13,41,142,10,322,0,0
4709,507,149,547,290,45,17,13,40,141,11,322,0,0
4710,507,149,548,291,45,17,13,41,142,12,322,0,0
4711,508,153,547,289,45,17,13,39,136,13,322,0,0
4712,508,155,546,288,45,17,13,38,133,14,322,0,0
4713,508,155,546,288,45,17,13,38,133,15,322,0,0
4714,507,153,547,290,45,17,13,40,137,16,322,0,0
4715,508,154,546,288,45,17,13,38,134,17,322,0,0
4716,508,153,547,290,45,17,13,39,137,18,322,0,0
4717,508,153,547,291,45,17,13,39,138,19,322,0,0
4718,508,153,547,291,45,17,13,39,138,20,322,0,0
4719,508,153,547,292,45,17,13,39,139,21,322,0,0
4720,509,155,547,290,45,17,13,38,135,22,322,0,0
4721,508,157,546,291,45,17,13,38,134,23,322,0,0
4722,508,158,545,291,45,17,13,37,133,24,322,0,0
4723,508,159,545,291,45,17,13,37,132,25,322,0,0
4724,508,159,545,291,45,17,13,37,132,26,322,0,0
4725,508,159,545,292,45,17,13,37,133,27,322,0,0
4726,508,154,547,292,45,17,13,39,138,28,322,0,0
4727,508,152,548,292,45,17,13,40,140,29,322,0,0
4728,508,151,548,292,45,17,13,40,141,30,322,0,0
4729,508,150,548,292,45,17,13,40,142,31,322,0,0
4730,508,150,548,292,45,17,13,40,142,32,322,0,0
4731,508,151,548,292,45,17,13,40,141,33,322,0,0
4732,508,151,548,292,45,17,13,40,141,34,322,0,0
4733,508,153,548,292,45,17,13,40,139,35,322,0,0
4734,509,153,548,292,45,17,13,39,139,36,322,0,0
4735,508,151,548,292,45,17,13,40,141,37,322,0,0
4736,508,151,547,292,45,17,13,39,141,38,322,0,0
4737,509,151,548,293,45,17,13,39,142,39,322,0,0
4738,509,152,548,291,45,17,13,39,139,40,322,0,0
4739,508,152,547,292,45,17,13,39,140,41,322,0,0
4740,509,155,547,291,45,17,13,38,136,42,322,0,0
4741,508,155,546,292,45,17,13,38,137,43,322,0,0
4742,507,154,546,292,45,17,13,39,138,44,322,0,0
4743,507,154,546,292,45,17,13,39,138,45,322,0,0
4744,508,154,547,292,45,17,13,39,138,46,322,0,0
4745,508,154,547,292,45,17,13,39,138,47,322,0,0
4746,508,154,547,291,45,17,13,39,137,48,322,0,0
4747,509,152,548,290,45,17,13,39,138,49,322,0,0
4748,507,149,547,290,45,17,13,40,141,50,322,0,0
4749,505,150,544,290,45,17,13,39,140,51,322,0,0
4750,500,149,539,288,45,17,13,39,139,52,322,0,0
4751,493,150,534,288,45,17,13,41,138,53,322,0,0
4752,485,151,528,290,45,17,13,43,139,54,322,0,0
4753,476,153,519,288,45,17,13,43,135,55,322,0,0
4754,468,147,512,286,45,17,13,44,139,56,322,0,0
4755,460,146,505,287,45,17,13,45,141,57,322,0,0
4756,453,147,498,287,45,17,13,45,140,58,322,0,0
4757,448,145,494,285,45,17,13,46,140,59,322,0,0
4758,444,145,490,284,45,17,13,46,139,60,322,0,0
4759,443,144,488,285,45,17,13,45,141,61,322,0,0
4760,442,143,487,284,45,17,13,45,141,62,322,0,0
4761,442,144,486,284,45,17,13,44,140,63,322,0,0
4762,442,143,486,284,45,17,13,44,141,64,322,0,0
4763,441,141,485,285,45,17,13,44,144,65,322,0,0
4764,442,142,485,285,45,17,13,43,143,66,322,0,0
4765,442,143,484,285,45,17,13,42,142,67,322,0,0
4766,443,144,483,283,45,17,13,40,139,68,322,0,0
4767,442,141,484,285,45,17,13,42,144,69,322,0,0
4768,442,139,484,285,45,17,13,42,146,70,322,0,0
4769,442,139,484,284,45,17,13,42,145,71,322,0,0
4770,444,143,484,284,45,17,13,40,141,72,322,0,0
4771,444,143,484,284,45,17,13,40,141,73,322,0,0
4772,444,141,485,283,45,17,13,41,142,74,322,0,0
4773,444,141,485,283,45,17,13,41,142,75,322,0,0
4774,444,141,485,284,45,17,13,41,143,76,322,0,0
4775,444,147,483,284,45,17,13,39,137,77,322,0,0
4776,444,147,482,284,45,17,13,38,137,78,322,0,0
4778,438,144,480,287,45,17,13,42,143,0,322,0,0
4779,436,142,478,289,45,17,13,42,147,1,322,0,0
4780,433,135,476,286,45,17,13,43,151,2,322,0,0
4781,431,127,475,284,45,17,13,44,157,3,322,0,0
4782,429,133,471,282,45,17,13,42,149,4,322,0,0
4783,427,136,470,284,45,17,13,43,148,5,322,0,0
4784,424,136,468,284,45,17,13,44,148,6,322,0,0
4785,420,138,463,281,45,17,13,43,143,7,322,0,0
4786,412,140,455,277,45,17,13,43,137,8,322,0,0
4787,404,138,447,276,45,17,13,43,138,9,322,0,0
4788,397,140,438,274,45,17,13,41,134,10,322,0,0
4789,394,141,435,271,45,17,13,41,130,11,322,0,0
4790,390,141,430,267,45,17,13,40,126,12,322,0,0
4791,389,142,429,265,45,17,13,40,123,13,322,0,0
4792,386,142,425,263,45,17,13,39,121,14,322,0,0
4802,381,134,417,247,45,17,13,36,113,0,322,0,0
4803,378,133,414,248,45,17,13,36,115,1,322,0,0
4804,374,133,409,251,45,17,13,35,118,2,322,0,0
4805,373,129,409,256,45,17,13,36,127,3,322,0,0
4806,371,128,407,256,45,17,13,36,128,4,322,0,0
4820,363,130,398,254,45,17,13,35,124,0,322,0,1
4821,362,130,397,254,45,17,13,35,124,1,322,0,0
4822,360,130,397,256,45,17,13,37,126,2,322,0,0
4823,357,130,396,258,45,17,13,39,128,3,322,0,0
4824,354,127,394,258,45,17,13,40,131,4,322,0,0
4825,354,128,395,257,45,17,13,41,129,5,322,0,0
4826,356,129,396,254,45,17,13,40,125,6,322,0,0
4827,356,129,396,254,45,17,13,40,125,7,322,0,0
4828,352,128,395,256,45,17,13,43,128,8,322,0,0
4829,351,127,395,257,45,17,13,44,130,9,322,0,0
4830,350,128,395,257,45,17,13,45,129,10,322,0,0
4831,346,128,393,260,45,17,13,47,132,11,322,0,0
4832,345,128,392,260,45,17,13,47,132,12,322,0,0
4833,351,131,396,256,45,17,13,45,125,13,322,0,0
4834,352,129,397,257,45,17,13,45,128,14,322,0,0
4835,354,130,399,257,45,17,13,45,127,15,322,0,0
4836,353,130,398,257,45,17,13,45,127,16,322,0,0
4837,352,130,398,258,45,17,13,46,128,17,322,0,0
4838,353,133,398,257,45,17,13,45,124,18,322,0,0
4839,354,131,399,257,45,17,13,45,126,19,322,0,0
4840,355,131,399,257,45,17,13,44,126,20,322,0,0
4841,357,132,400,256,45,17,13,43,124,21,322,0,0
4842,356,132,399,256,45,17,13,43,124,22,322,0,0
4843,350,129,394,255,45,17,13,44,126,23,322,0,0
4844,343,127,386,255,45,17,13,43,128,24,322,0,0
4845,341,127,385,255,45,17,13,44,128,25,322,0,0
3696,548,157,585,288,47,17,13,37,131,0,9,0,0
3697,547,161,582,286,47,17,13,35,125,1,9,0,0
3698,546,162,581,285,47,17,13,35,123,2,9,0,0
3699,545,163,581,285,47,17,13,36,122,3,9,0,0
3700,545,167,581,283,47,17,13,36,116,4,9,0,0
3701,545,160,584,286,47,17,13,39,126,5,9,0,0
3702,546,157,585,283,47,17,13,39,126,6,9,0,0
3703,546,156,584,282,47,17,13,38,126,7,9,0,0
3704,545,159,583,282,47,17,13,38,123,8,9,0,0
3705,545,159,583,281,47,17,13,38,122,9,9,0,0
3725,544,161,583,283,47,17,13,39,122,0,9,0,0
3726,544,162,583,284,47,17,13,39,122,1,9,0,0
3759,540,157,584,284,48,17,13,44,127,0,5,0,0
3760,541,159,584,283,48,17,13,43,124,1,5,0,0
3761,540,165,581,283,48,17,13,41,118,2,5,0,0
3762,539,156,585,287,48,17,13,46,131,3,5,0,0
3763,542,151,589,287,48,17,13,47,136,4,5,0,0
3764,542,148,591,288,48,17,13,49,140,5,5,0,0
3887,569,179,604,295,50,17,13,35,116,0,2,0,0
3888,568,173,606,295,50,17,13,38,122,1,2,0,0
3889,568,172,606,295,50,17,13,38,123,2,2,0,0
3891,570,162,610,292,50,17,13,40,130,0,2,0,0
3892,569,161,610,293,50,17,13,41,132,1,2,0,0
3893,569,159,610,293,50,17,13,41,134,2,2,0,0
4003,571,157,606,289,52,17,13,35,132,0,0,0,0
4125,563,149,603,296,55,17,13,40,147,0,0,0,0
4131,562,150,597,286,56,17,13,35,136,0,1,0,0
4135,561,151,596,285,56,17,13,35,134,0,1,0,0
4136,561,151,596,285,56,17,13,35,134,1,1,0,0
4188,1035,816,1286,1072,58,17,13,251,256,0,26,0,1
4189,919,725,1253,1066,58,17,13,334,341,1,26,0,0
4190,813,655,1210,1063,58,17,13,397,408,2,26,0,0
4191,721,611,1159,1066,58,17,13,438,455,3,26,0,0
4192,627,560,1109,1071,58,17,13,482,511,4,26,0,0
4193,555,506,1071,1067,58,17,13,516,561,5,26,0,0
4194,508,475,1033,1062,58,17,13,525,587,6,26,0,0
4195,448,427,999,1064,58,17,13,551,637,7,26,0,0
4196,393,396,943,1050,58,17,13,550,654,8,26,0,0
4197,346,384,886,1049,58,17,13,540,665,9,26,0,0
4198,314,362,821,1007,58,17,13,507,645,10,26,0,0
4199,293,355,754,960,58,17,13,461,605,11,26,0,0
4200,264,335,709,944,58,17,13,445,609,12,26,0,0
4201,240,319,670,927,58,17,13,430,608,13,26,0,0
4202,233,305,642,904,58,17,13,409,599,14,26,0,0
4203,247,304,633,892,58,17,13,386,588,15,26,0,0
4204,264,304,627,880,58,17,13,363,576,16,26,0,0
4205,264,304,613,882,58,17,13,349,578,17,26,0,0
4206,275,311,610,887,58,17,13,335,576,18,26,0,0
4207,296,321,616,895,58,17,13,320,574,19,26,0,0
4208,307,336,616,908,58,17,13,309,572,20,26,0,0
4209,294,350,601,936,58,17,13,307,586,21,26,0,0
4210,272,362,577,964,58,17,13,305,602,22,26,0,0
4211,236,369,535,977,58,17,13,299,608,23,26,0,0
4212,202,387,501,1019,58,17,13,299,632,24,26,0,0
4213,207,447,462,1004,58,17,13,255,557,25,26,0,0
4214,185,452,441,1009,58,17,13,256,557,26,26,1,0
4191,572,215,608,299,59,17,13,36,84,0,0,0,0
4305,878,662,1286,1073,67,17,13,408,411,0,44,0,1
4306,795,609,1246,1072,67,17,13,451,463,1,44,0,0
4307,707,573,1182,1072,67,17,13,475,499,2,44,0,0
4308,617,532,1119,1074,67,17,13,502,542,3,44,0,0
4309,569,498,1084,1070,67,17,13,515,572,4,44,0,0
4310,517,475,1036,1072,67,17,13,519,597,5,44,0,0
4311,454,448,976,1071,67,17,13,522,623,6,44,0,0
4312,405,430,911,1058,67,17,13,506,628,7,44,0,0
4313,372,415,852,1033,67,17,13,480,618,8,44,0,0
4314,340,396,793,1003,67,17,13,453,607,9,44,0,0
4315,321,385,759,988,67,17,13,438,603,10,44,0,0
4316,299,375,721,975,67,17,13,422,600,11,44,0,0
4317,291,364,677,935,67,17,13,386,571,12,44,0,0
4318,290,356,654,914,67,17,13,364,558,13,44,0,0
4319,293,352,641,909,67,17,13,348,557,14,44,0,0
4320,287,353,623,909,67,17,13,336,556,15,44,0,0
4321,285,355,610,909,67,17,13,325,554,16,44,0,0
4322,287,356,603,910,67,17,13,316,554,17,44,0,0
4323,290,357,597,910,67,17,13,307,553,18,44,0,0
4324,295,358,594,912,67,17,13,299,554,19,44,0,0
4325,300,356,595,914,67,17,13,295,558,20,44,0,0
4326,316,353,605,912,67,17,13,289,559,21,44,0,0
4327,339,354,618,910,67,17,13,279,556,22,44,0,0
4328,363,360,637,922,67,17,13,274,562,23,44,0,0
4329,399,371,661,930,67,17,13,262,559,24,44,0,0
4330,434,382,688,936,67,17,13,254,554,25,44,0,0
4331,469,395,721,953,67,17,13,252,558,26,44,0,0
4332,489,405,741,966,67,17,13,252,561,27,44,0,0
4333,497,415,760,1007,67,17,13,263,592,28,44,0,0
4334,501,429,771,1046,67,17,13,270,617,29,44,0,0
4335,506,444,773,1058,67,17,13,267,614,30,44,0,0
4336,523,461,786,1071,67,17,13,263,610,31,44,0,0
4337,563,485,817,1072,67,17,13,254,587,32,44,0,0
4338,627,507,877,1076,67,17,13,250,569,33,44,0,0
4339,695,529,942,1077,67,17,13,247,548,34,44,0,0
4340,773,573,1006,1073,67,17,13,233,500,35,44,0,0
4341,870,605,1096,1073,67,17,13,226,468,36,44,0,0
4342,975,640,1193,1073,67,17,13,218,433,37,44,0,0
4343,1086,684,1293,1076,67,17,13,207,392,38,44,0,0
4344,1209,715,1408,1074,67,17,13,199,359,39,44,0,0
4345,1321,770,1504,1075,67,17,13,183,305,40,44,0,0
4346,1457,818,1622,1070,67,17,13,165,252,41,44,0,0
4347,1547,857,1707,1072,67,17,13,160,215,42,44,0,0
4348,1695,903,1834,1075,67,17,13,139,172,43,44,0,0
4349,1784,934,1905,1079,67,17,13,121,145,44,44,1,0
4347,570,177,607,305,68,17,13,37,128,0,4,0,0
4348,573,173,610,302,68,17,13,37,129,1,4,0,0
4349,571,172,610,305,68,17,13,39,133,2,4,0,0
4350,573,171,610,300,68,17,13,37,129,3,4,0,0
4351,574,169,611,299,68,17,13,37,130,4,4,0,0
4361,569,151,609,293,68,17,13,40,142,0,4,0,0
4362,568,149,609,293,68,17,13,41,144,1,4,0,0
4426,570,147,608,303,71,17,13,38,156,0,1,0,0
4427,569,143,608,303,71,17,13,39,160,1,1,0,0
4451,574,147,610,290,72,17,13,36,143,0,37,0,1
4452,573,147,610,291,72,17,13,37,144,1,37,0,0
4453,572,147,610,290,72,17,13,38,143,2,37,0,0
4454,572,148,610,290,72,17,13,38,142,3,37,0,0
4455,572,148,611,290,72,17,13,39,142,4,37,0,0
4456,571,150,610,290,72,17,13,39,140,5,37,0,0
4457,570,150,609,291,72,17,13,39,141,6,37,0,0
4458,570,151,609,291,72,17,13,39,140,7,37,0,0
4459,569,151,609,291,72,17,13,40,140,8,37,0,0
4460,570,150,610,291,72,17,13,40,141,9,37,0,0
4461,569,147,610,291,72,17,13,41,144,10,37,0,0
4462,569,147,611,291,72,17,13,42,144,11,37,0,0
4463,569,148,611,291,72,17,13,42,143,12,37,0,0
4464,570,147,612,292,72,17,13,42,145,13,37,0,0
4465,571,150,612,291,72,17,13,41,141,14,37,0,0
4466,573,158,611,290,72,17,13,38,132,15,37,0,0
4467,573,154,611,288,72,17,13,38,134,16,37,0,0
4468,572,153,611,289,72,17,13,39,136,17,37,0,0
4469,572,153,611,289,72,17,13,39,136,18,37,0,0
4470,573,154,611,289,72,17,13,38,135,19,37,0,0
4471,572,156,610,290,72,17,13,38,134,20,37,0,0
4472,573,157,611,292,72,17,13,38,135,21,37,0,0
4473,574,158,612,292,72,17,13,38,134,22,37,0,0
4474,573,163,610,292,72,17,13,37,129,23,37,0,0
4475,573,160,611,292,72,17,13,38,132,24,37,0,0
4476,571,155,610,291,72,17,13,39,136,25,37,0,0
4477,571,153,611,291,72,17,13,40,138,26,37,0,0
4478,572,153,611,290,72,17,13,39,137,27,37,0,0
4479,572,151,611,290,72,17,13,39,139,28,37,0,0
4480,572,150,611,290,72,17,13,39,140,29,37,0,0
4481,572,152,611,291,72,17,13,39,139,30,37,0,0
4482,572,155,610,291,72,17,13,38,136,31,37,0,0
4483,573,157,610,291,72,17,13,37,134,32,37,0,0
4484,573,157,610,291,72,17,13,37,134,33,37,0,0
4485,573,157,611,291,72,17,13,38,134,34,37,0,0
4486,572,156,610,291,72,17,13,38,135,35,37,0,0
4487,574,154,612,291,72,17,13,38,137,36,37,0,0
4488,574,154,612,292,72,17,13,38,138,37,37,1,0
4497,573,168,609,293,72,17,13,36,125,0,37,0,0
4498,573,168,609,293,72,17,13,36,125,1,37,0,0
4499,572,163,610,293,72,17,13,38,130,2,37,0,0
4500,573,167,609,292,72,17,13,36,125,3,37,0,0
4505,570,168,609,296,72,17,13,39,128,0,37,0,0
4506,568,155,610,294,72,17,13,42,139,1,37,0,0
4507,568,155,610,296,72,17,13,42,141,2,37,0,0
4508,575,168,610,288,72,17,13,35,120,3,37,0,0
4509,575,168,610,288,72,17,13,35,120,4,37,0,0
4513,570,171,608,299,72,17,13,38,128,0,37,0,0
4514,569,166,607,298,72,17,13,38,132,1,37,0,0
4515,568,156,610,302,72,17,13,42,146,2,37,0,0
4516,572,149,613,296,72,17,13,41,147,3,37,0,0
4517,574,143,614,291,72,17,13,40,148,4,37,0,0
4518,575,142,614,288,72,17,13,39,146,5,37,0,0
4519,576,141,614,287,72,17,13,38,146,6,37,0,0
4520,576,138,615,288,72,17,13,39,150,7,37,0,0
4521,576,136,615,288,72,17,13,39,152,8,37,0,0
4528,571,154,608,291,72,17,13,37,137,0,37,0,0
4529,573,154,609,292,72,17,13,36,138,1,37,0,0
4530,575,152,611,292,72,17,13,36,140,2,37,0,0
4531,575,151,611,293,72,17,13,36,142,3,37,0,0
4544,572,175,608,299,72,17,13,36,124,0,37,0,0
4545,570,160,611,301,72,17,13,41,141,1,37,0,0
4546,570,162,609,295,72,17,13,39,133,2,37,0,0
4547,568,152,610,295,72,17,13,42,143,3,37,0,0
4548,569,159,609,292,72,17,13,40,133,4,37,0,0
4549,570,156,611,293,72,17,13,41,137,5,37,0,0
4550,570,164,609,293,72,17,13,39,129,6,37,0,0
4551,569,170,607,293,72,17,13,38,123,7,37,0,0
4552,569,170,607,294,72,17,13,38,124,8,37,0,0
4553,568,171,607,294,72,17,13,39,123,9,37,0,0
4554,568,171,607,295,72,17,13,39,124,10,37,0,0
4555,568,167,608,294,72,17,13,40,127,11,37,0,0
4556,566,161,609,296,72,17,13,43,135,12,37,0,0
4557,566,162,609,298,72,17,13,43,136,13,37,0,0
4558,565,161,609,299,72,17,13,44,138,14,37,0,0
4559,565,160,608,300,72,17,13,43,140,15,37,0,0
4560,566,164,608,299,72,17,13,42,135,16,37,0,0
4561,570,187,605,296,72,17,13,35,109,17,37,0,0
4447,548,152,587,281,73,17,13,39,129,0,0,0,0
4511,902,831,1098,1068,75,17,13,196,237,0,0,0,0
4517,323,431,944,1063,76,17,13,621,632,0,3,0,0
4518,313,405,928,1054,76,17,13,615,649,1,3,0,0
4519,298,375,914,1054,76,17,13,616,679,2,3,0,0
4520,254,332,907,1052,76,17,13,653,720,3,3,0,0
4520,497,347,711,979,77,17,13,214,632,0,21,0,1
4521,506,351,715,971,77,17,13,209,620,1,21,0,0
4522,520,329,714,903,77,17,13,194,574,2,21,0,0
4523,532,301,717,847,77,17,13,185,546,3,21,0,0
4524,538,296,719,830,77,17,13,181,534,4,21,0,0
4525,545,284,714,785,77,17,13,169,501,5,21,0,0
4526,556,270,714,738,77,17,13,158,468,6,21,0,0
4527,564,263,718,720,77,17,13,154,457,7,21,0,0
4528,582,261,723,678,77,17,13,141,417,8,21,0,0
4529,595,246,732,651,77,17,13,137,405,9,21,0,0
4530,609,245,743,642,77,17,13,134,397,10,21,0,0
4531,618,239,749,630,77,17,13,131,391,11,21,0,0
4532,635,228,759,600,77,17,13,124,372,12,21,0,0
4533,651,233,770,582,77,17,13,119,349,13,21,0,0
4534,670,237,787,569,77,17,13,117,332,14,21,0,0
4535,710,233,824,552,77,17,13,114,319,15,21,0,0
4536,740,236,851,543,77,17,13,111,307,16,21,0,0
4537,769,237,882,544,77,17,13,113,307,17,21,0,0
4538,806,234,918,540,77,17,13,112,306,18,21,0,0
4539,826,245,932,532,77,17,13,106,287,19,21,0,0
4540,841,279,935,530,77,17,13,94,251,20,21,0,0
4541,863,283,952,518,77,17,13,89,235,21,21,1,0
4635,541,176,576,285,78,17,13,35,109,0,4,0,0
4642,542,178,577,283,78,17,13,35,105,0,4,0,0
4643,542,178,577,283,78,17,13,35,105,1,4,0,0
4644,542,178,577,283,78,17,13,35,105,2,4,0,0
4645,542,177,577,283,78,17,13,35,106,3,4,0,0
4646,542,177,577,283,78,17,13,35,106,4,4,0,0
4669,542,183,577,287,78,17,13,35,104,0,4,0,0
4670,541,184,577,287,78,17,13,36,103,1,4,0,0
4671,540,184,575,288,78,17,13,35,104,2,4,0,0
4657,1236,778,1475,1065,80,17,13,239,287,0,54,0,1
4658,1126,729,1407,1068,80,17,13,281,339,1,54,0,0
4659,1020,685,1340,1073,80,17,13,320,388,2,54,0,0
4660,906,628,1271,1073,80,17,13,365,445,3,54,0,0
4661,840,581,1236,1072,80,17,13,396,491,4,54,0,0
4662,783,541,1205,1073,80,17,13,422,532,5,54,0,0
4663,757,500,1203,1076,80,17,13,446,576,6,54,0,0
4664,752,474,1174,1033,80,17,13,422,559,7,54,0,0
4665,759,597,1112,1055,80,17,13,353,458,8,54,0,0
4666,697,604,1058,1066,80,17,13,361,462,9,54,0,0
4667,603,564,992,1066,80,17,13,389,502,10,54,0,0
4668,534,520,949,1066,80,17,13,415,546,11,54,0,0
4669,487,483,915,1065,80,17,13,428,582,12,54,0,0
4670,449,444,891,1067,80,17,13,442,623,13,54,0,0
4671,424,418,867,1068,80,17,13,443,650,14,54,0,0
4672,409,396,842,1056,80,17,13,433,660,15,54,0,0
4673,395,369,814,1037,80,17,13,419,668,16,54,0,0
4674,396,347,798,1018,80,17,13,402,671,17,54,0,0
4675,394,330,782,1006,80,17,13,388,676,18,54,0,0
4676,414,311,760,938,80,17,13,346,627,19,54,0,0
4677,428,307,744,902,80,17,13,316,595,20,54,0,0
4678,428,302,725,883,80,17,13,297,581,21,54,0,0
4679,428,282,702,839,80,17,13,274,557,22,54,0,0
4680,431,270,685,806,80,17,13,254,536,23,54,0,0
4681,440,264,676,779,80,17,13,236,515,24,54,0,0
4682,451,252,666,733,80,17,13,215,481,25,54,0,0
4683,460,244,664,712,80,17,13,204,468,26,54,0,0
4684,461,238,652,691,80,17,13,191,453,27,54,0,0
4685,460,231,638,662,80,17,13,178,431,28,54,0,0
4686,462,230,633,649,80,17,13,171,419,29,54,0,0
4687,459,227,624,645,80,17,13,165,418,30,54,0,0
4688,458,223,610,612,80,17,13,152,389,31,54,0,0
4689,453,221,602,605,80,17,13,149,384,32,54,0,0
4690,451,218,597,602,80,17,13,146,384,33,54,0,0
4691,449,212,591,595,80,17,13,142,383,34,54,0,0
4692,447,211,581,578,80,17,13,134,367,35,54,0,0
4693,452,207,582,568,80,17,13,130,361,36,54,0,0
4694,461,207,587,561,80,17,13,126,354,37,54,0,0
4695,479,203,603,552,80,17,13,124,349,38,54,0,0
4696,493,199,615,545,80,17,13,122,346,39,54,0,0
4697,509,203,626,538,80,17,13,117,335,40,54,0,0
4698,524,202,638,532,80,17,13,114,330,41,54,0,0
4699,547,201,659,525,80,17,13,112,324,42,54,0,0
4700,565,201,678,524,80,17,13,113,323,43,54,0,0
4701,581,205,693,517,80,17,13,112,312,44,54,0,0
4702,617,207,725,507,80,17,13,108,300,45,54,0,0
4703,649,213,756,507,80,17,13,107,294,46,54,0,0
4704,670,216,777,505,80,17,13,107,289,47,54,0,0
4705,706,213,813,499,80,17,13,107,286,48,54,0,0
4706,735,217,842,505,80,17,13,107,288,49,54,0,0
4707,757,221,867,507,80,17,13,110,286,50,54,0,0
4708,798,221,907,506,80,17,13,109,285,51,54,0,0
4709,826,225,934,511,80,17,13,108,286,52,54,0,0
4710,844,252,943,512,80,17,13,99,260,53,54,0,0
4711,867,256,964,510,80,17,13,97,254,54,54,1,0
4659,1757,891,1920,1075,81,17,13,163,184,0,1,0,0
4660,1681,870,1862,1073,81,17,13,181,203,1,1,0,0
4671,599,421,1211,1065,82,17,13,612,644,0,1,0,0
4672,519,384,1167,1065,82,17,13,648,681,1,1,0,0
4665,841,454,1063,843,85,17,13,222,389,0,19,0,1
4666,822,428,1035,802,85,17,13,213,374,1,19,0,0
4667,810,411,1017,774,85,17,13,207,363,2,19,0,0
4668,771,388,1043,874,85,17,13,272,486,3,19,0,0
4669,756,376,1022,858,85,17,13,266,482,4,19,0,0
4670,753,362,978,776,85,17,13,225,414,5,19,0,0
4671,718,343,946,770,85,17,13,228,427,6,19,0,0
4672,688,330,930,796,85,17,13,242,466,7,19,0,0
4673,678,320,904,769,85,17,13,226,449,8,19,0,0
4674,673,302,878,719,85,17,13,205,417,9,19,0,0
4675,664,296,857,700,85,17,13,193,404,10,19,0,0
4676,653,282,835,674,85,17,13,182,392,11,19,0,0
4677,640,274,815,657,85,17,13,175,383,12,19,0,0
4678,627,266,789,630,85,17,13,162,364,13,19,0,0
4679,624,259,772,600,85,17,13,148,341,14,19,0,0
4680,621,255,746,545,85,17,13,125,290,15,19,0,0
4681,631,250,726,470,85,17,13,95,220,16,19,0,0
4682,630,244,712,431,85,17,13,82,187,17,19,0,0
4683,634,244,703,398,85,17,13,69,154,18,19,0,0
4684,629,237,687,365,85,17,13,58,128,19,19,0,0
4672,805,407,994,1052,86,17,13,189,645,0,35,0,1
4673,785,373,967,992,86,17,13,182,619,1,35,0,0
4674,773,380,948,974,86,17,13,175,594,2,35,0,0
4675,760,358,931,936,86,17,13,171,578,3,35,0,0
4676,747,346,905,877,86,17,13,158,531,4,35,0,0
4677,734,331,888,846,86,17,13,154,515,5,35,0,0
4678,714,314,864,817,86,17,13,150,503,6,35,0,0
4679,698,301,845,794,86,17,13,147,493,7,35,0,0
4680,670,293,817,775,86,17,13,147,482,8,35,0,0
4681,657,284,796,735,86,17,13,139,451,9,35,0,0
4682,647,271,783,712,86,17,13,136,441,10,35,0,0
4683,634,266,767,698,86,17,13,133,432,11,35,0,0
4684,621,257,748,670,86,17,13,127,413,12,35,0,0
4685,613,249,739,661,86,17,13,126,412,13,35,0,0
4686,613,243,736,642,86,17,13,123,399,14,35,0,0
4687,613,242,733,628,86,17,13,120,386,15,35,0,0
4688,611,245,728,626,86,17,13,117,381,16,35,0,0
4689,606,247,722,628,86,17,13,116,381,17,35,0,0
4690,600,243,716,627,86,17,13,116,384,18,35,0,0
4691,598,238,711,618,86,17,13,113,380,19,35,0,0
4692,598,240,708,606,86,17,13,110,366,20,35,0,0
4693,605,240,713,598,86,17,13,108,358,21,35,0,0
4694,613,240,719,594,86,17,13,106,354,22,35,0,0
4695,624,236,729,587,86,17,13,105,351,23,35,0,0
4696,635,235,740,585,86,17,13,105,350,24,35,0,0
4697,646,231,751,580,86,17,13,105,349,25,35,0,0
4698,666,234,764,556,86,17,13,98,322,26,35,0,0
4699,679,236,779,557,86,17,13,100,321,27,35,0,0
4700,693,238,793,549,86,17,13,100,311,28,35,0,0
4701,728,236,827,544,86,17,13,99,308,29,35,0,0
4702,749,237,848,542,86,17,13,99,305,30,35,0,0
4703,786,240,881,530,86,17,13,95,290,31,35,0,0
4704,806,241,902,528,86,17,13,96,287,32,35,0,0
4705,823,249,919,528,86,17,13,96,279,33,35,0,0
4706,854,268,942,536,86,17,13,88,268,34,35,0,0
4707,872,271,957,531,86,17,13,85,260,35,35,1,0
4688,691,252,760,587,87,17,13,69,335,0,8,0,0
4689,718,245,782,553,87,17,13,64,308,1,8,0,0
4690,740,250,800,535,87,17,13,60,285,2,8,0,0
4691,757,251,818,530,87,17,13,61,279,3,8,0,0
4692,788,249,850,523,87,17,13,62,274,4,8,0,0
4693,821,247,887,528,87,17,13,66,281,5,8,0,0
4694,835,255,903,529,87,17,13,68,274,6,8,0,0
4695,858,259,924,517,87,17,13,66,258,7,8,0,0
4696,881,260,945,512,87,17,13,64,252,8,8,0,0
4708,1016,796,1283,1074,89,17,13,267,278,0,9,0,0
4709,884,730,1209,1071,89,17,13,325,341,1,9,0,0
4710,758,682,1124,1068,89,17,13,366,386,2,9,0,0
4711,628,620,1044,1067,89,17,13,416,447,3,9,0,0
4712,518,567,977,1068,89,17,13,459,501,4,9,0,0
4713,443,527,930,1068,89,17,13,487,541,5,9,0,0
4714,365,486,874,1071,89,17,13,509,585,6,9,0,0
4715,311,455,822,1068,89,17,13,511,613,7,9,0,0
4716,281,434,767,1042,89,17,13,486,608,8,9,0,0
4717,201,397,715,1039,89,17,13,514,642,9,9,0,0
4717,401,412,556,1002,90,17,13,155,590,0,42,0,1
4718,353,409,512,1009,90,17,13,159,600,1,42,0,0
4719,334,390,496,996,90,17,13,162,606,2,42,0,0
4720,333,372,494,958,90,17,13,161,586,3,42,0,0
4721,352,366,509,931,90,17,13,157,565,4,42,0,0
4722,374,365,531,928,90,17,13,157,563,5,42,0,0
4723,384,363,545,940,90,17,13,161,577,6,42,0,0
4724,385,366,544,933,90,17,13,159,567,7,42,0,0
4725,401,368,561,936,90,17,13,160,568,8,42,0,0
4726,416,371,575,941,90,17,13,159,570,9,42,0,0
4727,414,379,574,944,90,17,13,160,565,10,42,0,0
4728,412,385,573,944,90,17,13,161,559,11,42,0,0
4729,412,382,575,946,90,17,13,163,564,12,42,0,0
4730,411,383,574,948,90,17,13,163,565,13,42,0,0
4731,411,382,575,948,90,17,13,164,566,14,42,0,0
4732,409,381,572,948,90,17,13,163,567,15,42,0,0
4733,401,381,566,950,90,17,13,165,569,16,42,0,0
4734,398,380,563,944,90,17,13,165,564,17,42,0,0
4735,399,380,564,946,90,17,13,165,566,18,42,0,0
4736,406,383,569,944,90,17,13,163,561,19,42,0,0
4737,408,383,570,942,90,17,13,162,559,20,42,0,0
4738,407,385,568,942,90,17,13,161,557,21,42,0,0
4739,404,381,567,948,90,17,13,163,567,22,42,0,0
4740,405,384,567,944,90,17,13,162,560,23,42,0,0
4741,408,385,569,943,90,17,13,161,558,24,42,0,0
4742,411,387,571,941,90,17,13,160,554,25,42,0,0
4743,412,387,572,942,90,17,13,160,555,26,42,0,0
4744,411,387,572,947,90,17,13,161,560,27,42,0,0
4745,412,388,575,949,90,17,13,163,561,28,42,0,0
4746,415,399,577,946,90,17,13,162,547,29,42,0,0
4747,408,401,575,954,90,17,13,167,553,30,42,0,0
4748,390,413,560,972,90,17,13,170,559,31,42,0,0
4749,379,421,546,964,90,17,13,167,543,32,42,0,0
4750,338,428,508,978,90,17,13,170,550,33,42,0,0
4751,288,434,465,1007,90,17,13,177,573,34,42,0,0
4752,274,488,439,1015,90,17,13,165,527,35,42,0,0
4753,262,497,426,1021,90,17,13,164,524,36,42,0,0
4766,614,284,800,892,90,17,13,186,608,0,42,0,1
4767,610,262,786,845,90,17,13,176,583,1,42,0,0
4768,601,245,772,798,90,17,13,171,553,2,42,0,0
4769,584,236,757,777,90,17,13,173,541,3,42,0,0
4770,567,226,730,732,90,17,13,163,506,4,42,0,0
4771,556,221,707,691,90,17,13,151,470,5,42,0,0
4772,543,217,687,670,90,17,13,144,453,6,42,0,0
4773,529,206,663,632,90,17,13,134,426,7,42,0,0
4774,520,196,650,610,90,17,13,130,414,8,42,0,0
4775,511,195,640,602,90,17,13,129,407,9,42,0,0
4776,511,189,631,567,90,17,13,120,378,10,42,0,0
4777,506,178,623,552,90,17,13,117,374,11,42,0,0
4778,503,177,616,545,90,17,13,113,368,12,42,0,0
4779,502,171,610,524,90,17,13,108,353,13,42,0,0
4780,501,168,605,508,90,17,13,104,340,14,42,0,0
4781,502,170,603,499,90,17,13,101,329,15,42,0,0
4782,508,170,603,480,90,17,13,95,310,16,42,0,0
4783,512,172,603,469,90,17,13,91,297,17,42,0,0
4784,513,171,602,464,90,17,13,89,293,18,42,0,0
4785,517,171,601,450,90,17,13,84,279,19,42,0,0
4786,518,161,602,441,90,17,13,84,280,20,42,0,0
4787,518,159,601,436,90,17,13,83,277,21,42,0,0
4788,519,157,600,423,90,17,13,81,266,22,42,0,0
4789,520,158,598,414,90,17,13,78,256,23,42,0,0
4790,521,150,597,402,90,17,13,76,252,24,42,0,0
4791,522,148,595,389,90,17,13,73,241,25,42,0,0
4792,522,145,595,386,90,17,13,73,241,26,42,0,0
4793,525,146,598,387,90,17,13,73,241,27,42,0,0
4794,532,145,603,381,90,17,13,71,236,28,42,0,0
4795,537,140,607,372,90,17,13,70,232,29,42,0,0
4796,542,140,611,370,90,17,13,69,230,30,42,0,0
4797,547,138,615,362,90,17,13,68,224,31,42,0,0
4798,554,137,624,358,90,17,13,70,221,32,42,0,0
4799,564,139,637,356,90,17,13,73,217,33,42,0,0
4800,572,139,648,353,90,17,13,76,214,34,42,0,0
4801,570,141,645,351,90,17,13,75,210,35,42,0,0
4802,575,138,649,345,90,17,13,74,207,36,42,0,0
4803,573,138,649,343,90,17,13,76,205,37,42,0,0
4804,562,137,637,341,90,17,13,75,204,38,42,0,0
4805,562,138,635,339,90,17,13,73,201,39,42,0,0
4806,564,146,629,331,90,17,13,65,185,40,42,0,0
4807,561,164,620,335,90,17,13,59,171,41,42,0,0
4808,562,167,618,332,90,17,13,56,165,42,42,1,0
4726,543,186,580,289,91,17,13,37,103,0,5,0,0
4727,542,186,578,285,91,17,13,36,99,1,5,0,0
4728,542,187,578,284,91,17,13,36,97,2,5,0,0
4729,542,187,577,284,91,17,13,35,97,3,5,0,0
4730,543,186,579,287,91,17,13,36,101,4,5,0,0
4731,543,186,579,288,91,17,13,36,102,5,5,0,0
4749,572,195,607,296,92,17,13,35,101,0,0,0,0
4751,563,185,608,295,93,17,13,45,110,0,43,0,1
4752,552,186,596,293,93,17,13,44,107,1,43,0,0
4753,547,186,590,291,93,17,13,43,105,2,43,0,0
4754,544,173,588,279,93,17,13,44,106,3,43,0,0
4755,540,160,589,280,93,17,13,49,120,4,43,0,0
4756,536,150,591,287,93,17,13,55,137,5,43,0,0
4757,536,146,592,288,93,17,13,56,142,6,43,0,0
4758,536,144,591,287,93,17,13,55,143,7,43,0,0
4759,536,147,589,284,93,17,13,53,137,8,43,0,0
4760,538,146,588,281,93,17,13,50,135,9,43,0,0
4761,537,151,585,281,93,17,13,48,130,10,43,0,0
4762,538,152,584,282,93,17,13,46,130,11,43,0,0
4763,539,150,584,278,93,17,13,45,128,12,43,0,0
4764,538,146,585,283,93,17,13,47,137,13,43,0,0
4765,539,149,584,284,93,17,13,45,135,14,43,0,0
4766,541,146,585,283,93,17,13,44,137,15,43,0,0
4767,542,144,586,283,93,17,13,44,139,16,43,0,0
4768,543,147,586,283,93,17,13,43,136,17,43,0,0
4769,543,149,586,286,93,17,13,43,137,18,43,0,0
4770,543,151,587,291,93,17,13,44,140,19,43,0,0
4771,542,152,587,297,93,17,13,45,145,20,43,0,0
4772,544,172,584,300,93,17,13,40,128,21,43,0,0
4773,543,173,584,302,93,17,13,41,129,22,43,0,0
4785,493,149,542,298,93,17,13,49,149,0,43,0,1
4786,481,145,530,298,93,17,13,49,153,1,43,0,0
4787,469,144,517,297,93,17,13,48,153,2,43,0,0
4788,455,143,502,293,93,17,13,47,150,3,43,0,0
4789,441,143,490,291,93,17,13,49,148,4,43,0,0
4790,431,142,481,290,93,17,13,50,148,5,43,0,0
4791,421,139,469,283,93,17,13,48,144,6,43,0,0
4792,404,134,454,278,93,17,13,50,144,7,43,0,0
4793,393,131,444,274,93,17,13,51,143,8,43,0,0
4794,387,131,439,274,93,17,13,52,143,9,43,0,0
4795,383,131,434,271,93,17,13,51,140,10,43,0,0
4796,376,131,427,269,93,17,13,51,138,11,43,0,0
4797,368,131,419,268,93,17,13,51,137,12,43,0,0
4798,362,131,413,264,93,17,13,51,133,13,43,0,0
4799,358,130,409,263,93,17,13,51,133,14,43,0,0
4800,354,131,406,264,93,17,13,52,133,15,43,0,0
4801,348,128,402,264,93,17,13,54,136,16,43,0,0
4802,346,127,400,263,93,17,13,54,136,17,43,0,0
4803,343,126,397,264,93,17,13,54,138,18,43,0,0
4804,340,127,394,265,93,17,13,54,138,19,43,0,0
4805,339,126,394,266,93,17,13,55,140,20,43,0,0
4806,342,125,396,264,93,17,13,54,139,21,43,0,0
4807,343,126,397,263,93,17,13,54,137,22,43,0,0
4808,344,126,397,263,93,17,13,53,137,23,43,0,0
4809,343,126,397,262,93,17,13,54,136,24,43,0,0
4810,344,126,398,263,93,17,13,54,137,25,43,0,0
4811,342,126,397,264,93,17,13,55,138,26,43,0,0
4812,342,125,397,265,93,17,13,55,140,27,43,0,0
4813,342,125,396,263,93,17,13,54,138,28,43,0,0
4814,341,127,394,262,93,17,13,53,135,29,43,0,0
4815,339,127,392,262,93,17,13,53,135,30,43,0,0
4816,335,129,387,262,93,17,13,52,133,31,43,0,0
4817,334,129,383,262,93,17,13,49,133,32,43,0,0
4818,334,131,381,263,93,17,13,47,132,33,43,0,0
4819,334,132,379,261,93,17,13,45,129,34,43,0,0
4820,332,130,377,260,93,17,13,45,130,35,43,0,0
4821,331,132,374,259,93,17,13,43,127,36,43,0,0
4822,330,132,372,259,93,17,13,42,127,37,43,0,0
4823,328,129,369,260,93,17,13,41,131,38,43,0,0
4824,329,126,369,260,93,17,13,40,134,39,43,0,0
4825,331,126,371,261,93,17,13,40,135,40,43,0,0
4826,334,129,372,261,93,17,13,38,132,41,43,0,0
4827,335,130,373,261,93,17,13,38,131,42,43,0,0
4828,334,130,372,261,93,17,13,38,131,43,43,1,0
4833,338,130,376,260,93,17,13,38,130,0,43,0,0
4834,338,130,375,259,93,17,13,37,129,1,43,0,0
4835,337,130,375,260,93,17,13,38,130,2,43,0,0
4836,335,129,372,260,93,17,13,37,131,3,43,0,0
4837,334,127,371,261,93,17,13,37,134,4,43,0,0
4838,336,130,372,260,93,17,13,36,130,5,43,0,0
4839,336,130,372,260,93,17,13,36,130,6,43,0,0
4840,336,132,371,260,93,17,13,35,128,7,43,0,0
4753,1368,758,1660,1070,95,17,13,292,312,0,0,0,0
4754,1190,668,1494,1071,96,17,13,304,403,0,12,0,0
4755,1085,593,1442,1067,96,17,13,357,474,1,12,0,0
4756,980,549,1370,1066,96,17,13,390,517,2,12,0,0
4757,886,511,1303,1067,96,17,13,417,556,3,12,0,0
4758,814,461,1260,1062,96,17,13,446,601,4,12,0,0
4759,756,418,1216,1052,96,17,13,460,634,5,12,0,0
4760,689,408,1150,1057,96,17,13,461,649,6,12,0,0
4761,637,378,1102,1054,96,17,13,465,676,7,12,0,0
4762,595,344,1067,1057,96,17,13,472,713,8,12,0,0
4763,558,323,1018,1043,96,17,13,460,720,9,12,0,0
4764,548,295,962,968,96,17,13,414,673,10,12,0,0
4765,538,280,917,921,96,17,13,379,641,11,12,0,0
4766,486,251,874,907,96,17,13,388,656,12,12,0,0
4784,499,148,552,328,98,17,13,53,180,0,0,0,0
4965,291,320,422,748,100,17,13,131,428,0,19,0,1
4966,305,326,435,752,100,17,13,130,426,1,19,0,0
4967,341,334,470,754,100,17,13,129,420,2,19,0,0
4968,388,345,524,780,100,17,13,136,435,3,19,0,0
4969,421,349,574,835,100,17,13,153,486,4,19,0,0
4970,470,360,625,841,100,17,13,155,481,5,19,0,0
4971,526,369,687,868,100,17,13,161,499,6,19,0,0
4972,576,381,743,883,100,17,13,167,502,7,19,0,0
4973,622,404,803,936,100,17,13,181,532,8,19,0,0
4974,675,429,864,970,100,17,13,189,541,9,19,0,0
4975,726,450,929,1026,100,17,13,203,576,10,19,0,0
4976,781,489,988,1071,100,17,13,207,582,11,19,0,0
4977,856,517,1064,1080,100,17,13,208,563,12,19,0,0
4978,922,556,1126,1080,100,17,13,204,524,13,19,0,0
4979,1016,597,1211,1080,100,17,13,195,483,14,19,0,0
4980,1108,647,1296,1080,100,17,13,188,433,15,19,0,0
4981,1216,714,1386,1080,100,17,13,170,366,16,19,0,0
4982,1352,776,1506,1080,100,17,13,154,304,17,19,0,0
4983,1495,842,1627,1076,100,17,13,132,234,18,19,0,0
4984,1591,884,1705,1080,100,17,13,114,196,19,19,0,0
5158,547,133,604,346,102,17,13,57,213,0,55,0,1
5159,539,139,593,341,102,17,13,54,202,1,55,0,0
5160,511,135,569,346,102,17,13,58,211,2,55,0,0
5161,499,134,559,348,102,17,13,60,214,3,55,0,0
5162,485,132,546,347,102,17,13,61,215,4,55,0,0
5163,471,138,531,349,102,17,13,60,211,5,55,0,0
5164,460,136,522,352,102,17,13,62,216,6,55,0,0
5165,450,134,513,352,102,17,13,63,218,7,55,0,0
5166,441,137,507,361,102,17,13,66,224,8,55,0,0
5167,434,139,501,367,102,17,13,67,228,9,55,0,0
5168,427,140,495,372,102,17,13,68,232,10,55,0,0
5169,423,141,492,375,102,17,13,69,234,11,55,0,0
5170,420,141,492,384,102,17,13,72,243,12,55,0,0
5171,417,140,491,387,102,17,13,74,247,13,55,0,0
5172,412,143,489,396,102,17,13,77,253,14,55,0,0
5173,408,145,487,404,102,17,13,79,259,15,55,0,0
5174,402,142,483,406,102,17,13,81,264,16,55,0,0
5175,396,146,481,421,102,17,13,85,275,17,55,0,0
5176,393,151,481,437,102,17,13,88,286,18,55,0,0
5177,395,154,483,438,102,17,13,88,284,19,55,0,0
5178,392,153,487,457,102,17,13,95,304,20,55,0,0
5179,392,162,488,465,102,17,13,96,303,21,55,0,0
5180,392,164,487,467,102,17,13,95,303,22,55,0,0
5181,391,169,488,477,102,17,13,97,308,23,55,0,0
5182,392,175,491,493,102,17,13,99,318,24,55,0,0
5183,392,176,493,504,102,17,13,101,328,25,55,0,0
5184,391,179,497,517,102,17,13,106,338,26,55,0,0
5185,389,184,501,537,102,17,13,112,353,27,55,0,0
5186,387,185,503,551,102,17,13,116,366,28,55,0,0
5187,395,188,514,565,102,17,13,119,377,29,55,0,0
5188,407,197,528,586,102,17,13,121,389,30,55,0,0
5189,425,196,548,591,102,17,13,123,395,31,55,0,0
5190,442,201,567,601,102,17,13,125,400,32,55,0,0
5191,457,209,592,636,102,17,13,135,427,33,55,0,0
5192,476,211,613,650,102,17,13,137,439,34,55,0,0
5193,496,215,638,675,102,17,13,142,460,35,55,0,0
5194,512,224,660,708,102,17,13,148,484,36,55,0,0
5195,536,229,687,724,102,17,13,151,495,37,55,0,0
5196,545,236,709,762,102,17,13,164,526,38,55,0,0
5197,561,253,735,800,102,17,13,174,547,39,55,0,0
5198,579,258,757,820,102,17,13,178,562,40,55,0,0
5199,596,270,781,858,102,17,13,185,588,41,55,0,0
5200,616,291,811,919,102,17,13,195,628,42,55,0,0
5201,638,294,837,935,102,17,13,199,641,43,55,0,0
5202,656,314,871,1000,102,17,13,215,686,44,55,0,0
5203,672,327,899,1039,102,17,13,227,712,45,55,0,0
5204,683,343,913,1064,102,17,13,230,721,46,55,0,0
5205,706,372,921,1030,102,17,13,215,658,47,55,0,0
5206,729,411,949,1064,102,17,13,220,653,48,55,0,0
5207,755,429,982,1077,102,17,13,227,648,49,55,0,0
5208,779,464,1009,1080,102,17,13,230,616,50,55,0,0
5209,802,529,1027,1079,102,17,13,225,550,51,55,0,0
5210,840,583,1061,1079,102,17,13,221,496,52,55,0,0
5211,890,660,1099,1078,102,17,13,209,418,53,55,0,0
5212,1012,794,1175,1072,102,17,13,163,278,54,55,0,0
5213,1061,844,1201,1080,102,17,13,140,236,55,55,1,0
5238,1194,706,1504,1065,105,17,13,310,359,0,29,0,1
5239,1076,605,1471,1064,105,17,13,395,459,1,29,0,0
5240,973,542,1424,1069,105,17,13,451,527,2,29,0,0
5241,874,486,1365,1067,105,17,13,491,581,3,29,0,0
5242,808,429,1335,1064,105,17,13,527,635,4,29,0,0
5243,744,400,1283,1066,105,17,13,539,666,5,29,0,0
5244,707,386,1221,1039,105,17,13,514,653,6,29,0,0
5245,667,341,1173,1011,105,17,13,506,670,7,29,0,0
5246,632,314,1127,995,105,17,13,495,681,8,29,0,0
5247,612,296,1077,961,105,17,13,465,665,9,29,0,0
5248,616,276,1021,878,105,17,13,405,602,10,29,0,0
5249,617,269,983,838,105,17,13,366,569,11,29,0,0
5250,617,255,953,802,105,17,13,336,547,12,29,0,0
5251,624,233,924,743,105,17,13,300,510,13,29,0,0
5252,634,232,910,719,105,17,13,276,487,14,29,0,0
5253,651,219,899,674,105,17,13,248,455,15,29,0,0
5254,658,215,889,654,105,17,13,231,439,16,29,0,0
5255,665,217,881,644,105,17,13,216,427,17,29,0,0
5256,672,211,867,610,105,17,13,195,399,18,29,0,0
5257,678,206,861,593,105,17,13,183,387,19,29,0,0
5258,685,206,859,585,105,17,13,174,379,20,29,0,0
5259,693,199,856,560,105,17,13,163,361,21,29,0,0
5260,696,191,853,548,105,17,13,157,357,22,29,0,0
5261,698,188,851,541,105,17,13,153,353,23,29,0,0
5262,705,191,850,528,105,17,13,145,337,24,29,0,0
5263,717,199,856,523,105,17,13,139,324,25,29,0,0
5264,753,213,885,516,105,17,13,132,303,26,29,0,0
5265,795,218,923,513,105,17,13,128,295,27,29,0,0
5266,819,246,935,514,105,17,13,116,268,28,29,0,0
5267,830,249,940,503,105,17,13,110,254,29,29,1,0
5991,533,131,586,283,106,17,13,53,152,0,9,0,0
5992,526,135,570,261,106,17,13,44,126,1,9,0,0
5993,514,139,555,258,106,17,13,41,119,2,9,0,0
5994,494,139,535,258,106,17,13,41,119,3,9,0,0
5995,476,143,516,257,106,17,13,40,114,4,9,0,0
5996,460,137,503,261,106,17,13,43,124,5,9,0,0
5997,441,133,487,263,106,17,13,46,130,6,9,0,0
5998,425,135,471,267,106,17,13,46,132,7,9,0,0
5999,410,139,453,263,106,17,13,43,124,8,9,0,0
6000,389,135,435,261,106,17,13,46,126,9,9,0,0
3838,1,454,50,782,1,17,14,49,328,0,105,0,1
3839,6,474,47,748,1,17,14,41,274,1,105,0,0
3840,9,471,62,820,1,17,14,53,349,2,105,0,0
3841,14,462,73,842,1,17,14,59,380,3,105,0,0
3842,38,484,100,853,1,17,14,62,369,4,105,0,0
3843,45,481,112,857,1,17,14,67,376,5,105,0,0
3844,50,475,122,859,1,17,14,72,384,6,105,0,0
3845,63,483,142,876,1,17,14,79,393,7,105,0,0
3846,75,484,170,921,1,17,14,95,437,8,105,0,0
3847,85,477,191,935,1,17,14,106,458,9,105,0,0
3848,119,485,238,947,1,17,14,119,462,10,105,0,0
3849,147,493,280,963,1,17,14,133,470,11,105,0,0
3850,165,490,309,975,1,17,14,144,485,12,105,0,0
3851,183,486,343,1008,1,17,14,160,522,13,105,0,0
3852,215,494,392,1044,1,17,14,177,550,14,105,0,0
3853,235,495,419,1052,1,17,14,184,557,15,105,0,0
3854,283,494,482,1063,1,17,14,199,569,16,105,0,0
3855,345,507,553,1074,1,17,14,208,567,17,105,0,0
3856,393,498,609,1078,1,17,14,216,580,18,105,0,0
3857,453,486,679,1080,1,17,14,226,594,19,105,0,0
3858,539,491,770,1080,1,17,14,231,589,20,105,0,0
3859,605,483,834,1073,1,17,14,229,590,21,105,0,0
3860,679,471,914,1078,1,17,14,235,607,22,105,0,0
3861,758,466,999,1079,1,17,14,241,613,23,105,0,0
3862,844,457,1085,1073,1,17,14,241,616,24,105,0,0
3863,925,442,1171,1078,1,17,14,246,636,25,105,0,0
3864,1006,440,1256,1069,1,17,14,250,629,26,105,0,0
3865,1068,428,1322,1059,1,17,14,254,631,27,105,0,0
3866,1157,410,1409,1043,1,17,14,252,633,28,105,0,0
3867,1222,413,1467,1037,1,17,14,245,624,29,105,0,0
3868,1271,410,1510,1025,1,17,14,239,615,30,105,0,0
3869,1325,394,1549,979,1,17,14,224,585,31,105,0,0
3870,1369,379,1588,960,1,17,14,219,581,32,105,0,0
3871,1407,374,1618,939,1,17,14,211,565,33,105,0,0
3872,1454,356,1652,889,1,17,14,198,533,34,105,0,0
3873,1486,343,1675,862,1,17,14,189,519,35,105,0,0
3874,1497,337,1682,851,1,17,14,185,514,36,105,0,0
3875,1509,327,1678,804,1,17,14,169,477,37,105,0,0
3876,1513,319,1674,775,1,17,14,161,456,38,105,0,0
3877,1523,319,1676,757,1,17,14,153,438,39,105,0,0
3878,1534,307,1679,727,1,17,14,145,420,40,105,0,0
3879,1542,297,1683,710,1,17,14,141,413,41,105,0,0
3880,1541,295,1677,701,1,17,14,136,406,42,105,0,0
3881,1539,284,1667,665,1,17,14,128,381,43,105,0,0
3882,1536,276,1660,653,1,17,14,124,377,44,105,0,0
3883,1537,273,1657,642,1,17,14,120,369,45,105,0,0
3884,1548,272,1660,615,1,17,14,112,343,46,105,0,0
3885,1555,265,1665,603,1,17,14,110,338,47,105,0,0
3886,1557,261,1667,602,1,17,14,110,341,48,105,0,0
3887,1554,254,1658,582,1,17,14,104,328,49,105,0,0
3888,1553,248,1653,565,1,17,14,100,317,50,105,0,0
3889,1557,246,1651,548,1,17,14,94,302,51,105,0,0
3890,1565,245,1656,536,1,17,14,91,291,52,105,0,0
3891,1571,244,1659,526,1,17,14,88,282,53,105,0,0
3892,1571,241,1660,528,1,17,14,89,287,54,105,0,0
3893,1569,237,1654,511,1,17,14,85,274,55,105,0,0
3894,1568,234,1651,500,1,17,14,83,266,56,105,0,0
3895,1569,234,1651,498,1,17,14,82,264,57,105,0,0
3896,1576,232,1655,487,1,17,14,79,255,58,105,0,0
3897,1582,228,1658,477,1,17,14,76,249,59,105,0,0
3898,1583,228,1658,472,1,17,14,75,244,60,105,0,0
3899,1583,225,1655,460,1,17,14,72,235,61,105,0,0
3900,1582,220,1654,453,1,17,14,72,233,62,105,0,0
3901,1584,219,1653,445,1,17,14,69,226,63,105,0,0
3902,1586,215,1656,441,1,17,14,70,226,64,105,0,0
3903,1589,211,1658,432,1,17,14,69,221,65,105,0,0
3904,1591,212,1657,428,1,17,14,66,216,66,105,0,0
3905,1591,210,1656,424,1,17,14,65,214,67,105,0,0
3906,1591,206,1655,414,1,17,14,64,208,68,105,0,0
3907,1592,206,1654,408,1,17,14,62,202,69,105,0,0
3908,1593,205,1655,403,1,17,14,62,198,70,105,0,0
3909,1595,202,1656,398,1,17,14,61,196,71,105,0,0
3910,1596,202,1657,396,1,17,14,61,194,72,105,0,0
3911,1595,201,1655,394,1,17,14,60,193,73,105,0,0
3912,1593,199,1652,388,1,17,14,59,189,74,105,0,0
3913,1592,199,1650,382,1,17,14,58,183,75,105,0,0
3914,1593,198,1650,380,1,17,14,57,182,76,105,0,0
3915,1593,197,1649,372,1,17,14,56,175,77,105,0,0
3916,1593,195,1648,368,1,17,14,55,173,78,105,0,0
3917,1593,195,1647,367,1,17,14,54,172,79,105,0,0
3918,1589,193,1643,360,1,17,14,54,167,80,105,0,0
3919,1589,194,1640,357,1,17,14,51,163,81,105,0,0
3920,1590,193,1641,354,1,17,14,51,161,82,105,0,0
3921,1591,188,1643,351,1,17,14,52,163,83,105,0,0
3922,1594,188,1645,348,1,17,14,51,160,84,105,0,0
3923,1594,189,1645,347,1,17,14,51,158,85,105,0,0
3924,1595,187,1643,339,1,17,14,48,152,86,105,0,0
3925,1596,186,1644,335,1,17,14,48,149,87,105,0,0
3926,1600,187,1647,334,1,17,14,47,147,88,105,0,0
3927,1603,186,1649,332,1,17,14,46,146,89,105,0,0
3928,1605,186,1650,328,1,17,14,45,142,90,105,0,0
3929,1606,185,1652,328,1,17,14,46,143,91,105,0,0
3930,1606,184,1650,323,1,17,14,44,139,92,105,0,0
3931,1607,184,1650,321,1,17,14,43,137,93,105,0,0
3932,1609,186,1651,320,1,17,14,42,134,94,105,0,0
3933,1611,182,1653,317,1,17,14,42,135,95,105,0,0
3934,1612,180,1654,314,1,17,14,42,134,96,105,0,0
3935,1612,180,1653,314,1,17,14,41,134,97,105,0,0
3936,1611,180,1651,310,1,17,14,40,130,98,105,0,0
3937,1609,179,1648,307,1,17,14,39,128,99,105,0,0
3938,1609,179,1648,308,1,17,14,39,129,100,105,0,0
3939,1610,177,1648,303,1,17,14,38,126,101,105,0,0
3940,1610,176,1648,299,1,17,14,38,123,102,105,0,0
3941,1610,175,1646,298,1,17,14,36,123,103,105,0,0
3942,1609,174,1644,293,1,17,14,35,119,104,105,0,0
3943,1609,174,1644,290,1,17,14,35,116,105,105,1,0
3845,5,504,81,805,2,17,14,76,301,0,102,0,1
3846,2,492,85,821,2,17,14,83,329,1,102,0,0
3847,1,497,87,838,2,17,14,86,341,2,102,0,0
3848,4,490,98,862,2,17,14,94,372,3,102,0,0
3849,11,477,111,867,2,17,14,100,390,4,102,0,0
3850,27,466,137,882,2,17,14,110,416,5,102,0,0
3851,39,461,159,894,2,17,14,120,433,6,102,0,0
3852,47,466,171,906,2,17,14,124,440,7,102,0,0
3853,59,473,198,946,2,17,14,139,473,8,102,0,0
3854,74,486,219,962,2,17,14,145,476,9,102,0,0
3855,89,485,244,980,2,17,14,155,495,10,102,0,0
3856,129,499,293,992,2,17,14,164,493,11,102,0,0
3857,164,498,339,1004,2,17,14,175,506,12,102,0,0
3858,183,499,362,1011,2,17,14,179,512,13,102,0,0
3859,228,503,422,1037,2,17,14,194,534,14,102,0,0
3860,272,507,476,1056,2,17,14,204,549,15,102,0,0
3861,338,512,537,1027,2,17,14,199,515,16,102,0,0
3862,404,518,620,1059,2,17,14,216,541,17,102,0,0
3863,461,498,693,1077,2,17,14,232,579,18,102,0,0
3864,531,480,770,1080,2,17,14,239,600,19,102,0,0
3865,611,459,861,1080,2,17,14,250,621,20,102,0,0
3866,725,434,976,1056,2,17,14,251,622,21,102,0,0
3867,815,424,1074,1067,2,17,14,259,643,22,102,0,0
3868,911,427,1178,1074,2,17,14,267,647,23,102,0,0
3869,986,433,1251,1075,2,17,14,265,642,24,102,0,0
3870,1029,424,1293,1074,2,17,14,264,650,25,102,0,0
3871,1095,421,1356,1072,2,17,14,261,651,26,102,0,0
3872,1170,409,1416,1026,2,17,14,246,617,27,102,0,0
3873,1229,390,1464,981,2,17,14,235,591,28,102,0,0
3874,1267,388,1488,953,2,17,14,221,565,29,102,0,0
3875,1301,368,1505,892,2,17,14,204,524,30,102,0,0
3876,1328,349,1524,858,2,17,14,196,509,31,102,0,0
3877,1348,339,1541,847,2,17,14,193,508,32,102,0,0
3878,1377,328,1560,812,2,17,14,183,484,33,102,0,0
3879,1398,315,1574,785,2,17,14,176,470,34,102,0,0
3880,1408,309,1579,777,2,17,14,171,468,35,102,0,0
3881,1418,299,1577,737,2,17,14,159,438,36,102,0,0
3882,1425,287,1576,708,2,17,14,151,421,37,102,0,0
3883,1431,286,1577,696,2,17,14,146,410,38,102,0,0
3884,1443,276,1583,674,2,17,14,140,398,39,102,0,0
3885,1452,268,1586,655,2,17,14,134,387,40,102,0,0
3886,1457,266,1590,651,2,17,14,133,385,41,102,0,0
3887,1463,257,1588,622,2,17,14,125,365,42,102,0,0
3888,1463,249,1585,605,2,17,14,122,356,43,102,0,0
3889,1467,251,1583,596,2,17,14,116,345,44,102,0,0
3890,1478,249,1588,577,2,17,14,110,328,45,102,0,0
3891,1484,243,1591,565,2,17,14,107,322,46,102,0,0
3892,1487,242,1593,565,2,17,14,106,323,47,102,0,0
3893,1491,237,1590,539,2,17,14,99,302,48,102,0,0
3894,1490,234,1586,529,2,17,14,96,295,49,102,0,0
3895,1494,233,1587,519,2,17,14,93,286,50,102,0,0
3896,1504,227,1595,507,2,17,14,91,280,51,102,0,0
3897,1509,224,1598,497,2,17,14,89,273,52,102,0,0
3898,1514,226,1596,479,2,17,14,82,253,53,102,0,0
3899,1513,223,1594,472,2,17,14,81,249,54,102,0,0
3900,1512,217,1594,470,2,17,14,82,253,55,102,0,0
3901,1514,219,1596,469,2,17,14,82,250,56,102,0,0
3902,1520,216,1599,459,2,17,14,79,243,57,102,0,0
3903,1521,210,1599,451,2,17,14,78,241,58,102,0,0
3904,1521,210,1598,448,2,17,14,77,238,59,102,0,0
3905,1523,208,1597,437,2,17,14,74,229,60,102,0,0
3906,1523,204,1597,431,2,17,14,74,227,61,102,0,0
3907,1524,203,1596,428,2,17,14,72,225,62,102,0,0
3908,1526,202,1598,423,2,17,14,72,221,63,102,0,0
3909,1527,198,1598,416,2,17,14,71,218,64,102,0,0
3910,1530,199,1599,408,2,17,14,69,209,65,102,0,0
3911,1531,200,1598,402,2,17,14,67,202,66,102,0,0
3912,1532,200,1597,398,2,17,14,65,198,67,102,0,0
3913,1533,201,1596,393,2,17,14,63,192,68,102,0,0
3914,1534,200,1597,392,2,17,14,63,192,69,102,0,0
3915,1536,198,1597,386,2,17,14,61,188,70,102,0,0
3916,1534,196,1594,384,2,17,14,60,188,71,102,0,0
3917,1534,197,1592,379,2,17,14,58,182,72,102,0,0
3918,1534,191,1592,372,2,17,14,58,181,73,102,0,0
3919,1535,191,1592,368,2,17,14,57,177,74,102,0,0
3920,1537,193,1592,367,2,17,14,55,174,75,102,0,0
3921,1538,186,1595,365,2,17,14,57,179,76,102,0,0
3922,1541,183,1597,361,2,17,14,56,178,77,102,0,0
3923,1541,183,1597,360,2,17,14,56,177,78,102,0,0
3924,1544,184,1597,352,2,17,14,53,168,79,102,0,0
3925,1546,186,1597,347,2,17,14,51,161,80,102,0,0
3926,1551,186,1600,345,2,17,14,49,159,81,102,0,0
3927,1555,184,1604,339,2,17,14,49,155,82,102,0,0
3928,1558,185,1605,333,2,17,14,47,148,83,102,0,0
3929,1560,184,1607,332,2,17,14,47,148,84,102,0,0
3930,1560,184,1606,328,2,17,14,46,144,85,102,0,0
3931,1560,184,1606,326,2,17,14,46,142,86,102,0,0
3932,1563,183,1608,324,2,17,14,45,141,87,102,0,0
3933,1565,181,1611,323,2,17,14,46,142,88,102,0,0
3934,1566,178,1612,321,2,17,14,46,143,89,102,0,0
3935,1568,180,1612,319,2,17,14,44,139,90,102,0,0
3936,1566,177,1610,317,2,17,14,44,140,91,102,0,0
3937,1567,175,1611,318,2,17,14,44,143,92,102,0,0
3938,1568,175,1612,317,2,17,14,44,142,93,102,0,0
3939,1568,174,1612,314,2,17,14,44,140,94,102,0,0
3940,1570,173,1612,312,2,17,14,42,139,95,102,0,0
3941,1571,174,1612,308,2,17,14,41,134,96,102,0,0
3942,1571,172,1611,300,2,17,14,40,128,97,102,0,0
3943,1573,173,1611,297,2,17,14,38,124,98,102,0,0
3944,1575,174,1612,294,2,17,14,37,120,99,102,0,0
3945,1578,174,1615,291,2,17,14,37,117,100,102,0,0
3946,1580,173,1617,289,2,17,14,37,116,101,102,0,0
3947,1581,173,1616,286,2,17,14,35,113,102,102,1,0
3847,61,445,113,531,3,17,14,52,86,0,4,0,0
3848,73,451,136,557,3,17,14,63,106,1,4,0,0
3849,63,446,169,623,3,17,14,106,177,2,4,0,0
3850,61,448,203,690,3,17,14,142,242,3,4,0,0
3851,59,447,221,725,3,17,14,162,278,4,4,0,0
3852,148,449,249,770,4,17,14,101,321,0,75,0,0
3853,172,448,266,746,4,17,14,94,298,1,75,0,0
3854,201,455,312,807,4,17,14,111,352,2,75,0,0
3855,240,451,354,816,4,17,14,114,365,3,75,0,0
3856,283,454,418,877,4,17,14,135,423,4,75,0,0
3857,334,461,483,921,4,17,14,149,460,5,75,0,0
3858,369,461,532,949,4,17,14,163,488,6,75,0,0
3859,401,456,569,952,4,17,14,168,496,7,75,0,0
3860,457,453,639,975,4,17,14,182,522,8,75,0,0
3861,500,453,693,1003,4,17,14,193,550,9,75,0,0
3862,558,453,758,1011,4,17,14,200,558,10,75,0,0
3863,626,448,841,1025,4,17,14,215,577,11,75,0,0
3864,683,446,902,1027,4,17,14,219,581,12,75,0,0
3865,727,446,954,1049,4,17,14,227,603,13,75,0,0
3872,1109,376,1285,854,4,17,14,176,478,0,75,0,1
3873,1152,373,1326,860,4,17,14,174,487,1,75,0,0
3874,1189,357,1357,842,4,17,14,168,485,2,75,0,0
3875,1212,339,1379,837,4,17,14,167,498,3,75,0,0
3876,1239,336,1399,830,4,17,14,160,494,4,75,0,0
3877,1271,331,1417,790,4,17,14,146,459,5,75,0,0
3878,1289,320,1428,762,4,17,14,139,442,6,75,0,0
3879,1300,317,1437,756,4,17,14,137,439,7,75,0,0
3880,1311,308,1446,741,4,17,14,135,433,8,75,0,0
3881,1322,296,1448,704,4,17,14,126,408,9,75,0,0
3882,1332,293,1452,690,4,17,14,120,397,10,75,0,0
3883,1342,283,1458,675,4,17,14,116,392,11,75,0,0
3884,1350,273,1462,649,4,17,14,112,376,12,75,0,0
3885,1360,271,1469,645,4,17,14,109,374,13,75,0,0
3886,1360,262,1467,628,4,17,14,107,366,14,75,0,0
3887,1365,255,1465,602,4,17,14,100,347,15,75,0,0
3888,1375,254,1473,592,4,17,14,98,338,16,75,0,0
3889,1385,254,1481,587,4,17,14,96,333,17,75,0,0
3890,1395,249,1486,563,4,17,14,91,314,18,75,0,0
3891,1399,248,1487,552,4,17,14,88,304,19,75,0,0
3892,1399,241,1488,547,4,17,14,89,306,20,75,0,0
3893,1402,237,1487,529,4,17,14,85,292,21,75,0,0
3894,1406,237,1488,521,4,17,14,82,284,22,75,0,0
3895,1412,233,1492,511,4,17,14,80,278,23,75,0,0
3896,1420,228,1496,493,4,17,14,76,265,24,75,0,0
3897,1426,227,1500,486,4,17,14,74,259,25,75,0,0
3898,1428,226,1500,478,4,17,14,72,252,26,75,0,0
3899,1430,221,1501,470,4,17,14,71,249,27,75,0,0
3900,1433,221,1501,463,4,17,14,68,242,28,75,0,0
3901,1437,217,1505,459,4,17,14,68,242,29,75,0,0
3902,1440,212,1507,453,4,17,14,67,241,30,75,0,0
3903,1441,212,1507,447,4,17,14,66,235,31,75,0,0
3904,1440,211,1506,443,4,17,14,66,232,32,75,0,0
3905,1441,208,1505,434,4,17,14,64,226,33,75,0,0
3906,1442,207,1503,423,4,17,14,61,216,34,75,0,0
3907,1446,206,1506,420,4,17,14,60,214,35,75,0,0
3908,1451,203,1510,411,4,17,14,59,208,36,75,0,0
3909,1457,203,1513,404,4,17,14,56,201,37,75,0,0
3910,1461,202,1517,402,4,17,14,56,200,38,75,0,0
3911,1465,200,1522,397,4,17,14,57,197,39,75,0,0
3912,1470,201,1525,392,4,17,14,55,191,40,75,0,0
3913,1476,200,1531,393,4,17,14,55,193,41,75,0,0
3914,1481,199,1534,385,4,17,14,53,186,42,75,0,0
3915,1485,199,1536,378,4,17,14,51,179,43,75,0,0
3916,1486,199,1537,376,4,17,14,51,177,44,75,0,0
3917,1486,195,1537,372,4,17,14,51,177,45,75,0,0
3918,1486,195,1536,370,4,17,14,50,175,46,75,0,0
3919,1488,197,1536,367,4,17,14,48,170,47,75,0,0
3920,1490,194,1538,365,4,17,14,48,171,48,75,0,0
3921,1492,190,1540,358,4,17,14,48,168,49,75,0,0
3922,1493,188,1541,356,4,17,14,48,168,50,75,0,0
3923,1493,186,1541,356,4,17,14,48,170,51,75,0,0
3924,1494,188,1540,351,4,17,14,46,163,52,75,0,0
3925,1496,185,1542,347,4,17,14,46,162,53,75,0,0
3926,1499,186,1543,342,4,17,14,44,156,54,75,0,0
3927,1501,184,1545,338,4,17,14,44,154,55,75,0,0
3928,1503,185,1545,330,4,17,14,42,145,56,75,0,0
3929,1503,182,1546,329,4,17,14,43,147,57,75,0,0
3930,1506,181,1548,322,4,17,14,42,141,58,75,0,0
3931,1510,179,1553,324,4,17,14,43,145,59,75,0,0
3932,1514,178,1558,326,4,17,14,44,148,60,75,0,0
3933,1518,178,1560,322,4,17,14,42,144,61,75,0,0
3934,1520,178,1562,318,4,17,14,42,140,62,75,0,0
3935,1522,177,1563,316,4,17,14,41,139,63,75,0,0
3936,1524,177,1565,314,4,17,14,41,137,64,75,0,0
3937,1527,178,1567,313,4,17,14,40,135,65,75,0,0
3938,1529,177,1571,313,4,17,14,42,136,66,75,0,0
3939,1531,176,1571,311,4,17,14,40,135,67,75,0,0
3940,1531,176,1572,310,4,17,14,41,134,68,75,0,0
3941,1530,174,1570,303,4,17,14,40,129,69,75,0,0
3942,1531,173,1570,299,4,17,14,39,126,70,75,0,0
3943,1534,174,1571,293,4,17,14,37,119,71,75,0,0
3944,1537,173,1573,288,4,17,14,36,115,72,75,0,0
3945,1539,170,1575,285,4,17,14,36,115,73,75,0,0
3946,1540,169,1575,283,4,17,14,35,114,74,75,0,0
3947,1540,169,1575,281,4,17,14,35,112,75,75,1,0
3949,1541,169,1576,279,4,17,14,35,110,0,75,0,0
3868,938,401,1069,604,5,17,14,131,203,0,4,0,0
3869,976,396,1108,601,5,17,14,132,205,1,4,0,0
3870,1034,395,1157,589,5,17,14,123,194,2,4,0,0
3871,1087,380,1229,607,5,17,14,142,227,3,4,0,0
3872,1124,374,1272,610,5,17,14,148,236,4,4,0,0
3870,1013,573,1119,941,6,17,14,106,368,0,0,0,0
4153,2,482,49,762,13,17,14,47,280,0,0,0,0
4155,0,485,114,783,14,17,14,114,298,0,31,0,1
4156,5,474,125,786,14,17,14,120,312,1,31,0,0
4157,13,468,136,787,14,17,14,123,319,2,31,0,0
4158,21,465,146,787,14,17,14,125,322,3,31,0,0
4159,50,473,188,823,14,17,14,138,350,4,31,0,0
4160,64,459,213,836,14,17,14,149,377,5,31,0,0
4161,101,455,259,847,14,17,14,158,392,6,31,0,0
4162,140,450,309,860,14,17,14,169,410,7,31,0,0
4163,167,441,341,861,14,17,14,174,420,8,31,0,0
4164,207,439,388,868,14,17,14,181,429,9,31,0,0
4165,253,444,438,875,14,17,14,185,431,10,31,0,0
4166,281,437,469,877,14,17,14,188,440,11,31,0,0
4167,338,433,538,889,14,17,14,200,456,12,31,0,0
4168,393,440,600,904,14,17,14,207,464,13,31,0,0
4169,427,445,634,912,14,17,14,207,467,14,31,0,0
4170,483,449,703,944,14,17,14,220,495,15,31,0,0
4171,533,460,765,976,14,17,14,232,516,16,31,0,0
4172,566,454,800,981,14,17,14,234,527,17,31,0,0
4173,641,462,878,990,14,17,14,237,528,18,31,0,0
4174,704,469,947,1004,14,17,14,243,535,19,31,0,0
4175,757,459,1003,1013,14,17,14,246,554,20,31,0,0
4176,837,462,1095,1048,14,17,14,258,586,21,31,0,0
4177,903,481,1159,1060,14,17,14,256,579,22,31,0,0
4178,984,479,1241,1069,14,17,14,257,590,23,31,0,0
4179,1070,489,1325,1079,14,17,14,255,590,24,31,0,0
4180,1145,512,1400,1080,14,17,14,255,568,25,31,0,0
4181,1278,506,1526,1059,14,17,14,248,553,26,31,0,0
4182,1381,530,1625,1064,14,17,14,244,534,27,31,0,0
4183,1507,559,1739,1062,14,17,14,232,503,28,31,0,0
4184,1621,565,1857,1067,14,17,14,236,502,29,31,0,0
4185,1688,593,1913,1072,14,17,14,225,479,30,31,0,0
4186,1767,604,1920,1078,14,17,14,153,474,31,31,1,0
4229,2,460,114,729,15,17,14,112,269,0,82,0,1
4230,5,454,128,749,15,17,14,123,295,1,82,0,0
4231,21,458,144,751,15,17,14,123,293,2,82,0,0
4232,34,459,166,774,15,17,14,132,315,3,82,0,0
4233,65,457,204,785,15,17,14,139,328,4,82,0,0
4234,91,463,235,798,15,17,14,144,335,5,82,0,0
4235,106,462,256,809,15,17,14,150,347,6,82,0,0
4236,129,461,291,834,15,17,14,162,373,7,82,0,0
4237,147,463,314,841,15,17,14,167,378,8,82,0,0
4238,167,462,339,854,15,17,14,172,392,9,82,0,0
4239,201,459,389,877,15,17,14,188,418,10,82,0,0
4240,232,465,425,892,15,17,14,193,427,11,82,0,0
4241,271,465,480,924,15,17,14,209,459,12,82,0,0
4242,303,469,523,951,15,17,14,220,482,13,82,0,0
4243,347,474,563,954,15,17,14,216,480,14,82,0,0
4244,416,477,642,972,15,17,14,226,495,15,82,0,0
4245,473,476,701,977,15,17,14,228,501,16,82,0,0
4246,548,476,787,996,15,17,14,239,520,17,82,0,0
4247,632,473,878,997,15,17,14,246,524,18,82,0,0
4248,693,460,942,999,15,17,14,249,539,19,82,0,0
4249,790,456,1044,1003,15,17,14,254,547,20,82,0,0
4250,852,446,1102,995,15,17,14,250,549,21,82,0,0
4251,940,434,1185,983,15,17,14,245,549,22,82,0,0
4252,1022,421,1266,964,15,17,14,244,543,23,82,0,0
4253,1092,400,1324,924,15,17,14,232,524,24,82,0,0
4254,1160,397,1376,897,15,17,14,216,500,25,82,0,0
4255,1206,406,1415,889,15,17,14,209,483,26,82,0,0
4256,1265,374,1463,839,15,17,14,198,465,27,82,0,0
4257,1312,362,1500,808,15,17,14,188,446,28,82,0,0
4258,1350,346,1534,787,15,17,14,184,441,29,82,0,0
4259,1379,332,1557,764,15,17,14,178,432,30,82,0,0
4260,1387,327,1562,753,15,17,14,175,426,31,82,0,0
4261,1392,313,1559,719,15,17,14,167,406,32,82,0,0
4262,1405,303,1560,685,15,17,14,155,382,33,82,0,0
4263,1410,290,1563,668,15,17,14,153,378,34,82,0,0
4264,1417,284,1561,641,15,17,14,144,357,35,82,0,0
4265,1419,283,1558,632,15,17,14,139,349,36,82,0,0
4266,1415,273,1549,611,15,17,14,134,338,37,82,0,0
4267,1421,259,1551,590,15,17,14,130,331,38,82,0,0
4268,1429,257,1553,582,15,17,14,124,325,39,82,0,0
4269,1437,251,1553,561,15,17,14,116,310,40,82,0,0
4270,1445,252,1557,553,15,17,14,112,301,41,82,0,0
4271,1456,249,1561,535,15,17,14,105,286,42,82,0,0
4272,1468,248,1565,515,15,17,14,97,267,43,82,0,0
4273,1479,244,1572,500,15,17,14,93,256,44,82,0,0
4274,1492,240,1582,492,15,17,14,90,252,45,82,0,0
4275,1502,233,1594,491,15,17,14,92,258,46,82,0,0
4276,1513,234,1599,475,15,17,14,86,241,47,82,0,0
4277,1527,232,1610,462,15,17,14,83,230,48,82,0,0
4278,1543,230,1623,455,15,17,14,80,225,49,82,0,0
4279,1556,228,1635,452,15,17,14,79,224,50,82,0,0
4280,1569,227,1645,447,15,17,14,76,220,51,82,0,0
4281,1576,226,1650,443,15,17,14,74,217,52,82,0,0
4282,1582,223,1651,427,15,17,14,69,204,53,82,0,0
4283,1587,220,1654,422,15,17,14,67,202,54,82,0,0
4284,1588,216,1657,421,15,17,14,69,205,55,82,0,0
4285,1592,214,1658,412,15,17,14,66,198,56,82,0,0
4286,1592,213,1657,407,15,17,14,65,194,57,82,0,0
4287,1591,211,1654,399,15,17,14,63,188,58,82,0,0
4288,1590,209,1653,395,15,17,14,63,186,59,82,0,0
4289,1592,207,1653,391,15,17,14,61,184,60,82,0,0
4290,1594,205,1654,384,15,17,14,60,179,61,82,0,0
4291,1595,205,1652,379,15,17,14,57,174,62,82,0,0
4292,1594,205,1651,376,15,17,14,57,171,63,82,0,0
4293,1593,204,1647,367,15,17,14,54,163,64,82,0,0
4294,1593,203,1645,363,15,17,14,52,160,65,82,0,0
4295,1596,200,1648,359,15,17,14,52,159,66,82,0,0
4296,1598,200,1647,353,15,17,14,49,153,67,82,0,0
4297,1597,200,1645,350,15,17,14,48,150,68,82,0,0
4298,1595,197,1642,344,15,17,14,47,147,69,82,0,0
4299,1595,198,1641,343,15,17,14,46,145,70,82,0,0
4300,1595,197,1640,341,15,17,14,45,144,71,82,0,0
4301,1595,196,1639,338,15,17,14,44,142,72,82,0,0
4302,1595,194,1638,333,15,17,14,43,139,73,82,0,0
4303,1595,193,1636,329,15,17,14,41,136,74,82,0,0
4304,1594,191,1635,326,15,17,14,41,135,75,82,0,0
4305,1596,190,1636,323,15,17,14,40,133,76,82,0,0
4306,1597,187,1637,319,15,17,14,40,132,77,82,0,0
4307,1600,187,1638,312,15,17,14,38,125,78,82,0,0
4308,1601,185,1639,312,15,17,14,38,127,79,82,0,0
4309,1601,183,1639,312,15,17,14,38,129,80,82,0,0
4310,1602,183,1640,312,15,17,14,38,129,81,82,0,0
4311,1604,182,1640,310,15,17,14,36,128,82,82,1,0
4259,0,477,54,706,16,17,14,54,229,0,40,0,1
4260,0,472,55,726,16,17,14,55,254,1,40,0,0
4261,0,479,62,746,16,17,14,62,267,2,40,0,0
4262,5,479,70,753,16,17,14,65,274,3,40,0,0
4263,22,458,95,756,16,17,14,73,298,4,40,0,0
4264,32,452,110,758,16,17,14,78,306,5,40,0,0
4265,36,444,123,770,16,17,14,87,326,6,40,0,0
4266,39,451,132,785,16,17,14,93,334,7,40,0,0
4267,48,450,147,794,16,17,14,99,344,8,40,0,0
4268,70,449,178,800,16,17,14,108,351,9,40,0,0
4269,95,457,208,804,16,17,14,113,347,10,40,0,0
4270,109,459,227,807,16,17,14,118,348,11,40,0,0
4271,118,458,248,834,16,17,14,130,376,12,40,0,0
4272,132,463,268,850,16,17,14,136,387,13,40,0,0
4273,149,460,292,859,16,17,14,143,399,14,40,0,0
4274,187,461,341,866,16,17,14,154,405,15,40,0,0
4275,218,459,378,869,16,17,14,160,410,16,40,0,0
4276,234,460,403,895,16,17,14,169,435,17,40,0,0
4277,266,463,446,918,16,17,14,180,455,18,40,0,0
4278,285,463,470,933,16,17,14,185,470,19,40,0,0
4279,341,466,536,942,16,17,14,195,476,20,40,0,0
4280,382,471,582,950,16,17,14,200,479,21,40,0,0
4281,402,471,612,974,16,17,14,210,503,22,40,0,0
4282,437,477,665,1007,16,17,14,228,530,23,40,0,0
4283,471,477,710,1033,16,17,14,239,556,24,40,0,0
4284,530,482,773,1047,16,17,14,243,565,25,40,0,0
4285,605,487,856,1058,16,17,14,251,571,26,40,0,0
4286,656,483,911,1063,16,17,14,255,580,27,40,0,0
4287,715,488,977,1074,16,17,14,262,586,28,40,0,0
4288,762,503,1024,1076,16,17,14,262,573,29,40,0,0
4289,823,509,1084,1080,16,17,14,261,571,30,40,0,0
4290,900,521,1156,1079,16,17,14,256,558,31,40,0,0
4291,994,537,1247,1080,16,17,14,253,543,32,40,0,0
4292,1080,543,1332,1072,16,17,14,252,529,33,40,0,0
4293,1142,563,1402,1075,16,17,14,260,512,34,40,0,0
4294,1268,577,1524,1072,16,17,14,256,495,35,40,0,0
4295,1376,587,1628,1069,16,17,14,252,482,36,40,0,0
4296,1494,610,1743,1076,16,17,14,249,466,37,40,0,0
4297,1605,617,1851,1071,16,17,14,246,454,38,40,0,0
4298,1673,633,1916,1078,16,17,14,243,445,39,40,0,0
4299,1753,643,1920,1080,16,17,14,167,437,40,40,1,0
4270,1435,290,1486,432,17,17,14,51,142,0,0,0,0
4339,1612,136,1652,246,18,17,14,40,110,0,1,0,0
4340,1614,134,1654,245,18,17,14,40,111,1,1,0,0
4387,0,522,70,818,19,17,14,70,296,0,14,0,0
4388,3,521,74,818,19,17,14,71,297,1,14,0,0
4389,3,518,73,816,19,17,14,70,298,2,14,0,0
4390,4,517,78,825,19,17,14,74,308,3,14,0,0
4391,3,513,80,832,19,17,14,77,319,4,14,0,0
4392,4,515,82,836,19,17,14,78,321,5,14,0,0
4393,3,521,80,836,19,17,14,77,315,6,14,0,0
4394,0,534,66,836,19,17,14,66,302,7,14,0,0
4395,0,557,61,833,19,17,14,61,276,8,14,0,0
4396,0,565,54,819,19,17,14,54,254,9,14,0,0
4397,0,577,49,811,19,17,14,49,234,10,14,0,0
4398,0,573,47,804,19,17,14,47,231,11,14,0,0
4399,0,578,45,801,19,17,14,45,223,12,14,0,0
4400,0,540,45,769,19,17,14,45,229,13,14,0,0
4401,0,538,43,762,19,17,14,43,224,14,14,0,0
4415,2,459,40,641,20,17,14,38,182,0,0,0,0
4450,0,451,104,818,21,17,14,104,367,0,61,0,1
4451,7,444,117,829,21,17,14,110,385,1,61,0,0
4452,20,454,132,845,21,17,14,112,391,2,61,0,0
4453,29,445,149,856,21,17,14,120,411,3,61,0,0
4454,58,448,183,862,21,17,14,125,414,4,61,0,0
4455,84,461,215,878,21,17,14,131,417,5,61,0,0
4456,101,463,237,888,21,17,14,136,425,6,61,0,0
4457,130,466,279,917,21,17,14,149,451,7,61,0,0
4458,164,473,321,934,21,17,14,157,461,8,61,0,0
4459,188,467,355,948,21,17,14,167,481,9,61,0,0
4460,245,465,425,956,21,17,14,180,491,10,61,0,0
4461,296,466,490,973,21,17,14,194,507,11,61,0,0
4462,335,457,539,977,21,17,14,204,520,12,61,0,0
4463,384,452,605,1005,21,17,14,221,553,13,61,0,0
4464,444,456,681,1028,21,17,14,237,572,14,61,0,0
4465,489,452,737,1045,21,17,14,248,593,15,61,0,0
4466,549,445,803,1048,21,17,14,254,603,16,61,0,0
4467,636,446,899,1048,21,17,14,263,602,17,61,0,0
4468,688,429,949,1024,21,17,14,261,595,18,61,0,0
4469,735,420,1001,1025,21,17,14,266,605,19,61,0,0
4470,796,419,1070,1036,21,17,14,274,617,20,61,0,0
4471,830,420,1107,1043,21,17,14,277,623,21,61,0,0
4472,846,422,1120,1045,21,17,14,274,623,22,61,0,0
4473,859,420,1128,1044,21,17,14,269,624,23,61,0,0
4474,863,424,1133,1063,21,17,14,270,639,24,61,0,0
4475,872,440,1135,1067,21,17,14,263,627,25,61,0,0
4476,867,448,1122,1069,21,17,14,255,621,26,61,0,0
4477,859,454,1110,1074,21,17,14,251,620,27,61,0,0
4478,857,449,1107,1073,21,17,14,250,624,28,61,0,0
4479,864,444,1111,1071,21,17,14,247,627,29,61,0,0
4480,873,436,1119,1073,21,17,14,246,637,30,61,0,0
4481,880,430,1125,1076,21,17,14,245,646,31,61,0,0
4482,884,423,1127,1078,21,17,14,243,655,32,61,0,0
4483,889,418,1130,1079,21,17,14,241,661,33,61,0,0
4484,892,415,1130,1080,21,17,14,238,665,34,61,0,0
4485,890,413,1126,1080,21,17,14,236,667,35,61,0,0
4486,887,414,1118,1077,21,17,14,231,663,36,61,0,0
4487,879,410,1107,1062,21,17,14,228,652,37,61,0,0
4488,863,408,1088,1057,21,17,14,225,649,38,61,0,0
4489,845,410,1066,1046,21,17,14,221,636,39,61,0,0
4490,813,406,1032,1026,21,17,14,219,620,40,61,0,0
4491,761,407,976,1017,21,17,14,215,610,41,61,0,0
4492,728,428,938,1013,21,17,14,210,585,42,61,0,0
4493,691,439,909,1019,21,17,14,218,580,43,61,0,0
4494,652,443,878,1026,21,17,14,226,583,44,61,0,0
4495,626,444,862,1034,21,17,14,236,590,45,61,0,0
4496,626,443,871,1041,21,17,14,245,598,46,61,0,0
4497,650,434,905,1043,21,17,14,255,609,47,61,0,0
4498,673,437,925,1041,21,17,14,252,604,48,61,0,0
4499,696,441,941,1042,21,17,14,245,601,49,61,0,0
4500,763,448,1007,1044,21,17,14,244,596,50,61,0,0
4501,850,466,1102,1054,21,17,14,252,588,51,61,0,0
4502,910,450,1170,1058,21,17,14,260,608,52,61,0,0
4503,1005,444,1271,1070,21,17,14,266,626,53,61,0,0
4504,1090,475,1351,1073,21,17,14,261,598,54,61,0,0
4505,1203,481,1461,1068,21,17,14,258,587,55,61,0,0
4506,1327,465,1593,1070,21,17,14,266,605,56,61,0,0
4507,1447,484,1709,1066,21,17,14,262,582,57,61,0,0
4508,1558,478,1828,1065,21,17,14,270,587,58,61,0,0
4509,1645,490,1913,1075,21,17,14,268,585,59,61,0,0
4510,1706,611,1920,1075,21,17,14,214,464,60,61,0,0
4511,1774,628,1920,1077,21,17,14,146,449,61,61,1,0
4649,444,830,683,1071,23,17,14,239,241,0,6,0,0
4650,498,778,789,1071,23,17,14,291,293,1,6,0,0
4651,590,751,909,1071,23,17,14,319,320,2,6,0,0
4655,1109,619,1552,1069,23,17,14,443,450,0,6,0,0
4656,1225,592,1685,1070,23,17,14,460,478,1,6,0,0
4657,1333,583,1789,1066,23,17,14,456,483,2,6,0,0
4658,1429,576,1885,1068,23,17,14,456,492,3,6,0,0
4659,1522,570,1920,1072,23,17,14,398,502,4,6,0,0
4660,1584,564,1920,1072,23,17,14,336,508,5,6,0,0
4661,1677,544,1920,1072,23,17,14,243,528,6,6,0,0
4651,1668,843,1857,1080,25,17,14,189,237,0,0,0,0
4658,1670,796,1920,1079,27,17,14,250,283,0,0,0,0
4679,2,519,116,839,28,17,14,114,320,0,26,0,1
4680,0,499,127,861,28,17,14,127,362,1,26,0,0
4681,8,504,145,889,28,17,14,137,385,2,26,0,0
4682,14,502,153,891,28,17,14,139,389,3,26,0,0
4683,47,509,195,907,28,17,14,148,398,4,26,0,0
4684,76,508,234,928,28,17,14,158,420,5,26,0,0
4685,96,516,258,941,28,17,14,162,425,6,26,0,0
4686,112,521,289,979,28,17,14,177,458,7,26,0,0
4687,136,532,322,1008,28,17,14,186,476,8,26,0,0
4688,173,543,366,1027,28,17,14,193,484,9,26,0,0
4689,226,551,434,1056,28,17,14,208,505,10,26,0,0
4690,265,547,481,1067,28,17,14,216,520,11,26,0,0
4691,303,549,526,1079,28,17,14,223,530,12,26,0,0
4692,359,564,583,1080,28,17,14,224,516,13,26,0,0
4693,423,566,650,1080,28,17,14,227,514,14,26,0,0
4694,506,587,728,1080,28,17,14,222,493,15,26,0,0
4695,590,587,811,1077,28,17,14,221,490,16,26,0,0
4696,680,587,905,1077,28,17,14,225,490,17,26,0,0
4697,783,613,1013,1077,28,17,14,230,464,18,26,0,0
4698,896,623,1120,1072,28,17,14,224,449,19,26,0,0
4699,1012,637,1230,1075,28,17,14,218,438,20,26,0,0
4700,1150,651,1359,1073,28,17,14,209,422,21,26,0,0
4701,1289,647,1496,1070,28,17,14,207,423,22,26,0,0
4702,1433,673,1629,1070,28,17,14,196,397,23,26,0,0
4703,1586,695,1776,1076,28,17,14,190,381,24,26,0,0
4704,1709,707,1895,1075,28,17,14,186,368,25,26,0,0
4705,1813,719,1920,1078,28,17,14,107,359,26,26,1,0
4723,0,502,103,829,29,17,14,103,327,0,29,0,1
4724,3,504,112,849,29,17,14,109,345,1,29,0,0
4725,0,448,132,876,29,17,14,132,428,2,29,0,0
4726,16,434,165,900,29,17,14,149,466,3,29,0,0
4727,24,425,177,900,29,17,14,153,475,4,29,0,0
4728,58,422,224,922,29,17,14,166,500,5,29,0,0
4729,80,427,259,950,29,17,14,179,523,6,29,0,0
4730,100,431,284,963,29,17,14,184,532,7,29,0,0
4731,117,433,317,997,29,17,14,200,564,8,29,0,0
4732,151,438,370,1034,29,17,14,219,596,9,29,0,0
4733,178,436,406,1046,29,17,14,228,610,10,29,0,0
4734,235,443,480,1068,29,17,14,245,625,11,29,0,0
4735,275,452,523,1074,29,17,14,248,622,12,29,0,0
4736,304,446,557,1078,29,17,14,253,632,13,29,0,0
4737,355,440,616,1080,29,17,14,261,640,14,29,0,0
4738,419,447,685,1080,29,17,14,266,633,15,29,0,0
4739,465,448,735,1080,29,17,14,270,632,16,29,0,0
4740,538,449,817,1078,29,17,14,279,629,17,29,0,0
4741,635,461,925,1080,29,17,14,290,619,18,29,0,0
4742,696,451,992,1079,29,17,14,296,628,19,29,0,0
4743,788,442,1094,1080,29,17,14,306,638,20,29,0,0
4744,880,443,1187,1080,29,17,14,307,637,21,29,0,0
4745,972,440,1276,1073,29,17,14,304,633,22,29,0,0
4746,1085,441,1392,1077,29,17,14,307,636,23,29,0,0
4747,1195,448,1500,1073,29,17,14,305,625,24,29,0,0
4748,1322,460,1620,1070,29,17,14,298,610,25,29,0,0
4749,1447,458,1744,1069,29,17,14,297,611,26,29,0,0
4750,1557,463,1855,1070,29,17,14,298,607,27,29,0,0
4751,1659,500,1920,1077,29,17,14,261,577,28,29,0,0
4752,1746,505,1920,1080,29,17,14,174,575,29,29,1,0
5209,1546,159,1581,262,31,17,14,35,103,0,83,0,1
5210,1543,162,1579,268,31,17,14,36,106,1,83,0,0
5211,1541,162,1578,273,31,17,14,37,111,2,83,0,0
5212,1540,164,1577,275,31,17,14,37,111,3,83,0,0
5213,1540,165,1577,275,31,17,14,37,110,4,83,0,0
5214,1539,165,1577,277,31,17,14,38,112,5,83,0,0
5215,1537,169,1574,278,31,17,14,37,109,6,83,0,0
5216,1535,168,1574,281,31,17,14,39,113,7,83,0,0
5217,1536,170,1574,282,31,17,14,38,112,8,83,0,0
5218,1536,171,1574,283,31,17,14,38,112,9,83,0,0
5219,1535,172,1574,285,31,17,14,39,113,10,83,0,0
5220,1533,171,1572,286,31,17,14,39,115,11,83,0,0
5221,1530,169,1572,290,31,17,14,42,121,12,83,0,0
5222,1529,171,1571,294,31,17,14,42,123,13,83,0,0
5223,1528,172,1570,296,31,17,14,42,124,14,83,0,0
5224,1527,173,1571,300,31,17,14,44,127,15,83,0,0
5225,1524,173,1569,304,31,17,14,45,131,16,83,0,0
5226,1520,172,1567,310,31,17,14,47,138,17,83,0,0
5227,1518,174,1564,313,31,17,14,46,139,18,83,0,0
5228,1517,175,1564,316,31,17,14,47,141,19,83,0,0
5229,1515,176,1562,319,31,17,14,47,143,20,83,0,0
5230,1513,177,1560,321,31,17,14,47,144,21,83,0,0
5231,1509,174,1557,322,31,17,14,48,148,22,83,0,0
5232,1507,178,1554,324,31,17,14,47,146,23,83,0,0
5233,1505,178,1554,330,31,17,14,49,152,24,83,0,0
5234,1504,179,1552,334,31,17,14,48,155,25,83,0,0
5235,1500,183,1550,340,31,17,14,50,157,26,83,0,0
5236,1498,184,1548,343,31,17,14,50,159,27,83,0,0
5237,1495,185,1547,350,31,17,14,52,165,28,83,0,0
5238,1495,186,1547,353,31,17,14,52,167,29,83,0,0
5239,1492,187,1547,360,31,17,14,55,173,30,83,0,0
5240,1490,194,1544,368,31,17,14,54,174,31,83,0,0
5241,1484,194,1539,372,31,17,14,55,178,32,83,0,0
5242,1480,197,1536,381,31,17,14,56,184,33,83,0,0
5243,1476,198,1534,387,31,17,14,58,189,34,83,0,0
5244,1470,200,1530,392,31,17,14,60,192,35,83,0,0
5245,1463,202,1524,402,31,17,14,61,200,36,83,0,0
5246,1458,201,1521,406,31,17,14,63,205,37,83,0,0
5247,1451,206,1516,417,31,17,14,65,211,38,83,0,0
5248,1445,206,1513,427,31,17,14,68,221,39,83,0,0
5249,1440,208,1509,430,31,17,14,69,222,40,83,0,0
5250,1433,213,1502,439,31,17,14,69,226,41,83,0,0
5251,1423,212,1495,449,31,17,14,72,237,42,83,0,0
5252,1414,219,1488,461,31,17,14,74,242,43,83,0,0
5253,1408,224,1485,474,31,17,14,77,250,44,83,0,0
5254,1401,223,1479,480,31,17,14,78,257,45,83,0,0
5255,1393,227,1475,495,31,17,14,82,268,46,83,0,0
5256,1384,230,1469,508,31,17,14,85,278,47,83,0,0
5257,1373,235,1463,534,31,17,14,90,299,48,83,0,0
5258,1366,239,1460,548,31,17,14,94,309,49,83,0,0
5259,1361,242,1457,560,31,17,14,96,318,50,83,0,0
5260,1349,248,1450,584,31,17,14,101,336,51,83,0,0
5261,1339,250,1442,594,31,17,14,103,344,52,83,0,0
5262,1328,256,1437,621,31,17,14,109,365,53,83,0,0
5263,1321,266,1434,642,31,17,14,113,376,54,83,0,0
5264,1310,272,1428,661,31,17,14,118,389,55,83,0,0
5265,1292,286,1416,696,31,17,14,124,410,56,83,0,0
5266,1275,289,1404,713,31,17,14,129,424,57,83,0,0
5267,1255,302,1392,750,31,17,14,137,448,58,83,0,0
5268,1239,315,1385,786,31,17,14,146,471,59,83,0,0
5269,1209,326,1359,810,31,17,14,150,484,60,83,0,0
5270,1167,346,1327,854,31,17,14,160,508,61,83,0,0
5271,1127,352,1297,887,31,17,14,170,535,62,83,0,0
5272,1062,361,1248,941,31,17,14,186,580,63,83,0,0
5273,1008,386,1199,966,31,17,14,191,580,64,83,0,0
5274,909,400,1100,979,31,17,14,191,579,65,83,0,0
5275,816,420,1018,992,31,17,14,202,572,66,83,0,0
5276,709,435,909,983,31,17,14,200,548,67,83,0,0
5277,620,438,825,994,31,17,14,205,556,68,83,0,0
5278,547,451,758,997,31,17,14,211,546,69,83,0,0
5279,448,455,654,986,31,17,14,206,531,70,83,0,0
5280,346,458,560,982,31,17,14,214,524,71,83,0,0
5281,272,461,484,957,31,17,14,212,496,72,83,0,0
5282,231,458,432,928,31,17,14,201,470,73,83,0,0
5283,191,462,386,908,31,17,14,195,446,74,83,0,0
5284,134,461,322,889,31,17,14,188,428,75,83,0,0
5285,88,460,274,876,31,17,14,186,416,76,83,0,0
5286,49,453,225,853,31,17,14,176,400,77,83,0,0
5287,35,450,202,824,31,17,14,167,374,78,83,0,0
5288,17,462,174,807,31,17,14,157,345,79,83,0,0
5289,0,463,133,796,31,17,14,133,333,80,83,0,0
5290,0,467,116,788,31,17,14,116,321,81,83,0,0
5291,0,464,94,765,31,17,14,94,301,82,83,0,0
5292,0,466,56,753,31,17,14,56,287,83,83,1,0
5215,1624,411,1920,1067,32,17,14,296,656,0,19,0,1
5216,1610,402,1908,1062,32,17,14,298,660,1,19,0,0
5217,1556,382,1864,1067,32,17,14,308,685,2,19,0,0
5218,1461,369,1771,1057,32,17,14,310,688,3,19,0,0
5219,1404,354,1703,1025,32,17,14,299,671,4,19,0,0
5220,1362,329,1661,1007,32,17,14,299,678,5,19,0,0
5221,1330,320,1620,977,32,17,14,290,657,6,19,0,0
5222,1309,309,1587,947,32,17,14,278,638,7,19,0,0
5223,1317,290,1575,894,32,17,14,258,604,8,19,0,0
5224,1314,286,1561,874,32,17,14,247,588,9,19,0,0
5225,1313,285,1557,873,32,17,14,244,588,10,19,0,0
5226,1299,285,1546,891,32,17,14,247,606,11,19,0,0
5227,1303,289,1556,925,32,17,14,253,636,12,19,0,0
5228,1306,307,1557,945,32,17,14,251,638,13,19,0,0
5229,1291,319,1546,961,32,17,14,255,642,14,19,0,0
5230,1280,340,1554,1024,32,17,14,274,684,15,19,0,0
5231,1292,358,1568,1052,32,17,14,276,694,16,19,0,0
5232,1330,379,1599,1053,32,17,14,269,674,17,19,0,0
5233,1375,399,1645,1056,32,17,14,270,657,18,19,0,0
5234,1373,405,1643,1062,32,17,14,270,657,19,19,0,0
5234,1544,424,1828,1059,33,17,14,284,635,0,3,0,0
5235,1612,446,1888,1062,33,17,14,276,616,1,3,0,0
5236,1691,591,1905,1067,33,17,14,214,476,2,3,0,0
5237,1734,655,1920,1069,33,17,14,186,414,3,3,0,0
5493,1,472,68,747,34,17,14,67,275,0,86,0,1
5494,9,478,78,760,34,17,14,69,282,1,86,0,0
5495,21,435,101,759,34,17,14,80,324,2,86,0,0
5496,48,413,139,769,34,17,14,91,356,3,86,0,0
5497,63,407,160,773,34,17,14,97,366,4,86,0,0
5498,94,410,200,796,34,17,14,106,386,5,86,0,0
5499,118,417,229,811,34,17,14,111,394,6,86,0,0
5500,161,411,283,822,34,17,14,122,411,7,86,0,0
5501,203,411,334,829,34,17,14,131,418,8,86,0,0
5502,229,404,368,843,34,17,14,139,439,9,86,0,0
5503,273,416,421,865,34,17,14,148,449,10,86,0,0
5504,303,416,458,878,34,17,14,155,462,11,86,0,0
5505,367,417,533,891,34,17,14,166,474,12,86,0,0
5506,425,417,603,907,34,17,14,178,490,13,86,0,0
5507,466,414,653,931,34,17,14,187,517,14,86,0,0
5508,546,419,747,961,34,17,14,201,542,15,86,0,0
5509,602,416,811,977,34,17,14,209,561,16,86,0,0
5510,701,411,921,977,34,17,14,220,566,17,86,0,0
5511,776,399,1000,972,34,17,14,224,573,18,86,0,0
5512,869,376,1102,975,34,17,14,233,599,19,86,0,0
5513,955,368,1195,966,34,17,14,240,598,20,86,0,0
5514,1033,352,1270,956,34,17,14,237,604,21,86,0,0
5515,1114,347,1341,936,34,17,14,227,589,22,86,0,0
5516,1182,334,1402,912,34,17,14,220,578,23,86,0,0
5517,1247,319,1452,865,34,17,14,205,546,24,86,0,0
5518,1303,325,1497,844,34,17,14,194,519,25,86,0,0
5519,1349,302,1536,804,34,17,14,187,502,26,86,0,0
5520,1384,292,1563,778,34,17,14,179,486,27,86,0,0
5521,1407,286,1578,756,34,17,14,171,470,28,86,0,0
5522,1428,273,1588,717,34,17,14,160,444,29,86,0,0
5523,1448,271,1596,686,34,17,14,148,415,30,86,0,0
5524,1463,261,1603,656,34,17,14,140,395,31,86,0,0
5525,1472,252,1608,640,34,17,14,136,388,32,86,0,0
5526,1477,248,1605,620,34,17,14,128,372,33,86,0,0
5527,1478,241,1599,591,34,17,14,121,350,34,86,0,0
5528,1480,236,1597,578,34,17,14,117,342,35,86,0,0
5529,1490,230,1602,558,34,17,14,112,328,36,86,0,0
5530,1497,230,1604,546,34,17,14,107,316,37,86,0,0
5531,1499,228,1601,532,34,17,14,102,304,38,86,0,0
5532,1498,216,1597,514,34,17,14,99,298,39,86,0,0
5533,1500,217,1595,504,34,17,14,95,287,40,86,0,0
5534,1505,216,1594,487,34,17,14,89,271,41,86,0,0
5535,1508,216,1592,471,34,17,14,84,255,42,86,0,0
5536,1503,214,1586,467,34,17,14,83,253,43,86,0,0
5537,1499,206,1582,459,34,17,14,83,253,44,86,0,0
5538,1498,205,1579,456,34,17,14,81,251,45,86,0,0
5539,1499,201,1576,439,34,17,14,77,238,46,86,0,0
5540,1499,198,1572,428,34,17,14,73,230,47,86,0,0
5541,1496,195,1568,422,34,17,14,72,227,48,86,0,0
5542,1494,196,1563,412,34,17,14,69,216,49,86,0,0
5543,1493,192,1563,414,34,17,14,70,222,50,86,0,0
5544,1494,193,1560,403,34,17,14,66,210,51,86,0,0
5545,1493,192,1557,398,34,17,14,64,206,52,86,0,0
5546,1489,190,1551,393,34,17,14,62,203,53,86,0,0
5547,1486,185,1547,385,34,17,14,61,200,54,86,0,0
5548,1486,185,1545,382,34,17,14,59,197,55,86,0,0
5549,1488,183,1546,372,34,17,14,58,189,56,86,0,0
5550,1491,182,1547,367,34,17,14,56,185,57,86,0,0
5551,1491,180,1547,364,34,17,14,56,184,58,86,0,0
5552,1492,178,1547,360,34,17,14,55,182,59,86,0,0
5553,1494,180,1548,358,34,17,14,54,178,60,86,0,0
5554,1499,179,1551,350,34,17,14,52,171,61,86,0,0
5555,1503,178,1554,345,34,17,14,51,167,62,86,0,0
5556,1504,177,1554,345,34,17,14,50,168,63,86,0,0
5557,1506,176,1555,339,34,17,14,49,163,64,86,0,0
5558,1508,177,1556,336,34,17,14,48,159,65,86,0,0
5559,1513,176,1559,331,34,17,14,46,155,66,86,0,0
5560,1514,175,1560,326,34,17,14,46,151,67,86,0,0
5561,1514,173,1559,323,34,17,14,45,150,68,86,0,0
5562,1514,170,1558,317,34,17,14,44,147,69,86,0,0
5563,1515,173,1558,313,34,17,14,43,140,70,86,0,0
5564,1517,174,1559,311,34,17,14,42,137,71,86,0,0
5565,1518,171,1561,312,34,17,14,43,141,72,86,0,0
5566,1518,171,1561,312,34,17,14,43,141,73,86,0,0
5567,1521,171,1563,306,34,17,14,42,135,74,86,0,0
5568,1524,172,1566,304,34,17,14,42,132,75,86,0,0
5569,1530,172,1570,299,34,17,14,40,127,76,86,0,0
5570,1536,171,1574,291,34,17,14,38,120,77,86,0,0
5571,1539,171,1577,289,34,17,14,38,118,78,86,0,0
5572,1542,166,1580,286,34,17,14,38,120,79,86,0,0
5573,1544,163,1583,285,34,17,14,39,122,80,86,0,0
5574,1546,161,1585,285,34,17,14,39,124,81,86,0,0
5575,1547,160,1587,284,34,17,14,40,124,82,86,0,0
5576,1550,159,1589,281,34,17,14,39,122,83,86,0,0
5577,1551,160,1590,281,34,17,14,39,121,84,86,0,0
5578,1552,162,1590,280,34,17,14,38,118,85,86,0,0
5579,1556,167,1593,278,34,17,14,37,111,86,86,1,0
4611,1,868,105,1074,1,17,15,104,206,0,0,0,0
4622,845,383,1055,957,3,17,15,210,574,0,51,0,1
4623,887,376,1091,935,3,17,15,204,559,1,51,0,0
4624,939,359,1138,901,3,17,15,199,542,2,51,0,0
4625,991,342,1191,888,3,17,15,200,546,3,51,0,0
4626,1022,330,1224,877,3,17,15,202,547,4,51,0,0
4627,1078,318,1265,828,3,17,15,187,510,5,51,0,0
4628,1117,309,1299,799,3,17,15,182,490,6,51,0,0
4629,1154,307,1333,785,3,17,15,179,478,7,51,0,0
4630,1206,296,1380,763,3,17,15,174,467,8,51,0,0
4631,1234,291,1405,750,3,17,15,171,459,9,51,0,0
4632,1257,283,1422,727,3,17,15,165,444,10,51,0,0
4633,1277,282,1431,698,3,17,15,154,416,11,51,0,0
4634,1289,278,1441,691,3,17,15,152,413,12,51,0,0
4635,1302,267,1448,671,3,17,15,146,404,13,51,0,0
4636,1305,261,1441,641,3,17,15,136,380,14,51,0,0
4637,1304,253,1438,625,3,17,15,134,372,15,51,0,0
4638,1303,245,1435,608,3,17,15,132,363,16,51,0,0
4639,1301,244,1429,595,3,17,15,128,351,17,51,0,0
4640,1300,239,1424,579,3,17,15,124,340,18,51,0,0
4641,1291,235,1409,554,3,17,15,118,319,19,51,0,0
4642,1267,231,1387,556,3,17,15,120,325,20,51,0,0
4643,1251,225,1366,536,3,17,15,115,311,21,51,0,0
4644,1236,217,1348,522,3,17,15,112,305,22,51,0,0
4645,1226,213,1337,518,3,17,15,111,305,23,51,0,0
4646,1222,206,1328,497,3,17,15,106,291,24,51,0,0
4647,1207,200,1325,524,3,17,15,118,324,25,51,0,0
4648,1205,197,1313,496,3,17,15,108,299,26,51,0,0
4649,1208,191,1311,477,3,17,15,103,286,27,51,0,0
4650,1210,192,1311,471,3,17,15,101,279,28,51,0,0
4651,1231,193,1325,461,3,17,15,94,268,29,51,0,0
4652,1244,193,1337,457,3,17,15,93,264,30,51,0,0
4653,1246,193,1337,456,3,17,15,91,263,31,51,0,0
4654,1251,192,1343,456,3,17,15,92,264,32,51,0,0
4655,1255,193,1346,455,3,17,15,91,262,33,51,0,0
4656,1256,195,1347,454,3,17,15,91,259,34,51,0,0
4657,1257,196,1347,456,3,17,15,90,260,35,51,0,0
4658,1262,193,1356,458,3,17,15,94,265,36,51,0,0
4659,1266,195,1360,458,3,17,15,94,263,37,51,0,0
4660,1269,194,1366,459,3,17,15,97,265,38,51,0,0
4661,1265,193,1363,459,3,17,15,98,266,39,51,0,0
4662,1257,196,1353,460,3,17,15,96,264,40,51,0,0
4663,1258,199,1352,460,3,17,15,94,261,41,51,0,0
4664,1262,198,1359,469,3,17,15,97,271,42,51,0,0
4665,1270,205,1370,479,3,17,15,100,274,43,51,0,0
4666,1292,208,1391,480,3,17,15,99,272,44,51,0,0
4667,1312,209,1412,485,3,17,15,100,276,45,51,0,0
4668,1325,214,1423,488,3,17,15,98,274,46,51,0,0
4669,1332,217,1432,502,3,17,15,100,285,47,51,0,0
4670,1342,219,1441,506,3,17,15,99,287,48,51,0,0
4671,1349,223,1446,512,3,17,15,97,289,49,51,0,0
4672,1358,252,1445,513,3,17,15,87,261,50,51,0,0
4673,1365,256,1451,516,3,17,15,86,260,51,51,1,0
5226,0,938,101,1080,4,17,15,101,142,0,0,0,0
5227,102,853,281,1069,5,17,15,179,216,0,0,0,0
5228,244,803,470,1076,6,17,15,226,273,0,0,0,0
5229,379,731,624,1071,7,17,15,245,340,0,0,0,0
5230,508,662,756,1076,8,17,15,248,414,0,12,0,0
5231,587,614,860,1070,8,17,15,273,456,1,12,0,0
5232,649,555,962,1077,8,17,15,313,522,2,12,0,0
5233,712,521,1041,1074,8,17,15,329,553,3,12,0,0
5234,777,488,1121,1070,8,17,15,344,582,4,12,0,0
5235,847,449,1198,1054,8,17,15,351,605,5,12,0,0
5236,912,433,1253,1029,8,17,15,341,596,6,12,0,0
5237,991,398,1307,960,8,17,15,316,562,7,12,0,0
5238,1047,389,1340,914,8,17,15,293,525,8,12,0,0
5239,1118,380,1387,866,8,17,15,269,486,9,12,0,0
5240,1185,360,1444,841,8,17,15,259,481,10,12,0,0
5241,1226,353,1476,833,8,17,15,250,480,11,12,0,0
5242,1282,331,1532,811,8,17,15,250,480,12,12,0,0
5658,1376,225,1440,545,9,17,15,64,320,0,56,0,1
5659,1347,222,1413,546,9,17,15,66,324,1,56,0,0
5660,1325,226,1390,536,9,17,15,65,310,2,56,0,0
5661,1310,210,1377,524,9,17,15,67,314,3,56,0,0
5662,1297,198,1365,506,9,17,15,68,308,4,56,0,0
5663,1268,199,1343,528,9,17,15,75,329,5,56,0,0
5664,1246,196,1324,531,9,17,15,78,335,6,56,0,0
5665,1224,191,1298,500,9,17,15,74,309,7,56,0,0
5666,1203,191,1278,493,9,17,15,75,302,8,56,0,0
5667,1195,191,1269,476,9,17,15,74,285,9,56,0,0
5668,1184,183,1261,468,9,17,15,77,285,10,56,0,0
5669,1171,180,1251,472,9,17,15,80,292,11,56,0,0
5670,1159,179,1239,463,9,17,15,80,284,12,56,0,0
5671,1151,176,1229,442,9,17,15,78,266,13,56,0,0
5672,1147,177,1223,429,9,17,15,76,252,14,56,0,0
5673,1148,176,1224,420,9,17,15,76,244,15,56,0,0
5674,1150,173,1225,407,9,17,15,75,234,16,56,0,0
5675,1150,170,1226,401,9,17,15,76,231,17,56,0,0
5676,1150,169,1227,400,9,17,15,77,231,18,56,0,0
5677,1144,164,1224,396,9,17,15,80,232,19,56,0,0
5678,1142,157,1223,388,9,17,15,81,231,20,56,0,0
5679,1143,159,1225,386,9,17,15,82,227,21,56,0,0
5680,1148,157,1230,385,9,17,15,82,228,22,56,0,0
5681,1155,153,1235,374,9,17,15,80,221,23,56,0,0
5682,1158,152,1237,370,9,17,15,79,218,24,56,0,0
5683,1160,151,1238,367,9,17,15,78,216,25,56,0,0
5684,1161,152,1238,363,9,17,15,77,211,26,56,0,0
5685,1166,149,1242,357,9,17,15,76,208,27,56,0,0
5686,1172,147,1248,354,9,17,15,76,207,28,56,0,0
5687,1183,149,1256,344,9,17,15,73,195,29,56,0,0
5688,1190,148,1260,336,9,17,15,70,188,30,56,0,0
5689,1190,147,1260,334,9,17,15,70,187,31,56,0,0
5690,1190,149,1256,327,9,17,15,66,178,32,56,0,0
5691,1190,145,1257,323,9,17,15,67,178,33,56,0,0
5692,1193,146,1259,321,9,17,15,66,175,34,56,0,0
5693,1201,145,1264,314,9,17,15,63,169,35,56,0,0
5694,1206,143,1268,308,9,17,15,62,165,36,56,0,0
5695,1206,141,1269,310,9,17,15,63,169,37,56,0,0
5696,1205,140,1267,309,9,17,15,62,169,38,56,0,0
5697,1205,138,1268,306,9,17,15,63,168,39,56,0,0
5698,1210,139,1271,300,9,17,15,61,161,40,56,0,0
5699,1215,133,1277,299,9,17,15,62,166,41,56,0,0
5700,1218,130,1279,293,9,17,15,61,163,42,56,0,0
5701,1219,130,1279,289,9,17,15,60,159,43,56,0,0
5702,1218,130,1278,289,9,17,15,60,159,44,56,0,0
5703,1217,128,1277,286,9,17,15,60,158,45,56,0,0
5704,1216,127,1275,285,9,17,15,59,158,46,56,0,0
5705,1217,129,1273,279,9,17,15,56,150,47,56,0,0
5706,1215,122,1273,278,9,17,15,58,156,48,56,0,0
5707,1213,123,1267,269,9,17,15,54,146,49,56,0,0
5708,1205,124,1260,274,9,17,15,55,150,50,56,0,0
5709,1196,121,1251,271,9,17,15,55,150,51,56,0,0
5710,1190,122,1243,265,9,17,15,53,143,52,56,0,0
5711,1182,121,1234,266,9,17,15,52,145,53,56,0,0
5712,1174,119,1225,261,9,17,15,51,142,54,56,0,0
5713,1170,120,1215,249,9,17,15,45,129,55,56,0,0
5714,1166,119,1210,245,9,17,15,44,126,56,56,1,0
94,1510,489,1677,787,1,17,2,167,298,0,0,0,0
368,1554,489,1667,764,2,17,2,113,275,0,0,0,0
546,1511,495,1663,720,3,17,2,152,225,0,1,0,0
547,1499,491,1679,758,3,17,2,180,267,1,1,0,0
550,1513,492,1665,753,4,17,2,152,261,0,0,0,0
592,2,818,141,1075,5,17,2,139,257,0,0,0,0
593,66,809,250,1069,6,17,2,184,260,0,9,0,0
594,137,781,343,1071,6,17,2,206,290,1,9,0,0
595,225,761,445,1069,6,17,2,220,308,2,9,0,0
596,324,733,564,1071,6,17,2,240,338,3,9,0,0
597,393,692,658,1069,6,17,2,265,377,4,9,0,0
598,456,674,730,1069,6,17,2,274,395,5,9,0,0
599,527,656,814,1068,6,17,2,287,412,6,9,0,0
600,586,644,888,1074,6,17,2,302,430,7,9,0,0
601,628,644,932,1076,6,17,2,304,432,8,9,0,0
602,689,626,1006,1076,6,17,2,317,450,9,9,0,0
602,570,679,829,1069,7,17,2,259,390,0,10,0,0
603,527,707,769,1071,7,17,2,242,364,1,10,0,0
604,495,738,717,1072,7,17,2,222,334,2,10,0,0
605,446,758,655,1072,7,17,2,209,314,3,10,0,0
606,379,779,578,1074,7,17,2,199,295,4,10,0,0
607,278,789,473,1074,7,17,2,195,285,5,10,0,0
608,188,795,385,1075,7,17,2,197,280,6,10,0,0
609,118,810,310,1076,7,17,2,192,266,7,10,0,0
610,50,853,219,1077,7,17,2,169,224,8,10,0,0
611,0,895,137,1078,7,17,2,137,183,9,10,0,0
612,0,919,57,1078,7,17,2,57,159,10,10,0,0
626,0,767,98,962,8,17,2,98,195,0,0,0,0
629,0,658,85,916,9,17,2,85,258,0,0,0,0
1041,1547,489,1679,763,11,17,2,132,274,0,0,0,0
1143,1536,480,1679,786,12,17,2,143,306,0,3,0,0
1144,1530,488,1671,787,12,17,2,141,299,1,3,0,0
1145,1532,485,1675,789,12,17,2,143,304,2,3,0,0
1146,1532,485,1675,790,12,17,2,143,305,3,3,0,0
1341,1532,488,1674,777,13,17,2,142,289,0,5,0,0
1342,1532,488,1672,771,13,17,2,140,283,1,5,0,0
1343,1532,488,1672,770,13,17,2,140,282,2,5,0,0
1344,1533,488,1671,769,13,17,2,138,281,3,5,0,0
1345,1532,488,1672,774,13,17,2,140,286,4,5,0,0
1346,1531,488,1672,774,13,17,2,141,286,5,5,0,0
1766,1511,484,1684,799,14,17,2,173,315,0,4,0,0
1767,1510,486,1683,800,14,17,2,173,314,1,4,0,0
1768,1512,486,1683,797,14,17,2,171,311,2,4,0,0
1769,1513,486,1682,794,14,17,2,169,308,3,4,0,0
1770,1513,487,1681,792,14,17,2,168,305,4,4,0,0
1906,1542,489,1681,781,15,17,2,139,292,0,5,0,0
1907,1532,481,1691,817,15,17,2,159,336,1,5,0,0
1908,1538,486,1682,790,15,17,2,144,304,2,5,0,0
1909,1542,488,1681,782,15,17,2,139,294,3,5,0,0
1910,1542,488,1683,784,15,17,2,141,296,4,5,0,0
1911,1543,489,1682,780,15,17,2,139,291,5,5,0,0
2254,1530,487,1685,779,16,17,2,155,292,0,0,0,0
2411,1557,487,1678,781,17,17,2,121,294,0,5,0,0
2412,1557,486,1678,781,17,17,2,121,295,1,5,0,0
2413,1558,485,1678,777,17,17,2,120,292,2,5,0,0
2414,1556,485,1678,781,17,17,2,122,296,3,5,0,0
2415,1556,485,1677,781,17,17,2,121,296,4,5,0,0
2416,1555,485,1677,781,17,17,2,122,296,5,5,0,0
2441,1528,485,1663,790,17,17,2,135,305,0,5,0,0
2442,1527,486,1662,791,17,17,2,135,305,1,5,0,0
2443,1525,487,1660,776,17,17,2,135,289,2,5,0,0
2444,1524,487,1663,777,17,17,2,139,290,3,5,0,0
2445,1523,488,1662,770,17,17,2,139,282,4,5,0,0
2446,1523,488,1661,768,17,17,2,138,280,5,5,0,0
2491,1542,487,1678,787,18,17,2,136,300,0,5,0,0
2492,1543,487,1679,787,18,17,2,136,300,1,5,0,0
2493,1540,488,1675,784,18,17,2,135,296,2,5,0,0
2494,1540,487,1674,783,18,17,2,134,296,3,5,0,0
2495,1540,487,1675,783,18,17,2,135,296,4,5,0,0
2496,1540,487,1674,782,18,17,2,134,295,5,5,0,0
2561,1549,486,1682,788,19,17,2,133,302,0,0,0,0
2563,1549,486,1682,785,20,17,2,133,299,0,3,0,0
2564,1542,485,1683,800,20,17,2,141,315,1,3,0,0
2565,1546,486,1681,788,20,17,2,135,302,2,3,0,0
2566,1547,486,1681,786,20,17,2,134,300,3,3,0,0
2735,1547,488,1689,797,23,17,2,142,309,0,0,0,0
2746,5,953,127,1077,24,17,2,122,124,0,1,0,0
2747,6,953,128,1077,24,17,2,122,124,1,1,0,0
2749,6,949,132,1080,25,17,2,126,131,0,5,0,0
2750,2,946,131,1080,25,17,2,129,134,1,5,0,0
2751,1,942,133,1080,25,17,2,132,138,2,5,0,0
2752,0,939,134,1080,25,17,2,134,141,3,5,0,0
2754,1,942,130,1078,25,17,2,129,136,0,5,0,0
2755,0,941,130,1077,25,17,2,130,136,1,5,0,0
2761,1,955,120,1079,25,17,2,119,124,0,5,0,0
2762,2,956,120,1079,25,17,2,118,123,1,5,0,0
2763,2,957,120,1080,25,17,2,118,123,2,5,0,0
2764,3,956,120,1076,25,17,2,117,120,3,5,0,0
2765,4,956,120,1075,25,17,2,116,119,4,5,0,0
2766,4,956,119,1074,25,17,2,115,118,5,5,0,0
2781,2,949,127,1077,25,17,2,125,128,0,5,0,0
2782,3,948,128,1077,25,17,2,125,129,1,5,0,0
2783,4,947,128,1077,25,17,2,124,130,2,5,0,0
2784,4,950,126,1078,25,17,2,122,128,3,5,0,0
2785,3,951,125,1079,25,17,2,122,128,4,5,0,0
2786,3,951,125,1079,25,17,2,122,128,5,5,0,0
2751,1524,488,1678,791,26,17,2,154,303,0,5,0,0
2752,1525,487,1679,791,26,17,2,154,304,1,5,0,0
2753,1527,487,1679,787,26,17,2,152,300,2,5,0,0
2754,1528,487,1682,790,26,17,2,154,303,3,5,0,0
2755,1529,487,1682,789,26,17,2,153,302,4,5,0,0
2756,1530,486,1683,789,26,17,2,153,303,5,5,0,0
2906,1528,488,1682,793,27,17,2,154,305,0,3,0,0
2907,1522,485,1684,805,27,17,2,162,320,1,3,0,0
2908,1528,487,1682,791,27,17,2,154,304,2,3,0,0
2909,1529,487,1681,788,27,17,2,152,301,3,3,0,0
2933,1536,486,1687,784,27,17,2,151,298,0,3,0,0
2934,1536,485,1687,784,27,17,2,151,299,1,3,0,0
2946,1549,485,1691,782,27,17,2,142,297,0,3,0,0
2947,1550,485,1691,782,27,17,2,141,297,1,3,0,0
2950,1547,487,1684,780,27,17,2,137,293,0,3,0,0
2951,1547,487,1683,779,27,17,2,136,292,1,3,0,0
2991,1542,485,1680,803,28,17,2,138,318,0,10,0,0
2992,1543,484,1681,802,28,17,2,138,318,1,10,0,0
2993,1542,484,1680,801,28,17,2,138,317,2,10,0,0
2994,1542,484,1680,801,28,17,2,138,317,3,10,0,0
3006,1539,490,1670,787,28,17,2,131,297,0,10,0,0
3007,1539,491,1671,788,28,17,2,132,297,1,10,0,0
3008,1539,491,1672,788,28,17,2,133,297,2,10,0,0
3009,1539,491,1673,789,28,17,2,134,298,3,10,0,0
3010,1539,492,1672,789,28,17,2,133,297,4,10,0,0
3026,1527,486,1668,783,28,17,2,141,297,0,10,0,0
3027,1527,485,1668,783,28,17,2,141,298,1,10,0,0
3039,1525,487,1671,783,28,17,2,146,296,0,10,0,0
3040,1525,487,1671,783,28,17,2,146,296,1,10,0,0
3051,1530,487,1678,781,28,17,2,148,294,0,10,0,0
3052,1522,483,1675,783,28,17,2,153,300,1,10,0,0
3053,1520,482,1674,785,28,17,2,154,303,2,10,0,0
3054,1519,481,1675,786,28,17,2,156,305,3,10,0,0
3055,1525,485,1675,776,28,17,2,150,291,4,10,0,0
3056,1531,486,1679,779,28,17,2,148,293,5,10,0,0
3057,1534,486,1678,778,28,17,2,144,292,6,10,0,0
3058,1535,486,1677,777,28,17,2,142,291,7,10,0,0
3059,1531,484,1678,788,28,17,2,147,304,8,10,0,0
3060,1530,484,1676,787,28,17,2,146,303,9,10,0,0
3061,1530,484,1677,788,28,17,2,147,304,10,10,0,0
3146,1544,487,1684,780,29,17,2,140,293,0,0,0,0
3149,1550,488,1685,775,30,17,2,135,287,0,5,0,0
3150,1548,487,1685,777,30,17,2,137,290,1,5,0,0
3151,1544,487,1689,795,30,17,2,145,308,2,5,0,0
3152,1545,487,1687,791,30,17,2,142,304,3,5,0,0
3153,1546,487,1683,782,30,17,2,137,295,4,5,0,0
3154,1546,487,1682,782,30,17,2,136,295,5,5,0,0
3192,1549,486,1680,785,31,17,2,131,299,0,0,0,0
3195,1548,486,1674,778,32,17,2,126,292,0,0,0,0
3207,1519,486,1681,792,33,17,2,162,306,0,0,0,0
3209,1517,486,1682,792,34,17,2,165,306,0,0,0,0
3226,1510,484,1683,812,35,17,2,173,328,0,5,0,0
3227,1511,483,1685,813,35,17,2,174,330,1,5,0,0
3228,1511,483,1685,813,35,17,2,174,330,2,5,0,0
3229,1516,488,1680,799,35,17,2,164,311,3,5,0,0
3230,1513,485,1683,808,35,17,2,170,323,4,5,0,0
3231,1513,485,1683,807,35,17,2,170,322,5,5,0,0
3236,1514,493,1669,785,35,17,2,155,292,0,5,0,0
3237,1514,494,1670,782,35,17,2,156,288,1,5,0,0
3238,1513,494,1669,784,35,17,2,156,290,2,5,0,0
3239,1510,489,1675,793,35,17,2,165,304,3,5,0,0
3240,1511,492,1671,785,35,17,2,160,293,4,5,0,0
3241,1511,493,1670,784,35,17,2,159,291,5,5,0,0
3253,1518,492,1676,776,35,17,2,158,284,0,5,0,0
3254,1519,492,1676,775,35,17,2,157,283,1,5,0,0
3255,1522,488,1678,769,35,17,2,156,281,2,5,0,0
3256,1523,488,1679,768,35,17,2,156,280,3,5,0,0
3291,1514,486,1684,807,36,17,2,170,321,0,5,0,0
3292,1513,485,1682,803,36,17,2,169,318,1,5,0,0
3293,1515,484,1682,799,36,17,2,167,315,2,5,0,0
3294,1517,487,1681,796,36,17,2,164,309,3,5,0,0
3295,1517,485,1684,799,36,17,2,167,314,4,5,0,0
3296,1518,485,1684,799,36,17,2,166,314,5,5,0,0
3482,1556,489,1674,767,37,17,2,118,278,0,0,0,0
3485,1548,489,1678,771,38,17,2,130,282,0,0,0,0
3611,1546,483,1685,829,39,17,2,139,346,0,15,0,0
3612,1543,482,1683,830,39,17,2,140,348,1,15,0,0
3613,1542,481,1681,827,39,17,2,139,346,2,15,0,0
3614,1551,484,1680,805,39,17,2,129,321,3,15,0,0
3615,1544,482,1678,813,39,17,2,134,331,4,15,0,0
3616,1552,486,1670,777,39,17,2,118,291,5,15,0,0
3617,1557,486,1674,772,39,17,2,117,286,6,15,0,0
3618,1560,487,1673,762,39,17,2,113,275,7,15,0,0
3619,1558,487,1671,762,39,17,2,113,275,8,15,0,0
3620,1559,488,1671,759,39,17,2,112,271,9,15,0,0
3621,1541,486,1671,794,39,17,2,130,308,10,15,0,0
3622,1540,486,1670,793,39,17,2,130,307,11,15,0,0
3623,1532,485,1671,808,39,17,2,139,323,12,15,0,0
3624,1529,485,1673,815,39,17,2,144,330,13,15,0,0
3625,1529,486,1675,817,39,17,2,146,331,14,15,0,0
3626,1527,486,1674,819,39,17,2,147,333,15,15,0,0
3651,1523,488,1667,794,39,17,2,144,306,0,15,0,0
3652,1520,488,1671,797,39,17,2,151,309,1,15,0,0
3653,1520,483,1677,810,39,17,2,157,327,2,15,0,0
3654,1520,485,1677,806,39,17,2,157,321,3,15,0,0
3655,1522,483,1681,812,39,17,2,159,329,4,15,0,0
3656,1523,483,1682,813,39,17,2,159,330,5,15,0,0
3722,1543,490,1675,794,40,17,2,132,304,0,9,0,0
3723,1542,490,1674,793,40,17,2,132,303,1,9,0,0
3724,1543,491,1674,792,40,17,2,131,301,2,9,0,0
3725,1541,489,1672,791,40,17,2,131,302,3,9,0,0
3726,1547,486,1676,783,40,17,2,129,297,4,9,0,0
3727,1549,484,1677,781,40,17,2,128,297,5,9,0,0
3728,1549,484,1677,780,40,17,2,128,296,6,9,0,0
3729,1543,481,1680,798,40,17,2,137,317,7,9,0,0
3730,1546,483,1680,794,40,17,2,134,311,8,9,0,0
3731,1547,482,1681,794,40,17,2,134,312,9,9,0,0
4676,1508,483,1677,807,41,17,2,169,324,0,5,0,0
4677,1507,481,1679,810,41,17,2,172,329,1,5,0,0
4678,1509,481,1680,810,41,17,2,171,329,2,5,0,0
4679,1511,486,1680,810,41,17,2,169,324,3,5,0,0
4680,1511,482,1682,811,41,17,2,171,329,4,5,0,0
4681,1512,482,1683,811,41,17,2,171,329,5,5,0,0
4782,3,792,134,1080,42,17,2,131,288,0,117,0,1
4783,6,682,182,1071,42,17,2,176,389,1,117,0,0
4784,54,650,248,1072,42,17,2,194,422,2,117,0,0
4785,100,612,315,1072,42,17,2,215,460,3,117,0,0
4786,157,579,391,1070,42,17,2,234,491,4,117,0,0
4787,214,553,465,1070,42,17,2,251,517,5,117,0,0
4788,246,517,516,1070,42,17,2,270,553,6,117,0,0
4789,303,503,587,1071,42,17,2,284,568,7,117,0,0
4790,357,500,649,1071,42,17,2,292,571,8,117,0,0
4791,405,505,700,1073,42,17,2,295,568,9,117,0,0
4792,450,500,748,1074,42,17,2,298,574,10,117,0,0
4793,493,488,794,1066,42,17,2,301,578,11,117,0,0
4794,530,475,834,1065,42,17,2,304,590,12,117,0,0
4795,572,469,871,1069,42,17,2,299,600,13,117,0,0
4796,598,460,891,1061,42,17,2,293,601,14,117,0,0
4797,645,458,929,1055,42,17,2,284,597,15,117,0,0
4798,678,458,951,1050,42,17,2,273,592,16,117,0,0
4799,702,460,967,1048,42,17,2,265,588,17,117,0,0
4800,725,450,983,1037,42,17,2,258,587,18,117,0,0
4801,754,445,1009,1044,42,17,2,255,599,19,117,0,0
4802,769,435,1022,1047,42,17,2,253,612,20,117,0,0
4803,774,431,1018,1043,42,17,2,244,612,21,117,0,0
4804,777,428,1015,1045,42,17,2,238,617,22,117,0,0
4805,776,428,1008,1043,42,17,2,232,615,23,117,0,0
4806,781,427,1009,1048,42,17,2,228,621,24,117,0,0
4807,784,427,1006,1050,42,17,2,222,623,25,117,0,0
4808,781,430,997,1051,42,17,2,216,621,26,117,0,0
4809,780,432,990,1050,42,17,2,210,618,27,117,0,0
4810,782,430,988,1050,42,17,2,206,620,28,117,0,0
4811,791,435,991,1048,42,17,2,200,613,29,117,0,0
4812,798,437,993,1046,42,17,2,195,609,30,117,0,0
4813,796,434,988,1047,42,17,2,192,613,31,117,0,0
4814,792,431,981,1048,42,17,2,189,617,32,117,0,0
4815,786,428,974,1046,42,17,2,188,618,33,117,0,0
4816,788,429,972,1042,42,17,2,184,613,34,117,0,0
4817,789,431,969,1037,42,17,2,180,606,35,117,0,0
4818,779,431,961,1043,42,17,2,182,612,36,117,0,0
4819,789,431,969,1046,42,17,2,180,615,37,117,0,0
4820,794,432,970,1044,42,17,2,176,612,38,117,0,0
4821,786,435,963,1046,42,17,2,177,611,39,117,0,0
4822,784,364,977,1048,42,17,2,193,684,40,117,0,0
4823,782,333,980,1050,42,17,2,198,717,41,117,0,0
4824,783,329,977,1049,42,17,2,194,720,42,117,0,0
4825,787,334,976,1050,42,17,2,189,716,43,117,0,0
4826,788,337,972,1049,42,17,2,184,712,44,117,0,0
4827,789,343,969,1048,42,17,2,180,705,45,117,0,0
4828,793,356,967,1043,42,17,2,174,687,46,117,0,0
4829,795,365,964,1045,42,17,2,169,680,47,117,0,0
4830,798,389,961,1046,42,17,2,163,657,48,117,0,0
4831,796,409,955,1048,42,17,2,159,639,49,117,0,0
4832,801,418,956,1047,42,17,2,155,629,50,117,0,0
4833,809,427,957,1032,42,17,2,148,605,51,117,0,0
4834,809,418,960,1038,42,17,2,151,620,52,117,0,0
4835,804,418,957,1043,42,17,2,153,625,53,117,0,0
4836,812,426,964,1044,42,17,2,152,618,54,117,0,0
4837,813,433,962,1044,42,17,2,149,611,55,117,0,0
4838,812,441,959,1044,42,17,2,147,603,56,117,0,0
4839,796,438,946,1044,42,17,2,150,606,57,117,0,0
4840,793,435,942,1042,42,17,2,149,607,58,117,0,0
4841,792,430,942,1046,42,17,2,150,616,59,117,0,0
4842,785,416,929,999,42,17,2,144,583,60,117,0,0
4843,765,398,908,965,42,17,2,143,567,61,117,0,0
4844,741,384,877,914,42,17,2,136,530,62,117,0,0
4845,709,365,844,878,42,17,2,135,513,63,117,0,0
4846,681,357,818,861,42,17,2,137,504,64,117,0,0
4847,663,332,791,789,42,17,2,128,457,65,117,0,0
4848,637,324,763,766,42,17,2,126,442,66,117,0,0
4849,612,312,733,729,42,17,2,121,417,67,117,0,0
4850,589,294,709,703,42,17,2,120,409,68,117,0,0
4851,572,284,690,678,42,17,2,118,394,69,117,0,0
4852,561,267,670,632,42,17,2,109,365,70,117,0,0
4853,549,265,652,610,42,17,2,103,345,71,117,0,0
4854,534,257,631,582,42,17,2,97,325,72,117,0,0
4855,517,248,614,573,42,17,2,97,325,73,117,0,0
4856,505,240,600,556,42,17,2,95,316,74,117,0,0
4857,501,231,588,522,42,17,2,87,291,75,117,0,0
4858,494,231,578,517,42,17,2,84,286,76,117,0,0
4859,481,227,562,497,42,17,2,81,270,77,117,0,0
4860,473,224,549,476,42,17,2,76,252,78,117,0,0
4861,467,221,539,462,42,17,2,72,241,79,117,0,0
4862,458,212,531,455,42,17,2,73,243,80,117,0,0
4863,451,211,521,441,42,17,2,70,230,81,117,0,0
4864,437,201,508,435,42,17,2,71,234,82,117,0,0
4865,431,201,499,427,42,17,2,68,226,83,117,0,0
4866,430,198,495,415,42,17,2,65,217,84,117,0,0
4867,429,197,491,405,42,17,2,62,208,85,117,0,0
4868,421,199,481,403,42,17,2,60,204,86,117,0,0
4869,418,192,477,392,42,17,2,59,200,87,117,0,0
4870,420,191,477,382,42,17,2,57,191,88,117,0,0
4871,422,197,475,374,42,17,2,53,177,89,117,0,0
4872,422,188,477,370,42,17,2,55,182,90,117,0,0
4873,421,196,471,362,42,17,2,50,166,91,117,0,0
4874,416,192,466,356,42,17,2,50,164,92,117,0,0
4875,412,190,462,353,42,17,2,50,163,93,117,0,0
4876,409,185,458,344,42,17,2,49,159,94,117,0,0
4877,402,183,451,340,42,17,2,49,157,95,117,0,0
4878,394,179,445,345,42,17,2,51,166,96,117,0,0
4879,390,178,438,336,42,17,2,48,158,97,117,0,0
4880,386,178,433,332,42,17,2,47,154,98,117,0,0
4881,379,173,427,330,42,17,2,48,157,99,117,0,0
4882,372,171,419,327,42,17,2,47,156,100,117,0,0
4883,366,168,414,326,42,17,2,48,158,101,117,0,0
4884,361,167,407,321,42,17,2,46,154,102,117,0,0
4885,357,169,401,316,42,17,2,44,147,103,117,0,0
4886,357,168,398,307,42,17,2,41,139,104,117,0,0
4887,356,166,396,301,42,17,2,40,135,105,117,0,0
4888,354,167,394,305,42,17,2,40,138,106,117,0,0
4889,353,164,393,300,42,17,2,40,136,107,117,0,0
4890,351,163,392,298,42,17,2,41,135,108,117,0,0
4891,351,159,391,295,42,17,2,40,136,109,117,0,0
4892,348,159,388,295,42,17,2,40,136,110,117,0,0
4893,345,158,385,290,42,17,2,40,132,111,117,0,0
4894,343,158,381,285,42,17,2,38,127,112,117,0,0
4895,341,161,378,285,42,17,2,37,124,113,117,0,0
4896,339,159,376,282,42,17,2,37,123,114,117,0,0
4897,338,162,373,280,42,17,2,35,118,115,117,0,0
4898,336,158,372,277,42,17,2,36,119,116,117,0,0
4899,336,157,371,274,42,17,2,35,117,117,117,1,0
4792,2,572,141,1072,43,17,2,139,500,0,119,0,1
4793,48,558,192,1066,43,17,2,144,508,1,119,0,0
4794,121,530,268,1044,43,17,2,147,514,2,119,0,0
4795,186,502,345,1048,43,17,2,159,546,3,119,0,0
4796,247,485,418,1064,43,17,2,171,579,4,119,0,0
4797,301,466,477,1057,43,17,2,176,591,5,119,0,0
4798,327,448,506,1039,43,17,2,179,591,6,119,0,0
4799,351,436,539,1048,43,17,2,188,612,7,119,0,0
4800,371,425,555,1026,43,17,2,184,601,8,119,0,0
4801,390,423,576,1036,43,17,2,186,613,9,119,0,0
4802,401,421,585,1039,43,17,2,184,618,10,119,0,0
4803,411,420,592,1037,43,17,2,181,617,11,119,0,0
4804,418,418,599,1042,43,17,2,181,624,12,119,0,0
4805,425,417,597,1022,43,17,2,172,605,13,119,0,0
4806,432,416,591,979,43,17,2,159,563,14,119,0,0
4807,439,424,595,979,43,17,2,156,555,15,119,0,0
4808,445,430,592,950,43,17,2,147,520,16,119,0,0
4809,441,425,586,939,43,17,2,145,514,17,119,0,0
4810,442,424,583,923,43,17,2,141,499,18,119,0,0
4811,420,428,581,992,43,17,2,161,564,19,119,0,0
4812,409,428,577,1007,43,17,2,168,579,20,119,0,0
4813,401,421,574,1014,43,17,2,173,593,21,119,0,0
4814,406,418,579,1019,43,17,2,173,601,22,119,0,0
4815,413,419,584,1019,43,17,2,171,600,23,119,0,0
4816,424,415,595,1016,43,17,2,171,601,24,119,0,0
4817,433,408,601,1009,43,17,2,168,601,25,119,0,0
4818,464,416,611,927,43,17,2,147,511,26,119,0,0
4819,480,401,618,874,43,17,2,138,473,27,119,0,0
4820,486,402,643,942,43,17,2,157,540,28,119,0,0
4821,485,403,644,945,43,17,2,159,542,29,119,0,0
4822,486,403,659,977,43,17,2,173,574,30,119,0,0
4823,471,401,650,990,43,17,2,179,589,31,119,0,0
4824,457,401,640,994,43,17,2,183,593,32,119,0,0
4825,449,404,636,996,43,17,2,187,592,33,119,0,0
4826,451,408,641,996,43,17,2,190,588,34,119,0,0
4827,448,413,640,996,43,17,2,192,583,35,119,0,0
4828,443,417,635,996,43,17,2,192,579,36,119,0,0
4829,444,419,635,994,43,17,2,191,575,37,119,0,0
4830,455,415,652,996,43,17,2,197,581,38,119,0,0
4831,450,414,649,994,43,17,2,199,580,39,119,0,0
4832,445,416,645,994,43,17,2,200,578,40,119,0,0
4833,437,417,636,992,43,17,2,199,575,41,119,0,0
4834,436,416,634,993,43,17,2,198,577,42,119,0,0
4835,443,416,641,995,43,17,2,198,579,43,119,0,0
4836,446,415,640,990,43,17,2,194,575,44,119,0,0
4837,453,414,639,970,43,17,2,186,556,45,119,0,0
4838,463,413,642,953,43,17,2,179,540,46,119,0,0
4839,473,408,643,933,43,17,2,170,525,47,119,0,0
4840,487,401,643,894,43,17,2,156,493,48,119,0,0
4841,499,403,646,877,43,17,2,147,474,49,119,0,0
4842,500,396,641,851,43,17,2,141,455,50,119,0,0
4843,478,399,640,919,43,17,2,162,520,51,119,0,0
4844,477,395,644,932,43,17,2,167,537,52,119,0,0
4845,483,386,648,914,43,17,2,165,528,53,119,0,0
4846,472,379,635,880,43,17,2,163,501,54,119,0,0
4847,452,365,627,876,43,17,2,175,511,55,119,0,0
4848,434,353,612,849,43,17,2,178,496,56,119,0,0
4849,403,340,584,826,43,17,2,181,486,57,119,0,0
4850,387,334,564,796,43,17,2,177,462,58,119,0,0
4851,374,317,544,749,43,17,2,170,432,59,119,0,0
4852,371,306,536,720,43,17,2,165,414,60,119,0,0
4853,355,295,515,691,43,17,2,160,396,61,119,0,0
4854,332,288,492,675,43,17,2,160,387,62,119,0,0
4855,324,280,481,658,43,17,2,157,378,63,119,0,0
4856,322,268,474,629,43,17,2,152,361,64,119,0,0
4857,324,268,470,614,43,17,2,146,346,65,119,0,0
4858,311,256,452,587,43,17,2,141,331,66,119,0,0
4859,308,248,442,564,43,17,2,134,316,67,119,0,0
4860,311,244,441,552,43,17,2,130,308,68,119,0,0
4861,307,238,432,535,43,17,2,125,297,69,119,0,0
4862,309,238,428,520,43,17,2,119,282,70,119,0,0
4863,296,228,417,508,43,17,2,121,280,71,119,0,0
4864,287,226,405,497,43,17,2,118,271,72,119,0,0
4865,290,224,400,475,43,17,2,110,251,73,119,0,0
4866,290,221,397,462,43,17,2,107,241,74,119,0,0
4867,297,222,399,455,43,17,2,102,233,75,119,0,0
4868,287,214,392,447,43,17,2,105,233,76,119,0,0
4869,295,213,395,440,43,17,2,100,227,77,119,0,0
4870,303,206,396,425,43,17,2,93,219,78,119,0,0
4871,300,203,391,417,43,17,2,91,214,79,119,0,0
4872,302,202,389,410,43,17,2,87,208,80,119,0,0
4873,296,198,380,401,43,17,2,84,203,81,119,0,0
4874,295,197,376,396,43,17,2,81,199,82,119,0,0
4875,293,194,371,385,43,17,2,78,191,83,119,0,0
4876,295,193,371,380,43,17,2,76,187,84,119,0,0
4877,292,187,368,374,43,17,2,76,187,85,119,0,0
4878,288,181,364,367,43,17,2,76,186,86,119,0,0
4879,291,179,364,358,43,17,2,73,179,87,119,0,0
4880,296,177,366,353,43,17,2,70,176,88,119,0,0
4881,296,177,365,351,43,17,2,69,174,89,119,0,0
4882,300,174,366,346,43,17,2,66,172,90,119,0,0
4883,299,175,363,342,43,17,2,64,167,91,119,0,0
4884,300,175,362,335,43,17,2,62,160,92,119,0,0
4885,302,174,362,330,43,17,2,60,156,93,119,0,0
4886,306,174,364,327,43,17,2,58,153,94,119,0,0
4887,301,162,362,323,43,17,2,61,161,95,119,0,0
4888,302,167,359,319,43,17,2,57,152,96,119,0,0
4889,303,163,358,315,43,17,2,55,152,97,119,0,0
4890,302,164,355,310,43,17,2,53,146,98,119,0,0
4891,297,161,350,308,43,17,2,53,147,99,119,0,0
4892,297,155,350,303,43,17,2,53,148,100,119,0,0
4893,296,154,347,299,43,17,2,51,145,101,119,0,0
4894,295,148,346,295,43,17,2,51,147,102,119,0,0
4895,296,153,344,294,43,17,2,48,141,103,119,0,0
4896,294,150,342,292,43,17,2,48,142,104,119,0,0
4897,295,153,341,290,43,17,2,46,137,105,119,0,0
4898,296,150,340,286,43,17,2,44,136,106,119,0,0
4899,297,149,340,282,43,17,2,43,133,107,119,0,0
4900,298,150,339,278,43,17,2,41,128,108,119,0,0
4901,296,146,338,277,43,17,2,42,131,109,119,0,0
4902,297,148,338,275,43,17,2,41,127,110,119,0,0
4903,300,149,338,270,43,17,2,38,121,111,119,0,0
4904,301,148,339,268,43,17,2,38,120,112,119,0,0
4905,301,148,339,266,43,17,2,38,118,113,119,0,0
4906,302,147,339,264,43,17,2,37,117,114,119,0,0
4907,302,147,339,263,43,17,2,37,116,115,119,0,0
4908,303,147,338,259,43,17,2,35,112,116,119,0,0
4909,303,144,339,256,43,17,2,36,112,117,119,0,0
4910,302,145,337,255,43,17,2,35,110,118,119,0,0
4911,301,143,336,254,43,17,2,35,111,119,119,1,0
4915,300,132,335,247,43,17,2,35,115,0,119,0,0
4916,300,130,337,248,43,17,2,37,118,1,119,0,0
4917,301,131,336,242,43,17,2,35,111,2,119,0,0
4918,301,128,336,242,43,17,2,35,114,3,119,0,0
4919,300,128,335,240,43,17,2,35,112,4,119,0,0
4920,300,125,335,239,43,17,2,35,114,5,119,0,0
4796,1529,482,1679,826,44,17,2,150,344,0,5,0,0
4797,1529,482,1679,826,44,17,2,150,344,1,5,0,0
4798,1529,482,1678,826,44,17,2,149,344,2,5,0,0
4799,1529,482,1679,825,44,17,2,150,343,3,5,0,0
4800,1529,482,1678,824,44,17,2,149,342,4,5,0,0
4801,1529,482,1678,824,44,17,2,149,342,5,5,0,0
5005,1550,489,1677,776,56,17,2,127,287,0,0,0,0
5121,1558,486,1675,772,57,17,2,117,286,0,0,0,0
5206,1546,486,1672,802,58,17,2,126,316,0,5,0,0
5207,1548,488,1667,787,58,17,2,119,299,1,5,0,0
5208,1547,488,1665,782,58,17,2,118,294,2,5,0,0
5209,1544,485,1667,791,58,17,2,123,306,3,5,0,0
5210,1545,485,1670,797,58,17,2,125,312,4,5,0,0
5211,1544,485,1670,799,58,17,2,126,314,5,5,0,0
5331,1558,489,1676,774,59,17,2,118,285,0,5,0,0
5332,1559,488,1676,771,59,17,2,117,283,1,5,0,0
5333,1559,487,1677,771,59,17,2,118,284,2,5,0,0
5334,1560,487,1677,771,59,17,2,117,284,3,5,0,0
5335,1559,488,1677,775,59,17,2,118,287,4,5,0,0
5336,1559,488,1677,776,59,17,2,118,288,5,5,0,0
5351,1542,481,1670,785,59,17,2,128,304,0,5,0,0
5352,1541,480,1669,785,59,17,2,128,305,1,5,0,0
5481,1516,482,1684,797,60,17,2,168,315,0,0,0,0
5483,1514,482,1684,795,61,17,2,170,313,0,0,0,0
5485,1513,482,1684,793,62,17,2,171,311,0,0,0,0
5496,1527,487,1684,804,63,17,2,157,317,0,0,0,0
5499,1548,487,1676,774,64,17,2,128,287,0,1,0,0
5500,1540,481,1678,790,64,17,2,138,309,1,1,0,0
5651,1537,491,1677,768,65,17,2,140,277,0,9,0,0
5652,1523,488,1678,794,65,17,2,155,306,1,9,0,0
5653,1533,490,1678,776,65,17,2,145,286,2,9,0,0
5654,1529,491,1679,788,65,17,2,150,297,3,9,0,0
5655,1522,489,1679,798,65,17,2,157,309,4,9,0,0
5656,1520,489,1679,802,65,17,2,159,313,5,9,0,0
5666,1531,483,1686,791,65,17,2,155,308,0,9,0,0
5667,1533,482,1687,790,65,17,2,154,308,1,9,0,0
5668,1532,483,1685,790,65,17,2,153,307,2,9,0,0
5669,1534,482,1685,787,65,17,2,151,305,3,9,0,0
5670,1534,484,1683,786,65,17,2,149,302,4,9,0,0
5671,1527,484,1685,804,65,17,2,158,320,5,9,0,0
5672,1525,483,1686,810,65,17,2,161,327,6,9,0,0
5673,1524,483,1687,812,65,17,2,163,329,7,9,0,0
5674,1525,483,1687,811,65,17,2,162,328,8,9,0,0
5675,1524,482,1688,814,65,17,2,164,332,9,9,0,0
5767,1552,488,1674,778,66,17,2,122,290,0,1,0,0
5768,1551,488,1672,775,66,17,2,121,287,1,1,0,0
5826,1527,489,1675,795,67,17,2,148,306,0,0,0,0
5828,1541,489,1673,781,68,17,2,132,292,0,3,0,0
5829,1540,489,1674,783,68,17,2,134,294,1,3,0,0
5830,1540,489,1675,786,68,17,2,135,297,2,3,0,0
5831,1540,489,1675,787,68,17,2,135,298,3,3,0,0
5911,1526,482,1684,804,69,17,2,158,322,0,5,0,0
5912,1527,482,1685,804,69,17,2,158,322,1,5,0,0
5913,1528,482,1687,806,69,17,2,159,324,2,5,0,0
5914,1527,482,1686,807,69,17,2,159,325,3,5,0,0
5915,1526,483,1685,808,69,17,2,159,325,4,5,0,0
5916,1525,484,1685,810,69,17,2,160,326,5,5,0,0
5921,1545,488,1679,765,69,17,2,134,277,0,5,0,0
5922,1547,489,1679,760,69,17,2,132,271,1,5,0,0
5923,1547,489,1677,758,69,17,2,130,269,2,5,0,0
5924,1547,489,1676,757,69,17,2,129,268,3,5,0,0
5925,1546,488,1676,760,69,17,2,130,272,4,5,0,0
5926,1547,488,1675,757,69,17,2,128,269,5,5,0,0
5940,1543,486,1681,775,69,17,2,138,289,0,5,0,0
5941,1543,485,1681,776,69,17,2,138,291,1,5,0,0
5948,1552,487,1683,774,69,17,2,131,287,0,5,0,0
5949,1552,487,1683,774,69,17,2,131,287,1,5,0,0
5950,1553,487,1683,779,69,17,2,130,292,2,5,0,0
5951,1553,487,1684,780,69,17,2,131,293,3,5,0,0
5954,1552,483,1688,793,69,17,2,136,310,0,5,0,0
5955,1552,483,1689,795,69,17,2,137,312,1,5,0,0
320,556,176,592,371,1,17,3,36,195,0,49,0,1
321,550,183,587,377,1,17,3,37,194,1,49,0,0
322,541,187,579,379,1,17,3,38,192,2,49,0,0
323,533,192,573,386,1,17,3,40,194,3,49,0,0
324,526,189,570,392,1,17,3,44,203,4,49,0,0
325,523,192,570,402,1,17,3,47,210,5,49,0,0
326,529,191,579,408,1,17,3,50,217,6,49,0,0
327,535,189,589,414,1,17,3,54,225,7,49,0,0
328,540,187,598,424,1,17,3,58,237,8,49,0,0
329,541,191,603,432,1,17,3,62,241,9,49,0,0
330,556,204,618,445,1,17,3,62,241,10,49,0,0
331,567,211,631,452,1,17,3,64,241,11,49,0,0
332,584,218,648,458,1,17,3,64,240,12,49,0,0
333,597,225,667,477,1,17,3,70,252,13,49,0,0
334,608,226,681,485,1,17,3,73,259,14,49,0,0
335,621,231,698,502,1,17,3,77,271,15,49,0,0
336,636,238,716,511,1,17,3,80,273,16,49,0,0
337,652,243,736,523,1,17,3,84,280,17,49,0,0
338,664,254,755,550,1,17,3,91,296,18,49,0,0
339,674,257,766,557,1,17,3,92,300,19,49,0,0
340,680,263,776,575,1,17,3,96,312,20,49,0,0
341,691,266,793,593,1,17,3,102,327,21,49,0,0
342,705,272,814,616,1,17,3,109,344,22,49,0,0
343,715,283,830,646,1,17,3,115,363,23,49,0,0
344,722,288,840,658,1,17,3,118,370,24,49,0,0
345,728,298,854,696,1,17,3,126,398,25,49,0,0
346,743,305,872,710,1,17,3,129,405,26,49,0,0
347,761,321,899,751,1,17,3,138,430,27,49,0,0
348,769,337,916,787,1,17,3,147,450,28,49,0,0
349,773,346,922,803,1,17,3,149,457,29,49,0,0
350,776,364,936,853,1,17,3,160,489,30,49,0,0
351,784,382,951,888,1,17,3,167,506,31,49,0,0
352,792,389,972,926,1,17,3,180,537,32,49,0,0
353,797,413,997,997,1,17,3,200,584,33,49,0,0
354,804,434,1009,1024,1,17,3,205,590,34,49,0,0
355,809,454,1022,1061,1,17,3,213,607,35,49,0,0
356,831,485,1042,1073,1,17,3,211,588,36,49,0,0
357,865,509,1073,1080,1,17,3,208,571,37,49,0,0
358,898,550,1098,1080,1,17,3,200,530,38,49,0,0
359,916,584,1113,1080,1,17,3,197,496,39,49,0,0
360,932,609,1134,1080,1,17,3,202,471,40,49,0,0
361,941,643,1148,1080,1,17,3,207,437,41,49,0,0
362,948,683,1166,1080,1,17,3,218,397,42,49,0,0
363,966,713,1195,1080,1,17,3,229,367,43,49,0,0
364,1043,756,1260,1079,1,17,3,217,323,44,49,0,0
365,1082,797,1282,1074,1,17,3,200,277,45,49,0,0
366,1078,830,1272,1078,1,17,3,194,248,46,49,0,0
367,1082,852,1273,1078,1,17,3,191,226,47,49,0,0
368,1095,884,1268,1077,1,17,3,173,193,48,49,0,0
369,1120,914,1270,1080,1,17,3,150,166,49,49,1,0
330,513,183,583,393,3,17,3,70,210,0,47,0,1
331,508,189,579,401,3,17,3,71,212,1,47,0,0
332,506,190,578,406,3,17,3,72,216,2,47,0,0
333,507,190,579,405,3,17,3,72,215,3,47,0,0
334,510,194,586,418,3,17,3,76,224,4,47,0,0
335,511,196,588,418,3,17,3,77,222,5,47,0,0
336,511,200,592,432,3,17,3,81,232,6,47,0,0
337,517,205,601,443,3,17,3,84,238,7,47,0,0
338,531,204,619,446,3,17,3,88,242,8,47,0,0
339,540,210,633,460,3,17,3,93,250,9,47,0,0
340,549,215,645,467,3,17,3,96,252,10,47,0,0
341,555,219,654,477,3,17,3,99,258,11,47,0,0
342,557,226,661,494,3,17,3,104,268,12,47,0,0
343,572,226,681,500,3,17,3,109,274,13,47,0,0
344,585,231,702,517,3,17,3,117,286,14,47,0,0
345,590,234,713,531,3,17,3,123,297,15,47,0,0
346,593,240,723,551,3,17,3,130,311,16,47,0,0
347,595,251,729,571,3,17,3,134,320,17,47,0,0
348,608,255,745,577,3,17,3,137,322,18,47,0,0
349,618,263,764,600,3,17,3,146,337,19,47,0,0
350,622,271,772,614,3,17,3,150,343,20,47,0,0
351,621,276,779,638,3,17,3,158,362,21,47,0,0
352,623,288,785,664,3,17,3,162,376,22,47,0,0
353,637,294,806,676,3,17,3,169,382,23,47,0,0
354,645,305,821,698,3,17,3,176,393,24,47,0,0
355,631,315,819,735,3,17,3,188,420,25,47,0,0
356,630,329,825,767,3,17,3,195,438,26,47,0,0
357,627,348,830,802,3,17,3,203,454,27,47,0,0
358,641,357,855,819,3,17,3,214,462,28,47,0,0
359,633,378,861,864,3,17,3,228,486,29,47,0,0
360,613,389,856,907,3,17,3,243,518,30,47,0,0
361,602,401,855,942,3,17,3,253,541,31,47,0,0
362,587,431,859,1017,3,17,3,272,586,32,47,0,0
363,576,449,859,1053,3,17,3,283,604,33,47,0,0
364,570,461,859,1070,3,17,3,289,609,34,47,0,0
365,556,485,841,1079,3,17,3,285,594,35,47,0,0
366,550,506,836,1080,3,17,3,286,574,36,47,0,0
367,539,535,819,1080,3,17,3,280,545,37,47,0,0
368,519,570,793,1080,3,17,3,274,510,38,47,0,0
369,510,596,782,1080,3,17,3,272,484,39,47,0,0
370,511,624,782,1080,3,17,3,271,456,40,47,0,0
371,502,659,764,1080,3,17,3,262,421,41,47,0,0
372,492,698,749,1078,3,17,3,257,380,42,47,0,0
373,475,742,724,1080,3,17,3,249,338,43,47,0,0
374,438,769,676,1075,3,17,3,238,306,44,47,0,0
375,443,784,681,1074,3,17,3,238,290,45,47,0,0
376,467,808,697,1074,3,17,3,230,266,46,47,0,0
377,485,830,715,1074,3,17,3,230,244,47,47,1,0
453,238,233,291,519,9,17,3,53,286,0,25,0,1
454,257,233,321,576,9,17,3,64,343,1,25,0,0
455,271,237,340,596,9,17,3,69,359,2,25,0,0
456,285,233,358,602,9,17,3,73,369,3,25,0,0
457,303,239,378,608,9,17,3,75,369,4,25,0,0
458,315,247,394,629,9,17,3,79,382,5,25,0,0
459,323,248,408,645,9,17,3,85,397,6,25,0,0
460,341,256,432,663,9,17,3,91,407,7,25,0,0
461,354,264,450,673,9,17,3,96,409,8,25,0,0
462,368,264,470,682,9,17,3,102,418,9,25,0,0
463,372,269,484,708,9,17,3,112,439,10,25,0,0
464,364,276,486,730,9,17,3,122,454,11,25,0,0
465,331,279,466,744,9,17,3,135,465,12,25,0,0
466,312,284,462,767,9,17,3,150,483,13,25,0,0
467,300,292,465,791,9,17,3,165,499,14,25,0,0
468,297,298,478,816,9,17,3,181,518,15,25,0,0
469,304,297,494,825,9,17,3,190,528,16,25,0,0
470,322,300,507,822,9,17,3,185,522,17,25,0,0
471,320,304,501,822,9,17,3,181,518,18,25,0,0
472,309,306,488,816,9,17,3,179,510,19,25,0,0
473,294,309,475,824,9,17,3,181,515,20,25,0,0
474,271,309,448,810,9,17,3,177,501,21,25,0,0
475,241,303,413,795,9,17,3,172,492,22,25,0,0
476,228,302,394,780,9,17,3,166,478,23,25,0,0
477,217,338,350,735,9,17,3,133,397,24,25,0,0
478,210,344,341,733,9,17,3,131,389,25,25,1,0
655,231,317,367,608,19,17,3,136,291,0,28,0,1
656,227,317,394,675,19,17,3,167,358,1,28,0,0
657,214,310,417,748,19,17,3,203,438,2,28,0,0
658,211,310,425,776,19,17,3,214,466,3,28,0,0
659,223,312,443,801,19,17,3,220,489,4,28,0,0
660,243,318,466,819,19,17,3,223,501,5,28,0,0
661,274,315,498,827,19,17,3,224,512,6,28,0,0
662,309,315,533,835,19,17,3,224,520,7,28,0,0
663,337,312,562,847,19,17,3,225,535,8,28,0,0
664,371,297,591,835,19,17,3,220,538,9,28,0,0
665,408,297,616,818,19,17,3,208,521,10,28,0,0
666,448,299,646,795,19,17,3,198,496,11,28,0,0
667,472,295,659,771,19,17,3,187,476,12,28,0,0
668,491,289,675,757,19,17,3,184,468,13,28,0,0
669,497,286,678,747,19,17,3,181,461,14,28,0,0
670,490,282,663,728,19,17,3,173,446,15,28,0,0
671,476,278,643,709,19,17,3,167,431,16,28,0,0
672,462,273,629,703,19,17,3,167,430,17,28,0,0
673,449,266,613,692,19,17,3,164,426,18,28,0,0
674,438,256,598,673,19,17,3,160,417,19,28,0,0
675,413,251,569,659,19,17,3,156,408,20,28,0,0
676,388,257,541,654,19,17,3,153,397,21,28,0,0
677,358,257,508,648,19,17,3,150,391,22,28,0,0
678,330,252,476,635,19,17,3,146,383,23,28,0,0
679,306,255,449,633,19,17,3,143,378,24,28,0,0
680,286,248,427,628,19,17,3,141,380,25,28,0,0
681,268,243,401,611,19,17,3,133,368,26,28,0,0
682,258,238,388,608,19,17,3,130,370,27,28,0,0
683,244,234,373,601,19,17,3,129,367,28,28,1,0
724,82,922,194,1079,26,17,3,112,157,0,10,0,0
725,79,917,194,1079,26,17,3,115,162,1,10,0,0
726,81,921,194,1079,26,17,3,113,158,2,10,0,0
727,80,919,193,1078,26,17,3,113,159,3,10,0,0
728,79,916,193,1078,26,17,3,114,162,4,10,0,0
729,77,910,196,1078,26,17,3,119,168,5,10,0,0
730,75,908,197,1079,26,17,3,122,171,6,10,0,0
731,78,912,197,1079,26,17,3,119,167,7,10,0,0
732,78,913,195,1079,26,17,3,117,166,8,10,0,0
733,81,919,193,1078,26,17,3,112,159,9,10,0,0
734,82,919,193,1078,26,17,3,111,159,10,10,0,0
740,93,926,201,1076,26,17,3,108,150,0,10,0,0
741,100,934,206,1075,26,17,3,106,141,1,10,0,0
742,102,935,207,1075,26,17,3,105,140,2,10,0,0
747,78,905,204,1075,26,17,3,126,170,0,10,0,0
748,81,900,212,1074,26,17,3,131,174,1,10,0,0
749,79,895,215,1075,26,17,3,136,180,2,10,0,0
750,76,889,216,1075,26,17,3,140,186,3,10,0,0
751,75,886,217,1074,26,17,3,142,188,4,10,0,0
755,70,892,205,1075,26,17,3,135,183,0,10,0,0
756,69,891,205,1075,26,17,3,136,184,1,10,0,0
778,109,962,201,1075,26,17,3,92,113,0,10,0,0
779,111,965,201,1074,26,17,3,90,109,1,10,0,0
786,80,908,215,1076,26,17,3,135,168,0,10,0,0
787,79,905,216,1078,26,17,3,137,173,1,10,0,0
788,78,903,216,1079,26,17,3,138,176,2,10,0,0
789,78,904,215,1080,26,17,3,137,176,3,10,0,0
790,76,900,216,1080,26,17,3,140,180,4,10,0,0
791,81,906,215,1079,26,17,3,134,173,5,10,0,0
792,81,906,215,1079,26,17,3,134,173,6,10,0,0
793,82,907,215,1078,26,17,3,133,171,7,10,0,0
794,81,904,216,1078,26,17,3,135,174,8,10,0,0
795,68,895,207,1078,26,17,3,139,183,9,10,0,0
796,65,892,207,1079,26,17,3,142,187,10,10,0,0
1866,332,736,564,1069,37,17,3,232,333,0,19,0,1
1867,332,742,559,1069,37,17,3,227,327,1,19,0,0
1868,329,736,561,1068,37,17,3,232,332,2,19,0,0
1869,334,735,568,1072,37,17,3,234,337,3,19,0,0
1870,335,727,575,1073,37,17,3,240,346,4,19,0,0
1871,332,722,574,1073,37,17,3,242,351,5,19,0,0
1872,330,716,574,1072,37,17,3,244,356,6,19,0,0
1873,330,715,576,1073,37,17,3,246,358,7,19,0,0
1874,311,712,560,1073,37,17,3,249,361,8,19,0,0
1875,258,711,520,1071,37,17,3,262,360,9,19,0,0
1876,233,708,509,1072,37,17,3,276,364,10,19,0,0
1877,229,703,519,1073,37,17,3,290,370,11,19,0,0
1878,228,704,527,1073,37,17,3,299,369,12,19,0,0
1879,228,709,531,1072,37,17,3,303,363,13,19,0,0
1880,223,709,535,1072,37,17,3,312,363,14,19,0,0
1881,211,711,532,1072,37,17,3,321,361,15,19,0,0
1882,202,711,533,1073,37,17,3,331,362,16,19,0,0
1883,205,719,535,1068,37,17,3,330,349,17,19,0,0
1884,202,719,539,1065,37,17,3,337,346,18,19,0,0
1885,189,712,542,1068,37,17,3,353,356,19,19,0,0
1888,245,705,607,1073,37,17,3,362,368,0,19,0,0
1889,262,710,607,1072,37,17,3,345,362,1,19,0,0
1890,259,731,580,1075,37,17,3,321,344,2,19,0,0
1891,230,766,518,1077,37,17,3,288,311,3,19,0,0
1892,180,813,423,1075,37,17,3,243,262,4,19,0,0
1893,127,848,333,1075,37,17,3,206,227,5,19,0,0
1894,105,886,275,1073,37,17,3,170,187,6,19,0,0
1895,82,915,226,1073,37,17,3,144,158,7,19,0,0
1896,64,935,190,1073,37,17,3,126,138,8,19,0,0
1910,59,821,304,1080,40,17,3,245,259,0,0,0,0
1912,46,766,306,1065,41,17,3,260,299,0,5,0,0
1913,41,776,297,1071,41,17,3,256,295,1,5,0,0
1914,25,758,296,1072,41,17,3,271,314,2,5,0,0
1915,17,752,295,1073,41,17,3,278,321,3,5,0,0
1916,34,768,292,1067,41,17,3,258,299,4,5,0,0
1917,32,768,290,1066,41,17,3,258,298,5,5,0,0
1920,53,787,295,1067,41,17,3,242,280,0,5,0,0
1921,56,790,295,1067,41,17,3,239,277,1,5,0,0
1923,36,758,301,1069,41,17,3,265,311,0,5,0,0
1924,23,745,294,1067,41,17,3,271,322,1,5,0,0
1925,20,741,294,1067,41,17,3,274,326,2,5,0,0
2810,489,181,527,337,49,17,3,38,156,0,18,0,0
2811,477,182,515,337,49,17,3,38,155,1,18,0,0
2812,464,183,504,341,49,17,3,40,158,2,18,0,0
2813,454,186,495,342,49,17,3,41,156,3,18,0,0
2814,441,187,484,348,49,17,3,43,161,4,18,0,0
2815,428,188,474,360,49,17,3,46,172,5,18,0,0
2816,416,187,463,361,49,17,3,47,174,6,18,0,0
2817,407,192,455,364,49,17,3,48,172,7,18,0,0
2818,398,187,449,366,49,17,3,51,179,8,18,0,0
2819,387,195,436,363,49,17,3,49,168,9,18,0,0
2820,371,198,424,377,49,17,3,53,179,10,18,0,0
2821,356,200,409,376,49,17,3,53,176,11,18,0,0
2822,341,204,396,386,49,17,3,55,182,12,18,0,0
2823,324,206,381,394,49,17,3,57,188,13,18,0,0
2824,305,209,366,405,49,17,3,61,196,14,18,0,0
2825,287,215,347,409,49,17,3,60,194,15,18,0,0
2826,267,215,328,408,49,17,3,61,193,16,18,0,0
2827,243,216,305,414,49,17,3,62,198,17,18,0,0
2828,228,218,290,419,49,17,3,62,201,18,18,0,0
2821,445,924,593,1075,51,17,3,148,151,0,1,0,0
2822,455,971,562,1079,51,17,3,107,108,1,1,0,0
2834,551,652,973,1078,52,17,3,422,426,0,68,0,1
2835,520,630,950,1073,52,17,3,430,443,1,68,0,0
2836,520,612,954,1073,52,17,3,434,461,2,68,0,0
2837,527,605,950,1068,52,17,3,423,463,3,68,0,0
2838,545,605,955,1069,52,17,3,410,464,4,68,0,0
2839,561,609,956,1070,52,17,3,395,461,5,68,0,0
2840,568,621,943,1070,52,17,3,375,449,6,68,0,0
2841,532,636,899,1067,52,17,3,367,431,7,68,0,0
2842,518,643,886,1070,52,17,3,368,427,8,68,0,0
2843,526,646,888,1066,52,17,3,362,420,9,68,0,0
2844,526,649,884,1063,52,17,3,358,414,10,68,0,0
2845,541,649,900,1068,52,17,3,359,419,11,68,0,0
2846,536,642,899,1068,52,17,3,363,426,12,68,0,0
2847,538,636,902,1067,52,17,3,364,431,13,68,0,0
2848,540,630,908,1073,52,17,3,368,443,14,68,0,0
2849,546,626,914,1075,52,17,3,368,449,15,68,0,0
2850,546,627,909,1075,52,17,3,363,448,16,68,0,0
2851,549,635,905,1076,52,17,3,356,441,17,68,0,0
2852,551,641,898,1074,52,17,3,347,433,18,68,0,0
2853,549,638,895,1072,52,17,3,346,434,19,68,0,0
2854,542,629,890,1066,52,17,3,348,437,20,68,0,0
2855,541,626,892,1070,52,17,3,351,444,21,68,0,0
2856,541,621,893,1070,52,17,3,352,449,22,68,0,0
2857,543,621,894,1071,52,17,3,351,450,23,68,0,0
2858,545,621,894,1073,52,17,3,349,452,24,68,0,0
2859,544,621,892,1074,52,17,3,348,453,25,68,0,0
2860,545,620,891,1074,52,17,3,346,454,26,68,0,0
2861,545,619,890,1074,52,17,3,345,455,27,68,0,0
2862,547,619,890,1074,52,17,3,343,455,28,68,0,0
2863,547,619,888,1073,52,17,3,341,454,29,68,0,0
2864,551,619,890,1073,52,17,3,339,454,30,68,0,0
2865,554,620,890,1074,52,17,3,336,454,31,68,0,0
2866,555,621,888,1072,52,17,3,333,451,32,68,0,0
2867,556,622,888,1073,52,17,3,332,451,33,68,0,0
2868,558,622,888,1073,52,17,3,330,451,34,68,0,0
2869,559,622,888,1073,52,17,3,329,451,35,68,0,0
2870,560,622,888,1074,52,17,3,328,452,36,68,0,0
2871,560,622,887,1072,52,17,3,327,450,37,68,0,0
2872,559,621,885,1072,52,17,3,326,451,38,68,0,0
2873,560,621,885,1072,52,17,3,325,451,39,68,0,0
2874,560,621,886,1072,52,17,3,326,451,40,68,0,0
2875,561,621,885,1072,52,17,3,324,451,41,68,0,0
2876,561,619,886,1072,52,17,3,325,453,42,68,0,0
2877,563,620,886,1072,52,17,3,323,452,43,68,0,0
2878,565,620,888,1073,52,17,3,323,453,44,68,0,0
2879,566,621,887,1073,52,17,3,321,452,45,68,0,0
2880,567,623,887,1073,52,17,3,320,450,46,68,0,0
2881,570,623,889,1073,52,17,3,319,450,47,68,0,0
2882,572,622,890,1073,52,17,3,318,451,48,68,0,0
2883,574,622,891,1072,52,17,3,317,450,49,68,0,0
2884,574,621,891,1072,52,17,3,317,451,50,68,0,0
2885,577,621,892,1072,52,17,3,315,451,51,68,0,0
2886,574,621,889,1072,52,17,3,315,451,52,68,0,0
2887,573,621,888,1074,52,17,3,315,453,53,68,0,0
2888,572,621,888,1074,52,17,3,316,453,54,68,0,0
2889,574,622,888,1073,52,17,3,314,451,55,68,0,0
2890,582,630,889,1071,52,17,3,307,441,56,68,0,0
2891,581,641,885,1073,52,17,3,304,432,57,68,0,0
2892,596,655,895,1075,52,17,3,299,420,58,68,0,0
2893,603,668,897,1074,52,17,3,294,406,59,68,0,0
2894,609,687,894,1074,52,17,3,285,387,60,68,0,0
2895,610,701,883,1072,52,17,3,273,371,61,68,0,0
2896,604,714,867,1071,52,17,3,263,357,62,68,0,0
2897,564,730,824,1071,52,17,3,260,341,63,68,0,0
2898,564,759,808,1068,52,17,3,244,309,64,68,0,0
2899,607,804,823,1069,52,17,3,216,265,65,68,0,0
2900,648,846,842,1072,52,17,3,194,226,66,68,0,0
2901,674,874,856,1074,52,17,3,182,200,67,68,0,0
2902,692,887,871,1072,52,17,3,179,185,68,68,1,0
2959,647,613,1089,1067,52,17,3,442,454,0,68,0,0
2960,645,605,1096,1068,52,17,3,451,463,1,68,0,0
2893,80,909,217,1075,59,17,3,137,166,0,14,0,0
2894,82,893,234,1077,59,17,3,152,184,1,14,0,0
2895,82,891,231,1072,59,17,3,149,181,2,14,0,0
2896,70,881,227,1072,59,17,3,157,191,3,14,0,0
2897,93,884,248,1072,59,17,3,155,188,4,14,0,0
2898,131,893,283,1076,59,17,3,152,183,5,14,0,0
2899,171,899,318,1073,59,17,3,147,174,6,14,0,0
2900,168,895,322,1072,59,17,3,154,177,7,14,0,0
2901,152,886,317,1074,59,17,3,165,188,8,14,0,0
2902,145,881,316,1075,59,17,3,171,194,9,14,0,0
2903,147,879,322,1074,59,17,3,175,195,10,14,0,0
2904,151,876,332,1074,59,17,3,181,198,11,14,0,0
2905,151,874,336,1074,59,17,3,185,200,12,14,0,0
2906,147,872,338,1072,59,17,3,191,200,13,14,0,0
2907,147,871,344,1073,59,17,3,197,202,14,14,0,0
2956,806,819,1046,1071,67,17,3,240,252,0,31,0,0
2957,828,854,1035,1071,67,17,3,207,217,1,31,0,0
2958,828,848,1041,1071,67,17,3,213,223,2,31,0,0
2959,828,847,1043,1072,67,17,3,215,225,3,31,0,0
2960,811,817,1057,1077,67,17,3,246,260,4,31,0,0
2961,778,762,1074,1079,67,17,3,296,317,5,31,0,0
2962,742,719,1068,1072,67,17,3,326,353,6,31,0,0
2963,715,729,1037,1074,67,17,3,322,345,7,31,0,0
2964,693,738,1011,1072,67,17,3,318,334,8,31,0,0
2965,695,745,1011,1072,67,17,3,316,327,9,31,0,0
2966,737,762,1035,1072,67,17,3,298,310,10,31,0,0
2967,729,753,1037,1072,67,17,3,308,319,11,31,0,0
2969,762,770,1046,1069,67,17,3,284,299,0,31,0,1
2970,771,778,1045,1069,67,17,3,274,291,1,31,0,0
2971,774,782,1043,1070,67,17,3,269,288,2,31,0,0
2972,775,780,1044,1070,67,17,3,269,290,3,31,0,0
2973,775,779,1045,1070,67,17,3,270,291,4,31,0,0
2974,776,777,1047,1071,67,17,3,271,294,5,31,0,0
2975,778,776,1048,1071,67,17,3,270,295,6,31,0,0
2976,779,778,1048,1072,67,17,3,269,294,7,31,0,0
2977,780,781,1046,1072,67,17,3,266,291,8,31,0,0
2978,781,782,1045,1071,67,17,3,264,289,9,31,0,0
2979,783,784,1046,1071,67,17,3,263,287,10,31,0,0
2980,785,788,1045,1072,67,17,3,260,284,11,31,0,0
2981,781,788,1044,1075,67,17,3,263,287,12,31,0,0
2982,780,789,1041,1075,67,17,3,261,286,13,31,0,0
2983,779,788,1040,1074,67,17,3,261,286,14,31,0,0
2984,779,786,1040,1073,67,17,3,261,287,15,31,0,0
2985,779,784,1041,1071,67,17,3,262,287,16,31,0,0
2986,780,779,1046,1072,67,17,3,266,293,17,31,0,0
2987,782,778,1047,1073,67,17,3,265,295,18,31,0,0
2988,783,777,1049,1075,67,17,3,266,298,19,31,0,0
2989,784,775,1049,1073,67,17,3,265,298,20,31,0,0
2990,784,776,1048,1075,67,17,3,264,299,21,31,0,0
2991,788,786,1044,1075,67,17,3,256,289,22,31,0,0
2992,787,792,1039,1076,67,17,3,252,284,23,31,0,0
2993,786,795,1034,1073,67,17,3,248,278,24,31,0,0
2994,784,794,1034,1072,67,17,3,250,278,25,31,0,0
2995,787,806,1028,1072,67,17,3,241,266,26,31,0,0
2996,789,819,1021,1074,67,17,3,232,255,27,31,0,0
2997,785,816,1020,1074,67,17,3,235,258,28,31,0,0
2998,770,811,1013,1072,67,17,3,243,261,29,31,0,0
2999,756,818,998,1073,67,17,3,242,255,30,31,0,0
3000,754,839,985,1071,67,17,3,231,232,31,31,1,0
3228,65,922,218,1079,78,17,3,153,157,0,1,0,0
3229,60,917,218,1079,78,17,3,158,162,1,1,0,0
3198,75,907,189,1077,79,17,3,114,170,0,22,0,0
3199,66,902,182,1077,79,17,3,116,175,1,22,0,0
3200,65,894,185,1074,79,17,3,120,180,2,22,0,0
3201,64,890,186,1073,79,17,3,122,183,3,22,0,0
3203,60,890,179,1071,79,17,3,119,181,0,22,0,0
3204,58,887,178,1071,79,17,3,120,184,1,22,0,0
3206,77,895,196,1076,79,17,3,119,181,0,22,0,0
3207,73,904,183,1072,79,17,3,110,168,1,22,0,0
3208,70,903,177,1068,79,17,3,107,165,2,22,0,0
3209,66,895,175,1067,79,17,3,109,172,3,22,0,0
3210,66,900,168,1063,79,17,3,102,163,4,22,0,0
3211,65,900,166,1061,79,17,3,101,161,5,22,0,0
3216,97,923,196,1074,79,17,3,99,151,0,22,0,0
3217,105,945,196,1078,79,17,3,91,133,1,22,0,0
3218,109,949,198,1079,79,17,3,89,130,2,22,0,0
3238,69,886,193,1073,79,17,3,124,187,0,22,0,0
3239,67,883,193,1072,79,17,3,126,189,1,22,0,0
3241,66,878,190,1071,79,17,3,124,193,0,22,0,1
3242,75,878,205,1071,79,17,3,130,193,1,22,0,0
3243,78,879,211,1073,79,17,3,133,194,2,22,0,0
3244,76,879,212,1074,79,17,3,136,195,3,22,0,0
3245,76,877,213,1074,79,17,3,137,197,4,22,0,0
3246,76,881,213,1074,79,17,3,137,193,5,22,0,0
3247,78,892,204,1071,79,17,3,126,179,6,22,0,0
3248,81,898,204,1069,79,17,3,123,171,7,22,0,0
3249,81,898,203,1069,79,17,3,122,171,8,22,0,0
3250,85,903,209,1072,79,17,3,124,169,9,22,0,0
3251,86,904,209,1072,79,17,3,123,168,10,22,0,0
3252,99,931,212,1077,79,17,3,113,146,11,22,0,0
3253,103,937,216,1078,79,17,3,113,141,12,22,0,0
3254,101,934,219,1078,79,17,3,118,144,13,22,0,0
3255,98,932,220,1078,79,17,3,122,146,14,22,0,0
3256,97,926,223,1075,79,17,3,126,149,15,22,0,0
3257,87,915,224,1077,79,17,3,137,162,16,22,0,0
3258,79,904,223,1076,79,17,3,144,172,17,22,0,0
3259,73,894,222,1075,79,17,3,149,181,18,22,0,0
3260,73,888,225,1074,79,17,3,152,186,19,22,0,0
3261,76,889,228,1075,79,17,3,152,186,20,22,0,0
3262,75,893,223,1075,79,17,3,148,182,21,22,0,0
3263,74,892,224,1075,79,17,3,150,183,22,22,1,0
3266,78,895,223,1073,79,17,3,145,178,0,22,0,0
3267,77,898,220,1073,79,17,3,143,175,1,22,0,0
3268,79,899,221,1072,79,17,3,142,173,2,22,0,0
3269,79,899,222,1074,79,17,3,143,175,3,22,0,0
3270,78,901,222,1075,79,17,3,144,174,4,22,0,0
3271,77,900,221,1075,79,17,3,144,175,5,22,0,0
3272,75,901,219,1076,79,17,3,144,175,6,22,0,0
3273,74,896,220,1075,79,17,3,146,179,7,22,0,0
3274,73,893,220,1073,79,17,3,147,180,8,22,0,0
3275,71,890,220,1074,79,17,3,149,184,9,22,0,0
3276,70,889,218,1073,79,17,3,148,184,10,22,0,0
3277,69,888,217,1073,79,17,3,148,185,11,22,0,0
3279,91,918,220,1076,79,17,3,129,158,0,22,0,0
3280,99,928,223,1076,79,17,3,124,148,1,22,0,0
3281,98,928,224,1077,79,17,3,126,149,2,22,0,0
3282,98,928,226,1078,79,17,3,128,150,3,22,0,0
3283,96,927,227,1078,79,17,3,131,151,4,22,0,0
3284,96,927,228,1078,79,17,3,132,151,5,22,0,0
3285,95,926,229,1078,79,17,3,134,152,6,22,0,0
3286,94,926,229,1078,79,17,3,135,152,7,22,0,0
3287,95,927,229,1078,79,17,3,134,151,8,22,0,0
3289,78,907,227,1078,79,17,3,149,171,0,22,0,0
3290,72,905,220,1076,79,17,3,148,171,1,22,0,0
3291,71,904,219,1076,79,17,3,148,172,2,22,0,0
3298,68,895,218,1074,79,17,3,150,179,0,22,0,0
3299,67,894,218,1073,79,17,3,151,179,1,22,0,0
3300,84,916,219,1076,79,17,3,135,160,2,22,0,0
3301,88,922,220,1076,79,17,3,132,154,3,22,0,0
3302,88,923,221,1077,79,17,3,133,154,4,22,0,0
3303,90,924,223,1076,79,17,3,133,152,5,22,0,0
3304,90,925,221,1074,79,17,3,131,149,6,22,0,0
3305,89,925,223,1076,79,17,3,134,151,7,22,0,0
3306,89,922,225,1076,79,17,3,136,154,8,22,0,0
3307,88,919,228,1077,79,17,3,140,158,9,22,0,0
3308,84,914,230,1078,79,17,3,146,164,10,22,0,0
3309,85,910,231,1076,79,17,3,146,166,11,22,0,0
3310,84,900,238,1076,79,17,3,154,176,12,22,0,0
3311,82,894,239,1076,79,17,3,157,182,13,22,0,0
3312,81,892,238,1075,79,17,3,157,183,14,22,0,0
3313,81,890,239,1075,79,17,3,158,185,15,22,0,0
3314,75,891,231,1074,79,17,3,156,183,16,22,0,0
3315,74,889,231,1074,79,17,3,157,185,17,22,0,0
3322,59,889,211,1074,79,17,3,152,185,0,22,0,0
3323,58,888,210,1074,79,17,3,152,186,1,22,0,0
3326,53,880,202,1071,79,17,3,149,191,0,22,0,0
3327,55,880,199,1071,79,17,3,144,191,1,22,0,0
3328,57,880,197,1071,79,17,3,140,191,2,22,0,0
3329,59,880,196,1071,79,17,3,137,191,3,22,0,0
3330,61,880,195,1070,79,17,3,134,190,4,22,0,0
3331,77,899,202,1073,79,17,3,125,174,5,22,0,0
3332,110,932,220,1077,79,17,3,110,145,6,22,0,0
3333,150,947,258,1079,79,17,3,108,132,7,22,0,0
3334,195,941,311,1079,79,17,3,116,138,8,22,0,0
3335,212,946,325,1079,79,17,3,113,133,9,22,0,0
3342,200,870,382,1073,82,17,3,182,203,0,7,0,0
3343,197,855,387,1067,82,17,3,190,212,1,7,0,0
3344,206,859,396,1071,82,17,3,190,212,2,7,0,0
3345,250,862,444,1075,82,17,3,194,213,3,7,0,0
3346,286,854,492,1074,82,17,3,206,220,4,7,0,0
3347,306,838,533,1074,82,17,3,227,236,5,7,0,0
3348,323,817,571,1072,82,17,3,248,255,6,7,0,0
3349,331,808,594,1074,82,17,3,263,266,7,7,0,0
3431,214,888,395,1072,82,17,3,181,184,0,7,0,0
3432,189,885,374,1074,82,17,3,185,189,1,7,0,0
3433,146,877,337,1076,82,17,3,191,199,2,7,0,0
3434,140,874,333,1076,82,17,3,193,202,3,7,0,0
3360,179,845,369,1069,83,17,3,190,224,0,0,0,0
3361,95,876,257,1074,84,17,3,162,198,0,0,0,0
3364,79,919,181,1076,85,17,3,102,157,0,8,0,0
3365,81,917,186,1079,85,17,3,105,162,1,8,0,0
3366,80,912,187,1077,85,17,3,107,165,2,8,0,0
3367,82,913,190,1078,85,17,3,108,165,3,8,0,0
3368,86,917,192,1078,85,17,3,106,161,4,8,0,0
3369,85,918,190,1078,85,17,3,105,160,5,8,0,0
3370,86,921,190,1079,85,17,3,104,158,6,8,0,0
3371,87,922,191,1079,85,17,3,104,157,7,8,0,0
3373,85,919,191,1079,85,17,3,106,160,0,8,0,0
3374,85,919,191,1078,85,17,3,106,159,1,8,0,0
3375,83,916,192,1078,85,17,3,109,162,2,8,0,0
3376,80,915,189,1078,85,17,3,109,163,3,8,0,0
3377,80,915,189,1078,85,17,3,109,163,4,8,0,0
3378,77,909,191,1079,85,17,3,114,170,5,8,0,0
3379,79,906,193,1077,85,17,3,114,171,6,8,0,0
3380,82,901,200,1075,85,17,3,118,174,7,8,0,0
3381,82,900,201,1075,85,17,3,119,175,8,8,0,0
3396,103,944,201,1076,85,17,3,98,132,0,8,0,0
3397,104,947,201,1076,85,17,3,97,129,1,8,0,0
3412,104,930,226,1077,85,17,3,122,147,0,8,0,0
3413,105,929,228,1078,85,17,3,123,149,1,8,0,0
3434,93,882,255,1076,85,17,3,162,194,0,8,0,0
3435,74,886,227,1077,85,17,3,153,191,1,8,0,0
3436,63,894,197,1078,85,17,3,134,184,2,8,0,0
3437,59,893,194,1078,85,17,3,135,185,3,8,0,0
3542,235,741,561,1069,93,17,3,326,328,0,102,0,0
3543,234,741,554,1069,93,17,3,320,328,1,102,0,0
3544,222,741,541,1070,93,17,3,319,329,2,102,0,0
3545,226,741,539,1069,93,17,3,313,328,3,102,0,0
3546,229,745,532,1065,93,17,3,303,320,4,102,0,0
3547,238,766,529,1072,93,17,3,291,306,5,102,0,0
3548,247,808,502,1066,93,17,3,255,258,6,102,0,0
3549,249,811,501,1066,93,17,3,252,255,7,102,0,0
3558,280,807,547,1075,93,17,3,267,268,0,102,0,1
3559,276,788,557,1073,93,17,3,281,285,1,102,0,0
3560,276,774,566,1072,93,17,3,290,298,2,102,0,0
3561,274,766,568,1070,93,17,3,294,304,3,102,0,0
3562,273,761,569,1070,93,17,3,296,309,4,102,0,0
3563,266,758,567,1072,93,17,3,301,314,5,102,0,0
3564,270,755,571,1073,93,17,3,301,318,6,102,0,0
3565,267,754,565,1067,93,17,3,298,313,7,102,0,0
3566,261,755,559,1069,93,17,3,298,314,8,102,0,0
3567,250,755,547,1069,93,17,3,297,314,9,102,0,0
3568,243,755,540,1069,93,17,3,297,314,10,102,0,0
3569,238,755,535,1069,93,17,3,297,314,11,102,0,0
3570,237,750,538,1070,93,17,3,301,320,12,102,0,0
3571,243,750,544,1070,93,17,3,301,320,13,102,0,0
3572,248,750,550,1071,93,17,3,302,321,14,102,0,0
3573,250,749,553,1071,93,17,3,303,322,15,102,0,0
3574,252,747,556,1071,93,17,3,304,324,16,102,0,0
3575,259,745,563,1071,93,17,3,304,326,17,102,0,0
3576,265,743,569,1072,93,17,3,304,329,18,102,0,0
3577,274,741,577,1072,93,17,3,303,331,19,102,0,0
3578,286,743,585,1072,93,17,3,299,329,20,102,0,0
3579,300,748,595,1073,93,17,3,295,325,21,102,0,0
3580,315,752,607,1073,93,17,3,292,321,22,102,0,0
3581,322,753,616,1072,93,17,3,294,319,23,102,0,0
3582,329,755,623,1068,93,17,3,294,313,24,102,0,0
3583,326,760,619,1068,93,17,3,293,308,25,102,0,0
3584,311,760,605,1069,93,17,3,294,309,26,102,0,0
3585,304,757,600,1069,93,17,3,296,312,27,102,0,0
3586,289,758,584,1067,93,17,3,295,309,28,102,0,0
3587,283,759,580,1071,93,17,3,297,312,29,102,0,0
3588,283,761,578,1071,93,17,3,295,310,30,102,0,0
3589,286,762,579,1070,93,17,3,293,308,31,102,0,0
3590,288,762,580,1070,93,17,3,292,308,32,102,0,0
3591,287,759,579,1068,93,17,3,292,309,33,102,0,0
3592,284,759,577,1069,93,17,3,293,310,34,102,0,0
3593,279,759,572,1071,93,17,3,293,312,35,102,0,0
3594,274,759,567,1072,93,17,3,293,313,36,102,0,0
3595,272,758,566,1072,93,17,3,294,314,37,102,0,0
3596,273,758,565,1072,93,17,3,292,314,38,102,0,0
3597,273,758,565,1072,93,17,3,292,314,39,102,0,0
3598,269,760,559,1072,93,17,3,290,312,40,102,0,0
3599,266,764,556,1073,93,17,3,290,309,41,102,0,0
3600,267,761,559,1073,93,17,3,292,312,42,102,0,0
3601,263,762,555,1072,93,17,3,292,310,43,102,0,0
3602,258,764,552,1072,93,17,3,294,308,44,102,0,0
3603,248,764,543,1072,93,17,3,295,308,45,102,0,0
3604,255,761,554,1072,93,17,3,299,311,46,102,0,0
3605,260,755,563,1071,93,17,3,303,316,47,102,0,0
3606,265,758,565,1072,93,17,3,300,314,48,102,0,0
3607,266,759,565,1073,93,17,3,299,314,49,102,0,0
3608,267,759,565,1073,93,17,3,298,314,50,102,0,0
3609,268,758,566,1073,93,17,3,298,315,51,102,0,0
3610,266,756,566,1074,93,17,3,300,318,52,102,0,0
3611,266,756,565,1073,93,17,3,299,317,53,102,0,0
3612,262,757,560,1072,93,17,3,298,315,54,102,0,0
3613,253,756,553,1072,93,17,3,300,316,55,102,0,0
3614,236,758,535,1070,93,17,3,299,312,56,102,0,0
3615,232,758,529,1070,93,17,3,297,312,57,102,0,0
3616,232,759,528,1070,93,17,3,296,311,58,102,0,0
3617,233,760,526,1069,93,17,3,293,309,59,102,0,0
3618,230,760,522,1070,93,17,3,292,310,60,102,0,0
3619,231,761,522,1070,93,17,3,291,309,61,102,0,0
3620,233,761,522,1070,93,17,3,289,309,62,102,0,0
3621,224,760,515,1071,93,17,3,291,311,63,102,0,0
3622,231,761,520,1071,93,17,3,289,310,64,102,0,0
3623,226,761,515,1071,93,17,3,289,310,65,102,0,0
3624,228,761,517,1071,93,17,3,289,310,66,102,0,0
3625,229,759,516,1070,93,17,3,287,311,67,102,0,0
3626,229,757,519,1070,93,17,3,290,313,68,102,0,0
3627,242,753,533,1070,93,17,3,291,317,69,102,0,0
3628,261,747,555,1072,93,17,3,294,325,70,102,0,0
3629,280,740,575,1070,93,17,3,295,330,71,102,0,0
3630,306,737,603,1072,93,17,3,297,335,72,102,0,0
3631,328,728,626,1069,93,17,3,298,341,73,102,0,0
3632,344,732,638,1069,93,17,3,294,337,74,102,0,0
3633,343,739,632,1069,93,17,3,289,330,75,102,0,0
3634,331,748,611,1065,93,17,3,280,317,76,102,0,0
3635,308,755,584,1067,93,17,3,276,312,77,102,0,0
3636,291,760,565,1071,93,17,3,274,311,78,102,0,0
3637,285,762,559,1071,93,17,3,274,309,79,102,0,0
3638,282,762,559,1073,93,17,3,277,311,80,102,0,0
3639,283,760,562,1073,93,17,3,279,313,81,102,0,0
3640,281,760,563,1074,93,17,3,282,314,82,102,0,0
3641,276,761,559,1075,93,17,3,283,314,83,102,0,0
3642,270,759,557,1073,93,17,3,287,314,84,102,0,0
3643,264,764,549,1074,93,17,3,285,310,85,102,0,0
3644,247,761,536,1072,93,17,3,289,311,86,102,0,0
3645,239,767,524,1074,93,17,3,285,307,87,102,0,0
3646,236,764,522,1072,93,17,3,286,308,88,102,0,0
3647,240,762,526,1070,93,17,3,286,308,89,102,0,0
3648,234,762,520,1073,93,17,3,286,311,90,102,0,0
3649,233,767,515,1075,93,17,3,282,308,91,102,0,0
3650,232,769,511,1077,93,17,3,279,308,92,102,0,0
3651,232,766,511,1076,93,17,3,279,310,93,102,0,0
3652,231,763,511,1075,93,17,3,280,312,94,102,0,0
3653,231,765,508,1074,93,17,3,277,309,95,102,0,0
3654,235,765,510,1074,93,17,3,275,309,96,102,0,0
3655,244,761,520,1071,93,17,3,276,310,97,102,0,0
3656,259,757,542,1076,93,17,3,283,319,98,102,0,0
3657,266,758,550,1076,93,17,3,284,318,99,102,0,0
3658,279,788,543,1076,93,17,3,264,288,100,102,0,0
3659,311,861,518,1074,93,17,3,207,213,101,102,0,0
3660,318,872,515,1074,93,17,3,197,202,102,102,1,0
3675,197,900,371,1078,93,17,3,174,178,0,102,0,0
3676,207,882,392,1074,93,17,3,185,192,1,102,0,0
3677,209,855,420,1071,93,17,3,211,216,2,102,0,0
3722,208,848,430,1071,93,17,3,222,223,0,102,0,0
3723,218,842,443,1070,93,17,3,225,228,1,102,0,0
3724,220,839,449,1070,93,17,3,229,231,2,102,0,0
3699,920,835,1155,1073,99,17,3,235,238,0,64,0,1
3700,916,832,1152,1071,99,17,3,236,239,1,64,0,0
3701,913,831,1148,1071,99,17,3,235,240,2,64,0,0
3702,912,829,1149,1071,99,17,3,237,242,3,64,0,0
3703,910,828,1147,1070,99,17,3,237,242,4,64,0,0
3704,908,828,1144,1070,99,17,3,236,242,5,64,0,0
3705,903,828,1140,1072,99,17,3,237,244,6,64,0,0
3706,900,829,1135,1071,99,17,3,235,242,7,64,0,0
3707,900,828,1134,1069,99,17,3,234,241,8,64,0,0
3708,899,829,1134,1071,99,17,3,235,242,9,64,0,0
3709,900,829,1135,1072,99,17,3,235,243,10,64,0,0
3710,899,830,1133,1072,99,17,3,234,242,11,64,0,0
3711,897,829,1131,1072,99,17,3,234,243,12,64,0,0
3712,896,831,1124,1068,99,17,3,228,237,13,64,0,0
3713,895,830,1126,1070,99,17,3,231,240,14,64,0,0
3714,897,833,1121,1068,99,17,3,224,235,15,64,0,0
3715,899,831,1127,1069,99,17,3,228,238,16,64,0,0
3716,898,829,1129,1069,99,17,3,231,240,17,64,0,0
3717,898,828,1129,1069,99,17,3,231,241,18,64,0,0
3718,897,828,1129,1069,99,17,3,232,241,19,64,0,0
3719,896,828,1128,1070,99,17,3,232,242,20,64,0,0
3720,897,828,1129,1070,99,17,3,232,242,21,64,0,0
3721,893,828,1127,1072,99,17,3,234,244,22,64,0,0
3722,895,828,1127,1072,99,17,3,232,244,23,64,0,0
3723,894,828,1125,1071,99,17,3,231,243,24,64,0,0
3724,893,828,1123,1071,99,17,3,230,243,25,64,0,0
3725,891,828,1122,1071,99,17,3,231,243,26,64,0,0
3726,895,828,1124,1070,99,17,3,229,242,27,64,0,0
3727,894,828,1124,1070,99,17,3,230,242,28,64,0,0
3728,893,828,1124,1071,99,17,3,231,243,29,64,0,0
3729,892,828,1124,1071,99,17,3,232,243,30,64,0,0
3730,891,828,1123,1071,99,17,3,232,243,31,64,0,0
3731,895,828,1126,1069,99,17,3,231,241,32,64,0,0
3732,896,829,1126,1070,99,17,3,230,241,33,64,0,0
3733,899,829,1128,1069,99,17,3,229,240,34,64,0,0
3734,897,829,1126,1070,99,17,3,229,241,35,64,0,0
3735,895,829,1126,1072,99,17,3,231,243,36,64,0,0
3736,897,829,1129,1072,99,17,3,232,243,37,64,0,0
3737,899,829,1130,1072,99,17,3,231,243,38,64,0,0
3738,898,828,1130,1070,99,17,3,232,242,39,64,0,0
3739,899,828,1130,1070,99,17,3,231,242,40,64,0,0
3740,893,828,1126,1070,99,17,3,233,242,41,64,0,0
3741,886,828,1123,1072,99,17,3,237,244,42,64,0,0
3742,880,829,1117,1070,99,17,3,237,241,43,64,0,0
3743,881,827,1122,1072,99,17,3,241,245,44,64,0,0
3744,881,824,1124,1072,99,17,3,243,248,45,64,0,0
3745,881,824,1124,1071,99,17,3,243,247,46,64,0,0
3746,875,826,1115,1069,99,17,3,240,243,47,64,0,0
3747,874,827,1114,1070,99,17,3,240,243,48,64,0,0
3748,875,827,1115,1070,99,17,3,240,243,49,64,0,0
3749,879,825,1119,1070,99,17,3,240,245,50,64,0,0
3750,883,825,1124,1070,99,17,3,241,245,51,64,0,0
3751,885,825,1125,1070,99,17,3,240,245,52,64,0,0
3752,883,826,1120,1069,99,17,3,237,243,53,64,0,0
3753,885,826,1123,1071,99,17,3,238,245,54,64,0,0
3754,885,828,1124,1071,99,17,3,239,243,55,64,0,0
3755,887,829,1126,1072,99,17,3,239,243,56,64,0,0
3756,889,831,1126,1070,99,17,3,237,239,57,64,0,0
3757,891,830,1128,1070,99,17,3,237,240,58,64,0,0
3758,890,829,1129,1070,99,17,3,239,241,59,64,0,0
3759,887,827,1127,1072,99,17,3,240,245,60,64,0,0
3760,865,821,1108,1071,99,17,3,243,250,61,64,0,0
3761,797,809,1055,1072,99,17,3,258,263,62,64,0,0
3762,748,807,999,1065,99,17,3,251,258,63,64,0,0
3763,735,805,986,1064,99,17,3,251,259,64,64,1,0
3758,226,897,399,1072,101,17,3,173,175,0,1,0,0
3759,166,917,323,1076,101,17,3,157,159,1,1,0,0
3858,378,145,413,252,103,17,3,35,107,0,11,0,0
3859,383,144,419,256,103,17,3,36,112,1,11,0,0
3860,391,146,428,259,103,17,3,37,113,2,11,0,0
3861,397,146,435,258,103,17,3,38,112,3,11,0,0
3862,404,146,444,259,103,17,3,40,113,4,11,0,0
3863,413,150,450,256,103,17,3,37,106,5,11,0,0
3864,424,147,463,256,103,17,3,39,109,6,11,0,0
3865,435,145,476,261,103,17,3,41,116,7,11,0,0
3866,445,147,486,264,103,17,3,41,117,8,11,0,0
3867,461,149,502,267,103,17,3,41,118,9,11,0,0
3868,468,149,508,267,103,17,3,40,118,10,11,0,0
3869,474,149,515,269,103,17,3,41,120,11,11,0,0
3831,315,126,351,220,104,17,3,36,94,0,13,0,0
3832,317,128,352,220,104,17,3,35,92,1,13,0,0
3833,316,129,351,221,104,17,3,35,92,2,13,0,0
3834,316,128,351,221,104,17,3,35,93,3,13,0,0
3835,316,130,351,224,104,17,3,35,94,4,13,0,0
3836,319,130,354,224,104,17,3,35,94,5,13,0,0
3837,321,128,357,225,104,17,3,36,97,6,13,0,0
3838,323,129,358,227,104,17,3,35,98,7,13,0,0
3844,331,138,366,237,104,17,3,35,99,0,13,0,0
3845,331,137,367,239,104,17,3,36,102,1,13,0,0
3846,333,141,369,242,104,17,3,36,101,2,13,0,0
3847,333,141,371,248,104,17,3,38,107,3,13,0,0
3848,331,137,369,244,104,17,3,38,107,4,13,0,0
3849,338,140,374,240,104,17,3,36,100,5,13,0,0
3850,335,139,372,244,104,17,3,37,105,6,13,0,0
3851,333,138,371,244,104,17,3,38,106,7,13,0,0
3852,332,139,369,245,104,17,3,37,106,8,13,0,0
3853,330,139,367,246,104,17,3,37,107,9,13,0,0
3854,330,138,367,248,104,17,3,37,110,10,13,0,0
3855,331,138,370,253,104,17,3,39,115,11,13,0,0
3856,334,139,373,253,104,17,3,39,114,12,13,0,0
3857,336,140,374,253,104,17,3,38,113,13,13,0,0
3860,346,142,383,251,104,17,3,37,109,0,13,0,0
3861,351,143,390,258,104,17,3,39,115,1,13,0,0
3862,356,143,396,261,104,17,3,40,118,2,13,0,0
3863,363,141,400,253,104,17,3,37,112,3,13,0,0
3865,378,144,415,251,104,17,3,37,107,0,13,0,0
3866,386,141,426,257,104,17,3,40,116,1,13,0,0
3867,395,143,436,262,104,17,3,41,119,2,13,0,0
3868,408,144,445,255,104,17,3,37,111,3,13,0,0
3869,420,144,459,262,104,17,3,39,118,4,13,0,0
3870,432,146,472,266,104,17,3,40,120,5,13,0,0
3871,452,144,493,266,104,17,3,41,122,6,13,0,0
3872,466,142,507,271,104,17,3,41,129,7,13,0,0
3873,474,142,516,273,104,17,3,42,131,8,13,0,0
3871,480,146,515,268,107,17,3,35,122,0,0,0,0
4166,388,144,423,249,114,17,3,35,105,0,47,0,1
4167,393,144,428,249,114,17,3,35,105,1,47,0,0
4168,398,144,433,247,114,17,3,35,103,2,47,0,0
4169,403,146,438,248,114,17,3,35,102,3,47,0,0
4170,405,149,441,253,114,17,3,36,104,4,47,0,0
4171,405,148,443,253,114,17,3,38,105,5,47,0,0
4172,407,149,445,255,114,17,3,38,106,6,47,0,0
4173,408,150,448,260,114,17,3,40,110,7,47,0,0
4174,410,148,452,262,114,17,3,42,114,8,47,0,0
4175,412,149,454,265,114,17,3,42,116,9,47,0,0
4176,412,149,456,269,114,17,3,44,120,10,47,0,0
4177,412,150,456,269,114,17,3,44,119,11,47,0,0
4178,412,150,457,272,114,17,3,45,122,12,47,0,0
4179,411,151,457,274,114,17,3,46,123,13,47,0,0
4180,411,151,457,277,114,17,3,46,126,14,47,0,0
4181,409,152,457,281,114,17,3,48,129,15,47,0,0
4182,408,153,457,284,114,17,3,49,131,16,47,0,0
4183,407,152,458,287,114,17,3,51,135,17,47,0,0
4184,406,152,458,291,114,17,3,52,139,18,47,0,0
4185,407,153,460,296,114,17,3,53,143,19,47,0,0
4186,408,152,462,299,114,17,3,54,147,20,47,0,0
4187,409,153,464,304,114,17,3,55,151,21,47,0,0
4188,408,155,464,307,114,17,3,56,152,22,47,0,0
4189,408,152,464,308,114,17,3,56,156,23,47,0,0
4190,408,154,464,311,114,17,3,56,157,24,47,0,0
4191,410,157,466,314,114,17,3,56,157,25,47,0,0
4192,414,157,470,315,114,17,3,56,158,26,47,0,0
4193,419,163,473,317,114,17,3,54,154,27,47,0,0
4194,422,164,478,321,114,17,3,56,157,28,47,0,0
4195,427,163,483,320,114,17,3,56,157,29,47,0,0
4196,434,165,494,329,114,17,3,60,164,30,47,0,0
4197,443,167,505,333,114,17,3,62,166,31,47,0,0
4198,457,166,522,336,114,17,3,65,170,32,47,0,0
4199,467,169,532,336,114,17,3,65,167,33,47,0,0
4200,479,171,547,340,114,17,3,68,169,34,47,0,0
4201,485,171,556,342,114,17,3,71,171,35,47,0,0
4202,486,167,560,345,114,17,3,74,178,36,47,0,0
4203,483,170,555,346,114,17,3,72,176,37,47,0,0
4204,481,173,552,347,114,17,3,71,174,38,47,0,0
4205,480,175,549,348,114,17,3,69,173,39,47,0,0
4206,479,172,548,346,114,17,3,69,174,40,47,0,0
4207,479,170,545,343,114,17,3,66,173,41,47,0,0
4208,481,169,547,342,114,17,3,66,173,42,47,0,0
4209,488,167,553,342,114,17,3,65,175,43,47,0,0
4210,495,163,559,337,114,17,3,64,174,44,47,0,0
4211,504,164,565,330,114,17,3,61,166,45,47,0,0
4212,509,170,565,326,114,17,3,56,156,46,47,0,0
4213,513,170,569,325,114,17,3,56,155,47,47,1,0
4247,416,150,451,256,121,17,3,35,106,0,6,0,0
4248,423,150,459,258,121,17,3,36,108,1,6,0,0
4249,433,150,470,257,121,17,3,37,107,2,6,0,0
4250,448,153,483,253,121,17,3,35,100,3,6,0,0
4251,459,151,498,262,121,17,3,39,111,4,6,0,0
4252,469,155,506,262,121,17,3,37,107,5,6,0,0
4253,476,155,514,264,121,17,3,38,109,6,6,0,0
4276,378,146,413,251,122,17,3,35,105,0,77,0,0
4278,380,147,415,252,122,17,3,35,105,0,77,0,1
4279,383,148,418,253,122,17,3,35,105,1,77,0,0
4280,385,148,422,255,122,17,3,37,107,2,77,0,0
4281,385,149,423,260,122,17,3,38,111,3,77,0,0
4282,385,150,423,262,122,17,3,38,112,4,77,0,0
4283,387,148,426,263,122,17,3,39,115,5,77,0,0
4284,391,149,430,264,122,17,3,39,115,6,77,0,0
4285,392,148,432,263,122,17,3,40,115,7,77,0,0
4286,393,149,433,265,122,17,3,40,116,8,77,0,0
4287,391,151,432,267,122,17,3,41,116,9,77,0,0
4288,388,151,430,268,122,17,3,42,117,10,77,0,0
4289,388,151,432,272,122,17,3,44,121,11,77,0,0
4290,389,152,433,273,122,17,3,44,121,12,77,0,0
4291,390,153,434,274,122,17,3,44,121,13,77,0,0
4292,389,153,435,278,122,17,3,46,125,14,77,0,0
4293,386,154,433,280,122,17,3,47,126,15,77,0,0
4294,385,154,432,282,122,17,3,47,128,16,77,0,0
4295,386,155,434,285,122,17,3,48,130,17,77,0,0
4296,386,155,435,287,122,17,3,49,132,18,77,0,0
4297,384,156,435,292,122,17,3,51,136,19,77,0,0
4298,381,157,433,295,122,17,3,52,138,20,77,0,0
4299,378,156,432,298,122,17,3,54,142,21,77,0,0
4300,378,159,431,301,122,17,3,53,142,22,77,0,0
4301,379,160,433,304,122,17,3,54,144,23,77,0,0
4302,380,160,434,305,122,17,3,54,145,24,77,0,0
4303,379,163,434,310,122,17,3,55,147,25,77,0,0
4304,380,166,434,310,122,17,3,54,144,26,77,0,0
4305,385,166,439,311,122,17,3,54,145,27,77,0,0
4306,390,165,446,317,122,17,3,56,152,28,77,0,0
4307,396,165,454,321,122,17,3,58,156,29,77,0,0
4308,405,167,462,320,122,17,3,57,153,30,77,0,0
4309,410,169,467,323,122,17,3,57,154,31,77,0,0
4310,418,170,474,321,122,17,3,56,151,32,77,0,0
4311,425,169,483,327,122,17,3,58,158,33,77,0,0
4312,434,171,492,331,122,17,3,58,160,34,77,0,0
4313,445,172,505,332,122,17,3,60,160,35,77,0,0
4314,453,174,516,336,122,17,3,63,162,36,77,0,0
4315,460,173,524,339,122,17,3,64,166,37,77,0,0
4316,467,172,533,340,122,17,3,66,168,38,77,0,0
4317,471,171,537,342,122,17,3,66,171,39,77,0,0
4318,473,172,539,342,122,17,3,66,170,40,77,0,0
4319,475,173,540,342,122,17,3,65,169,41,77,0,0
4320,476,173,541,342,122,17,3,65,169,42,77,0,0
4321,477,173,541,342,122,17,3,64,169,43,77,0,0
4322,477,173,541,342,122,17,3,64,169,44,77,0,0
4323,477,173,541,343,122,17,3,64,170,45,77,0,0
4324,477,173,540,342,122,17,3,63,169,46,77,0,0
4325,475,173,538,342,122,17,3,63,169,47,77,0,0
4326,470,174,532,341,122,17,3,62,167,48,77,0,0
4327,467,176,527,340,122,17,3,60,164,49,77,0,0
4328,463,175,523,341,122,17,3,60,166,50,77,0,0
4329,457,176,516,342,122,17,3,59,166,51,77,0,0
4330,451,177,509,339,122,17,3,58,162,52,77,0,0
4331,446,175,504,337,122,17,3,58,162,53,77,0,0
4332,443,175,500,335,122,17,3,57,160,54,77,0,0
4333,441,173,498,332,122,17,3,57,159,55,77,0,0
4334,440,173,497,332,122,17,3,57,159,56,77,0,0
4335,439,171,496,328,122,17,3,57,157,57,77,0,0
4336,434,171,490,325,122,17,3,56,154,58,77,0,0
4337,426,171,483,326,122,17,3,57,155,59,77,0,0
4338,415,168,472,322,122,17,3,57,154,60,77,0,0
4339,406,168,462,320,122,17,3,56,152,61,77,0,0
4340,398,166,454,318,122,17,3,56,152,62,77,0,0
4341,389,167,443,315,122,17,3,54,148,63,77,0,0
4342,379,166,433,312,122,17,3,54,146,64,77,0,0
4343,368,165,421,311,122,17,3,53,146,65,77,0,0
4344,358,166,409,306,122,17,3,51,140,66,77,0,0
4345,350,165,400,305,122,17,3,50,140,67,77,0,0
4346,344,166,393,304,122,17,3,49,138,68,77,0,0
4347,337,161,386,300,122,17,3,49,139,69,77,0,0
4348,328,159,378,302,122,17,3,50,143,70,77,0,0
4349,319,153,369,296,122,17,3,50,143,71,77,0,0
4350,314,155,362,296,122,17,3,48,141,72,77,0,0
4351,308,158,356,296,122,17,3,48,138,73,77,0,0
4352,299,157,345,292,122,17,3,46,135,74,77,0,0
4353,292,162,335,289,122,17,3,43,127,75,77,0,0
4354,281,162,324,288,122,17,3,43,126,76,77,0,0
4355,273,162,315,286,122,17,3,42,124,77,77,1,0
4318,79,929,202,1080,126,17,3,123,151,0,0,0,0
4406,59,889,232,1070,130,17,3,173,181,0,27,0,0
4407,58,886,229,1072,130,17,3,171,186,1,27,0,0
4408,56,884,229,1072,130,17,3,173,188,2,27,0,0
4432,80,904,233,1069,130,17,3,153,165,0,27,0,0
4433,84,895,249,1075,130,17,3,165,180,1,27,0,0
4434,95,897,261,1076,130,17,3,166,179,2,27,0,0
4435,99,901,262,1075,130,17,3,163,174,3,27,0,0
4436,104,911,263,1075,130,17,3,159,164,4,27,0,0
4437,104,920,258,1077,130,17,3,154,157,5,27,0,0
4438,99,920,255,1077,130,17,3,156,157,6,27,0,0
4439,97,901,268,1075,130,17,3,171,174,7,27,0,0
4440,136,885,319,1076,130,17,3,183,191,8,27,0,0
4441,142,882,328,1076,130,17,3,186,194,9,27,0,0
4446,200,850,406,1070,130,17,3,206,220,0,27,0,0
4447,209,833,435,1071,130,17,3,226,238,1,27,0,0
4448,207,824,447,1066,130,17,3,240,242,2,27,0,0
4560,64,924,213,1077,130,17,3,149,153,0,27,0,0
4561,65,922,212,1077,130,17,3,147,155,1,27,0,0
4562,61,919,211,1077,130,17,3,150,158,2,27,0,0
4563,63,917,212,1079,130,17,3,149,162,3,27,0,0
4564,59,915,211,1079,130,17,3,152,164,4,27,0,0
4568,69,921,209,1077,130,17,3,140,156,0,27,0,0
4569,67,920,208,1077,130,17,3,141,157,1,27,0,0
4571,71,921,208,1077,130,17,3,137,156,0,27,0,0
4572,70,920,208,1076,130,17,3,138,156,1,27,0,0
4589,88,927,218,1075,130,17,3,130,148,0,27,0,0
4590,89,925,220,1075,130,17,3,131,150,1,27,0,0
4591,89,923,225,1075,130,17,3,136,152,2,27,0,0
4592,90,923,226,1074,130,17,3,136,151,3,27,0,0
4593,81,930,211,1077,130,17,3,130,147,4,27,0,0
4594,81,930,210,1077,130,17,3,129,147,5,27,0,0
4622,108,947,236,1079,130,17,3,128,132,0,27,0,0
4633,66,915,227,1077,130,17,3,161,162,0,27,0,1
4634,66,911,227,1078,130,17,3,161,167,1,27,0,0
4635,68,904,232,1076,130,17,3,164,172,2,27,0,0
4636,71,898,238,1076,130,17,3,167,178,3,27,0,0
4637,71,892,240,1074,130,17,3,169,182,4,27,0,0
4638,71,890,239,1074,130,17,3,168,184,5,27,0,0
4639,71,889,238,1073,130,17,3,167,184,6,27,0,0
4640,77,893,237,1069,130,17,3,160,176,7,27,0,0
4641,83,896,239,1069,130,17,3,156,173,8,27,0,0
4642,84,897,243,1075,130,17,3,159,178,9,27,0,0
4643,87,907,238,1075,130,17,3,151,168,10,27,0,0
4644,87,911,235,1075,130,17,3,148,164,11,27,0,0
4645,85,909,236,1077,130,17,3,151,168,12,27,0,0
4646,81,907,233,1077,130,17,3,152,170,13,27,0,0
4647,80,910,229,1077,130,17,3,149,167,14,27,0,0
4648,79,910,229,1078,130,17,3,150,168,15,27,0,0
4649,77,927,209,1076,130,17,3,132,149,16,27,0,0
4650,86,940,209,1078,130,17,3,123,138,17,27,0,0
4651,95,950,210,1078,130,17,3,115,128,18,27,0,0
4652,101,957,213,1079,130,17,3,112,122,19,27,0,0
4653,102,960,214,1078,130,17,3,112,118,20,27,0,0
4654,104,964,212,1078,130,17,3,108,114,21,27,0,0
4660,85,933,223,1078,130,17,3,138,145,0,27,0,0
4661,83,929,223,1077,130,17,3,140,148,1,27,0,0
4662,81,924,225,1076,130,17,3,144,152,2,27,0,0
4663,81,921,228,1076,130,17,3,147,155,3,27,0,0
4664,81,918,232,1076,130,17,3,151,158,4,27,0,0
4665,79,916,232,1077,130,17,3,153,161,5,27,0,0
4666,78,916,231,1077,130,17,3,153,161,6,27,0,0
4667,77,915,231,1077,130,17,3,154,162,7,27,0,0
4669,72,913,224,1077,130,17,3,152,164,0,27,0,1
4670,71,912,224,1077,130,17,3,153,165,1,27,0,0
4671,79,914,229,1076,130,17,3,150,162,2,27,0,0
4672,81,915,230,1078,130,17,3,149,163,3,27,0,0
4673,84,918,232,1079,130,17,3,148,161,4,27,0,0
4674,86,919,235,1079,130,17,3,149,160,5,27,0,0
4675,88,920,236,1080,130,17,3,148,160,6,27,0,0
4676,88,919,235,1076,130,17,3,147,157,7,27,0,0
4677,84,912,237,1077,130,17,3,153,165,8,27,0,0
4678,80,905,238,1077,130,17,3,158,172,9,27,0,0
4679,82,900,243,1075,130,17,3,161,175,10,27,0,0
4680,85,896,249,1075,130,17,3,164,179,11,27,0,0
4681,86,897,248,1075,130,17,3,162,178,12,27,0,0
4682,88,895,250,1074,130,17,3,162,179,13,27,0,0
4683,88,895,250,1074,130,17,3,162,179,14,27,0,0
4684,87,898,246,1074,130,17,3,159,176,15,27,0,0
4685,89,897,250,1074,130,17,3,161,177,16,27,0,0
4686,89,898,248,1074,130,17,3,159,176,17,27,0,0
4687,91,896,251,1074,130,17,3,160,178,18,27,0,0
4688,92,895,252,1074,130,17,3,160,179,19,27,0,0
4689,99,892,261,1074,130,17,3,162,182,20,27,0,0
4690,103,891,266,1073,130,17,3,163,182,21,27,0,0
4691,91,894,252,1074,130,17,3,161,180,22,27,0,0
4692,85,898,243,1076,130,17,3,158,178,23,27,0,0
4693,83,897,241,1076,130,17,3,158,179,24,27,0,0
4694,83,898,239,1076,130,17,3,156,178,25,27,0,0
4695,83,907,232,1077,130,17,3,149,170,26,27,0,0
4696,82,908,231,1077,130,17,3,149,169,27,27,1,0
4698,81,928,210,1077,130,17,3,129,149,0,27,0,0
4699,80,931,206,1078,130,17,3,126,147,1,27,0,0
4446,329,128,365,237,131,17,3,36,109,0,71,0,0
4460,363,141,398,255,131,17,3,35,114,0,71,0,0
4466,400,144,436,258,131,17,3,36,114,0,71,0,0
4468,413,140,451,257,131,17,3,38,117,0,71,0,1
4469,418,141,455,258,131,17,3,37,117,1,71,0,0
4470,419,141,456,257,131,17,3,37,116,2,71,0,0
4471,419,141,455,257,131,17,3,36,116,3,71,0,0
4472,417,142,456,264,131,17,3,39,122,4,71,0,0
4473,414,142,454,266,131,17,3,40,124,5,71,0,0
4474,409,143,449,267,131,17,3,40,124,6,71,0,0
4475,404,145,444,267,131,17,3,40,122,7,71,0,0
4476,398,144,439,268,131,17,3,41,124,8,71,0,0
4477,396,140,439,269,131,17,3,43,129,9,71,0,0
4478,397,140,441,269,131,17,3,44,129,10,71,0,0
4479,398,142,440,266,131,17,3,42,124,11,71,0,0
4480,399,142,440,263,131,17,3,41,121,12,71,0,0
4481,400,140,441,264,131,17,3,41,124,13,71,0,0
4482,402,140,443,264,131,17,3,41,124,14,71,0,0
4483,403,139,445,264,131,17,3,42,125,15,71,0,0
4484,404,139,446,265,131,17,3,42,126,16,71,0,0
4485,408,141,450,264,131,17,3,42,123,17,71,0,0
4486,414,141,457,266,131,17,3,43,125,18,71,0,0
4487,416,143,458,264,131,17,3,42,121,19,71,0,0
4488,418,145,459,265,131,17,3,41,120,20,71,0,0
4489,419,143,461,265,131,17,3,42,122,21,71,0,0
4490,419,145,458,260,131,17,3,39,115,22,71,0,0
4491,416,143,455,256,131,17,3,39,113,23,71,0,0
4492,408,143,448,257,131,17,3,40,114,24,71,0,0
4493,404,143,443,257,131,17,3,39,114,25,71,0,0
4494,402,144,439,249,131,17,3,37,105,26,71,0,0
4495,400,143,438,251,131,17,3,38,108,27,71,0,0
4496,400,142,440,255,131,17,3,40,113,28,71,0,0
4497,400,143,440,255,131,17,3,40,112,29,71,0,0
4498,402,145,441,254,131,17,3,39,109,30,71,0,0
4499,403,145,445,261,131,17,3,42,116,31,71,0,0
4500,407,146,449,265,131,17,3,42,119,32,71,0,0
4501,411,146,453,265,131,17,3,42,119,33,71,0,0
4502,414,148,457,269,131,17,3,43,121,34,71,0,0
4503,418,151,461,270,131,17,3,43,119,35,71,0,0
4504,420,149,464,273,131,17,3,44,124,36,71,0,0
4505,422,147,469,280,131,17,3,47,133,37,71,0,0
4506,424,149,472,284,131,17,3,48,135,38,71,0,0
4507,426,148,476,288,131,17,3,50,140,39,71,0,0
4508,428,148,478,292,131,17,3,50,144,40,71,0,0
4509,429,150,480,296,131,17,3,51,146,41,71,0,0
4510,431,150,481,296,131,17,3,50,146,42,71,0,0
4511,431,150,484,302,131,17,3,53,152,43,71,0,0
4512,435,154,488,307,131,17,3,53,153,44,71,0,0
4513,439,153,492,308,131,17,3,53,155,45,71,0,0
4514,442,154,496,312,131,17,3,54,158,46,71,0,0
4515,443,157,497,317,131,17,3,54,160,47,71,0,0
4516,444,156,499,320,131,17,3,55,164,48,71,0,0
4517,444,157,501,324,131,17,3,57,167,49,71,0,0
4518,447,163,503,329,131,17,3,56,166,50,71,0,0
4519,447,158,504,331,131,17,3,57,173,51,71,0,0
4520,446,163,504,336,131,17,3,58,173,52,71,0,0
4521,443,166,502,343,131,17,3,59,177,53,71,0,0
4522,439,166,500,349,131,17,3,61,183,54,71,0,0
4523,434,167,496,353,131,17,3,62,186,55,71,0,0
4524,430,169,494,362,131,17,3,64,193,56,71,0,0
4525,427,169,492,366,131,17,3,65,197,57,71,0,0
4526,421,172,488,373,131,17,3,67,201,58,71,0,0
4527,414,175,482,383,131,17,3,68,208,59,71,0,0
4528,407,174,474,382,131,17,3,67,208,60,71,0,0
4529,399,174,470,390,131,17,3,71,216,61,71,0,0
4530,391,177,463,397,131,17,3,72,220,62,71,0,0
4531,380,177,452,401,131,17,3,72,224,63,71,0,0
4532,362,180,437,412,131,17,3,75,232,64,71,0,0
4533,346,188,423,421,131,17,3,77,233,65,71,0,0
4534,324,189,401,420,131,17,3,77,231,66,71,0,0
4535,300,188,375,418,131,17,3,75,230,67,71,0,0
4536,280,196,358,428,131,17,3,78,232,68,71,0,0
4537,251,196,326,427,131,17,3,75,231,69,71,0,0
4538,233,206,303,427,131,17,3,70,221,70,71,0,0
4539,220,208,290,431,131,17,3,70,223,71,71,1,0
4441,260,928,386,1074,135,17,3,126,146,0,0,0,0
4445,270,933,411,1075,136,17,3,141,142,0,0,0,0
4525,87,937,162,1077,147,17,3,75,140,0,3,0,0
4526,104,926,186,1077,147,17,3,82,151,1,3,0,0
4527,114,930,195,1075,147,17,3,81,145,2,3,0,0
4528,121,929,201,1074,147,17,3,80,145,3,3,0,0
4529,89,943,220,1078,148,17,3,131,135,0,1,0,0
4530,92,949,215,1075,148,17,3,123,126,1,1,0,0
4650,322,154,359,289,156,17,3,37,135,0,42,0,0
4652,348,158,383,287,156,17,3,35,129,0,42,0,1
4653,355,160,392,291,156,17,3,37,131,1,42,0,0
4654,363,156,402,293,156,17,3,39,137,2,42,0,0
4655,367,152,408,296,156,17,3,41,144,3,42,0,0
4656,372,150,415,298,156,17,3,43,148,4,42,0,0
4657,378,147,423,299,156,17,3,45,152,5,42,0,0
4658,384,150,430,305,156,17,3,46,155,6,42,0,0
4659,389,149,436,307,156,17,3,47,158,7,42,0,0
4660,394,151,441,306,156,17,3,47,155,8,42,0,0
4661,383,158,431,313,156,17,3,48,155,9,42,0,0
4662,374,155,425,319,156,17,3,51,164,10,42,0,0
4663,372,157,423,322,156,17,3,51,165,11,42,0,0
4664,371,160,424,329,156,17,3,53,169,12,42,0,0
4665,372,159,426,329,156,17,3,54,170,13,42,0,0
4666,370,162,424,332,156,17,3,54,170,14,42,0,0
4667,370,166,425,333,156,17,3,55,167,15,42,0,0
4668,369,171,424,334,156,17,3,55,163,16,42,0,0
4669,370,170,430,342,156,17,3,60,172,17,42,0,0
4670,369,169,432,349,156,17,3,63,180,18,42,0,0
4671,366,169,432,354,156,17,3,66,185,19,42,0,0
4672,365,174,431,360,156,17,3,66,186,20,42,0,0
4673,362,175,428,361,156,17,3,66,186,21,42,0,0
4674,361,176,431,370,156,17,3,70,194,22,42,0,0
4675,360,174,435,384,156,17,3,75,210,23,42,0,0
4676,362,177,436,383,156,17,3,74,206,24,42,0,0
4677,362,183,436,390,156,17,3,74,207,25,42,0,0
4678,363,190,436,396,156,17,3,73,206,26,42,0,0
4679,363,189,438,402,156,17,3,75,213,27,42,0,0
4680,368,191,443,406,156,17,3,75,215,28,42,0,0
4681,372,193,446,406,156,17,3,74,213,29,42,0,0
4682,373,194,448,408,156,17,3,75,214,30,42,0,0
4683,381,198,455,409,156,17,3,74,211,31,42,0,0
4684,382,196,460,417,156,17,3,78,221,32,42,0,0
4685,381,197,458,420,156,17,3,77,223,33,42,0,0
4686,374,200,448,416,156,17,3,74,216,34,42,0,0
4687,355,203,433,427,156,17,3,78,224,35,42,0,0
4688,335,205,414,435,156,17,3,79,230,36,42,0,0
4689,308,207,385,436,156,17,3,77,229,37,42,0,0
4690,283,210,362,440,156,17,3,79,230,38,42,0,0
4691,264,214,341,437,156,17,3,77,223,39,42,0,0
4692,239,211,315,437,156,17,3,76,226,40,42,0,0
4693,226,217,298,438,156,17,3,72,221,41,42,0,0
4694,215,219,287,441,156,17,3,72,222,42,42,1,0
4649,296,161,333,282,157,17,3,37,121,0,46,0,0
4651,294,152,332,277,157,17,3,38,125,0,46,0,0
4652,317,154,356,281,157,17,3,39,127,1,46,0,0
4653,332,161,369,282,157,17,3,37,121,2,46,0,0
4654,341,163,378,285,157,17,3,37,122,3,46,0,0
4661,414,151,457,295,157,17,3,43,144,0,46,0,1
4662,418,151,464,302,157,17,3,46,151,1,46,0,0
4663,422,151,468,299,157,17,3,46,148,2,46,0,0
4664,426,151,473,303,157,17,3,47,152,3,46,0,0
4665,429,150,478,309,157,17,3,49,159,4,46,0,0
4666,433,150,483,311,157,17,3,50,161,5,46,0,0
4667,437,151,487,310,157,17,3,50,159,6,46,0,0
4668,439,153,490,317,157,17,3,51,164,7,46,0,0
4669,443,153,493,315,157,17,3,50,162,8,46,0,0
4670,444,152,496,321,157,17,3,52,169,9,46,0,0
4671,445,154,499,329,157,17,3,54,175,10,46,0,0
4672,449,155,502,329,157,17,3,53,174,11,46,0,0
4673,450,158,503,332,157,17,3,53,174,12,46,0,0
4674,451,160,505,335,157,17,3,54,175,13,46,0,0
4675,450,161,504,338,157,17,3,54,177,14,46,0,0
4676,450,161,506,341,157,17,3,56,180,15,46,0,0
4677,449,166,507,350,157,17,3,58,184,16,46,0,0
4678,451,166,510,356,157,17,3,59,190,17,46,0,0
4679,452,167,513,359,157,17,3,61,192,18,46,0,0
4680,453,169,514,362,157,17,3,61,193,19,46,0,0
4681,454,169,516,367,157,17,3,62,198,20,46,0,0
4682,455,170,518,373,157,17,3,63,203,21,46,0,0
4683,455,172,520,380,157,17,3,65,208,22,46,0,0
4684,456,173,522,385,157,17,3,66,212,23,46,0,0
4685,460,174,526,386,157,17,3,66,212,24,46,0,0
4686,462,175,529,394,157,17,3,67,219,25,46,0,0
4687,463,174,532,396,157,17,3,69,222,26,46,0,0
4688,466,173,535,399,157,17,3,69,226,27,46,0,0
4689,469,174,539,403,157,17,3,70,229,28,46,0,0
4690,472,174,543,409,157,17,3,71,235,29,46,0,0
4691,476,175,546,407,157,17,3,70,232,30,46,0,0
4692,476,177,548,415,157,17,3,72,238,31,46,0,0
4693,473,178,546,417,157,17,3,73,239,32,46,0,0
4694,469,178,541,416,157,17,3,72,238,33,46,0,0
4695,462,179,533,418,157,17,3,71,239,34,46,0,0
4696,452,183,523,424,157,17,3,71,241,35,46,0,0
4697,441,186,513,429,157,17,3,72,243,36,46,0,0
4698,428,185,498,426,157,17,3,70,241,37,46,0,0
4699,408,186,482,435,157,17,3,74,249,38,46,0,0
4700,389,194,466,445,157,17,3,77,251,39,46,0,0
4701,362,185,445,453,157,17,3,83,268,40,46,0,0
4702,340,186,421,451,157,17,3,81,265,41,46,0,0
4703,326,197,387,395,157,17,3,61,198,42,46,0,0
4704,295,197,367,431,157,17,3,72,234,43,46,0,0
4705,267,197,344,444,157,17,3,77,247,44,46,0,0
4706,247,200,325,447,157,17,3,78,247,45,46,0,0
4707,232,201,311,451,157,17,3,79,250,46,46,1,0
4652,296,152,332,279,158,17,3,36,127,0,19,0,0
4653,304,150,340,278,158,17,3,36,128,1,19,0,0
4654,305,139,346,281,158,17,3,41,142,2,19,0,0
4655,313,147,353,285,158,17,3,40,138,3,19,0,0
4656,320,150,360,288,158,17,3,40,138,4,19,0,0
4657,326,153,367,292,158,17,3,41,139,5,19,0,0
4658,336,154,375,288,158,17,3,39,134,6,19,0,0
4659,341,154,381,292,158,17,3,40,138,7,19,0,0
4660,346,153,389,297,158,17,3,43,144,8,19,0,0
4661,353,155,396,301,158,17,3,43,146,9,19,0,0
4662,359,156,402,304,158,17,3,43,148,10,19,0,0
4686,407,185,454,346,158,17,3,47,161,0,19,0,1
4687,401,183,456,378,158,17,3,55,195,1,19,0,0
4688,398,187,457,395,158,17,3,59,208,2,19,0,0
4689,397,183,460,398,158,17,3,63,215,3,19,0,0
4690,397,182,463,400,158,17,3,66,218,4,19,0,0
4691,395,181,463,405,158,17,3,68,224,5,19,0,0
4692,393,181,463,406,158,17,3,70,225,6,19,0,0
4693,390,183,459,406,158,17,3,69,223,7,19,0,0
4694,385,187,453,407,158,17,3,68,220,8,19,0,0
4695,374,192,443,408,158,17,3,69,216,9,19,0,0
4696,364,195,434,412,158,17,3,70,217,10,19,0,0
4697,350,191,424,422,158,17,3,74,231,11,19,0,0
4698,339,193,415,425,158,17,3,76,232,12,19,0,0
4699,325,196,401,428,158,17,3,76,232,13,19,0,0
4700,306,198,380,428,158,17,3,74,230,14,19,0,0
4701,283,198,359,432,158,17,3,76,234,15,19,0,0
4702,261,199,336,434,158,17,3,75,235,16,19,0,0
4703,239,198,312,430,158,17,3,73,232,17,19,0,0
4704,229,204,298,431,158,17,3,69,227,18,19,0,0
4705,218,206,287,434,158,17,3,69,228,19,19,0,0
4691,347,153,383,258,159,17,3,36,105,0,49,0,0
4692,349,152,385,259,159,17,3,36,107,1,49,0,0
4693,350,151,387,261,159,17,3,37,110,2,49,0,0
4694,353,149,390,263,159,17,3,37,114,3,49,0,0
4695,354,150,393,267,159,17,3,39,117,4,49,0,0
4703,375,158,417,271,159,17,3,42,113,0,49,0,1
4704,378,158,423,286,159,17,3,45,128,1,49,0,0
4705,384,159,431,292,159,17,3,47,133,2,49,0,0
4706,388,160,438,303,159,17,3,50,143,3,49,0,0
4707,391,162,443,308,159,17,3,52,146,4,49,0,0
4708,400,162,450,306,159,17,3,50,144,5,49,0,0
4709,409,164,461,311,159,17,3,52,147,6,49,0,0
4710,417,163,468,310,159,17,3,51,147,7,49,0,0
4711,425,164,475,309,159,17,3,50,145,8,49,0,0
4712,432,166,483,316,159,17,3,51,150,9,49,0,0
4713,440,168,493,323,159,17,3,53,155,10,49,0,0
4714,451,169,503,321,159,17,3,52,152,11,49,0,0
4715,458,169,513,331,159,17,3,55,162,12,49,0,0
4716,472,170,525,331,159,17,3,53,161,13,49,0,0
4717,484,169,536,327,159,17,3,52,158,14,49,0,0
4718,495,172,548,332,159,17,3,53,160,15,49,0,0
4719,495,171,548,335,159,17,3,53,164,16,49,0,0
4720,494,173,547,338,159,17,3,53,165,17,49,0,0
4721,492,174,545,339,159,17,3,53,165,18,49,0,0
4722,490,173,542,338,159,17,3,52,165,19,49,0,0
4723,488,174,540,337,159,17,3,52,163,20,49,0,0
4724,485,175,537,337,159,17,3,52,162,21,49,0,0
4725,481,177,532,338,159,17,3,51,161,22,49,0,0
4726,479,179,529,339,159,17,3,50,160,23,49,0,0
4727,478,176,530,339,159,17,3,52,163,24,49,0,0
4728,477,174,529,338,159,17,3,52,164,25,49,0,0
4729,477,175,528,338,159,17,3,51,163,26,49,0,0
4730,477,179,528,339,159,17,3,51,160,27,49,0,0
4731,478,180,528,338,159,17,3,50,158,28,49,0,0
4732,478,179,528,338,159,17,3,50,159,29,49,0,0
4733,479,178,529,337,159,17,3,50,159,30,49,0,0
4734,479,178,529,338,159,17,3,50,160,31,49,0,0
4735,479,181,528,338,159,17,3,49,157,32,49,0,0
4736,478,181,526,337,159,17,3,48,156,33,49,0,0
4737,478,182,526,337,159,17,3,48,155,34,49,0,0
4738,479,186,525,337,159,17,3,46,151,35,49,0,0
4739,479,186,525,337,159,17,3,46,151,36,49,0,0
4740,479,187,525,337,159,17,3,46,150,37,49,0,0
4741,479,182,526,337,159,17,3,47,155,38,49,0,0
4742,478,179,526,337,159,17,3,48,158,39,49,0,0
4743,477,176,526,337,159,17,3,49,161,40,49,0,0
4744,476,175,526,337,159,17,3,50,162,41,49,0,0
4745,477,175,527,337,159,17,3,50,162,42,49,0,0
4746,477,176,526,336,159,17,3,49,160,43,49,0,0
4747,478,177,527,332,159,17,3,49,155,44,49,0,0
4748,483,180,531,332,159,17,3,48,152,45,49,0,0
4749,491,172,542,333,159,17,3,51,161,46,49,0,0
4750,504,171,553,327,159,17,3,49,156,47,49,0,0
4751,511,172,557,323,159,17,3,46,151,48,49,0,0
4752,514,171,560,322,159,17,3,46,151,49,49,1,0
4672,404,165,439,257,161,17,3,35,92,0,3,0,0
4677,399,171,435,260,161,17,3,36,89,0,3,0,0
4678,403,172,440,264,161,17,3,37,92,1,3,0,0
4679,407,175,442,263,161,17,3,35,88,2,3,0,0
4680,407,176,443,265,161,17,3,36,89,3,3,0,0
4722,328,123,363,237,163,17,3,35,114,0,73,0,0
4723,328,124,363,240,163,17,3,35,116,1,73,0,0
4724,329,125,364,242,163,17,3,35,117,2,73,0,0
4725,330,126,366,246,163,17,3,36,120,3,73,0,0
4726,331,126,367,247,163,17,3,36,121,4,73,0,0
4727,332,125,368,247,163,17,3,36,122,5,73,0,0
4728,334,127,369,246,163,17,3,35,119,6,73,0,0
4729,335,128,371,249,163,17,3,36,121,7,73,0,0
4730,336,129,372,253,163,17,3,36,124,8,73,0,0
4731,338,132,373,254,163,17,3,35,122,9,73,0,0
4732,339,130,375,254,163,17,3,36,124,10,73,0,0
4737,347,141,382,263,163,17,3,35,122,0,73,0,0
4739,351,141,386,265,163,17,3,35,124,0,73,0,1
4740,354,142,389,267,163,17,3,35,125,1,73,0,0
4741,359,138,396,268,163,17,3,37,130,2,73,0,0
4742,363,136,402,270,163,17,3,39,134,3,73,0,0
4743,369,136,409,273,163,17,3,40,137,4,73,0,0
4744,374,136,415,276,163,17,3,41,140,5,73,0,0
4745,379,134,420,274,163,17,3,41,140,6,73,0,0
4746,384,134,425,276,163,17,3,41,142,7,73,0,0
4747,388,136,429,279,163,17,3,41,143,8,73,0,0
4748,390,136,432,282,163,17,3,42,146,9,73,0,0
4749,390,137,433,285,163,17,3,43,148,10,73,0,0
4750,389,139,434,291,163,17,3,45,152,11,73,0,0
4751,388,139,433,293,163,17,3,45,154,12,73,0,0
4752,387,139,434,295,163,17,3,47,156,13,73,0,0
4753,387,140,435,301,163,17,3,48,161,14,73,0,0
4754,388,140,436,300,163,17,3,48,160,15,73,0,0
4755,387,140,437,304,163,17,3,50,164,16,73,0,0
4756,389,143,438,306,163,17,3,49,163,17,73,0,0
4757,389,147,439,311,163,17,3,50,164,18,73,0,0
4758,390,144,441,313,163,17,3,51,169,19,73,0,0
4759,392,144,446,320,163,17,3,54,176,20,73,0,0
4760,395,144,450,324,163,17,3,55,180,21,73,0,0
4761,398,143,454,328,163,17,3,56,185,22,73,0,0
4762,399,146,457,334,163,17,3,58,188,23,73,0,0
4763,402,148,460,337,163,17,3,58,189,24,73,0,0
4764,405,146,464,337,163,17,3,59,191,25,73,0,0
4765,410,150,468,340,163,17,3,58,190,26,73,0,0
4766,414,152,474,349,163,17,3,60,197,27,73,0,0
4767,417,153,478,355,163,17,3,61,202,28,73,0,0
4768,417,155,483,368,163,17,3,66,213,29,73,0,0
4769,420,157,487,371,163,17,3,67,214,30,73,0,0
4770,425,155,493,374,163,17,3,68,219,31,73,0,0
4771,430,159,498,378,163,17,3,68,219,32,73,0,0
4772,434,162,505,392,163,17,3,71,230,33,73,0,0
4773,437,161,510,396,163,17,3,73,235,34,73,0,0
4774,440,164,515,399,163,17,3,75,235,35,73,0,0
4775,443,165,518,403,163,17,3,75,238,36,73,0,0
4776,446,167,522,406,163,17,3,76,239,37,73,0,0
4777,447,166,527,422,163,17,3,80,256,38,73,0,0
4778,451,169,531,428,163,17,3,80,259,39,73,0,0
4779,453,169,534,434,163,17,3,81,265,40,73,0,0
4780,452,172,536,442,163,17,3,84,270,41,73,0,0
4781,452,176,536,448,163,17,3,84,272,42,73,0,0
4782,450,176,537,459,163,17,3,87,283,43,73,0,0
4783,446,181,537,477,163,17,3,91,296,44,73,0,0
4784,446,186,540,495,163,17,3,94,309,45,73,0,0
4785,443,186,539,500,163,17,3,96,314,46,73,0,0
4786,440,191,541,517,163,17,3,101,326,47,73,0,0
4787,439,195,545,535,163,17,3,106,340,48,73,0,0
4788,440,192,548,544,163,17,3,108,352,49,73,0,0
4789,441,199,551,556,163,17,3,110,357,50,73,0,0
4790,443,202,555,573,163,17,3,112,371,51,73,0,0
4791,439,204,556,588,163,17,3,117,384,52,73,0,0
4792,433,209,554,603,163,17,3,121,394,53,73,0,0
4793,424,217,551,632,163,17,3,127,415,54,73,0,0
4794,412,217,543,650,163,17,3,131,433,55,73,0,0
4795,399,227,536,678,163,17,3,137,451,56,73,0,0
4796,389,233,532,706,163,17,3,143,473,57,73,0,0
4797,379,236,524,714,163,17,3,145,478,58,73,0,0
4798,333,244,495,747,163,17,3,162,503,59,73,0,0
4799,302,250,478,774,163,17,3,176,524,60,73,0,0
4800,286,255,470,781,163,17,3,184,526,61,73,0,0
4801,279,262,473,807,163,17,3,194,545,62,73,0,0
4802,278,268,479,830,163,17,3,201,562,63,73,0,0
4803,293,268,494,833,163,17,3,201,565,64,73,0,0
4804,307,274,501,834,163,17,3,194,560,65,73,0,0
4805,293,271,489,842,163,17,3,196,571,66,73,0,0
4806,291,282,479,838,163,17,3,188,556,67,73,0,0
4807,288,294,472,834,163,17,3,184,540,68,73,0,0
4808,274,305,448,812,163,17,3,174,507,69,73,0,0
4809,242,288,412,789,163,17,3,170,501,70,73,0,0
4810,225,278,392,774,163,17,3,167,496,71,73,0,0
4811,226,325,375,767,163,17,3,149,442,72,73,0,0
4812,217,332,364,767,163,17,3,147,435,73,73,1,0
4781,444,608,888,1066,168,17,3,444,458,0,12,0,0
4782,511,608,943,1070,168,17,3,432,462,1,12,0,0
4783,592,618,1005,1074,168,17,3,413,456,2,12,0,0
4784,679,632,1071,1074,168,17,3,392,442,3,12,0,0
4785,781,634,1162,1074,168,17,3,381,440,4,12,0,0
4786,903,656,1266,1072,168,17,3,363,416,5,12,0,0
4787,1036,693,1370,1074,168,17,3,334,381,6,12,0,0
4788,1173,729,1480,1073,168,17,3,307,344,7,12,0,0
4789,1320,753,1608,1075,168,17,3,288,322,8,12,0,0
4790,1437,766,1716,1075,168,17,3,279,309,9,12,0,0
4791,1553,803,1804,1077,168,17,3,251,274,10,12,0,0
4792,1685,840,1905,1079,168,17,3,220,239,11,12,0,0
4793,1774,850,1920,1080,168,17,3,146,230,12,12,0,0
4784,1840,975,1920,1069,170,17,3,80,94,0,0,0,0
4964,559,189,607,364,172,17,3,48,175,0,26,0,1
4965,546,192,593,363,172,17,3,47,171,1,26,0,0
4966,531,185,576,348,172,17,3,45,163,2,26,0,0
4967,506,184,553,353,172,17,3,47,169,3,26,0,0
4968,486,183,536,358,172,17,3,50,175,4,26,0,0
4969,467,179,519,360,172,17,3,52,181,5,26,0,0
4970,446,188,494,351,172,17,3,48,163,6,26,0,0
4971,431,179,482,353,172,17,3,51,174,7,26,0,0
4972,418,179,470,354,172,17,3,52,175,8,26,0,0
4973,406,180,457,349,172,17,3,51,169,9,26,0,0
4974,395,179,445,340,172,17,3,50,161,10,26,0,0
4975,382,179,432,337,172,17,3,50,158,11,26,0,0
4976,373,180,421,330,172,17,3,48,150,12,26,0,0
4977,366,178,414,325,172,17,3,48,147,13,26,0,0
4978,357,177,405,322,172,17,3,48,145,14,26,0,0
4979,348,174,394,315,172,17,3,46,141,15,26,0,0
4980,342,175,388,310,172,17,3,46,135,16,26,0,0
4981,337,173,383,308,172,17,3,46,135,17,26,0,0
4982,333,170,380,307,172,17,3,47,137,18,26,0,0
4983,330,171,376,306,172,17,3,46,135,19,26,0,0
4984,321,168,368,300,172,17,3,47,132,20,26,0,0
4985,317,168,360,290,172,17,3,43,122,21,26,0,0
4986,310,165,354,290,172,17,3,44,125,22,26,0,0
4987,306,164,352,289,172,17,3,46,125,23,26,0,0
4988,298,164,343,291,172,17,3,45,127,24,26,0,0
4989,286,163,329,286,172,17,3,43,123,25,26,0,0
4990,278,162,321,283,172,17,3,43,121,26,26,1,0
5153,228,268,363,786,173,17,3,135,518,0,67,0,1
5154,237,259,374,783,173,17,3,137,524,1,67,0,0
5155,249,274,380,774,173,17,3,131,500,2,67,0,0
5156,298,266,439,789,173,17,3,141,523,3,67,0,0
5157,333,265,481,797,173,17,3,148,532,4,67,0,0
5158,382,261,532,799,173,17,3,150,538,5,67,0,0
5159,455,260,611,798,173,17,3,156,538,6,67,0,0
5160,490,259,647,787,173,17,3,157,528,7,67,0,0
5161,529,253,682,764,173,17,3,153,511,8,67,0,0
5162,559,253,712,766,173,17,3,153,513,9,67,0,0
5163,584,254,736,759,173,17,3,152,505,10,67,0,0
5164,599,244,742,717,173,17,3,143,473,11,67,0,0
5165,608,236,747,698,173,17,3,139,462,12,67,0,0
5166,616,238,749,681,173,17,3,133,443,13,67,0,0
5167,623,231,747,642,173,17,3,124,411,14,67,0,0
5168,623,224,743,622,173,17,3,120,398,15,67,0,0
5169,619,226,738,620,173,17,3,119,394,16,67,0,0
5170,615,213,731,597,173,17,3,116,384,17,67,0,0
5171,610,207,722,578,173,17,3,112,371,18,67,0,0
5172,605,208,716,571,173,17,3,111,363,19,67,0,0
5173,604,202,713,561,173,17,3,109,359,20,67,0,0
5174,603,194,707,541,173,17,3,104,347,21,67,0,0
5175,598,194,700,534,173,17,3,102,340,22,67,0,0
5176,590,191,688,518,173,17,3,98,327,23,67,0,0
5177,583,187,675,501,173,17,3,92,314,24,67,0,0
5178,572,188,664,495,173,17,3,92,307,25,67,0,0
5179,566,186,655,484,173,17,3,89,298,26,67,0,0
5180,561,180,647,469,173,17,3,86,289,27,67,0,0
5181,557,179,641,461,173,17,3,84,282,28,67,0,0
5182,548,178,630,455,173,17,3,82,277,29,67,0,0
5183,542,170,621,440,173,17,3,79,270,30,67,0,0
5184,534,170,613,431,173,17,3,79,261,31,67,0,0
5185,529,168,606,426,173,17,3,77,258,32,67,0,0
5186,522,164,597,415,173,17,3,75,251,33,67,0,0
5187,513,165,590,414,173,17,3,77,249,34,67,0,0
5188,501,165,576,405,173,17,3,75,240,35,67,0,0
5189,488,162,560,397,173,17,3,72,235,36,67,0,0
5190,473,164,543,391,173,17,3,70,227,37,67,0,0
5191,463,164,531,384,173,17,3,68,220,38,67,0,0
5192,454,158,520,375,173,17,3,66,217,39,67,0,0
5193,445,158,511,373,173,17,3,66,215,40,67,0,0
5194,434,155,499,369,173,17,3,65,214,41,67,0,0
5195,426,151,492,364,173,17,3,66,213,42,67,0,0
5196,418,151,485,366,173,17,3,67,215,43,67,0,0
5197,413,151,478,358,173,17,3,65,207,44,67,0,0
5198,411,147,474,348,173,17,3,63,201,45,67,0,0
5199,410,148,471,344,173,17,3,61,196,46,67,0,0
5200,407,147,466,339,173,17,3,59,192,47,67,0,0
5201,405,147,463,335,173,17,3,58,188,48,67,0,0
5202,405,148,461,330,173,17,3,56,182,49,67,0,0
5203,406,147,461,326,173,17,3,55,179,50,67,0,0
5204,407,146,462,323,173,17,3,55,177,51,67,0,0
5205,410,148,462,319,173,17,3,52,171,52,67,0,0
5206,410,147,463,319,173,17,3,53,172,53,67,0,0
5207,410,143,462,315,173,17,3,52,172,54,67,0,0
5208,412,143,462,310,173,17,3,50,167,55,67,0,0
5209,415,142,464,308,173,17,3,49,166,56,67,0,0
5210,417,139,466,305,173,17,3,49,166,57,67,0,0
5211,421,139,469,301,173,17,3,48,162,58,67,0,0
5212,424,139,471,298,173,17,3,47,159,59,67,0,0
5213,427,137,474,295,173,17,3,47,158,60,67,0,0
5214,431,138,478,293,173,17,3,47,155,61,67,0,0
5215,436,139,482,289,173,17,3,46,150,62,67,0,0
5216,441,139,485,285,173,17,3,44,146,63,67,0,0
5217,449,138,493,280,173,17,3,44,142,64,67,0,0
5218,457,138,500,279,173,17,3,43,141,65,67,0,0
5219,466,142,506,273,173,17,3,40,131,66,67,0,0
5220,470,142,509,269,173,17,3,39,127,67,67,1,0
5228,470,136,510,272,173,17,3,40,136,0,67,0,1
5229,464,135,506,276,173,17,3,42,141,1,67,0,0
5230,449,136,493,277,173,17,3,44,141,2,67,0,0
5231,434,134,480,279,173,17,3,46,145,3,67,0,0
5232,426,136,472,280,173,17,3,46,144,4,67,0,0
5233,417,138,464,282,173,17,3,47,144,5,67,0,0
5234,408,138,456,288,173,17,3,48,150,6,67,0,0
5235,401,138,451,294,173,17,3,50,156,7,67,0,0
5236,393,138,445,298,173,17,3,52,160,8,67,0,0
5237,388,140,440,302,173,17,3,52,162,9,67,0,0
5238,385,142,436,304,173,17,3,51,162,10,67,0,0
5239,380,141,432,303,173,17,3,52,162,11,67,0,0
5240,376,142,430,308,173,17,3,54,166,12,67,0,0
5241,372,142,427,312,173,17,3,55,170,13,67,0,0
5242,369,141,425,316,173,17,3,56,175,14,67,0,0
5243,368,143,425,322,173,17,3,57,179,15,67,0,0
5244,370,143,428,326,173,17,3,58,183,16,67,0,0
5245,371,143,429,329,173,17,3,58,186,17,67,0,0
5246,372,145,431,335,173,17,3,59,190,18,67,0,0
5247,373,148,432,338,173,17,3,59,190,19,67,0,0
5248,375,149,434,343,173,17,3,59,194,20,67,0,0
5249,374,152,435,348,173,17,3,61,196,21,67,0,0
5250,373,151,435,352,173,17,3,62,201,22,67,0,0
5251,365,153,431,363,173,17,3,66,210,23,67,0,0
5252,356,159,424,372,173,17,3,68,213,24,67,0,0
5253,347,158,418,379,173,17,3,71,221,25,67,0,0
5254,341,162,411,384,173,17,3,70,222,26,67,0,0
5255,336,165,408,393,173,17,3,72,228,27,67,0,0
5256,329,165,402,398,173,17,3,73,233,28,67,0,0
5257,320,167,396,411,173,17,3,76,244,29,67,0,0
5258,311,168,388,419,173,17,3,77,251,30,67,0,0
5259,304,169,382,425,173,17,3,78,256,31,67,0,0
5260,296,172,375,432,173,17,3,79,260,32,67,0,0
5261,287,171,366,432,173,17,3,79,261,33,67,0,0
5262,274,176,357,443,173,17,3,83,267,34,67,0,0
5263,261,182,344,442,173,17,3,83,260,35,67,0,0
5264,238,185,309,417,173,17,3,71,232,36,67,0,0
5265,229,187,301,419,173,17,3,72,232,37,67,0,0
5505,395,140,430,253,175,17,3,35,113,0,9,0,0
5506,400,139,437,255,175,17,3,37,116,1,9,0,0
5507,405,139,443,256,175,17,3,38,117,2,9,0,0
5508,410,140,448,257,175,17,3,38,117,3,9,0,0
5509,416,140,454,259,175,17,3,38,119,4,9,0,0
5510,423,141,461,261,175,17,3,38,120,5,9,0,0
5511,432,141,471,263,175,17,3,39,122,6,9,0,0
5512,441,142,480,263,175,17,3,39,121,7,9,0,0
5513,453,143,493,266,175,17,3,40,123,8,9,0,0
5514,465,143,505,268,175,17,3,40,125,9,9,0,0
458,1158,283,1262,412,3,17,4,104,129,0,1,0,0
459,1158,283,1262,412,3,17,4,104,129,1,1,0,0
592,1816,696,1920,1080,4,17,4,104,384,0,1,0,0
593,1755,677,1864,1076,4,17,4,109,399,1,1,0,0
594,1605,653,1815,1073,5,17,4,210,420,0,1,0,0
595,1533,637,1754,1079,5,17,4,221,442,1,1,0,0
596,1368,660,1628,1065,6,17,4,260,405,0,8,0,0
597,1306,639,1584,1073,6,17,4,278,434,1,8,0,0
598,1245,628,1529,1076,6,17,4,284,448,2,8,0,0
599,1179,623,1463,1075,6,17,4,284,452,3,8,0,0
600,1133,616,1420,1073,6,17,4,287,457,4,8,0,0
601,1090,617,1381,1073,6,17,4,291,456,5,8,0,0
602,1081,609,1380,1074,6,17,4,299,465,6,8,0,0
603,1144,604,1446,1078,6,17,4,302,474,7,8,0,0
604,1123,599,1429,1079,6,17,4,306,480,8,8,0,0
604,1289,589,1629,1070,7,17,4,340,481,0,10,0,0
605,1353,591,1689,1064,7,17,4,336,473,1,10,0,0
606,1368,602,1692,1062,7,17,4,324,460,2,10,0,0
607,1409,619,1724,1070,7,17,4,315,451,3,10,0,0
608,1483,632,1786,1072,7,17,4,303,440,4,10,0,0
609,1544,629,1849,1078,7,17,4,305,449,5,10,0,0
610,1600,630,1897,1074,7,17,4,297,444,6,10,0,0
611,1641,627,1920,1078,7,17,4,279,451,7,10,0,0
612,1674,623,1920,1080,7,17,4,246,457,8,10,0,0
613,1726,687,1920,1077,7,17,4,194,390,9,10,0,0
614,1768,699,1920,1079,7,17,4,152,380,10,10,0,0
621,1782,820,1920,1075,8,17,4,138,255,0,1,0,0
622,1711,751,1881,1062,8,17,4,170,311,1,1,0,0
624,1765,812,1920,1064,9,17,4,155,252,0,1,0,0
625,1771,809,1920,1064,9,17,4,149,255,1,1,0,0
633,1846,848,1920,1080,10,17,4,74,232,0,0,0,0
1458,1845,959,1919,1080,13,17,4,74,121,0,0,0,0
2720,1819,767,1920,1080,20,17,4,101,313,0,0,0,0
2722,1794,765,1920,1075,21,17,4,126,310,0,97,0,1
2723,1778,741,1915,1079,21,17,4,137,338,1,97,0,0
2724,1765,704,1915,1071,21,17,4,150,367,2,97,0,0
2725,1755,666,1920,1077,21,17,4,165,411,3,97,0,0
2726,1759,685,1918,1077,21,17,4,159,392,4,97,0,0
2727,1777,736,1915,1072,21,17,4,138,336,5,97,0,0
2728,1786,755,1918,1077,21,17,4,132,322,6,97,0,0
2729,1792,762,1919,1071,21,17,4,127,309,7,97,0,0
2730,1792,769,1917,1073,21,17,4,125,304,8,97,0,0
2731,1793,766,1919,1072,21,17,4,126,306,9,97,0,0
2732,1791,761,1919,1071,21,17,4,128,310,10,97,0,0
2733,1789,757,1919,1072,21,17,4,130,315,11,97,0,0
2734,1789,760,1918,1070,21,17,4,129,310,12,97,0,0
2735,1787,760,1918,1076,21,17,4,131,316,13,97,0,0
2736,1787,760,1918,1077,21,17,4,131,317,14,97,0,0
2737,1787,761,1919,1077,21,17,4,132,316,15,97,0,0
2738,1787,760,1920,1078,21,17,4,133,318,16,97,0,0
2739,1788,761,1919,1076,21,17,4,131,315,17,97,0,0
2740,1789,761,1919,1074,21,17,4,130,313,18,97,0,0
2741,1790,772,1918,1076,21,17,4,128,304,19,97,0,0
2742,1790,775,1917,1077,21,17,4,127,302,20,97,0,0
2743,1791,779,1917,1077,21,17,4,126,298,21,97,0,0
2744,1792,779,1917,1075,21,17,4,125,296,22,97,0,0
2745,1790,776,1917,1076,21,17,4,127,300,23,97,0,0
2746,1787,768,1919,1078,21,17,4,132,310,24,97,0,0
2747,1785,764,1919,1078,21,17,4,134,314,25,97,0,0
2748,1785,761,1920,1079,21,17,4,135,318,26,97,0,0
2749,1785,760,1920,1078,21,17,4,135,318,27,97,0,0
2750,1787,756,1920,1076,21,17,4,133,320,28,97,0,0
2751,1788,759,1919,1069,21,17,4,131,310,29,97,0,0
2752,1787,757,1919,1068,21,17,4,132,311,30,97,0,0
2753,1788,759,1918,1067,21,17,4,130,308,31,97,0,0
2754,1788,760,1918,1066,21,17,4,130,306,32,97,0,0
2755,1787,759,1918,1067,21,17,4,131,308,33,97,0,0
2756,1787,760,1919,1070,21,17,4,132,310,34,97,0,0
2757,1788,761,1919,1070,21,17,4,131,309,35,97,0,0
2758,1788,761,1920,1071,21,17,4,132,310,36,97,0,0
2759,1786,762,1920,1077,21,17,4,134,315,37,97,0,0
2760,1786,763,1920,1077,21,17,4,134,314,38,97,0,0
2761,1788,763,1919,1072,21,17,4,131,309,39,97,0,0
2762,1788,763,1919,1070,21,17,4,131,307,40,97,0,0
2763,1788,763,1918,1068,21,17,4,130,305,41,97,0,0
2764,1786,762,1920,1075,21,17,4,134,313,42,97,0,0
2765,1786,762,1920,1077,21,17,4,134,315,43,97,0,0
2766,1788,768,1920,1077,21,17,4,132,309,44,97,0,0
2767,1789,768,1920,1077,21,17,4,131,309,45,97,0,0
2768,1789,767,1920,1076,21,17,4,131,309,46,97,0,0
2769,1789,768,1920,1076,21,17,4,131,308,47,97,0,0
2770,1789,769,1919,1075,21,17,4,130,306,48,97,0,0
2771,1791,772,1920,1077,21,17,4,129,305,49,97,0,0
2772,1792,774,1920,1078,21,17,4,128,304,50,97,0,0
2773,1794,779,1920,1078,21,17,4,126,299,51,97,0,0
2774,1793,780,1919,1076,21,17,4,126,296,52,97,0,0
2775,1792,775,1919,1076,21,17,4,127,301,53,97,0,0
2776,1788,768,1919,1076,21,17,4,131,308,54,97,0,0
2777,1786,764,1919,1076,21,17,4,133,312,55,97,0,0
2778,1785,763,1919,1077,21,17,4,134,314,56,97,0,0
2779,1785,762,1919,1077,21,17,4,134,315,57,97,0,0
2780,1787,763,1918,1070,21,17,4,131,307,58,97,0,0
2781,1786,765,1918,1074,21,17,4,132,309,59,97,0,0
2782,1786,767,1918,1075,21,17,4,132,308,60,97,0,0
2783,1787,768,1918,1075,21,17,4,131,307,61,97,0,0
2784,1787,768,1919,1075,21,17,4,132,307,62,97,0,0
2785,1787,769,1919,1075,21,17,4,132,306,63,97,0,0
2786,1785,762,1920,1077,21,17,4,135,315,64,97,0,0
2787,1785,760,1920,1077,21,17,4,135,317,65,97,0,0
2788,1784,759,1920,1077,21,17,4,136,318,66,97,0,0
2789,1784,758,1920,1077,21,17,4,136,319,67,97,0,0
2790,1784,758,1920,1077,21,17,4,136,319,68,97,0,0
2791,1785,761,1920,1077,21,17,4,135,316,69,97,0,0
2792,1785,763,1920,1077,21,17,4,135,314,70,97,0,0
2793,1785,763,1919,1077,21,17,4,134,314,71,97,0,0
2794,1786,763,1920,1076,21,17,4,134,313,72,97,0,0
2795,1785,763,1920,1076,21,17,4,135,313,73,97,0,0
2796,1785,762,1920,1076,21,17,4,135,314,74,97,0,0
2797,1785,762,1919,1077,21,17,4,134,315,75,97,0,0
2798,1785,762,1920,1077,21,17,4,135,315,76,97,0,0
2799,1785,760,1920,1077,21,17,4,135,317,77,97,0,0
2800,1785,761,1920,1077,21,17,4,135,316,78,97,0,0
2801,1786,764,1920,1077,21,17,4,134,313,79,97,0,0
2802,1786,762,1920,1077,21,17,4,134,315,80,97,0,0
2803,1787,762,1920,1077,21,17,4,133,315,81,97,0,0
2804,1786,762,1920,1077,21,17,4,134,315,82,97,0,0
2805,1786,761,1920,1077,21,17,4,134,316,83,97,0,0
2806,1789,778,1917,1076,21,17,4,128,298,84,97,0,0
2807,1791,785,1916,1076,21,17,4,125,291,85,97,0,0
2808,1790,787,1916,1078,21,17,4,126,291,86,97,0,0
2809,1789,785,1916,1077,21,17,4,127,292,87,97,0,0
2810,1787,780,1917,1077,21,17,4,130,297,88,97,0,0
2811,1789,789,1915,1076,21,17,4,126,287,89,97,0,0
2812,1789,789,1915,1072,21,17,4,126,283,90,97,0,0
2813,1788,789,1915,1071,21,17,4,127,282,91,97,0,0
2814,1786,785,1916,1075,21,17,4,130,290,92,97,0,0
2815,1785,783,1917,1077,21,17,4,132,294,93,97,0,0
2816,1782,770,1920,1077,21,17,4,138,307,94,97,0,0
2817,1782,767,1920,1078,21,17,4,138,311,95,97,0,0
2818,1793,780,1920,1079,21,17,4,127,299,96,97,0,0
2819,1794,780,1920,1079,21,17,4,126,299,97,97,1,0
4793,798,843,1023,1074,52,17,4,225,231,0,1,0,0
4794,746,721,1082,1065,52,17,4,336,344,1,1,0,0
4822,259,588,597,1073,55,17,4,338,485,0,9,0,0
4823,249,611,569,1071,55,17,4,320,460,1,9,0,0
4824,237,596,566,1069,55,17,4,329,473,2,9,0,0
4825,235,591,568,1069,55,17,4,333,478,3,9,0,0
4826,238,595,569,1070,55,17,4,331,475,4,9,0,0
4827,241,599,571,1070,55,17,4,330,471,5,9,0,0
4828,257,627,570,1072,55,17,4,313,445,6,9,0,0
4829,284,685,564,1076,55,17,4,280,391,7,9,0,0
4830,304,738,554,1077,55,17,4,250,339,8,9,0,0
4831,314,760,549,1078,55,17,4,235,318,9,9,0,0
5895,1633,149,1668,247,64,17,4,35,98,0,88,0,0
5896,1632,148,1668,250,64,17,4,36,102,1,88,0,0
5897,1631,146,1667,252,64,17,4,36,106,2,88,0,0
5898,1632,147,1668,252,64,17,4,36,105,3,88,0,0
5899,1632,147,1668,251,64,17,4,36,104,4,88,0,0
5907,1631,158,1666,257,64,17,4,35,99,0,88,0,1
5908,1630,157,1667,261,64,17,4,37,104,1,88,0,0
5909,1629,154,1666,262,64,17,4,37,108,2,88,0,0
5910,1627,154,1665,263,64,17,4,38,109,3,88,0,0
5911,1629,161,1664,262,64,17,4,35,101,4,88,0,0
5912,1629,161,1665,263,64,17,4,36,102,5,88,0,0
5913,1628,160,1666,268,64,17,4,38,108,6,88,0,0
5914,1625,159,1665,274,64,17,4,40,115,7,88,0,0
5915,1622,160,1663,276,64,17,4,41,116,8,88,0,0
5916,1620,159,1661,277,64,17,4,41,118,9,88,0,0
5917,1619,160,1660,277,64,17,4,41,117,10,88,0,0
5918,1619,163,1659,279,64,17,4,40,116,11,88,0,0
5919,1619,162,1660,283,64,17,4,41,121,12,88,0,0
5920,1617,163,1661,289,64,17,4,44,126,13,88,0,0
5921,1614,165,1659,292,64,17,4,45,127,14,88,0,0
5922,1612,164,1657,291,64,17,4,45,127,15,88,0,0
5923,1610,168,1654,290,64,17,4,44,122,16,88,0,0
5924,1610,168,1653,289,64,17,4,43,121,17,88,0,0
5925,1608,167,1655,294,64,17,4,47,127,18,88,0,0
5926,1605,165,1654,298,64,17,4,49,133,19,88,0,0
5927,1602,164,1651,301,64,17,4,49,137,20,88,0,0
5928,1600,167,1648,301,64,17,4,48,134,21,88,0,0
5929,1600,171,1648,304,64,17,4,48,133,22,88,0,0
5930,1602,169,1653,308,64,17,4,51,139,23,88,0,0
5931,1604,170,1656,314,64,17,4,52,144,24,88,0,0
5932,1603,170,1657,320,64,17,4,54,150,25,88,0,0
5933,1603,172,1658,324,64,17,4,55,152,26,88,0,0
5934,1602,171,1658,325,64,17,4,56,154,27,88,0,0
5935,1601,172,1657,328,64,17,4,56,156,28,88,0,0
5936,1603,172,1660,332,64,17,4,57,160,29,88,0,0
5937,1607,172,1665,335,64,17,4,58,163,30,88,0,0
5938,1607,172,1667,339,64,17,4,60,167,31,88,0,0
5939,1605,174,1666,343,64,17,4,61,169,32,88,0,0
5940,1604,174,1665,346,64,17,4,61,172,33,88,0,0
5941,1602,175,1665,353,64,17,4,63,178,34,88,0,0
5942,1603,175,1666,357,64,17,4,63,182,35,88,0,0
5943,1606,176,1670,360,64,17,4,64,184,36,88,0,0
5944,1606,177,1672,366,64,17,4,66,189,37,88,0,0
5945,1603,179,1669,370,64,17,4,66,191,38,88,0,0
5946,1601,179,1667,372,64,17,4,66,193,39,88,0,0
5947,1600,181,1665,373,64,17,4,65,192,40,88,0,0
5948,1606,186,1670,377,64,17,4,64,191,41,88,0,0
5949,1611,186,1677,385,64,17,4,66,199,42,88,0,0
5950,1614,190,1682,393,64,17,4,68,203,43,88,0,0
5951,1614,192,1683,397,64,17,4,69,205,44,88,0,0
5952,1611,192,1680,400,64,17,4,69,208,45,88,0,0
5953,1608,195,1678,406,64,17,4,70,211,46,88,0,0
5954,1606,197,1679,416,64,17,4,73,219,47,88,0,0
5955,1608,202,1680,420,64,17,4,72,218,48,88,0,0
5956,1607,198,1682,425,64,17,4,75,227,49,88,0,0
5957,1603,202,1679,433,64,17,4,76,231,50,88,0,0
5958,1595,206,1672,437,64,17,4,77,231,51,88,0,0
5959,1590,206,1670,445,64,17,4,80,239,52,88,0,0
5960,1590,211,1670,452,64,17,4,80,241,53,88,0,0
5961,1590,213,1671,456,64,17,4,81,243,54,88,0,0
5962,1587,214,1669,463,64,17,4,82,249,55,88,0,0
5963,1581,221,1665,475,64,17,4,84,254,56,88,0,0
5964,1573,222,1658,479,64,17,4,85,257,57,88,0,0
5965,1566,222,1654,485,64,17,4,88,263,58,88,0,0
5966,1561,229,1654,501,64,17,4,93,272,59,88,0,0
5967,1561,231,1656,512,64,17,4,95,281,60,88,0,0
5968,1558,233,1655,517,64,17,4,97,284,61,88,0,0
5969,1549,239,1650,534,64,17,4,101,295,62,88,0,0
5970,1539,242,1643,545,64,17,4,104,303,63,88,0,0
5971,1535,242,1642,555,64,17,4,107,313,64,88,0,0
5972,1534,247,1646,573,64,17,4,112,326,65,88,0,0
5973,1537,251,1653,588,64,17,4,116,337,66,88,0,0
5974,1539,253,1659,600,64,17,4,120,347,67,88,0,0
5975,1533,261,1658,620,64,17,4,125,359,68,88,0,0
5976,1525,268,1653,637,64,17,4,128,369,69,88,0,0
5977,1522,274,1652,649,64,17,4,130,375,70,88,0,0
5978,1517,283,1656,687,64,17,4,139,404,71,88,0,0
5979,1522,289,1664,702,64,17,4,142,413,72,88,0,0
5980,1521,294,1668,716,64,17,4,147,422,73,88,0,0
5981,1514,306,1669,753,64,17,4,155,447,74,88,0,0
5982,1504,311,1663,768,64,17,4,159,457,75,88,0,0
5983,1491,318,1656,793,64,17,4,165,475,76,88,0,0
5984,1482,331,1657,839,64,17,4,175,508,77,88,0,0
5985,1481,342,1662,870,64,17,4,181,528,78,88,0,0
5986,1471,350,1659,892,64,17,4,188,542,79,88,0,0
5987,1445,367,1646,939,64,17,4,201,572,80,88,0,0
5988,1423,377,1629,963,64,17,4,206,586,81,88,0,0
5989,1396,386,1618,1017,64,17,4,222,631,82,88,0,0
5990,1380,414,1608,1057,64,17,4,228,643,83,88,0,0
5991,1363,436,1592,1071,64,17,4,229,635,84,88,0,0
5992,1339,458,1568,1075,64,17,4,229,617,85,88,0,0
5993,1305,494,1529,1078,64,17,4,224,584,86,88,0,0
5994,1256,523,1478,1080,64,17,4,222,557,87,88,0,0
5995,1213,562,1435,1080,64,17,4,222,518,88,88,1,0
440,5,523,302,1072,2,17,5,297,549,0,27,0,1
441,125,519,425,1073,2,17,5,300,554,1,27,0,0
442,259,480,580,1074,2,17,5,321,594,2,27,0,0
443,460,463,790,1067,2,17,5,330,604,3,27,0,0
444,611,447,946,1062,2,17,5,335,615,4,27,0,0
445,723,419,1072,1071,2,17,5,349,652,5,27,0,0
446,826,422,1174,1070,2,17,5,348,648,6,27,0,0
447,957,416,1302,1063,2,17,5,345,647,7,27,0,0
448,1084,400,1444,1070,2,17,5,360,670,8,27,0,0
449,1179,384,1547,1066,2,17,5,368,682,9,27,0,0
450,1241,375,1604,1054,2,17,5,363,679,10,27,0,0
451,1292,373,1654,1040,2,17,5,362,667,11,27,0,0
452,1370,369,1712,997,2,17,5,342,628,12,27,0,0
453,1453,358,1783,963,2,17,5,330,605,13,27,0,0
454,1505,351,1830,942,2,17,5,325,591,14,27,0,0
455,1554,343,1850,892,2,17,5,296,549,15,27,0,0
456,1581,346,1861,868,2,17,5,280,522,16,27,0,0
457,1623,350,1886,836,2,17,5,263,486,17,27,0,0
458,1675,339,1920,820,2,17,5,245,481,18,27,0,0
459,1703,335,1920,806,2,17,5,217,471,19,27,0,0
460,1735,326,1920,777,2,17,5,185,451,20,27,0,0
461,1749,326,1920,756,2,17,5,171,430,21,27,0,0
462,1771,366,1920,729,2,17,5,149,363,22,27,0,0
463,1801,367,1920,709,2,17,5,119,342,23,27,0,0
464,1811,359,1920,716,2,17,5,109,357,24,27,0,0
465,1832,355,1920,688,2,17,5,88,333,25,27,0,0
466,1844,360,1920,667,2,17,5,76,307,26,27,0,0
467,1874,359,1920,648,2,17,5,46,289,27,27,1,0
460,1872,328,1919,405,3,17,5,47,77,0,0,0,0
1981,1324,7,1389,135,4,17,5,65,128,0,5,0,0
1982,1324,7,1389,135,4,17,5,65,128,1,5,0,0
1983,1322,5,1388,135,4,17,5,66,130,2,5,0,0
1984,1321,5,1388,136,4,17,5,67,131,3,5,0,0
1985,1322,5,1388,136,4,17,5,66,131,4,5,0,0
1986,1321,5,1388,136,4,17,5,67,131,5,5,0,0
2052,1,799,63,1029,8,17,5,62,230,0,0,0,0
2053,5,432,285,1034,9,17,5,280,602,0,16,0,0
2054,58,396,342,1007,9,17,5,284,611,1,16,0,0
2055,184,372,468,978,9,17,5,284,606,2,16,0,0
2056,308,354,593,959,9,17,5,285,605,3,16,0,0
2057,459,339,736,933,9,17,5,277,594,4,16,0,0
2058,608,339,874,905,9,17,5,266,566,5,16,0,0
2059,775,327,1032,871,9,17,5,257,544,6,16,0,0
2060,944,320,1184,827,9,17,5,240,507,7,16,0,0
2061,1105,304,1350,810,9,17,5,245,506,8,16,0,0
2062,1262,298,1490,775,9,17,5,228,477,9,16,0,0
2063,1369,294,1585,738,9,17,5,216,444,10,16,0,0
2064,1490,299,1692,716,9,17,5,202,417,11,16,0,0
2065,1576,286,1770,682,9,17,5,194,396,12,16,0,0
2066,1644,289,1826,662,9,17,5,182,373,13,16,0,0
2067,1717,302,1879,634,9,17,5,162,332,14,16,0,0
2068,1776,293,1920,608,9,17,5,144,315,15,16,0,0
2069,1876,289,1920,581,9,17,5,44,292,16,16,0,0
2056,331,18,366,122,10,17,5,35,104,0,100,0,1
2057,332,18,367,123,10,17,5,35,105,1,100,0,0
2058,333,17,368,120,10,17,5,35,103,2,100,0,0
2059,331,16,369,126,10,17,5,38,110,3,100,0,0
2060,332,18,371,135,10,17,5,39,117,4,100,0,0
2061,332,18,372,137,10,17,5,40,119,5,100,0,0
2062,337,24,375,136,10,17,5,38,112,6,100,0,0
2063,339,21,380,141,10,17,5,41,120,7,100,0,0
2064,341,20,382,140,10,17,5,41,120,8,100,0,0
2065,340,20,382,142,10,17,5,42,122,9,100,0,0
2066,342,22,385,148,10,17,5,43,126,10,100,0,0
2067,341,24,384,149,10,17,5,43,125,11,100,0,0
2068,341,27,383,150,10,17,5,42,123,12,100,0,0
2069,342,27,385,152,10,17,5,43,125,13,100,0,0
2070,339,24,382,151,10,17,5,43,127,14,100,0,0
2071,336,24,379,151,10,17,5,43,127,15,100,0,0
2072,336,25,380,153,10,17,5,44,128,16,100,0,0
2073,336,32,379,158,10,17,5,43,126,17,100,0,0
2074,337,34,380,160,10,17,5,43,126,18,100,0,0
2075,341,35,383,160,10,17,5,42,125,19,100,0,0
2076,342,32,386,163,10,17,5,44,131,20,100,0,0
2077,343,29,388,165,10,17,5,45,136,21,100,0,0
2078,343,28,389,168,10,17,5,46,140,22,100,0,0
2079,343,30,390,174,10,17,5,47,144,23,100,0,0
2080,345,30,393,178,10,17,5,48,148,24,100,0,0
2081,350,34,396,178,10,17,5,46,144,25,100,0,0
2082,352,34,399,182,10,17,5,47,148,26,100,0,0
2083,353,33,402,184,10,17,5,49,151,27,100,0,0
2084,354,37,402,185,10,17,5,48,148,28,100,0,0
2085,354,38,403,190,10,17,5,49,152,29,100,0,0
2086,354,38,404,198,10,17,5,50,160,30,100,0,0
2087,354,39,404,199,10,17,5,50,160,31,100,0,0
2088,354,40,406,203,10,17,5,52,163,32,100,0,0
2089,353,41,406,210,10,17,5,53,169,33,100,0,0
2090,352,42,405,212,10,17,5,53,170,34,100,0,0
2091,351,48,403,217,10,17,5,52,169,35,100,0,0
2092,351,58,401,222,10,17,5,50,164,36,100,0,0
2093,348,53,401,225,10,17,5,53,172,37,100,0,0
2094,348,58,401,230,10,17,5,53,172,38,100,0,0
2095,345,61,399,238,10,17,5,54,177,39,100,0,0
2096,340,61,394,236,10,17,5,54,175,40,100,0,0
2097,336,63,392,242,10,17,5,56,179,41,100,0,0
2098,333,64,389,249,10,17,5,56,185,42,100,0,0
2099,331,66,389,253,10,17,5,58,187,43,100,0,0
2100,329,69,388,259,10,17,5,59,190,44,100,0,0
2101,329,79,388,268,10,17,5,59,189,45,100,0,0
2102,325,83,384,273,10,17,5,59,190,46,100,0,0
2103,322,80,384,275,10,17,5,62,195,47,100,0,0
2104,320,84,384,287,10,17,5,64,203,48,100,0,0
2105,318,79,386,294,10,17,5,68,215,49,100,0,0
2106,319,73,389,298,10,17,5,70,225,50,100,0,0
2107,323,87,391,304,10,17,5,68,217,51,100,0,0
2108,322,82,395,313,10,17,5,73,231,52,100,0,0
2109,324,80,399,318,10,17,5,75,238,53,100,0,0
2110,328,80,405,328,10,17,5,77,248,54,100,0,0
2111,334,78,415,340,10,17,5,81,262,55,100,0,0
2112,343,78,426,346,10,17,5,83,268,56,100,0,0
2113,349,81,436,361,10,17,5,87,280,57,100,0,0
2114,355,86,443,372,10,17,5,88,286,58,100,0,0
2115,365,87,454,376,10,17,5,89,289,59,100,0,0
2116,372,88,468,397,10,17,5,96,309,60,100,0,0
2117,378,85,478,410,10,17,5,100,325,61,100,0,0
2118,382,83,487,424,10,17,5,105,341,62,100,0,0
2119,389,96,495,445,10,17,5,106,349,63,100,0,0
2120,393,101,501,456,10,17,5,108,355,64,100,0,0
2121,396,102,511,479,10,17,5,115,377,65,100,0,0
2122,405,114,524,503,10,17,5,119,389,66,100,0,0
2123,417,124,539,519,10,17,5,122,395,67,100,0,0
2124,425,135,554,557,10,17,5,129,422,68,100,0,0
2125,437,148,573,587,10,17,5,136,439,69,100,0,0
2126,443,151,583,600,10,17,5,140,449,70,100,0,0
2127,458,170,607,637,10,17,5,149,467,71,100,0,0
2128,481,194,633,671,10,17,5,152,477,72,100,0,0
2129,509,200,665,690,10,17,5,156,490,73,100,0,0
2130,546,223,712,735,10,17,5,166,512,74,100,0,0
2131,588,240,760,767,10,17,5,172,527,75,100,0,0
2132,643,245,822,778,10,17,5,179,533,76,100,0,0
2133,710,264,902,798,10,17,5,192,534,77,100,0,0
2134,805,277,1001,801,10,17,5,196,524,78,100,0,0
2135,899,279,1105,814,10,17,5,206,535,79,100,0,0
2136,973,303,1188,821,10,17,5,215,518,80,100,0,0
2137,1082,309,1303,822,10,17,5,221,513,81,100,0,0
2138,1181,303,1409,818,10,17,5,228,515,82,100,0,0
2139,1243,308,1480,823,10,17,5,237,515,83,100,0,0
2140,1341,303,1573,806,10,17,5,232,503,84,100,0,0
2141,1406,319,1632,795,10,17,5,226,476,85,100,0,0
2142,1462,324,1687,784,10,17,5,225,460,86,100,0,0
2143,1533,323,1752,773,10,17,5,219,450,87,100,0,0
2144,1572,328,1789,767,10,17,5,217,439,88,100,0,0
2145,1631,335,1818,721,10,17,5,187,386,89,100,0,0
2146,1667,315,1852,703,10,17,5,185,388,90,100,0,0
2147,1683,317,1865,698,10,17,5,182,381,91,100,0,0
2148,1722,305,1895,671,10,17,5,173,366,92,100,0,0
2149,1743,300,1914,664,10,17,5,171,364,93,100,0,0
2150,1768,304,1920,645,10,17,5,152,341,94,100,0,0
2151,1795,305,1920,626,10,17,5,125,321,95,100,0,0
2152,1812,323,1920,607,10,17,5,108,284,96,100,0,0
2153,1823,326,1920,593,10,17,5,97,267,97,100,0,0
2154,1839,337,1920,586,10,17,5,81,249,98,100,0,0
2155,1845,346,1920,587,10,17,5,75,241,99,100,0,0
2156,1865,346,1920,563,10,17,5,55,217,100,100,1,0
2069,1817,308,1917,593,11,17,5,100,285,0,1,0,0
2070,1832,322,1920,573,11,17,5,88,251,1,1,0,0
2145,1737,315,1814,567,13,17,5,77,252,0,0,0,0
2195,0,918,117,1056,14,17,5,117,138,0,0,0,0
2196,3,726,180,1026,15,17,5,177,300,0,83,0,1
2197,0,457,265,1045,15,17,5,265,588,1,83,0,0
2198,0,359,345,1040,15,17,5,345,681,2,83,0,0
2199,15,314,421,1015,15,17,5,406,701,3,83,0,0
2200,80,281,475,971,15,17,5,395,690,4,83,0,0
2201,152,262,543,956,15,17,5,391,694,5,83,0,0
2202,217,248,592,927,15,17,5,375,679,6,83,0,0
2203,264,222,610,861,15,17,5,346,639,7,83,0,0
2204,321,209,648,825,15,17,5,327,616,8,83,0,0
2205,379,200,676,764,15,17,5,297,564,9,83,0,0
2206,386,179,660,716,15,17,5,274,537,10,83,0,0
2207,388,175,646,696,15,17,5,258,521,11,83,0,0
2208,389,159,622,641,15,17,5,233,482,12,83,0,0
2209,393,144,613,609,15,17,5,220,465,13,83,0,0
2210,398,141,609,598,15,17,5,211,457,14,83,0,0
2211,397,128,587,553,15,17,5,190,425,15,83,0,0
2212,395,120,574,535,15,17,5,179,415,16,83,0,0
2213,393,116,560,515,15,17,5,167,399,17,83,0,0
2214,389,101,546,484,15,17,5,157,383,18,83,0,0
2215,386,92,540,474,15,17,5,154,382,19,83,0,0
2216,381,91,526,460,15,17,5,145,369,20,83,0,0
2217,377,86,508,429,15,17,5,131,343,21,83,0,0
2218,370,85,496,421,15,17,5,126,336,22,83,0,0
2219,366,81,487,409,15,17,5,121,328,23,83,0,0
2220,361,76,476,392,15,17,5,115,316,24,83,0,0
2221,359,78,470,388,15,17,5,111,310,25,83,0,0
2222,358,78,460,367,15,17,5,102,289,26,83,0,0
2223,356,79,453,358,15,17,5,97,279,27,83,0,0
2224,355,77,449,352,15,17,5,94,275,28,83,0,0
2225,353,71,441,332,15,17,5,88,261,29,83,0,0
2226,353,68,438,321,15,17,5,85,253,30,83,0,0
2227,353,67,438,322,15,17,5,85,255,31,83,0,0
2228,357,68,435,304,15,17,5,78,236,32,83,0,0
2229,359,69,433,296,15,17,5,74,227,33,83,0,0
2230,359,69,431,293,15,17,5,72,224,34,83,0,0
2231,362,66,430,277,15,17,5,68,211,35,83,0,0
2232,362,59,431,272,15,17,5,69,213,36,83,0,0
2233,369,62,436,268,15,17,5,67,206,37,83,0,0
2234,371,55,438,261,15,17,5,67,206,38,83,0,0
2235,374,59,437,258,15,17,5,63,199,39,83,0,0
2236,372,56,434,249,15,17,5,62,193,40,83,0,0
2237,371,40,435,241,15,17,5,64,201,41,83,0,0
2238,371,40,434,236,15,17,5,63,196,42,83,0,0
2239,376,51,434,228,15,17,5,58,177,43,83,0,0
2240,373,38,434,222,15,17,5,61,184,44,83,0,0
2241,373,39,432,218,15,17,5,59,179,45,83,0,0
2242,369,36,428,210,15,17,5,59,174,46,83,0,0
2243,367,30,426,208,15,17,5,59,178,47,83,0,0
2244,367,27,426,205,15,17,5,59,178,48,83,0,0
2245,369,34,423,197,15,17,5,54,163,49,83,0,0
2246,371,38,422,196,15,17,5,51,158,50,83,0,0
2247,370,36,420,193,15,17,5,50,157,51,83,0,0
2248,368,36,417,187,15,17,5,49,151,52,83,0,0
2249,366,35,413,184,15,17,5,47,149,53,83,0,0
2250,365,35,411,182,15,17,5,46,147,54,83,0,0
2251,365,31,411,177,15,17,5,46,146,55,83,0,0
2252,366,32,410,174,15,17,5,44,142,56,83,0,0
2253,364,33,408,171,15,17,5,44,138,57,83,0,0
2254,361,26,406,167,15,17,5,45,141,58,83,0,0
2255,360,25,405,163,15,17,5,45,138,59,83,0,0
2256,361,24,404,157,15,17,5,43,133,60,83,0,0
2257,361,20,403,152,15,17,5,42,132,61,83,0,0
2258,361,19,403,151,15,17,5,42,132,62,83,0,0
2259,359,15,401,150,15,17,5,42,135,63,83,0,0
2260,358,15,400,150,15,17,5,42,135,64,83,0,0
2261,357,11,400,149,15,17,5,43,138,65,83,0,0
2262,357,9,399,145,15,17,5,42,136,66,83,0,0
2263,357,10,398,143,15,17,5,41,133,67,83,0,0
2264,355,9,398,142,15,17,5,43,133,68,83,0,0
2265,353,11,395,138,15,17,5,42,127,69,83,0,0
2266,350,12,392,137,15,17,5,42,125,70,83,0,0
2267,349,11,391,138,15,17,5,42,127,71,83,0,0
2268,349,10,389,132,15,17,5,40,122,72,83,0,0
2269,348,9,388,130,15,17,5,40,121,73,83,0,0
2270,344,12,384,131,15,17,5,40,119,74,83,0,0
2271,340,8,381,129,15,17,5,41,121,75,83,0,0
2272,339,7,381,127,15,17,5,42,120,76,83,0,0
2273,341,10,381,125,15,17,5,40,115,77,83,0,0
2274,341,9,380,123,15,17,5,39,114,78,83,0,0
2275,341,10,379,121,15,17,5,38,111,79,83,0,0
2276,338,7,377,118,15,17,5,39,111,80,83,0,0
2277,337,7,375,118,15,17,5,38,111,81,83,0,0
2278,338,10,373,114,15,17,5,35,104,82,83,0,0
2279,340,7,375,112,15,17,5,35,105,83,83,1,0
2481,1322,5,1383,141,16,17,5,61,136,0,3,0,0
2482,1322,4,1383,140,16,17,5,61,136,1,3,0,0
2483,1322,3,1382,137,16,17,5,60,134,2,3,0,0
2484,1322,3,1381,136,16,17,5,59,133,3,3,0,0
2866,335,8,370,116,17,17,5,35,108,0,75,0,1
2867,334,8,370,119,17,17,5,36,111,1,75,0,0
2868,334,10,369,120,17,17,5,35,110,2,75,0,0
2869,334,13,369,121,17,17,5,35,108,3,75,0,0
2870,333,13,370,126,17,17,5,37,113,4,75,0,0
2871,333,11,372,132,17,17,5,39,121,5,75,0,0
2872,334,10,374,134,17,17,5,40,124,6,75,0,0
2873,335,9,376,136,17,17,5,41,127,7,75,0,0
2874,335,10,375,136,17,17,5,40,126,8,75,0,0
2875,336,8,377,137,17,17,5,41,129,9,75,0,0
2876,339,13,379,139,17,17,5,40,126,10,75,0,0
2877,342,15,382,140,17,17,5,40,125,11,75,0,0
2878,342,13,383,144,17,17,5,41,131,12,75,0,0
2879,339,15,381,149,17,17,5,42,134,13,75,0,0
2880,337,15,380,151,17,17,5,43,136,14,75,0,0
2881,335,16,378,155,17,17,5,43,139,15,75,0,0
2882,333,15,378,157,17,17,5,45,142,16,75,0,0
2883,334,15,379,159,17,17,5,45,144,17,75,0,0
2884,331,17,377,163,17,17,5,46,146,18,75,0,0
2885,329,19,376,165,17,17,5,47,146,19,75,0,0
2886,327,18,374,169,17,17,5,47,151,20,75,0,0
2887,327,24,374,173,17,17,5,47,149,21,75,0,0
2888,328,26,375,176,17,17,5,47,150,22,75,0,0
2889,329,26,376,178,17,17,5,47,152,23,75,0,0
2890,327,31,375,183,17,17,5,48,152,24,75,0,0
2891,327,33,374,186,17,17,5,47,153,25,75,0,0
2892,327,35,374,191,17,17,5,47,156,26,75,0,0
2893,327,33,377,199,17,17,5,50,166,27,75,0,0
2894,327,32,378,202,17,17,5,51,170,28,75,0,0
2895,327,32,379,208,17,17,5,52,176,29,75,0,0
2896,325,35,377,214,17,17,5,52,179,30,75,0,0
2897,324,34,378,217,17,17,5,54,183,31,75,0,0
2898,323,38,377,221,17,17,5,54,183,32,75,0,0
2899,324,41,378,226,17,17,5,54,185,33,75,0,0
2900,323,38,380,232,17,17,5,57,194,34,75,0,0
2901,320,46,377,238,17,17,5,57,192,35,75,0,0
2902,315,44,375,242,17,17,5,60,198,36,75,0,0
2903,314,51,374,249,17,17,5,60,198,37,75,0,0
2904,316,56,376,258,17,17,5,60,202,38,75,0,0
2905,317,51,381,261,17,17,5,64,210,39,75,0,0
2906,314,55,380,271,17,17,5,66,216,40,75,0,0
2907,313,59,381,280,17,17,5,68,221,41,75,0,0
2908,315,60,383,283,17,17,5,68,223,42,75,0,0
2909,318,60,390,296,17,17,5,72,236,43,75,0,0
2910,324,64,396,300,17,17,5,72,236,44,75,0,0
2911,327,69,402,310,17,17,5,75,241,45,75,0,0
2912,332,72,410,323,17,17,5,78,251,46,75,0,0
2913,332,74,414,333,17,17,5,82,259,47,75,0,0
2914,338,74,423,344,17,17,5,85,270,48,75,0,0
2915,344,76,433,356,17,17,5,89,280,49,75,0,0
2916,351,78,442,365,17,17,5,91,287,50,75,0,0
2917,351,83,448,389,17,17,5,97,306,51,75,0,0
2918,348,87,447,402,17,17,5,99,315,52,75,0,0
2919,349,89,450,413,17,17,5,101,324,53,75,0,0
2920,352,96,456,433,17,17,5,104,337,54,75,0,0
2921,358,96,465,444,17,17,5,107,348,55,75,0,0
2922,357,100,470,469,17,17,5,113,369,56,75,0,0
2923,353,109,473,495,17,17,5,120,386,57,75,0,0
2924,354,112,475,504,17,17,5,121,392,58,75,0,0
2925,358,127,484,536,17,17,5,126,409,59,75,0,0
2926,361,135,493,559,17,17,5,132,424,60,75,0,0
2927,368,139,506,581,17,17,5,138,442,61,75,0,0
2928,365,150,515,627,17,17,5,150,477,62,75,0,0
2929,361,160,516,648,17,17,5,155,488,63,75,0,0
2930,359,171,526,688,17,17,5,167,517,64,75,0,0
2931,362,201,538,735,17,17,5,176,534,65,75,0,0
2932,367,206,550,753,17,17,5,183,547,66,75,0,0
2933,361,216,561,815,17,17,5,200,599,67,75,0,0
2934,343,242,551,860,17,17,5,208,618,68,75,0,0
2935,304,255,518,885,17,17,5,214,630,69,75,0,0
2936,250,282,486,976,17,17,5,236,694,70,75,0,0
2937,203,312,447,1033,17,17,5,244,721,71,75,0,0
2938,152,325,403,1053,17,17,5,251,728,72,75,0,0
2939,98,368,358,1079,17,17,5,260,711,73,75,0,0
2940,43,469,276,1080,17,17,5,233,611,74,75,0,0
2941,24,491,259,1080,17,17,5,235,589,75,75,1,0
2941,3,781,150,1078,18,17,5,147,297,0,1,0,0
2942,30,915,113,1079,18,17,5,83,164,1,1,0,0
4593,1859,328,1920,544,19,17,5,61,216,0,38,0,1
4594,1855,301,1920,550,19,17,5,65,249,1,38,0,0
4595,1852,300,1920,547,19,17,5,68,247,2,38,0,0
4596,1841,288,1920,568,19,17,5,79,280,3,38,0,0
4597,1822,276,1909,579,19,17,5,87,303,4,38,0,0
4598,1804,278,1895,588,19,17,5,91,310,5,38,0,0
4599,1796,275,1892,592,19,17,5,96,317,6,38,0,0
4600,1777,276,1881,611,19,17,5,104,335,7,38,0,0
4601,1757,276,1869,626,19,17,5,112,350,8,38,0,0
4602,1741,268,1859,634,19,17,5,118,366,9,38,0,0
4603,1704,271,1831,643,19,17,5,127,372,10,38,0,0
4604,1679,272,1811,651,19,17,5,132,379,11,38,0,0
4605,1657,272,1796,663,19,17,5,139,391,12,38,0,0
4606,1626,271,1775,681,19,17,5,149,410,13,38,0,0
4607,1608,270,1762,690,19,17,5,154,420,14,38,0,0
4608,1556,268,1720,698,19,17,5,164,430,15,38,0,0
4609,1510,274,1679,707,19,17,5,169,433,16,38,0,0
4610,1478,264,1656,713,19,17,5,178,449,17,38,0,0
4611,1433,273,1621,736,19,17,5,188,463,18,38,0,0
4612,1392,278,1588,757,19,17,5,196,479,19,38,0,0
4613,1350,275,1551,764,19,17,5,201,489,20,38,0,0
4614,1283,283,1493,780,19,17,5,210,497,21,38,0,0
4615,1237,284,1451,790,19,17,5,214,506,22,38,0,0
4616,1169,283,1404,833,19,17,5,235,550,23,38,0,0
4617,1104,291,1353,867,19,17,5,249,576,24,38,0,0
4618,1055,297,1303,880,19,17,5,248,583,25,38,0,0
4619,970,312,1217,888,19,17,5,247,576,26,38,0,0
4620,886,314,1148,921,19,17,5,262,607,27,38,0,0
4621,811,318,1084,966,19,17,5,273,648,28,38,0,0
4622,701,336,984,992,19,17,5,283,656,29,38,0,0
4623,612,353,895,1018,19,17,5,283,665,30,38,0,0
4624,525,373,805,1033,19,17,5,280,660,31,38,0,0
4625,447,386,738,1052,19,17,5,291,666,32,38,0,0
4626,341,393,634,1055,19,17,5,293,662,33,38,0,0
4627,225,407,529,1071,19,17,5,304,664,34,38,0,0
4628,133,435,440,1076,19,17,5,307,641,35,38,0,0
4629,22,458,321,1080,19,17,5,299,622,36,38,0,0
4630,0,551,249,1076,19,17,5,249,525,37,38,0,0
4631,0,571,176,1080,19,17,5,176,509,38,38,1,0
5001,1874,355,1919,608,20,17,5,45,253,0,27,0,1
5002,1863,335,1915,627,20,17,5,52,292,1,27,0,0
5003,1840,324,1896,627,20,17,5,56,303,2,27,0,0
5004,1817,303,1881,634,20,17,5,64,331,3,27,0,0
5005,1805,288,1878,651,20,17,5,73,363,4,27,0,0
5006,1777,279,1862,677,20,17,5,85,398,5,27,0,0
5007,1759,279,1852,690,20,17,5,93,411,6,27,0,0
5008,1714,278,1815,694,20,17,5,101,416,7,27,0,0
5009,1675,284,1784,700,20,17,5,109,416,8,27,0,0
5010,1646,278,1768,728,20,17,5,122,450,9,27,0,0
5011,1598,289,1732,759,20,17,5,134,470,10,27,0,0
5012,1561,287,1705,777,20,17,5,144,490,11,27,0,0
5013,1482,293,1641,794,20,17,5,159,501,12,27,0,0
5014,1417,305,1588,815,20,17,5,171,510,13,27,0,0
5015,1372,300,1559,848,20,17,5,187,548,14,27,0,0
5016,1288,317,1492,893,20,17,5,204,576,15,27,0,0
5017,1223,323,1438,920,20,17,5,215,597,16,27,0,0
5018,1101,330,1333,938,20,17,5,232,608,17,27,0,0
5019,1009,343,1250,962,20,17,5,241,619,18,27,0,0
5020,907,332,1177,1029,20,17,5,270,697,19,27,0,0
5021,785,363,1064,1061,20,17,5,279,698,20,27,0,0
5022,661,371,941,1071,20,17,5,280,700,21,27,0,0
5023,540,398,823,1078,20,17,5,283,680,22,27,0,0
5024,404,419,699,1080,20,17,5,295,661,23,27,0,0
5025,255,431,549,1080,20,17,5,294,649,24,27,0,0
5026,120,468,412,1080,20,17,5,292,612,25,27,0,0
5027,0,505,248,1080,20,17,5,248,575,26,27,0,0
5028,0,519,156,1080,20,17,5,156,561,27,27,1,0
5037,1398,507,1920,1066,21,17,5,522,559,0,2,0,0
5038,1427,470,1920,1059,21,17,5,493,589,1,2,0,0
5039,1402,430,1920,1058,21,17,5,518,628,2,2,0,0
5045,1324,466,1917,1071,23,17,5,593,605,0,6,0,0
5046,1388,442,1920,1046,23,17,5,532,604,1,6,0,0
5047,1447,430,1920,1030,23,17,5,473,600,2,6,0,0
5048,1499,415,1920,1000,23,17,5,421,585,3,6,0,0
5049,1568,398,1920,949,23,17,5,352,551,4,6,0,0
5050,1603,393,1920,922,23,17,5,317,529,5,6,0,0
5051,1611,360,1920,910,23,17,5,309,550,6,6,0,0
5039,1676,455,1894,912,24,17,5,218,457,0,9,0,0
5040,1678,437,1909,923,24,17,5,231,486,1,9,0,0
5041,1700,436,1909,875,24,17,5,209,439,2,9,0,0
5042,1729,425,1920,855,24,17,5,191,430,3,9,0,0
5043,1736,395,1920,855,24,17,5,184,460,4,9,0,0
5044,1761,401,1920,830,24,17,5,159,429,5,9,0,0
5045,1786,400,1920,779,24,17,5,134,379,6,9,0,0
5046,1815,404,1920,729,24,17,5,105,325,7,9,0,0
5047,1831,409,1920,708,24,17,5,89,299,8,9,0,0
5048,1848,406,1920,681,24,17,5,72,275,9,9,0,0
5051,1790,457,1920,880,25,17,5,130,423,0,4,0,0
5052,1807,472,1920,868,25,17,5,113,396,1,4,0,0
5053,1821,477,1920,845,25,17,5,99,368,2,4,0,0
5054,1839,453,1920,803,25,17,5,81,350,3,4,0,0
5055,1851,447,1920,780,25,17,5,69,333,4,4,0,0
395,698,128,746,250,1,17,6,48,122,0,1,0,0
396,704,131,746,236,1,17,6,42,105,1,1,0,0
398,697,138,768,335,2,17,6,71,197,0,40,0,1
399,699,151,767,340,2,17,6,68,189,1,40,0,0
400,699,149,769,342,2,17,6,70,193,2,40,0,0
401,696,143,772,354,2,17,6,76,211,3,40,0,0
402,694,142,772,357,2,17,6,78,215,4,40,0,0
403,689,141,770,368,2,17,6,81,227,5,40,0,0
404,685,144,768,376,2,17,6,83,232,6,40,0,0
405,672,145,758,385,2,17,6,86,240,7,40,0,0
406,662,146,750,394,2,17,6,88,248,8,40,0,0
407,653,148,745,406,2,17,6,92,258,9,40,0,0
408,649,150,743,410,2,17,6,94,260,10,40,0,0
409,644,153,741,422,2,17,6,97,269,11,40,0,0
410,636,155,736,433,2,17,6,100,278,12,40,0,0
411,631,158,732,439,2,17,6,101,281,13,40,0,0
412,627,162,734,461,2,17,6,107,299,14,40,0,0
413,625,164,734,472,2,17,6,109,308,15,40,0,0
414,622,169,736,491,2,17,6,114,322,16,40,0,0
415,618,176,734,506,2,17,6,116,330,17,40,0,0
416,615,177,733,514,2,17,6,118,337,18,40,0,0
417,612,184,737,543,2,17,6,125,359,19,40,0,0
418,615,188,743,558,2,17,6,128,370,20,40,0,0
419,616,195,750,583,2,17,6,134,388,21,40,0,0
420,616,207,755,612,2,17,6,139,405,22,40,0,0
421,618,212,760,629,2,17,6,142,417,23,40,0,0
422,622,221,770,659,2,17,6,148,438,24,40,0,0
423,634,230,785,683,2,17,6,151,453,25,40,0,0
424,641,235,800,714,2,17,6,159,479,26,40,0,0
425,650,248,817,755,2,17,6,167,507,27,40,0,0
426,655,260,826,777,2,17,6,171,517,28,40,0,0
427,667,277,852,840,2,17,6,185,563,29,40,0,0
428,688,294,879,876,2,17,6,191,582,30,40,0,0
429,713,305,912,912,2,17,6,199,607,31,40,0,0
430,735,333,950,997,2,17,6,215,664,32,40,0,0
431,762,356,983,1039,2,17,6,221,683,33,40,0,0
432,796,378,1020,1068,2,17,6,224,690,34,40,0,0
433,835,414,1058,1077,2,17,6,223,663,35,40,0,0
434,902,446,1121,1080,2,17,6,219,634,36,40,0,0
435,976,501,1186,1080,2,17,6,210,579,37,40,0,0
436,1049,570,1248,1080,2,17,6,199,510,38,40,0,0
437,1147,631,1336,1079,2,17,6,189,448,39,40,0,0
438,1187,660,1371,1080,2,17,6,184,420,40,40,1,0
2015,260,145,317,327,6,17,6,57,182,0,38,0,1
2016,275,145,328,313,6,17,6,53,168,1,38,0,0
2017,297,145,353,327,6,17,6,56,182,2,38,0,0
2018,317,141,376,330,6,17,6,59,189,3,38,0,0
2019,349,142,410,334,6,17,6,61,192,4,38,0,0
2020,375,144,437,336,6,17,6,62,192,5,38,0,0
2021,386,144,449,337,6,17,6,63,193,6,38,0,0
2022,401,150,467,352,6,17,6,66,202,7,38,0,0
2023,421,149,489,358,6,17,6,68,209,8,38,0,0
2024,450,155,522,367,6,17,6,72,212,9,38,0,0
2025,469,160,544,370,6,17,6,75,210,10,38,0,0
2026,475,163,550,379,6,17,6,75,216,11,38,0,0
2027,485,168,561,387,6,17,6,76,219,12,38,0,0
2028,508,167,589,397,6,17,6,81,230,13,38,0,0
2029,526,168,616,416,6,17,6,90,248,14,38,0,0
2030,537,171,629,423,6,17,6,92,252,15,38,0,0
2031,548,179,640,433,6,17,6,92,254,16,38,0,0
2032,567,184,659,441,6,17,6,92,257,17,38,0,0
2033,595,189,697,467,6,17,6,102,278,18,38,0,0
2034,617,195,725,485,6,17,6,108,290,19,38,0,0
2035,628,197,737,496,6,17,6,109,299,20,38,0,0
2036,644,211,754,512,6,17,6,110,301,21,38,0,0
2037,673,214,788,531,6,17,6,115,317,22,38,0,0
2038,713,230,840,568,6,17,6,127,338,23,38,0,0
2039,741,235,874,587,6,17,6,133,352,24,38,0,0
2040,754,251,890,613,6,17,6,136,362,25,38,0,0
2041,779,262,920,638,6,17,6,141,376,26,38,0,0
2042,813,276,970,682,6,17,6,157,406,27,38,0,0
2043,863,296,1033,715,6,17,6,170,419,28,38,0,0
2044,896,308,1070,743,6,17,6,174,435,29,38,0,0
2045,925,340,1108,795,6,17,6,183,455,30,38,0,0
2046,988,357,1173,821,6,17,6,185,464,31,38,0,0
2047,1047,392,1259,902,6,17,6,212,510,32,38,0,0
2048,1117,420,1340,951,6,17,6,223,531,33,38,0,0
2049,1158,463,1385,1003,6,17,6,227,540,34,38,0,0
2050,1206,512,1444,1058,6,17,6,238,546,35,38,0,0
2051,1321,545,1560,1073,6,17,6,239,528,36,38,0,0
2052,1413,612,1656,1080,6,17,6,243,468,37,38,0,0
2053,1461,636,1708,1080,6,17,6,247,444,38,38,1,0
2054,1693,810,1919,1072,7,17,6,226,262,0,0,0,0
2169,243,213,297,542,8,17,6,54,329,0,30,0,1
2170,247,190,306,545,8,17,6,59,355,1,30,0,0
2171,261,198,323,567,8,17,6,62,369,2,30,0,0
2172,283,205,347,579,8,17,6,64,374,3,30,0,0
2173,321,213,388,583,8,17,6,67,370,4,30,0,0
2174,352,219,426,603,8,17,6,74,384,5,30,0,0
2175,382,217,461,612,8,17,6,79,395,6,30,0,0
2176,406,222,496,642,8,17,6,90,420,7,30,0,0
2177,429,233,525,659,8,17,6,96,426,8,30,0,0
2178,468,233,570,670,8,17,6,102,437,9,30,0,0
2179,509,241,621,688,8,17,6,112,447,10,30,0,0
2180,535,251,657,713,8,17,6,122,462,11,30,0,0
2181,557,245,691,726,8,17,6,134,481,12,30,0,0
2182,564,253,718,775,8,17,6,154,522,13,30,0,0
2183,606,267,769,801,8,17,6,163,534,14,30,0,0
2184,656,275,821,810,8,17,6,165,535,15,30,0,0
2185,693,297,871,854,8,17,6,178,557,16,30,0,0
2186,735,316,923,883,8,17,6,188,567,17,30,0,0
2187,765,325,978,933,8,17,6,213,608,18,30,0,0
2188,787,359,1025,1004,8,17,6,238,645,19,30,0,0
2189,865,387,1108,1034,8,17,6,243,647,20,30,0,0
2190,922,404,1174,1064,8,17,6,252,660,21,30,0,0
2191,971,442,1227,1076,8,17,6,256,634,22,30,0,0
2192,1055,465,1315,1079,8,17,6,260,614,23,30,0,0
2193,1126,499,1392,1080,8,17,6,266,581,24,30,0,0
2194,1215,549,1480,1080,8,17,6,265,531,25,30,0,0
2195,1354,583,1609,1080,8,17,6,255,497,26,30,0,0
2196,1466,623,1707,1080,8,17,6,241,457,27,30,0,0
2197,1596,676,1817,1080,8,17,6,221,404,28,30,0,0
2198,1698,713,1901,1080,8,17,6,203,367,29,30,0,0
2199,1782,743,1920,1080,8,17,6,138,337,30,30,1,0
2941,1667,769,1908,1074,9,17,6,241,305,0,29,0,1
2942,1564,700,1854,1067,9,17,6,290,367,1,29,0,0
2943,1439,671,1752,1066,9,17,6,313,395,2,29,0,0
2944,1304,626,1653,1070,9,17,6,349,444,3,29,0,0
2945,1163,575,1548,1067,9,17,6,385,492,4,29,0,0
2946,1040,537,1454,1068,9,17,6,414,531,5,29,0,0
2947,946,493,1384,1070,9,17,6,438,577,6,29,0,0
2948,839,452,1299,1070,9,17,6,460,618,7,29,0,0
2949,748,426,1214,1068,9,17,6,466,642,8,29,0,0
2950,698,392,1143,1030,9,17,6,445,638,9,29,0,0
2951,640,360,1080,1011,9,17,6,440,651,10,29,0,0
2952,600,347,1021,990,9,17,6,421,643,11,29,0,0
2953,584,320,957,913,9,17,6,373,593,12,29,0,0
2954,547,301,890,866,9,17,6,343,565,13,29,0,0
2955,527,288,844,828,9,17,6,317,540,14,29,0,0
2956,504,268,791,780,9,17,6,287,512,15,29,0,0
2957,480,256,754,763,9,17,6,274,507,16,29,0,0
2958,462,249,716,736,9,17,6,254,487,17,29,0,0
2959,436,234,672,706,9,17,6,236,472,18,29,0,0
2960,419,236,634,676,9,17,6,215,440,19,29,0,0
2961,401,225,599,645,9,17,6,198,420,20,29,0,0
2962,384,215,574,626,9,17,6,190,411,21,29,0,0
2963,364,216,547,620,9,17,6,183,404,22,29,0,0
2964,341,207,504,578,9,17,6,163,371,23,29,0,0
2965,316,203,471,565,9,17,6,155,362,24,29,0,0
2966,297,207,445,555,9,17,6,148,348,25,29,0,0
2967,259,195,404,545,9,17,6,145,350,26,29,0,0
2968,234,191,377,543,9,17,6,143,352,27,29,0,0
2969,215,190,353,539,9,17,6,138,349,28,29,0,0
2970,184,182,319,523,9,17,6,135,341,29,29,1,0
4122,314,108,350,233,10,17,6,36,125,0,38,0,1
4123,326,111,361,229,10,17,6,35,118,1,38,0,0
4124,339,113,374,232,10,17,6,35,119,2,38,0,0
4125,347,117,384,238,10,17,6,37,121,3,38,0,0
4126,357,113,395,238,10,17,6,38,125,4,38,0,0
4127,366,112,402,233,10,17,6,36,121,5,38,0,0
4128,372,110,413,247,10,17,6,41,137,6,38,0,0
4129,380,119,420,251,10,17,6,40,132,7,38,0,0
4130,387,112,431,257,10,17,6,44,145,8,38,0,0
4131,394,112,441,264,10,17,6,47,152,9,38,0,0
4132,402,114,449,267,10,17,6,47,153,10,38,0,0
4133,407,113,455,267,10,17,6,48,154,11,38,0,0
4134,412,114,461,271,10,17,6,49,157,12,38,0,0
4135,417,115,467,276,10,17,6,50,161,13,38,0,0
4136,424,116,475,282,10,17,6,51,166,14,38,0,0
4137,433,115,486,289,10,17,6,53,174,15,38,0,0
4138,440,117,494,293,10,17,6,54,176,16,38,0,0
4139,447,118,501,294,10,17,6,54,176,17,38,0,0
4140,453,121,508,300,10,17,6,55,179,18,38,0,0
4141,462,122,519,304,10,17,6,57,182,19,38,0,0
4142,475,130,530,305,10,17,6,55,175,20,38,0,0
4143,483,125,542,311,10,17,6,59,186,21,38,0,0
4144,492,123,553,312,10,17,6,61,189,22,38,0,0
4145,501,123,561,312,10,17,6,60,189,23,38,0,0
4146,509,125,573,324,10,17,6,64,199,24,38,0,0
4147,518,123,586,331,10,17,6,68,208,25,38,0,0
4148,533,127,601,333,10,17,6,68,206,26,38,0,0
4149,546,131,614,339,10,17,6,68,208,27,38,0,0
4150,560,135,628,344,10,17,6,68,209,28,38,0,0
4151,574,135,643,347,10,17,6,69,212,29,38,0,0
4152,583,135,656,353,10,17,6,73,218,30,38,0,0
4153,610,139,681,351,10,17,6,71,212,31,38,0,0
4154,642,142,712,355,10,17,6,70,213,32,38,0,0
4155,667,142,741,361,10,17,6,74,219,33,38,0,0
4156,691,144,767,364,10,17,6,76,220,34,38,0,0
4157,721,140,798,362,10,17,6,77,222,35,38,0,0
4158,736,140,813,361,10,17,6,77,221,36,38,0,0
4159,757,142,830,355,10,17,6,73,213,37,38,0,0
4160,775,143,848,357,10,17,6,73,214,38,38,1,0
4169,777,151,834,323,10,17,6,57,172,0,38,0,0
4170,780,156,838,346,10,17,6,58,190,1,38,0,0
4171,786,157,844,347,10,17,6,58,190,2,38,0,0
4124,297,111,334,220,12,17,6,37,109,0,34,0,1
4125,305,113,344,224,12,17,6,39,111,1,34,0,0
4126,318,110,358,225,12,17,6,40,115,2,34,0,0
4127,328,107,370,230,12,17,6,42,123,3,34,0,0
4128,338,109,378,226,12,17,6,40,117,4,34,0,0
4129,347,113,384,221,12,17,6,37,108,5,34,0,0
4130,353,111,393,228,12,17,6,40,117,6,34,0,0
4131,358,111,400,236,12,17,6,42,125,7,34,0,0
4132,361,111,405,243,12,17,6,44,132,8,34,0,0
4133,364,107,410,246,12,17,6,46,139,9,34,0,0
4134,371,109,413,233,12,17,6,42,124,10,34,0,0
4135,374,109,421,250,12,17,6,47,141,11,34,0,0
4136,379,109,425,247,12,17,6,46,138,12,34,0,0
4137,383,111,431,258,12,17,6,48,147,13,34,0,0
4138,386,111,436,263,12,17,6,50,152,14,34,0,0
4139,394,111,446,270,12,17,6,52,159,15,34,0,0
4140,400,113,453,277,12,17,6,53,164,16,34,0,0
4141,407,115,461,279,12,17,6,54,164,17,34,0,0
4142,415,114,468,279,12,17,6,53,165,18,34,0,0
4143,422,116,477,286,12,17,6,55,170,19,34,0,0
4144,429,115,486,292,12,17,6,57,177,20,34,0,0
4145,440,115,497,293,12,17,6,57,178,21,34,0,0
4146,449,118,508,299,12,17,6,59,181,22,34,0,0
4147,456,120,516,301,12,17,6,60,181,23,34,0,0
4148,461,119,521,303,12,17,6,60,184,24,34,0,0
4149,465,123,525,307,12,17,6,60,184,25,34,0,0
4150,472,121,535,314,12,17,6,63,193,26,34,0,0
4151,481,121,545,316,12,17,6,64,195,27,34,0,0
4152,488,124,553,321,12,17,6,65,197,28,34,0,0
4153,491,123,560,329,12,17,6,69,206,29,34,0,0
4154,498,125,565,330,12,17,6,67,205,30,34,0,0
4155,506,133,571,336,12,17,6,65,203,31,34,0,0
4156,518,134,584,340,12,17,6,66,206,32,34,0,0
4157,533,135,598,338,12,17,6,65,203,33,34,0,0
4158,541,136,607,342,12,17,6,66,206,34,34,1,0
4126,282,109,318,220,13,17,6,36,111,0,43,0,1
4127,290,108,327,224,13,17,6,37,116,1,43,0,0
4128,300,109,338,225,13,17,6,38,116,2,43,0,0
4129,309,108,346,222,13,17,6,37,114,3,43,0,0
4130,313,108,355,239,13,17,6,42,131,4,43,0,0
4131,319,108,363,242,13,17,6,44,134,5,43,0,0
4132,322,108,368,249,13,17,6,46,141,6,43,0,0
4133,325,109,374,256,13,17,6,49,147,7,43,0,0
4134,332,107,378,246,13,17,6,46,139,8,43,0,0
4135,338,111,384,252,13,17,6,46,141,9,43,0,0
4136,342,110,391,261,13,17,6,49,151,10,43,0,0
4137,345,110,397,271,13,17,6,52,161,11,43,0,0
4138,347,110,400,275,13,17,6,53,165,12,43,0,0
4139,350,111,403,279,13,17,6,53,168,13,43,0,0
4140,354,112,407,284,13,17,6,53,172,14,43,0,0
4141,357,114,410,287,13,17,6,53,173,15,43,0,0
4142,360,114,412,289,13,17,6,52,175,16,43,0,0
4143,363,114,419,298,13,17,6,56,184,17,43,0,0
4144,365,116,421,304,13,17,6,56,188,18,43,0,0
4145,369,114,425,305,13,17,6,56,191,19,43,0,0
4146,372,117,429,308,13,17,6,57,191,20,43,0,0
4147,378,118,435,311,13,17,6,57,193,21,43,0,0
4148,386,120,444,312,13,17,6,58,192,22,43,0,0
4149,392,120,454,323,13,17,6,62,203,23,43,0,0
4150,399,117,463,328,13,17,6,64,211,24,43,0,0
4151,410,118,474,326,13,17,6,64,208,25,43,0,0
4152,420,122,485,333,13,17,6,65,211,26,43,0,0
4153,429,124,496,341,13,17,6,67,217,27,43,0,0
4154,444,126,510,343,13,17,6,66,217,28,43,0,0
4155,456,133,521,344,13,17,6,65,211,29,43,0,0
4156,471,137,534,345,13,17,6,63,208,30,43,0,0
4157,492,136,555,345,13,17,6,63,209,31,43,0,0
4158,523,137,591,346,13,17,6,68,209,32,43,0,0
4159,536,135,612,365,13,17,6,76,230,33,43,0,0
4160,554,134,631,368,13,17,6,77,234,34,43,0,0
4161,567,138,648,376,13,17,6,81,238,35,43,0,0
4162,582,139,666,385,13,17,6,84,246,36,43,0,0
4163,616,141,692,369,13,17,6,76,228,37,43,0,0
4164,641,140,727,388,13,17,6,86,248,38,43,0,0
4165,654,141,744,391,13,17,6,90,250,39,43,0,0
4166,686,146,774,396,13,17,6,88,250,40,43,0,0
4167,705,151,792,398,13,17,6,87,247,41,43,0,0
4168,720,154,804,391,13,17,6,84,237,42,43,0,0
4169,737,156,822,394,13,17,6,85,238,43,43,1,0
4476,284,112,323,232,14,17,6,39,120,0,41,0,1
4477,295,117,334,235,14,17,6,39,118,1,41,0,0
4478,304,114,344,236,14,17,6,40,122,2,41,0,0
4479,311,110,354,240,14,17,6,43,130,3,41,0,0
4480,318,107,362,244,14,17,6,44,137,4,41,0,0
4481,325,108,370,245,14,17,6,45,137,5,41,0,0
4482,332,110,377,247,14,17,6,45,137,6,41,0,0
4483,339,112,384,249,14,17,6,45,137,7,41,0,0
4484,343,112,388,251,14,17,6,45,139,8,41,0,0
4485,344,114,391,256,14,17,6,47,142,9,41,0,0
4486,345,114,393,260,14,17,6,48,146,10,41,0,0
4487,348,115,397,265,14,17,6,49,150,11,41,0,0
4488,351,115,401,269,14,17,6,50,154,12,41,0,0
4489,351,115,403,272,14,17,6,52,157,13,41,0,0
4490,353,117,405,279,14,17,6,52,162,14,41,0,0
4491,352,119,405,281,14,17,6,53,162,15,41,0,0
4492,351,121,403,284,14,17,6,52,163,16,41,0,0
4493,352,127,405,290,14,17,6,53,163,17,41,0,0
4494,351,126,407,297,14,17,6,56,171,18,41,0,0
4495,352,129,407,301,14,17,6,55,172,19,41,0,0
4496,349,131,407,308,14,17,6,58,177,20,41,0,0
4497,350,131,408,310,14,17,6,58,179,21,41,0,0
4498,355,135,414,317,14,17,6,59,182,22,41,0,0
4499,361,136,421,323,14,17,6,60,187,23,41,0,0
4500,369,137,429,323,14,17,6,60,186,24,41,0,0
4501,380,140,442,332,14,17,6,62,192,25,41,0,0
4502,392,138,456,335,14,17,6,64,197,26,41,0,0
4503,409,141,475,338,14,17,6,66,197,27,41,0,0
4504,429,145,498,343,14,17,6,69,198,28,41,0,0
4505,450,144,518,342,14,17,6,68,198,29,41,0,0
4506,472,149,542,349,14,17,6,70,200,30,41,0,0
4507,498,148,570,351,14,17,6,72,203,31,41,0,0
4508,521,148,599,362,14,17,6,78,214,32,41,0,0
4509,551,155,627,360,14,17,6,76,205,33,41,0,0
4510,581,153,658,359,14,17,6,77,206,34,41,0,0
4511,610,156,689,367,14,17,6,79,211,35,41,0,0
4512,643,156,724,373,14,17,6,81,217,36,41,0,0
4513,671,159,756,379,14,17,6,85,220,37,41,0,0
4514,708,165,788,372,14,17,6,80,207,38,41,0,0
4515,734,162,816,373,14,17,6,82,211,39,41,0,0
4516,754,164,833,370,14,17,6,79,206,40,41,0,0
4517,776,166,855,372,14,17,6,79,206,41,41,1,0
4631,1846,882,1920,1080,15,17,6,74,198,0,0,0,0
4632,1735,822,1875,1062,16,17,6,140,240,0,0,0,0
4633,1565,750,1766,1077,17,17,6,201,327,0,0,0,0
4634,1421,682,1665,1079,18,17,6,244,397,0,30,0,1
4635,1321,648,1580,1069,18,17,6,259,421,1,30,0,0
4636,1203,599,1491,1070,18,17,6,288,471,2,30,0,0
4637,1103,547,1421,1071,18,17,6,318,524,3,30,0,0
4638,981,508,1320,1067,18,17,6,339,559,4,30,0,0
4639,893,464,1255,1072,18,17,6,362,608,5,30,0,0
4640,807,427,1182,1069,18,17,6,375,642,6,30,0,0
4641,738,400,1114,1054,18,17,6,376,654,7,30,0,0
4642,707,369,1052,990,18,17,6,345,621,8,30,0,0
4643,651,347,988,966,18,17,6,337,619,9,30,0,0
4644,609,327,933,938,18,17,6,324,611,10,30,0,0
4645,586,310,872,867,18,17,6,286,557,11,30,0,0
4646,554,297,824,837,18,17,6,270,540,12,30,0,0
4647,534,281,786,801,18,17,6,252,520,13,30,0,0
4648,505,265,741,765,18,17,6,236,500,14,30,0,0
4649,477,256,707,750,18,17,6,230,494,15,30,0,0
4650,462,249,670,703,18,17,6,208,454,16,30,0,0
4651,445,239,639,676,18,17,6,194,437,17,30,0,0
4652,430,235,611,655,18,17,6,181,420,18,30,0,0
4653,405,218,577,627,18,17,6,172,409,19,30,0,0
4654,383,219,547,614,18,17,6,164,395,20,30,0,0
4655,363,217,520,605,18,17,6,157,388,21,30,0,0
4656,349,210,491,570,18,17,6,142,360,22,30,0,0
4657,330,208,463,552,18,17,6,133,344,23,30,0,0
4658,315,202,440,532,18,17,6,125,330,24,30,0,0
4659,295,198,415,525,18,17,6,120,327,25,30,0,0
4660,274,196,391,519,18,17,6,117,323,26,30,0,0
4661,248,190,356,496,18,17,6,108,306,27,30,0,0
4662,227,187,335,500,18,17,6,108,313,28,30,0,0
4663,218,191,323,505,18,17,6,105,314,29,30,0,0
4664,194,186,297,492,18,17,6,103,306,30,30,1,0
5029,1770,928,1917,1078,19,17,6,147,150,0,0,0,0
5030,1553,825,1788,1071,20,17,6,235,246,0,0,0,0
5031,1371,742,1626,1068,21,17,6,255,326,0,0,0,0
5032,1136,643,1501,1076,22,17,6,365,433,0,55,0,1
5033,998,590,1408,1078,22,17,6,410,488,1,55,0,0
5034,888,543,1334,1079,22,17,6,446,536,2,55,0,0
5035,781,481,1270,1079,22,17,6,489,598,3,55,0,0
5036,683,437,1196,1079,22,17,6,513,642,4,55,0,0
5037,613,392,1126,1052,22,17,6,513,660,5,55,0,0
5038,547,357,1046,1019,22,17,6,499,662,6,55,0,0
5039,508,336,969,966,22,17,6,461,630,7,55,0,0
5040,479,317,897,910,22,17,6,418,593,8,55,0,0
5041,458,289,854,874,22,17,6,396,585,9,55,0,0
5042,456,268,804,803,22,17,6,348,535,10,55,0,0
5043,447,255,765,763,22,17,6,318,508,11,55,0,0
5044,435,248,722,724,22,17,6,287,476,12,55,0,0
5045,422,236,686,693,22,17,6,264,457,13,55,0,0
5046,412,229,658,671,22,17,6,246,442,14,55,0,0
5047,416,215,632,617,22,17,6,216,402,15,55,0,0
5048,414,208,614,592,22,17,6,200,384,16,55,0,0
5049,410,203,595,569,22,17,6,185,366,17,55,0,0
5050,405,189,576,541,22,17,6,171,352,18,55,0,0
5051,401,186,564,530,22,17,6,163,344,19,55,0,0
5052,407,179,555,501,22,17,6,148,322,20,55,0,0
5053,408,173,546,485,22,17,6,138,312,21,55,0,0
5054,401,172,534,478,22,17,6,133,306,22,55,0,0
5055,394,163,519,458,22,17,6,125,295,23,55,0,0
5056,390,162,507,447,22,17,6,117,285,24,55,0,0
5057,390,157,501,429,22,17,6,111,272,25,55,0,0
5058,387,156,492,417,22,17,6,105,261,26,55,0,0
5059,378,154,478,408,22,17,6,100,254,27,55,0,0
5060,370,147,468,399,22,17,6,98,252,28,55,0,0
5061,365,147,458,392,22,17,6,93,245,29,55,0,0
5062,361,142,452,386,22,17,6,91,244,30,55,0,0
5063,358,139,444,374,22,17,6,86,235,31,55,0,0
5064,352,138,434,364,22,17,6,82,226,32,55,0,0
5065,348,135,425,353,22,17,6,77,218,33,55,0,0
5066,344,136,418,347,22,17,6,74,211,34,55,0,0
5067,344,134,415,339,22,17,6,71,205,35,55,0,0
5068,342,128,412,332,22,17,6,70,204,36,55,0,0
5069,340,130,407,326,22,17,6,67,196,37,55,0,0
5070,336,126,400,318,22,17,6,64,192,38,55,0,0
5071,334,124,396,310,22,17,6,62,186,39,55,0,0
5072,335,122,395,306,22,17,6,60,184,40,55,0,0
5073,335,119,393,297,22,17,6,58,178,41,55,0,0
5074,334,120,390,294,22,17,6,56,174,42,55,0,0
5075,331,118,386,291,22,17,6,55,173,43,55,0,0
5076,329,119,382,285,22,17,6,53,166,44,55,0,0
5077,329,121,380,281,22,17,6,51,160,45,55,0,0
5078,328,116,379,276,22,17,6,51,160,46,55,0,0
5079,325,118,374,271,22,17,6,49,153,47,55,0,0
5080,320,114,369,267,22,17,6,49,153,48,55,0,0
5081,316,112,365,265,22,17,6,49,153,49,55,0,0
5082,312,111,360,263,22,17,6,48,152,50,55,0,0
5083,310,109,355,255,22,17,6,45,146,51,55,0,0
5084,305,111,349,251,22,17,6,44,140,52,55,0,0
5085,299,112,342,246,22,17,6,43,134,53,55,0,0
5086,293,109,335,239,22,17,6,42,130,54,55,0,0
5087,286,109,327,238,22,17,6,41,129,55,55,1,0
5457,781,217,818,392,23,17,6,37,175,0,0,0,0
5458,713,185,821,431,24,17,6,108,246,0,75,0,1
5459,708,191,814,432,24,17,6,106,241,1,75,0,0
5460,690,185,797,433,24,17,6,107,248,2,75,0,0
5461,650,188,756,432,24,17,6,106,244,3,75,0,0
5462,626,177,727,412,24,17,6,101,235,4,75,0,0
5463,599,180,695,406,24,17,6,96,226,5,75,0,0
5464,565,176,666,411,24,17,6,101,235,6,75,0,0
5465,540,171,641,410,24,17,6,101,239,7,75,0,0
5466,518,172,616,406,24,17,6,98,234,8,75,0,0
5467,493,170,590,405,24,17,6,97,235,9,75,0,0
5468,471,165,566,399,24,17,6,95,234,10,75,0,0
5469,447,162,542,398,24,17,6,95,236,11,75,0,0
5470,423,163,518,399,24,17,6,95,236,12,75,0,0
5471,405,160,497,396,24,17,6,92,236,13,75,0,0
5472,388,156,478,393,24,17,6,90,237,14,75,0,0
5473,374,154,460,383,24,17,6,86,229,15,75,0,0
5474,360,150,446,384,24,17,6,86,234,16,75,0,0
5475,349,150,430,374,24,17,6,81,224,17,75,0,0
5476,337,150,416,372,24,17,6,79,222,18,75,0,0
5477,329,146,404,361,24,17,6,75,215,19,75,0,0
5478,324,145,397,354,24,17,6,73,209,20,75,0,0
5479,321,144,390,345,24,17,6,69,201,21,75,0,0
5480,317,142,385,339,24,17,6,68,197,22,75,0,0
5481,315,142,381,335,24,17,6,66,193,23,75,0,0
5482,314,142,378,332,24,17,6,64,190,24,75,0,0
5483,313,141,375,328,24,17,6,62,187,25,75,0,0
5484,313,142,373,324,24,17,6,60,182,26,75,0,0
5485,314,138,372,316,24,17,6,58,178,27,75,0,0
5486,311,137,368,311,24,17,6,57,174,28,75,0,0
5487,309,135,364,307,24,17,6,55,172,29,75,0,0
5488,303,132,358,304,24,17,6,55,172,30,75,0,0
5489,299,131,355,304,24,17,6,56,173,31,75,0,0
5490,299,130,353,302,24,17,6,54,172,32,75,0,0
5491,297,128,351,299,24,17,6,54,171,33,75,0,0
5492,296,126,349,295,24,17,6,53,169,34,75,0,0
5493,290,127,343,295,24,17,6,53,168,35,75,0,0
5494,284,127,335,292,24,17,6,51,165,36,75,0,0
5495,276,127,328,291,24,17,6,52,164,37,75,0,0
5496,272,127,325,290,24,17,6,53,163,38,75,0,0
5497,270,126,323,291,24,17,6,53,165,39,75,0,0
5498,269,127,323,291,24,17,6,54,164,40,75,0,0
5499,269,127,323,291,24,17,6,54,164,41,75,0,0
5500,268,126,324,292,24,17,6,56,166,42,75,0,0
5501,268,127,324,292,24,17,6,56,165,43,75,0,0
5502,267,126,324,292,24,17,6,57,166,44,75,0,0
5503,268,126,325,292,24,17,6,57,166,45,75,0,0
5504,269,127,326,292,24,17,6,57,165,46,75,0,0
5505,271,128,328,292,24,17,6,57,164,47,75,0,0
5506,269,127,328,293,24,17,6,59,166,48,75,0,0
5507,270,127,329,293,24,17,6,59,166,49,75,0,0
5508,272,126,332,293,24,17,6,60,167,50,75,0,0
5509,282,126,339,291,24,17,6,57,165,51,75,0,0
5510,291,125,348,290,24,17,6,57,165,52,75,0,0
5511,297,123,354,291,24,17,6,57,168,53,75,0,0
5512,303,125,358,291,24,17,6,55,166,54,75,0,0
5513,310,125,363,288,24,17,6,53,163,55,75,0,0
5514,314,125,366,290,24,17,6,52,165,56,75,0,0
5515,318,125,369,288,24,17,6,51,163,57,75,0,0
5516,322,125,371,283,24,17,6,49,158,58,75,0,0
5517,326,126,374,278,24,17,6,48,152,59,75,0,0
5518,332,123,379,273,24,17,6,47,150,60,75,0,0
5519,339,122,384,269,24,17,6,45,147,61,75,0,0
5520,342,118,387,268,24,17,6,45,150,62,75,0,0
5521,343,118,388,268,24,17,6,45,150,63,75,0,0
5522,344,118,387,263,24,17,6,43,145,64,75,0,0
5523,342,116,386,264,24,17,6,44,148,65,75,0,0
5524,342,115,386,264,24,17,6,44,149,66,75,0,0
5525,341,114,385,262,24,17,6,44,148,67,75,0,0
5526,342,113,384,256,24,17,6,42,143,68,75,0,0
5527,342,114,383,253,24,17,6,41,139,69,75,0,0
5528,340,112,380,251,24,17,6,40,139,70,75,0,0
5529,338,111,378,247,24,17,6,40,136,71,75,0,0
5530,338,110,376,241,24,17,6,38,131,72,75,0,0
5531,338,109,377,240,24,17,6,39,131,73,75,0,0
5532,337,108,376,239,24,17,6,39,131,74,75,0,0
5533,338,107,376,236,24,17,6,38,129,75,75,1,0
5547,334,104,369,218,24,17,6,35,114,0,75,0,0
5554,315,109,351,220,24,17,6,36,111,0,75,0,0
5555,316,109,353,222,24,17,6,37,113,1,75,0,0
5556,320,111,356,222,24,17,6,36,111,2,75,0,0
5557,321,109,359,224,24,17,6,38,115,3,75,0,0
5558,322,109,360,226,24,17,6,38,117,4,75,0,0
5559,324,107,363,229,24,17,6,39,122,5,75,0,0
5560,327,110,366,230,24,17,6,39,120,6,75,0,0
5561,333,112,372,233,24,17,6,39,121,7,75,0,0
5562,337,112,376,233,24,17,6,39,121,8,75,0,0
5563,341,112,379,232,24,17,6,38,120,9,75,0,0
5564,344,111,382,230,24,17,6,38,119,10,75,0,0
5565,346,111,384,230,24,17,6,38,119,11,75,0,0
5460,780,155,819,376,25,17,6,39,221,0,67,0,0
5461,761,155,805,400,25,17,6,44,245,1,67,0,0
5462,747,153,793,401,25,17,6,46,248,2,67,0,0
5463,730,147,775,387,25,17,6,45,240,3,67,0,0
5464,712,151,759,392,25,17,6,47,241,4,67,0,0
5465,695,150,743,389,25,17,6,48,239,5,67,0,0
5466,682,149,730,394,25,17,6,48,245,6,67,0,0
5473,620,138,664,366,25,17,6,44,228,0,67,0,1
5474,610,137,653,360,25,17,6,43,223,1,67,0,0
5475,600,137,643,349,25,17,6,43,212,2,67,0,0
5476,595,134,640,349,25,17,6,45,215,3,67,0,0
5477,593,132,641,349,25,17,6,48,217,4,67,0,0
5478,593,132,642,347,25,17,6,49,215,5,67,0,0
5479,593,133,643,344,25,17,6,50,211,6,67,0,0
5480,593,131,644,338,25,17,6,51,207,7,67,0,0
5481,593,131,645,335,25,17,6,52,204,8,67,0,0
5482,594,137,647,336,25,17,6,53,199,9,67,0,0
5483,594,138,649,339,25,17,6,55,201,10,67,0,0
5484,597,140,651,337,25,17,6,54,197,11,67,0,0
5485,598,138,654,336,25,17,6,56,198,12,67,0,0
5486,596,136,654,338,25,17,6,58,202,13,67,0,0
5487,596,135,655,339,25,17,6,59,204,14,67,0,0
5488,595,135,654,336,25,17,6,59,201,15,67,0,0
5489,594,135,654,339,25,17,6,60,204,16,67,0,0
5490,596,136,655,336,25,17,6,59,200,17,67,0,0
5491,599,140,659,344,25,17,6,60,204,18,67,0,0
5492,602,142,662,349,25,17,6,60,207,19,67,0,0
5493,600,140,659,344,25,17,6,59,204,20,67,0,0
5494,599,140,658,342,25,17,6,59,202,21,67,0,0
5495,601,140,659,340,25,17,6,58,200,22,67,0,0
5496,598,139,660,347,25,17,6,62,208,23,67,0,0
5497,600,139,663,351,25,17,6,63,212,24,67,0,0
5498,596,138,661,352,25,17,6,65,214,25,67,0,0
5499,595,138,658,346,25,17,6,63,208,26,67,0,0
5500,592,136,656,343,25,17,6,64,207,27,67,0,0
5501,591,137,658,349,25,17,6,67,212,28,67,0,0
5502,595,139,663,349,25,17,6,68,210,29,67,0,0
5503,589,139,659,358,25,17,6,70,219,30,67,0,0
5504,579,140,654,369,25,17,6,75,229,31,67,0,0
5505,569,144,646,373,25,17,6,77,229,32,67,0,0
5506,555,141,636,379,25,17,6,81,238,33,67,0,0
5507,539,139,624,382,25,17,6,85,243,34,67,0,0
5508,532,146,617,386,25,17,6,85,240,35,67,0,0
5509,528,147,614,391,25,17,6,86,244,36,67,0,0
5510,517,148,604,392,25,17,6,87,244,37,67,0,0
5511,503,153,595,412,25,17,6,92,259,38,67,0,0
5512,486,154,582,423,25,17,6,96,269,39,67,0,0
5513,474,155,572,430,25,17,6,98,275,40,67,0,0
5514,464,159,565,448,25,17,6,101,289,41,67,0,0
5515,457,161,559,457,25,17,6,102,296,42,67,0,0
5516,448,162,553,467,25,17,6,105,305,43,67,0,0
5517,438,170,545,481,25,17,6,107,311,44,67,0,0
5518,420,174,532,500,25,17,6,112,326,45,67,0,0
5519,407,176,522,514,25,17,6,115,338,46,67,0,0
5520,396,183,519,546,25,17,6,123,363,47,67,0,0
5521,392,186,514,548,25,17,6,122,362,48,67,0,0
5522,386,194,512,562,25,17,6,126,368,49,67,0,0
5523,375,205,505,585,25,17,6,130,380,50,67,0,0
5524,354,210,494,612,25,17,6,140,402,51,67,0,0
5525,336,217,484,632,25,17,6,148,415,52,67,0,0
5526,317,221,480,662,25,17,6,163,441,53,67,0,0
5527,301,229,474,676,25,17,6,173,447,54,67,0,0
5528,283,240,472,707,25,17,6,189,467,55,67,0,0
5529,265,244,467,732,25,17,6,202,488,56,67,0,0
5530,257,246,465,742,25,17,6,208,496,57,67,0,0
5531,253,255,467,764,25,17,6,214,509,58,67,0,0
5532,284,262,494,776,25,17,6,210,514,59,67,0,0
5533,277,261,486,780,25,17,6,209,519,60,67,0,0
5534,269,264,474,777,25,17,6,205,513,61,67,0,0
5535,266,270,466,779,25,17,6,200,509,62,67,0,0
5536,253,272,454,784,25,17,6,201,512,63,67,0,0
5537,232,263,424,756,25,17,6,192,493,64,67,0,0
5538,207,256,382,720,25,17,6,175,464,65,67,0,0
5539,211,306,344,670,25,17,6,133,364,66,67,0,0
5540,201,314,331,667,25,17,6,130,353,67,67,1,0
5463,760,169,822,375,26,17,6,62,206,0,229,0,1
5464,745,166,814,396,26,17,6,69,230,1,229,0,0
5465,726,164,796,394,26,17,6,70,230,2,229,0,0
5466,701,156,776,398,26,17,6,75,242,3,229,0,0
5467,677,152,755,400,26,17,6,78,248,4,229,0,0
5468,658,144,739,402,26,17,6,81,258,5,229,0,0
5469,643,147,721,392,26,17,6,78,245,6,229,0,0
5470,639,151,714,385,26,17,6,75,234,7,229,0,0
5471,630,145,710,394,26,17,6,80,249,8,229,0,0
5472,625,143,707,396,26,17,6,82,253,9,229,0,0
5473,626,149,705,394,26,17,6,79,245,10,229,0,0
5474,628,151,705,393,26,17,6,77,242,11,229,0,0
5475,630,154,707,395,26,17,6,77,241,12,229,0,0
5476,631,155,708,395,26,17,6,77,240,13,229,0,0
5477,633,154,710,395,26,17,6,77,241,14,229,0,0
5478,633,154,710,395,26,17,6,77,241,15,229,0,0
5479,633,154,710,396,26,17,6,77,242,16,229,0,0
5480,633,155,710,395,26,17,6,77,240,17,229,0,0
5481,633,156,711,395,26,17,6,78,239,18,229,0,0
5482,632,155,711,396,26,17,6,79,241,19,229,0,0
5483,631,155,710,396,26,17,6,79,241,20,229,0,0
5484,632,155,711,396,26,17,6,79,241,21,229,0,0
5485,633,156,712,396,26,17,6,79,240,22,229,0,0
5486,633,157,713,397,26,17,6,80,240,23,229,0,0
5487,632,158,710,392,26,17,6,78,234,24,229,0,0
5488,632,158,713,395,26,17,6,81,237,25,229,0,0
5489,633,158,714,396,26,17,6,81,238,26,229,0,0
5490,633,158,714,396,26,17,6,81,238,27,229,0,0
5491,633,157,714,395,26,17,6,81,238,28,229,0,0
5492,631,155,714,395,26,17,6,83,240,29,229,0,0
5493,631,156,713,395,26,17,6,82,239,30,229,0,0
5494,631,156,714,395,26,17,6,83,239,31,229,0,0
5495,632,158,713,394,26,17,6,81,236,32,229,0,0
5496,628,156,711,393,26,17,6,83,237,33,229,0,0
5497,627,155,711,393,26,17,6,84,238,34,229,0,0
5498,629,155,712,395,26,17,6,83,240,35,229,0,0
5499,630,152,715,397,26,17,6,85,245,36,229,0,0
5500,630,150,716,397,26,17,6,86,247,37,229,0,0
5501,628,151,713,395,26,17,6,85,244,38,229,0,0
5502,628,153,712,395,26,17,6,84,242,39,229,0,0
5503,630,151,714,397,26,17,6,84,246,40,229,0,0
5504,633,154,716,397,26,17,6,83,243,41,229,0,0
5505,632,152,716,398,26,17,6,84,246,42,229,0,0
5506,630,155,714,398,26,17,6,84,243,43,229,0,0
5507,630,154,714,397,26,17,6,84,243,44,229,0,0
5508,635,158,716,394,26,17,6,81,236,45,229,0,0
5509,635,158,718,395,26,17,6,83,237,46,229,0,0
5510,638,161,720,395,26,17,6,82,234,47,229,0,0
5511,637,159,720,395,26,17,6,83,236,48,229,0,0
5512,637,160,720,395,26,17,6,83,235,49,229,0,0
5513,637,160,720,396,26,17,6,83,236,50,229,0,0
5514,637,160,720,396,26,17,6,83,236,51,229,0,0
5515,637,160,720,397,26,17,6,83,237,52,229,0,0
5516,636,160,719,397,26,17,6,83,237,53,229,0,0
5517,637,158,721,398,26,17,6,84,240,54,229,0,0
5518,637,157,721,398,26,17,6,84,241,55,229,0,0
5519,637,157,721,398,26,17,6,84,241,56,229,0,0
5520,636,157,721,398,26,17,6,85,241,57,229,0,0
5521,635,154,719,397,26,17,6,84,243,58,229,0,0
5522,633,153,717,397,26,17,6,84,244,59,229,0,0
5523,632,153,717,397,26,17,6,85,244,60,229,0,0
5524,632,153,717,398,26,17,6,85,245,61,229,0,0
5525,628,153,713,396,26,17,6,85,243,62,229,0,0
5526,618,153,703,397,26,17,6,85,244,63,229,0,0
5527,608,155,692,394,26,17,6,84,239,64,229,0,0
5528,594,154,674,388,26,17,6,80,234,65,229,0,0
5529,585,156,664,388,26,17,6,79,232,66,229,0,0
5530,565,157,645,383,26,17,6,80,226,67,229,0,0
5531,546,157,629,384,26,17,6,83,227,68,229,0,0
5532,539,157,621,379,26,17,6,82,222,69,229,0,0
5533,520,153,603,373,26,17,6,83,220,70,229,0,0
5534,497,147,582,373,26,17,6,85,226,71,229,0,0
5535,480,148,567,375,26,17,6,87,227,72,229,0,0
5536,466,146,556,378,26,17,6,90,232,73,229,0,0
5537,452,144,540,372,26,17,6,88,228,74,229,0,0
5538,435,144,522,373,26,17,6,87,229,75,229,0,0
5539,419,143,506,371,26,17,6,87,228,76,229,0,0
5540,408,143,494,368,26,17,6,86,225,77,229,0,0
5541,399,142,481,359,26,17,6,82,217,78,229,0,0
5542,389,142,468,353,26,17,6,79,211,79,229,0,0
5543,378,140,458,358,26,17,6,80,218,80,229,0,0
5544,370,139,449,355,26,17,6,79,216,81,229,0,0
5545,364,142,437,341,26,17,6,73,199,82,229,0,0
5546,354,142,429,344,26,17,6,75,202,83,229,0,0
5547,346,146,421,347,26,17,6,75,201,84,229,0,0
5548,340,144,414,346,26,17,6,74,202,85,229,0,0
5549,336,145,409,346,26,17,6,73,201,86,229,0,0
5550,331,142,404,343,26,17,6,73,201,87,229,0,0
5551,331,140,404,342,26,17,6,73,202,88,229,0,0
5552,333,133,408,343,26,17,6,75,210,89,229,0,0
5553,335,134,408,342,26,17,6,73,208,90,229,0,0
5554,337,135,409,343,26,17,6,72,208,91,229,0,0
5555,340,135,411,340,26,17,6,71,205,92,229,0,0
5556,343,137,414,341,26,17,6,71,204,93,229,0,0
5557,344,138,415,343,26,17,6,71,205,94,229,0,0
5558,346,138,415,342,26,17,6,69,204,95,229,0,0
5559,347,138,416,343,26,17,6,69,205,96,229,0,0
5560,347,137,417,344,26,17,6,70,207,97,229,0,0
5561,348,137,418,345,26,17,6,70,208,98,229,0,0
5562,350,137,419,345,26,17,6,69,208,99,229,0,0
5563,352,138,420,343,26,17,6,68,205,100,229,0,0
5564,352,138,421,343,26,17,6,69,205,101,229,0,0
5565,353,137,422,343,26,17,6,69,206,102,229,0,0
5566,353,134,422,342,26,17,6,69,208,103,229,0,0
5567,353,135,422,343,26,17,6,69,208,104,229,0,0
5568,353,131,423,343,26,17,6,70,212,105,229,0,0
5569,354,131,423,344,26,17,6,69,213,106,229,0,0
5570,354,126,424,343,26,17,6,70,217,107,229,0,0
5571,355,125,424,343,26,17,6,69,218,108,229,0,0
5572,357,130,424,343,26,17,6,67,213,109,229,0,0
5573,357,132,424,343,26,17,6,67,211,110,229,0,0
5574,357,130,424,344,26,17,6,67,214,111,229,0,0
5575,357,129,425,344,26,17,6,68,215,112,229,0,0
5576,357,129,424,342,26,17,6,67,213,113,229,0,0
5577,358,131,423,342,26,17,6,65,211,114,229,0,0
5578,358,131,424,343,26,17,6,66,212,115,229,0,0
5579,359,131,425,343,26,17,6,66,212,116,229,0,0
5580,358,131,424,341,26,17,6,66,210,117,229,0,0
5581,358,129,425,342,26,17,6,67,213,118,229,0,0
5582,358,129,425,343,26,17,6,67,214,119,229,0,0
5583,359,129,425,344,26,17,6,66,215,120,229,0,0
5584,359,132,424,342,26,17,6,65,210,121,229,0,0
5585,358,133,423,342,26,17,6,65,209,122,229,0,0
5586,359,134,424,343,26,17,6,65,209,123,229,0,0
5587,359,134,424,345,26,17,6,65,211,124,229,0,0
5588,358,134,423,343,26,17,6,65,209,125,229,0,0
5589,357,134,422,345,26,17,6,65,211,126,229,0,0
5590,357,134,423,346,26,17,6,66,212,127,229,0,0
5591,356,134,423,346,26,17,6,67,212,128,229,0,0
5592,356,134,423,346,26,17,6,67,212,129,229,0,0
5593,357,132,423,344,26,17,6,66,212,130,229,0,0
5594,357,132,423,343,26,17,6,66,211,131,229,0,0
5595,356,134,422,343,26,17,6,66,209,132,229,0,0
5596,357,134,422,343,26,17,6,65,209,133,229,0,0
5597,356,134,422,343,26,17,6,66,209,134,229,0,0
5598,356,134,423,343,26,17,6,67,209,135,229,0,0
5599,356,134,423,343,26,17,6,67,209,136,229,0,0
5600,355,133,422,343,26,17,6,67,210,137,229,0,0
5601,354,133,422,345,26,17,6,68,212,138,229,0,0
5602,353,133,421,345,26,17,6,68,212,139,229,0,0
5603,351,132,419,344,26,17,6,68,212,140,229,0,0
5604,350,135,417,336,26,17,6,67,201,141,229,0,0
5605,345,134,413,336,26,17,6,68,202,142,229,0,0
5606,342,135,414,341,26,17,6,72,206,143,229,0,0
5607,346,141,417,345,26,17,6,71,204,144,229,0,0
5608,351,141,421,345,26,17,6,70,204,145,229,0,0
5609,353,142,422,342,26,17,6,69,200,146,229,0,0
5610,353,139,421,337,26,17,6,68,198,147,229,0,0
5611,354,138,421,335,26,17,6,67,197,148,229,0,0
5612,355,138,421,334,26,17,6,66,196,149,229,0,0
5613,355,138,419,332,26,17,6,64,194,150,229,0,0
5614,354,138,418,333,26,17,6,64,195,151,229,0,0
5615,353,136,416,333,26,17,6,63,197,152,229,0,0
5616,350,136,413,334,26,17,6,63,198,153,229,0,0
5617,348,135,410,332,26,17,6,62,197,154,229,0,0
5618,347,135,408,330,26,17,6,61,195,155,229,0,0
5619,344,133,404,325,26,17,6,60,192,156,229,0,0
5620,341,133,399,321,26,17,6,58,188,157,229,0,0
5621,336,129,395,319,26,17,6,59,190,158,229,0,0
5622,333,126,391,316,26,17,6,58,190,159,229,0,0
5623,330,124,387,311,26,17,6,57,187,160,229,0,0
5624,329,124,385,308,26,17,6,56,184,161,229,0,0
5625,331,125,385,304,26,17,6,54,179,162,229,0,0
5626,334,123,388,301,26,17,6,54,178,163,229,0,0
5627,336,121,390,298,26,17,6,54,177,164,229,0,0
5628,334,121,387,295,26,17,6,53,174,165,229,0,0
5629,330,122,383,294,26,17,6,53,172,166,229,0,0
5630,326,119,379,294,26,17,6,53,175,167,229,0,0
5631,322,118,375,294,26,17,6,53,176,168,229,0,0
5632,321,123,372,292,26,17,6,51,169,169,229,0,0
5633,320,128,369,291,26,17,6,49,163,170,229,0,0
5634,320,131,368,293,26,17,6,48,162,171,229,0,0
5635,324,136,369,288,26,17,6,45,152,172,229,0,0
5636,327,138,370,286,26,17,6,43,148,173,229,0,0
5637,328,139,370,284,26,17,6,42,145,174,229,0,0
5638,327,136,370,285,26,17,6,43,149,175,229,0,0
5639,329,138,371,281,26,17,6,42,143,176,229,0,0
5640,329,132,372,283,26,17,6,43,151,177,229,0,0
5641,330,128,375,284,26,17,6,45,156,178,229,0,0
5642,333,126,379,283,26,17,6,46,157,179,229,0,0
5643,334,124,381,283,26,17,6,47,159,180,229,0,0
5644,333,127,379,286,26,17,6,46,159,181,229,0,0
5645,333,128,379,288,26,17,6,46,160,182,229,0,0
5646,332,126,379,289,26,17,6,47,163,183,229,0,0
5647,332,125,379,291,26,17,6,47,166,184,229,0,0
5648,333,124,380,289,26,17,6,47,165,185,229,0,0
5649,335,125,383,291,26,17,6,48,166,186,229,0,0
5650,336,119,388,295,26,17,6,52,176,187,229,0,0
5651,340,122,392,292,26,17,6,52,170,188,229,0,0
5652,346,125,399,294,26,17,6,53,169,189,229,0,0
5653,353,125,405,289,26,17,6,52,164,190,229,0,0
5654,357,127,409,289,26,17,6,52,162,191,229,0,0
5655,358,127,411,289,26,17,6,53,162,192,229,0,0
5656,358,127,411,289,26,17,6,53,162,193,229,0,0
5657,358,127,411,289,26,17,6,53,162,194,229,0,0
5658,358,129,411,287,26,17,6,53,158,195,229,0,0
5659,358,129,412,289,26,17,6,54,160,196,229,0,0
5660,358,128,412,289,26,17,6,54,161,197,229,0,0
5661,356,126,412,289,26,17,6,56,163,198,229,0,0
5662,356,127,412,290,26,17,6,56,163,199,229,0,0
5663,355,127,411,290,26,17,6,56,163,200,229,0,0
5664,355,127,411,290,26,17,6,56,163,201,229,0,0
5665,355,125,412,290,26,17,6,57,165,202,229,0,0
5666,355,126,412,291,26,17,6,57,165,203,229,0,0
5667,355,126,412,291,26,17,6,57,165,204,229,0,0
5668,355,126,413,291,26,17,6,58,165,205,229,0,0
5669,355,125,414,291,26,17,6,59,166,206,229,0,0
5670,355,125,413,291,26,17,6,58,166,207,229,0,0
5671,355,126,412,289,26,17,6,57,163,208,229,0,0
5672,353,123,413,291,26,17,6,60,168,209,229,0,0
5673,352,123,412,291,26,17,6,60,168,210,229,0,0
5674,352,126,410,288,26,17,6,58,162,211,229,0,0
5675,350,122,410,290,26,17,6,60,168,212,229,0,0
5676,349,120,410,291,26,17,6,61,171,213,229,0,0
5677,349,121,409,291,26,17,6,60,170,214,229,0,0
5678,350,122,410,292,26,17,6,60,170,215,229,0,0
5679,352,123,412,291,26,17,6,60,168,216,229,0,0
5680,354,124,413,291,26,17,6,59,167,217,229,0,0
5681,355,124,415,291,26,17,6,60,167,218,229,0,0
5682,355,123,416,292,26,17,6,61,169,219,229,0,0
5683,356,123,416,291,26,17,6,60,168,220,229,0,0
5684,356,123,416,291,26,17,6,60,168,221,229,0,0
5685,356,123,416,291,26,17,6,60,168,222,229,0,0
5686,356,123,416,291,26,17,6,60,168,223,229,0,0
5687,356,123,416,291,26,17,6,60,168,224,229,0,0
5688,356,123,416,291,26,17,6,60,168,225,229,0,0
5689,356,125,416,291,26,17,6,60,166,226,229,0,0
5690,357,126,416,291,26,17,6,59,165,227,229,0,0
5691,360,124,418,289,26,17,6,58,165,228,229,0,0
5692,360,124,419,288,26,17,6,59,164,229,229,1,0
5698,369,126,423,287,26,17,6,54,161,0,229,0,1
5699,365,127,418,288,26,17,6,53,161,1,229,0,0
5700,363,130,416,290,26,17,6,53,160,2,229,0,0
5701,363,133,415,289,26,17,6,52,156,3,229,0,0
5702,360,127,415,291,26,17,6,55,164,4,229,0,0
5703,358,123,414,294,26,17,6,56,171,5,229,0,0
5704,356,123,412,295,26,17,6,56,172,6,229,0,0
5705,357,129,413,298,26,17,6,56,169,7,229,0,0
5706,361,134,415,301,26,17,6,54,167,8,229,0,0
5707,364,137,419,304,26,17,6,55,167,9,229,0,0
5708,368,134,425,307,26,17,6,57,173,10,229,0,0
5709,370,133,429,315,26,17,6,59,182,11,229,0,0
5710,372,128,434,323,26,17,6,62,195,12,229,0,0
5711,375,131,436,322,26,17,6,61,191,13,229,0,0
5712,377,134,439,328,26,17,6,62,194,14,229,0,0
5713,381,136,441,329,26,17,6,60,193,15,229,0,0
5714,384,133,446,332,26,17,6,62,199,16,229,0,0
5715,387,134,449,336,26,17,6,62,202,17,229,0,0
5716,388,137,452,340,26,17,6,64,203,18,229,0,0
5717,385,136,451,346,26,17,6,66,210,19,229,0,0
5718,387,131,455,347,26,17,6,68,216,20,229,0,0
5719,389,134,459,357,26,17,6,70,223,21,229,0,0
5720,390,138,462,361,26,17,6,72,223,22,229,0,0
5721,390,140,462,367,26,17,6,72,227,23,229,0,0
5722,390,141,463,371,26,17,6,73,230,24,229,0,0
5723,388,144,462,378,26,17,6,74,234,25,229,0,0
5724,387,145,463,383,26,17,6,76,238,26,229,0,0
5725,389,147,465,385,26,17,6,76,238,27,229,0,0
5726,393,152,469,393,26,17,6,76,241,28,229,0,0
5727,401,152,480,403,26,17,6,79,251,29,229,0,0
5728,405,155,485,405,26,17,6,80,250,30,229,0,0
5729,405,159,488,414,26,17,6,83,255,31,229,0,0
5730,404,161,492,432,26,17,6,88,271,32,229,0,0
5731,407,163,495,435,26,17,6,88,272,33,229,0,0
5732,407,169,500,454,26,17,6,93,285,34,229,0,0
5733,407,170,503,464,26,17,6,96,294,35,229,0,0
5734,409,174,506,470,26,17,6,97,296,36,229,0,0
5735,406,183,507,491,26,17,6,101,308,37,229,0,0
5736,404,186,509,503,26,17,6,105,317,38,229,0,0
5737,405,188,511,511,26,17,6,106,323,39,229,0,0
5738,409,197,519,532,26,17,6,110,335,40,229,0,0
5739,414,201,526,543,26,17,6,112,342,41,229,0,0
5740,419,206,535,561,26,17,6,116,355,42,229,0,0
5741,415,215,537,589,26,17,6,122,374,43,229,0,0
5742,411,214,536,599,26,17,6,125,385,44,229,0,0
5743,403,221,530,609,26,17,6,127,388,45,229,0,0
5744,389,231,528,641,26,17,6,139,410,46,229,0,0
5745,369,236,520,659,26,17,6,151,423,47,229,0,0
5746,344,240,509,682,26,17,6,165,442,48,229,0,0
5747,312,251,492,709,26,17,6,180,458,49,229,0,0
5748,291,259,484,718,26,17,6,193,459,50,229,0,0
5749,284,263,490,724,26,17,6,206,461,51,229,0,0
5750,280,270,498,742,26,17,6,218,472,52,229,0,0
5751,286,265,512,754,26,17,6,226,489,53,229,0,0
5752,319,268,538,752,26,17,6,219,484,54,229,0,0
5753,331,283,535,743,26,17,6,204,460,55,229,0,0
5754,306,287,512,748,26,17,6,206,461,56,229,0,0
5755,299,294,502,753,26,17,6,203,459,57,229,0,0
5756,269,281,463,727,26,17,6,194,446,58,229,0,0
5757,238,275,428,721,26,17,6,190,446,59,229,0,0
5758,222,279,404,713,26,17,6,182,434,60,229,0,0
5759,211,282,394,716,26,17,6,183,434,61,229,0,0
5494,264,155,306,293,27,17,6,42,138,0,0,0,0
5607,329,141,379,321,29,17,6,50,180,0,77,0,1
5608,323,137,374,322,29,17,6,51,185,1,77,0,0
5609,318,137,369,323,29,17,6,51,186,2,77,0,0
5610,315,137,366,323,29,17,6,51,186,3,77,0,0
5611,312,137,362,317,29,17,6,50,180,4,77,0,0
5612,309,137,359,315,29,17,6,50,178,5,77,0,0
5613,305,137,356,315,29,17,6,51,178,6,77,0,0
5614,299,137,352,319,29,17,6,53,182,7,77,0,0
5615,296,137,349,319,29,17,6,53,182,8,77,0,0
5616,290,139,343,319,29,17,6,53,180,9,77,0,0
5617,283,142,335,319,29,17,6,52,177,10,77,0,0
5618,274,138,329,323,29,17,6,55,185,11,77,0,0
5619,271,138,324,316,29,17,6,53,178,12,77,0,0
5620,274,137,326,314,29,17,6,52,177,13,77,0,0
5621,277,138,329,317,29,17,6,52,179,14,77,0,0
5622,278,138,330,317,29,17,6,52,179,15,77,0,0
5623,275,139,328,315,29,17,6,53,176,16,77,0,0
5624,272,139,324,315,29,17,6,52,176,17,77,0,0
5625,270,140,322,313,29,17,6,52,173,18,77,0,0
5626,269,140,321,313,29,17,6,52,173,19,77,0,0
5627,268,141,320,314,29,17,6,52,173,20,77,0,0
5628,267,139,320,317,29,17,6,53,178,21,77,0,0
5629,267,139,320,317,29,17,6,53,178,22,77,0,0
5630,268,135,323,317,29,17,6,55,182,23,77,0,0
5631,270,137,325,315,29,17,6,55,178,24,77,0,0
5632,278,134,332,309,29,17,6,54,175,25,77,0,0
5633,285,133,339,306,29,17,6,54,173,26,77,0,0
5634,288,132,343,307,29,17,6,55,175,27,77,0,0
5635,293,135,347,307,29,17,6,54,172,28,77,0,0
5636,294,137,349,308,29,17,6,55,171,29,77,0,0
5637,293,137,349,308,29,17,6,56,171,30,77,0,0
5638,293,134,350,308,29,17,6,57,174,31,77,0,0
5639,290,128,349,311,29,17,6,59,183,32,77,0,0
5640,290,127,350,309,29,17,6,60,182,33,77,0,0
5641,290,131,347,307,29,17,6,57,176,34,77,0,0
5642,290,135,345,306,29,17,6,55,171,35,77,0,0
5643,290,136,345,308,29,17,6,55,172,36,77,0,0
5644,290,137,345,307,29,17,6,55,170,37,77,0,0
5645,290,138,345,308,29,17,6,55,170,38,77,0,0
5646,291,138,346,308,29,17,6,55,170,39,77,0,0
5647,291,139,345,308,29,17,6,54,169,40,77,0,0
5648,291,138,346,308,29,17,6,55,170,41,77,0,0
5649,291,138,346,308,29,17,6,55,170,42,77,0,0
5650,292,137,346,308,29,17,6,54,171,43,77,0,0
5651,292,137,347,308,29,17,6,55,171,44,77,0,0
5652,292,135,347,308,29,17,6,55,173,45,77,0,0
5653,292,135,347,308,29,17,6,55,173,46,77,0,0
5654,291,133,347,308,29,17,6,56,175,47,77,0,0
5655,293,134,348,310,29,17,6,55,176,48,77,0,0
5656,293,129,349,308,29,17,6,56,179,49,77,0,0
5657,291,131,346,309,29,17,6,55,178,50,77,0,0
5658,290,134,344,313,29,17,6,54,179,51,77,0,0
5659,287,136,341,317,29,17,6,54,181,52,77,0,0
5660,279,137,333,316,29,17,6,54,179,53,77,0,0
5661,271,134,324,310,29,17,6,53,176,54,77,0,0
5662,264,136,318,316,29,17,6,54,180,55,77,0,0
5663,261,134,312,313,29,17,6,51,179,56,77,0,0
5664,256,132,308,317,29,17,6,52,185,57,77,0,0
5665,253,130,304,317,29,17,6,51,187,58,77,0,0
5666,253,132,303,317,29,17,6,50,185,59,77,0,0
5667,255,131,304,316,29,17,6,49,185,60,77,0,0
5668,259,129,307,310,29,17,6,48,181,61,77,0,0
5669,263,130,311,308,29,17,6,48,178,62,77,0,0
5670,267,130,314,303,29,17,6,47,173,63,77,0,0
5671,269,129,316,300,29,17,6,47,171,64,77,0,0
5672,271,129,318,298,29,17,6,47,169,65,77,0,0
5673,271,129,319,297,29,17,6,48,168,66,77,0,0
5674,271,128,320,297,29,17,6,49,169,67,77,0,0
5675,271,128,320,297,29,17,6,49,169,68,77,0,0
5676,270,128,321,296,29,17,6,51,168,69,77,0,0
5677,270,129,321,297,29,17,6,51,168,70,77,0,0
5678,269,131,320,299,29,17,6,51,168,71,77,0,0
5679,265,129,316,299,29,17,6,51,170,72,77,0,0
5680,262,129,313,301,29,17,6,51,172,73,77,0,0
5681,259,130,310,300,29,17,6,51,170,74,77,0,0
5682,256,131,305,299,29,17,6,49,168,75,77,0,0
5683,254,134,302,299,29,17,6,48,165,76,77,0,0
5684,253,134,300,298,29,17,6,47,164,77,77,1,0
5688,255,132,303,301,29,17,6,48,169,0,77,0,0
5689,255,132,302,301,29,17,6,47,169,1,77,0,0
5714,318,103,356,217,29,17,6,38,114,0,77,0,0
5715,333,100,374,220,29,17,6,41,120,1,77,0,0
5716,351,100,392,221,29,17,6,41,121,2,77,0,0
5717,361,99,402,220,29,17,6,41,121,3,77,0,0
5720,440,104,476,206,29,17,6,36,102,0,77,0,0
5617,264,163,300,312,30,17,6,36,149,0,0,0,0
5691,232,260,340,683,31,17,6,108,423,0,276,0,1
5692,245,248,365,717,31,17,6,120,469,1,276,0,0
5693,273,262,394,726,31,17,6,121,464,2,276,0,0
5694,316,274,443,748,31,17,6,127,474,3,276,0,0
5695,380,267,508,732,31,17,6,128,465,4,276,0,0
5696,430,253,562,715,31,17,6,132,462,5,276,0,0
5697,462,246,598,715,31,17,6,136,469,6,276,0,0
5698,485,229,621,691,31,17,6,136,462,7,276,0,0
5699,499,224,633,673,31,17,6,134,449,8,276,0,0
5700,512,223,640,650,31,17,6,128,427,9,276,0,0
5701,525,212,644,604,31,17,6,119,392,10,276,0,0
5702,526,206,643,586,31,17,6,117,380,11,276,0,0
5703,526,197,642,574,31,17,6,116,377,12,276,0,0
5704,525,184,638,544,31,17,6,113,360,13,276,0,0
5705,522,182,632,532,31,17,6,110,350,14,276,0,0
5706,521,175,629,515,31,17,6,108,340,15,276,0,0
5707,522,166,626,489,31,17,6,104,323,16,276,0,0
5708,517,167,617,476,31,17,6,100,309,17,276,0,0
5709,509,161,607,458,31,17,6,98,297,18,276,0,0
5710,503,158,598,444,31,17,6,95,286,19,276,0,0
5711,498,158,593,440,31,17,6,95,282,20,276,0,0
5712,497,154,587,422,31,17,6,90,268,21,276,0,0
5713,493,152,581,409,31,17,6,88,257,22,276,0,0
5714,481,153,567,404,31,17,6,86,251,23,276,0,0
5715,468,146,553,391,31,17,6,85,245,24,276,0,0
5716,458,140,544,385,31,17,6,86,245,25,276,0,0
5717,462,140,544,375,31,17,6,82,235,26,276,0,0
5718,463,137,544,368,31,17,6,81,231,27,276,0,0
5719,463,134,544,364,31,17,6,81,230,28,276,0,0
5720,463,133,543,362,31,17,6,80,229,29,276,0,0
5721,461,132,541,363,31,17,6,80,231,30,276,0,0
5722,464,130,543,360,31,17,6,79,230,31,276,0,0
5723,469,132,543,349,31,17,6,74,217,32,276,0,0
5724,474,132,546,343,31,17,6,72,211,33,276,0,0
5725,481,130,551,337,31,17,6,70,207,34,276,0,0
5726,483,130,554,337,31,17,6,71,207,35,276,0,0
5727,486,130,556,339,31,17,6,70,209,36,276,0,0
5728,487,130,558,341,31,17,6,71,211,37,276,0,0
5729,487,131,559,342,31,17,6,72,211,38,276,0,0
5730,487,131,559,342,31,17,6,72,211,39,276,0,0
5731,488,130,560,342,31,17,6,72,212,40,276,0,0
5732,489,131,561,343,31,17,6,72,212,41,276,0,0
5733,489,131,562,344,31,17,6,73,213,42,276,0,0
5734,489,132,561,344,31,17,6,72,212,43,276,0,0
5735,489,133,561,344,31,17,6,72,211,44,276,0,0
5736,489,132,561,343,31,17,6,72,211,45,276,0,0
5737,489,132,562,345,31,17,6,73,213,46,276,0,0
5738,491,132,564,346,31,17,6,73,214,47,276,0,0
5739,493,134,567,351,31,17,6,74,217,48,276,0,0
5740,492,133,570,363,31,17,6,78,230,49,276,0,0
5741,492,134,571,370,31,17,6,79,236,50,276,0,0
5742,494,133,567,352,31,17,6,73,219,51,276,0,0
5743,490,135,566,362,31,17,6,76,227,52,276,0,0
5744,490,135,562,348,31,17,6,72,213,53,276,0,0
5745,488,135,560,348,31,17,6,72,213,54,276,0,0
5746,487,133,559,347,31,17,6,72,214,55,276,0,0
5747,487,133,559,346,31,17,6,72,213,56,276,0,0
5748,487,133,559,345,31,17,6,72,212,57,276,0,0
5749,487,132,559,344,31,17,6,72,212,58,276,0,0
5750,487,132,560,345,31,17,6,73,213,59,276,0,0
5751,487,132,560,346,31,17,6,73,214,60,276,0,0
5752,487,132,561,344,31,17,6,74,212,61,276,0,0
5753,488,132,561,343,31,17,6,73,211,62,276,0,0
5754,487,132,561,342,31,17,6,74,210,63,276,0,0
5755,486,132,560,341,31,17,6,74,209,64,276,0,0
5756,486,132,559,339,31,17,6,73,207,65,276,0,0
5757,480,130,554,339,31,17,6,74,209,66,276,0,0
5758,466,130,542,340,31,17,6,76,210,67,276,0,0
5759,455,130,533,341,31,17,6,78,211,68,276,0,0
5760,452,132,532,344,31,17,6,80,212,69,276,0,0
5761,443,134,519,340,31,17,6,76,206,70,276,0,0
5762,429,132,505,339,31,17,6,76,207,71,276,0,0
5763,413,131,490,343,31,17,6,77,212,72,276,0,0
5764,395,134,475,347,31,17,6,80,213,73,276,0,0
5765,388,134,468,347,31,17,6,80,213,74,276,0,0
5766,381,131,464,353,31,17,6,83,222,75,276,0,0
5767,372,132,449,341,31,17,6,77,209,76,276,0,0
5768,362,129,436,334,31,17,6,74,205,77,276,0,0
5769,337,131,417,345,31,17,6,80,214,78,276,0,0
5770,326,132,408,348,31,17,6,82,216,79,276,0,0
5771,323,130,403,345,31,17,6,80,215,80,276,0,0
5772,317,131,394,341,31,17,6,77,210,81,276,0,0
5773,314,133,388,339,31,17,6,74,206,82,276,0,0
5774,309,134,383,340,31,17,6,74,206,83,276,0,0
5775,307,134,380,340,31,17,6,73,206,84,276,0,0
5776,305,135,377,338,31,17,6,72,203,85,276,0,0
5777,305,135,375,338,31,17,6,70,203,86,276,0,0
5778,305,136,375,339,31,17,6,70,203,87,276,0,0
5779,305,136,375,339,31,17,6,70,203,88,276,0,0
5780,307,136,376,339,31,17,6,69,203,89,276,0,0
5781,308,134,377,338,31,17,6,69,204,90,276,0,0
5782,309,134,378,339,31,17,6,69,205,91,276,0,0
5783,309,134,378,339,31,17,6,69,205,92,276,0,0
5784,308,134,378,339,31,17,6,70,205,93,276,0,0
5785,308,135,378,339,31,17,6,70,204,94,276,0,0
5786,309,135,378,339,31,17,6,69,204,95,276,0,0
5787,309,136,378,339,31,17,6,69,203,96,276,0,0
5788,310,136,380,339,31,17,6,70,203,97,276,0,0
5789,311,136,380,339,31,17,6,69,203,98,276,0,0
5790,311,136,380,339,31,17,6,69,203,99,276,0,0
5791,311,136,381,339,31,17,6,70,203,100,276,0,0
5792,311,137,380,339,31,17,6,69,202,101,276,0,0
5793,310,137,380,339,31,17,6,70,202,102,276,0,0
5794,310,137,379,338,31,17,6,69,201,103,276,0,0
5795,310,138,379,338,31,17,6,69,200,104,276,0,0
5796,310,138,380,339,31,17,6,70,201,105,276,0,0
5797,311,137,380,339,31,17,6,69,202,106,276,0,0
5798,311,137,380,339,31,17,6,69,202,107,276,0,0
5799,311,138,380,339,31,17,6,69,201,108,276,0,0
5800,311,138,380,339,31,17,6,69,201,109,276,0,0
5801,312,138,380,339,31,17,6,68,201,110,276,0,0
5802,311,138,380,339,31,17,6,69,201,111,276,0,0
5803,311,138,380,339,31,17,6,69,201,112,276,0,0
5804,311,138,379,338,31,17,6,68,200,113,276,0,0
5805,311,138,379,338,31,17,6,68,200,114,276,0,0
5806,311,138,379,339,31,17,6,68,201,115,276,0,0
5807,311,138,380,339,31,17,6,69,201,116,276,0,0
5808,311,138,380,339,31,17,6,69,201,117,276,0,0
5809,311,138,380,340,31,17,6,69,202,118,276,0,0
5810,311,138,380,340,31,17,6,69,202,119,276,0,0
5811,311,138,379,339,31,17,6,68,201,120,276,0,0
5812,311,138,379,339,31,17,6,68,201,121,276,0,0
5813,311,138,379,339,31,17,6,68,201,122,276,0,0
5814,311,138,379,339,31,17,6,68,201,123,276,0,0
5815,311,138,379,339,31,17,6,68,201,124,276,0,0
5816,311,138,379,339,31,17,6,68,201,125,276,0,0
5817,311,138,379,340,31,17,6,68,202,126,276,0,0
5818,310,139,379,340,31,17,6,69,201,127,276,0,0
5819,310,139,379,340,31,17,6,69,201,128,276,0,0
5820,310,139,379,340,31,17,6,69,201,129,276,0,0
5821,310,139,379,340,31,17,6,69,201,130,276,0,0
5822,309,139,379,340,31,17,6,70,201,131,276,0,0
5823,310,139,379,340,31,17,6,69,201,132,276,0,0
5824,310,140,379,340,31,17,6,69,200,133,276,0,0
5825,311,140,379,339,31,17,6,68,199,134,276,0,0
5826,310,139,379,339,31,17,6,69,200,135,276,0,0
5827,310,139,379,339,31,17,6,69,200,136,276,0,0
5828,310,139,379,339,31,17,6,69,200,137,276,0,0
5829,310,140,379,339,31,17,6,69,199,138,276,0,0
5830,310,139,379,339,31,17,6,69,200,139,276,0,0
5831,310,139,380,339,31,17,6,70,200,140,276,0,0
5832,311,139,380,339,31,17,6,69,200,141,276,0,0
5833,310,139,380,339,31,17,6,70,200,142,276,0,0
5834,310,140,379,339,31,17,6,69,199,143,276,0,0
5835,310,140,379,339,31,17,6,69,199,144,276,0,0
5836,309,139,379,339,31,17,6,70,200,145,276,0,0
5837,309,139,379,339,31,17,6,70,200,146,276,0,0
5838,310,139,380,340,31,17,6,70,201,147,276,0,0
5839,310,138,381,340,31,17,6,71,202,148,276,0,0
5840,311,138,381,340,31,17,6,70,202,149,276,0,0
5841,311,139,381,340,31,17,6,70,201,150,276,0,0
5842,311,139,381,340,31,17,6,70,201,151,276,0,0
5843,311,139,381,340,31,17,6,70,201,152,276,0,0
5844,311,140,381,340,31,17,6,70,200,153,276,0,0
5845,311,140,380,340,31,17,6,69,200,154,276,0,0
5846,310,140,380,339,31,17,6,70,199,155,276,0,0
5847,310,140,380,339,31,17,6,70,199,156,276,0,0
5848,310,140,380,339,31,17,6,70,199,157,276,0,0
5849,310,140,380,339,31,17,6,70,199,158,276,0,0
5850,310,140,380,339,31,17,6,70,199,159,276,0,0
5851,310,140,380,339,31,17,6,70,199,160,276,0,0
5852,310,140,380,338,31,17,6,70,198,161,276,0,0
5853,310,140,380,338,31,17,6,70,198,162,276,0,0
5854,310,140,380,338,31,17,6,70,198,163,276,0,0
5855,310,140,380,338,31,17,6,70,198,164,276,0,0
5856,309,140,379,339,31,17,6,70,199,165,276,0,0
5857,309,140,379,339,31,17,6,70,199,166,276,0,0
5858,309,140,379,339,31,17,6,70,199,167,276,0,0
5859,309,140,380,339,31,17,6,71,199,168,276,0,0
5860,309,140,380,339,31,17,6,71,199,169,276,0,0
5861,310,141,380,339,31,17,6,70,198,170,276,0,0
5862,310,141,380,339,31,17,6,70,198,171,276,0,0
5863,310,141,380,339,31,17,6,70,198,172,276,0,0
5864,310,141,380,338,31,17,6,70,197,173,276,0,0
5865,309,141,379,338,31,17,6,70,197,174,276,0,0
5866,310,141,380,339,31,17,6,70,198,175,276,0,0
5867,310,141,380,339,31,17,6,70,198,176,276,0,0
5868,309,140,380,339,31,17,6,71,199,177,276,0,0
5869,309,140,380,340,31,17,6,71,200,178,276,0,0
5870,309,140,380,340,31,17,6,71,200,179,276,0,0
5871,309,139,380,339,31,17,6,71,200,180,276,0,0
5872,309,139,380,339,31,17,6,71,200,181,276,0,0
5873,309,140,379,339,31,17,6,70,199,182,276,0,0
5874,309,140,379,338,31,17,6,70,198,183,276,0,0
5875,309,140,379,338,31,17,6,70,198,184,276,0,0
5876,309,140,379,339,31,17,6,70,199,185,276,0,0
5877,309,140,379,339,31,17,6,70,199,186,276,0,0
5878,309,140,379,339,31,17,6,70,199,187,276,0,0
5879,309,140,379,340,31,17,6,70,200,188,276,0,0
5880,309,139,380,340,31,17,6,71,201,189,276,0,0
5881,309,139,380,340,31,17,6,71,201,190,276,0,0
5882,310,139,380,340,31,17,6,70,201,191,276,0,0
5883,309,139,380,340,31,17,6,71,201,192,276,0,0
5884,310,139,380,339,31,17,6,70,200,193,276,0,0
5885,310,139,380,339,31,17,6,70,200,194,276,0,0
5886,310,139,380,339,31,17,6,70,200,195,276,0,0
5887,309,139,379,338,31,17,6,70,199,196,276,0,0
5888,310,139,380,338,31,17,6,70,199,197,276,0,0
5889,310,139,380,338,31,17,6,70,199,198,276,0,0
5890,311,139,380,338,31,17,6,69,199,199,276,0,0
5891,311,138,380,339,31,17,6,69,201,200,276,0,0
5892,311,138,380,339,31,17,6,69,201,201,276,0,0
5893,311,138,380,339,31,17,6,69,201,202,276,0,0
5894,311,138,380,340,31,17,6,69,202,203,276,0,0
5895,311,138,380,339,31,17,6,69,201,204,276,0,0
5896,311,139,380,339,31,17,6,69,200,205,276,0,0
5897,311,139,380,339,31,17,6,69,200,206,276,0,0
5898,312,139,381,339,31,17,6,69,200,207,276,0,0
5899,311,139,380,340,31,17,6,69,201,208,276,0,0
5900,311,138,380,340,31,17,6,69,202,209,276,0,0
5901,311,138,380,340,31,17,6,69,202,210,276,0,0
5902,311,138,381,340,31,17,6,70,202,211,276,0,0
5903,311,137,381,340,31,17,6,70,203,212,276,0,0
5904,312,138,380,339,31,17,6,68,201,213,276,0,0
5905,311,138,380,339,31,17,6,69,201,214,276,0,0
5906,311,138,380,339,31,17,6,69,201,215,276,0,0
5907,311,138,380,339,31,17,6,69,201,216,276,0,0
5908,311,138,380,339,31,17,6,69,201,217,276,0,0
5909,311,139,380,339,31,17,6,69,200,218,276,0,0
5910,312,139,380,339,31,17,6,68,200,219,276,0,0
5911,312,139,380,339,31,17,6,68,200,220,276,0,0
5912,311,139,380,340,31,17,6,69,201,221,276,0,0
5913,311,139,379,340,31,17,6,68,201,222,276,0,0
5914,311,139,379,340,31,17,6,68,201,223,276,0,0
5915,311,139,379,340,31,17,6,68,201,224,276,0,0
5916,311,139,379,340,31,17,6,68,201,225,276,0,0
5917,311,139,380,340,31,17,6,69,201,226,276,0,0
5918,311,139,380,340,31,17,6,69,201,227,276,0,0
5919,311,139,380,340,31,17,6,69,201,228,276,0,0
5920,311,138,380,340,31,17,6,69,202,229,276,0,0
5921,311,138,380,340,31,17,6,69,202,230,276,0,0
5922,312,138,380,340,31,17,6,68,202,231,276,0,0
5923,311,138,380,340,31,17,6,69,202,232,276,0,0
5924,312,138,380,339,31,17,6,68,201,233,276,0,0
5925,312,138,380,339,31,17,6,68,201,234,276,0,0
5926,312,139,380,339,31,17,6,68,200,235,276,0,0
5927,312,139,379,338,31,17,6,67,199,236,276,0,0
5928,312,139,379,338,31,17,6,67,199,237,276,0,0
5929,312,140,379,338,31,17,6,67,198,238,276,0,0
5930,312,140,379,338,31,17,6,67,198,239,276,0,0
5931,312,139,380,338,31,17,6,68,199,240,276,0,0
5932,312,139,380,338,31,17,6,68,199,241,276,0,0
5933,313,139,380,339,31,17,6,67,200,242,276,0,0
5934,312,138,380,339,31,17,6,68,201,243,276,0,0
5935,312,138,380,339,31,17,6,68,201,244,276,0,0
5936,312,138,380,339,31,17,6,68,201,245,276,0,0
5937,312,138,380,338,31,17,6,68,200,246,276,0,0
5938,312,138,380,338,31,17,6,68,200,247,276,0,0
5939,313,139,380,338,31,17,6,67,199,248,276,0,0
5940,312,139,379,338,31,17,6,67,199,249,276,0,0
5941,312,139,380,339,31,17,6,68,200,250,276,0,0
5942,313,139,380,339,31,17,6,67,200,251,276,0,0
5943,312,139,380,339,31,17,6,68,200,252,276,0,0
5944,312,138,380,340,31,17,6,68,202,253,276,0,0
5945,312,138,380,340,31,17,6,68,202,254,276,0,0
5946,313,138,380,339,31,17,6,67,201,255,276,0,0
5947,313,138,380,339,31,17,6,67,201,256,276,0,0
5948,313,138,380,339,31,17,6,67,201,257,276,0,0
5949,313,138,380,338,31,17,6,67,200,258,276,0,0
5950,312,138,380,338,31,17,6,68,200,259,276,0,0
5951,312,139,380,339,31,17,6,68,200,260,276,0,0
5952,312,139,380,339,31,17,6,68,200,261,276,0,0
5953,312,139,380,339,31,17,6,68,200,262,276,0,0
5954,312,140,380,340,31,17,6,68,200,263,276,0,0
5955,312,140,380,340,31,17,6,68,200,264,276,0,0
5956,312,139,380,340,31,17,6,68,201,265,276,0,0
5957,312,138,380,340,31,17,6,68,202,266,276,0,0
5958,313,138,380,340,31,17,6,67,202,267,276,0,0
5959,312,138,380,339,31,17,6,68,201,268,276,0,0
5960,312,138,380,339,31,17,6,68,201,269,276,0,0
5961,312,139,379,339,31,17,6,67,200,270,276,0,0
5962,312,139,379,339,31,17,6,67,200,271,276,0,0
5963,312,139,379,339,31,17,6,67,200,272,276,0,0
5964,312,140,379,340,31,17,6,67,200,273,276,0,0
5965,312,140,379,340,31,17,6,67,200,274,276,0,0
5966,312,141,380,342,31,17,6,68,201,275,276,0,0
5967,313,141,380,342,31,17,6,67,201,276,276,1,0
5983,319,145,381,344,31,17,6,62,199,0,276,0,0
5984,316,142,380,340,31,17,6,64,198,1,276,0,0
5985,316,142,379,338,31,17,6,63,196,2,276,0,0
5986,314,140,378,340,31,17,6,64,200,3,276,0,0
5987,311,139,376,342,31,17,6,65,203,4,276,0,0
5988,309,137,373,344,31,17,6,64,207,5,276,0,0
5989,306,134,370,340,31,17,6,64,206,6,276,0,0
5990,304,133,370,347,31,17,6,66,214,7,276,0,0
5991,306,132,372,348,31,17,6,66,216,8,276,0,0
5992,309,130,376,347,31,17,6,67,217,9,276,0,0
5993,314,131,380,347,31,17,6,66,216,10,276,0,0
5994,317,135,386,361,31,17,6,69,226,11,276,0,0
5995,318,136,387,369,31,17,6,69,233,12,276,0,0
5996,318,136,388,371,31,17,6,70,235,13,276,0,0
5755,312,290,371,544,32,17,6,59,254,0,0,0,0
5759,234,340,305,584,33,17,6,71,244,0,0,0,0
5967,230,286,293,524,34,17,6,63,238,0,1,0,0
5968,234,279,282,462,34,17,6,48,183,1,1,0,0
5969,235,270,358,682,35,17,6,123,412,0,31,0,1
5970,254,281,384,711,35,17,6,130,430,1,31,0,0
5971,267,267,404,719,35,17,6,137,452,2,31,0,0
5972,306,253,448,721,35,17,6,142,468,3,31,0,0
5973,367,256,509,711,35,17,6,142,455,4,31,0,0
5974,385,252,537,719,35,17,6,152,467,5,31,0,0
5975,430,249,579,707,35,17,6,149,458,6,31,0,0
5976,465,247,610,697,35,17,6,145,450,7,31,0,0
5977,485,245,624,680,35,17,6,139,435,8,31,0,0
5978,492,240,624,652,35,17,6,132,412,9,31,0,0
5979,488,227,620,631,35,17,6,132,404,10,31,0,0
5980,486,222,621,624,35,17,6,135,402,11,31,0,0
5981,477,213,610,610,35,17,6,133,397,12,31,0,0
5982,475,203,599,577,35,17,6,124,374,13,31,0,0
5983,463,205,582,561,35,17,6,119,356,14,31,0,0
5984,446,198,562,548,35,17,6,116,350,15,31,0,0
5985,428,192,540,529,35,17,6,112,337,16,31,0,0
5986,415,191,525,521,35,17,6,110,330,17,31,0,0
5987,394,186,507,526,35,17,6,113,340,18,31,0,0
5988,389,183,495,505,35,17,6,106,322,19,31,0,0
5989,382,182,482,486,35,17,6,100,304,20,31,0,0
5990,367,178,466,480,35,17,6,99,302,21,31,0,0
5991,356,171,452,468,35,17,6,96,297,22,31,0,0
5992,347,166,443,461,35,17,6,96,295,23,31,0,0
5993,341,163,436,455,35,17,6,95,292,24,31,0,0
5994,341,155,431,437,35,17,6,90,282,25,31,0,0
5995,341,157,427,426,35,17,6,86,269,26,31,0,0
5996,330,149,416,421,35,17,6,86,272,27,31,0,0
5997,322,141,407,407,35,17,6,85,266,28,31,0,0
5998,317,137,400,394,35,17,6,83,257,29,31,0,0
5999,313,135,396,393,35,17,6,83,258,30,31,0,0
6000,314,131,392,373,35,17,6,78,242,31,31,1,0
441,1607,589,1910,1080,1,17,7,303,491,0,28,0,1
442,1478,540,1809,1078,1,17,7,331,538,1,28,0,0
443,1330,502,1676,1068,1,17,7,346,566,2,28,0,0
444,1174,497,1521,1069,1,17,7,347,572,3,28,0,0
445,1031,465,1389,1066,1,17,7,358,601,4,28,0,0
446,889,439,1265,1069,1,17,7,376,630,5,28,0,0
447,760,416,1147,1068,1,17,7,387,652,6,28,0,0
448,647,402,1033,1070,1,17,7,386,668,7,28,0,0
449,572,391,958,1068,1,17,7,386,677,8,28,0,0
450,479,373,862,1056,1,17,7,383,683,9,28,0,0
451,402,359,782,1042,1,17,7,380,683,10,28,0,0
452,346,354,711,1017,1,17,7,365,663,11,28,0,0
453,291,339,626,959,1,17,7,335,620,12,28,0,0
454,262,331,581,924,1,17,7,319,593,13,28,0,0
455,214,325,513,883,1,17,7,299,558,14,28,0,0
456,164,317,450,860,1,17,7,286,543,15,28,0,0
457,131,311,409,841,1,17,7,278,530,16,28,0,0
458,100,300,359,807,1,17,7,259,507,17,28,0,0
459,89,304,328,780,1,17,7,239,476,18,28,0,0
460,71,293,301,755,1,17,7,230,462,19,28,0,0
461,39,286,257,732,1,17,7,218,446,20,28,0,0
462,22,285,235,723,1,17,7,213,438,21,28,0,0
463,8,287,197,680,1,17,7,189,393,22,28,0,0
464,0,289,178,665,1,17,7,178,376,23,28,0,0
465,0,291,170,657,1,17,7,170,366,24,28,0,0
466,0,287,139,642,1,17,7,139,355,25,28,0,0
467,0,300,122,645,1,17,7,122,345,26,28,0,0
468,0,306,102,632,1,17,7,102,326,27,28,0,0
469,0,306,70,616,1,17,7,70,310,28,28,1,0
470,3,377,72,612,3,17,7,69,235,0,0,0,0
2064,0,444,551,1059,6,17,7,551,615,0,0,0,0
2064,1,462,176,955,7,17,7,175,493,0,4,0,0
2065,6,460,163,900,7,17,7,157,440,1,4,0,0
2066,2,473,127,825,7,17,7,125,352,2,4,0,0
2067,0,453,82,769,7,17,7,82,316,3,4,0,0
2068,0,447,54,722,7,17,7,54,275,4,4,0,0
2132,0,938,129,1080,8,17,7,129,142,0,0,0,0
2138,0,512,542,1059,9,17,7,542,547,0,5,0,0
2139,0,483,538,1045,9,17,7,538,562,1,5,0,0
2140,0,454,540,1044,9,17,7,540,590,2,5,0,0
2141,0,421,503,1003,9,17,7,503,582,3,5,0,0
2142,0,404,475,979,9,17,7,475,575,4,5,0,0
2143,0,364,494,971,9,17,7,494,607,5,5,0,0
2143,56,386,249,889,10,17,7,193,503,0,9,0,0
2144,52,384,235,859,10,17,7,183,475,1,9,0,0
2145,47,385,220,829,10,17,7,173,444,2,9,0,0
2146,20,374,183,790,10,17,7,163,416,3,9,0,0
2147,0,366,151,768,10,17,7,151,402,4,9,0,0
2148,0,388,126,749,10,17,7,126,361,5,9,0,0
2149,0,384,104,723,10,17,7,104,339,6,9,0,0
2150,0,385,96,715,10,17,7,96,330,7,9,0,0
2151,0,407,78,687,10,17,7,78,280,8,9,0,0
2152,0,412,60,666,10,17,7,60,254,9,9,0,0
4604,1,473,37,775,11,17,7,36,302,0,1,0,0
4605,7,486,42,776,11,17,7,35,290,1,1,0,0
4606,0,469,105,809,12,17,7,105,340,0,18,0,0
4607,0,447,117,829,12,17,7,117,382,1,18,0,0
4608,0,434,120,840,12,17,7,120,406,2,18,0,0
4609,0,452,126,871,12,17,7,126,419,3,18,0,0
4610,0,440,140,923,12,17,7,140,483,4,18,0,0
4611,10,429,169,942,12,17,7,159,513,5,18,0,0
4612,28,439,200,978,12,17,7,172,539,6,18,0,0
4613,38,446,220,1004,12,17,7,182,558,7,18,0,0
4614,49,456,246,1044,12,17,7,197,588,8,18,0,0
4615,75,478,280,1071,12,17,7,205,593,9,18,0,0
4616,109,491,320,1080,12,17,7,211,589,10,18,0,0
4617,166,511,382,1080,12,17,7,216,569,11,18,0,0
4618,223,528,440,1080,12,17,7,217,552,12,18,0,0
4619,293,544,515,1080,12,17,7,222,536,13,18,0,0
4620,392,582,615,1079,12,17,7,223,497,14,18,0,0
4621,482,613,704,1078,12,17,7,222,465,15,18,0,0
4622,562,638,777,1076,12,17,7,215,438,16,18,0,0
4623,691,669,895,1075,12,17,7,204,406,17,18,0,0
4624,752,687,952,1080,12,17,7,200,393,18,18,0,0
4624,832,719,1138,1072,13,17,7,306,353,0,0,0,0
4934,1661,47,1697,140,20,17,7,36,93,0,103,0,0
4935,1662,46,1699,142,20,17,7,37,96,1,103,0,0
4938,1664,53,1700,149,20,17,7,36,96,0,103,0,0
4949,1655,62,1691,157,20,17,7,36,95,0,103,0,0
4950,1656,66,1691,158,20,17,7,35,92,1,103,0,0
4951,1659,67,1694,160,20,17,7,35,93,2,103,0,0
4952,1655,69,1690,161,20,17,7,35,92,3,103,0,0
4954,1658,68,1694,163,20,17,7,36,95,0,103,0,0
4963,1658,76,1694,169,20,17,7,36,93,0,103,0,1
4964,1658,76,1694,169,20,17,7,36,93,1,103,0,0
4965,1657,76,1694,170,20,17,7,37,94,2,103,0,0
4966,1657,73,1696,174,20,17,7,39,101,3,103,0,0
4967,1657,75,1696,175,20,17,7,39,100,4,103,0,0
4968,1657,75,1699,180,20,17,7,42,105,5,103,0,0
4969,1656,76,1697,179,20,17,7,41,103,6,103,0,0
4970,1655,74,1697,181,20,17,7,42,107,7,103,0,0
4971,1655,77,1697,183,20,17,7,42,106,8,103,0,0
4972,1652,76,1696,187,20,17,7,44,111,9,103,0,0
4973,1651,79,1695,189,20,17,7,44,110,10,103,0,0
4974,1651,83,1693,190,20,17,7,42,107,11,103,0,0
4975,1651,83,1694,192,20,17,7,43,109,12,103,0,0
4976,1651,87,1694,196,20,17,7,43,109,13,103,0,0
4977,1648,83,1695,200,20,17,7,47,117,14,103,0,0
4978,1648,85,1695,202,20,17,7,47,117,15,103,0,0
4979,1645,87,1692,204,20,17,7,47,117,16,103,0,0
4980,1644,87,1691,204,20,17,7,47,117,17,103,0,0
4981,1646,90,1692,205,20,17,7,46,115,18,103,0,0
4982,1646,89,1693,209,20,17,7,47,120,19,103,0,0
4983,1648,89,1698,212,20,17,7,50,123,20,103,0,0
4984,1649,89,1699,215,20,17,7,50,126,21,103,0,0
4985,1649,87,1700,219,20,17,7,51,132,22,103,0,0
4986,1649,89,1702,223,20,17,7,53,134,23,103,0,0
4987,1650,92,1703,228,20,17,7,53,136,24,103,0,0
4988,1647,92,1701,231,20,17,7,54,139,25,103,0,0
4989,1644,96,1697,232,20,17,7,53,136,26,103,0,0
4990,1643,98,1696,235,20,17,7,53,137,27,103,0,0
4991,1645,101,1698,238,20,17,7,53,137,28,103,0,0
4992,1641,102,1694,242,20,17,7,53,140,29,103,0,0
4993,1635,104,1688,243,20,17,7,53,139,30,103,0,0
4994,1635,105,1688,245,20,17,7,53,140,31,103,0,0
4995,1633,109,1687,253,20,17,7,54,144,32,103,0,0
4996,1633,112,1686,257,20,17,7,53,145,33,103,0,0
4997,1630,112,1685,262,20,17,7,55,150,34,103,0,0
4998,1630,114,1685,266,20,17,7,55,152,35,103,0,0
4999,1631,115,1686,268,20,17,7,55,153,36,103,0,0
5000,1632,121,1687,275,20,17,7,55,154,37,103,0,0
5001,1630,122,1684,277,20,17,7,54,155,38,103,0,0
5002,1627,121,1684,285,20,17,7,57,164,39,103,0,0
5003,1627,118,1686,290,20,17,7,59,172,40,103,0,0
5004,1626,119,1688,301,20,17,7,62,182,41,103,0,0
5005,1626,121,1687,305,20,17,7,61,184,42,103,0,0
5006,1624,120,1687,307,20,17,7,63,187,43,103,0,0
5007,1622,124,1685,313,20,17,7,63,189,44,103,0,0
5008,1622,124,1688,318,20,17,7,66,194,45,103,0,0
5009,1620,128,1690,328,20,17,7,70,200,46,103,0,0
5010,1617,133,1686,332,20,17,7,69,199,47,103,0,0
5011,1619,131,1692,336,20,17,7,73,205,48,103,0,0
5012,1617,139,1692,345,20,17,7,75,206,49,103,0,0
5013,1610,140,1685,348,20,17,7,75,208,50,103,0,0
5014,1603,144,1686,364,20,17,7,83,220,51,103,0,0
5015,1601,150,1688,374,20,17,7,87,224,52,103,0,0
5016,1598,149,1691,382,20,17,7,93,233,53,103,0,0
5017,1595,155,1691,389,20,17,7,96,234,54,103,0,0
5018,1590,158,1692,403,20,17,7,102,245,55,103,0,0
5019,1584,163,1691,415,20,17,7,107,252,56,103,0,0
5020,1580,165,1692,424,20,17,7,112,259,57,103,0,0
5021,1575,170,1697,447,20,17,7,122,277,58,103,0,0
5022,1571,176,1697,460,20,17,7,126,284,59,103,0,0
5023,1570,177,1699,467,20,17,7,129,290,60,103,0,0
5024,1560,183,1693,486,20,17,7,133,303,61,103,0,0
5025,1554,183,1695,500,20,17,7,141,317,62,103,0,0
5026,1551,190,1698,522,20,17,7,147,332,63,103,0,0
5027,1542,197,1692,539,20,17,7,150,342,64,103,0,0
5028,1537,200,1691,556,20,17,7,154,356,65,103,0,0
5029,1526,213,1690,594,20,17,7,164,381,66,103,0,0
5030,1515,217,1684,608,20,17,7,169,391,67,103,0,0
5031,1498,227,1673,628,20,17,7,175,401,68,103,0,0
5032,1480,237,1661,652,20,17,7,181,415,69,103,0,0
5033,1467,247,1655,683,20,17,7,188,436,70,103,0,0
5034,1444,259,1644,720,20,17,7,200,461,71,103,0,0
5035,1412,272,1618,741,20,17,7,206,469,72,103,0,0
5036,1348,291,1561,774,20,17,7,213,483,73,103,0,0
5037,1308,305,1524,794,20,17,7,216,489,74,103,0,0
5038,1234,314,1474,845,20,17,7,240,531,75,103,0,0
5039,1169,311,1425,883,20,17,7,256,572,76,103,0,0
5040,1064,324,1314,890,20,17,7,250,566,77,103,0,0
5041,972,333,1230,903,20,17,7,258,570,78,103,0,0
5042,868,340,1116,904,20,17,7,248,564,79,103,0,0
5043,768,350,1020,904,20,17,7,252,554,80,103,0,0
5044,667,353,921,905,20,17,7,254,552,81,103,0,0
5045,529,340,791,896,20,17,7,262,556,82,103,0,0
5046,427,341,699,889,20,17,7,272,548,83,103,0,0
5047,365,328,627,854,20,17,7,262,526,84,103,0,0
5048,355,334,603,824,20,17,7,248,490,85,103,0,0
5049,301,320,543,793,20,17,7,242,473,86,103,0,0
5050,227,309,469,772,20,17,7,242,463,87,103,0,0
5051,183,303,418,746,20,17,7,235,443,88,103,0,0
5052,164,295,385,711,20,17,7,221,416,89,103,0,0
5053,161,304,367,690,20,17,7,206,386,90,103,0,0
5054,128,298,328,671,20,17,7,200,373,91,103,0,0
5055,85,296,283,660,20,17,7,198,364,92,103,0,0
5056,52,288,246,642,20,17,7,194,354,93,103,0,0
5057,37,281,221,620,20,17,7,184,339,94,103,0,0
5058,35,297,203,605,20,17,7,168,308,95,103,0,0
5059,8,297,170,595,20,17,7,162,298,96,103,0,0
5060,0,295,146,591,20,17,7,146,296,97,103,0,0
5061,0,291,124,575,20,17,7,124,284,98,103,0,0
5062,0,283,110,564,20,17,7,110,281,99,103,0,0
5063,0,294,100,558,20,17,7,100,264,100,103,0,0
5064,0,296,89,546,20,17,7,89,250,101,103,0,0
5065,0,325,73,542,20,17,7,73,217,102,103,0,0
5066,0,329,49,532,20,17,7,49,203,103,103,1,0
4982,1586,87,1622,208,22,17,7,36,121,0,71,0,1
4983,1581,82,1622,217,22,17,7,41,135,1,71,0,0
4984,1577,76,1621,222,22,17,7,44,146,2,71,0,0
4985,1576,76,1621,224,22,17,7,45,148,3,71,0,0
4986,1575,81,1619,227,22,17,7,44,146,4,71,0,0
4987,1574,83,1618,226,22,17,7,44,143,5,71,0,0
4988,1571,85,1617,231,22,17,7,46,146,6,71,0,0
4989,1568,82,1615,231,22,17,7,47,149,7,71,0,0
4990,1566,86,1613,237,22,17,7,47,151,8,71,0,0
4991,1566,87,1614,242,22,17,7,48,155,9,71,0,0
4992,1566,90,1614,243,22,17,7,48,153,10,71,0,0
4993,1566,97,1613,248,22,17,7,47,151,11,71,0,0
4994,1565,97,1612,249,22,17,7,47,152,12,71,0,0
4995,1563,100,1613,260,22,17,7,50,160,13,71,0,0
4996,1563,107,1611,262,22,17,7,48,155,14,71,0,0
4997,1560,108,1610,268,22,17,7,50,160,15,71,0,0
4998,1555,111,1606,275,22,17,7,51,164,16,71,0,0
4999,1551,114,1602,279,22,17,7,51,165,17,71,0,0
5000,1547,115,1599,287,22,17,7,52,172,18,71,0,0
5001,1543,116,1596,290,22,17,7,53,174,19,71,0,0
5002,1536,117,1591,298,22,17,7,55,181,20,71,0,0
5003,1531,120,1585,299,22,17,7,54,179,21,71,0,0
5004,1523,114,1581,306,22,17,7,58,192,22,71,0,0
5005,1517,116,1578,317,22,17,7,61,201,23,71,0,0
5006,1508,112,1571,324,22,17,7,63,212,24,71,0,0
5007,1502,130,1562,331,22,17,7,60,201,25,71,0,0
5008,1494,130,1556,339,22,17,7,62,209,26,71,0,0
5009,1485,128,1551,349,22,17,7,66,221,27,71,0,0
5010,1478,129,1546,363,22,17,7,68,234,28,71,0,0
5011,1474,129,1544,371,22,17,7,70,242,29,71,0,0
5012,1468,137,1536,375,22,17,7,68,238,30,71,0,0
5013,1458,137,1530,390,22,17,7,72,253,31,71,0,0
5014,1451,140,1528,414,22,17,7,77,274,32,71,0,0
5015,1446,150,1525,431,22,17,7,79,281,33,71,0,0
5016,1439,150,1522,439,22,17,7,83,289,34,71,0,0
5017,1432,157,1518,456,22,17,7,86,299,35,71,0,0
5018,1424,158,1512,463,22,17,7,88,305,36,71,0,0
5019,1414,165,1508,493,22,17,7,94,328,37,71,0,0
5020,1404,173,1501,508,22,17,7,97,335,38,71,0,0
5021,1392,178,1495,528,22,17,7,103,350,39,71,0,0
5022,1380,188,1490,554,22,17,7,110,366,40,71,0,0
5023,1363,191,1476,571,22,17,7,113,380,41,71,0,0
5024,1339,202,1463,614,22,17,7,124,412,42,71,0,0
5025,1322,213,1452,643,22,17,7,130,430,43,71,0,0
5026,1305,223,1437,657,22,17,7,132,434,44,71,0,0
5027,1275,247,1413,693,22,17,7,138,446,45,71,0,0
5028,1242,251,1384,710,22,17,7,142,459,46,71,0,0
5029,1195,269,1352,771,22,17,7,157,502,47,71,0,0
5030,1153,282,1318,804,22,17,7,165,522,48,71,0,0
5031,1104,290,1273,819,22,17,7,169,529,49,71,0,0
5032,1049,304,1229,844,22,17,7,180,540,50,71,0,0
5033,961,309,1146,850,22,17,7,185,541,51,71,0,0
5034,867,317,1065,873,22,17,7,198,556,52,71,0,0
5035,792,324,995,881,22,17,7,203,557,53,71,0,0
5036,701,329,905,885,22,17,7,204,556,54,71,0,0
5037,613,332,822,876,22,17,7,209,544,55,71,0,0
5038,513,318,715,849,22,17,7,202,531,56,71,0,0
5039,450,324,651,835,22,17,7,201,511,57,71,0,0
5040,379,322,576,810,22,17,7,197,488,58,71,0,0
5041,303,316,497,797,22,17,7,194,481,59,71,0,0
5042,252,319,441,778,22,17,7,189,459,60,71,0,0
5043,201,307,379,747,22,17,7,178,440,61,71,0,0
5044,171,311,345,733,22,17,7,174,422,62,71,0,0
5045,124,306,292,713,22,17,7,168,407,63,71,0,0
5046,82,301,248,703,22,17,7,166,402,64,71,0,0
5047,50,299,203,674,22,17,7,153,375,65,71,0,0
5048,25,298,171,656,22,17,7,146,358,66,71,0,0
5049,13,309,153,646,22,17,7,140,337,67,71,0,0
5050,0,306,121,632,22,17,7,121,326,68,71,0,0
5051,0,303,104,636,22,17,7,104,333,69,71,0,0
5052,0,326,77,617,22,17,7,77,291,70,71,0,0
5053,0,361,58,606,22,17,7,58,245,71,71,1,0
5004,0,387,42,694,26,17,7,42,307,0,17,0,0
5005,3,384,47,703,26,17,7,44,319,1,17,0,0
5006,18,376,67,715,26,17,7,49,339,2,17,0,0
5007,29,361,86,735,26,17,7,57,374,3,17,0,0
5008,29,347,94,759,26,17,7,65,412,4,17,0,0
5009,37,347,114,803,26,17,7,77,456,5,17,0,0
5010,42,347,128,821,26,17,7,86,474,6,17,0,0
5011,70,352,170,843,26,17,7,100,491,7,17,0,0
5012,94,364,208,873,26,17,7,114,509,8,17,0,0
5013,106,370,235,915,26,17,7,129,545,9,17,0,0
5014,140,392,289,975,26,17,7,149,583,10,17,0,0
5015,163,414,322,1001,26,17,7,159,587,11,17,0,0
5016,227,430,409,1037,26,17,7,182,607,12,17,0,0
5017,281,451,478,1066,26,17,7,197,615,13,17,0,0
5018,331,458,540,1079,26,17,7,209,621,14,17,0,0
5019,410,485,623,1080,26,17,7,213,595,15,17,0,0
5020,512,507,731,1080,26,17,7,219,573,16,17,0,0
5021,549,514,773,1080,26,17,7,224,566,17,17,0,0
5021,650,523,968,1060,27,17,7,318,537,0,0,0,0
5022,822,558,1163,1064,28,17,7,341,506,0,3,0,0
5023,945,570,1281,1067,28,17,7,336,497,1,3,0,0
5024,1097,616,1405,1071,28,17,7,308,455,2,3,0,0
5025,1178,638,1472,1074,28,17,7,294,436,3,3,0,0
5025,1366,645,1662,1064,29,17,7,296,419,0,0,0,0
5026,1580,677,1888,1080,30,17,7,308,403,0,1,0,0
5027,1676,721,1920,1080,30,17,7,244,359,1,1,0,0
5054,0,468,42,602,31,17,7,42,134,0,0,0,0
1816,1435,125,1476,274,1,17,8,41,149,0,0,0,0
1818,1451,125,1496,242,3,17,8,45,117,0,11,0,0
1819,1466,119,1512,239,3,17,8,46,120,1,11,0,0
1820,1476,114,1521,231,3,17,8,45,117,2,11,0,0
1821,1486,110,1534,234,3,17,8,48,124,3,11,0,0
1822,1506,117,1552,233,3,17,8,46,116,4,11,0,0
1823,1518,111,1566,233,3,17,8,48,122,5,11,0,0
1824,1532,111,1576,219,3,17,8,44,108,6,11,0,0
1825,1547,117,1592,228,3,17,8,45,111,7,11,0,0
1826,1561,117,1606,228,3,17,8,45,111,8,11,0,0
1827,1578,117,1616,210,3,17,8,38,93,9,11,0,0
1828,1592,115,1636,223,3,17,8,44,108,10,11,0,0
1829,1605,115,1649,222,3,17,8,44,107,11,11,0,0
2443,1585,111,1621,257,4,17,8,36,146,0,11,0,0
2444,1568,113,1605,256,4,17,8,37,143,1,11,0,0
2445,1553,110,1592,259,4,17,8,39,149,2,11,0,0
2446,1539,115,1579,261,4,17,8,40,146,3,11,0,0
2447,1514,110,1556,260,4,17,8,42,150,4,11,0,0
2448,1490,111,1534,262,4,17,8,44,151,5,11,0,0
2449,1480,114,1525,263,4,17,8,45,149,6,11,0,0
2450,1463,116,1509,265,4,17,8,46,149,7,11,0,0
2451,1446,114,1493,266,4,17,8,47,152,8,11,0,0
2452,1434,117,1484,272,4,17,8,50,155,9,11,0,0
2453,1424,116,1478,276,4,17,8,54,160,10,11,0,0
2454,1410,116,1464,278,4,17,8,54,162,11,11,0,0
2702,1413,124,1453,274,5,17,8,40,150,0,12,0,0
2703,1428,121,1469,274,5,17,8,41,153,1,12,0,0
2704,1450,120,1489,265,5,17,8,39,145,2,12,0,0
2705,1468,119,1507,263,5,17,8,39,144,3,12,0,0
2706,1482,110,1524,261,5,17,8,42,151,4,12,0,0
2707,1505,112,1548,262,5,17,8,43,150,5,12,0,0
2708,1520,110,1563,259,5,17,8,43,149,6,12,0,0
2709,1534,111,1577,257,5,17,8,43,146,7,12,0,0
2710,1549,108,1594,259,5,17,8,45,151,8,12,0,0
2711,1569,108,1609,242,5,17,8,40,134,9,12,0,0
2712,1584,109,1627,250,5,17,8,43,141,10,12,0,0
2713,1602,109,1642,238,5,17,8,40,129,11,12,0,0
2714,1619,108,1657,235,5,17,8,38,127,12,12,0,0
3053,380,524,534,814,6,17,8,154,290,0,58,0,1
3054,372,507,637,1008,6,17,8,265,501,1,58,0,0
3055,384,510,673,1057,6,17,8,289,547,2,58,0,0
3056,407,529,700,1080,6,17,8,293,551,3,58,0,0
3057,428,541,719,1080,6,17,8,291,539,4,58,0,0
3058,461,545,747,1080,6,17,8,286,535,5,58,0,0
3059,509,565,786,1080,6,17,8,277,515,6,58,0,0
3060,605,576,875,1080,6,17,8,270,504,7,58,0,0
3061,724,567,1002,1080,6,17,8,278,513,8,58,0,0
3062,834,535,1129,1078,6,17,8,295,543,9,58,0,0
3063,926,497,1237,1077,6,17,8,311,580,10,58,0,0
3064,1015,465,1339,1078,6,17,8,324,613,11,58,0,0
3065,1096,432,1435,1079,6,17,8,339,647,12,58,0,0
3066,1191,401,1543,1072,6,17,8,352,671,13,58,0,0
3067,1257,364,1583,992,6,17,8,326,628,14,58,0,0
3068,1282,338,1589,945,6,17,8,307,607,15,58,0,0
3069,1314,314,1604,909,6,17,8,290,595,16,58,0,0
3070,1362,288,1627,838,6,17,8,265,550,17,58,0,0
3071,1390,277,1640,803,6,17,8,250,526,18,58,0,0
3072,1409,258,1639,751,6,17,8,230,493,19,58,0,0
3073,1412,248,1622,710,6,17,8,210,462,20,58,0,0
3074,1423,239,1617,680,6,17,8,194,441,21,58,0,0
3075,1446,231,1620,630,6,17,8,174,399,22,58,0,0
3076,1458,226,1623,613,6,17,8,165,387,23,58,0,0
3077,1468,211,1619,573,6,17,8,151,362,24,58,0,0
3078,1467,202,1613,558,6,17,8,146,356,25,58,0,0
3079,1475,192,1614,542,6,17,8,139,350,26,58,0,0
3080,1489,184,1620,514,6,17,8,131,330,27,58,0,0
3081,1501,182,1626,498,6,17,8,125,316,28,58,0,0
3082,1506,177,1625,476,6,17,8,119,299,29,58,0,0
3083,1508,173,1622,467,6,17,8,114,294,30,58,0,0
3084,1517,171,1620,435,6,17,8,103,264,31,58,0,0
3085,1524,166,1623,420,6,17,8,99,254,32,58,0,0
3086,1527,164,1624,417,6,17,8,97,253,33,58,0,0
3087,1530,156,1623,401,6,17,8,93,245,34,58,0,0
3088,1531,155,1621,394,6,17,8,90,239,35,58,0,0
3089,1532,149,1618,380,6,17,8,86,231,36,58,0,0
3090,1535,147,1618,370,6,17,8,83,223,37,58,0,0
3091,1535,146,1616,366,6,17,8,81,220,38,58,0,0
3092,1532,142,1610,354,6,17,8,78,212,39,58,0,0
3093,1532,144,1605,345,6,17,8,73,201,40,58,0,0
3094,1532,140,1602,334,6,17,8,70,194,41,58,0,0
3095,1530,136,1599,328,6,17,8,69,192,42,58,0,0
3096,1525,137,1593,326,6,17,8,68,189,43,58,0,0
3097,1519,132,1584,312,6,17,8,65,180,44,58,0,0
3098,1512,131,1576,308,6,17,8,64,177,45,58,0,0
3099,1506,128,1569,304,6,17,8,63,176,46,58,0,0
3100,1501,125,1563,299,6,17,8,62,174,47,58,0,0
3101,1493,124,1555,295,6,17,8,62,171,48,58,0,0
3102,1482,120,1543,292,6,17,8,61,172,49,58,0,0
3103,1474,121,1534,289,6,17,8,60,168,50,58,0,0
3104,1466,120,1524,285,6,17,8,58,165,51,58,0,0
3105,1462,123,1517,280,6,17,8,55,157,52,58,0,0
3106,1450,122,1508,280,6,17,8,58,158,53,58,0,0
3107,1437,120,1494,278,6,17,8,57,158,54,58,0,0
3108,1428,121,1486,279,6,17,8,58,158,55,58,0,0
3109,1419,120,1476,279,6,17,8,57,159,56,58,0,0
3110,1412,121,1469,278,6,17,8,57,157,57,58,0,0
3111,1405,120,1461,275,6,17,8,56,155,58,58,1,0
3378,1435,135,1510,279,7,17,8,75,144,0,59,0,1
3379,1438,128,1515,277,7,17,8,77,149,1,59,0,0
3380,1444,126,1522,278,7,17,8,78,152,2,59,0,0
3381,1450,128,1528,281,7,17,8,78,153,3,59,0,0
3382,1453,129,1530,283,7,17,8,77,154,4,59,0,0
3383,1454,130,1532,289,7,17,8,78,159,5,59,0,0
3384,1455,130,1533,292,7,17,8,78,162,6,59,0,0
3385,1456,129,1534,293,7,17,8,78,164,7,59,0,0
3386,1456,134,1533,298,7,17,8,77,164,8,59,0,0
3387,1455,135,1532,300,7,17,8,77,165,9,59,0,0
3388,1453,140,1529,308,7,17,8,76,168,10,59,0,0
3389,1451,142,1528,315,7,17,8,77,173,11,59,0,0
3390,1448,142,1525,320,7,17,8,77,178,12,59,0,0
3391,1439,142,1520,329,7,17,8,81,187,13,59,0,0
3392,1434,144,1514,332,7,17,8,80,188,14,59,0,0
3393,1428,148,1505,332,7,17,8,77,184,15,59,0,0
3394,1421,148,1501,340,7,17,8,80,192,16,59,0,0
3395,1413,149,1499,358,7,17,8,86,209,17,59,0,0
3396,1404,158,1489,368,7,17,8,85,210,18,59,0,0
3397,1393,162,1479,375,7,17,8,86,213,19,59,0,0
3398,1381,164,1470,381,7,17,8,89,217,20,59,0,0
3399,1370,167,1456,381,7,17,8,86,214,21,59,0,0
3400,1357,167,1448,398,7,17,8,91,231,22,59,0,0
3401,1337,169,1433,416,7,17,8,96,247,23,59,0,0
3402,1321,167,1420,426,7,17,8,99,259,24,59,0,0
3403,1301,170,1406,446,7,17,8,105,276,25,59,0,0
3404,1293,173,1397,452,7,17,8,104,279,26,59,0,0
3405,1285,186,1390,471,7,17,8,105,285,27,59,0,0
3406,1268,191,1374,481,7,17,8,106,290,28,59,0,0
3407,1247,200,1360,507,7,17,8,113,307,29,59,0,0
3408,1234,205,1350,525,7,17,8,116,320,30,59,0,0
3409,1222,209,1342,542,7,17,8,120,333,31,59,0,0
3410,1204,219,1333,585,7,17,8,129,366,32,59,0,0
3411,1190,225,1320,596,7,17,8,130,371,33,59,0,0
3412,1171,240,1305,628,7,17,8,134,388,34,59,0,0
3413,1147,248,1287,655,7,17,8,140,407,35,59,0,0
3414,1113,262,1261,685,7,17,8,148,423,36,59,0,0
3415,1085,279,1242,710,7,17,8,157,431,37,59,0,0
3416,1054,284,1218,737,7,17,8,164,453,38,59,0,0
3417,1018,306,1194,797,7,17,8,176,491,39,59,0,0
3418,982,323,1160,828,7,17,8,178,505,40,59,0,0
3419,939,343,1131,882,7,17,8,192,539,41,59,0,0
3420,882,368,1084,916,7,17,8,202,548,42,59,0,0
3421,793,392,1017,983,7,17,8,224,591,43,59,0,0
3422,708,422,956,1046,7,17,8,248,624,44,59,0,0
3423,619,448,877,1067,7,17,8,258,619,45,59,0,0
3424,554,473,826,1080,7,17,8,272,607,46,59,0,0
3425,515,500,791,1080,7,17,8,276,580,47,59,0,0
3426,484,521,755,1080,7,17,8,271,559,48,59,0,0
3427,478,539,740,1080,7,17,8,262,541,49,59,0,0
3428,457,548,714,1080,7,17,8,257,532,50,59,0,0
3429,440,558,693,1080,7,17,8,253,522,51,59,0,0
3430,429,562,682,1080,7,17,8,253,518,52,59,0,0
3431,434,564,692,1073,7,17,8,258,509,53,59,0,0
3432,418,555,686,1078,7,17,8,268,523,54,59,0,0
3433,408,536,687,1079,7,17,8,279,543,55,59,0,0
3434,395,527,681,1076,7,17,8,286,549,56,59,0,0
3435,384,522,673,1071,7,17,8,289,549,57,59,0,0
3436,378,562,614,1013,7,17,8,236,451,58,59,0,0
3437,360,569,593,1013,7,17,8,233,444,59,59,1,0
4033,452,85,488,208,3,17,9,36,123,0,93,0,1
4034,449,87,484,207,3,17,9,35,120,1,93,0,0
4035,450,88,486,210,3,17,9,36,122,2,93,0,0
4036,442,87,480,213,3,17,9,38,126,3,93,0,0
4037,438,87,476,215,3,17,9,38,128,4,93,0,0
4038,437,85,477,218,3,17,9,40,133,5,93,0,0
4039,441,84,483,221,3,17,9,42,137,6,93,0,0
4040,438,87,478,218,3,17,9,40,131,7,93,0,0
4041,438,91,476,220,3,17,9,38,129,8,93,0,0
4042,437,93,475,221,3,17,9,38,128,9,93,0,0
4043,437,96,475,224,3,17,9,38,128,10,93,0,0
4044,438,96,475,225,3,17,9,37,129,11,93,0,0
4045,438,94,475,225,3,17,9,37,131,12,93,0,0
4046,438,97,475,228,3,17,9,37,131,13,93,0,0
4047,438,99,475,231,3,17,9,37,132,14,93,0,0
4048,437,96,476,234,3,17,9,39,138,15,93,0,0
4049,437,93,477,238,3,17,9,40,145,16,93,0,0
4050,438,93,480,243,3,17,9,42,150,17,93,0,0
4051,444,97,487,245,3,17,9,43,148,18,93,0,0
4052,450,102,492,243,3,17,9,42,141,19,93,0,0
4053,443,106,483,244,3,17,9,40,138,20,93,0,0
4054,442,108,481,245,3,17,9,39,137,21,93,0,0
4055,441,110,480,248,3,17,9,39,138,22,93,0,0
4056,443,119,481,253,3,17,9,38,134,23,93,0,0
4057,447,117,487,256,3,17,9,40,139,24,93,0,0
4058,450,118,492,258,3,17,9,42,140,25,93,0,0
4059,445,112,489,262,3,17,9,44,150,26,93,0,0
4060,439,100,487,264,3,17,9,48,164,27,93,0,0
4061,439,100,488,267,3,17,9,49,167,28,93,0,0
4062,438,102,487,271,3,17,9,49,169,29,93,0,0
4063,437,102,487,274,3,17,9,50,172,30,93,0,0
4064,439,116,485,275,3,17,9,46,159,31,93,0,0
4065,437,114,484,277,3,17,9,47,163,32,93,0,0
4066,438,120,484,278,3,17,9,46,158,33,93,0,0
4067,434,125,481,284,3,17,9,47,159,34,93,0,0
4068,431,122,481,294,3,17,9,50,172,35,93,0,0
4069,432,120,485,300,3,17,9,53,180,36,93,0,0
4070,433,122,485,301,3,17,9,52,179,37,93,0,0
4071,433,124,485,304,3,17,9,52,180,38,93,0,0
4072,433,125,485,305,3,17,9,52,180,39,93,0,0
4073,434,125,487,308,3,17,9,53,183,40,93,0,0
4074,436,128,489,314,3,17,9,53,186,41,93,0,0
4075,439,129,493,316,3,17,9,54,187,42,93,0,0
4076,443,131,499,326,3,17,9,56,195,43,93,0,0
4077,443,136,499,332,3,17,9,56,196,44,93,0,0
4078,443,139,499,335,3,17,9,56,196,45,93,0,0
4079,445,142,501,340,3,17,9,56,198,46,93,0,0
4080,446,144,503,348,3,17,9,57,204,47,93,0,0
4081,447,147,505,354,3,17,9,58,207,48,93,0,0
4082,447,147,506,359,3,17,9,59,212,49,93,0,0
4083,448,151,507,365,3,17,9,59,214,50,93,0,0
4084,448,153,508,368,3,17,9,60,215,51,93,0,0
4085,447,153,511,379,3,17,9,64,226,52,93,0,0
4086,446,156,512,390,3,17,9,66,234,53,93,0,0
4087,445,156,512,397,3,17,9,67,241,54,93,0,0
4088,443,159,511,405,3,17,9,68,246,55,93,0,0
4089,440,161,510,414,3,17,9,70,253,56,93,0,0
4090,437,161,509,419,3,17,9,72,258,57,93,0,0
4091,435,163,510,429,3,17,9,75,266,58,93,0,0
4092,434,167,512,440,3,17,9,78,273,59,93,0,0
4093,438,168,518,446,3,17,9,80,278,60,93,0,0
4094,439,170,523,456,3,17,9,84,286,61,93,0,0
4095,438,175,526,472,3,17,9,88,297,62,93,0,0
4096,436,176,527,478,3,17,9,91,302,63,93,0,0
4097,437,180,531,492,3,17,9,94,312,64,93,0,0
4098,439,183,539,515,3,17,9,100,332,65,93,0,0
4099,443,187,544,523,3,17,9,101,336,66,93,0,0
4100,445,185,551,540,3,17,9,106,355,67,93,0,0
4101,446,192,556,561,3,17,9,110,369,68,93,0,0
4102,445,194,557,569,3,17,9,112,375,69,93,0,0
4103,443,201,559,586,3,17,9,116,385,70,93,0,0
4104,448,216,566,612,3,17,9,118,396,71,93,0,0
4105,454,223,574,623,3,17,9,120,400,72,93,0,0
4106,455,229,581,650,3,17,9,126,421,73,93,0,0
4107,456,240,586,681,3,17,9,130,441,74,93,0,0
4108,459,252,590,694,3,17,9,131,442,75,93,0,0
4109,461,257,599,720,3,17,9,138,463,76,93,0,0
4110,464,262,614,762,3,17,9,150,500,77,93,0,0
4111,468,266,621,775,3,17,9,153,509,78,93,0,0
4112,468,271,633,819,3,17,9,165,548,79,93,0,0
4113,463,297,636,874,3,17,9,173,577,80,93,0,0
4114,454,311,631,897,3,17,9,177,586,81,93,0,0
4115,440,320,630,945,3,17,9,190,625,82,93,0,0
4116,432,342,633,998,3,17,9,201,656,83,93,0,0
4117,421,354,629,1032,3,17,9,208,678,84,93,0,0
4118,401,377,609,1045,3,17,9,208,668,85,93,0,0
4119,377,403,590,1076,3,17,9,213,673,86,93,0,0
4120,346,429,563,1080,3,17,9,217,651,87,93,0,0
4121,275,449,493,1080,3,17,9,218,631,88,93,0,0
4122,211,488,430,1080,3,17,9,219,592,89,93,0,0
4123,113,524,329,1080,3,17,9,216,556,90,93,0,0
4124,32,556,234,1080,3,17,9,202,524,91,93,0,0
4125,0,702,145,1080,3,17,9,145,378,92,93,0,0
4126,0,738,104,1080,3,17,9,104,342,93,93,1,0
4028,439,85,474,197,6,17,9,35,112,0,74,0,0
4044,464,101,499,219,6,17,9,35,118,0,74,0,0
4045,463,98,501,222,6,17,9,38,124,1,74,0,0
4046,467,104,503,221,6,17,9,36,117,2,74,0,0
4047,464,103,501,224,6,17,9,37,121,3,74,0,0
4048,464,102,502,226,6,17,9,38,124,4,74,0,0
4049,462,104,501,230,6,17,9,39,126,5,74,0,0
4050,469,107,506,226,6,17,9,37,119,6,74,0,0
4051,470,108,507,227,6,17,9,37,119,7,74,0,0
4053,462,115,500,239,6,17,9,38,124,0,74,0,1
4054,462,113,502,241,6,17,9,40,128,1,74,0,0
4055,464,115,504,243,6,17,9,40,128,2,74,0,0
4056,466,115,505,245,6,17,9,39,130,3,74,0,0
4057,471,115,509,243,6,17,9,38,128,4,74,0,0
4058,472,116,510,245,6,17,9,38,129,5,74,0,0
4059,467,117,506,253,6,17,9,39,136,6,74,0,0
4060,468,118,507,255,6,17,9,39,137,7,74,0,0
4061,461,113,505,263,6,17,9,44,150,8,74,0,0
4062,465,113,508,261,6,17,9,43,148,9,74,0,0
4063,459,110,506,266,6,17,9,47,156,10,74,0,0
4064,462,111,509,269,6,17,9,47,158,11,74,0,0
4065,470,113,514,267,6,17,9,44,154,12,74,0,0
4066,471,116,515,269,6,17,9,44,153,13,74,0,0
4067,475,122,518,270,6,17,9,43,148,14,74,0,0
4068,476,121,519,270,6,17,9,43,149,15,74,0,0
4069,476,120,521,275,6,17,9,45,155,16,74,0,0
4070,477,122,522,279,6,17,9,45,157,17,74,0,0
4071,478,122,525,279,6,17,9,47,157,18,74,0,0
4072,476,119,526,291,6,17,9,50,172,19,74,0,0
4073,476,119,527,296,6,17,9,51,177,20,74,0,0
4074,478,123,528,298,6,17,9,50,175,21,74,0,0
4075,478,121,529,304,6,17,9,51,183,22,74,0,0
4076,481,126,533,307,6,17,9,52,181,23,74,0,0
4077,485,130,536,308,6,17,9,51,178,24,74,0,0
4078,485,129,540,316,6,17,9,55,187,25,74,0,0
4079,486,133,542,323,6,17,9,56,190,26,74,0,0
4080,487,131,545,327,6,17,9,58,196,27,74,0,0
4081,490,135,548,334,6,17,9,58,199,28,74,0,0
4082,492,136,550,337,6,17,9,58,201,29,74,0,0
4083,493,135,552,339,6,17,9,59,204,30,74,0,0
4084,494,137,554,343,6,17,9,60,206,31,74,0,0
4085,494,138,553,346,6,17,9,59,208,32,74,0,0
4086,492,139,553,354,6,17,9,61,215,33,74,0,0
4087,492,143,553,365,6,17,9,61,222,34,74,0,0
4088,493,145,554,370,6,17,9,61,225,35,74,0,0
4089,492,145,555,378,6,17,9,63,233,36,74,0,0
4090,494,145,558,383,6,17,9,64,238,37,74,0,0
4091,495,146,561,390,6,17,9,66,244,38,74,0,0
4092,500,145,566,391,6,17,9,66,246,39,74,0,0
4093,505,149,573,400,6,17,9,68,251,40,74,0,0
4094,509,152,578,407,6,17,9,69,255,41,74,0,0
4095,512,154,582,412,6,17,9,70,258,42,74,0,0
4096,515,159,586,416,6,17,9,71,257,43,74,0,0
4097,516,161,589,427,6,17,9,73,266,44,74,0,0
4098,516,162,591,435,6,17,9,75,273,45,74,0,0
4099,518,164,596,448,6,17,9,78,284,46,74,0,0
4100,522,168,600,456,6,17,9,78,288,47,74,0,0
4101,523,172,603,465,6,17,9,80,293,48,74,0,0
4102,526,176,606,473,6,17,9,80,297,49,74,0,0
4103,525,175,609,482,6,17,9,84,307,50,74,0,0
4104,527,175,614,498,6,17,9,87,323,51,74,0,0
4105,530,178,621,523,6,17,9,91,345,52,74,0,0
4106,535,182,626,527,6,17,9,91,345,53,74,0,0
4107,536,190,628,538,6,17,9,92,348,54,74,0,0
4108,541,195,628,522,6,17,9,87,327,55,74,0,0
4109,540,197,635,559,6,17,9,95,362,56,74,0,0
4110,540,205,638,578,6,17,9,98,373,57,74,0,0
4111,553,211,633,503,6,17,9,80,292,58,74,0,0
4112,564,217,637,475,6,17,9,73,258,59,74,0,0
4113,560,228,645,521,6,17,9,85,293,60,74,0,0
4114,555,237,651,566,6,17,9,96,329,61,74,0,0
4115,544,240,663,644,6,17,9,119,404,62,74,0,0
4116,535,249,674,727,6,17,9,139,478,63,74,0,0
4117,535,257,684,775,6,17,9,149,518,64,74,0,0
4118,537,269,691,800,6,17,9,154,531,65,74,0,0
4119,529,287,689,834,6,17,9,160,547,66,74,0,0
4120,508,297,685,896,6,17,9,177,599,67,74,0,0
4121,487,308,671,922,6,17,9,184,614,68,74,0,0
4122,456,325,659,990,6,17,9,203,665,69,74,0,0
4123,421,339,635,1027,6,17,9,214,688,70,74,0,0
4124,410,359,621,1038,6,17,9,211,679,71,74,0,0
4125,380,386,600,1072,6,17,9,220,686,72,74,0,0
4126,307,400,530,1080,6,17,9,223,680,73,74,0,0
4127,292,411,522,1080,6,17,9,230,669,74,74,1,0
4031,506,96,541,195,7,17,9,35,99,0,92,0,0
4032,508,95,543,194,7,17,9,35,99,1,92,0,0
4033,509,96,544,195,7,17,9,35,99,2,92,0,0
4034,510,94,545,195,7,17,9,35,101,3,92,0,0
4036,510,97,545,198,7,17,9,35,101,0,92,0,1
4037,510,95,548,205,7,17,9,38,110,1,92,0,0
4038,511,95,548,203,7,17,9,37,108,2,92,0,0
4039,510,102,546,208,7,17,9,36,106,3,92,0,0
4040,510,102,546,210,7,17,9,36,108,4,92,0,0
4041,510,102,546,210,7,17,9,36,108,5,92,0,0
4042,509,104,546,216,7,17,9,37,112,6,92,0,0
4043,510,106,547,215,7,17,9,37,109,7,92,0,0
4044,511,106,547,214,7,17,9,36,108,8,92,0,0
4045,511,107,548,218,7,17,9,37,111,9,92,0,0
4046,511,108,547,220,7,17,9,36,112,10,92,0,0
4047,511,108,548,221,7,17,9,37,113,11,92,0,0
4048,511,108,549,223,7,17,9,38,115,12,92,0,0
4049,513,111,550,224,7,17,9,37,113,13,92,0,0
4050,513,112,549,224,7,17,9,36,112,14,92,0,0
4051,513,111,550,227,7,17,9,37,116,15,92,0,0
4052,513,108,552,227,7,17,9,39,119,16,92,0,0
4053,513,108,553,230,7,17,9,40,122,17,92,0,0
4054,514,111,553,236,7,17,9,39,125,18,92,0,0
4055,516,110,556,236,7,17,9,40,126,19,92,0,0
4056,519,108,559,234,7,17,9,40,126,20,92,0,0
4057,524,110,562,227,7,17,9,38,117,21,92,0,0
4058,526,110,564,227,7,17,9,38,117,22,92,0,0
4059,525,110,567,240,7,17,9,42,130,23,92,0,0
4060,525,112,569,248,7,17,9,44,136,24,92,0,0
4061,525,111,570,249,7,17,9,45,138,25,92,0,0
4062,526,111,570,250,7,17,9,44,139,26,92,0,0
4063,526,113,571,253,7,17,9,45,140,27,92,0,0
4064,526,113,572,254,7,17,9,46,141,28,92,0,0
4065,525,112,573,258,7,17,9,48,146,29,92,0,0
4066,525,115,573,265,7,17,9,48,150,30,92,0,0
4067,526,116,575,268,7,17,9,49,152,31,92,0,0
4068,528,117,577,269,7,17,9,49,152,32,92,0,0
4069,530,118,578,268,7,17,9,48,150,33,92,0,0
4070,530,118,580,274,7,17,9,50,156,34,92,0,0
4071,532,119,583,279,7,17,9,51,160,35,92,0,0
4072,532,120,585,288,7,17,9,53,168,36,92,0,0
4073,536,119,590,290,7,17,9,54,171,37,92,0,0
4074,541,121,593,287,7,17,9,52,166,38,92,0,0
4075,543,122,596,292,7,17,9,53,170,39,92,0,0
4076,545,123,598,295,7,17,9,53,172,40,92,0,0
4077,546,122,601,303,7,17,9,55,181,41,92,0,0
4078,549,128,604,311,7,17,9,55,183,42,92,0,0
4079,552,129,608,313,7,17,9,56,184,43,92,0,0
4080,553,131,610,320,7,17,9,57,189,44,92,0,0
4081,553,133,611,324,7,17,9,58,191,45,92,0,0
4082,553,133,613,330,7,17,9,60,197,46,92,0,0
4083,555,136,615,336,7,17,9,60,200,47,92,0,0
4084,557,138,618,342,7,17,9,61,204,48,92,0,0
4085,559,138,621,344,7,17,9,62,206,49,92,0,0
4086,561,138,625,352,7,17,9,64,214,50,92,0,0
4087,561,141,626,359,7,17,9,65,218,51,92,0,0
4088,561,141,628,365,7,17,9,67,224,52,92,0,0
4089,562,143,630,370,7,17,9,68,227,53,92,0,0
4090,567,146,636,376,7,17,9,69,230,54,92,0,0
4091,572,147,642,378,7,17,9,70,231,55,92,0,0
4092,577,148,648,384,7,17,9,71,236,56,92,0,0
4093,579,154,652,394,7,17,9,73,240,57,92,0,0
4094,582,157,656,399,7,17,9,74,242,58,92,0,0
4095,583,156,659,404,7,17,9,76,248,59,92,0,0
4096,587,161,663,410,7,17,9,76,249,60,92,0,0
4097,590,160,670,420,7,17,9,80,260,61,92,0,0
4098,592,161,676,432,7,17,9,84,271,62,92,0,0
4099,595,167,681,441,7,17,9,86,274,63,92,0,0
4100,597,171,684,449,7,17,9,87,278,64,92,0,0
4101,600,179,686,455,7,17,9,86,276,65,92,0,0
4102,600,182,690,475,7,17,9,90,293,66,92,0,0
4103,607,184,700,490,7,17,9,93,306,67,92,0,0
4104,615,185,711,498,7,17,9,96,313,68,92,0,0
4105,621,194,719,516,7,17,9,98,322,69,92,0,0
4106,626,196,728,527,7,17,9,102,331,70,92,0,0
4107,629,198,734,539,7,17,9,105,341,71,92,0,0
4108,636,209,742,554,7,17,9,106,345,72,92,0,0
4109,646,213,753,561,7,17,9,107,348,73,92,0,0
4110,658,218,775,593,7,17,9,117,375,74,92,0,0
4111,665,231,788,623,7,17,9,123,392,75,92,0,0
4112,670,235,796,638,7,17,9,126,403,76,92,0,0
4113,672,241,801,657,7,17,9,129,416,77,92,0,0
4114,681,256,817,693,7,17,9,136,437,78,92,0,0
4115,698,260,840,713,7,17,9,142,453,79,92,0,0
4116,707,271,861,764,7,17,9,154,493,80,92,0,0
4117,711,284,873,804,7,17,9,162,520,81,92,0,0
4118,717,292,882,820,7,17,9,165,528,82,92,0,0
4119,719,318,894,877,7,17,9,175,559,83,92,0,0
4120,731,339,917,928,7,17,9,186,589,84,92,0,0
4121,729,350,921,950,7,17,9,192,600,85,92,0,0
4122,700,377,906,1026,7,17,9,206,649,86,92,0,0
4123,667,402,877,1065,7,17,9,210,663,87,92,0,0
4124,639,426,849,1079,7,17,9,210,653,88,92,0,0
4125,616,455,828,1079,7,17,9,212,624,89,92,0,0
4126,549,479,760,1080,7,17,9,211,601,90,92,0,0
4127,447,499,654,1080,7,17,9,207,581,91,92,0,0
4128,429,514,638,1080,7,17,9,209,566,92,92,1,0
4127,175,409,387,1062,20,17,9,212,653,0,1,0,0
4128,268,523,451,1077,20,17,9,183,554,1,1,0,0
4128,45,429,305,1034,21,17,9,260,605,0,4,0,0
4129,0,450,246,1059,21,17,9,246,609,1,4,0,0
4130,41,547,266,1072,21,17,9,225,525,2,4,0,0
4131,17,631,210,1080,21,17,9,193,449,3,4,0,0
4132,17,690,188,1080,21,17,9,171,390,4,4,0,0
4129,159,554,380,1078,22,17,9,221,524,0,0,0,0
4395,434,85,469,202,26,17,9,35,117,0,76,0,0
4396,433,81,469,207,26,17,9,36,126,1,76,0,0
4397,434,79,470,207,26,17,9,36,128,2,76,0,0
4398,434,81,470,210,26,17,9,36,129,3,76,0,0
4399,435,83,471,212,26,17,9,36,129,4,76,0,0
4400,433,81,470,212,26,17,9,37,131,5,76,0,0
4401,432,84,469,214,26,17,9,37,130,6,76,0,0
4402,432,87,468,217,26,17,9,36,130,7,76,0,0
4403,432,90,468,218,26,17,9,36,128,8,76,0,0
4404,433,93,469,219,26,17,9,36,126,9,76,0,0
4406,432,95,468,222,26,17,9,36,127,0,76,0,1
4407,431,96,469,226,26,17,9,38,130,1,76,0,0
4408,432,92,470,224,26,17,9,38,132,2,76,0,0
4409,434,91,473,227,26,17,9,39,136,3,76,0,0
4410,435,93,474,228,26,17,9,39,135,4,76,0,0
4411,434,91,475,233,26,17,9,41,142,5,76,0,0
4412,434,89,477,239,26,17,9,43,150,6,76,0,0
4413,435,89,478,238,26,17,9,43,149,7,76,0,0
4414,436,88,482,246,26,17,9,46,158,8,76,0,0
4415,440,102,482,247,26,17,9,42,145,9,76,0,0
4416,441,99,484,248,26,17,9,43,149,10,76,0,0
4417,441,93,487,253,26,17,9,46,160,11,76,0,0
4418,446,105,490,256,26,17,9,44,151,12,76,0,0
4419,446,100,492,257,26,17,9,46,157,13,76,0,0
4420,450,117,492,258,26,17,9,42,141,14,76,0,0
4421,452,124,492,259,26,17,9,40,135,15,76,0,0
4422,452,123,494,263,26,17,9,42,140,16,76,0,0
4423,452,125,495,268,26,17,9,43,143,17,76,0,0
4424,454,126,496,269,26,17,9,42,143,18,76,0,0
4425,454,128,498,274,26,17,9,44,146,19,76,0,0
4426,455,130,499,276,26,17,9,44,146,20,76,0,0
4427,453,128,498,280,26,17,9,45,152,21,76,0,0
4428,452,130,499,288,26,17,9,47,158,22,76,0,0
4429,455,134,502,287,26,17,9,47,153,23,76,0,0
4430,455,134,504,294,26,17,9,49,160,24,76,0,0
4431,455,137,504,298,26,17,9,49,161,25,76,0,0
4432,455,138,504,301,26,17,9,49,163,26,76,0,0
4433,453,143,503,308,26,17,9,50,165,27,76,0,0
4434,454,145,505,312,26,17,9,51,167,28,76,0,0
4435,453,145,507,320,26,17,9,54,175,29,76,0,0
4436,453,147,507,326,26,17,9,54,179,30,76,0,0
4437,451,149,505,329,26,17,9,54,180,31,76,0,0
4438,449,151,504,335,26,17,9,55,184,32,76,0,0
4439,448,154,505,341,26,17,9,57,187,33,76,0,0
4440,447,154,506,348,26,17,9,59,194,34,76,0,0
4441,446,155,507,357,26,17,9,61,202,35,76,0,0
4442,443,155,506,363,26,17,9,63,208,36,76,0,0
4443,441,156,505,368,26,17,9,64,212,37,76,0,0
4444,440,163,506,381,26,17,9,66,218,38,76,0,0
4445,443,165,508,385,26,17,9,65,220,39,76,0,0
4446,444,169,512,395,26,17,9,68,226,40,76,0,0
4447,443,169,514,404,26,17,9,71,235,41,76,0,0
4448,441,169,513,410,26,17,9,72,241,42,76,0,0
4449,442,175,517,424,26,17,9,75,249,43,76,0,0
4450,448,179,523,427,26,17,9,75,248,44,76,0,0
4451,454,180,532,439,26,17,9,78,259,45,76,0,0
4452,458,186,538,453,26,17,9,80,267,46,76,0,0
4453,459,189,541,459,26,17,9,82,270,47,76,0,0
4454,458,192,544,474,26,17,9,86,282,48,76,0,0
4455,463,198,552,490,26,17,9,89,292,49,76,0,0
4456,465,199,557,497,26,17,9,92,298,50,76,0,0
4457,468,208,563,519,26,17,9,95,311,51,76,0,0
4458,467,211,566,533,26,17,9,99,322,52,76,0,0
4459,465,214,567,543,26,17,9,102,329,53,76,0,0
4460,466,226,574,572,26,17,9,108,346,54,76,0,0
4461,470,230,582,585,26,17,9,112,355,55,76,0,0
4462,467,236,587,619,26,17,9,120,383,56,76,0,0
4463,465,244,591,643,26,17,9,126,399,57,76,0,0
4464,466,251,593,653,26,17,9,127,402,58,76,0,0
4465,465,263,601,691,26,17,9,136,428,59,76,0,0
4466,467,274,609,716,26,17,9,142,442,60,76,0,0
4467,465,279,609,728,26,17,9,144,449,61,76,0,0
4468,465,292,622,783,26,17,9,157,491,62,76,0,0
4469,463,304,624,808,26,17,9,161,504,63,76,0,0
4470,461,320,633,854,26,17,9,172,534,64,76,0,0
4471,459,341,642,901,26,17,9,183,560,65,76,0,0
4472,457,353,642,920,26,17,9,185,567,66,76,0,0
4473,446,378,648,989,26,17,9,202,611,67,76,0,0
4474,410,399,620,1026,26,17,9,210,627,68,76,0,0
4475,362,417,582,1064,26,17,9,220,647,69,76,0,0
4476,307,452,532,1076,26,17,9,225,624,70,76,0,0
4477,228,485,457,1080,26,17,9,229,595,71,76,0,0
4478,153,512,390,1080,26,17,9,237,568,72,76,0,0
4479,85,537,323,1080,26,17,9,238,543,73,76,0,0
4480,18,562,237,1072,26,17,9,219,510,74,76,0,0
4481,0,668,166,1080,26,17,9,166,412,75,76,0,0
4482,0,697,130,1080,26,17,9,130,383,76,76,1,0
4901,1645,491,1680,571,34,17,9,35,80,0,1,0,0
4905,1646,495,1681,569,34,17,9,35,74,0,1,0,0
4906,1647,495,1682,570,34,17,9,35,75,1,1,0,0
4910,1646,493,1683,571,34,17,9,37,78,0,1,0,0
4912,1647,494,1682,567,34,17,9,35,73,0,1,0,0
4913,1646,493,1681,563,34,17,9,35,70,1,1,0,0
4954,1647,494,1682,570,36,17,9,35,76,0,0,0,0
4963,1646,492,1683,562,38,17,9,37,70,0,0,0,0
5011,1646,494,1683,564,39,17,9,37,70,0,1,0,0
5020,1644,493,1686,572,39,17,9,42,79,0,1,0,0
5021,1644,493,1686,573,39,17,9,42,80,1,1,0,0
5030,1643,494,1682,569,39,17,9,39,75,0,1,0,0
5031,1643,494,1682,569,39,17,9,39,75,1,1,0,0
5083,3,499,165,960,40,17,9,162,461,0,1,0,0
5084,56,462,263,1051,40,17,9,207,589,1,1,0,0
5085,150,437,530,1073,41,17,9,380,636,0,66,0,1
5086,198,426,585,1076,41,17,9,387,650,1,66,0,0
5087,243,396,633,1059,41,17,9,390,663,2,66,0,0
5088,310,375,705,1055,41,17,9,395,680,3,66,0,0
5089,384,348,742,975,41,17,9,358,627,4,66,0,0
5090,446,329,786,934,41,17,9,340,605,5,66,0,0
5091,497,310,803,868,41,17,9,306,558,6,66,0,0
5092,535,288,820,820,41,17,9,285,532,7,66,0,0
5093,556,282,824,794,41,17,9,268,512,8,66,0,0
5094,582,267,821,736,41,17,9,239,469,9,66,0,0
5095,594,254,821,712,41,17,9,227,458,10,66,0,0
5096,615,243,819,666,41,17,9,204,423,11,66,0,0
5097,631,227,822,634,41,17,9,191,407,12,66,0,0
5098,637,224,817,617,41,17,9,180,393,13,66,0,0
5099,640,214,801,573,41,17,9,161,359,14,66,0,0
5100,640,205,792,555,41,17,9,152,350,15,66,0,0
5101,642,202,786,541,41,17,9,144,339,16,66,0,0
5102,644,193,777,512,41,17,9,133,319,17,66,0,0
5103,638,187,767,499,41,17,9,129,312,18,66,0,0
5104,629,183,749,477,41,17,9,120,294,19,66,0,0
5105,621,174,739,467,41,17,9,118,293,20,66,0,0
5106,616,173,729,459,41,17,9,113,286,21,66,0,0
5107,612,166,720,444,41,17,9,108,278,22,66,0,0
5108,607,163,710,433,41,17,9,103,270,23,66,0,0
5109,601,160,697,416,41,17,9,96,256,24,66,0,0
5110,594,156,688,406,41,17,9,94,250,25,66,0,0
5111,589,154,681,399,41,17,9,92,245,26,66,0,0
5112,587,150,673,385,41,17,9,86,235,27,66,0,0
5113,585,145,668,374,41,17,9,83,229,28,66,0,0
5114,581,144,661,367,41,17,9,80,223,29,66,0,0
5115,575,138,654,359,41,17,9,79,221,30,66,0,0
5116,571,138,648,357,41,17,9,77,219,31,66,0,0
5117,569,138,643,347,41,17,9,74,209,32,66,0,0
5118,568,136,639,340,41,17,9,71,204,33,66,0,0
5119,565,137,633,334,41,17,9,68,197,34,66,0,0
5120,561,132,626,325,41,17,9,65,193,35,66,0,0
5121,559,131,623,319,41,17,9,64,188,36,66,0,0
5122,558,128,619,309,41,17,9,61,181,37,66,0,0
5123,555,121,617,304,41,17,9,62,183,38,66,0,0
5124,552,121,613,301,41,17,9,61,180,39,66,0,0
5125,547,119,607,297,41,17,9,60,178,40,66,0,0
5126,547,119,604,290,41,17,9,57,171,41,66,0,0
5127,547,118,602,284,41,17,9,55,166,42,66,0,0
5128,546,116,600,280,41,17,9,54,164,43,66,0,0
5129,544,116,598,280,41,17,9,54,164,44,66,0,0
5130,542,116,594,274,41,17,9,52,158,45,66,0,0
5131,541,115,591,265,41,17,9,50,150,46,66,0,0
5132,542,113,590,256,41,17,9,48,143,47,66,0,0
5133,540,111,588,253,41,17,9,48,142,48,66,0,0
5134,539,113,586,252,41,17,9,47,139,49,66,0,0
5135,535,111,583,253,41,17,9,48,142,50,66,0,0
5136,533,110,580,251,41,17,9,47,141,51,66,0,0
5137,533,111,578,246,41,17,9,45,135,52,66,0,0
5138,532,108,577,242,41,17,9,45,134,53,66,0,0
5139,531,108,576,242,41,17,9,45,134,54,66,0,0
5140,529,107,574,241,41,17,9,45,134,55,66,0,0
5141,529,106,572,233,41,17,9,43,127,56,66,0,0
5142,530,107,570,224,41,17,9,40,117,57,66,0,0
5143,530,104,570,221,41,17,9,40,117,58,66,0,0
5144,529,106,570,224,41,17,9,41,118,59,66,0,0
5145,529,104,567,216,41,17,9,38,112,60,66,0,0
5146,528,101,567,215,41,17,9,39,114,61,66,0,0
5147,527,102,565,212,41,17,9,38,110,62,66,0,0
5148,528,100,565,207,41,17,9,37,107,63,66,0,0
5149,526,99,564,208,41,17,9,38,109,64,66,0,0
5150,524,97,562,206,41,17,9,38,109,65,66,0,0
5151,523,96,558,197,41,17,9,35,101,66,66,1,0
5159,508,96,543,194,41,17,9,35,98,0,66,0,0
5160,506,96,541,195,41,17,9,35,99,1,66,0,0
5525,3,840,108,1080,42,17,9,105,240,0,24,0,1
5526,4,761,144,1080,42,17,9,140,319,1,24,0,0
5527,2,647,188,1073,42,17,9,186,426,2,24,0,0
5528,35,591,249,1072,42,17,9,214,481,3,24,0,0
5529,83,569,309,1069,42,17,9,226,500,4,24,0,0
5530,156,556,389,1067,42,17,9,233,511,5,24,0,0
5531,240,546,482,1065,42,17,9,242,519,6,24,0,0
5532,323,546,570,1069,42,17,9,247,523,7,24,0,0
5533,419,541,672,1066,42,17,9,253,525,8,24,0,0
5534,512,526,777,1068,42,17,9,265,542,9,24,0,0
5535,606,528,876,1071,42,17,9,270,543,10,24,0,0
5536,686,518,966,1073,42,17,9,280,555,11,24,0,0
5537,760,509,1049,1074,42,17,9,289,565,12,24,0,0
5538,829,511,1116,1069,42,17,9,287,558,13,24,0,0
5539,900,515,1185,1074,42,17,9,285,559,14,24,0,0
5540,961,502,1251,1076,42,17,9,290,574,15,24,0,0
5541,1012,497,1303,1078,42,17,9,291,581,16,24,0,0
5542,1061,500,1350,1078,42,17,9,289,578,17,24,0,0
5543,1093,494,1384,1078,42,17,9,291,584,18,24,0,0
5544,1110,498,1401,1077,42,17,9,291,579,19,24,0,0
5545,1122,487,1418,1075,42,17,9,296,588,20,24,0,0
5546,1121,483,1415,1075,42,17,9,294,592,21,24,0,0
5547,1093,478,1385,1078,42,17,9,292,600,22,24,0,0
5548,1058,482,1343,1079,42,17,9,285,597,23,24,0,0
5549,1085,473,1374,1079,42,17,9,289,606,24,24,1,0
5542,1285,613,1339,689,43,17,9,54,76,0,0,0,0
5549,963,493,1190,1080,44,17,9,227,587,0,12,0,0
5550,880,489,1109,1077,44,17,9,229,588,1,12,0,0
5551,811,484,1041,1075,44,17,9,230,591,2,12,0,0
5552,728,474,963,1077,44,17,9,235,603,3,12,0,0
5553,661,489,892,1073,44,17,9,231,584,4,12,0,0
5554,562,498,791,1075,44,17,9,229,577,5,12,0,0
5555,470,512,697,1077,44,17,9,227,565,6,12,0,0
5556,374,521,601,1074,44,17,9,227,553,7,12,0,0
5557,255,531,479,1073,44,17,9,224,542,8,12,0,0
5558,166,550,385,1065,44,17,9,219,515,9,12,0,0
5559,58,568,269,1063,44,17,9,211,495,10,12,0,0
5560,0,602,181,1074,44,17,9,181,472,11,12,0,0
5561,0,615,90,1074,44,17,9,90,459,12,12,0,0
5630,494,92,529,186,45,17,9,35,94,0,84,0,0
5631,496,91,531,186,45,17,9,35,95,1,84,0,0
5632,498,93,533,187,45,17,9,35,94,2,84,0,0
5634,499,95,534,192,45,17,9,35,97,0,84,0,1
5635,499,96,535,196,45,17,9,36,100,1,84,0,0
5636,500,94,536,197,45,17,9,36,103,2,84,0,0
5637,501,95,538,198,45,17,9,37,103,3,84,0,0
5638,500,95,538,200,45,17,9,38,105,4,84,0,0
5639,498,94,536,202,45,17,9,38,108,5,84,0,0
5640,498,95,537,205,45,17,9,39,110,6,84,0,0
5641,498,93,537,205,45,17,9,39,112,7,84,0,0
5642,499,94,540,207,45,17,9,41,113,8,84,0,0
5643,499,94,540,209,45,17,9,41,115,9,84,0,0
5644,498,94,539,210,45,17,9,41,116,10,84,0,0
5645,499,98,539,214,45,17,9,40,116,11,84,0,0
5646,502,95,544,217,45,17,9,42,122,12,84,0,0
5647,504,97,546,218,45,17,9,42,121,13,84,0,0
5648,507,100,548,221,45,17,9,41,121,14,84,0,0
5649,507,95,550,223,45,17,9,43,128,15,84,0,0
5650,509,101,551,225,45,17,9,42,124,16,84,0,0
5651,513,101,555,226,45,17,9,42,125,17,84,0,0
5652,517,101,559,226,45,17,9,42,125,18,84,0,0
5653,520,105,561,226,45,17,9,41,121,19,84,0,0
5654,519,103,563,233,45,17,9,44,130,20,84,0,0
5655,519,103,565,238,45,17,9,46,135,21,84,0,0
5656,521,101,568,241,45,17,9,47,140,22,84,0,0
5657,523,103,570,242,45,17,9,47,139,23,84,0,0
5658,523,106,570,245,45,17,9,47,139,24,84,0,0
5659,522,106,570,248,45,17,9,48,142,25,84,0,0
5660,523,108,571,251,45,17,9,48,143,26,84,0,0
5661,526,108,575,254,45,17,9,49,146,27,84,0,0
5662,528,109,578,257,45,17,9,50,148,28,84,0,0
5663,528,112,578,261,45,17,9,50,149,29,84,0,0
5664,527,113,579,266,45,17,9,52,153,30,84,0,0
5665,528,115,580,272,45,17,9,52,157,31,84,0,0
5666,530,114,584,276,45,17,9,54,162,32,84,0,0
5667,532,115,587,279,45,17,9,55,164,33,84,0,0
5668,533,116,588,283,45,17,9,55,167,34,84,0,0
5669,532,115,589,289,45,17,9,57,174,35,84,0,0
5670,537,116,594,293,45,17,9,57,177,36,84,0,0
5671,544,116,602,295,45,17,9,58,179,37,84,0,0
5672,549,117,608,302,45,17,9,59,185,38,84,0,0
5673,552,120,613,307,45,17,9,61,187,39,84,0,0
5674,556,119,616,308,45,17,9,60,189,40,84,0,0
5675,559,121,619,311,45,17,9,60,190,41,84,0,0
5676,565,122,626,317,45,17,9,61,195,42,84,0,0
5677,569,123,632,324,45,17,9,63,201,43,84,0,0
5678,572,126,636,332,45,17,9,64,206,44,84,0,0
5679,572,125,636,335,45,17,9,64,210,45,84,0,0
5680,574,132,639,344,45,17,9,65,212,46,84,0,0
5681,578,138,644,350,45,17,9,66,212,47,84,0,0
5682,582,138,650,359,45,17,9,68,221,48,84,0,0
5683,584,142,654,369,45,17,9,70,227,49,84,0,0
5684,584,140,654,372,45,17,9,70,232,50,84,0,0
5685,586,144,658,383,45,17,9,72,239,51,84,0,0
5686,592,145,667,393,45,17,9,75,248,52,84,0,0
5687,599,143,676,397,45,17,9,77,254,53,84,0,0
5688,603,150,682,408,45,17,9,79,258,54,84,0,0
5689,605,154,686,416,45,17,9,81,262,55,84,0,0
5690,606,150,692,433,45,17,9,86,283,56,84,0,0
5691,615,154,705,447,45,17,9,90,293,57,84,0,0
5692,626,157,717,455,45,17,9,91,298,58,84,0,0
5693,635,166,730,475,45,17,9,95,309,59,84,0,0
5694,642,171,739,484,45,17,9,97,313,60,84,0,0
5695,648,175,748,497,45,17,9,100,322,61,84,0,0
5696,661,182,764,516,45,17,9,103,334,62,84,0,0
5697,676,184,782,527,45,17,9,106,343,63,84,0,0
5698,692,200,800,549,45,17,9,108,349,64,84,0,0
5699,697,206,810,570,45,17,9,113,364,65,84,0,0
5700,705,207,824,593,45,17,9,119,386,66,84,0,0
5701,719,222,842,622,45,17,9,123,400,67,84,0,0
5702,736,227,864,644,45,17,9,128,417,68,84,0,0
5703,748,244,888,691,45,17,9,140,447,69,84,0,0
5704,754,255,897,710,45,17,9,143,455,70,84,0,0
5705,755,264,910,756,45,17,9,155,492,71,84,0,0
5706,765,277,927,801,45,17,9,162,524,72,84,0,0
5707,786,289,955,825,45,17,9,169,536,73,84,0,0
5708,798,311,988,902,45,17,9,190,591,74,84,0,0
5709,809,328,1005,930,45,17,9,196,602,75,84,0,0
5710,814,352,1026,1002,45,17,9,212,650,76,84,0,0
5711,835,380,1056,1055,45,17,9,221,675,77,84,0,0
5712,885,400,1111,1075,45,17,9,226,675,78,84,0,0
5713,949,444,1172,1080,45,17,9,223,636,79,84,0,0
5714,996,484,1215,1080,45,17,9,219,596,80,84,0,0
5715,1045,557,1250,1080,45,17,9,205,523,81,84,0,0
5716,1168,640,1364,1080,45,17,9,196,440,82,84,0,0
5717,1284,721,1469,1080,45,17,9,185,359,83,84,0,0
5718,1336,759,1511,1080,45,17,9,175,321,84,84,1,0
1170,1257,184,1342,439,1,19,1,85,255,0,36,0,1
1171,1260,186,1346,445,1,19,1,86,259,1,36,0,0
1172,1263,183,1352,451,1,19,1,89,268,2,36,0,0
1173,1271,186,1364,463,1,19,1,93,277,3,36,0,0
1174,1276,191,1371,472,1,19,1,95,281,4,36,0,0
1175,1282,193,1378,474,1,19,1,96,281,5,36,0,0
1176,1289,199,1391,496,1,19,1,102,297,6,36,0,0
1177,1292,201,1397,509,1,19,1,105,308,7,36,0,0
1178,1289,202,1399,523,1,19,1,110,321,8,36,0,0
1179,1284,209,1397,541,1,19,1,113,332,9,36,0,0
1180,1277,214,1392,552,1,19,1,115,338,10,36,0,0
1181,1268,219,1388,573,1,19,1,120,354,11,36,0,0
1182,1262,227,1386,592,1,19,1,124,365,12,36,0,0
1183,1255,229,1379,594,1,19,1,124,365,13,36,0,0
1184,1242,237,1371,619,1,19,1,129,382,14,36,0,0
1185,1229,245,1362,641,1,19,1,133,396,15,36,0,0
1186,1209,248,1344,645,1,19,1,135,397,16,36,0,0
1187,1188,258,1332,683,1,19,1,144,425,17,36,0,0
1188,1176,269,1328,713,1,19,1,152,444,18,36,0,0
1189,1157,275,1312,727,1,19,1,155,452,19,36,0,0
1190,1132,288,1298,772,1,19,1,166,484,20,36,0,0
1191,1104,301,1272,791,1,19,1,168,490,21,36,0,0
1192,1064,312,1244,841,1,19,1,180,529,22,36,0,0
1193,1031,332,1220,882,1,19,1,189,550,23,36,0,0
1194,1002,345,1196,909,1,19,1,194,564,24,36,0,0
1195,973,364,1175,953,1,19,1,202,589,25,36,0,0
1196,938,392,1146,999,1,19,1,208,607,26,36,0,0
1197,883,404,1101,1036,1,19,1,218,632,27,36,0,0
1198,832,434,1056,1068,1,19,1,224,634,28,36,0,0
1199,796,465,1018,1080,1,19,1,222,615,29,36,0,0
1200,774,497,990,1080,1,19,1,216,583,30,36,0,0
1201,740,546,948,1080,1,19,1,208,534,31,36,0,0
1202,687,590,891,1080,1,19,1,204,490,32,36,0,0
1203,634,641,835,1080,1,19,1,201,439,33,36,0,0
1204,602,728,789,1080,1,19,1,187,352,34,36,0,0
1205,566,806,734,1080,1,19,1,168,274,35,36,0,0
1206,540,849,690,1080,1,19,1,150,231,36,36,1,0
1877,1038,460,1251,1073,4,19,1,213,613,0,35,0,1
1878,1069,448,1284,1066,4,19,1,215,618,1,35,0,0
1879,1122,421,1323,1000,4,19,1,201,579,2,35,0,0
1880,1161,403,1362,982,4,19,1,201,579,3,35,0,0
1881,1184,381,1386,966,4,19,1,202,585,4,35,0,0
1882,1219,359,1402,887,4,19,1,183,528,5,35,0,0
1883,1246,341,1423,851,4,19,1,177,510,6,35,0,0
1884,1264,334,1436,830,4,19,1,172,496,7,35,0,0
1885,1294,321,1452,778,4,19,1,158,457,8,35,0,0
1886,1315,310,1472,760,4,19,1,157,450,9,35,0,0
1887,1328,303,1483,750,4,19,1,155,447,10,35,0,0
1888,1340,288,1485,705,4,19,1,145,417,11,35,0,0
1889,1355,282,1494,683,4,19,1,139,401,12,35,0,0
1890,1368,277,1503,672,4,19,1,135,395,13,35,0,0
1891,1385,264,1514,646,4,19,1,129,382,14,35,0,0
1892,1396,260,1522,628,4,19,1,126,368,15,35,0,0
1893,1400,257,1524,616,4,19,1,124,359,16,35,0,0
1894,1400,243,1519,590,4,19,1,119,347,17,35,0,0
1895,1398,236,1516,579,4,19,1,118,343,18,35,0,0
1896,1399,233,1514,571,4,19,1,115,338,19,35,0,0
1897,1403,229,1514,555,4,19,1,111,326,20,35,0,0
1898,1405,225,1511,534,4,19,1,106,309,21,35,0,0
1899,1400,223,1504,525,4,19,1,104,302,22,35,0,0
1900,1389,215,1491,508,4,19,1,102,293,23,35,0,0
1901,1381,209,1481,497,4,19,1,100,288,24,35,0,0
1902,1374,208,1474,495,4,19,1,100,287,25,35,0,0
1903,1369,205,1465,482,4,19,1,96,277,26,35,0,0
1904,1358,201,1451,466,4,19,1,93,265,27,35,0,0
1905,1345,204,1436,461,4,19,1,91,257,28,35,0,0
1906,1332,200,1423,452,4,19,1,91,252,29,35,0,0
1907,1312,199,1399,441,4,19,1,87,242,30,35,0,0
1908,1293,198,1380,438,4,19,1,87,240,31,35,0,0
1909,1275,199,1361,432,4,19,1,86,233,32,35,0,0
1910,1258,196,1339,420,4,19,1,81,224,33,35,0,0
1911,1251,202,1330,423,4,19,1,79,221,34,35,0,0
1912,1241,200,1317,414,4,19,1,76,214,35,35,1,0
1,233,278,306,504,1,19,10,73,226,0,57,0,1
2,227,280,299,503,1,19,10,72,223,1,57,0,0
3,221,278,291,498,1,19,10,70,220,2,57,0,0
4,217,277,287,492,1,19,10,70,215,3,57,0,0
5,215,279,283,490,1,19,10,68,211,4,57,0,0
6,210,281,277,489,1,19,10,67,208,5,57,0,0
7,203,274,270,481,1,19,10,67,207,6,57,0,0
8,195,277,262,484,1,19,10,67,207,7,57,0,0
9,188,270,253,470,1,19,10,65,200,8,57,0,0
10,182,266,249,470,1,19,10,67,204,9,57,0,0
11,180,260,252,479,1,19,10,72,219,10,57,0,0
12,174,259,241,461,1,19,10,67,202,11,57,0,0
13,167,261,231,455,1,19,10,64,194,12,57,0,0
14,164,260,228,445,1,19,10,64,185,13,57,0,0
15,160,258,224,441,1,19,10,64,183,14,57,0,0
16,159,258,220,430,1,19,10,61,172,15,57,0,0
17,153,250,217,428,1,19,10,64,178,16,57,0,0
18,148,245,213,429,1,19,10,65,184,17,57,0,0
19,144,242,208,423,1,19,10,64,181,18,57,0,0
20,142,239,205,419,1,19,10,63,180,19,57,0,0
21,141,239,202,415,1,19,10,61,176,20,57,0,0
22,142,237,202,411,1,19,10,60,174,21,57,0,0
23,141,235,199,403,1,19,10,58,168,22,57,0,0
24,138,236,196,404,1,19,10,58,168,23,57,0,0
25,135,235,192,402,1,19,10,57,167,24,57,0,0
26,134,233,191,400,1,19,10,57,167,25,57,0,0
27,138,235,191,394,1,19,10,53,159,26,57,0,0
28,139,234,192,390,1,19,10,53,156,27,57,0,0
29,141,234,193,388,1,19,10,52,154,28,57,0,0
30,140,233,193,386,1,19,10,53,153,29,57,0,0
31,140,233,192,382,1,19,10,52,149,30,57,0,0
32,143,232,194,380,1,19,10,51,148,31,57,0,0
33,146,231,197,377,1,19,10,51,146,32,57,0,0
34,147,230,199,374,1,19,10,52,144,33,57,0,0
35,147,230,197,371,1,19,10,50,141,34,57,0,0
36,143,229,193,367,1,19,10,50,138,35,57,0,0
37,142,230,192,368,1,19,10,50,138,36,57,0,0
38,142,231,190,366,1,19,10,48,135,37,57,0,0
39,141,228,188,362,1,19,10,47,134,38,57,0,0
40,138,230,184,360,1,19,10,46,130,39,57,0,0
41,135,227,182,358,1,19,10,47,131,40,57,0,0
42,134,227,180,356,1,19,10,46,129,41,57,0,0
43,133,229,178,354,1,19,10,45,125,42,57,0,0
44,132,228,176,351,1,19,10,44,123,43,57,0,0
45,130,230,173,349,1,19,10,43,119,44,57,0,0
46,127,231,168,345,1,19,10,41,114,45,57,0,0
47,126,232,165,341,1,19,10,39,109,46,57,0,0
48,128,233,166,339,1,19,10,38,106,47,57,0,0
49,128,231,168,338,1,19,10,40,107,48,57,0,0
50,127,231,165,335,1,19,10,38,104,49,57,0,0
51,124,229,162,333,1,19,10,38,104,50,57,0,0
52,122,227,160,330,1,19,10,38,103,51,57,0,0
53,123,226,160,330,1,19,10,37,104,52,57,0,0
54,125,225,161,326,1,19,10,36,101,53,57,0,0
55,126,224,163,326,1,19,10,37,102,54,57,0,0
56,126,223,162,323,1,19,10,36,100,55,57,0,0
57,125,219,161,319,1,19,10,36,100,56,57,0,0
58,126,218,161,317,1,19,10,35,99,57,57,1,0
61,128,214,163,313,1,19,10,35,99,0,57,0,0
62,127,212,162,311,1,19,10,35,99,1,57,0,0
63,125,209,160,308,1,19,10,35,99,2,57,0,0
1112,156,200,192,301,2,19,10,36,101,0,23,0,0
1113,156,200,192,303,2,19,10,36,103,1,23,0,0
1115,158,203,194,306,2,19,10,36,103,0,23,0,1
1116,158,203,195,309,2,19,10,37,106,1,23,0,0
1117,158,205,194,309,2,19,10,36,104,2,23,0,0
1118,158,205,195,310,2,19,10,37,105,3,23,0,0
1119,157,205,195,313,2,19,10,38,108,4,23,0,0
1120,157,206,195,314,2,19,10,38,108,5,23,0,0
1121,158,206,197,315,2,19,10,39,109,6,23,0,0
1122,158,207,198,317,2,19,10,40,110,7,23,0,0
1123,157,209,197,319,2,19,10,40,110,8,23,0,0
1124,157,210,198,323,2,19,10,41,113,9,23,0,0
1125,159,210,200,325,2,19,10,41,115,10,23,0,0
1126,160,209,204,329,2,19,10,44,120,11,23,0,0
1127,163,210,208,332,2,19,10,45,122,12,23,0,0
1128,164,207,212,338,2,19,10,48,131,13,23,0,0
1129,166,207,215,342,2,19,10,49,135,14,23,0,0
1130,174,209,222,343,2,19,10,48,134,15,23,0,0
1131,181,214,229,345,2,19,10,48,131,16,23,0,0
1132,189,220,234,341,2,19,10,45,121,17,23,0,0
1133,200,221,245,342,2,19,10,45,121,18,23,0,0
1134,211,224,256,344,2,19,10,45,120,19,23,0,0
1135,226,226,268,339,2,19,10,42,113,20,23,0,0
1136,231,228,273,341,2,19,10,42,113,21,23,0,0
1137,241,228,285,346,2,19,10,44,118,22,23,0,0
1138,247,229,291,348,2,19,10,44,119,23,23,1,0
3741,1817,902,1920,1078,3,19,10,103,176,0,3,0,0
3742,1771,861,1898,1078,3,19,10,127,217,1,3,0,0
3743,1713,857,1844,1077,3,19,10,131,220,2,3,0,0
3744,1686,850,1821,1077,3,19,10,135,227,3,3,0,0
3744,1555,831,1750,1074,4,19,10,195,243,0,0,0,0
3745,1435,789,1649,1074,5,19,10,214,285,0,0,0,0
3746,1321,772,1526,1078,6,19,10,205,306,0,0,0,0
3747,1156,715,1426,1077,7,19,10,270,362,0,27,0,1
3748,1075,685,1365,1074,7,19,10,290,389,1,27,0,0
3749,963,662,1270,1075,7,19,10,307,413,2,27,0,0
3750,856,607,1193,1065,7,19,10,337,458,3,27,0,0
3751,767,561,1134,1066,7,19,10,367,505,4,27,0,0
3752,702,541,1077,1071,7,19,10,375,530,5,27,0,0
3753,642,508,1034,1075,7,19,10,392,567,6,27,0,0
3754,591,491,978,1068,7,19,10,387,577,7,27,0,0
3755,552,470,935,1061,7,19,10,383,591,8,27,0,0
3756,530,446,883,1008,7,19,10,353,562,9,27,0,0
3757,508,427,847,987,7,19,10,339,560,10,27,0,0
3758,496,416,809,955,7,19,10,313,539,11,27,0,0
3759,490,400,769,897,7,19,10,279,497,12,27,0,0
3760,473,400,729,870,7,19,10,256,470,13,27,0,0
3761,460,380,695,828,7,19,10,235,448,14,27,0,0
3762,454,364,675,797,7,19,10,221,433,15,27,0,0
3763,452,356,666,786,7,19,10,214,430,16,27,0,0
3764,451,344,642,743,7,19,10,191,399,17,27,0,0
3765,451,334,631,722,7,19,10,180,388,18,27,0,0
3766,450,334,619,707,7,19,10,169,373,19,27,0,0
3767,450,325,605,674,7,19,10,155,349,20,27,0,0
3768,458,318,606,661,7,19,10,148,343,21,27,0,0
3769,469,316,609,646,7,19,10,140,330,22,27,0,0
3770,486,308,621,632,7,19,10,135,324,23,27,0,0
3771,501,308,633,630,7,19,10,132,322,24,27,0,0
3772,522,308,643,613,7,19,10,121,305,25,27,0,0
3773,538,309,648,599,7,19,10,110,290,26,27,0,0
3774,539,303,644,582,7,19,10,105,279,27,27,1,0
4963,895,377,991,768,8,19,10,96,391,0,60,0,1
4964,873,371,970,763,8,19,10,97,392,1,60,0,0
4965,848,372,945,761,8,19,10,97,389,2,60,0,0
4966,800,364,903,767,8,19,10,103,403,3,60,0,0
4967,756,363,856,752,8,19,10,100,389,4,60,0,0
4968,679,354,791,771,8,19,10,112,417,5,60,0,0
4969,622,346,735,755,8,19,10,113,409,6,60,0,0
4970,566,341,682,753,8,19,10,116,412,7,60,0,0
4971,507,338,628,753,8,19,10,121,415,8,60,0,0
4972,465,324,584,731,8,19,10,119,407,9,60,0,0
4973,419,316,535,712,8,19,10,116,396,10,60,0,0
4974,381,310,494,693,8,19,10,113,383,11,60,0,0
4975,351,298,460,670,8,19,10,109,372,12,60,0,0
4976,324,297,429,663,8,19,10,105,366,13,60,0,0
4977,299,288,399,631,8,19,10,100,343,14,60,0,0
4978,283,284,381,619,8,19,10,98,335,15,60,0,0
4979,267,285,361,606,8,19,10,94,321,16,60,0,0
4980,253,274,343,581,8,19,10,90,307,17,60,0,0
4981,237,271,324,571,8,19,10,87,300,18,60,0,0
4982,229,272,311,548,8,19,10,82,276,19,60,0,0
4983,222,268,302,539,8,19,10,80,271,20,60,0,0
4984,212,266,295,547,8,19,10,83,281,21,60,0,0
4985,205,259,283,526,8,19,10,78,267,22,60,0,0
4986,199,258,272,506,8,19,10,73,248,23,60,0,0
4987,193,254,262,493,8,19,10,69,239,24,60,0,0
4988,183,247,253,489,8,19,10,70,242,25,60,0,0
4989,180,257,247,490,8,19,10,67,233,26,60,0,0
4990,172,252,238,480,8,19,10,66,228,27,60,0,0
4991,168,246,232,467,8,19,10,64,221,28,60,0,0
4992,166,244,228,459,8,19,10,62,215,29,60,0,0
4993,162,240,221,441,8,19,10,59,201,30,60,0,0
4994,156,237,217,448,8,19,10,61,211,31,60,0,0
4995,152,234,212,445,8,19,10,60,211,32,60,0,0
4996,148,231,206,434,8,19,10,58,203,33,60,0,0
4997,147,229,205,431,8,19,10,58,202,34,60,0,0
4998,147,227,202,419,8,19,10,55,192,35,60,0,0
4999,147,227,202,415,8,19,10,55,188,36,60,0,0
5000,146,226,198,405,8,19,10,52,179,37,60,0,0
5001,146,225,198,399,8,19,10,52,174,38,60,0,0
5002,148,227,199,398,8,19,10,51,171,39,60,0,0
5003,148,221,198,390,8,19,10,50,169,40,60,0,0
5004,147,220,197,389,8,19,10,50,169,41,60,0,0
5005,146,221,193,380,8,19,10,47,159,42,60,0,0
5006,145,218,192,376,8,19,10,47,158,43,60,0,0
5007,145,218,192,375,8,19,10,47,157,44,60,0,0
5008,144,215,191,371,8,19,10,47,156,45,60,0,0
5009,144,214,189,366,8,19,10,45,152,46,60,0,0
5010,142,214,186,360,8,19,10,44,146,47,60,0,0
5011,142,211,185,354,8,19,10,43,143,48,60,0,0
5012,145,213,185,341,8,19,10,40,128,49,60,0,0
5013,143,209,185,347,8,19,10,42,138,50,60,0,0
5014,141,210,183,344,8,19,10,42,134,51,60,0,0
5015,139,211,180,342,8,19,10,41,131,52,60,0,0
5016,137,212,177,339,8,19,10,40,127,53,60,0,0
5017,139,213,175,324,8,19,10,36,111,54,60,0,0
5018,137,214,174,330,8,19,10,37,116,55,60,0,0
5019,135,211,172,328,8,19,10,37,117,56,60,0,0
5020,134,206,173,329,8,19,10,39,123,57,60,0,0
5021,133,204,170,325,8,19,10,37,121,58,60,0,0
5022,133,203,169,320,8,19,10,36,117,59,60,0,0
5023,135,205,170,317,8,19,10,35,112,60,60,1,0
5896,140,200,181,271,17,19,10,41,71,0,0,0,0
5904,152,209,193,281,18,19,10,41,72,0,0,0,0
5906,153,208,191,284,20,19,10,38,76,0,37,0,1
5907,151,208,190,287,20,19,10,39,79,1,37,0,0
5908,149,208,190,288,20,19,10,41,80,2,37,0,0
5909,149,208,189,289,20,19,10,40,81,3,37,0,0
5910,150,207,191,289,20,19,10,41,82,4,37,0,0
5911,151,207,191,289,20,19,10,40,82,5,37,0,0
5912,149,211,188,290,20,19,10,39,79,6,37,0,0
5913,147,212,185,290,20,19,10,38,78,7,37,0,0
5914,148,212,186,291,20,19,10,38,79,8,37,0,0
5915,149,210,188,292,20,19,10,39,82,9,37,0,0
5916,149,211,189,294,20,19,10,40,83,10,37,0,0
5917,149,215,187,295,20,19,10,38,80,11,37,0,0
5918,147,215,186,297,20,19,10,39,82,12,37,0,0
5919,144,217,184,301,20,19,10,40,84,13,37,0,0
5920,145,216,186,304,20,19,10,41,88,14,37,0,0
5921,145,216,187,304,20,19,10,42,88,15,37,0,0
5922,144,216,187,306,20,19,10,43,90,16,37,0,0
5923,143,215,188,309,20,19,10,45,94,17,37,0,0
5924,142,215,187,311,20,19,10,45,96,18,37,0,0
5925,141,215,188,314,20,19,10,47,99,19,37,0,0
5926,141,216,187,316,20,19,10,46,100,20,37,0,0
5927,141,218,187,318,20,19,10,46,100,21,37,0,0
5928,141,220,186,320,20,19,10,45,100,22,37,0,0
5929,139,220,185,322,20,19,10,46,102,23,37,0,0
5930,141,220,186,324,20,19,10,45,104,24,37,0,0
5931,141,219,189,330,20,19,10,48,111,25,37,0,0
5932,139,217,189,332,20,19,10,50,115,26,37,0,0
5933,143,212,196,335,20,19,10,53,123,27,37,0,0
5934,153,213,206,335,20,19,10,53,122,28,37,0,0
5935,158,213,211,338,20,19,10,53,125,29,37,0,0
5936,165,212,217,340,20,19,10,52,128,30,37,0,0
5937,174,215,226,342,20,19,10,52,127,31,37,0,0
5938,187,218,236,342,20,19,10,49,124,32,37,0,0
5939,196,216,245,342,20,19,10,49,126,33,37,0,0
5940,207,216,256,342,20,19,10,49,126,34,37,0,0
5941,223,214,265,322,20,19,10,42,108,35,37,0,0
5942,237,212,284,333,20,19,10,47,121,36,37,0,0
5943,244,211,291,333,20,19,10,47,122,37,37,1,0
563,19,291,215,769,1,19,11,196,478,0,0,0,0
1285,23,276,215,764,2,19,11,192,488,0,0,0,0
2968,299,313,466,555,3,19,11,167,242,0,0,0,0
3060,27,258,206,698,4,19,11,179,440,0,8,0,0
3061,32,267,204,691,4,19,11,172,424,1,8,0,0
3062,36,278,203,686,4,19,11,167,408,2,8,0,0
3063,38,281,201,679,4,19,11,163,398,3,8,0,0
3064,41,288,197,669,4,19,11,156,381,4,8,0,0
3065,42,289,198,670,4,19,11,156,381,5,8,0,0
3066,44,293,197,666,4,19,11,153,373,6,8,0,0
3067,46,300,199,670,4,19,11,153,370,7,8,0,0
3068,48,305,198,667,4,19,11,150,362,8,8,0,0
3271,40,323,191,610,5,19,11,151,287,0,0,0,0
3273,35,317,199,670,6,19,11,164,353,0,1,0,0
3274,40,313,194,643,6,19,11,154,330,1,1,0,0
3406,30,278,212,659,7,19,11,182,381,0,0,0,0
3409,39,293,202,623,8,19,11,163,330,0,1,0,0
3410,38,288,202,620,8,19,11,164,332,1,1,0,0
3721,319,313,459,599,9,19,11,140,286,0,0,0,0
3723,332,312,455,576,10,19,11,123,264,0,0,0,0
3731,327,311,446,547,11,19,11,119,236,0,0,0,0
3738,1749,754,1917,1073,13,19,11,168,319,0,3,0,0
3739,1743,830,1874,1075,13,19,11,131,245,1,3,0,0
3740,1782,822,1918,1077,13,19,11,136,255,2,3,0,0
3741,1799,828,1920,1079,13,19,11,121,251,3,3,0,0
3749,141,196,181,279,14,19,11,40,83,0,1,0,0
3750,142,196,178,271,14,19,11,36,75,1,1,0,0
3749,204,202,251,295,15,19,11,47,93,0,1,0,0
3750,204,203,250,295,15,19,11,46,92,1,1,0,0
3841,302,308,465,557,16,19,11,163,249,0,0,0,0
3844,309,311,460,578,17,19,11,151,267,0,1,0,0
3845,305,304,457,573,17,19,11,152,269,1,1,0,0
3984,305,306,468,547,18,19,11,163,241,0,0,0,0
4415,209,205,246,293,19,19,11,37,88,0,0,0,0
4415,687,342,752,470,20,19,11,65,128,0,0,0,0
4416,0,687,67,820,21,19,11,67,133,0,0,0,0
4964,42,208,211,529,22,19,11,169,321,0,0,0,0
4971,64,231,176,358,23,19,11,112,127,0,0,0,0
4976,141,170,251,308,24,19,11,110,138,0,0,0,0
5000,210,202,249,294,25,19,11,39,92,0,0,0,0
5775,209,208,250,289,26,19,11,41,81,0,0,0,0
2401,1077,409,1165,498,5,19,12,88,89,0,0,0,0
3493,1844,533,1920,825,8,19,12,76,292,0,1,0,0
3494,1841,509,1920,832,8,19,12,79,323,1,1,0,0
3496,1844,553,1920,891,9,19,12,76,338,0,16,0,0
3497,1822,545,1903,905,9,19,12,81,360,1,16,0,0
3498,1800,552,1890,939,9,19,12,90,387,2,16,0,0
3499,1788,517,1891,955,9,19,12,103,438,3,16,0,0
3500,1775,510,1895,1011,9,19,12,120,501,4,16,0,0
3501,1760,522,1888,1045,9,19,12,128,523,5,16,0,0
3502,1745,528,1882,1068,9,19,12,137,540,6,16,0,0
3503,1704,546,1851,1077,9,19,12,147,531,7,16,0,0
3504,1678,561,1833,1080,9,19,12,155,519,8,16,0,0
3505,1652,558,1819,1080,9,19,12,167,522,9,16,0,0
3506,1621,582,1793,1080,9,19,12,172,498,10,16,0,0
3507,1604,613,1782,1080,9,19,12,178,467,11,16,0,0
3508,1587,640,1771,1080,9,19,12,184,440,12,16,0,0
3509,1560,703,1741,1080,9,19,12,181,377,13,16,0,0
3510,1581,748,1754,1075,9,19,12,173,327,14,16,0,0
3511,1620,819,1779,1080,9,19,12,159,261,15,16,0,0
3512,1622,849,1768,1080,9,19,12,146,231,16,16,0,0
1413,343,152,392,252,1,19,13,49,100,0,0,0,0
1416,377,145,433,250,2,19,13,56,105,0,1,0,0
1417,386,138,445,250,2,19,13,59,112,1,1,0,0
1419,426,147,474,249,3,19,13,48,102,0,7,0,0
1420,434,137,488,253,3,19,13,54,116,1,7,0,0
1421,446,134,501,251,3,19,13,55,117,2,7,0,0
1422,458,128,514,251,3,19,13,56,123,3,7,0,0
1423,473,137,526,251,3,19,13,53,114,4,7,0,0
1424,491,143,539,250,3,19,13,48,107,5,7,0,0
1425,504,147,551,253,3,19,13,47,106,6,7,0,0
1426,516,149,562,254,3,19,13,46,105,7,7,0,0
1452,544,139,581,266,4,19,13,37,127,0,0,0,0
1455,519,129,561,266,5,19,13,42,137,0,4,0,0
1456,515,136,556,268,5,19,13,41,132,1,4,0,0
1457,512,137,554,274,5,19,13,42,137,2,4,0,0
1458,511,135,553,271,5,19,13,42,136,3,4,0,0
1459,509,136,551,271,5,19,13,42,135,4,4,0,0
1510,506,142,555,281,6,19,13,49,139,0,13,0,0
1511,508,145,555,280,6,19,13,47,135,1,13,0,0
1512,514,146,562,281,6,19,13,48,135,2,13,0,0
1513,524,147,571,279,6,19,13,47,132,3,13,0,0
1514,531,146,578,281,6,19,13,47,135,4,13,0,0
1515,534,148,582,281,6,19,13,48,133,5,13,0,0
1516,539,151,586,284,6,19,13,47,133,6,13,0,0
1517,545,147,595,284,6,19,13,50,137,7,13,0,0
1518,549,144,601,285,6,19,13,52,141,8,13,0,0
1519,552,144,604,284,6,19,13,52,140,9,13,0,0
1520,556,145,607,281,6,19,13,51,136,10,13,0,0
1521,561,145,612,281,6,19,13,51,136,11,13,0,0
1537,557,139,610,281,6,19,13,53,142,0,13,0,0
1538,558,145,609,282,6,19,13,51,137,1,13,0,0
1539,550,142,602,281,6,19,13,52,139,2,13,0,0
1540,540,146,592,283,6,19,13,52,137,3,13,0,0
1541,532,147,582,282,6,19,13,50,135,4,13,0,0
1542,524,146,574,283,6,19,13,50,137,5,13,0,0
1543,516,144,567,282,6,19,13,51,138,6,13,0,0
1544,511,143,563,282,6,19,13,52,139,7,13,0,0
1545,510,142,560,279,6,19,13,50,137,8,13,0,0
1546,506,140,557,281,6,19,13,51,141,9,13,0,0
1547,506,142,556,283,6,19,13,50,141,10,13,0,0
1548,507,146,556,285,6,19,13,49,139,11,13,0,0
1549,506,148,555,285,6,19,13,49,137,12,13,0,0
1550,504,148,552,285,6,19,13,48,137,13,13,0,0
1511,542,147,582,271,7,19,13,40,124,0,1,0,0
1512,540,147,581,274,7,19,13,41,127,1,1,0,0
1514,561,149,596,272,8,19,13,35,123,0,0,0,0
1588,511,138,557,272,10,19,13,46,134,0,43,0,0
1589,510,141,558,280,10,19,13,48,139,1,43,0,0
1590,515,145,561,279,10,19,13,46,134,2,43,0,0
1591,522,146,568,281,10,19,13,46,135,3,43,0,0
1592,532,147,579,282,10,19,13,47,135,4,43,0,0
1593,540,145,588,282,10,19,13,48,137,5,43,0,0
1594,547,142,598,285,10,19,13,51,143,6,43,0,0
1595,552,138,605,285,10,19,13,53,147,7,43,0,0
1596,554,138,609,287,10,19,13,55,149,8,43,0,0
1597,560,137,615,288,10,19,13,55,151,9,43,0,0
1616,559,144,610,284,10,19,13,51,140,0,43,0,0
1617,551,147,604,284,10,19,13,53,137,1,43,0,0
1618,543,150,595,286,10,19,13,52,136,2,43,0,0
1619,535,148,586,284,10,19,13,51,136,3,43,0,0
1620,529,146,579,283,10,19,13,50,137,4,43,0,0
1621,524,145,574,282,10,19,13,50,137,5,43,0,0
1622,520,143,569,279,10,19,13,49,136,6,43,0,0
1623,513,142,563,282,10,19,13,50,140,7,43,0,0
1624,510,142,560,281,10,19,13,50,139,8,43,0,0
1625,509,144,557,279,10,19,13,48,135,9,43,0,0
1626,506,143,554,278,10,19,13,48,135,10,43,0,0
1627,510,150,556,281,10,19,13,46,131,11,43,0,0
1628,507,150,553,281,10,19,13,46,131,12,43,0,0
1651,508,152,551,274,10,19,13,43,122,0,43,0,1
1652,508,152,551,273,10,19,13,43,121,1,43,0,0
1653,515,146,566,284,10,19,13,51,138,2,43,0,0
1654,519,144,571,286,10,19,13,52,142,3,43,0,0
1655,522,146,573,287,10,19,13,51,141,4,43,0,0
1656,522,144,575,291,10,19,13,53,147,5,43,0,0
1657,523,144,577,295,10,19,13,54,151,6,43,0,0
1658,524,146,578,298,10,19,13,54,152,7,43,0,0
1659,524,148,579,299,10,19,13,55,151,8,43,0,0
1660,522,147,578,302,10,19,13,56,155,9,43,0,0
1661,520,148,578,305,10,19,13,58,157,10,43,0,0
1662,517,148,576,307,10,19,13,59,159,11,43,0,0
1663,516,145,578,314,10,19,13,62,169,12,43,0,0
1664,514,143,579,321,10,19,13,65,178,13,43,0,0
1665,512,144,578,321,10,19,13,66,177,14,43,0,0
1666,508,146,573,325,10,19,13,65,179,15,43,0,0
1667,506,146,572,325,10,19,13,66,179,16,43,0,0
1668,504,147,570,321,10,19,13,66,174,17,43,0,0
1669,506,152,574,331,10,19,13,68,179,18,43,0,0
1670,507,150,578,336,10,19,13,71,186,19,43,0,0
1671,509,149,581,340,10,19,13,72,191,20,43,0,0
1672,512,151,586,347,10,19,13,74,196,21,43,0,0
1673,517,151,591,352,10,19,13,74,201,22,43,0,0
1674,523,151,599,359,10,19,13,76,208,23,43,0,0
1675,532,157,607,365,10,19,13,75,208,24,43,0,0
1676,545,160,620,366,10,19,13,75,206,25,43,0,0
1677,556,164,632,372,10,19,13,76,208,26,43,0,0
1678,567,168,643,377,10,19,13,76,209,27,43,0,0
1679,579,169,654,377,10,19,13,75,208,28,43,0,0
1680,592,172,668,384,10,19,13,76,212,29,43,0,0
1681,601,175,683,399,10,19,13,82,224,30,43,0,0
1682,624,177,705,396,10,19,13,81,219,31,43,0,0
1683,637,181,719,404,10,19,13,82,223,32,43,0,0
1684,653,183,738,415,10,19,13,85,232,33,43,0,0
1685,676,181,761,412,10,19,13,85,231,34,43,0,0
1686,693,182,784,422,10,19,13,91,240,35,43,0,0
1687,715,188,807,426,10,19,13,92,238,36,43,0,0
1688,743,190,836,435,10,19,13,93,245,37,43,0,0
1689,763,195,858,439,10,19,13,95,244,38,43,0,0
1690,785,201,881,444,10,19,13,96,243,39,43,0,0
1691,816,204,909,444,10,19,13,93,240,40,43,0,0
1692,833,213,925,447,10,19,13,92,234,41,43,0,0
1693,853,217,943,443,10,19,13,90,226,42,43,0,0
1694,870,220,961,447,10,19,13,91,227,43,43,1,0
1589,540,141,580,272,11,19,13,40,131,0,1,0,0
1590,542,143,582,272,11,19,13,40,129,1,1,0,0
1620,561,151,596,274,13,19,13,35,123,0,0,0,0
2036,859,210,949,440,16,19,13,90,230,0,109,0,1
2037,850,202,941,435,16,19,13,91,233,1,109,0,0
2038,814,200,906,435,16,19,13,92,235,2,109,0,0
2039,782,193,877,433,16,19,13,95,240,3,109,0,0
2040,756,187,848,423,16,19,13,92,236,4,109,0,0
2041,715,185,809,421,16,19,13,94,236,5,109,0,0
2042,700,180,786,395,16,19,13,86,215,6,109,0,0
2043,670,174,760,403,16,19,13,90,229,7,109,0,0
2044,637,172,729,405,16,19,13,92,233,8,109,0,0
2045,619,169,708,395,16,19,13,89,226,9,109,0,0
2046,603,166,691,391,16,19,13,88,225,10,109,0,0
2047,588,165,674,387,16,19,13,86,222,11,109,0,0
2048,574,160,660,380,16,19,13,86,220,12,109,0,0
2049,566,161,649,373,16,19,13,83,212,13,109,0,0
2050,558,157,639,365,16,19,13,81,208,14,109,0,0
2051,550,154,630,358,16,19,13,80,204,15,109,0,0
2052,543,152,621,353,16,19,13,78,201,16,109,0,0
2053,533,148,611,349,16,19,13,78,201,17,109,0,0
2054,528,146,602,339,16,19,13,74,193,18,109,0,0
2055,525,147,596,335,16,19,13,71,188,19,109,0,0
2056,518,144,589,331,16,19,13,71,187,20,109,0,0
2057,511,142,581,326,16,19,13,70,184,21,109,0,0
2058,505,140,576,326,16,19,13,71,186,22,109,0,0
2059,501,139,569,319,16,19,13,68,180,23,109,0,0
2060,499,141,565,313,16,19,13,66,172,24,109,0,0
2061,498,141,561,306,16,19,13,63,165,25,109,0,0
2062,497,141,558,300,16,19,13,61,159,26,109,0,0
2063,495,142,554,297,16,19,13,59,155,27,109,0,0
2064,493,141,551,294,16,19,13,58,153,28,109,0,0
2065,492,141,550,291,16,19,13,58,150,29,109,0,0
2066,493,140,550,289,16,19,13,57,149,30,109,0,0
2067,495,135,552,286,16,19,13,57,151,31,109,0,0
2068,500,134,556,283,16,19,13,56,149,32,109,0,0
2069,503,135,557,283,16,19,13,54,148,33,109,0,0
2070,505,132,559,281,16,19,13,54,149,34,109,0,0
2071,508,133,560,277,16,19,13,52,144,35,109,0,0
2072,513,134,563,276,16,19,13,50,142,36,109,0,0
2073,515,136,564,275,16,19,13,49,139,37,109,0,0
2074,517,137,565,275,16,19,13,48,138,38,109,0,0
2075,516,137,564,274,16,19,13,48,137,39,109,0,0
2076,517,136,565,273,16,19,13,48,137,40,109,0,0
2077,517,138,562,271,16,19,13,45,133,41,109,0,0
2078,516,138,561,272,16,19,13,45,134,42,109,0,0
2079,516,135,561,270,16,19,13,45,135,43,109,0,0
2080,516,135,560,268,16,19,13,44,133,44,109,0,0
2081,515,133,562,277,16,19,13,47,144,45,109,0,0
2082,515,133,561,278,16,19,13,46,145,46,109,0,0
2083,515,133,560,278,16,19,13,45,145,47,109,0,0
2084,516,135,559,274,16,19,13,43,139,48,109,0,0
2085,515,135,559,278,16,19,13,44,143,49,109,0,0
2086,514,134,558,278,16,19,13,44,144,50,109,0,0
2087,514,136,557,278,16,19,13,43,142,51,109,0,0
2088,514,137,556,277,16,19,13,42,140,52,109,0,0
2089,514,137,555,277,16,19,13,41,140,53,109,0,0
2090,513,135,555,280,16,19,13,42,145,54,109,0,0
2091,518,133,560,275,16,19,13,42,142,55,109,0,0
2092,520,130,564,274,16,19,13,44,144,56,109,0,0
2093,520,130,564,271,16,19,13,44,141,57,109,0,0
2094,520,130,564,271,16,19,13,44,141,58,109,0,0
2095,519,129,564,272,16,19,13,45,143,59,109,0,0
2096,516,132,562,276,16,19,13,46,144,60,109,0,0
2097,516,132,562,278,16,19,13,46,146,61,109,0,0
2098,516,131,563,280,16,19,13,47,149,62,109,0,0
2099,516,132,564,280,16,19,13,48,148,63,109,0,0
2100,514,132,562,282,16,19,13,48,150,64,109,0,0
2101,512,133,558,277,16,19,13,46,144,65,109,0,0
2102,512,132,558,276,16,19,13,46,144,66,109,0,0
2103,511,133,556,276,16,19,13,45,143,67,109,0,0
2104,510,133,555,276,16,19,13,45,143,68,109,0,0
2105,510,136,554,279,16,19,13,44,143,69,109,0,0
2106,511,142,554,279,16,19,13,43,137,70,109,0,0
2107,513,144,556,284,16,19,13,43,140,71,109,0,0
2108,517,143,562,284,16,19,13,45,141,72,109,0,0
2109,524,145,570,286,16,19,13,46,141,73,109,0,0
2110,529,146,576,290,16,19,13,47,144,74,109,0,0
2111,529,147,578,295,16,19,13,49,148,75,109,0,0
2112,529,147,580,296,16,19,13,51,149,76,109,0,0
2113,531,149,582,299,16,19,13,51,150,77,109,0,0
2114,534,150,586,302,16,19,13,52,152,78,109,0,0
2115,535,149,591,313,16,19,13,56,164,79,109,0,0
2116,537,150,594,316,16,19,13,57,166,80,109,0,0
2117,538,151,596,317,16,19,13,58,166,81,109,0,0
2118,538,149,598,319,16,19,13,60,170,82,109,0,0
2119,540,149,601,324,16,19,13,61,175,83,109,0,0
2120,544,147,606,325,16,19,13,62,178,84,109,0,0
2121,549,147,613,327,16,19,13,64,180,85,109,0,0
2122,551,151,616,332,16,19,13,65,181,86,109,0,0
2123,550,151,617,336,16,19,13,67,185,87,109,0,0
2124,548,151,618,344,16,19,13,70,193,88,109,0,0
2125,550,157,620,349,16,19,13,70,192,89,109,0,0
2126,553,157,625,353,16,19,13,72,196,90,109,0,0
2127,557,163,630,360,16,19,13,73,197,91,109,0,0
2128,557,166,632,364,16,19,13,75,198,92,109,0,0
2129,556,166,633,370,16,19,13,77,204,93,109,0,0
2130,563,167,640,374,16,19,13,77,207,94,109,0,0
2131,573,171,653,382,16,19,13,80,211,95,109,0,0
2132,585,174,666,388,16,19,13,81,214,96,109,0,0
2133,597,176,679,394,16,19,13,82,218,97,109,0,0
2134,609,177,691,396,16,19,13,82,219,98,109,0,0
2135,624,177,708,401,16,19,13,84,224,99,109,0,0
2136,640,180,725,406,16,19,13,85,226,100,109,0,0
2137,671,180,757,408,16,19,13,86,228,101,109,0,0
2138,691,182,781,418,16,19,13,90,236,102,109,0,0
2139,713,191,802,425,16,19,13,89,234,103,109,0,0
2140,744,191,833,427,16,19,13,89,236,104,109,0,0
2141,767,195,857,428,16,19,13,90,233,105,109,0,0
2142,793,199,886,432,16,19,13,93,233,106,109,0,0
2143,829,204,920,437,16,19,13,91,233,107,109,0,0
2144,848,209,939,437,16,19,13,91,228,108,109,0,0
2145,867,212,958,441,16,19,13,91,229,109,109,1,0
2081,1153,203,1295,418,1,19,14,142,215,0,0,0,0
2090,1155,205,1295,419,2,19,14,140,214,0,0,0,0
2237,1647,172,1686,289,3,19,14,39,117,0,0,0,0
2246,1640,122,1694,282,4,19,14,54,160,0,0,0,0
2248,1631,116,1694,280,5,19,14,63,164,0,0,0,0
2256,1634,104,1698,300,6,19,14,64,196,0,4,0,0
2257,1640,122,1696,293,6,19,14,56,171,1,4,0,0
2258,1635,111,1696,296,6,19,14,61,185,2,4,0,0
2259,1641,125,1693,284,6,19,14,52,159,3,4,0,0
2260,1642,129,1692,281,6,19,14,50,152,4,4,0,0
2265,1641,119,1698,293,6,19,14,57,174,0,4,0,0
2266,1641,119,1699,293,6,19,14,58,174,1,4,0,0
2276,1643,139,1686,271,6,19,14,43,132,0,4,0,0
2277,1643,140,1685,270,6,19,14,42,130,1,4,0,0
3114,1506,186,1552,282,7,19,14,46,96,0,0,0,0
3121,1507,188,1550,280,8,19,14,43,92,0,6,0,0
3122,1506,187,1550,280,8,19,14,44,93,1,6,0,0
3123,1506,185,1551,281,8,19,14,45,96,2,6,0,0
3124,1506,184,1552,282,8,19,14,46,98,3,6,0,0
3131,1503,187,1550,286,8,19,14,47,99,0,6,0,0
3132,1503,187,1550,287,8,19,14,47,100,1,6,0,0
3133,1504,188,1550,286,8,19,14,46,98,2,6,0,0
3134,1504,188,1550,286,8,19,14,46,98,3,6,0,0
3135,1504,189,1550,286,8,19,14,46,97,4,6,0,0
3138,1505,189,1549,283,8,19,14,44,94,0,6,0,0
3139,1506,189,1549,282,8,19,14,43,93,1,6,0,0
3140,1506,189,1549,282,8,19,14,43,93,2,6,0,0
3141,1507,187,1551,283,8,19,14,44,96,3,6,0,0
3142,1506,186,1552,283,8,19,14,46,97,4,6,0,0
3143,1507,186,1552,283,8,19,14,45,97,5,6,0,0
3144,1507,186,1552,283,8,19,14,45,97,6,6,0,0
3489,1,485,62,744,9,19,14,61,259,0,103,0,1
3490,5,476,69,748,9,19,14,64,272,1,103,0,0
3491,23,453,95,749,9,19,14,72,296,2,103,0,0
3492,35,441,114,757,9,19,14,79,316,3,103,0,0
3493,51,427,140,770,9,19,14,89,343,4,103,0,0
3494,73,431,169,785,9,19,14,96,354,5,103,0,0
3495,88,438,189,798,9,19,14,101,360,6,103,0,0
3496,127,435,237,804,9,19,14,110,369,7,103,0,0
3497,160,438,277,808,9,19,14,117,370,8,103,0,0
3498,171,426,299,810,9,19,14,128,384,9,103,0,0
3499,194,426,338,845,9,19,14,144,419,10,103,0,0
3500,220,432,371,856,9,19,14,151,424,11,103,0,0
3501,248,434,406,872,9,19,14,158,438,12,103,0,0
3502,303,437,472,880,9,19,14,169,443,13,103,0,0
3503,341,429,518,883,9,19,14,177,454,14,103,0,0
3504,375,429,560,895,9,19,14,185,466,15,103,0,0
3505,429,439,630,934,9,19,14,201,495,16,103,0,0
3506,459,437,667,952,9,19,14,208,515,17,103,0,0
3507,519,435,734,962,9,19,14,215,527,18,103,0,0
3508,594,439,814,963,9,19,14,220,524,19,103,0,0
3509,651,425,875,966,9,19,14,224,541,20,103,0,0
3510,738,416,970,968,9,19,14,232,552,21,103,0,0
3511,821,415,1052,958,9,19,14,231,543,22,103,0,0
3512,906,401,1151,976,9,19,14,245,575,23,103,0,0
3513,988,395,1245,984,9,19,14,257,589,24,103,0,0
3514,1046,371,1304,957,9,19,14,258,586,25,103,0,0
3515,1115,357,1357,923,9,19,14,242,566,26,103,0,0
3516,1181,361,1413,902,9,19,14,232,541,27,103,0,0
3517,1242,329,1474,867,9,19,14,232,538,28,103,0,0
3518,1291,321,1518,854,9,19,14,227,533,29,103,0,0
3519,1328,328,1541,836,9,19,14,213,508,30,103,0,0
3520,1352,296,1554,786,9,19,14,202,490,31,103,0,0
3521,1370,280,1564,759,9,19,14,194,479,32,103,0,0
3522,1389,295,1567,745,9,19,14,178,450,33,103,0,0
3523,1410,280,1573,699,9,19,14,163,419,34,103,0,0
3524,1423,279,1574,679,9,19,14,151,400,35,103,0,0
3525,1429,277,1572,660,9,19,14,143,383,36,103,0,0
3526,1434,258,1571,633,9,19,14,137,375,37,103,0,0
3527,1440,252,1573,620,9,19,14,133,368,38,103,0,0
3528,1453,248,1579,600,9,19,14,126,352,39,103,0,0
3529,1481,239,1571,485,9,19,14,90,246,40,103,0,0
3530,1466,235,1573,534,9,19,14,107,299,41,103,0,0
3531,1469,233,1575,535,9,19,14,106,302,42,103,0,0
3532,1479,222,1564,457,9,19,14,85,235,43,103,0,0
3533,1470,214,1575,514,9,19,14,105,300,44,103,0,0
3534,1468,211,1580,533,9,19,14,112,322,45,103,0,0
3535,1469,206,1578,528,9,19,14,109,322,46,103,0,0
3536,1475,207,1578,510,9,19,14,103,303,47,103,0,0
3537,1474,194,1579,509,9,19,14,105,315,48,103,0,0
3538,1475,192,1580,507,9,19,14,105,315,49,103,0,0
3539,1482,204,1579,495,9,19,14,97,291,50,103,0,0
3540,1488,207,1578,482,9,19,14,90,275,51,103,0,0
3541,1494,208,1576,463,9,19,14,82,255,52,103,0,0
3542,1494,206,1575,456,9,19,14,81,250,53,103,0,0
3543,1496,201,1573,441,9,19,14,77,240,54,103,0,0
3544,1495,200,1573,442,9,19,14,78,242,55,103,0,0
3545,1496,199,1571,429,9,19,14,75,230,56,103,0,0
3546,1496,194,1568,420,9,19,14,72,226,57,103,0,0
3547,1488,198,1558,414,9,19,14,70,216,58,103,0,0
3548,1488,193,1557,407,9,19,14,69,214,59,103,0,0
3549,1491,195,1557,396,9,19,14,66,201,60,103,0,0
3550,1500,196,1552,351,9,19,14,52,155,61,103,0,0
3551,1501,194,1558,363,9,19,14,57,169,62,103,0,0
3552,1500,192,1562,380,9,19,14,62,188,63,103,0,0
3553,1501,191,1564,380,9,19,14,63,189,64,103,0,0
3554,1503,182,1565,365,9,19,14,62,183,65,103,0,0
3555,1506,181,1566,357,9,19,14,60,176,66,103,0,0
3556,1510,180,1572,362,9,19,14,62,182,67,103,0,0
3557,1516,178,1576,357,9,19,14,60,179,68,103,0,0
3558,1523,161,1589,355,9,19,14,66,194,69,103,0,0
3559,1525,172,1581,338,9,19,14,56,166,70,103,0,0
3560,1522,174,1578,340,9,19,14,56,166,71,103,0,0
3561,1525,177,1576,329,9,19,14,51,152,72,103,0,0
3562,1529,171,1586,338,9,19,14,57,167,73,103,0,0
3563,1531,171,1588,339,9,19,14,57,168,74,103,0,0
3564,1533,168,1590,338,9,19,14,57,170,75,103,0,0
3565,1534,168,1589,330,9,19,14,55,162,76,103,0,0
3566,1535,171,1586,323,9,19,14,51,152,77,103,0,0
3567,1537,172,1587,324,9,19,14,50,152,78,103,0,0
3568,1539,172,1589,321,9,19,14,50,149,79,103,0,0
3569,1540,168,1591,319,9,19,14,51,151,80,103,0,0
3570,1541,169,1590,316,9,19,14,49,147,81,103,0,0
3571,1542,171,1588,310,9,19,14,46,139,82,103,0,0
3572,1541,170,1588,311,9,19,14,47,141,83,103,0,0
3573,1542,166,1591,314,9,19,14,49,148,84,103,0,0
3574,1544,162,1593,310,9,19,14,49,148,85,103,0,0
3575,1544,160,1594,310,9,19,14,50,150,86,103,0,0
3576,1546,165,1592,300,9,19,14,46,135,87,103,0,0
3577,1547,164,1593,300,9,19,14,46,136,88,103,0,0
3578,1547,164,1593,297,9,19,14,46,133,89,103,0,0
3579,1548,163,1594,295,9,19,14,46,132,90,103,0,0
3580,1547,162,1594,292,9,19,14,47,130,91,103,0,0
3581,1548,164,1593,289,9,19,14,45,125,92,103,0,0
3582,1545,164,1590,285,9,19,14,45,121,93,103,0,0
3583,1548,166,1593,283,9,19,14,45,117,94,103,0,0
3584,1552,168,1596,281,9,19,14,44,113,95,103,0,0
3585,1551,165,1596,279,9,19,14,45,114,96,103,0,0
3586,1557,164,1602,277,9,19,14,45,113,97,103,0,0
3587,1561,164,1604,275,9,19,14,43,111,98,103,0,0
3588,1560,164,1604,273,9,19,14,44,109,99,103,0,0
3589,1563,164,1604,270,9,19,14,41,106,100,103,0,0
3590,1565,166,1605,269,9,19,14,40,103,101,103,0,0
3591,1565,162,1606,267,9,19,14,41,105,102,103,0,0
3592,1566,162,1606,265,9,19,14,40,103,103,103,1,0
3501,1508,193,1545,280,10,19,14,37,87,0,1,0,0
3502,1505,188,1545,282,10,19,14,40,94,1,1,0,0
3506,1507,187,1548,279,11,19,14,41,92,0,1,0,0
3507,1509,191,1548,279,11,19,14,39,88,1,1,0,0
3511,1507,189,1547,279,12,19,14,40,90,0,0,0,0
3522,1509,189,1548,282,13,19,14,39,93,0,0,0,0
3563,1595,63,1710,345,14,19,14,115,282,0,1,0,0
3564,1590,63,1703,341,14,19,14,113,278,1,1,0,0
3584,1515,187,1554,281,15,19,14,39,94,0,0,0,0
3635,1505,186,1554,286,16,19,14,49,100,0,0,0,0
3641,1506,184,1552,286,17,19,14,46,102,0,0,0,0
3643,1507,186,1552,288,18,19,14,45,102,0,0,0,0
3664,1508,187,1549,283,19,19,14,41,96,0,0,0,0
3666,1507,186,1549,283,20,19,14,42,97,0,0,0,0
3741,1638,112,1705,349,21,19,14,67,237,0,1,0,0
3742,1641,118,1706,345,21,19,14,65,227,1,1,0,0
3929,1507,186,1547,282,22,19,14,40,96,0,1,0,0
3930,1507,186,1548,284,22,19,14,41,98,1,1,0,0
3993,1508,184,1548,282,23,19,14,40,98,0,1,0,0
3994,1505,181,1547,282,23,19,14,42,101,1,1,0,0
4244,1507,186,1548,281,24,19,14,41,95,0,1,0,0
4245,1506,184,1548,280,24,19,14,42,96,1,1,0,0
4249,1508,186,1549,281,25,19,14,41,95,0,0,0,0
4251,1509,186,1549,279,26,19,14,40,93,0,1,0,0
4252,1509,188,1548,279,26,19,14,39,91,1,1,0,0
4266,1506,184,1549,283,27,19,14,43,99,0,5,0,0
4267,1506,184,1549,283,27,19,14,43,99,1,5,0,0
4268,1506,184,1549,282,27,19,14,43,98,2,5,0,0
4269,1506,184,1549,281,27,19,14,43,97,3,5,0,0
4270,1506,185,1548,282,27,19,14,42,97,4,5,0,0
4271,1506,185,1548,282,27,19,14,42,97,5,5,0,0
4403,1508,184,1549,284,28,19,14,41,100,0,0,0,0
4406,1505,181,1548,284,29,19,14,43,103,0,4,0,0
4407,1505,181,1548,284,29,19,14,43,103,1,4,0,0
4408,1506,181,1548,282,29,19,14,42,101,2,4,0,0
4409,1506,181,1548,281,29,19,14,42,100,3,4,0,0
4411,1507,184,1547,280,29,19,14,40,96,0,4,0,0
4412,1507,185,1547,280,29,19,14,40,95,1,4,0,0
4413,1507,185,1547,280,29,19,14,40,95,2,4,0,0
4414,1507,185,1547,280,29,19,14,40,95,3,4,0,0
4415,1507,186,1547,280,29,19,14,40,94,4,4,0,0
4455,1513,189,1550,282,30,19,14,37,93,0,0,0,0
4471,1511,190,1547,279,31,19,14,36,89,0,0,0,0
5038,1638,87,1706,358,32,19,14,68,271,0,0,0,0
5225,1491,106,1632,311,33,19,14,141,205,0,0,0,0
5370,1500,115,1628,284,34,19,14,128,169,0,0,0,0
5705,1142,128,1263,430,35,19,14,121,302,0,0,0,0
5858,1492,106,1619,313,36,19,14,127,207,0,3,0,0
5859,1496,104,1669,386,36,19,14,173,282,1,3,0,0
5860,1496,103,1647,350,36,19,14,151,247,2,3,0,0
5861,1497,102,1648,349,36,19,14,151,247,3,3,0,0
5967,1641,128,1700,349,37,19,14,59,221,0,0,0,0
5969,1496,115,1599,318,38,19,14,103,203,0,0,0,0
1169,1366,191,1440,426,1,19,15,74,235,0,44,0,1
1170,1334,194,1425,479,1,19,15,91,285,1,44,0,0
1171,1318,190,1413,487,1,19,15,95,297,2,44,0,0
1172,1296,183,1392,483,1,19,15,96,300,3,44,0,0
1173,1281,181,1376,479,1,19,15,95,298,4,44,0,0
1174,1270,176,1363,468,1,19,15,93,292,5,44,0,0
1175,1256,175,1351,469,1,19,15,95,294,6,44,0,0
1176,1246,169,1339,457,1,19,15,93,288,7,44,0,0
1177,1240,165,1330,444,1,19,15,90,279,8,44,0,0
1178,1239,167,1326,434,1,19,15,87,267,9,44,0,0
1179,1241,164,1326,420,1,19,15,85,256,10,44,0,0
1180,1240,156,1324,408,1,19,15,84,252,11,44,0,0
1181,1240,156,1321,398,1,19,15,81,242,12,44,0,0
1182,1238,147,1319,389,1,19,15,81,242,13,44,0,0
1183,1240,145,1319,381,1,19,15,79,236,14,44,0,0
1184,1242,144,1320,378,1,19,15,78,234,15,44,0,0
1185,1247,141,1322,366,1,19,15,75,225,16,44,0,0
1186,1249,141,1322,359,1,19,15,73,218,17,44,0,0
1187,1250,140,1321,351,1,19,15,71,211,18,44,0,0
1188,1254,140,1321,337,1,19,15,67,197,19,44,0,0
1189,1258,140,1324,335,1,19,15,66,195,20,44,0,0
1190,1261,138,1328,331,1,19,15,67,193,21,44,0,0
1191,1264,138,1328,322,1,19,15,64,184,22,44,0,0
1192,1264,138,1328,323,1,19,15,64,185,23,44,0,0
1193,1265,135,1329,319,1,19,15,64,184,24,44,0,0
1194,1267,134,1330,315,1,19,15,63,181,25,44,0,0
1195,1270,134,1332,311,1,19,15,62,177,26,44,0,0
1196,1273,133,1332,304,1,19,15,59,171,27,44,0,0
1197,1272,132,1330,300,1,19,15,58,168,28,44,0,0
1198,1270,134,1326,298,1,19,15,56,164,29,44,0,0
1199,1267,132,1324,295,1,19,15,57,163,30,44,0,0
1200,1266,133,1321,292,1,19,15,55,159,31,44,0,0
1201,1264,132,1319,287,1,19,15,55,155,32,44,0,0
1202,1260,130,1314,283,1,19,15,54,153,33,44,0,0
1203,1255,133,1307,281,1,19,15,52,148,34,44,0,0
1204,1246,130,1298,276,1,19,15,52,146,35,44,0,0
1205,1240,129,1291,272,1,19,15,51,143,36,44,0,0
1206,1234,129,1285,271,1,19,15,51,142,37,44,0,0
1207,1227,128,1277,268,1,19,15,50,140,38,44,0,0
1208,1218,128,1269,266,1,19,15,51,138,39,44,0,0
1209,1208,127,1259,265,1,19,15,51,138,40,44,0,0
1210,1196,124,1247,260,1,19,15,51,136,41,44,0,0
1211,1187,123,1236,257,1,19,15,49,134,42,44,0,0
1212,1176,124,1224,253,1,19,15,48,129,43,44,0,0
1213,1170,123,1216,250,1,19,15,46,127,44,44,1,0
1861,1211,141,1256,242,2,19,15,45,101,0,49,0,1
1862,1220,141,1267,246,2,19,15,47,105,1,49,0,0
1863,1225,139,1274,250,2,19,15,49,111,2,49,0,0
1864,1231,141,1280,251,2,19,15,49,110,3,49,0,0
1865,1233,142,1285,258,2,19,15,52,116,4,49,0,0
1866,1237,141,1291,262,2,19,15,54,121,5,49,0,0
1867,1239,141,1294,265,2,19,15,55,124,6,49,0,0
1868,1241,142,1297,271,2,19,15,56,129,7,49,0,0
1869,1243,144,1300,272,2,19,15,57,128,8,49,0,0
1870,1242,143,1302,280,2,19,15,60,137,9,49,0,0
1871,1240,144,1300,285,2,19,15,60,141,10,49,0,0
1872,1237,144,1298,287,2,19,15,61,143,11,49,0,0
1873,1235,144,1297,292,2,19,15,62,148,12,49,0,0
1874,1234,143,1297,294,2,19,15,63,151,13,49,0,0
1875,1232,142,1295,296,2,19,15,63,154,14,49,0,0
1876,1228,144,1290,299,2,19,15,62,155,15,49,0,0
1877,1223,146,1286,302,2,19,15,63,156,16,49,0,0
1878,1218,146,1282,305,2,19,15,64,159,17,49,0,0
1879,1213,148,1277,312,2,19,15,64,164,18,49,0,0
1880,1209,148,1273,315,2,19,15,64,167,19,49,0,0
1881,1205,148,1271,319,2,19,15,66,171,20,49,0,0
1882,1200,150,1267,326,2,19,15,67,176,21,49,0,0
1883,1195,151,1263,332,2,19,15,68,181,22,49,0,0
1884,1191,149,1260,336,2,19,15,69,187,23,49,0,0
1885,1186,151,1256,342,2,19,15,70,191,24,49,0,0
1886,1181,153,1252,349,2,19,15,71,196,25,49,0,0
1887,1178,153,1250,353,2,19,15,72,200,26,49,0,0
1888,1173,159,1244,358,2,19,15,71,199,27,49,0,0
1889,1166,164,1238,364,2,19,15,72,200,28,49,0,0
1890,1159,164,1233,372,2,19,15,74,208,29,49,0,0
1891,1151,169,1226,381,2,19,15,75,212,30,49,0,0
1892,1150,171,1225,386,2,19,15,75,215,31,49,0,0
1893,1151,171,1226,390,2,19,15,75,219,32,49,0,0
1894,1153,174,1229,397,2,19,15,76,223,33,49,0,0
1895,1153,177,1230,406,2,19,15,77,229,34,49,0,0
1896,1151,179,1229,411,2,19,15,78,232,35,49,0,0
1897,1151,182,1232,424,2,19,15,81,242,36,49,0,0
1898,1157,183,1240,434,2,19,15,83,251,37,49,0,0
1899,1163,183,1249,443,2,19,15,86,260,38,49,0,0
1900,1172,192,1258,452,2,19,15,86,260,39,49,0,0
1901,1178,194,1268,465,2,19,15,90,271,40,49,0,0
1902,1190,199,1278,464,2,19,15,88,265,41,49,0,0
1903,1205,199,1299,481,2,19,15,94,282,42,49,0,0
1904,1216,205,1313,490,2,19,15,97,285,43,49,0,0
1905,1237,205,1339,503,2,19,15,102,298,44,49,0,0
1906,1265,216,1362,503,2,19,15,97,287,45,49,0,0
1907,1285,226,1385,512,2,19,15,100,286,46,49,0,0
1908,1322,225,1422,516,2,19,15,100,291,47,49,0,0
1909,1346,235,1441,524,2,19,15,95,289,48,49,0,0
1910,1358,239,1455,531,2,19,15,97,292,49,49,1,0
199,231,98,289,223,2,19,2,58,125,0,1,0,0
200,231,99,288,223,2,19,2,57,124,1,1,0,0
289,230,109,280,222,4,19,2,50,113,0,0,0,0
298,229,112,284,226,5,19,2,55,114,0,0,0,0
337,229,120,264,224,7,19,2,35,104,0,0,0,0
374,232,115,286,227,8,19,2,54,112,0,0,0,0
379,232,113,288,220,9,19,2,56,107,0,0,0,0
405,231,125,282,223,10,19,2,51,98,0,0,0,0
720,1500,470,1719,699,11,19,2,219,229,0,0,0,0
1324,347,153,382,272,13,19,2,35,119,0,85,0,0
1325,347,153,382,273,13,19,2,35,120,1,85,0,0
1326,346,154,382,276,13,19,2,36,122,2,85,0,0
1327,346,155,383,278,13,19,2,37,123,3,85,0,0
1328,346,156,383,280,13,19,2,37,124,4,85,0,0
1329,345,156,383,282,13,19,2,38,126,5,85,0,0
1330,346,158,383,284,13,19,2,37,126,6,85,0,0
1331,346,158,384,286,13,19,2,38,128,7,85,0,0
1332,344,157,384,289,13,19,2,40,132,8,85,0,0
1333,343,155,384,293,13,19,2,41,138,9,85,0,0
1334,343,157,384,293,13,19,2,41,136,10,85,0,0
1335,343,155,385,295,13,19,2,42,140,11,85,0,0
1336,343,157,384,296,13,19,2,41,139,12,85,0,0
1337,343,157,385,298,13,19,2,42,141,13,85,0,0
1339,347,158,389,299,13,19,2,42,141,0,85,0,1
1340,347,160,388,298,13,19,2,41,138,1,85,0,0
1341,347,160,391,304,13,19,2,44,144,2,85,0,0
1342,347,160,391,305,13,19,2,44,145,3,85,0,0
1343,346,157,393,309,13,19,2,47,152,4,85,0,0
1344,346,154,394,312,13,19,2,48,158,5,85,0,0
1345,348,157,395,314,13,19,2,47,157,6,85,0,0
1346,349,164,395,319,13,19,2,46,155,7,85,0,0
1347,347,163,395,323,13,19,2,48,160,8,85,0,0
1348,345,160,392,323,13,19,2,47,163,9,85,0,0
1349,344,159,393,328,13,19,2,49,169,10,85,0,0
1350,343,155,394,331,13,19,2,51,176,11,85,0,0
1351,346,162,396,331,13,19,2,50,169,12,85,0,0
1352,348,160,399,334,13,19,2,51,174,13,85,0,0
1353,352,167,401,335,13,19,2,49,168,14,85,0,0
1354,354,164,405,334,13,19,2,51,170,15,85,0,0
1355,361,175,411,335,13,19,2,50,160,16,85,0,0
1356,365,178,416,343,13,19,2,51,165,17,85,0,0
1357,373,179,424,344,13,19,2,51,165,18,85,0,0
1358,378,180,429,346,13,19,2,51,166,19,85,0,0
1359,379,182,432,352,13,19,2,53,170,20,85,0,0
1360,380,181,435,358,13,19,2,55,177,21,85,0,0
1361,382,178,439,361,13,19,2,57,183,22,85,0,0
1362,386,182,443,364,13,19,2,57,182,23,85,0,0
1363,392,179,449,364,13,19,2,57,185,24,85,0,0
1364,396,176,456,369,13,19,2,60,193,25,85,0,0
1365,400,171,463,377,13,19,2,63,206,26,85,0,0
1366,406,179,468,381,13,19,2,62,202,27,85,0,0
1367,409,180,471,383,13,19,2,62,203,28,85,0,0
1368,411,164,479,388,13,19,2,68,224,29,85,0,0
1369,416,178,480,390,13,19,2,64,212,30,85,0,0
1370,419,184,484,408,13,19,2,65,224,31,85,0,0
1371,422,177,486,401,13,19,2,64,224,32,85,0,0
1372,423,164,491,404,13,19,2,68,240,33,85,0,0
1373,421,165,491,414,13,19,2,70,249,34,85,0,0
1374,420,150,493,418,13,19,2,73,268,35,85,0,0
1375,418,146,493,424,13,19,2,75,278,36,85,0,0
1376,419,163,492,434,13,19,2,73,271,37,85,0,0
1377,417,150,493,439,13,19,2,76,289,38,85,0,0
1378,420,186,489,446,13,19,2,69,260,39,85,0,0
1379,420,208,485,451,13,19,2,65,243,40,85,0,0
1380,417,213,483,456,13,19,2,66,243,41,85,0,0
1381,415,219,482,458,13,19,2,67,239,42,85,0,0
1382,418,222,488,470,13,19,2,70,248,43,85,0,0
1383,425,222,496,474,13,19,2,71,252,44,85,0,0
1384,429,228,500,477,13,19,2,71,249,45,85,0,0
1385,427,231,503,495,13,19,2,76,264,46,85,0,0
1386,428,231,507,506,13,19,2,79,275,47,85,0,0
1387,430,231,512,511,13,19,2,82,280,48,85,0,0
1388,433,232,520,521,13,19,2,87,289,49,85,0,0
1389,443,237,531,528,13,19,2,88,291,50,85,0,0
1390,448,239,537,531,13,19,2,89,292,51,85,0,0
1391,450,242,543,548,13,19,2,93,306,52,85,0,0
1392,452,250,545,556,13,19,2,93,306,53,85,0,0
1393,452,251,548,562,13,19,2,96,311,54,85,0,0
1394,454,257,554,579,13,19,2,100,322,55,85,0,0
1395,462,262,565,588,13,19,2,103,326,56,85,0,0
1396,473,265,577,594,13,19,2,104,329,57,85,0,0
1397,481,270,587,606,13,19,2,106,336,58,85,0,0
1398,482,279,597,645,13,19,2,115,366,59,85,0,0
1399,493,283,612,658,13,19,2,119,375,60,85,0,0
1400,501,282,627,668,13,19,2,126,386,61,85,0,0
1401,514,288,645,687,13,19,2,131,399,62,85,0,0
1402,528,299,663,707,13,19,2,135,408,63,85,0,0
1403,536,303,673,718,13,19,2,137,415,64,85,0,0
1404,548,315,685,738,13,19,2,137,423,65,85,0,0
1405,556,322,700,770,13,19,2,144,448,66,85,0,0
1406,570,321,722,788,13,19,2,152,467,67,85,0,0
1407,585,327,748,822,13,19,2,163,495,68,85,0,0
1408,598,337,764,838,13,19,2,166,501,69,85,0,0
1409,616,351,782,850,13,19,2,166,499,70,85,0,0
1410,633,367,801,865,13,19,2,168,498,71,85,0,0
1411,640,394,819,925,13,19,2,179,531,72,85,0,0
1412,647,407,828,938,13,19,2,181,531,73,85,0,0
1413,666,421,852,958,13,19,2,186,537,74,85,0,0
1414,697,442,894,997,13,19,2,197,555,75,85,0,0
1415,725,453,937,1040,13,19,2,212,587,76,85,0,0
1416,765,467,981,1055,13,19,2,216,588,77,85,0,0
1417,809,496,1025,1069,13,19,2,216,573,78,85,0,0
1418,842,533,1052,1073,13,19,2,210,540,79,85,0,0
1419,913,551,1132,1075,13,19,2,219,524,80,85,0,0
1420,967,587,1185,1073,13,19,2,218,486,81,85,0,0
1421,1027,627,1237,1078,13,19,2,210,451,82,85,0,0
1422,1094,664,1302,1080,13,19,2,208,416,83,85,0,0
1423,1165,724,1362,1080,13,19,2,197,356,84,85,0,0
1424,1212,752,1399,1080,13,19,2,187,328,85,85,1,0
1404,1560,470,1697,668,14,19,2,137,198,0,1,0,0
1405,1550,469,1693,675,14,19,2,143,206,1,1,0,0
1424,1344,795,1560,1046,15,19,2,216,251,0,0,0,0
1458,1524,478,1718,683,17,19,2,194,205,0,0,0,0
1463,439,102,491,212,18,19,2,52,110,0,0,0,0
1490,1513,468,1718,686,19,19,2,205,218,0,0,0,0
1568,1563,470,1698,671,20,19,2,135,201,0,1,0,0
1569,1562,473,1701,679,20,19,2,139,206,1,1,0,0
1612,1560,474,1716,666,21,19,2,156,192,0,0,0,0
1668,1544,476,1711,671,22,19,2,167,195,0,1,0,0
1669,1533,471,1707,674,22,19,2,174,203,1,1,0,0
1678,1544,473,1699,667,23,19,2,155,194,0,0,0,0
1680,1562,462,1699,658,24,19,2,137,196,0,0,0,0
1838,1522,472,1709,688,25,19,2,187,216,0,0,0,0
1880,1524,476,1709,679,26,19,2,185,203,0,0,0,0
1910,1532,471,1707,672,27,19,2,175,201,0,0,0,0
1924,1561,477,1694,663,29,19,2,133,186,0,0,0,0
2066,1549,472,1688,658,30,19,2,139,186,0,0,0,0
2133,1562,478,1702,661,32,19,2,140,183,0,0,0,0
2161,1549,476,1716,673,33,19,2,167,197,0,1,0,0
2162,1546,475,1709,667,33,19,2,163,192,1,1,0,0
2165,1561,476,1693,662,34,19,2,132,186,0,0,0,0
2237,1545,472,1719,677,35,19,2,174,205,0,0,0,0
2239,1553,476,1720,678,36,19,2,167,202,0,1,0,0
2240,1550,481,1711,676,36,19,2,161,195,1,1,0,0
2299,1532,472,1716,687,37,19,2,184,215,0,0,0,0
2308,1526,469,1698,667,38,19,2,172,198,0,0,0,0
2310,1535,470,1709,663,39,19,2,174,193,0,0,0,0
2336,1511,463,1724,690,40,19,2,213,227,0,3,0,0
2337,1510,469,1720,692,40,19,2,210,223,1,3,0,0
2338,1521,464,1718,675,40,19,2,197,211,2,3,0,0
2339,1525,463,1716,668,40,19,2,191,205,3,3,0,0
2342,1515,469,1713,680,40,19,2,198,211,0,3,0,0
2343,1515,470,1712,680,40,19,2,197,210,1,3,0,0
2362,1543,479,1728,681,40,19,2,185,202,0,3,0,0
2363,1544,479,1728,681,40,19,2,184,202,1,3,0,0
2494,1521,474,1704,767,41,19,2,183,293,0,1,0,0
2495,1550,474,1686,690,41,19,2,136,216,1,1,0,0
2511,1533,473,1722,685,42,19,2,189,212,0,1,0,0
2512,1543,479,1729,687,42,19,2,186,208,1,1,0,0
2519,1560,470,1703,672,43,19,2,143,202,0,0,0,0
2589,1540,470,1705,686,44,19,2,165,216,0,1,0,0
2590,1538,466,1711,692,44,19,2,173,226,1,1,0,0
2601,223,132,296,308,45,19,2,73,176,0,0,0,0
2611,1560,468,1712,664,46,19,2,152,196,0,1,0,0
2612,1559,470,1710,665,46,19,2,151,195,1,1,0,0
2614,1532,470,1718,676,47,19,2,186,206,0,0,0,0
2620,1521,466,1717,674,48,19,2,196,208,0,6,0,0
2621,1522,472,1721,683,48,19,2,199,211,1,6,0,0
2622,1513,466,1727,693,48,19,2,214,227,2,6,0,0
2623,1522,466,1730,688,48,19,2,208,222,3,6,0,0
2624,1522,465,1733,689,48,19,2,211,224,4,6,0,0
2625,1528,467,1730,683,48,19,2,202,216,5,6,0,0
2626,1530,467,1732,683,48,19,2,202,216,6,6,0,0
2661,1543,467,1719,673,49,19,2,176,206,0,7,0,0
2662,1548,470,1718,670,49,19,2,170,200,1,7,0,0
2663,1544,472,1714,672,49,19,2,170,200,2,7,0,0
2664,1543,474,1712,672,49,19,2,169,198,3,7,0,0
2665,1540,477,1721,691,49,19,2,181,214,4,7,0,0
2666,1538,479,1722,696,49,19,2,184,217,5,7,0,0
2667,1537,476,1712,681,49,19,2,175,205,6,7,0,0
2668,1535,477,1711,683,49,19,2,176,206,7,7,0,0
2705,1535,464,1692,661,50,19,2,157,197,0,0,0,0
2712,1551,468,1714,667,51,19,2,163,199,0,0,0,0
2716,1558,463,1695,670,52,19,2,137,207,0,0,0,0
2761,1509,481,1727,815,53,19,2,218,334,0,0,0,0
2763,1562,467,1685,665,54,19,2,123,198,0,0,0,0
2777,1469,481,1728,815,55,19,2,259,334,0,0,0,0
2781,1508,483,1710,833,56,19,2,202,350,0,1,0,0
2782,1515,476,1711,816,56,19,2,196,340,1,1,0,0
2804,1495,479,1694,831,57,19,2,199,352,0,0,0,0
2868,1551,469,1709,665,58,19,2,158,196,0,1,0,0
2869,1553,469,1706,659,58,19,2,153,190,1,1,0,0
2880,1497,478,1728,833,59,19,2,231,355,0,0,0,0
2926,1560,469,1696,658,60,19,2,136,189,0,3,0,0
2927,1553,474,1689,662,60,19,2,136,188,1,3,0,0
2928,1548,470,1699,678,60,19,2,151,208,2,3,0,0
2929,1544,469,1702,686,60,19,2,158,217,3,3,0,0
2993,1523,467,1720,682,61,19,2,197,215,0,0,0,0
2996,1528,474,1719,745,62,19,2,191,271,0,4,0,0
2997,1513,477,1730,786,62,19,2,217,309,1,4,0,0
2998,1528,459,1706,712,62,19,2,178,253,2,4,0,0
2999,1548,463,1694,669,62,19,2,146,206,3,4,0,0
3000,1558,461,1685,639,62,19,2,127,178,4,4,0,0
3070,1562,467,1683,661,63,19,2,121,194,0,0,0,0
3110,1529,471,1717,768,64,19,2,188,297,0,0,0,0
3112,1530,470,1718,800,65,19,2,188,330,0,0,0,0
3141,1550,470,1696,666,66,19,2,146,196,0,0,0,0
3143,1478,476,1724,835,67,19,2,246,359,0,0,0,0
3157,1502,473,1726,816,68,19,2,224,343,0,0,0,0
3173,1511,482,1720,811,69,19,2,209,329,0,0,0,0
3300,1549,469,1703,821,70,19,2,154,352,0,0,0,0
3305,1478,477,1721,843,71,19,2,243,366,0,0,0,0
3379,1502,478,1703,845,72,19,2,201,367,0,1,0,0
3380,1523,464,1713,813,72,19,2,190,349,1,1,0,0
3413,1483,459,1715,774,73,19,2,232,315,0,1,0,0
3414,1479,465,1718,790,73,19,2,239,325,1,1,0,0
3434,1495,466,1732,851,74,19,2,237,385,0,1,0,0
3435,1488,471,1723,851,74,19,2,235,380,1,1,0,0
3440,1500,477,1711,839,75,19,2,211,362,0,0,0,0
3449,1530,472,1683,790,76,19,2,153,318,0,7,0,0
3450,1535,473,1678,770,76,19,2,143,297,1,7,0,0
3451,1518,470,1701,849,76,19,2,183,379,2,7,0,0
3452,1512,468,1711,880,76,19,2,199,412,3,7,0,0
3453,1510,461,1699,846,76,19,2,189,385,4,7,0,0
3454,1504,458,1703,863,76,19,2,199,405,5,7,0,0
3463,1534,469,1719,844,76,19,2,185,375,0,7,0,0
3464,1535,469,1721,848,76,19,2,186,379,1,7,0,0
3467,1539,466,1721,831,76,19,2,182,365,0,7,0,0
3468,1540,465,1723,832,76,19,2,183,367,1,7,0,0
3471,1524,480,1703,825,76,19,2,179,345,0,7,0,0
3472,1520,483,1701,819,76,19,2,181,336,1,7,0,0
3473,1517,484,1704,822,76,19,2,187,338,2,7,0,0
3474,1516,485,1702,822,76,19,2,186,337,3,7,0,0
3498,1520,481,1719,841,76,19,2,199,360,0,7,0,0
3499,1520,480,1720,842,76,19,2,200,362,1,7,0,0
3500,1522,473,1722,836,76,19,2,200,363,2,7,0,0
3501,1522,472,1722,836,76,19,2,200,364,3,7,0,0
3507,1506,466,1703,832,76,19,2,197,366,0,7,0,0
3508,1505,466,1702,832,76,19,2,197,366,1,7,0,0
3511,1529,473,1724,835,76,19,2,195,362,0,7,0,0
3512,1530,473,1725,835,76,19,2,195,362,1,7,0,0
3513,1523,470,1726,853,76,19,2,203,383,2,7,0,0
3514,1527,474,1718,835,76,19,2,191,361,3,7,0,0
3515,1527,474,1719,835,76,19,2,192,361,4,7,0,0
3540,1510,485,1706,847,76,19,2,196,362,0,7,0,0
3541,1510,486,1705,848,76,19,2,195,362,1,7,0,0
3543,1519,480,1720,855,76,19,2,201,375,0,7,0,0
3544,1530,475,1729,852,76,19,2,199,377,1,7,0,0
3545,1531,471,1731,854,76,19,2,200,383,2,7,0,0
3546,1527,472,1727,850,76,19,2,200,378,3,7,0,0
3547,1523,477,1718,839,76,19,2,195,362,4,7,0,0
3548,1523,476,1719,838,76,19,2,196,362,5,7,0,0
3549,1517,466,1712,831,76,19,2,195,365,6,7,0,0
3550,1517,465,1711,830,76,19,2,194,365,7,7,0,0
3567,1519,471,1709,835,76,19,2,190,364,0,7,0,0
3568,1519,471,1709,835,76,19,2,190,364,1,7,0,0
3570,1537,465,1704,796,76,19,2,167,331,0,7,0,0
3571,1523,470,1706,825,76,19,2,183,355,1,7,0,0
3572,1523,470,1706,825,76,19,2,183,355,2,7,0,0
3575,1563,472,1673,640,77,19,2,110,168,0,0,0,0
3602,1544,478,1722,847,78,19,2,178,369,0,0,0,0
3617,1512,470,1708,781,79,19,2,196,311,0,0,0,0
3621,1540,474,1716,848,80,19,2,176,374,0,0,0,0
3623,1596,505,1724,883,81,19,2,128,378,0,0,0,0
3628,1522,480,1721,846,82,19,2,199,366,0,0,0,0
3668,1526,475,1705,827,83,19,2,179,352,0,1,0,0
3669,1510,475,1694,835,83,19,2,184,360,1,1,0,0
3673,1513,468,1716,830,84,19,2,203,362,0,0,0,0
3696,1507,480,1712,843,85,19,2,205,363,0,0,0,0
3739,1514,457,1685,815,86,19,2,171,358,0,1,0,0
3740,1510,454,1687,823,86,19,2,177,369,1,1,0,0
3742,1519,474,1709,848,87,19,2,190,374,0,0,0,0
3747,1527,462,1688,828,88,19,2,161,366,0,0,0,0
3751,1494,463,1702,838,89,19,2,208,375,0,0,0,0
3756,1517,471,1705,843,90,19,2,188,372,0,1,0,0
3757,1521,473,1707,840,90,19,2,186,367,1,1,0,0
3764,1520,470,1703,825,91,19,2,183,355,0,0,0,0
3775,1514,477,1704,844,92,19,2,190,367,0,0,0,0
3795,1531,470,1709,842,93,19,2,178,372,0,0,0,0
3811,1552,461,1715,841,94,19,2,163,380,0,0,0,0
4041,1524,481,1704,845,95,19,2,180,364,0,1,0,0
4042,1517,476,1696,838,95,19,2,179,362,1,1,0,0
4091,1502,458,1718,850,96,19,2,216,392,0,0,0,0
4125,1534,463,1690,826,97,19,2,156,363,0,0,0,0
4221,1539,471,1733,859,98,19,2,194,388,0,0,0,0
4284,1529,465,1693,854,99,19,2,164,389,0,0,0,0
4291,1522,480,1711,832,100,19,2,189,352,0,0,0,0
4330,1549,479,1721,854,101,19,2,172,375,0,0,0,0
4371,1583,497,1735,855,102,19,2,152,358,0,0,0,0
4391,1539,477,1718,861,103,19,2,179,384,0,0,0,0
4462,1470,474,1694,829,104,19,2,224,355,0,0,0,0
4513,1532,470,1686,832,105,19,2,154,362,0,0,0,0
4544,383,181,432,280,106,19,2,49,99,0,0,0,0
4964,1525,473,1736,843,107,19,2,211,370,0,0,0,0
5011,1549,475,1674,817,108,19,2,125,342,0,0,0,0
5046,1544,470,1706,867,109,19,2,162,397,0,1,0,0
5047,1545,483,1700,862,109,19,2,155,379,1,1,0,0
1667,501,448,742,1046,7,19,3,241,598,0,23,0,1
1668,476,421,730,1053,7,19,3,254,632,1,23,0,0
1669,474,388,729,1023,7,19,3,255,635,2,23,0,0
1670,475,368,731,1006,7,19,3,256,638,3,23,0,0
1671,478,339,725,957,7,19,3,247,618,4,23,0,0
1672,480,329,706,900,7,19,3,226,571,5,23,0,0
1673,470,322,687,875,7,19,3,217,553,6,23,0,0
1674,458,308,664,838,7,19,3,206,530,7,23,0,0
1675,442,295,642,808,7,19,3,200,513,8,23,0,0
1676,434,288,632,797,7,19,3,198,509,9,23,0,0
1677,426,277,609,752,7,19,3,183,475,10,23,0,0
1678,411,277,584,731,7,19,3,173,454,11,23,0,0
1679,394,271,565,726,7,19,3,171,455,12,23,0,0
1680,375,271,531,691,7,19,3,156,420,13,23,0,0
1681,351,269,500,675,7,19,3,149,406,14,23,0,0
1682,330,262,478,673,7,19,3,148,411,15,23,0,0
1683,322,253,461,643,7,19,3,139,390,16,23,0,0
1684,308,250,441,627,7,19,3,133,377,17,23,0,0
1685,299,256,426,615,7,19,3,127,359,18,23,0,0
1686,274,243,400,600,7,19,3,126,357,19,23,0,0
1687,253,234,378,595,7,19,3,125,361,20,23,0,0
1688,236,228,355,572,7,19,3,119,344,21,23,0,0
1689,221,226,336,565,7,19,3,115,339,22,23,0,0
1690,205,220,316,549,7,19,3,111,329,23,23,1,0
2046,237,229,296,569,8,19,3,59,340,0,28,0,1
2047,255,234,315,576,8,19,3,60,342,1,28,0,0
2048,269,235,336,605,8,19,3,67,370,2,28,0,0
2049,283,238,354,620,8,19,3,71,382,3,28,0,0
2050,301,243,377,633,8,19,3,76,390,4,28,0,0
2051,317,257,398,658,8,19,3,81,401,5,28,0,0
2052,336,258,423,673,8,19,3,87,415,6,28,0,0
2053,350,264,445,698,8,19,3,95,434,7,28,0,0
2054,358,274,463,728,8,19,3,105,454,8,28,0,0
2055,367,278,478,743,8,19,3,111,465,9,28,0,0
2056,375,291,497,783,8,19,3,122,492,10,28,0,0
2057,392,297,523,805,8,19,3,131,508,11,28,0,0
2058,411,302,553,825,8,19,3,142,523,12,28,0,0
2059,423,323,580,883,8,19,3,157,560,13,28,0,0
2060,440,335,608,913,8,19,3,168,578,14,28,0,0
2061,460,353,641,953,8,19,3,181,600,15,28,0,0
2062,486,379,678,1000,8,19,3,192,621,16,28,0,0
2063,521,393,723,1032,8,19,3,202,639,17,28,0,0
2064,549,421,758,1062,8,19,3,209,641,18,28,0,0
2065,580,445,777,1020,8,19,3,197,575,19,28,0,0
2066,597,471,807,1061,8,19,3,210,590,20,28,0,0
2067,631,512,844,1078,8,19,3,213,566,21,28,0,0
2068,689,551,903,1080,8,19,3,214,529,22,28,0,0
2069,748,596,961,1080,8,19,3,213,484,23,28,0,0
2070,784,659,990,1079,8,19,3,206,420,24,28,0,0
2071,808,724,1010,1077,8,19,3,202,353,25,28,0,0
2072,845,814,1025,1073,8,19,3,180,259,26,28,0,0
2073,950,913,1078,1079,8,19,3,128,166,27,28,0,0
2074,1009,970,1100,1080,8,19,3,91,110,28,28,1,0
2123,363,391,613,1032,12,19,3,250,641,0,20,0,1
2124,336,365,579,989,12,19,3,243,624,1,20,0,0
2125,327,347,556,936,12,19,3,229,589,2,20,0,0
2126,325,336,551,915,12,19,3,226,579,3,20,0,0
2127,338,318,547,857,12,19,3,209,539,4,20,0,0
2128,347,306,548,825,12,19,3,201,519,5,20,0,0
2129,342,298,539,807,12,19,3,197,509,6,20,0,0
2130,342,286,526,762,12,19,3,184,476,7,20,0,0
2131,339,282,518,744,12,19,3,179,462,8,20,0,0
2132,340,274,506,706,12,19,3,166,432,9,20,0,0
2133,344,271,501,683,12,19,3,157,412,10,20,0,0
2134,337,268,491,674,12,19,3,154,406,11,20,0,0
2135,322,262,472,661,12,19,3,150,399,12,20,0,0
2136,303,254,451,645,12,19,3,148,391,13,20,0,0
2137,289,253,433,640,12,19,3,144,387,14,20,0,0
2138,279,243,416,615,12,19,3,137,372,15,20,0,0
2139,268,239,398,596,12,19,3,130,357,16,20,0,0
2140,253,242,381,592,12,19,3,128,350,17,20,0,0
2141,231,237,351,573,12,19,3,120,336,18,20,0,0
2142,213,247,323,570,12,19,3,110,323,19,20,0,0
2143,200,244,306,554,12,19,3,106,310,20,20,1,0
3497,364,140,399,240,13,19,3,35,100,0,18,0,0
3498,367,139,402,242,13,19,3,35,103,1,18,0,0
3500,375,142,410,245,13,19,3,35,103,0,18,0,0
3501,380,141,416,247,13,19,3,36,106,1,18,0,0
3502,382,142,419,249,13,19,3,37,107,2,18,0,0
3503,385,142,421,249,13,19,3,36,107,3,18,0,0
3504,388,143,424,250,13,19,3,36,107,4,18,0,0
3505,392,145,428,252,13,19,3,36,107,5,18,0,0
3506,394,145,431,253,13,19,3,37,108,6,18,0,0
3507,397,145,436,257,13,19,3,39,112,7,18,0,0
3508,399,146,438,258,13,19,3,39,112,8,18,0,0
3509,401,145,441,258,13,19,3,40,113,9,18,0,0
3510,404,146,445,262,13,19,3,41,116,10,18,0,0
3511,409,148,450,263,13,19,3,41,115,11,18,0,0
3512,418,148,458,263,13,19,3,40,115,12,18,0,0
3513,424,147,466,264,13,19,3,42,117,13,18,0,0
3514,432,145,474,264,13,19,3,42,119,14,18,0,0
3515,440,148,483,266,13,19,3,43,118,15,18,0,0
3516,452,149,497,272,13,19,3,45,123,16,18,0,0
3517,463,147,508,276,13,19,3,45,129,17,18,0,0
3518,469,147,515,278,13,19,3,46,131,18,18,0,0
1,536,261,574,343,1,19,4,38,82,0,81,0,1
2,536,260,574,343,1,19,4,38,83,1,81,0,0
3,536,259,575,343,1,19,4,39,84,2,81,0,0
4,537,259,576,343,1,19,4,39,84,3,81,0,0
5,537,260,576,343,1,19,4,39,83,4,81,0,0
6,536,260,576,345,1,19,4,40,85,5,81,0,0
7,535,257,577,345,1,19,4,42,88,6,81,0,0
8,535,257,576,345,1,19,4,41,88,7,81,0,0
9,535,256,577,345,1,19,4,42,89,8,81,0,0
10,536,259,576,344,1,19,4,40,85,9,81,0,0
11,535,256,576,343,1,19,4,41,87,10,81,0,0
12,535,256,575,343,1,19,4,40,87,11,81,0,0
13,534,255,575,342,1,19,4,41,87,12,81,0,0
14,535,255,575,342,1,19,4,40,87,13,81,0,0
15,535,255,575,341,1,19,4,40,86,14,81,0,0
16,536,255,577,343,1,19,4,41,88,15,81,0,0
17,535,254,577,344,1,19,4,42,90,16,81,0,0
18,536,256,578,345,1,19,4,42,89,17,81,0,0
19,536,256,578,347,1,19,4,42,91,18,81,0,0
20,536,257,577,346,1,19,4,41,89,19,81,0,0
21,536,259,574,343,1,19,4,38,84,20,81,0,0
22,535,260,573,343,1,19,4,38,83,21,81,0,0
23,535,260,573,342,1,19,4,38,82,22,81,0,0
24,535,260,573,342,1,19,4,38,82,23,81,0,0
25,535,261,573,341,1,19,4,38,80,24,81,0,0
26,539,267,575,343,1,19,4,36,76,25,81,0,0
27,539,268,576,345,1,19,4,37,77,26,81,0,0
28,537,265,576,345,1,19,4,39,80,27,81,0,0
29,537,262,577,344,1,19,4,40,82,28,81,0,0
30,537,261,577,344,1,19,4,40,83,29,81,0,0
31,535,259,577,343,1,19,4,42,84,30,81,0,0
32,535,257,577,343,1,19,4,42,86,31,81,0,0
33,534,258,576,343,1,19,4,42,85,32,81,0,0
34,534,258,576,342,1,19,4,42,84,33,81,0,0
35,534,257,576,342,1,19,4,42,85,34,81,0,0
36,535,258,578,346,1,19,4,43,88,35,81,0,0
37,536,261,578,347,1,19,4,42,86,36,81,0,0
38,536,261,578,346,1,19,4,42,85,37,81,0,0
39,537,263,579,347,1,19,4,42,84,38,81,0,0
40,535,261,576,345,1,19,4,41,84,39,81,0,0
41,535,259,576,343,1,19,4,41,84,40,81,0,0
42,534,257,576,342,1,19,4,42,85,41,81,0,0
43,535,258,576,342,1,19,4,41,84,42,81,0,0
44,535,260,575,341,1,19,4,40,81,43,81,0,0
45,534,258,574,339,1,19,4,40,81,44,81,0,0
46,535,260,574,343,1,19,4,39,83,45,81,0,0
47,535,262,574,343,1,19,4,39,81,46,81,0,0
48,535,262,574,343,1,19,4,39,81,47,81,0,0
49,532,257,573,341,1,19,4,41,84,48,81,0,0
50,535,261,575,344,1,19,4,40,83,49,81,0,0
51,535,260,576,344,1,19,4,41,84,50,81,0,0
52,536,262,576,344,1,19,4,40,82,51,81,0,0
53,536,262,576,344,1,19,4,40,82,52,81,0,0
54,536,262,576,344,1,19,4,40,82,53,81,0,0
55,535,258,577,345,1,19,4,42,87,54,81,0,0
56,535,258,576,344,1,19,4,41,86,55,81,0,0
57,535,260,576,344,1,19,4,41,84,56,81,0,0
58,535,260,576,344,1,19,4,41,84,57,81,0,0
59,537,263,575,343,1,19,4,38,80,58,81,0,0
60,536,261,575,343,1,19,4,39,82,59,81,0,0
61,536,262,575,345,1,19,4,39,83,60,81,0,0
62,536,261,576,345,1,19,4,40,84,61,81,0,0
63,537,263,575,344,1,19,4,38,81,62,81,0,0
64,535,262,575,344,1,19,4,40,82,63,81,0,0
65,535,262,575,344,1,19,4,40,82,64,81,0,0
66,535,257,577,346,1,19,4,42,89,65,81,0,0
67,535,257,577,346,1,19,4,42,89,66,81,0,0
68,535,259,576,345,1,19,4,41,86,67,81,0,0
69,535,259,576,345,1,19,4,41,86,68,81,0,0
70,536,259,578,347,1,19,4,42,88,69,81,0,0
71,535,259,576,345,1,19,4,41,86,70,81,0,0
72,535,259,575,344,1,19,4,40,85,71,81,0,0
73,534,259,575,345,1,19,4,41,86,72,81,0,0
74,535,259,576,346,1,19,4,41,87,73,81,0,0
75,535,261,575,346,1,19,4,40,85,74,81,0,0
76,534,258,576,347,1,19,4,42,89,75,81,0,0
77,533,256,576,347,1,19,4,43,91,76,81,0,0
78,535,258,576,344,1,19,4,41,86,77,81,0,0
79,535,259,575,344,1,19,4,40,85,78,81,0,0
80,536,257,576,345,1,19,4,40,88,79,81,0,0
81,536,259,576,344,1,19,4,40,85,80,81,0,0
82,536,259,576,344,1,19,4,40,85,81,81,1,0
84,535,259,571,338,1,19,4,36,79,0,81,0,0
85,534,258,571,339,1,19,4,37,81,1,81,0,0
86,534,258,570,338,1,19,4,36,80,2,81,0,0
89,535,262,573,347,1,19,4,38,85,0,81,0,0
90,535,262,573,348,1,19,4,38,86,1,81,0,0
91,539,268,574,347,1,19,4,35,79,2,81,0,0
92,537,266,574,347,1,19,4,37,81,3,81,0,0
93,538,266,575,347,1,19,4,37,81,4,81,0,0
95,536,261,574,343,1,19,4,38,82,0,81,0,0
96,535,256,575,344,1,19,4,40,88,1,81,0,0
97,533,254,574,342,1,19,4,41,88,2,81,0,0
98,532,253,573,342,1,19,4,41,89,3,81,0,0
99,533,252,575,343,1,19,4,42,91,4,81,0,0
100,532,253,572,342,1,19,4,40,89,5,81,0,0
101,532,253,572,342,1,19,4,40,89,6,81,0,0
103,535,257,575,345,1,19,4,40,88,0,81,0,1
104,535,257,575,345,1,19,4,40,88,1,81,0,0
105,534,255,576,346,1,19,4,42,91,2,81,0,0
106,536,256,576,345,1,19,4,40,89,3,81,0,0
107,535,258,575,344,1,19,4,40,86,4,81,0,0
108,536,258,576,346,1,19,4,40,88,5,81,0,0
109,535,258,576,345,1,19,4,41,87,6,81,0,0
110,534,258,575,345,1,19,4,41,87,7,81,0,0
111,535,257,576,345,1,19,4,41,88,8,81,0,0
112,535,257,577,345,1,19,4,42,88,9,81,0,0
113,535,255,577,346,1,19,4,42,91,10,81,0,0
114,535,255,578,346,1,19,4,43,91,11,81,0,0
115,535,254,579,346,1,19,4,44,92,12,81,0,0
116,535,258,576,344,1,19,4,41,86,13,81,0,0
117,536,261,575,342,1,19,4,39,81,14,81,0,0
118,536,261,576,343,1,19,4,40,82,15,81,0,0
119,536,260,577,343,1,19,4,41,83,16,81,0,0
120,535,260,574,342,1,19,4,39,82,17,81,0,0
121,533,256,574,341,1,19,4,41,85,18,81,0,0
122,534,256,574,341,1,19,4,40,85,19,81,0,0
123,534,257,574,343,1,19,4,40,86,20,81,0,0
124,535,260,575,345,1,19,4,40,85,21,81,0,0
125,530,243,576,342,1,19,4,46,99,22,81,0,0
126,533,247,580,348,1,19,4,47,101,23,81,0,0
127,534,252,578,349,1,19,4,44,97,24,81,0,0
128,534,257,577,350,1,19,4,43,93,25,81,0,0
129,534,257,573,344,1,19,4,39,87,26,81,0,0
130,533,257,572,344,1,19,4,39,87,27,81,0,0
131,536,257,577,347,1,19,4,41,90,28,81,0,0
132,536,257,577,348,1,19,4,41,91,29,81,0,0
134,536,256,578,348,1,19,4,42,92,0,81,0,1
135,537,257,576,342,1,19,4,39,85,1,81,0,0
136,535,260,574,344,1,19,4,39,84,2,81,0,0
137,533,257,574,345,1,19,4,41,88,3,81,0,0
138,532,257,571,340,1,19,4,39,83,4,81,0,0
139,531,254,571,341,1,19,4,40,87,5,81,0,0
140,531,254,570,340,1,19,4,39,86,6,81,0,0
141,535,260,573,343,1,19,4,38,83,7,81,0,0
142,535,260,571,340,1,19,4,36,80,8,81,0,0
143,535,260,571,340,1,19,4,36,80,9,81,0,0
144,536,260,574,344,1,19,4,38,84,10,81,0,0
145,539,268,576,348,1,19,4,37,80,11,81,0,0
146,538,261,579,351,1,19,4,41,90,12,81,0,0
147,537,260,579,350,1,19,4,42,90,13,81,0,0
148,537,260,578,350,1,19,4,41,90,14,81,0,0
149,534,255,577,349,1,19,4,43,94,15,81,0,0
150,534,256,577,350,1,19,4,43,94,16,81,0,0
151,535,261,575,349,1,19,4,40,88,17,81,0,0
152,534,261,575,349,1,19,4,41,88,18,81,0,0
153,536,263,574,348,1,19,4,38,85,19,81,0,0
154,535,265,572,346,1,19,4,37,81,20,81,0,0
155,535,264,572,346,1,19,4,37,82,21,81,0,0
156,538,267,575,347,1,19,4,37,80,22,81,0,0
157,540,270,575,347,1,19,4,35,77,23,81,0,0
158,540,271,576,347,1,19,4,36,76,24,81,0,0
159,538,266,574,344,1,19,4,36,78,25,81,0,0
160,537,265,574,344,1,19,4,37,79,26,81,0,0
161,536,263,574,343,1,19,4,38,80,27,81,0,0
162,537,262,576,344,1,19,4,39,82,28,81,0,0
163,536,262,575,343,1,19,4,39,81,29,81,0,0
164,535,261,574,343,1,19,4,39,82,30,81,0,0
165,537,260,577,344,1,19,4,40,84,31,81,0,0
166,537,259,577,344,1,19,4,40,85,32,81,0,0
167,536,258,577,342,1,19,4,41,84,33,81,0,0
168,537,258,578,343,1,19,4,41,85,34,81,0,0
169,537,258,578,343,1,19,4,41,85,35,81,0,0
170,536,258,577,342,1,19,4,41,84,36,81,0,0
171,536,260,578,345,1,19,4,42,85,37,81,0,0
172,537,261,578,346,1,19,4,41,85,38,81,0,0
173,536,259,578,347,1,19,4,42,88,39,81,0,0
174,536,259,578,347,1,19,4,42,88,40,81,0,0
175,535,257,579,347,1,19,4,44,90,41,81,0,0
176,536,258,579,345,1,19,4,43,87,42,81,0,0
177,536,257,579,345,1,19,4,43,88,43,81,0,0
178,537,259,578,345,1,19,4,41,86,44,81,0,0
179,535,258,576,343,1,19,4,41,85,45,81,0,0
180,536,259,577,344,1,19,4,41,85,46,81,0,0
181,533,257,573,342,1,19,4,40,85,47,81,0,0
182,532,256,572,341,1,19,4,40,85,48,81,0,0
183,534,258,573,343,1,19,4,39,85,49,81,0,0
184,534,259,573,342,1,19,4,39,83,50,81,0,0
185,535,259,574,343,1,19,4,39,84,51,81,0,0
186,536,259,575,343,1,19,4,39,84,52,81,0,0
187,536,258,577,345,1,19,4,41,87,53,81,0,0
188,535,256,577,345,1,19,4,42,89,54,81,0,0
189,535,259,575,343,1,19,4,40,84,55,81,0,0
190,535,259,575,343,1,19,4,40,84,56,81,0,0
191,534,256,577,345,1,19,4,43,89,57,81,0,0
192,534,256,577,345,1,19,4,43,89,58,81,0,0
193,535,256,578,347,1,19,4,43,91,59,81,0,0
194,535,256,579,347,1,19,4,44,91,60,81,0,0
195,536,260,577,346,1,19,4,41,86,61,81,0,0
196,536,259,578,348,1,19,4,42,89,62,81,0,0
197,537,261,578,346,1,19,4,41,85,63,81,0,0
198,537,260,579,347,1,19,4,42,87,64,81,0,0
199,537,262,578,347,1,19,4,41,85,65,81,0,0
200,536,260,578,346,1,19,4,42,86,66,81,0,0
201,536,260,578,346,1,19,4,42,86,67,81,0,0
202,532,249,578,345,1,19,4,46,96,68,81,0,0
203,533,252,577,345,1,19,4,44,93,69,81,0,0
204,532,251,577,345,1,19,4,45,94,70,81,0,0
207,533,248,578,344,1,19,4,45,96,0,81,0,0
208,533,247,578,344,1,19,4,45,97,1,81,0,0
210,539,265,576,344,1,19,4,37,79,0,81,0,0
211,538,263,575,342,1,19,4,37,79,1,81,0,0
212,537,264,574,341,1,19,4,37,77,2,81,0,0
213,536,260,574,341,1,19,4,38,81,3,81,0,0
214,536,258,575,342,1,19,4,39,84,4,81,0,0
215,533,251,576,341,1,19,4,43,90,5,81,0,0
216,533,249,576,341,1,19,4,43,92,6,81,0,0
217,534,255,575,343,1,19,4,41,88,7,81,0,0
218,530,238,579,345,1,19,4,49,107,8,81,0,0
219,532,244,579,346,1,19,4,47,102,9,81,0,0
220,535,255,577,346,1,19,4,42,91,10,81,0,0
221,538,263,578,349,1,19,4,40,86,11,81,0,0
222,537,262,577,348,1,19,4,40,86,12,81,0,0
223,537,260,578,349,1,19,4,41,89,13,81,0,0
224,537,259,578,350,1,19,4,41,91,14,81,0,0
225,539,266,578,351,1,19,4,39,85,15,81,0,0
226,539,268,575,347,1,19,4,36,79,16,81,0,0
227,539,269,575,347,1,19,4,36,78,17,81,0,0
230,532,249,570,333,1,19,4,38,84,0,81,0,0
231,535,245,576,338,1,19,4,41,93,1,81,0,0
232,534,245,577,342,1,19,4,43,97,2,81,0,0
233,536,250,576,340,1,19,4,40,90,3,81,0,0
234,537,253,576,339,1,19,4,39,86,4,81,0,0
235,536,250,576,339,1,19,4,40,89,5,81,0,0
236,537,261,573,340,1,19,4,36,79,6,81,0,0
237,535,261,570,339,1,19,4,35,78,7,81,0,0
238,533,256,570,338,1,19,4,37,82,8,81,0,0
239,533,256,570,338,1,19,4,37,82,9,81,0,0
242,533,250,572,338,1,19,4,39,88,0,81,0,0
243,534,252,572,339,1,19,4,38,87,1,81,0,0
244,536,255,575,346,1,19,4,39,91,2,81,0,0
246,538,261,576,346,1,19,4,38,85,0,81,0,1
247,538,261,576,346,1,19,4,38,85,1,81,0,0
248,536,256,576,346,1,19,4,40,90,2,81,0,0
249,535,256,573,341,1,19,4,38,85,3,81,0,0
250,534,251,575,341,1,19,4,41,90,4,81,0,0
251,536,261,575,346,1,19,4,39,85,5,81,0,0
252,537,262,575,346,1,19,4,38,84,6,81,0,0
253,536,260,576,347,1,19,4,40,87,7,81,0,0
254,533,246,579,348,1,19,4,46,102,8,81,0,0
255,535,257,577,347,1,19,4,42,90,9,81,0,0
256,536,259,576,345,1,19,4,40,86,10,81,0,0
257,537,261,576,347,1,19,4,39,86,11,81,0,0
258,532,236,580,343,1,19,4,48,107,12,81,0,0
259,535,250,577,344,1,19,4,42,94,13,81,0,0
260,535,249,577,344,1,19,4,42,95,14,81,0,0
261,535,257,575,344,1,19,4,40,87,15,81,0,0
262,536,258,576,344,1,19,4,40,86,16,81,0,0
263,536,257,576,344,1,19,4,40,87,17,81,0,0
264,535,257,576,345,1,19,4,41,88,18,81,0,0
265,535,259,574,342,1,19,4,39,83,19,81,0,0
266,536,263,572,342,1,19,4,36,79,20,81,0,0
267,536,265,572,343,1,19,4,36,78,21,81,0,0
268,536,263,573,343,1,19,4,37,80,22,81,0,0
269,537,264,574,345,1,19,4,37,81,23,81,0,0
270,536,261,572,342,1,19,4,36,81,24,81,0,0
271,539,263,575,343,1,19,4,36,80,25,81,0,0
272,539,263,575,343,1,19,4,36,80,26,81,0,0
276,534,245,580,348,1,19,4,46,103,0,81,0,1
277,535,251,579,347,1,19,4,44,96,1,81,0,0
278,534,250,578,347,1,19,4,44,97,2,81,0,0
279,535,249,579,348,1,19,4,44,99,3,81,0,0
280,534,248,578,347,1,19,4,44,99,4,81,0,0
281,535,251,579,347,1,19,4,44,96,5,81,0,0
282,536,256,576,345,1,19,4,40,89,6,81,0,0
283,537,256,578,345,1,19,4,41,89,7,81,0,0
284,535,256,574,342,1,19,4,39,86,8,81,0,0
285,535,257,575,343,1,19,4,40,86,9,81,0,0
286,537,263,575,344,1,19,4,38,81,10,81,0,0
287,537,264,575,344,1,19,4,38,80,11,81,0,0
288,537,265,573,342,1,19,4,36,77,12,81,0,0
289,536,266,572,342,1,19,4,36,76,13,81,0,0
290,536,263,575,346,1,19,4,39,83,14,81,0,0
291,536,262,574,344,1,19,4,38,82,15,81,0,0
292,536,261,574,343,1,19,4,38,82,16,81,0,0
293,535,261,571,340,1,19,4,36,79,17,81,0,0
294,534,261,571,339,1,19,4,37,78,18,81,0,0
295,536,260,575,344,1,19,4,39,84,19,81,0,0
296,535,262,574,344,1,19,4,39,82,20,81,0,0
297,537,262,576,346,1,19,4,39,84,21,81,0,0
298,537,262,576,347,1,19,4,39,85,22,81,0,0
299,536,264,574,345,1,19,4,38,81,23,81,0,0
300,535,261,574,346,1,19,4,39,85,24,81,0,0
301,535,261,574,346,1,19,4,39,85,25,81,0,0
302,537,257,577,346,1,19,4,40,89,26,81,0,0
303,537,259,576,344,1,19,4,39,85,27,81,0,0
304,537,262,575,345,1,19,4,38,83,28,81,0,0
305,538,266,573,343,1,19,4,35,77,29,81,0,0
306,538,266,573,343,1,19,4,35,77,30,81,0,0
307,538,263,575,344,1,19,4,37,81,31,81,0,0
308,538,264,575,344,1,19,4,37,80,32,81,0,0
310,536,257,575,342,1,19,4,39,85,0,81,0,0
311,536,260,575,344,1,19,4,39,84,1,81,0,0
312,536,261,574,344,1,19,4,38,83,2,81,0,0
313,536,260,575,344,1,19,4,39,84,3,81,0,0
314,536,260,575,344,1,19,4,39,84,4,81,0,0
315,536,262,574,345,1,19,4,38,83,5,81,0,0
316,535,253,577,345,1,19,4,42,92,6,81,0,0
317,535,256,575,343,1,19,4,40,87,7,81,0,0
318,536,260,574,342,1,19,4,38,82,8,81,0,0
319,537,264,573,342,1,19,4,36,78,9,81,0,0
320,535,259,574,342,1,19,4,39,83,10,81,0,0
321,535,259,574,342,1,19,4,39,83,11,81,0,0
323,537,258,575,341,1,19,4,38,83,0,81,0,1
324,537,262,574,342,1,19,4,37,80,1,81,0,0
325,537,262,574,342,1,19,4,37,80,2,81,0,0
326,533,251,574,342,1,19,4,41,91,3,81,0,0
327,535,257,574,343,1,19,4,39,86,4,81,0,0
328,534,257,572,341,1,19,4,38,84,5,81,0,0
329,535,254,573,340,1,19,4,38,86,6,81,0,0
330,534,253,573,340,1,19,4,39,87,7,81,0,0
331,537,256,576,343,1,19,4,39,87,8,81,0,0
332,537,257,575,345,1,19,4,38,88,9,81,0,0
333,534,249,575,344,1,19,4,41,95,10,81,0,0
334,533,247,575,344,1,19,4,42,97,11,81,0,0
335,538,261,573,344,1,19,4,35,83,12,81,0,0
336,536,252,574,342,1,19,4,38,90,13,81,0,0
337,535,253,573,341,1,19,4,38,88,14,81,0,0
338,535,252,573,341,1,19,4,38,89,15,81,0,0
339,537,259,574,342,1,19,4,37,83,16,81,0,0
340,536,259,574,344,1,19,4,38,85,17,81,0,0
341,536,256,576,345,1,19,4,40,89,18,81,0,0
342,536,256,576,345,1,19,4,40,89,19,81,0,0
344,538,258,576,344,1,19,4,38,86,0,81,0,0
345,539,263,575,342,1,19,4,36,79,1,81,0,0
346,539,263,575,342,1,19,4,36,79,2,81,0,0
347,535,257,573,342,1,19,4,38,85,3,81,0,0
348,536,256,574,343,1,19,4,38,87,4,81,0,0
349,535,256,574,343,1,19,4,39,87,5,81,0,0
350,538,259,574,343,1,19,4,36,84,6,81,0,0
356,536,253,576,343,1,19,4,40,90,0,81,0,0
357,535,252,576,343,1,19,4,41,91,1,81,0,0
360,536,259,575,343,1,19,4,39,84,0,81,0,1
361,535,256,576,343,1,19,4,41,87,1,81,0,0
362,535,258,575,343,1,19,4,40,85,2,81,0,0
363,535,258,576,343,1,19,4,41,85,3,81,0,0
364,534,257,576,343,1,19,4,42,86,4,81,0,0
365,536,263,575,343,1,19,4,39,80,5,81,0,0
366,536,259,577,345,1,19,4,41,86,6,81,0,0
367,535,256,578,346,1,19,4,43,90,7,81,0,0
368,534,256,576,346,1,19,4,42,90,8,81,0,0
369,534,256,577,347,1,19,4,43,91,9,81,0,0
370,534,256,578,347,1,19,4,44,91,10,81,0,0
371,536,257,578,346,1,19,4,42,89,11,81,0,0
372,536,257,578,345,1,19,4,42,88,12,81,0,0
373,536,258,578,345,1,19,4,42,87,13,81,0,0
374,536,257,577,343,1,19,4,41,86,14,81,0,0
375,535,255,577,342,1,19,4,42,87,15,81,0,0
376,536,257,577,342,1,19,4,41,85,16,81,0,0
377,536,260,576,343,1,19,4,40,83,17,81,0,0
378,536,259,576,343,1,19,4,40,84,18,81,0,0
379,537,257,577,343,1,19,4,40,86,19,81,0,0
380,536,257,577,345,1,19,4,41,88,20,81,0,0
381,535,256,576,344,1,19,4,41,88,21,81,0,0
382,535,256,576,344,1,19,4,41,88,22,81,0,0
384,533,251,575,344,1,19,4,42,93,0,81,0,0
385,532,251,575,344,1,19,4,43,93,1,81,0,0
386,534,259,574,345,1,19,4,40,86,2,81,0,0
387,535,261,574,345,1,19,4,39,84,3,81,0,0
388,535,260,575,346,1,19,4,40,86,4,81,0,0
389,536,259,576,346,1,19,4,40,87,5,81,0,0
390,536,261,576,347,1,19,4,40,86,6,81,0,0
391,535,256,577,346,1,19,4,42,90,7,81,0,0
392,536,259,576,344,1,19,4,40,85,8,81,0,0
393,535,255,576,342,1,19,4,41,87,9,81,0,0
394,537,265,575,344,1,19,4,38,79,10,81,0,0
395,538,265,575,344,1,19,4,37,79,11,81,0,0
400,539,267,577,347,1,19,4,38,80,0,81,0,0
401,537,256,579,345,1,19,4,42,89,1,81,0,0
402,536,257,577,345,1,19,4,41,88,2,81,0,0
403,536,254,578,345,1,19,4,42,91,3,81,0,0
404,536,254,579,345,1,19,4,43,91,4,81,0,0
406,534,256,576,345,1,19,4,42,89,0,81,0,0
407,534,255,577,344,1,19,4,43,89,1,81,0,0
408,533,253,577,344,1,19,4,44,91,2,81,0,0
409,533,253,576,343,1,19,4,43,90,3,81,0,0
410,533,253,577,344,1,19,4,44,91,4,81,0,0
411,534,257,576,343,1,19,4,42,86,5,81,0,0
412,536,261,575,343,1,19,4,39,82,6,81,0,0
413,536,261,576,342,1,19,4,40,81,7,81,0,0
414,537,263,576,342,1,19,4,39,79,8,81,0,0
415,538,264,576,342,1,19,4,38,78,9,81,0,0
416,536,261,578,347,1,19,4,42,86,10,81,0,0
417,536,262,578,348,1,19,4,42,86,11,81,0,0
426,532,257,576,346,1,19,4,44,89,0,81,0,0
427,532,256,573,342,1,19,4,41,86,1,81,0,0
428,531,255,572,342,1,19,4,41,87,2,81,0,0
429,532,257,571,341,1,19,4,39,84,3,81,0,0
430,533,259,569,336,1,19,4,36,77,4,81,0,0
431,535,262,571,340,1,19,4,36,78,5,81,0,0
432,535,262,571,339,1,19,4,36,77,6,81,0,0
434,535,262,572,341,1,19,4,37,79,0,81,0,0
435,535,262,572,341,1,19,4,37,79,1,81,0,0
436,537,259,575,341,1,19,4,38,82,2,81,0,0
437,538,260,576,341,1,19,4,38,81,3,81,0,0
438,536,256,575,338,1,19,4,39,82,4,81,0,0
439,536,255,574,337,1,19,4,38,82,5,81,0,0
440,536,255,574,337,1,19,4,38,82,6,81,0,0
442,537,262,573,338,1,19,4,36,76,0,81,0,0
443,538,262,573,338,1,19,4,35,76,1,81,0,0
445,537,264,573,342,1,19,4,36,78,0,81,0,0
446,536,261,575,343,1,19,4,39,82,1,81,0,0
447,536,259,576,343,1,19,4,40,84,2,81,0,0
448,537,261,577,345,1,19,4,40,84,3,81,0,0
449,536,263,574,343,1,19,4,38,80,4,81,0,0
450,536,264,574,344,1,19,4,38,80,5,81,0,0
451,535,264,573,342,1,19,4,38,78,6,81,0,0
452,535,264,573,343,1,19,4,38,79,7,81,0,0
216,732,215,783,344,2,19,4,51,129,0,0,0,0
254,416,352,459,451,3,19,4,43,99,0,1,0,0
255,415,352,458,451,3,19,4,43,99,1,1,0,0
266,725,206,784,346,4,19,4,59,140,0,0,0,0
309,534,237,576,342,5,19,4,42,105,0,0,0,0
313,726,210,779,346,6,19,4,53,136,0,0,0,0
319,719,202,785,347,7,19,4,66,145,0,0,0,0
326,734,218,788,347,8,19,4,54,129,0,0,0,0
343,721,213,787,349,9,19,4,66,136,0,0,0,0
427,417,350,459,453,10,19,4,42,103,0,49,0,0
428,417,348,459,451,10,19,4,42,103,1,49,0,0
429,417,348,459,451,10,19,4,42,103,2,49,0,0
430,417,348,458,451,10,19,4,41,103,3,49,0,0
457,539,262,575,346,10,19,4,36,84,0,49,0,0
459,540,264,576,345,10,19,4,36,81,0,49,0,1
460,543,262,579,343,10,19,4,36,81,1,49,0,0
461,538,259,576,344,10,19,4,38,85,2,49,0,0
462,539,259,577,345,10,19,4,38,86,3,49,0,0
463,539,258,577,344,10,19,4,38,86,4,49,0,0
464,538,257,577,343,10,19,4,39,86,5,49,0,0
465,537,257,575,343,10,19,4,38,86,6,49,0,0
466,537,255,577,344,10,19,4,40,89,7,49,0,0
467,536,255,576,342,10,19,4,40,87,8,49,0,0
468,536,255,578,344,10,19,4,42,89,9,49,0,0
469,535,255,577,343,10,19,4,42,88,10,49,0,0
470,535,255,575,342,10,19,4,40,87,11,49,0,0
471,534,253,575,341,10,19,4,41,88,12,49,0,0
472,534,252,575,340,10,19,4,41,88,13,49,0,0
473,534,255,573,339,10,19,4,39,84,14,49,0,0
474,534,254,573,338,10,19,4,39,84,15,49,0,0
475,536,260,574,341,10,19,4,38,81,16,49,0,0
476,536,259,575,342,10,19,4,39,83,17,49,0,0
477,537,261,575,343,10,19,4,38,82,18,49,0,0
478,538,265,574,341,10,19,4,36,76,19,49,0,0
479,538,265,574,341,10,19,4,36,76,20,49,0,0
481,539,265,578,346,10,19,4,39,81,0,49,0,0
482,540,266,578,346,10,19,4,38,80,1,49,0,0
483,538,264,578,347,10,19,4,40,83,2,49,0,0
484,538,264,578,348,10,19,4,40,84,3,49,0,0
485,538,264,577,347,10,19,4,39,83,4,49,0,0
486,536,262,576,345,10,19,4,40,83,5,49,0,0
487,536,262,575,343,10,19,4,39,81,6,49,0,0
488,536,261,575,343,10,19,4,39,82,7,49,0,0
489,535,261,574,345,10,19,4,39,84,8,49,0,0
490,535,257,576,345,10,19,4,41,88,9,49,0,0
491,537,260,575,341,10,19,4,38,81,10,49,0,0
492,536,259,574,341,10,19,4,38,82,11,49,0,0
493,535,261,572,342,10,19,4,37,81,12,49,0,0
494,535,259,573,344,10,19,4,38,85,13,49,0,0
495,534,260,570,341,10,19,4,36,81,14,49,0,0
496,534,260,570,340,10,19,4,36,80,15,49,0,0
497,538,265,574,344,10,19,4,36,79,16,49,0,0
498,539,268,575,348,10,19,4,36,80,17,49,0,0
499,539,269,575,348,10,19,4,36,79,18,49,0,0
501,537,266,574,347,10,19,4,37,81,0,49,0,0
502,537,264,575,347,10,19,4,38,83,1,49,0,0
503,537,265,575,347,10,19,4,38,82,2,49,0,0
506,540,267,576,344,10,19,4,36,77,0,49,0,1
507,539,263,578,346,10,19,4,39,83,1,49,0,0
508,538,261,579,346,10,19,4,41,85,2,49,0,0
509,536,261,577,346,10,19,4,41,85,3,49,0,0
510,538,265,577,345,10,19,4,39,80,4,49,0,0
511,536,259,578,347,10,19,4,42,88,5,49,0,0
512,534,255,576,343,10,19,4,42,88,6,49,0,0
513,533,253,576,345,10,19,4,43,92,7,49,0,0
514,533,252,578,347,10,19,4,45,95,8,49,0,0
515,533,252,576,344,10,19,4,43,92,9,49,0,0
516,536,259,575,343,10,19,4,39,84,10,49,0,0
517,536,258,578,346,10,19,4,42,88,11,49,0,0
518,536,260,575,342,10,19,4,39,82,12,49,0,0
519,536,263,574,344,10,19,4,38,81,13,49,0,0
520,534,257,576,345,10,19,4,42,88,14,49,0,0
521,533,255,574,341,10,19,4,41,86,15,49,0,0
522,535,259,574,342,10,19,4,39,83,16,49,0,0
523,534,257,574,342,10,19,4,40,85,17,49,0,0
524,534,257,577,347,10,19,4,43,90,18,49,0,0
525,534,255,575,344,10,19,4,41,89,19,49,0,0
526,533,257,574,343,10,19,4,41,86,20,49,0,0
527,533,256,573,341,10,19,4,40,85,21,49,0,0
528,534,257,575,343,10,19,4,41,86,22,49,0,0
529,534,257,575,343,10,19,4,41,86,23,49,0,0
530,536,260,575,341,10,19,4,39,81,24,49,0,0
531,536,260,574,341,10,19,4,38,81,25,49,0,0
532,536,261,575,346,10,19,4,39,85,26,49,0,0
533,536,261,575,346,10,19,4,39,85,27,49,0,0
534,536,263,575,346,10,19,4,39,83,28,49,0,0
535,536,262,575,347,10,19,4,39,85,29,49,0,0
536,536,262,575,347,10,19,4,39,85,30,49,0,0
537,533,258,572,341,10,19,4,39,83,31,49,0,0
538,533,258,571,341,10,19,4,38,83,32,49,0,0
541,535,255,575,344,10,19,4,40,89,0,49,0,0
542,534,256,573,342,10,19,4,39,86,1,49,0,0
543,533,256,569,337,10,19,4,36,81,2,49,0,0
544,533,256,569,336,10,19,4,36,80,3,49,0,0
545,533,257,569,339,10,19,4,36,82,4,49,0,0
546,534,257,570,340,10,19,4,36,83,5,49,0,0
547,534,257,569,338,10,19,4,35,81,6,49,0,0
548,533,253,569,337,10,19,4,36,84,7,49,0,0
549,536,257,572,339,10,19,4,36,82,8,49,0,0
551,539,266,575,346,10,19,4,36,80,0,49,0,0
552,537,264,574,346,10,19,4,37,82,1,49,0,0
553,537,264,575,347,10,19,4,38,83,2,49,0,0
554,536,262,575,346,10,19,4,39,84,3,49,0,0
555,540,270,577,349,10,19,4,37,79,4,49,0,0
556,541,271,577,349,10,19,4,36,78,5,49,0,0
557,538,262,577,346,10,19,4,39,84,6,49,0,0
558,539,267,577,349,10,19,4,38,82,7,49,0,0
559,539,267,577,349,10,19,4,38,82,8,49,0,0
560,536,261,573,342,10,19,4,37,81,9,49,0,0
561,536,261,573,341,10,19,4,37,80,10,49,0,0
564,535,256,575,344,10,19,4,40,88,0,49,0,0
565,535,255,575,344,10,19,4,40,89,1,49,0,0
571,538,259,577,344,10,19,4,39,85,0,49,0,0
572,538,262,575,341,10,19,4,37,79,1,49,0,0
573,538,262,574,341,10,19,4,36,79,2,49,0,0
581,536,257,578,347,10,19,4,42,90,0,49,0,0
582,536,256,578,348,10,19,4,42,92,1,49,0,0
588,535,259,572,337,10,19,4,37,78,0,49,0,0
589,535,259,571,337,10,19,4,36,78,1,49,0,0
590,536,260,575,341,10,19,4,39,81,2,49,0,0
591,536,260,575,341,10,19,4,39,81,3,49,0,0
592,535,261,574,342,10,19,4,39,81,4,49,0,0
593,536,264,572,340,10,19,4,36,76,5,49,0,0
594,535,264,571,340,10,19,4,36,76,6,49,0,0
595,535,266,570,339,10,19,4,35,73,7,49,0,0
596,535,260,574,341,10,19,4,39,81,8,49,0,0
597,534,258,575,342,10,19,4,41,84,9,49,0,0
598,535,260,575,342,10,19,4,40,82,10,49,0,0
599,536,262,575,340,10,19,4,39,78,11,49,0,0
600,536,262,576,342,10,19,4,40,80,12,49,0,0
601,539,270,576,344,10,19,4,37,74,13,49,0,0
602,540,271,577,347,10,19,4,37,76,14,49,0,0
603,538,268,575,345,10,19,4,37,77,15,49,0,0
604,538,268,575,345,10,19,4,37,77,16,49,0,0
611,537,263,576,345,10,19,4,39,82,0,49,0,0
612,537,263,576,345,10,19,4,39,82,1,49,0,0
613,536,262,576,345,10,19,4,40,83,2,49,0,0
614,536,262,576,345,10,19,4,40,83,3,49,0,0
617,534,258,577,346,10,19,4,43,88,0,49,0,0
618,534,257,577,347,10,19,4,43,90,1,49,0,0
621,535,259,575,342,10,19,4,40,83,0,49,0,1
622,535,261,574,342,10,19,4,39,81,1,49,0,0
623,536,262,575,341,10,19,4,39,79,2,49,0,0
624,536,261,577,347,10,19,4,41,86,3,49,0,0
625,536,261,575,345,10,19,4,39,84,4,49,0,0
626,535,255,575,340,10,19,4,40,85,5,49,0,0
627,535,254,574,338,10,19,4,39,84,6,49,0,0
628,536,258,573,336,10,19,4,37,78,7,49,0,0
629,534,256,570,335,10,19,4,36,79,8,49,0,0
630,533,255,569,335,10,19,4,36,80,9,49,0,0
631,533,253,571,338,10,19,4,38,85,10,49,0,0
632,533,250,573,340,10,19,4,40,90,11,49,0,0
633,534,252,574,343,10,19,4,40,91,12,49,0,0
634,534,251,574,343,10,19,4,40,92,13,49,0,0
635,534,254,574,343,10,19,4,40,89,14,49,0,0
636,536,259,573,343,10,19,4,37,84,15,49,0,0
637,537,261,573,343,10,19,4,36,82,16,49,0,0
638,536,261,575,349,10,19,4,39,88,17,49,0,0
639,536,261,576,350,10,19,4,40,89,18,49,0,0
640,536,262,574,347,10,19,4,38,85,19,49,0,0
641,535,252,575,343,10,19,4,40,91,20,49,0,0
642,535,252,575,341,10,19,4,40,89,21,49,0,0
643,535,255,576,347,10,19,4,41,92,22,49,0,0
644,535,253,575,343,10,19,4,40,90,23,49,0,0
645,534,254,574,344,10,19,4,40,90,24,49,0,0
646,535,253,573,339,10,19,4,38,86,25,49,0,0
647,537,259,572,340,10,19,4,35,81,26,49,0,0
648,535,259,570,338,10,19,4,35,79,27,49,0,0
651,537,257,577,350,10,19,4,40,93,0,49,0,0
652,536,254,576,347,10,19,4,40,93,1,49,0,0
653,535,252,575,347,10,19,4,40,95,2,49,0,0
654,535,252,576,347,10,19,4,41,95,3,49,0,0
655,534,250,574,342,10,19,4,40,92,4,49,0,0
656,534,252,575,346,10,19,4,41,94,5,49,0,0
657,535,250,575,343,10,19,4,40,93,6,49,0,0
658,535,250,575,343,10,19,4,40,93,7,49,0,0
664,533,246,576,343,10,19,4,43,97,0,49,0,0
665,533,245,576,343,10,19,4,43,98,1,49,0,0
666,535,254,576,346,10,19,4,41,92,2,49,0,0
667,534,253,576,346,10,19,4,42,93,3,49,0,0
668,536,258,575,344,10,19,4,39,86,4,49,0,0
669,534,250,576,343,10,19,4,42,93,5,49,0,0
670,534,249,576,343,10,19,4,42,94,6,49,0,0
671,537,258,576,345,10,19,4,39,87,7,49,0,0
672,537,260,575,345,10,19,4,38,85,8,49,0,0
673,538,265,574,346,10,19,4,36,81,9,49,0,0
674,535,251,577,345,10,19,4,42,94,10,49,0,0
675,535,250,577,345,10,19,4,42,95,11,49,0,0
679,536,253,574,338,10,19,4,38,85,0,49,0,0
680,537,258,573,338,10,19,4,36,80,1,49,0,0
681,535,256,570,335,10,19,4,35,79,2,49,0,0
686,536,259,573,341,10,19,4,37,82,0,49,0,0
687,537,259,573,342,10,19,4,36,83,1,49,0,0
688,535,254,573,342,10,19,4,38,88,2,49,0,0
689,536,259,573,342,10,19,4,37,83,3,49,0,0
690,538,261,573,342,10,19,4,35,81,4,49,0,0
691,538,262,573,342,10,19,4,35,80,5,49,0,0
696,536,263,574,347,10,19,4,38,84,0,49,0,0
697,536,263,574,348,10,19,4,38,85,1,49,0,0
700,533,256,570,341,10,19,4,37,85,0,49,0,0
701,534,258,569,339,10,19,4,35,81,1,49,0,0
703,535,258,571,340,10,19,4,36,82,0,49,0,0
704,535,258,571,340,10,19,4,36,82,1,49,0,0
707,536,261,574,345,10,19,4,38,84,0,49,0,0
708,537,262,574,345,10,19,4,37,83,1,49,0,0
709,537,262,576,349,10,19,4,39,87,2,49,0,0
710,537,262,576,349,10,19,4,39,87,3,49,0,0
711,540,265,578,350,10,19,4,38,85,4,49,0,0
712,542,270,578,350,10,19,4,36,80,5,49,0,0
713,540,261,579,350,10,19,4,39,89,6,49,0,0
714,540,260,579,349,10,19,4,39,89,7,49,0,0
715,538,254,580,348,10,19,4,42,94,8,49,0,0
716,538,252,579,347,10,19,4,41,95,9,49,0,0
717,537,253,578,347,10,19,4,41,94,10,49,0,0
720,539,261,577,344,10,19,4,38,83,0,49,0,0
721,537,257,577,343,10,19,4,40,86,1,49,0,0
722,537,258,576,343,10,19,4,39,85,2,49,0,0
723,536,255,577,344,10,19,4,41,89,3,49,0,0
724,535,253,578,344,10,19,4,43,91,4,49,0,0
725,535,249,580,345,10,19,4,45,96,5,49,0,0
726,535,253,577,345,10,19,4,42,92,6,49,0,0
727,536,257,576,344,10,19,4,40,87,7,49,0,0
728,535,251,577,343,10,19,4,42,92,8,49,0,0
729,535,254,574,341,10,19,4,39,87,9,49,0,0
730,537,259,575,343,10,19,4,38,84,10,49,0,0
731,537,257,576,342,10,19,4,39,85,11,49,0,0
732,537,257,576,344,10,19,4,39,87,12,49,0,0
733,536,259,575,345,10,19,4,39,86,13,49,0,0
734,537,261,575,345,10,19,4,38,84,14,49,0,0
735,535,257,574,343,10,19,4,39,86,15,49,0,0
736,535,256,574,343,10,19,4,39,87,16,49,0,0
737,540,264,577,347,10,19,4,37,83,17,49,0,0
741,539,266,574,343,10,19,4,35,77,0,49,0,0
742,536,258,573,341,10,19,4,37,83,1,49,0,0
743,536,257,574,343,10,19,4,38,86,2,49,0,0
744,535,256,574,343,10,19,4,39,87,3,49,0,0
745,535,257,573,343,10,19,4,38,86,4,49,0,0
746,536,260,573,343,10,19,4,37,83,5,49,0,0
747,536,259,572,343,10,19,4,36,84,6,49,0,0
755,539,269,576,348,10,19,4,37,79,0,49,0,0
756,539,269,576,348,10,19,4,37,79,1,49,0,0
761,533,250,573,337,10,19,4,40,87,0,49,0,1
762,533,248,573,336,10,19,4,40,88,1,49,0,0
763,534,250,575,339,10,19,4,41,89,2,49,0,0
764,534,252,575,340,10,19,4,41,88,3,49,0,0
765,534,251,575,339,10,19,4,41,88,4,49,0,0
766,534,257,574,341,10,19,4,40,84,5,49,0,0
767,535,259,576,344,10,19,4,41,85,6,49,0,0
768,534,259,576,347,10,19,4,42,88,7,49,0,0
769,534,258,578,351,10,19,4,44,93,8,49,0,0
770,534,258,578,352,10,19,4,44,94,9,49,0,0
771,534,255,576,345,10,19,4,42,90,10,49,0,0
772,535,259,575,345,10,19,4,40,86,11,49,0,0
773,536,259,574,341,10,19,4,38,82,12,49,0,0
774,537,261,573,340,10,19,4,36,79,13,49,0,0
775,537,260,573,339,10,19,4,36,79,14,49,0,0
776,539,266,575,346,10,19,4,36,80,15,49,0,0
777,536,259,577,347,10,19,4,41,88,16,49,0,0
778,536,257,578,349,10,19,4,42,92,17,49,0,0
779,536,257,578,349,10,19,4,42,92,18,49,0,0
780,536,258,576,347,10,19,4,40,89,19,49,0,0
784,539,266,574,343,10,19,4,35,77,0,49,0,0
785,539,268,574,344,10,19,4,35,76,1,49,0,0
786,539,270,574,345,10,19,4,35,75,2,49,0,0
790,541,272,577,346,10,19,4,36,74,0,49,0,0
791,539,263,578,347,10,19,4,39,84,1,49,0,0
792,539,264,579,348,10,19,4,40,84,2,49,0,0
793,537,260,579,348,10,19,4,42,88,3,49,0,0
794,538,258,579,346,10,19,4,41,88,4,49,0,0
795,537,261,576,343,10,19,4,39,82,5,49,0,0
796,535,258,574,341,10,19,4,39,83,6,49,0,0
797,534,257,574,340,10,19,4,40,83,7,49,0,0
799,535,259,572,338,10,19,4,37,79,0,49,0,0
800,535,258,571,335,10,19,4,36,77,1,49,0,0
801,535,258,571,335,10,19,4,36,77,2,49,0,0
803,533,255,572,338,10,19,4,39,83,0,49,0,0
804,533,254,572,337,10,19,4,39,83,1,49,0,0
805,533,253,573,341,10,19,4,40,88,2,49,0,0
806,534,258,574,343,10,19,4,40,85,3,49,0,0
807,535,260,575,345,10,19,4,40,85,4,49,0,0
808,534,260,574,345,10,19,4,40,85,5,49,0,0
809,534,260,575,346,10,19,4,41,86,6,49,0,0
811,535,261,577,349,10,19,4,42,88,0,49,0,0
812,536,263,574,342,10,19,4,38,79,1,49,0,0
814,538,264,576,344,10,19,4,38,80,0,49,0,0
818,539,266,574,340,10,19,4,35,74,0,49,0,0
819,537,262,575,340,10,19,4,38,78,1,49,0,0
820,537,263,575,342,10,19,4,38,79,2,49,0,0
821,536,261,576,344,10,19,4,40,83,3,49,0,0
822,536,261,577,344,10,19,4,41,83,4,49,0,0
824,537,265,576,345,10,19,4,39,80,0,49,0,1
825,537,264,576,345,10,19,4,39,81,1,49,0,0
826,535,259,575,341,10,19,4,40,82,2,49,0,0
827,535,258,575,341,10,19,4,40,83,3,49,0,0
828,532,248,578,343,10,19,4,46,95,4,49,0,0
829,534,251,578,343,10,19,4,44,92,5,49,0,0
830,533,248,578,342,10,19,4,45,94,6,49,0,0
831,533,254,575,342,10,19,4,42,88,7,49,0,0
832,534,257,575,342,10,19,4,41,85,8,49,0,0
833,535,258,575,343,10,19,4,40,85,9,49,0,0
834,536,263,574,342,10,19,4,38,79,10,49,0,0
835,534,259,572,341,10,19,4,38,82,11,49,0,0
836,535,259,575,343,10,19,4,40,84,12,49,0,0
837,537,262,575,343,10,19,4,38,81,13,49,0,0
838,538,262,576,344,10,19,4,38,82,14,49,0,0
839,538,262,577,345,10,19,4,39,83,15,49,0,0
840,536,261,577,347,10,19,4,41,86,16,49,0,0
841,536,259,574,343,10,19,4,38,84,17,49,0,0
842,536,258,574,341,10,19,4,38,83,18,49,0,0
843,536,260,574,345,10,19,4,38,85,19,49,0,0
844,537,262,574,346,10,19,4,37,84,20,49,0,0
845,536,260,575,348,10,19,4,39,88,21,49,0,0
846,536,260,576,347,10,19,4,40,87,22,49,0,0
847,533,246,578,346,10,19,4,45,100,23,49,0,0
848,533,244,579,346,10,19,4,46,102,24,49,0,0
849,533,249,573,341,10,19,4,40,92,25,49,0,0
850,537,259,574,342,10,19,4,37,83,26,49,0,0
851,534,251,574,339,10,19,4,40,88,27,49,0,0
852,532,247,573,339,10,19,4,41,92,28,49,0,0
853,531,247,571,338,10,19,4,40,91,29,49,0,0
854,531,243,574,342,10,19,4,43,99,30,49,0,0
855,531,242,572,339,10,19,4,41,97,31,49,0,0
856,535,253,574,344,10,19,4,39,91,32,49,0,0
857,535,252,573,341,10,19,4,38,89,33,49,0,0
860,537,262,573,344,10,19,4,36,82,0,49,0,0
861,537,258,573,340,10,19,4,36,82,1,49,0,0
862,537,258,573,340,10,19,4,36,82,2,49,0,0
863,536,258,572,340,10,19,4,36,82,3,49,0,0
866,536,255,574,340,10,19,4,38,85,0,49,0,0
867,536,257,574,340,10,19,4,38,83,1,49,0,0
868,535,256,574,341,10,19,4,39,85,2,49,0,0
869,534,252,575,342,10,19,4,41,90,3,49,0,0
870,535,251,576,342,10,19,4,41,91,4,49,0,0
871,535,253,576,344,10,19,4,41,91,5,49,0,0
872,536,258,575,344,10,19,4,39,86,6,49,0,0
873,535,259,575,345,10,19,4,40,86,7,49,0,0
874,533,249,578,345,10,19,4,45,96,8,49,0,0
875,536,256,576,344,10,19,4,40,88,9,49,0,0
876,532,242,578,343,10,19,4,46,101,10,49,0,0
877,533,251,574,342,10,19,4,41,91,11,49,0,0
878,536,261,574,346,10,19,4,38,85,12,49,0,0
882,537,263,572,341,10,19,4,35,78,0,49,0,0
883,535,260,570,338,10,19,4,35,78,1,49,0,0
884,536,260,571,340,10,19,4,35,80,2,49,0,0
885,535,259,570,340,10,19,4,35,81,3,49,0,0
886,538,257,573,339,10,19,4,35,82,4,49,0,0
887,538,257,575,340,10,19,4,37,83,5,49,0,0
888,536,256,574,341,10,19,4,38,85,6,49,0,0
889,537,255,575,341,10,19,4,38,86,7,49,0,0
890,537,257,574,341,10,19,4,37,84,8,49,0,0
891,537,257,574,341,10,19,4,37,84,9,49,0,0
892,537,261,574,345,10,19,4,37,84,10,49,0,0
893,538,261,575,346,10,19,4,37,85,11,49,0,0
894,538,260,576,345,10,19,4,38,85,12,49,0,0
895,539,263,574,341,10,19,4,35,78,13,49,0,0
899,536,258,573,340,10,19,4,37,82,0,49,0,0
900,537,260,574,341,10,19,4,37,81,1,49,0,0
901,537,259,574,341,10,19,4,37,82,2,49,0,0
908,535,255,574,343,10,19,4,39,88,0,49,0,0
909,534,254,574,344,10,19,4,40,90,1,49,0,0
910,537,261,573,341,10,19,4,36,80,2,49,0,0
911,536,257,574,344,10,19,4,38,87,3,49,0,0
912,536,259,574,344,10,19,4,38,85,4,49,0,0
913,535,259,574,346,10,19,4,39,87,5,49,0,0
914,535,259,574,347,10,19,4,39,88,6,49,0,0
915,533,257,571,344,10,19,4,38,87,7,49,0,0
916,535,259,572,343,10,19,4,37,84,8,49,0,0
917,535,256,572,341,10,19,4,37,85,9,49,0,0
918,535,256,572,340,10,19,4,37,84,10,49,0,0
921,535,252,576,344,10,19,4,41,92,0,49,0,1
922,534,249,576,344,10,19,4,42,95,1,49,0,0
923,535,252,576,345,10,19,4,41,93,2,49,0,0
924,535,249,577,345,10,19,4,42,96,3,49,0,0
925,536,255,576,346,10,19,4,40,91,4,49,0,0
926,537,259,576,345,10,19,4,39,86,5,49,0,0
927,537,259,576,345,10,19,4,39,86,6,49,0,0
928,538,262,575,343,10,19,4,37,81,7,49,0,0
929,537,261,575,343,10,19,4,38,82,8,49,0,0
930,536,256,577,345,10,19,4,41,89,9,49,0,0
931,537,256,579,348,10,19,4,42,92,10,49,0,0
932,535,254,579,349,10,19,4,44,95,11,49,0,0
933,535,254,578,348,10,19,4,43,94,12,49,0,0
934,535,256,576,347,10,19,4,41,91,13,49,0,0
935,534,252,576,345,10,19,4,42,93,14,49,0,0
936,534,255,576,347,10,19,4,42,92,15,49,0,0
937,534,255,575,347,10,19,4,41,92,16,49,0,0
938,533,254,575,347,10,19,4,42,93,17,49,0,0
939,535,256,575,345,10,19,4,40,89,18,49,0,0
940,535,258,574,345,10,19,4,39,87,19,49,0,0
941,536,257,575,343,10,19,4,39,86,20,49,0,0
942,537,257,577,346,10,19,4,40,89,21,49,0,0
943,537,258,576,344,10,19,4,39,86,22,49,0,0
944,537,259,577,345,10,19,4,40,86,23,49,0,0
945,538,259,578,345,10,19,4,40,86,24,49,0,0
946,537,262,576,346,10,19,4,39,84,25,49,0,0
947,536,261,575,346,10,19,4,39,85,26,49,0,0
948,536,261,575,347,10,19,4,39,86,27,49,0,0
949,535,262,574,347,10,19,4,39,85,28,49,0,0
950,535,261,574,347,10,19,4,39,86,29,49,0,0
951,534,261,573,347,10,19,4,39,86,30,49,0,0
956,534,258,571,339,10,19,4,37,81,0,49,0,1
957,534,258,570,339,10,19,4,36,81,1,49,0,0
958,535,257,572,339,10,19,4,37,82,2,49,0,0
959,536,257,573,340,10,19,4,37,83,3,49,0,0
960,537,258,575,341,10,19,4,38,83,4,49,0,0
961,535,251,578,345,10,19,4,43,94,5,49,0,0
962,535,252,578,345,10,19,4,43,93,6,49,0,0
963,535,250,577,343,10,19,4,42,93,7,49,0,0
964,534,247,577,343,10,19,4,43,96,8,49,0,0
965,535,250,577,343,10,19,4,42,93,9,49,0,0
966,536,255,576,343,10,19,4,40,88,10,49,0,0
967,536,257,576,346,10,19,4,40,89,11,49,0,0
968,536,260,576,346,10,19,4,40,86,12,49,0,0
969,538,261,577,347,10,19,4,39,86,13,49,0,0
970,536,259,576,347,10,19,4,40,88,14,49,0,0
971,536,259,575,347,10,19,4,39,88,15,49,0,0
972,536,260,576,347,10,19,4,40,87,16,49,0,0
973,536,260,575,347,10,19,4,39,87,17,49,0,0
974,536,260,576,348,10,19,4,40,88,18,49,0,0
975,536,260,576,349,10,19,4,40,89,19,49,0,0
976,538,265,576,349,10,19,4,38,84,20,49,0,0
977,539,269,576,349,10,19,4,37,80,21,49,0,0
978,540,271,576,349,10,19,4,36,78,22,49,0,0
979,538,266,575,345,10,19,4,37,79,23,49,0,0
980,538,264,577,346,10,19,4,39,82,24,49,0,0
981,538,262,578,348,10,19,4,40,86,25,49,0,0
982,537,259,579,347,10,19,4,42,88,26,49,0,0
983,537,262,576,344,10,19,4,39,82,27,49,0,0
984,537,265,575,344,10,19,4,38,79,28,49,0,0
985,537,264,577,345,10,19,4,40,81,29,49,0,0
986,538,262,578,345,10,19,4,40,83,30,49,0,0
987,538,261,578,346,10,19,4,40,85,31,49,0,0
988,535,256,575,341,10,19,4,40,85,32,49,0,0
989,533,252,574,340,10,19,4,41,88,33,49,0,0
990,534,255,574,341,10,19,4,40,86,34,49,0,0
991,535,259,573,342,10,19,4,38,83,35,49,0,0
992,536,263,573,341,10,19,4,37,78,36,49,0,0
993,537,263,573,342,10,19,4,36,79,37,49,0,0
994,537,260,575,342,10,19,4,38,82,38,49,0,0
995,537,266,572,340,10,19,4,35,74,39,49,0,0
996,533,249,577,344,10,19,4,44,95,40,49,0,0
997,532,242,579,345,10,19,4,47,103,41,49,0,0
998,533,244,579,347,10,19,4,46,103,42,49,0,0
999,535,251,578,348,10,19,4,43,97,43,49,0,0
1000,535,250,579,348,10,19,4,44,98,44,49,0,0
1001,538,263,575,346,10,19,4,37,83,45,49,0,0
1002,538,265,574,346,10,19,4,36,81,46,49,0,0
1003,534,253,576,347,10,19,4,42,94,47,49,0,0
1004,535,255,576,347,10,19,4,41,92,48,49,0,0
1005,535,255,576,347,10,19,4,41,92,49,49,1,0
1008,534,250,574,342,10,19,4,40,92,0,49,0,1
1009,534,249,574,342,10,19,4,40,93,1,49,0,0
1010,532,234,576,337,10,19,4,44,103,2,49,0,0
1011,536,252,574,340,10,19,4,38,88,3,49,0,0
1012,535,246,576,342,10,19,4,41,96,4,49,0,0
1013,535,252,573,342,10,19,4,38,90,5,49,0,0
1014,535,250,575,344,10,19,4,40,94,6,49,0,0
1015,537,257,575,347,10,19,4,38,90,7,49,0,0
1016,534,248,576,347,10,19,4,42,99,8,49,0,0
1017,534,246,577,347,10,19,4,43,101,9,49,0,0
1018,534,247,577,348,10,19,4,43,101,10,49,0,0
1019,535,252,575,348,10,19,4,40,96,11,49,0,0
1020,536,252,576,346,10,19,4,40,94,12,49,0,0
1021,539,261,577,348,10,19,4,38,87,13,49,0,0
1022,539,264,577,350,10,19,4,38,86,14,49,0,0
1023,537,260,577,349,10,19,4,40,89,15,49,0,0
1024,536,258,576,348,10,19,4,40,90,16,49,0,0
1025,537,258,576,347,10,19,4,39,89,17,49,0,0
1026,537,260,576,346,10,19,4,39,86,18,49,0,0
1027,537,259,577,348,10,19,4,40,89,19,49,0,0
1028,536,257,577,347,10,19,4,41,90,20,49,0,0
1029,536,258,577,347,10,19,4,41,89,21,49,0,0
1030,535,257,577,347,10,19,4,42,90,22,49,0,0
1031,535,256,576,345,10,19,4,41,89,23,49,0,0
1032,535,256,575,343,10,19,4,40,87,24,49,0,0
1033,535,255,575,343,10,19,4,40,88,25,49,0,0
1034,534,253,574,342,10,19,4,40,89,26,49,0,0
1035,536,258,574,342,10,19,4,38,84,27,49,0,0
1036,536,262,573,343,10,19,4,37,81,28,49,0,0
1037,536,260,573,344,10,19,4,37,84,29,49,0,0
1038,538,263,575,346,10,19,4,37,83,30,49,0,0
1039,537,263,575,346,10,19,4,38,83,31,49,0,0
1040,536,261,574,345,10,19,4,38,84,32,49,0,0
1041,536,259,575,347,10,19,4,39,88,33,49,0,0
1042,535,256,576,347,10,19,4,41,91,34,49,0,0
1043,536,261,575,346,10,19,4,39,85,35,49,0,0
1044,536,262,575,346,10,19,4,39,84,36,49,0,0
1045,538,262,576,346,10,19,4,38,84,37,49,0,0
1046,536,258,578,348,10,19,4,42,90,38,49,0,0
1047,534,251,579,349,10,19,4,45,98,39,49,0,0
1048,533,239,582,348,10,19,4,49,109,40,49,0,0
1049,533,243,580,346,10,19,4,47,103,41,49,0,0
1050,534,245,580,347,10,19,4,46,102,42,49,0,0
1051,533,244,580,347,10,19,4,47,103,43,49,0,0
1056,537,256,578,348,10,19,4,41,92,0,49,0,0
1057,536,259,575,345,10,19,4,39,86,1,49,0,0
1058,536,259,575,346,10,19,4,39,87,2,49,0,0
1059,537,258,576,346,10,19,4,39,88,3,49,0,0
1060,536,256,576,346,10,19,4,40,90,4,49,0,0
1061,536,256,574,341,10,19,4,38,85,5,49,0,0
1062,536,258,573,340,10,19,4,37,82,6,49,0,0
1063,536,258,572,339,10,19,4,36,81,7,49,0,0
1064,537,259,574,341,10,19,4,37,82,8,49,0,0
1065,538,257,577,344,10,19,4,39,87,9,49,0,0
1066,538,257,577,344,10,19,4,39,87,10,49,0,0
1069,538,261,575,342,10,19,4,37,81,0,49,0,0
1070,538,261,575,342,10,19,4,37,81,1,49,0,0
1071,535,253,576,343,10,19,4,41,90,2,49,0,0
1072,534,250,577,345,10,19,4,43,95,3,49,0,0
1073,533,249,576,344,10,19,4,43,95,4,49,0,0
1074,533,249,577,344,10,19,4,44,95,5,49,0,0
1075,535,253,577,346,10,19,4,42,93,6,49,0,0
1076,535,256,575,344,10,19,4,40,88,7,49,0,0
1077,535,257,575,344,10,19,4,40,87,8,49,0,0
1080,534,254,573,341,10,19,4,39,87,0,49,0,1
1081,536,260,573,341,10,19,4,37,81,1,49,0,0
1082,536,260,572,340,10,19,4,36,80,2,49,0,0
1083,537,261,572,339,10,19,4,35,78,3,49,0,0
1084,539,264,575,341,10,19,4,36,77,4,49,0,0
1085,539,263,576,342,10,19,4,37,79,5,49,0,0
1086,536,256,577,343,10,19,4,41,87,6,49,0,0
1087,537,258,577,344,10,19,4,40,86,7,49,0,0
1088,537,258,578,347,10,19,4,41,89,8,49,0,0
1089,538,263,577,347,10,19,4,39,84,9,49,0,0
1090,538,262,576,344,10,19,4,38,82,10,49,0,0
1091,537,261,577,346,10,19,4,40,85,11,49,0,0
1092,537,261,576,346,10,19,4,39,85,12,49,0,0
1093,536,260,575,343,10,19,4,39,83,13,49,0,0
1094,537,261,575,343,10,19,4,38,82,14,49,0,0
1095,536,259,577,346,10,19,4,41,87,15,49,0,0
1096,536,257,578,347,10,19,4,42,90,16,49,0,0
1097,536,257,578,347,10,19,4,42,90,17,49,0,0
1098,536,256,578,348,10,19,4,42,92,18,49,0,0
1099,536,259,577,346,10,19,4,41,87,19,49,0,0
1100,536,260,577,346,10,19,4,41,86,20,49,0,0
1101,538,267,574,344,10,19,4,36,77,21,49,0,0
1104,538,269,573,343,10,19,4,35,74,0,49,0,0
1105,538,269,573,342,10,19,4,35,73,1,49,0,0
1106,537,263,574,342,10,19,4,37,79,2,49,0,0
1107,536,261,575,341,10,19,4,39,80,3,49,0,0
1108,537,263,576,341,10,19,4,39,78,4,49,0,0
1109,537,260,577,343,10,19,4,40,83,5,49,0,0
1110,537,259,576,341,10,19,4,39,82,6,49,0,0
1111,537,259,578,344,10,19,4,41,85,7,49,0,0
1112,537,258,580,346,10,19,4,43,88,8,49,0,0
1113,535,258,576,342,10,19,4,41,84,9,49,0,0
1114,533,258,573,340,10,19,4,40,82,10,49,0,0
1115,532,257,572,339,10,19,4,40,82,11,49,0,0
1116,534,258,573,340,10,19,4,39,82,12,49,0,0
1117,535,261,573,342,10,19,4,38,81,13,49,0,0
1118,536,262,574,342,10,19,4,38,80,14,49,0,0
1119,538,265,574,341,10,19,4,36,76,15,49,0,0
1120,538,266,574,341,10,19,4,36,75,16,49,0,0
1126,539,264,579,348,10,19,4,40,84,0,49,0,0
1127,539,264,580,349,10,19,4,41,85,1,49,0,0
1128,539,268,578,348,10,19,4,39,80,2,49,0,0
1129,539,269,578,348,10,19,4,39,79,3,49,0,0
1130,539,270,578,349,10,19,4,39,79,4,49,0,0
1131,537,263,577,345,10,19,4,40,82,5,49,0,0
1132,536,260,577,345,10,19,4,41,85,6,49,0,0
1133,533,254,576,342,10,19,4,43,88,7,49,0,0
1134,533,254,574,342,10,19,4,41,88,8,49,0,0
1135,535,257,575,341,10,19,4,40,84,9,49,0,0
1136,535,256,575,341,10,19,4,40,85,10,49,0,0
1138,538,262,575,340,10,19,4,37,78,0,49,0,0
1139,538,262,574,339,10,19,4,36,77,1,49,0,0
1141,535,253,579,346,10,19,4,44,93,0,49,0,0
1142,534,253,578,346,10,19,4,44,93,1,49,0,0
1143,534,252,579,346,10,19,4,45,94,2,49,0,0
1144,538,264,578,348,10,19,4,40,84,3,49,0,0
1145,536,262,576,346,10,19,4,40,84,4,49,0,0
1146,535,259,577,348,10,19,4,42,89,5,49,0,0
1147,536,259,573,338,10,19,4,37,79,6,49,0,0
1148,534,257,575,344,10,19,4,41,87,7,49,0,0
1149,534,256,576,345,10,19,4,42,89,8,49,0,0
1150,534,255,576,346,10,19,4,42,91,9,49,0,0
1157,531,247,573,339,10,19,4,42,92,0,49,0,0
1158,531,246,573,339,10,19,4,42,93,1,49,0,0
1161,535,257,574,342,10,19,4,39,85,0,49,0,0
1162,535,258,575,344,10,19,4,40,86,1,49,0,0
1163,537,261,576,345,10,19,4,39,84,2,49,0,0
1164,537,260,576,345,10,19,4,39,85,3,49,0,0
1165,536,259,576,345,10,19,4,40,86,4,49,0,0
1166,536,256,578,349,10,19,4,42,93,5,49,0,0
1167,536,256,579,350,10,19,4,43,94,6,49,0,0
1168,536,257,579,349,10,19,4,43,92,7,49,0,0
1169,536,256,577,346,10,19,4,41,90,8,49,0,0
1170,536,256,578,347,10,19,4,42,91,9,49,0,0
1171,536,258,574,342,10,19,4,38,84,10,49,0,0
1172,536,258,574,342,10,19,4,38,84,11,49,0,0
1174,535,249,578,343,10,19,4,43,94,0,49,0,0
1175,534,250,574,340,10,19,4,40,90,1,49,0,0
1176,534,253,573,341,10,19,4,39,88,2,49,0,0
1177,534,255,572,342,10,19,4,38,87,3,49,0,0
1178,536,259,573,344,10,19,4,37,85,4,49,0,0
1179,538,262,574,345,10,19,4,36,83,5,49,0,0
1180,538,261,576,347,10,19,4,38,86,6,49,0,0
1181,538,261,576,348,10,19,4,38,87,7,49,0,0
1182,537,260,574,343,10,19,4,37,83,8,49,0,0
1186,535,255,576,348,10,19,4,41,93,0,49,0,0
1187,534,250,577,346,10,19,4,43,96,1,49,0,0
1188,535,251,575,342,10,19,4,40,91,2,49,0,0
1189,533,237,580,343,10,19,4,47,106,3,49,0,0
1190,536,250,577,343,10,19,4,41,93,4,49,0,0
1192,540,263,575,342,10,19,4,35,79,0,49,0,0
1194,537,256,574,342,10,19,4,37,86,0,49,0,0
1195,537,258,573,339,10,19,4,36,81,1,49,0,0
1196,535,255,572,339,10,19,4,37,84,2,49,0,0
1197,534,256,571,340,10,19,4,37,84,3,49,0,0
1199,534,257,569,337,10,19,4,35,80,0,49,0,0
1200,534,255,569,337,10,19,4,35,82,1,49,0,0
1202,537,254,575,341,10,19,4,38,87,0,49,0,1
1203,538,256,577,344,10,19,4,39,88,1,49,0,0
1204,539,256,577,344,10,19,4,38,88,2,49,0,0
1205,538,257,578,349,10,19,4,40,92,3,49,0,0
1206,537,260,573,342,10,19,4,36,82,4,49,0,0
1207,537,260,574,343,10,19,4,37,83,5,49,0,0
1208,537,260,573,339,10,19,4,36,79,6,49,0,0
1209,537,260,573,339,10,19,4,36,79,7,49,0,0
1210,537,260,572,337,10,19,4,35,77,8,49,0,0
1211,537,262,573,339,10,19,4,36,77,9,49,0,0
1212,538,264,576,346,10,19,4,38,82,10,49,0,0
1213,539,268,575,346,10,19,4,36,78,11,49,0,0
1214,538,268,575,347,10,19,4,37,79,12,49,0,0
1215,538,262,576,346,10,19,4,38,84,13,49,0,0
1216,532,248,574,341,10,19,4,42,93,14,49,0,0
1217,530,227,581,342,10,19,4,51,115,15,49,0,0
1218,529,221,582,342,10,19,4,53,121,16,49,0,0
1219,532,240,576,340,10,19,4,44,100,17,49,0,0
1220,532,242,576,343,10,19,4,44,101,18,49,0,0
1221,534,243,577,343,10,19,4,43,100,19,49,0,0
1222,534,242,577,343,10,19,4,43,101,20,49,0,0
1223,532,245,573,340,10,19,4,41,95,21,49,0,0
1224,532,243,574,342,10,19,4,42,99,22,49,0,0
1225,533,244,574,342,10,19,4,41,98,23,49,0,0
1226,536,251,576,345,10,19,4,40,94,24,49,0,0
1227,537,260,573,341,10,19,4,36,81,25,49,0,0
1231,541,273,576,349,10,19,4,35,76,0,49,0,0
1232,540,269,578,350,10,19,4,38,81,1,49,0,0
1233,539,266,579,351,10,19,4,40,85,2,49,0,0
1234,537,259,580,351,10,19,4,43,92,3,49,0,0
1235,536,259,579,351,10,19,4,43,92,4,49,0,0
1236,533,247,578,346,10,19,4,45,99,5,49,0,0
1237,531,239,578,343,10,19,4,47,104,6,49,0,0
1238,531,237,579,343,10,19,4,48,106,7,49,0,0
1241,534,244,580,345,10,19,4,46,101,0,49,0,0
1242,536,251,578,345,10,19,4,42,94,1,49,0,0
1243,534,245,579,346,10,19,4,45,101,2,49,0,0
1244,534,249,577,344,10,19,4,43,95,3,49,0,0
1245,532,238,580,347,10,19,4,48,109,4,49,0,0
1246,534,248,576,345,10,19,4,42,97,5,49,0,0
1247,536,255,575,345,10,19,4,39,90,6,49,0,0
1248,536,255,575,345,10,19,4,39,90,7,49,0,0
1250,538,263,574,344,10,19,4,36,81,0,49,0,0
1251,539,262,574,341,10,19,4,35,79,1,49,0,0
1252,538,261,573,341,10,19,4,35,80,2,49,0,0
1253,537,260,572,340,10,19,4,35,80,3,49,0,0
1254,538,261,575,344,10,19,4,37,83,4,49,0,0
1255,537,259,576,348,10,19,4,39,89,5,49,0,0
1256,537,260,574,345,10,19,4,37,85,6,49,0,0
1257,536,258,575,347,10,19,4,39,89,7,49,0,0
1258,536,259,575,347,10,19,4,39,88,8,49,0,0
1259,536,259,575,345,10,19,4,39,86,9,49,0,0
1260,534,257,571,340,10,19,4,37,83,10,49,0,0
1261,534,252,571,337,10,19,4,37,85,11,49,0,0
1262,533,249,571,335,10,19,4,38,86,12,49,0,0
1263,533,248,570,334,10,19,4,37,86,13,49,0,0
1265,534,248,572,336,10,19,4,38,88,0,49,0,0
1266,538,261,573,342,10,19,4,35,81,1,49,0,0
1269,536,262,574,347,10,19,4,38,85,0,49,0,0
1270,537,263,574,344,10,19,4,37,81,1,49,0,0
1271,538,263,575,345,10,19,4,37,82,2,49,0,0
1278,538,262,574,345,10,19,4,36,83,0,49,0,0
1279,536,258,574,343,10,19,4,38,85,1,49,0,0
1280,537,260,573,342,10,19,4,36,82,2,49,0,0
1281,536,256,575,343,10,19,4,39,87,3,49,0,0
1282,535,255,574,343,10,19,4,39,88,4,49,0,0
1283,535,254,573,340,10,19,4,38,86,5,49,0,0
1284,536,260,571,339,10,19,4,35,79,6,49,0,0
1286,539,263,575,344,10,19,4,36,81,0,49,0,0
1287,536,258,575,343,10,19,4,39,85,1,49,0,0
1288,537,260,577,347,10,19,4,40,87,2,49,0,0
1289,536,260,572,342,10,19,4,36,82,3,49,0,0
1290,535,260,574,346,10,19,4,39,86,4,49,0,0
1291,534,244,579,346,10,19,4,45,102,5,49,0,0
1292,534,244,577,341,10,19,4,43,97,6,49,0,0
1293,534,246,577,341,10,19,4,43,95,7,49,0,0
1294,538,258,576,341,10,19,4,38,83,8,49,0,0
1298,537,265,573,344,10,19,4,36,79,0,49,0,0
1299,536,262,574,344,10,19,4,38,82,1,49,0,0
1300,537,265,574,345,10,19,4,37,80,2,49,0,0
1301,534,255,574,342,10,19,4,40,87,3,49,0,0
1302,533,250,574,341,10,19,4,41,91,4,49,0,0
1303,533,249,574,341,10,19,4,41,92,5,49,0,0
1304,536,261,573,344,10,19,4,37,83,6,49,0,0
1305,536,260,573,342,10,19,4,37,82,7,49,0,0
1306,534,253,574,344,10,19,4,40,91,8,49,0,0
1307,534,252,573,341,10,19,4,39,89,9,49,0,0
1308,533,247,575,344,10,19,4,42,97,10,49,0,0
1309,538,265,573,342,10,19,4,35,77,11,49,0,0
1311,532,232,579,340,10,19,4,47,108,0,49,0,0
1312,534,242,579,344,10,19,4,45,102,1,49,0,0
1313,532,239,578,343,10,19,4,46,104,2,49,0,0
1314,531,228,581,343,10,19,4,50,115,3,49,0,0
1315,535,244,577,341,10,19,4,42,97,4,49,0,0
1316,536,248,578,343,10,19,4,42,95,5,49,0,0
1317,536,250,578,345,10,19,4,42,95,6,49,0,0
1318,537,255,578,348,10,19,4,41,93,7,49,0,0
1319,536,253,578,349,10,19,4,42,96,8,49,0,0
1320,537,260,576,348,10,19,4,39,88,9,49,0,0
1321,537,258,576,346,10,19,4,39,88,10,49,0,0
1322,536,244,580,344,10,19,4,44,100,11,49,0,0
1323,538,256,577,344,10,19,4,39,88,12,49,0,0
1324,538,256,577,344,10,19,4,39,88,13,49,0,0
1326,533,250,573,340,10,19,4,40,90,0,49,0,0
1327,534,255,573,342,10,19,4,39,87,1,49,0,0
1328,536,256,574,343,10,19,4,38,87,2,49,0,0
1329,536,256,574,343,10,19,4,38,87,3,49,0,0
1332,540,263,575,342,10,19,4,35,79,0,49,0,0
1333,539,260,574,341,10,19,4,35,81,1,49,0,0
1336,537,255,574,339,10,19,4,37,84,0,49,0,0
1337,537,257,572,338,10,19,4,35,81,1,49,0,0
1338,538,261,573,339,10,19,4,35,78,2,49,0,0
1339,538,257,575,340,10,19,4,37,83,3,49,0,0
1340,537,254,575,339,10,19,4,38,85,4,49,0,0
1341,535,252,574,339,10,19,4,39,87,5,49,0,0
1342,534,249,575,341,10,19,4,41,92,6,49,0,0
1343,534,248,575,341,10,19,4,41,93,7,49,0,0
1344,534,257,571,340,10,19,4,37,83,8,49,0,0
1345,534,257,571,340,10,19,4,37,83,9,49,0,0
1346,536,258,576,347,10,19,4,40,89,10,49,0,0
1347,537,258,577,348,10,19,4,40,90,11,49,0,0
1348,537,260,575,345,10,19,4,38,85,12,49,0,0
1349,536,261,574,345,10,19,4,38,84,13,49,0,0
1350,538,263,574,343,10,19,4,36,80,14,49,0,0
1351,537,257,574,339,10,19,4,37,82,15,49,0,0
1352,535,255,574,340,10,19,4,39,85,16,49,0,0
1353,536,256,574,340,10,19,4,38,84,17,49,0,0
1355,539,264,576,345,10,19,4,37,81,0,49,0,0
1356,538,261,575,344,10,19,4,37,83,1,49,0,0
1357,537,258,577,346,10,19,4,40,88,2,49,0,0
1358,538,261,576,345,10,19,4,38,84,3,49,0,0
1359,536,257,577,346,10,19,4,41,89,4,49,0,0
1360,536,258,576,345,10,19,4,40,87,5,49,0,0
1361,537,262,573,340,10,19,4,36,78,6,49,0,0
1364,536,259,573,339,10,19,4,37,80,0,49,0,0
1365,537,262,573,340,10,19,4,36,78,1,49,0,0
1366,536,253,577,343,10,19,4,41,90,2,49,0,0
1367,535,248,578,343,10,19,4,43,95,3,49,0,0
1368,535,247,578,343,10,19,4,43,96,4,49,0,0
1369,535,247,577,340,10,19,4,42,93,5,49,0,0
1370,535,246,577,340,10,19,4,42,94,6,49,0,0
1372,533,246,576,343,10,19,4,43,97,0,49,0,0
1373,535,253,575,344,10,19,4,40,91,1,49,0,0
1374,534,254,574,344,10,19,4,40,90,2,49,0,0
1375,532,242,576,341,10,19,4,44,99,3,49,0,0
1376,534,248,575,341,10,19,4,41,93,4,49,0,0
1377,536,255,574,342,10,19,4,38,87,5,49,0,0
1378,535,250,575,342,10,19,4,40,92,6,49,0,0
1379,535,250,575,342,10,19,4,40,92,7,49,0,0
1381,534,245,577,345,10,19,4,43,100,0,49,0,0
1382,533,244,577,345,10,19,4,44,101,1,49,0,0
1383,533,244,577,346,10,19,4,44,102,2,49,0,0
1386,537,257,575,346,10,19,4,38,89,0,49,0,0
1387,537,258,575,346,10,19,4,38,88,1,49,0,0
1388,537,259,575,346,10,19,4,38,87,2,49,0,0
1389,536,259,576,347,10,19,4,40,88,3,49,0,0
1390,536,259,576,347,10,19,4,40,88,4,49,0,0
1400,537,265,573,345,10,19,4,36,80,0,49,0,1
1401,536,261,574,344,10,19,4,38,83,1,49,0,0
1402,536,258,575,343,10,19,4,39,85,2,49,0,0
1403,536,259,575,343,10,19,4,39,84,3,49,0,0
1404,537,263,576,346,10,19,4,39,83,4,49,0,0
1405,538,264,576,346,10,19,4,38,82,5,49,0,0
1406,538,257,579,346,10,19,4,41,89,6,49,0,0
1407,539,259,579,347,10,19,4,40,88,7,49,0,0
1408,538,259,579,345,10,19,4,41,86,8,49,0,0
1409,538,257,580,346,10,19,4,42,89,9,49,0,0
1410,537,257,579,346,10,19,4,42,89,10,49,0,0
1411,536,259,578,346,10,19,4,42,87,11,49,0,0
1412,534,251,580,347,10,19,4,46,96,12,49,0,0
1413,538,260,580,347,10,19,4,42,87,13,49,0,0
1414,538,260,580,348,10,19,4,42,88,14,49,0,0
1415,538,263,579,348,10,19,4,41,85,15,49,0,0
1416,538,261,579,348,10,19,4,41,87,16,49,0,0
1417,538,262,580,348,10,19,4,42,86,17,49,0,0
1418,537,260,579,349,10,19,4,42,89,18,49,0,0
1419,538,264,578,348,10,19,4,40,84,19,49,0,0
1420,541,272,577,348,10,19,4,36,76,20,49,0,0
1421,538,261,579,348,10,19,4,41,87,21,49,0,0
1422,536,259,576,344,10,19,4,40,85,22,49,0,0
1423,536,259,576,343,10,19,4,40,84,23,49,0,0
1425,534,261,569,337,10,19,4,35,76,0,49,0,1
1426,535,258,573,340,10,19,4,38,82,1,49,0,0
1427,536,256,575,340,10,19,4,39,84,2,49,0,0
1428,536,257,576,342,10,19,4,40,85,3,49,0,0
1429,536,257,576,341,10,19,4,40,84,4,49,0,0
1430,536,256,577,342,10,19,4,41,86,5,49,0,0
1431,536,255,577,342,10,19,4,41,87,6,49,0,0
1432,536,255,580,346,10,19,4,44,91,7,49,0,0
1433,537,256,579,346,10,19,4,42,90,8,49,0,0
1434,536,258,577,345,10,19,4,41,87,9,49,0,0
1435,536,258,577,346,10,19,4,41,88,10,49,0,0
1436,535,253,577,344,10,19,4,42,91,11,49,0,0
1437,538,263,576,343,10,19,4,38,80,12,49,0,0
1438,539,263,576,343,10,19,4,37,80,13,49,0,0
1439,539,266,577,345,10,19,4,38,79,14,49,0,0
1440,539,265,576,343,10,19,4,37,78,15,49,0,0
1441,533,248,579,345,10,19,4,46,97,16,49,0,0
1442,531,245,579,347,10,19,4,48,102,17,49,0,0
1443,531,243,579,348,10,19,4,48,105,18,49,0,0
1444,531,241,579,349,10,19,4,48,108,19,49,0,0
1445,533,250,577,347,10,19,4,44,97,20,49,0,0
1446,535,255,576,346,10,19,4,41,91,21,49,0,0
1447,535,257,576,346,10,19,4,41,89,22,49,0,0
1448,535,257,576,346,10,19,4,41,89,23,49,0,0
1450,535,260,572,341,10,19,4,37,81,0,49,0,1
1451,536,262,573,343,10,19,4,37,81,1,49,0,0
1452,537,264,573,341,10,19,4,36,77,2,49,0,0
1453,537,264,574,343,10,19,4,37,79,3,49,0,0
1454,538,267,574,344,10,19,4,36,77,4,49,0,0
1455,532,247,577,342,10,19,4,45,95,5,49,0,0
1456,536,253,578,344,10,19,4,42,91,6,49,0,0
1457,538,257,578,345,10,19,4,40,88,7,49,0,0
1458,539,259,578,346,10,19,4,39,87,8,49,0,0
1459,537,256,577,345,10,19,4,40,89,9,49,0,0
1460,538,261,576,345,10,19,4,38,84,10,49,0,0
1461,535,253,578,347,10,19,4,43,94,11,49,0,0
1462,535,251,579,348,10,19,4,44,97,12,49,0,0
1463,534,249,579,348,10,19,4,45,99,13,49,0,0
1464,533,245,579,347,10,19,4,46,102,14,49,0,0
1465,532,242,579,347,10,19,4,47,105,15,49,0,0
1466,535,255,575,345,10,19,4,40,90,16,49,0,0
1467,535,260,573,344,10,19,4,38,84,17,49,0,0
1468,536,263,572,344,10,19,4,36,81,18,49,0,0
1469,537,266,572,343,10,19,4,35,77,19,49,0,0
1470,536,262,572,343,10,19,4,36,81,20,49,0,0
1471,536,258,575,344,10,19,4,39,86,21,49,0,0
1472,537,256,578,345,10,19,4,41,89,22,49,0,0
1473,537,256,577,345,10,19,4,40,89,23,49,0,0
1474,536,251,580,345,10,19,4,44,94,24,49,0,0
1475,536,249,581,346,10,19,4,45,97,25,49,0,0
1476,538,260,579,346,10,19,4,41,86,26,49,0,0
1477,538,261,578,347,10,19,4,40,86,27,49,0,0
1478,537,261,577,346,10,19,4,40,85,28,49,0,0
1479,538,266,576,346,10,19,4,38,80,29,49,0,0
1480,536,263,575,345,10,19,4,39,82,30,49,0,0
1481,536,262,575,344,10,19,4,39,82,31,49,0,0
1482,535,262,574,343,10,19,4,39,81,32,49,0,0
1483,535,261,574,343,10,19,4,39,82,33,49,0,0
1484,533,253,576,343,10,19,4,43,90,34,49,0,0
1485,533,256,573,340,10,19,4,40,84,35,49,0,0
1486,531,239,578,341,10,19,4,47,102,36,49,0,0
1487,530,234,579,341,10,19,4,49,107,37,49,0,0
1488,532,248,576,343,10,19,4,44,95,38,49,0,0
1489,532,247,576,343,10,19,4,44,96,39,49,0,0
1490,532,245,576,343,10,19,4,44,98,40,49,0,0
1491,531,226,584,345,10,19,4,53,119,41,49,0,0
1492,533,234,583,346,10,19,4,50,112,42,49,0,0
1493,533,232,584,346,10,19,4,51,114,43,49,0,0
1496,540,262,578,346,10,19,4,38,84,0,49,0,0
1497,540,267,575,344,10,19,4,35,77,1,49,0,0
1499,540,266,576,345,10,19,4,36,79,0,49,0,0
1500,540,265,576,343,10,19,4,36,78,1,49,0,0
1501,534,248,578,344,10,19,4,44,96,2,49,0,0
1502,532,239,580,345,10,19,4,48,106,3,49,0,0
1503,531,237,580,346,10,19,4,49,109,4,49,0,0
1504,533,247,577,346,10,19,4,44,99,5,49,0,0
1505,531,245,576,346,10,19,4,45,101,6,49,0,0
1506,534,249,575,344,10,19,4,41,95,7,49,0,0
1507,535,250,576,343,10,19,4,41,93,8,49,0,0
1508,535,251,575,341,10,19,4,40,90,9,49,0,0
1509,534,252,572,339,10,19,4,38,87,10,49,0,0
1510,536,253,576,345,10,19,4,40,92,11,49,0,0
1511,539,262,575,346,10,19,4,36,84,12,49,0,0
1512,541,267,576,345,10,19,4,35,78,13,49,0,0
1515,539,261,577,346,10,19,4,38,85,0,49,0,0
1516,539,260,578,347,10,19,4,39,87,1,49,0,0
1517,538,260,576,344,10,19,4,38,84,2,49,0,0
1518,537,257,575,342,10,19,4,38,85,3,49,0,0
1519,537,258,577,346,10,19,4,40,88,4,49,0,0
1520,538,261,575,342,10,19,4,37,81,5,49,0,0
1521,534,248,576,341,10,19,4,42,93,6,49,0,0
1522,536,257,574,341,10,19,4,38,84,7,49,0,0
1523,535,253,575,342,10,19,4,40,89,8,49,0,0
1524,534,253,574,342,10,19,4,40,89,9,49,0,0
1525,535,256,573,340,10,19,4,38,84,10,49,0,0
1526,535,256,573,340,10,19,4,38,84,11,49,0,0
1527,534,253,572,340,10,19,4,38,87,12,49,0,0
1528,534,253,572,339,10,19,4,38,86,13,49,0,0
1529,534,254,572,339,10,19,4,38,85,14,49,0,0
1530,533,248,576,342,10,19,4,43,94,15,49,0,0
1531,534,254,572,339,10,19,4,38,85,16,49,0,0
1532,534,254,571,338,10,19,4,37,84,17,49,0,0
1537,536,252,577,344,10,19,4,41,92,0,49,0,0
1538,537,254,578,345,10,19,4,41,91,1,49,0,0
1539,535,249,578,346,10,19,4,43,97,2,49,0,0
1540,535,248,579,345,10,19,4,44,97,3,49,0,0
1546,536,259,575,344,10,19,4,39,85,0,49,0,1
1547,532,252,573,342,10,19,4,41,90,1,49,0,0
1548,531,249,572,340,10,19,4,41,91,2,49,0,0
1549,530,247,572,340,10,19,4,42,93,3,49,0,0
1550,535,256,573,340,10,19,4,38,84,4,49,0,0
1551,535,249,578,344,10,19,4,43,95,5,49,0,0
1552,535,242,580,343,10,19,4,45,101,6,49,0,0
1553,536,250,577,340,10,19,4,41,90,7,49,0,0
1554,537,254,577,340,10,19,4,40,86,8,49,0,0
1555,537,256,577,341,10,19,4,40,85,9,49,0,0
1556,536,247,581,346,10,19,4,45,99,10,49,0,0
1557,535,244,582,347,10,19,4,47,103,11,49,0,0
1558,536,252,580,348,10,19,4,44,96,12,49,0,0
1559,536,248,581,347,10,19,4,45,99,13,49,0,0
1560,535,245,581,346,10,19,4,46,101,14,49,0,0
1561,535,252,578,347,10,19,4,43,95,15,49,0,0
1562,536,255,577,346,10,19,4,41,91,16,49,0,0
1563,535,254,577,346,10,19,4,42,92,17,49,0,0
1564,536,256,576,344,10,19,4,40,88,18,49,0,0
1565,535,256,575,344,10,19,4,40,88,19,49,0,0
1566,534,251,575,344,10,19,4,41,93,20,49,0,0
1567,532,246,576,345,10,19,4,44,99,21,49,0,0
1568,531,243,575,343,10,19,4,44,100,22,49,0,0
1569,531,244,575,345,10,19,4,44,101,23,49,0,0
1570,533,247,575,344,10,19,4,42,97,24,49,0,0
1571,535,252,574,342,10,19,4,39,90,25,49,0,0
1572,536,250,577,345,10,19,4,41,95,26,49,0,0
1573,537,257,574,343,10,19,4,37,86,27,49,0,0
1575,538,262,573,343,10,19,4,35,81,0,49,0,1
1576,538,257,577,345,10,19,4,39,88,1,49,0,0
1577,537,255,577,345,10,19,4,40,90,2,49,0,0
1578,538,257,577,343,10,19,4,39,86,3,49,0,0
1579,537,256,577,343,10,19,4,40,87,4,49,0,0
1580,537,257,577,343,10,19,4,40,86,5,49,0,0
1581,533,244,579,343,10,19,4,46,99,6,49,0,0
1582,534,250,577,343,10,19,4,43,93,7,49,0,0
1583,533,248,577,343,10,19,4,44,95,8,49,0,0
1584,533,256,571,339,10,19,4,38,83,9,49,0,0
1585,536,260,573,341,10,19,4,37,81,10,49,0,0
1586,538,264,573,341,10,19,4,35,77,11,49,0,0
1587,538,264,574,341,10,19,4,36,77,12,49,0,0
1588,538,267,574,343,10,19,4,36,76,13,49,0,0
1589,537,264,575,343,10,19,4,38,79,14,49,0,0
1590,533,247,578,343,10,19,4,45,96,15,49,0,0
1591,537,261,576,344,10,19,4,39,83,16,49,0,0
1592,537,263,575,344,10,19,4,38,81,17,49,0,0
1593,538,266,574,343,10,19,4,36,77,18,49,0,0
1594,537,265,574,344,10,19,4,37,79,19,49,0,0
1595,537,264,574,344,10,19,4,37,80,20,49,0,0
1596,536,262,573,343,10,19,4,37,81,21,49,0,0
1597,534,257,572,342,10,19,4,38,85,22,49,0,0
1598,534,253,574,343,10,19,4,40,90,23,49,0,0
1599,535,254,574,342,10,19,4,39,88,24,49,0,0
1600,535,253,574,341,10,19,4,39,88,25,49,0,0
1601,536,258,574,345,10,19,4,38,87,26,49,0,0
1602,534,257,571,342,10,19,4,37,85,27,49,0,0
1603,532,254,570,342,10,19,4,38,88,28,49,0,0
1604,532,253,570,344,10,19,4,38,91,29,49,0,0
1605,532,251,571,345,10,19,4,39,94,30,49,0,0
1606,531,251,571,345,10,19,4,40,94,31,49,0,0
1607,536,254,574,346,10,19,4,38,92,32,49,0,0
1608,537,260,573,346,10,19,4,36,86,33,49,0,0
1611,535,252,575,345,10,19,4,40,93,0,49,0,0
1612,535,249,574,342,10,19,4,39,93,1,49,0,0
1613,535,248,575,342,10,19,4,40,94,2,49,0,0
1615,532,235,578,345,10,19,4,46,110,0,49,0,1
1616,538,257,576,345,10,19,4,38,88,1,49,0,0
1617,538,261,573,342,10,19,4,35,81,2,49,0,0
1618,535,252,574,343,10,19,4,39,91,3,49,0,0
1619,533,244,576,341,10,19,4,43,97,4,49,0,0
1620,533,244,575,341,10,19,4,42,97,5,49,0,0
1621,532,240,577,345,10,19,4,45,105,6,49,0,0
1622,531,233,578,343,10,19,4,47,110,7,49,0,0
1623,533,241,577,345,10,19,4,44,104,8,49,0,0
1624,534,244,576,343,10,19,4,42,99,9,49,0,0
1625,530,229,579,346,10,19,4,49,117,10,49,0,0
1626,533,242,576,343,10,19,4,43,101,11,49,0,0
1627,534,246,575,342,10,19,4,41,96,12,49,0,0
1628,535,250,574,341,10,19,4,39,91,13,49,0,0
1629,536,254,573,341,10,19,4,37,87,14,49,0,0
1630,533,237,578,342,10,19,4,45,105,15,49,0,0
1631,535,247,577,345,10,19,4,42,98,16,49,0,0
1632,536,253,577,346,10,19,4,41,93,17,49,0,0
1633,535,253,574,342,10,19,4,39,89,18,49,0,0
1634,535,254,575,346,10,19,4,40,92,19,49,0,0
1635,536,256,573,342,10,19,4,37,86,20,49,0,0
1636,536,257,573,342,10,19,4,37,85,21,49,0,0
1638,537,256,577,346,10,19,4,40,90,0,49,0,0
1639,538,256,577,346,10,19,4,39,90,1,49,0,0
1642,532,231,579,339,10,19,4,47,108,0,49,0,0
1643,532,229,579,339,10,19,4,47,110,1,49,0,0
1645,532,225,581,343,10,19,4,49,118,0,49,0,0
1646,533,237,579,344,10,19,4,46,107,1,49,0,0
1647,531,231,577,341,10,19,4,46,110,2,49,0,0
1648,531,229,577,341,10,19,4,46,112,3,49,0,0
1649,535,247,575,341,10,19,4,40,94,4,49,0,0
1650,534,235,576,340,10,19,4,42,105,5,49,0,0
1651,536,251,574,342,10,19,4,38,91,6,49,0,0
1652,538,254,573,339,10,19,4,35,85,7,49,0,0
1654,539,254,576,342,10,19,4,37,88,0,49,0,0
1655,540,255,576,342,10,19,4,36,87,1,49,0,0
1656,536,239,581,347,10,19,4,45,108,2,49,0,0
1657,537,247,579,348,10,19,4,42,101,3,49,0,0
1658,537,252,577,348,10,19,4,40,96,4,49,0,0
1659,537,252,577,348,10,19,4,40,96,5,49,0,0
1660,535,241,579,348,10,19,4,44,107,6,49,0,0
1661,535,233,583,349,10,19,4,48,116,7,49,0,0
1662,531,214,585,347,10,19,4,54,133,8,49,0,0
1663,539,251,579,348,10,19,4,40,97,9,49,0,0
1664,539,251,579,348,10,19,4,40,97,10,49,0,0
1666,537,258,573,346,10,19,4,36,88,0,49,0,0
1667,536,260,572,346,10,19,4,36,86,1,49,0,0
1668,537,260,573,346,10,19,4,36,86,2,49,0,0
1669,537,261,573,346,10,19,4,36,85,3,49,0,0
1670,537,259,574,346,10,19,4,37,87,4,49,0,0
1671,535,245,577,346,10,19,4,42,101,5,49,0,0
1672,538,252,578,346,10,19,4,40,94,6,49,0,0
1673,538,255,578,348,10,19,4,40,93,7,49,0,0
1674,537,250,578,347,10,19,4,41,97,8,49,0,0
1675,537,249,579,347,10,19,4,42,98,9,49,0,0
1679,537,254,576,346,10,19,4,39,92,0,49,0,0
1680,535,248,576,343,10,19,4,41,95,1,49,0,0
1681,535,251,576,346,10,19,4,41,95,2,49,0,0
1682,531,225,582,346,10,19,4,51,121,3,49,0,0
1683,533,217,587,346,10,19,4,54,129,4,49,0,0
1684,535,240,580,345,10,19,4,45,105,5,49,0,0
1685,535,246,576,343,10,19,4,41,97,6,49,0,0
1686,536,253,575,343,10,19,4,39,90,7,49,0,0
1687,535,251,575,344,10,19,4,40,93,8,49,0,0
1688,534,245,576,344,10,19,4,42,99,9,49,0,0
1689,534,247,576,345,10,19,4,42,98,10,49,0,0
1690,534,245,576,344,10,19,4,42,99,11,49,0,0
1691,537,256,574,344,10,19,4,37,88,12,49,0,0
1692,539,257,576,344,10,19,4,37,87,13,49,0,0
1693,539,260,575,343,10,19,4,36,83,14,49,0,0
1694,540,259,577,345,10,19,4,37,86,15,49,0,0
1695,541,263,577,346,10,19,4,36,83,16,49,0,0
1696,539,252,580,346,10,19,4,41,94,17,49,0,0
1697,539,262,576,344,10,19,4,37,82,18,49,0,0
1699,537,254,578,344,10,19,4,41,90,0,49,0,0
1700,534,240,581,346,10,19,4,47,106,1,49,0,0
1701,536,251,578,344,10,19,4,42,93,2,49,0,0
1702,537,260,575,344,10,19,4,38,84,3,49,0,0
1703,539,266,575,344,10,19,4,36,78,4,49,0,0
1704,538,265,575,344,10,19,4,37,79,5,49,0,0
1705,538,266,574,344,10,19,4,36,78,6,49,0,0
1706,534,250,577,343,10,19,4,43,93,7,49,0,0
1707,532,233,581,342,10,19,4,49,109,8,49,0,0
1708,531,230,582,342,10,19,4,51,112,9,49,0,0
1711,535,257,575,343,10,19,4,40,86,0,49,0,1
1712,537,260,576,345,10,19,4,39,85,1,49,0,0
1713,537,260,574,343,10,19,4,37,83,2,49,0,0
1714,536,260,571,339,10,19,4,35,79,3,49,0,0
1715,535,259,571,338,10,19,4,36,79,4,49,0,0
1716,536,256,576,344,10,19,4,40,88,5,49,0,0
1717,536,256,577,344,10,19,4,41,88,6,49,0,0
1718,536,257,577,345,10,19,4,41,88,7,49,0,0
1719,536,256,577,346,10,19,4,41,90,8,49,0,0
1720,536,259,576,346,10,19,4,40,87,9,49,0,0
1721,535,256,576,347,10,19,4,41,91,10,49,0,0
1722,534,254,574,344,10,19,4,40,90,11,49,0,0
1723,535,254,576,346,10,19,4,41,92,12,49,0,0
1724,535,256,576,347,10,19,4,41,91,13,49,0,0
1725,537,260,577,349,10,19,4,40,89,14,49,0,0
1726,536,260,574,345,10,19,4,38,85,15,49,0,0
1727,535,259,573,344,10,19,4,38,85,16,49,0,0
1728,536,260,574,344,10,19,4,38,84,17,49,0,0
1729,536,262,574,344,10,19,4,38,82,18,49,0,0
1730,536,261,573,343,10,19,4,37,82,19,49,0,0
1731,535,255,574,341,10,19,4,39,86,20,49,0,0
1732,534,253,575,341,10,19,4,41,88,21,49,0,0
1733,533,250,574,339,10,19,4,41,89,22,49,0,0
1734,533,249,573,339,10,19,4,40,90,23,49,0,0
1735,533,248,575,340,10,19,4,42,92,24,49,0,0
1736,535,254,574,341,10,19,4,39,87,25,49,0,0
1737,536,258,575,343,10,19,4,39,85,26,49,0,0
1738,535,257,575,343,10,19,4,40,86,27,49,0,0
1739,535,258,574,344,10,19,4,39,86,28,49,0,0
1740,536,259,574,342,10,19,4,38,83,29,49,0,0
1741,537,262,573,340,10,19,4,36,78,30,49,0,0
1742,537,262,573,340,10,19,4,36,78,31,49,0,0
1746,538,262,576,345,10,19,4,38,83,0,49,0,0
1747,538,259,578,346,10,19,4,40,87,1,49,0,0
1748,537,259,576,346,10,19,4,39,87,2,49,0,0
1749,536,258,577,346,10,19,4,41,88,3,49,0,0
1750,535,256,575,343,10,19,4,40,87,4,49,0,0
1751,535,254,575,343,10,19,4,40,89,5,49,0,0
1752,534,244,578,342,10,19,4,44,98,6,49,0,0
1753,532,234,581,344,10,19,4,49,110,7,49,0,0
1754,533,236,581,343,10,19,4,48,107,8,49,0,0
1755,535,242,580,345,10,19,4,45,103,9,49,0,0
1756,536,250,578,343,10,19,4,42,93,10,49,0,0
1757,536,251,576,342,10,19,4,40,91,11,49,0,0
1758,537,254,577,344,10,19,4,40,90,12,49,0,0
1759,537,256,575,342,10,19,4,38,86,13,49,0,0
1760,537,257,576,344,10,19,4,39,87,14,49,0,0
1764,535,259,571,341,10,19,4,36,82,0,49,0,0
1769,539,263,575,345,10,19,4,36,82,0,49,0,0
1770,538,259,576,344,10,19,4,38,85,1,49,0,0
1771,537,260,574,345,10,19,4,37,85,2,49,0,0
1772,537,260,574,345,10,19,4,37,85,3,49,0,0
1775,537,259,572,340,10,19,4,35,81,0,49,0,0
1776,538,261,574,342,10,19,4,36,81,1,49,0,0
1778,540,264,577,346,10,19,4,37,82,0,49,0,0
1779,538,260,576,344,10,19,4,38,84,1,49,0,0
1780,538,262,576,344,10,19,4,38,82,2,49,0,0
1781,539,266,574,342,10,19,4,35,76,3,49,0,0
1783,533,247,576,341,10,19,4,43,94,0,49,0,0
1784,536,255,575,342,10,19,4,39,87,1,49,0,0
1785,536,256,575,344,10,19,4,39,88,2,49,0,0
1786,535,255,575,344,10,19,4,40,89,3,49,0,0
1788,532,233,579,340,10,19,4,47,107,0,49,0,0
1789,532,230,580,339,10,19,4,48,109,1,49,0,0
1790,531,230,581,343,10,19,4,50,113,2,49,0,0
1791,531,227,581,343,10,19,4,50,116,3,49,0,0
1792,531,231,581,347,10,19,4,50,116,4,49,0,0
1793,531,227,580,346,10,19,4,49,119,5,49,0,0
1794,535,247,577,345,10,19,4,42,98,6,49,0,0
1795,534,237,578,345,10,19,4,44,108,7,49,0,0
1796,535,245,578,346,10,19,4,43,101,8,49,0,0
1797,536,246,578,346,10,19,4,42,100,9,49,0,0
1798,536,244,580,348,10,19,4,44,104,10,49,0,0
1799,536,250,577,346,10,19,4,41,96,11,49,0,0
1801,540,265,575,347,10,19,4,35,82,0,49,0,0
1802,535,253,575,346,10,19,4,40,93,1,49,0,0
1803,535,253,575,346,10,19,4,40,93,2,49,0,0
1806,534,242,578,345,10,19,4,44,103,0,49,0,0
1807,532,232,581,345,10,19,4,49,113,1,49,0,0
1808,536,248,577,345,10,19,4,41,97,2,49,0,0
1809,537,256,576,345,10,19,4,39,89,3,49,0,0
1810,537,256,576,345,10,19,4,39,89,4,49,0,0
1813,539,259,574,342,10,19,4,35,83,0,49,0,0
1814,539,260,574,342,10,19,4,35,82,1,49,0,0
1816,537,255,575,344,10,19,4,38,89,0,49,0,0
1817,535,251,576,346,10,19,4,41,95,1,49,0,0
1818,537,258,574,344,10,19,4,37,86,2,49,0,0
1819,537,260,573,344,10,19,4,36,84,3,49,0,0
1820,537,262,573,344,10,19,4,36,82,4,49,0,0
1821,537,262,573,345,10,19,4,36,83,5,49,0,0
1822,538,262,574,345,10,19,4,36,83,6,49,0,0
1823,538,262,574,345,10,19,4,36,83,7,49,0,0
1824,537,255,577,348,10,19,4,40,93,8,49,0,0
1825,537,254,577,348,10,19,4,40,94,9,49,0,0
1828,538,265,573,342,10,19,4,35,77,0,49,0,0
1829,538,265,573,342,10,19,4,35,77,1,49,0,0
1830,537,264,573,342,10,19,4,36,78,2,49,0,0
1831,537,260,575,343,10,19,4,38,83,3,49,0,0
1832,538,262,576,344,10,19,4,38,82,4,49,0,0
1833,539,265,575,342,10,19,4,36,77,5,49,0,0
1834,539,264,575,342,10,19,4,36,78,6,49,0,0
1835,539,267,574,342,10,19,4,35,75,7,49,0,0
1836,539,269,574,343,10,19,4,35,74,8,49,0,0
1837,539,267,574,344,10,19,4,35,77,9,49,0,0
1838,535,254,577,346,10,19,4,42,92,10,49,0,0
1839,537,265,575,347,10,19,4,38,82,11,49,0,0
1840,533,247,578,347,10,19,4,45,100,12,49,0,0
1841,535,256,576,347,10,19,4,41,91,13,49,0,0
1842,535,258,575,346,10,19,4,40,88,14,49,0,0
1843,533,249,576,344,10,19,4,43,95,15,49,0,0
1844,528,218,583,343,10,19,4,55,125,16,49,0,0
1845,532,242,577,344,10,19,4,45,102,17,49,0,0
1846,531,239,577,344,10,19,4,46,105,18,49,0,0
1849,536,246,578,344,10,19,4,42,98,0,49,0,0
1850,536,249,578,346,10,19,4,42,97,1,49,0,0
1851,537,256,576,344,10,19,4,39,88,2,49,0,0
1852,536,248,578,344,10,19,4,42,96,3,49,0,0
1853,534,243,579,344,10,19,4,45,101,4,49,0,0
1854,534,242,577,343,10,19,4,43,101,5,49,0,0
1855,534,245,575,341,10,19,4,41,96,6,49,0,0
1856,537,254,576,343,10,19,4,39,89,7,49,0,0
1857,538,258,576,345,10,19,4,38,87,8,49,0,0
1858,536,254,573,338,10,19,4,37,84,9,49,0,0
1859,536,254,572,337,10,19,4,36,83,10,49,0,0
1861,538,266,573,345,10,19,4,35,79,0,49,0,0
1863,537,262,573,344,10,19,4,36,82,0,49,0,1
1864,537,262,573,344,10,19,4,36,82,1,49,0,0
1865,533,244,575,341,10,19,4,42,97,2,49,0,0
1866,538,263,573,342,10,19,4,35,79,3,49,0,0
1867,532,244,576,345,10,19,4,44,101,4,49,0,0
1868,535,253,574,343,10,19,4,39,90,5,49,0,0
1869,534,246,574,340,10,19,4,40,94,6,49,0,0
1870,534,244,574,340,10,19,4,40,96,7,49,0,0
1871,536,252,576,346,10,19,4,40,94,8,49,0,0
1872,536,252,577,347,10,19,4,41,95,9,49,0,0
1873,537,255,579,350,10,19,4,42,95,10,49,0,0
1874,537,258,576,346,10,19,4,39,88,11,49,0,0
1875,537,254,577,346,10,19,4,40,92,12,49,0,0
1876,536,253,577,346,10,19,4,41,93,13,49,0,0
1877,538,258,577,348,10,19,4,39,90,14,49,0,0
1878,535,249,579,348,10,19,4,44,99,15,49,0,0
1879,535,248,579,349,10,19,4,44,101,16,49,0,0
1880,536,254,576,348,10,19,4,40,94,17,49,0,0
1881,535,253,576,348,10,19,4,41,95,18,49,0,0
1882,532,230,580,343,10,19,4,48,113,19,49,0,0
1883,531,229,580,344,10,19,4,49,115,20,49,0,0
1884,532,228,580,343,10,19,4,48,115,21,49,0,0
1885,533,235,577,338,10,19,4,44,103,22,49,0,0
1886,537,256,574,341,10,19,4,37,85,23,49,0,0
1887,538,259,573,342,10,19,4,35,83,24,49,0,0
1889,533,232,582,346,10,19,4,49,114,0,49,0,0
1890,536,245,578,345,10,19,4,42,100,1,49,0,0
1891,538,255,578,348,10,19,4,40,93,2,49,0,0
1892,538,254,578,347,10,19,4,40,93,3,49,0,0
1893,538,254,579,348,10,19,4,41,94,4,49,0,0
1896,540,265,576,346,10,19,4,36,81,0,49,0,0
1897,540,265,576,347,10,19,4,36,82,1,49,0,0
1898,538,261,576,347,10,19,4,38,86,2,49,0,0
1899,538,261,576,347,10,19,4,38,86,3,49,0,0
1901,536,256,575,345,10,19,4,39,89,0,49,0,0
1902,536,258,574,345,10,19,4,38,87,1,49,0,0
1903,531,236,579,346,10,19,4,48,110,2,49,0,0
1904,533,243,578,347,10,19,4,45,104,3,49,0,0
1905,532,235,579,344,10,19,4,47,109,4,49,0,0
1906,534,246,576,342,10,19,4,42,96,5,49,0,0
1907,535,250,574,342,10,19,4,39,92,6,49,0,0
1908,535,246,575,341,10,19,4,40,95,7,49,0,0
1909,538,260,573,341,10,19,4,35,81,8,49,0,0
1911,539,262,574,342,10,19,4,35,80,0,49,0,0
1912,537,255,574,341,10,19,4,37,86,1,49,0,0
1913,537,258,573,341,10,19,4,36,83,2,49,0,0
1914,537,254,575,342,10,19,4,38,88,3,49,0,0
1915,538,259,575,343,10,19,4,37,84,4,49,0,0
1916,539,261,576,347,10,19,4,37,86,5,49,0,0
1917,536,250,578,347,10,19,4,42,97,6,49,0,0
1918,536,249,579,348,10,19,4,43,99,7,49,0,0
1922,537,254,576,344,10,19,4,39,90,0,49,0,0
1923,537,254,576,344,10,19,4,39,90,1,49,0,0
1924,536,256,573,342,10,19,4,37,86,2,49,0,0
1925,536,259,573,344,10,19,4,37,85,3,49,0,0
1926,536,259,573,344,10,19,4,37,85,4,49,0,0
1927,540,264,575,346,10,19,4,35,82,5,49,0,0
1932,537,257,577,349,10,19,4,40,92,0,49,0,0
1933,537,256,577,350,10,19,4,40,94,1,49,0,0
1935,534,246,577,347,10,19,4,43,101,0,49,0,0
1936,533,245,577,347,10,19,4,44,102,1,49,0,0
1942,536,260,574,347,10,19,4,38,87,0,49,0,0
1943,538,263,574,345,10,19,4,36,82,1,49,0,0
1944,538,263,574,345,10,19,4,36,82,2,49,0,0
1946,539,266,575,347,10,19,4,36,81,0,49,0,0
1947,538,263,575,347,10,19,4,37,84,1,49,0,0
1948,538,263,575,347,10,19,4,37,84,2,49,0,0
1953,533,250,576,347,10,19,4,43,97,0,49,0,0
1954,532,249,576,348,10,19,4,44,99,1,49,0,0
1957,538,265,574,345,10,19,4,36,80,0,49,0,0
1958,537,264,573,345,10,19,4,36,81,1,49,0,0
1959,538,264,573,344,10,19,4,35,80,2,49,0,0
1960,538,265,573,345,10,19,4,35,80,3,49,0,0
1961,536,255,574,341,10,19,4,38,86,4,49,0,0
1962,539,260,575,341,10,19,4,36,81,5,49,0,0
1963,537,257,575,340,10,19,4,38,83,6,49,0,0
1964,536,255,575,341,10,19,4,39,86,7,49,0,0
1965,536,253,574,338,10,19,4,38,85,8,49,0,0
1966,536,252,574,338,10,19,4,38,86,9,49,0,0
1967,536,256,573,340,10,19,4,37,84,10,49,0,0
1971,540,266,576,342,10,19,4,36,76,0,49,0,1
1972,536,256,577,344,10,19,4,41,88,1,49,0,0
1973,536,254,578,343,10,19,4,42,89,2,49,0,0
1974,535,255,577,344,10,19,4,42,89,3,49,0,0
1975,534,256,575,343,10,19,4,41,87,4,49,0,0
1976,532,249,576,343,10,19,4,44,94,5,49,0,0
1977,534,254,575,343,10,19,4,41,89,6,49,0,0
1978,528,224,583,344,10,19,4,55,120,7,49,0,0
1979,530,228,583,345,10,19,4,53,117,8,49,0,0
1980,529,229,582,345,10,19,4,53,116,9,49,0,0
1981,528,226,583,346,10,19,4,55,120,10,49,0,0
1982,533,243,577,342,10,19,4,44,99,11,49,0,0
1983,533,242,578,345,10,19,4,45,103,12,49,0,0
1984,541,268,576,346,10,19,4,35,78,13,49,0,0
1985,535,250,578,347,10,19,4,43,97,14,49,0,0
1986,533,237,579,343,10,19,4,46,106,15,49,0,0
1987,534,247,575,340,10,19,4,41,93,16,49,0,0
1988,534,243,578,342,10,19,4,44,99,17,49,0,0
1989,532,231,580,340,10,19,4,48,109,18,49,0,0
1990,531,232,578,342,10,19,4,47,110,19,49,0,0
1991,532,239,576,343,10,19,4,44,104,20,49,0,0
1992,531,235,577,344,10,19,4,46,109,21,49,0,0
1993,532,239,576,344,10,19,4,44,105,22,49,0,0
1994,534,248,574,343,10,19,4,40,95,23,49,0,0
1995,534,246,575,344,10,19,4,41,98,24,49,0,0
1996,534,250,573,343,10,19,4,39,93,25,49,0,0
1997,535,252,573,343,10,19,4,38,91,26,49,0,0
1998,536,255,576,348,10,19,4,40,93,27,49,0,0
1999,536,257,574,347,10,19,4,38,90,28,49,0,0
2000,538,262,573,344,10,19,4,35,82,29,49,0,0
2006,538,264,574,347,10,19,4,36,83,0,49,0,0
2007,538,264,574,347,10,19,4,36,83,1,49,0,0
2008,537,262,572,342,10,19,4,35,80,2,49,0,0
2009,537,262,572,342,10,19,4,35,80,3,49,0,0
2011,539,261,577,349,10,19,4,38,88,0,49,0,0
2012,539,261,578,350,10,19,4,39,89,1,49,0,0
2013,540,267,575,347,10,19,4,35,80,2,49,0,0
2014,536,253,576,345,10,19,4,40,92,3,49,0,0
2015,536,252,576,345,10,19,4,40,93,4,49,0,0
2016,538,261,574,345,10,19,4,36,84,5,49,0,0
2017,537,257,575,347,10,19,4,38,90,6,49,0,0
2018,538,260,574,343,10,19,4,36,83,7,49,0,0
2019,538,260,574,343,10,19,4,36,83,8,49,0,0
2022,537,264,572,344,10,19,4,35,80,0,49,0,0
2023,537,264,573,345,10,19,4,36,81,1,49,0,0
2024,537,262,574,346,10,19,4,37,84,2,49,0,0
2025,536,257,576,347,10,19,4,40,90,3,49,0,0
2031,538,265,573,344,10,19,4,35,79,0,49,0,0
2032,537,261,576,346,10,19,4,39,85,1,49,0,0
2033,537,261,574,344,10,19,4,37,83,2,49,0,0
2034,536,260,572,340,10,19,4,36,80,3,49,0,0
2035,537,261,573,342,10,19,4,36,81,4,49,0,0
2036,537,261,573,341,10,19,4,36,80,5,49,0,0
2038,532,243,576,345,10,19,4,44,102,0,49,0,0
2039,535,252,574,342,10,19,4,39,90,1,49,0,0
2040,535,255,573,341,10,19,4,38,86,2,49,0,0
2041,533,251,573,343,10,19,4,40,92,3,49,0,0
2042,535,258,573,344,10,19,4,38,86,4,49,0,0
2043,535,259,572,343,10,19,4,37,84,5,49,0,0
2044,535,259,571,342,10,19,4,36,83,6,49,0,0
2045,536,259,572,342,10,19,4,36,83,7,49,0,0
2054,536,261,571,336,10,19,4,35,75,0,49,0,0
2055,537,264,572,339,10,19,4,35,75,1,49,0,0
2056,538,264,574,343,10,19,4,36,79,2,49,0,0
2057,538,263,574,343,10,19,4,36,80,3,49,0,0
2058,538,257,579,349,10,19,4,41,92,4,49,0,0
2059,532,228,586,350,10,19,4,54,122,5,49,0,0
2060,531,212,589,347,10,19,4,58,135,6,49,0,0
2061,530,208,590,347,10,19,4,60,139,7,49,0,0
482,730,210,784,350,11,19,4,54,140,0,0,0,0
498,422,349,459,452,12,19,4,37,103,0,0,0,0
501,423,360,460,451,13,19,4,37,91,0,0,0,0
503,417,354,460,451,14,19,4,43,97,0,0,0,0
551,421,356,460,452,15,19,4,39,96,0,0,0,0
571,720,201,782,347,16,19,4,62,146,0,5,0,0
572,719,201,781,347,16,19,4,62,146,1,5,0,0
573,720,203,782,348,16,19,4,62,145,2,5,0,0
574,724,204,785,346,16,19,4,61,142,3,5,0,0
575,723,211,780,344,16,19,4,57,133,4,5,0,0
576,724,214,779,343,16,19,4,55,129,5,5,0,0
582,722,215,778,346,16,19,4,56,131,0,5,0,0
583,722,216,777,346,16,19,4,55,130,1,5,0,0
586,727,219,781,345,16,19,4,54,126,0,5,0,0
587,728,220,781,345,16,19,4,53,125,1,5,0,0
616,723,217,779,344,16,19,4,56,127,0,5,0,0
617,723,216,779,344,16,19,4,56,128,1,5,0,0
652,730,219,778,341,17,19,4,48,122,0,0,0,0
666,725,212,779,345,18,19,4,54,133,0,0,0,0
731,736,226,793,344,19,19,4,57,118,0,0,0,0
748,733,217,779,341,20,19,4,46,124,0,0,0,0
763,416,355,459,453,21,19,4,43,98,0,0,0,0
766,731,216,786,344,22,19,4,55,128,0,0,0,0
780,420,352,459,455,23,19,4,39,103,0,0,0,0
799,732,210,789,345,24,19,4,57,135,0,1,0,0
800,728,207,786,345,24,19,4,58,138,1,1,0,0
807,722,203,779,344,25,19,4,57,141,0,0,0,0
902,736,222,779,343,26,19,4,43,121,0,0,0,0
1166,419,353,461,452,27,19,4,42,99,0,0,0,0
1302,723,214,784,340,28,19,4,61,126,0,1,0,0
1303,726,214,787,340,28,19,4,61,126,1,1,0,0
1366,1628,144,1667,245,29,19,4,39,101,0,146,0,1
1367,1628,144,1668,245,29,19,4,40,101,1,146,0,0
1368,1628,137,1671,248,29,19,4,43,111,2,146,0,0
1369,1628,138,1671,249,29,19,4,43,111,3,146,0,0
1370,1628,133,1674,252,29,19,4,46,119,4,146,0,0
1371,1627,135,1672,252,29,19,4,45,117,5,146,0,0
1372,1627,138,1671,254,29,19,4,44,116,6,146,0,0
1373,1626,138,1671,257,29,19,4,45,119,7,146,0,0
1374,1627,141,1671,259,29,19,4,44,118,8,146,0,0
1375,1627,141,1671,259,29,19,4,44,118,9,146,0,0
1376,1628,144,1672,263,29,19,4,44,119,10,146,0,0
1377,1630,146,1671,260,29,19,4,41,114,11,146,0,0
1378,1629,143,1672,263,29,19,4,43,120,12,146,0,0
1379,1629,143,1673,264,29,19,4,44,121,13,146,0,0
1380,1627,139,1674,268,29,19,4,47,129,14,146,0,0
1381,1628,145,1673,270,29,19,4,45,125,15,146,0,0
1382,1628,146,1672,270,29,19,4,44,124,16,146,0,0
1383,1627,150,1670,271,29,19,4,43,121,17,146,0,0
1384,1627,147,1672,277,29,19,4,45,130,18,146,0,0
1385,1626,153,1671,282,29,19,4,45,129,19,146,0,0
1386,1623,145,1673,288,29,19,4,50,143,20,146,0,0
1387,1622,142,1673,290,29,19,4,51,148,21,146,0,0
1388,1622,149,1672,294,29,19,4,50,145,22,146,0,0
1389,1621,146,1672,296,29,19,4,51,150,23,146,0,0
1390,1623,155,1669,292,29,19,4,46,137,24,146,0,0
1391,1622,148,1672,297,29,19,4,50,149,25,146,0,0
1392,1620,151,1671,300,29,19,4,51,149,26,146,0,0
1393,1617,147,1670,304,29,19,4,53,157,27,146,0,0
1394,1615,145,1670,306,29,19,4,55,161,28,146,0,0
1395,1614,142,1671,312,29,19,4,57,170,29,146,0,0
1396,1611,143,1669,314,29,19,4,58,171,30,146,0,0
1397,1610,147,1667,316,29,19,4,57,169,31,146,0,0
1398,1610,159,1662,317,29,19,4,52,158,32,146,0,0
1399,1609,162,1660,316,29,19,4,51,154,33,146,0,0
1400,1606,160,1661,325,29,19,4,55,165,34,146,0,0
1401,1608,158,1664,330,29,19,4,56,172,35,146,0,0
1402,1608,165,1664,333,29,19,4,56,168,36,146,0,0
1403,1607,156,1668,338,29,19,4,61,182,37,146,0,0
1404,1605,142,1671,340,29,19,4,66,198,38,146,0,0
1405,1607,158,1669,346,29,19,4,62,188,39,146,0,0
1406,1612,176,1669,346,29,19,4,57,170,40,146,0,0
1407,1614,178,1672,354,29,19,4,58,176,41,146,0,0
1408,1611,173,1674,361,29,19,4,63,188,42,146,0,0
1409,1607,176,1671,366,29,19,4,64,190,43,146,0,0
1410,1608,177,1671,368,29,19,4,63,191,44,146,0,0
1411,1604,172,1672,379,29,19,4,68,207,45,146,0,0
1412,1604,170,1673,380,29,19,4,69,210,46,146,0,0
1413,1601,169,1673,388,29,19,4,72,219,47,146,0,0
1414,1600,171,1673,398,29,19,4,73,227,48,146,0,0
1415,1599,165,1674,399,29,19,4,75,234,49,146,0,0
1416,1594,156,1675,407,29,19,4,81,251,50,146,0,0
1417,1596,166,1676,416,29,19,4,80,250,51,146,0,0
1418,1598,172,1678,421,29,19,4,80,249,52,146,0,0
1419,1597,172,1680,430,29,19,4,83,258,53,146,0,0
1420,1593,167,1678,436,29,19,4,85,269,54,146,0,0
1421,1596,177,1681,443,29,19,4,85,266,55,146,0,0
1422,1600,183,1686,458,29,19,4,86,275,56,146,0,0
1423,1604,190,1690,465,29,19,4,86,275,57,146,0,0
1424,1600,183,1691,474,29,19,4,91,291,58,146,0,0
1425,1599,192,1690,483,29,19,4,91,291,59,146,0,0
1426,1597,202,1687,489,29,19,4,90,287,60,146,0,0
1427,1594,206,1687,503,29,19,4,93,297,61,146,0,0
1428,1592,210,1688,521,29,19,4,96,311,62,146,0,0
1429,1584,209,1683,526,29,19,4,99,317,63,146,0,0
1430,1577,215,1680,539,29,19,4,103,324,64,146,0,0
1431,1567,225,1668,547,29,19,4,101,322,65,146,0,0
1432,1555,224,1661,556,29,19,4,106,332,66,146,0,0
1433,1547,229,1658,579,29,19,4,111,350,67,146,0,0
1434,1540,232,1654,591,29,19,4,114,359,68,146,0,0
1435,1532,235,1647,600,29,19,4,115,365,69,146,0,0
1436,1523,244,1639,612,29,19,4,116,368,70,146,0,0
1437,1508,246,1629,624,29,19,4,121,378,71,146,0,0
1438,1495,249,1627,662,29,19,4,132,413,72,146,0,0
1439,1491,261,1627,684,29,19,4,136,423,73,146,0,0
1440,1493,265,1631,691,29,19,4,138,426,74,146,0,0
1441,1494,276,1640,726,29,19,4,146,450,75,146,0,0
1442,1488,282,1640,746,29,19,4,152,464,76,146,0,0
1443,1488,287,1644,767,29,19,4,156,480,77,146,0,0
1444,1493,305,1656,811,29,19,4,163,506,78,146,0,0
1445,1497,316,1662,833,29,19,4,165,517,79,146,0,0
1446,1484,327,1657,860,29,19,4,173,533,80,146,0,0
1447,1471,343,1654,905,29,19,4,183,562,81,146,0,0
1448,1463,349,1654,931,29,19,4,191,582,82,146,0,0
1449,1464,363,1664,974,29,19,4,200,611,83,146,0,0
1450,1474,383,1680,1014,29,19,4,206,631,84,146,0,0
1451,1476,395,1689,1034,29,19,4,213,639,85,146,0,0
1452,1487,410,1710,1063,29,19,4,223,653,86,146,0,0
1453,1502,424,1726,1065,29,19,4,224,641,87,146,0,0
1454,1516,438,1745,1073,29,19,4,229,635,88,146,0,0
1455,1531,451,1766,1078,29,19,4,235,627,89,146,0,0
1456,1571,461,1812,1080,29,19,4,241,619,90,146,0,0
1457,1605,470,1850,1079,29,19,4,245,609,91,146,0,0
1458,1631,484,1875,1074,29,19,4,244,590,92,146,0,0
1459,1654,515,1889,1071,29,19,4,235,556,93,146,0,0
1460,1662,526,1900,1077,29,19,4,238,551,94,146,0,0
1461,1649,558,1873,1070,29,19,4,224,512,95,146,0,0
1462,1651,591,1863,1064,29,19,4,212,473,96,146,0,0
1463,1658,593,1878,1069,29,19,4,220,476,97,146,0,0
1464,1651,611,1865,1065,29,19,4,214,454,98,146,0,0
1465,1644,595,1872,1070,29,19,4,228,475,99,146,0,0
1466,1648,594,1882,1074,29,19,4,234,480,100,146,0,0
1467,1640,604,1871,1071,29,19,4,231,467,101,146,0,0
1468,1640,599,1875,1068,29,19,4,235,469,102,146,0,0
1469,1641,596,1881,1067,29,19,4,240,471,103,146,0,0
1470,1634,591,1876,1065,29,19,4,242,474,104,146,0,0
1471,1626,583,1874,1068,29,19,4,248,485,105,146,0,0
1472,1669,579,1912,1067,29,19,4,243,488,106,146,0,0
1473,1653,584,1898,1068,29,19,4,245,484,107,146,0,0
1474,1687,583,1920,1059,29,19,4,233,476,108,146,0,0
1475,1660,590,1899,1064,29,19,4,239,474,109,146,0,0
1476,1646,584,1892,1065,29,19,4,246,481,110,146,0,0
1477,1639,590,1883,1061,29,19,4,244,471,111,146,0,0
1478,1634,593,1882,1068,29,19,4,248,475,112,146,0,0
1479,1634,595,1882,1069,29,19,4,248,474,113,146,0,0
1480,1640,609,1885,1067,29,19,4,245,458,114,146,0,0
1481,1641,626,1876,1059,29,19,4,235,433,115,146,0,0
1482,1627,614,1869,1061,29,19,4,242,447,116,146,0,0
1483,1635,602,1883,1054,29,19,4,248,452,117,146,0,0
1484,1636,597,1891,1059,29,19,4,255,462,118,146,0,0
1485,1637,594,1896,1063,29,19,4,259,469,119,146,0,0
1486,1624,594,1881,1061,29,19,4,257,467,120,146,0,0
1487,1622,594,1880,1063,29,19,4,258,469,121,146,0,0
1488,1630,594,1890,1061,29,19,4,260,467,122,146,0,0
1489,1626,593,1890,1064,29,19,4,264,471,123,146,0,0
1490,1611,597,1869,1066,29,19,4,258,469,124,146,0,0
1491,1623,593,1887,1071,29,19,4,264,478,125,146,0,0
1492,1629,589,1895,1070,29,19,4,266,481,126,146,0,0
1493,1630,590,1897,1068,29,19,4,267,478,127,146,0,0
1494,1630,589,1900,1073,29,19,4,270,484,128,146,0,0
1495,1634,589,1901,1065,29,19,4,267,476,129,146,0,0
1496,1633,589,1902,1065,29,19,4,269,476,130,146,0,0
1497,1636,594,1901,1059,29,19,4,265,465,131,146,0,0
1498,1640,600,1903,1058,29,19,4,263,458,132,146,0,0
1499,1638,603,1902,1058,29,19,4,264,455,133,146,0,0
1500,1638,596,1907,1060,29,19,4,269,464,134,146,0,0
1501,1632,584,1910,1066,29,19,4,278,482,135,146,0,0
1502,1629,572,1912,1066,29,19,4,283,494,136,146,0,0
1503,1625,544,1920,1069,29,19,4,295,525,137,146,0,0
1504,1616,523,1920,1070,29,19,4,304,547,138,146,0,0
1505,1611,512,1917,1066,29,19,4,306,554,139,146,0,0
1506,1615,513,1920,1069,29,19,4,305,556,140,146,0,0
1507,1625,529,1920,1071,29,19,4,295,542,141,146,0,0
1508,1645,558,1920,1071,29,19,4,275,513,142,146,0,0
1509,1647,557,1920,1072,29,19,4,273,515,143,146,0,0
1510,1707,587,1920,1072,29,19,4,213,485,144,146,0,0
1511,1739,583,1920,1072,29,19,4,181,489,145,146,0,0
1512,1748,585,1920,1072,29,19,4,172,487,146,146,1,0
1413,294,897,465,1073,30,19,4,171,176,0,0,0,0
1414,356,814,573,1067,31,19,4,217,253,0,0,0,0
1418,652,613,939,1074,32,19,4,287,461,0,78,0,1
1419,683,584,982,1064,32,19,4,299,480,1,78,0,0
1420,730,539,1054,1062,32,19,4,324,523,2,78,0,0
1421,766,508,1096,1048,32,19,4,330,540,3,78,0,0
1422,821,490,1166,1062,32,19,4,345,572,4,78,0,0
1423,857,478,1201,1058,32,19,4,344,580,5,78,0,0
1424,886,444,1229,1038,32,19,4,343,594,6,78,0,0
1425,927,425,1264,1021,32,19,4,337,596,7,78,0,0
1426,945,403,1276,1005,32,19,4,331,602,8,78,0,0
1427,977,386,1268,926,32,19,4,291,540,9,78,0,0
1428,1010,379,1276,889,32,19,4,266,510,10,78,0,0
1429,1033,360,1285,860,32,19,4,252,500,11,78,0,0
1430,1064,336,1299,817,32,19,4,235,481,12,78,0,0
1431,1088,320,1316,799,32,19,4,228,479,13,78,0,0
1432,1101,318,1319,790,32,19,4,218,472,14,78,0,0
1433,1124,310,1321,746,32,19,4,197,436,15,78,0,0
1434,1140,300,1326,721,32,19,4,186,421,16,78,0,0
1435,1158,293,1338,712,32,19,4,180,419,17,78,0,0
1436,1184,286,1351,682,32,19,4,167,396,18,78,0,0
1437,1205,275,1366,665,32,19,4,161,390,19,78,0,0
1438,1216,273,1371,661,32,19,4,155,388,20,78,0,0
1439,1227,261,1378,650,32,19,4,151,389,21,78,0,0
1440,1242,257,1380,619,32,19,4,138,362,22,78,0,0
1441,1259,260,1387,601,32,19,4,128,341,23,78,0,0
1442,1274,252,1395,579,32,19,4,121,327,24,78,0,0
1443,1289,245,1409,573,32,19,4,120,328,25,78,0,0
1444,1300,245,1418,571,32,19,4,118,326,26,78,0,0
1445,1308,240,1424,567,32,19,4,116,327,27,78,0,0
1446,1317,237,1425,546,32,19,4,108,309,28,78,0,0
1447,1326,238,1429,537,32,19,4,103,299,29,78,0,0
1448,1338,233,1437,523,32,19,4,99,290,30,78,0,0
1449,1352,219,1451,512,32,19,4,99,293,31,78,0,0
1450,1365,220,1459,505,32,19,4,94,285,32,78,0,0
1451,1374,221,1466,499,32,19,4,92,278,33,78,0,0
1452,1383,214,1471,480,32,19,4,88,266,34,78,0,0
1453,1390,215,1475,475,32,19,4,85,260,35,78,0,0
1454,1401,206,1488,472,32,19,4,87,266,36,78,0,0
1455,1409,207,1492,463,32,19,4,83,256,37,78,0,0
1456,1422,207,1501,454,32,19,4,79,247,38,78,0,0
1457,1428,206,1507,454,32,19,4,79,248,39,78,0,0
1458,1433,207,1509,449,32,19,4,76,242,40,78,0,0
1459,1437,202,1510,436,32,19,4,73,234,41,78,0,0
1460,1441,200,1514,434,32,19,4,73,234,42,78,0,0
1461,1448,199,1519,427,32,19,4,71,228,43,78,0,0
1462,1453,187,1523,415,32,19,4,70,228,44,78,0,0
1463,1456,181,1525,413,32,19,4,69,232,45,78,0,0
1464,1459,186,1525,410,32,19,4,66,224,46,78,0,0
1465,1461,187,1524,399,32,19,4,63,212,47,78,0,0
1466,1463,187,1525,394,32,19,4,62,207,48,78,0,0
1467,1468,191,1529,392,32,19,4,61,201,49,78,0,0
1468,1472,170,1538,388,32,19,4,66,218,50,78,0,0
1469,1474,165,1539,383,32,19,4,65,218,51,78,0,0
1470,1474,163,1539,381,32,19,4,65,218,52,78,0,0
1471,1474,151,1541,375,32,19,4,67,224,53,78,0,0
1472,1476,158,1539,369,32,19,4,63,211,54,78,0,0
1473,1476,153,1540,365,32,19,4,64,212,55,78,0,0
1474,1479,148,1543,364,32,19,4,64,216,56,78,0,0
1475,1482,145,1546,359,32,19,4,64,214,57,78,0,0
1476,1485,153,1546,356,32,19,4,61,203,58,78,0,0
1477,1486,153,1546,356,32,19,4,60,203,59,78,0,0
1478,1487,154,1546,349,32,19,4,59,195,60,78,0,0
1479,1492,162,1548,346,32,19,4,56,184,61,78,0,0
1480,1495,154,1553,344,32,19,4,58,190,62,78,0,0
1481,1498,151,1556,341,32,19,4,58,190,63,78,0,0
1482,1503,152,1558,336,32,19,4,55,184,64,78,0,0
1483,1505,147,1560,331,32,19,4,55,184,65,78,0,0
1484,1504,149,1559,332,32,19,4,55,183,66,78,0,0
1485,1503,145,1558,327,32,19,4,55,182,67,78,0,0
1486,1503,148,1557,325,32,19,4,54,177,68,78,0,0
1487,1503,143,1558,325,32,19,4,55,182,69,78,0,0
1488,1508,150,1560,318,32,19,4,52,168,70,78,0,0
1489,1508,145,1560,317,32,19,4,52,172,71,78,0,0
1490,1510,148,1562,316,32,19,4,52,168,72,78,0,0
1491,1513,153,1561,311,32,19,4,48,158,73,78,0,0
1492,1515,146,1565,307,32,19,4,50,161,74,78,0,0
1493,1510,132,1563,305,32,19,4,53,173,75,78,0,0
1494,1509,120,1565,304,32,19,4,56,184,76,78,0,0
1495,1519,135,1568,294,32,19,4,49,159,77,78,0,0
1496,1521,133,1569,290,32,19,4,48,157,78,78,1,0
1501,1542,142,1585,285,32,19,4,43,143,0,78,0,1
1502,1545,142,1588,282,32,19,4,43,140,1,78,0,0
1503,1548,141,1591,284,32,19,4,43,143,2,78,0,0
1504,1550,143,1592,280,32,19,4,42,137,3,78,0,0
1505,1553,143,1594,278,32,19,4,41,135,4,78,0,0
1506,1548,143,1590,278,32,19,4,42,135,5,78,0,0
1507,1550,143,1591,275,32,19,4,41,132,6,78,0,0
1508,1552,143,1592,271,32,19,4,40,128,7,78,0,0
1509,1553,143,1594,270,32,19,4,41,127,8,78,0,0
1510,1552,142,1593,268,32,19,4,41,126,9,78,0,0
1511,1554,144,1594,264,32,19,4,40,120,10,78,0,0
1512,1553,144,1592,261,32,19,4,39,117,11,78,0,0
1513,1555,144,1597,267,32,19,4,42,123,12,78,0,0
1514,1560,139,1602,263,32,19,4,42,124,13,78,0,0
1515,1564,136,1606,258,32,19,4,42,122,14,78,0,0
1516,1566,135,1608,256,32,19,4,42,121,15,78,0,0
1517,1566,130,1610,257,32,19,4,44,127,16,78,0,0
1518,1564,133,1608,256,32,19,4,44,123,17,78,0,0
1519,1566,132,1609,255,32,19,4,43,123,18,78,0,0
1520,1566,135,1608,254,32,19,4,42,119,19,78,0,0
1521,1569,137,1609,253,32,19,4,40,116,20,78,0,0
1522,1569,136,1610,253,32,19,4,41,117,21,78,0,0
1523,1569,137,1608,252,32,19,4,39,115,22,78,0,0
1524,1570,137,1609,251,32,19,4,39,114,23,78,0,0
1526,1569,135,1610,249,32,19,4,41,114,0,78,0,0
1527,1569,136,1610,248,32,19,4,41,112,1,78,0,0
1528,1571,133,1612,245,32,19,4,41,112,2,78,0,0
1529,1569,132,1612,246,32,19,4,43,114,3,78,0,0
1530,1570,132,1614,246,32,19,4,44,114,4,78,0,0
1531,1571,132,1615,245,32,19,4,44,113,5,78,0,0
1532,1571,135,1611,241,32,19,4,40,106,6,78,0,0
1533,1571,134,1611,239,32,19,4,40,105,7,78,0,0
1536,1580,130,1621,239,32,19,4,41,109,0,78,0,0
1537,1582,129,1622,238,32,19,4,40,109,1,78,0,0
1539,1579,128,1620,235,32,19,4,41,107,0,78,0,0
1540,1581,126,1622,235,32,19,4,41,109,1,78,0,0
1541,1581,125,1623,234,32,19,4,42,109,2,78,0,0
1446,418,353,460,451,33,19,4,42,98,0,1,0,0
1447,418,353,460,451,33,19,4,42,98,1,1,0,0
1451,422,352,459,452,34,19,4,37,100,0,0,0,0
1477,1847,609,1917,694,35,19,4,70,85,0,0,0,0
1483,1853,601,1918,691,36,19,4,65,90,0,5,0,0
1484,1851,601,1916,691,36,19,4,65,90,1,5,0,0
1485,1852,603,1915,689,36,19,4,63,86,2,5,0,0
1486,1853,604,1914,688,36,19,4,61,84,3,5,0,0
1488,1855,609,1913,688,36,19,4,58,79,0,5,0,0
1489,1856,611,1912,688,36,19,4,56,77,1,5,0,0
1491,1851,599,1916,687,36,19,4,65,88,0,5,0,0
1492,1850,598,1915,686,36,19,4,65,88,1,5,0,0
1493,1847,597,1915,688,36,19,4,68,91,2,5,0,0
1494,1847,597,1915,687,36,19,4,68,90,3,5,0,0
1496,1852,600,1916,687,36,19,4,64,87,0,5,0,0
1497,1853,604,1915,687,36,19,4,62,83,1,5,0,0
1498,1853,607,1916,691,36,19,4,63,84,2,5,0,0
1499,1852,607,1917,691,36,19,4,65,84,3,5,0,0
1500,1850,603,1918,692,36,19,4,68,89,4,5,0,0
1501,1850,603,1918,693,36,19,4,68,90,5,5,0,0
1490,1748,632,1907,1063,37,19,4,159,431,0,0,0,0
1536,535,242,577,346,38,19,4,42,104,0,0,0,0
1543,421,348,458,450,39,19,4,37,102,0,0,0,0
1547,1676,498,1917,1070,40,19,4,241,572,0,22,0,1
1548,1677,496,1920,1074,40,19,4,243,578,1,22,0,0
1549,1676,512,1913,1074,40,19,4,237,562,2,22,0,0
1550,1680,556,1898,1070,40,19,4,218,514,3,22,0,0
1551,1680,582,1887,1066,40,19,4,207,484,4,22,0,0
1552,1673,600,1878,1076,40,19,4,205,476,5,22,0,0
1553,1665,575,1880,1068,40,19,4,215,493,6,22,0,0
1554,1657,585,1867,1065,40,19,4,210,480,7,22,0,0
1555,1652,577,1866,1063,40,19,4,214,486,8,22,0,0
1556,1654,579,1868,1062,40,19,4,214,483,9,22,0,0
1557,1657,591,1866,1059,40,19,4,209,468,10,22,0,0
1558,1658,592,1868,1064,40,19,4,210,472,11,22,0,0
1559,1663,599,1871,1063,40,19,4,208,464,12,22,0,0
1560,1669,606,1874,1061,40,19,4,205,455,13,22,0,0
1561,1669,600,1882,1067,40,19,4,213,467,14,22,0,0
1562,1670,600,1886,1069,40,19,4,216,469,15,22,0,0
1563,1669,599,1886,1069,40,19,4,217,470,16,22,0,0
1564,1663,599,1879,1068,40,19,4,216,469,17,22,0,0
1565,1663,599,1881,1068,40,19,4,218,469,18,22,0,0
1566,1657,601,1872,1062,40,19,4,215,461,19,22,0,0
1567,1652,601,1871,1066,40,19,4,219,465,20,22,0,0
1568,1645,607,1860,1063,40,19,4,215,456,21,22,0,0
1569,1644,610,1857,1063,40,19,4,213,453,22,22,1,0
1571,1651,582,1878,1064,40,19,4,227,482,0,22,0,0
1572,1655,593,1873,1058,40,19,4,218,465,1,22,0,0
1573,1657,597,1873,1059,40,19,4,216,462,2,22,0,0
1574,1656,594,1875,1065,40,19,4,219,471,3,22,0,0
1575,1652,590,1870,1064,40,19,4,218,474,4,22,0,0
1576,1660,589,1881,1064,40,19,4,221,475,5,22,0,0
1577,1659,583,1882,1059,40,19,4,223,476,6,22,0,0
1578,1653,591,1873,1062,40,19,4,220,471,7,22,0,0
1579,1658,569,1892,1065,40,19,4,234,496,8,22,0,0
1580,1665,590,1889,1060,40,19,4,224,470,9,22,0,0
1581,1670,589,1895,1057,40,19,4,225,468,10,22,0,0
1582,1671,581,1904,1065,40,19,4,233,484,11,22,0,0
1583,1672,571,1906,1058,40,19,4,234,487,12,22,0,0
1584,1673,533,1920,1060,40,19,4,247,527,13,22,0,0
1585,1673,537,1920,1065,40,19,4,247,528,14,22,0,0
1586,1673,540,1919,1067,40,19,4,246,527,15,22,0,0
1587,1674,536,1920,1068,40,19,4,246,532,16,22,0,0
1589,1678,620,1891,1069,40,19,4,213,449,0,22,0,0
1590,1680,625,1891,1070,40,19,4,211,445,1,22,0,0
1551,1824,587,1920,1047,41,19,4,96,460,0,1,0,0
1552,1822,603,1908,1016,41,19,4,86,413,1,1,0,0
1556,1808,568,1917,1028,42,19,4,109,460,0,0,0,0
1559,1821,601,1919,1027,43,19,4,98,426,0,7,0,0
1560,1821,608,1919,1036,43,19,4,98,428,1,7,0,0
1561,1819,589,1920,1033,43,19,4,101,444,2,7,0,0
1562,1820,599,1917,1020,43,19,4,97,421,3,7,0,0
1563,1819,601,1913,1009,43,19,4,94,408,4,7,0,0
1564,1822,602,1915,1005,43,19,4,93,403,5,7,0,0
1565,1815,597,1912,1011,43,19,4,97,414,6,7,0,0
1566,1814,597,1911,1008,43,19,4,97,411,7,7,0,0
1589,1837,598,1918,1071,44,19,4,81,473,0,0,0,0
1624,1664,586,1908,1065,45,19,4,244,479,0,24,0,1
1625,1657,504,1920,1078,45,19,4,263,574,1,24,0,0
1626,1650,484,1920,1076,45,19,4,270,592,2,24,0,0
1627,1652,491,1920,1077,45,19,4,268,586,3,24,0,0
1628,1659,523,1920,1069,45,19,4,261,546,4,24,0,0
1629,1658,564,1905,1062,45,19,4,247,498,5,24,0,0
1630,1656,581,1892,1057,45,19,4,236,476,6,24,0,0
1631,1649,593,1880,1059,45,19,4,231,466,7,24,0,0
1632,1650,596,1885,1069,45,19,4,235,473,8,24,0,0
1633,1649,605,1880,1070,45,19,4,231,465,9,24,0,0
1634,1658,614,1889,1077,45,19,4,231,463,10,24,0,0
1635,1662,600,1899,1075,45,19,4,237,475,11,24,0,0
1636,1659,605,1897,1078,45,19,4,238,473,12,24,0,0
1637,1662,597,1903,1075,45,19,4,241,478,13,24,0,0
1638,1655,587,1905,1078,45,19,4,250,491,14,24,0,0
1639,1660,590,1908,1079,45,19,4,248,489,15,24,0,0
1640,1657,590,1906,1080,45,19,4,249,490,16,24,0,0
1641,1652,569,1909,1073,45,19,4,257,504,17,24,0,0
1642,1657,574,1907,1065,45,19,4,250,491,18,24,0,0
1643,1656,588,1900,1065,45,19,4,244,477,19,24,0,0
1644,1651,576,1900,1064,45,19,4,249,488,20,24,0,0
1645,1651,582,1897,1064,45,19,4,246,482,21,24,0,0
1646,1657,596,1896,1067,45,19,4,239,471,22,24,0,0
1647,1664,582,1908,1069,45,19,4,244,487,23,24,0,0
1648,1665,582,1909,1069,45,19,4,244,487,24,24,1,0
1650,1667,621,1891,1061,45,19,4,224,440,0,24,0,0
1651,1735,646,1920,1070,45,19,4,185,424,1,24,0,0
1652,1743,652,1920,1070,45,19,4,177,418,2,24,0,0
1629,1819,598,1919,1011,46,19,4,100,413,0,0,0,0
1832,731,214,789,344,47,19,4,58,130,0,0,0,0
1949,534,233,580,346,49,19,4,46,113,0,0,0,0
1955,418,354,458,452,50,19,4,40,98,0,0,0,0
1983,415,348,458,453,51,19,4,43,105,0,0,0,0
2038,419,351,461,452,52,19,4,42,101,0,0,0,0
2078,539,265,574,349,53,19,4,35,84,0,25,0,0
2080,540,264,575,348,53,19,4,35,84,0,25,0,0
2081,536,259,572,345,53,19,4,36,86,1,25,0,0
2082,534,258,571,343,53,19,4,37,85,2,25,0,0
2083,536,259,572,344,53,19,4,36,85,3,25,0,0
2084,537,260,574,346,53,19,4,37,86,4,25,0,0
2085,539,263,574,345,53,19,4,35,82,5,25,0,0
2086,539,263,574,345,53,19,4,35,82,6,25,0,0
2096,532,254,568,337,53,19,4,36,83,0,25,0,0
2097,533,255,568,340,53,19,4,35,85,1,25,0,0
2098,535,258,572,345,53,19,4,37,87,2,25,0,0
2099,536,257,575,346,53,19,4,39,89,3,25,0,0
2100,537,259,573,341,53,19,4,36,82,4,25,0,0
2101,537,261,574,344,53,19,4,37,83,5,25,0,0
2102,538,265,574,344,53,19,4,36,79,6,25,0,0
2103,537,262,575,346,53,19,4,38,84,7,25,0,0
2104,536,260,575,346,53,19,4,39,86,8,25,0,0
2105,536,262,573,346,53,19,4,37,84,9,25,0,0
2106,534,259,570,340,53,19,4,36,81,10,25,0,0
2107,534,257,569,338,53,19,4,35,81,11,25,0,0
2108,534,258,569,339,53,19,4,35,81,12,25,0,0
2109,534,260,569,341,53,19,4,35,81,13,25,0,0
2111,537,259,574,345,53,19,4,37,86,0,25,0,0
2113,542,272,577,351,53,19,4,35,79,0,25,0,0
2116,540,269,575,349,53,19,4,35,80,0,25,0,0
2118,535,246,576,342,53,19,4,41,96,0,25,0,0
2119,536,257,574,344,53,19,4,38,87,1,25,0,0
2120,533,238,577,342,53,19,4,44,104,2,25,0,0
2121,537,254,574,340,53,19,4,37,86,3,25,0,0
2126,537,261,574,340,53,19,4,37,79,0,25,0,0
2127,538,263,576,345,53,19,4,38,82,1,25,0,0
2128,536,260,575,343,53,19,4,39,83,2,25,0,0
2129,535,257,574,341,53,19,4,39,84,3,25,0,0
2130,535,256,573,340,53,19,4,38,84,4,25,0,0
2131,534,255,573,340,53,19,4,39,85,5,25,0,0
2132,534,254,574,342,53,19,4,40,88,6,25,0,0
2133,533,250,575,344,53,19,4,42,94,7,25,0,0
2134,534,253,575,346,53,19,4,41,93,8,25,0,0
2135,534,256,574,345,53,19,4,40,89,9,25,0,0
2136,536,261,574,347,53,19,4,38,86,10,25,0,0
2137,537,263,573,344,53,19,4,36,81,11,25,0,0
2141,537,264,572,343,53,19,4,35,79,0,25,0,0
2142,539,266,574,348,53,19,4,35,82,1,25,0,0
2143,539,267,574,349,53,19,4,35,82,2,25,0,0
2146,537,260,576,351,53,19,4,39,91,0,25,0,0
2147,537,259,577,351,53,19,4,40,92,1,25,0,0
2148,538,261,579,352,53,19,4,41,91,2,25,0,0
2149,538,261,578,351,53,19,4,40,90,3,25,0,0
2150,539,262,579,352,53,19,4,40,90,4,25,0,0
2151,540,264,579,351,53,19,4,39,87,5,25,0,0
2152,542,273,577,349,53,19,4,35,76,6,25,0,0
2153,537,262,578,349,53,19,4,41,87,7,25,0,0
2154,537,261,578,349,53,19,4,41,88,8,25,0,0
2156,536,258,576,346,53,19,4,40,88,0,25,0,0
2157,535,257,576,346,53,19,4,41,89,1,25,0,0
2159,535,256,574,343,53,19,4,39,87,0,25,0,0
2160,535,256,574,343,53,19,4,39,87,1,25,0,0
2161,537,263,573,342,53,19,4,36,79,2,25,0,0
2162,537,264,573,341,53,19,4,36,77,3,25,0,0
2163,538,264,575,344,53,19,4,37,80,4,25,0,0
2165,539,264,576,345,53,19,4,37,81,0,25,0,0
2166,538,263,577,348,53,19,4,39,85,1,25,0,0
2167,537,263,578,349,53,19,4,41,86,2,25,0,0
2168,538,265,578,350,53,19,4,40,85,3,25,0,0
2169,539,268,578,350,53,19,4,39,82,4,25,0,0
2170,537,265,575,346,53,19,4,38,81,5,25,0,0
2171,536,263,577,349,53,19,4,41,86,6,25,0,0
2172,535,258,578,350,53,19,4,43,92,7,25,0,0
2173,538,263,579,351,53,19,4,41,88,8,25,0,0
2174,535,259,574,344,53,19,4,39,85,9,25,0,0
2175,535,257,575,346,53,19,4,40,89,10,25,0,0
2176,537,265,573,343,53,19,4,36,78,11,25,0,0
2177,536,263,573,343,53,19,4,37,80,12,25,0,0
2178,537,263,574,342,53,19,4,37,79,13,25,0,0
2179,537,261,574,342,53,19,4,37,81,14,25,0,0
2180,537,261,574,343,53,19,4,37,82,15,25,0,0
2181,537,261,574,343,53,19,4,37,82,16,25,0,0
2183,536,256,575,345,53,19,4,39,89,0,25,0,0
2184,538,261,577,347,53,19,4,39,86,1,25,0,0
2185,538,261,578,348,53,19,4,40,87,2,25,0,0
2186,536,261,573,343,53,19,4,37,82,3,25,0,0
2187,537,262,574,345,53,19,4,37,83,4,25,0,0
2188,537,263,574,344,53,19,4,37,81,5,25,0,0
2189,537,263,574,344,53,19,4,37,81,6,25,0,0
2191,532,241,578,345,53,19,4,46,104,0,25,0,0
2192,532,239,578,345,53,19,4,46,106,1,25,0,0
2193,535,246,579,346,53,19,4,44,100,2,25,0,0
2194,534,238,578,341,53,19,4,44,103,3,25,0,0
2195,534,245,576,343,53,19,4,42,98,4,25,0,0
2196,534,244,576,342,53,19,4,42,98,5,25,0,0
2198,539,256,576,344,53,19,4,37,88,0,25,0,0
2200,536,241,579,344,53,19,4,43,103,0,25,0,0
2201,536,239,580,343,53,19,4,44,104,1,25,0,0
2202,539,252,577,340,53,19,4,38,88,2,25,0,0
2203,537,256,575,345,53,19,4,38,89,3,25,0,0
2204,535,251,575,344,53,19,4,40,93,4,25,0,0
2205,533,244,576,346,53,19,4,43,102,5,25,0,0
2206,532,243,576,346,53,19,4,44,103,6,25,0,0
2207,538,259,576,347,53,19,4,38,88,7,25,0,0
2208,538,259,576,347,53,19,4,38,88,8,25,0,0
2216,537,263,572,343,53,19,4,35,80,0,25,0,0
2217,537,261,573,343,53,19,4,36,82,1,25,0,0
2219,538,267,573,341,53,19,4,35,74,0,25,0,0
2221,538,269,574,348,53,19,4,36,79,0,25,0,0
2222,536,263,574,347,53,19,4,38,84,1,25,0,0
2223,536,262,576,349,53,19,4,40,87,2,25,0,0
2224,535,261,573,344,53,19,4,38,83,3,25,0,0
2225,534,257,572,341,53,19,4,38,84,4,25,0,0
2226,534,252,573,342,53,19,4,39,90,5,25,0,0
2227,533,250,574,342,53,19,4,41,92,6,25,0,0
2231,537,264,573,344,53,19,4,36,80,0,25,0,0
2232,539,270,574,346,53,19,4,35,76,1,25,0,0
2233,537,265,574,347,53,19,4,37,82,2,25,0,0
2235,538,263,577,347,53,19,4,39,84,0,25,0,0
2236,535,257,578,347,53,19,4,43,90,1,25,0,0
2237,533,249,577,347,53,19,4,44,98,2,25,0,0
2238,532,248,578,347,53,19,4,46,99,3,25,0,0
2247,535,249,580,347,53,19,4,45,98,0,25,0,0
2248,535,248,580,347,53,19,4,45,99,1,25,0,0
2249,536,252,578,346,53,19,4,42,94,2,25,0,0
2250,536,254,578,348,53,19,4,42,94,3,25,0,0
2251,536,257,577,348,53,19,4,41,91,4,25,0,0
2252,537,258,577,348,53,19,4,40,90,5,25,0,0
2253,539,265,577,348,53,19,4,38,83,6,25,0,0
2254,538,266,576,349,53,19,4,38,83,7,25,0,0
2255,535,252,577,345,53,19,4,42,93,8,25,0,0
2256,533,251,573,342,53,19,4,40,91,9,25,0,0
2257,532,250,571,340,53,19,4,39,90,10,25,0,0
2258,532,253,569,340,53,19,4,37,87,11,25,0,0
2259,531,252,569,339,53,19,4,38,87,12,25,0,0
2262,535,259,571,344,53,19,4,36,85,0,25,0,0
2263,536,259,573,344,53,19,4,37,85,1,25,0,0
2264,537,261,573,346,53,19,4,36,85,2,25,0,0
2265,538,262,574,345,53,19,4,36,83,3,25,0,0
2266,537,259,576,349,53,19,4,39,90,4,25,0,0
2267,537,259,577,349,53,19,4,40,90,5,25,0,0
2276,537,259,574,345,53,19,4,37,86,0,25,0,0
2277,542,265,577,346,53,19,4,35,81,1,25,0,0
2278,538,250,578,345,53,19,4,40,95,2,25,0,0
2279,542,263,578,346,53,19,4,36,83,3,25,0,0
2280,542,263,578,346,53,19,4,36,83,4,25,0,0
2281,539,263,576,349,53,19,4,37,86,5,25,0,0
2282,537,258,578,351,53,19,4,41,93,6,25,0,0
2283,536,261,576,350,53,19,4,40,89,7,25,0,0
2284,536,261,575,351,53,19,4,39,90,8,25,0,0
2286,537,260,577,351,53,19,4,40,91,0,25,0,0
2287,536,255,578,350,53,19,4,42,95,1,25,0,0
2288,537,259,577,350,53,19,4,40,91,2,25,0,0
2289,537,259,577,350,53,19,4,40,91,3,25,0,0
2290,537,259,576,350,53,19,4,39,91,4,25,0,0
2291,534,247,579,349,53,19,4,45,102,5,25,0,0
2292,538,257,578,349,53,19,4,40,92,6,25,0,0
2293,536,251,579,349,53,19,4,43,98,7,25,0,0
2294,536,250,580,349,53,19,4,44,99,8,25,0,0
2307,538,262,575,344,53,19,4,37,82,0,25,0,0
2308,537,257,576,345,53,19,4,39,88,1,25,0,0
2309,535,254,576,347,53,19,4,41,93,2,25,0,0
2310,537,260,575,347,53,19,4,38,87,3,25,0,0
2311,537,260,575,347,53,19,4,38,87,4,25,0,0
2313,537,259,577,349,53,19,4,40,90,0,25,0,0
2314,536,258,577,350,53,19,4,41,92,1,25,0,0
2315,538,259,579,349,53,19,4,41,90,2,25,0,0
2316,535,257,574,345,53,19,4,39,88,3,25,0,0
2317,535,257,574,345,53,19,4,39,88,4,25,0,0
2320,536,257,577,350,53,19,4,41,93,0,25,0,0
2321,540,270,576,349,53,19,4,36,79,1,25,0,0
2323,540,271,575,346,53,19,4,35,75,0,25,0,0
2324,537,264,576,348,53,19,4,39,84,1,25,0,0
2325,538,267,575,346,53,19,4,37,79,2,25,0,0
2326,537,260,575,346,53,19,4,38,86,3,25,0,0
2327,536,258,575,346,53,19,4,39,88,4,25,0,0
2328,536,260,574,344,53,19,4,38,84,5,25,0,0
2329,537,261,573,344,53,19,4,36,83,6,25,0,0
2330,536,261,574,345,53,19,4,38,84,7,25,0,0
2331,535,253,577,346,53,19,4,42,93,8,25,0,0
2332,536,248,579,346,53,19,4,43,98,9,25,0,0
2333,534,244,578,343,53,19,4,44,99,10,25,0,0
2334,535,251,576,345,53,19,4,41,94,11,25,0,0
2335,533,249,574,342,53,19,4,41,93,12,25,0,0
2336,533,248,574,342,53,19,4,41,94,13,25,0,0
2339,538,260,576,344,53,19,4,38,84,0,25,0,0
2340,538,255,579,348,53,19,4,41,93,1,25,0,0
2341,537,257,579,350,53,19,4,42,93,2,25,0,0
2342,536,256,579,350,53,19,4,43,94,3,25,0,0
2343,535,252,577,345,53,19,4,42,93,4,25,0,0
2344,536,254,578,346,53,19,4,42,92,5,25,0,0
2345,536,253,578,347,53,19,4,42,94,6,25,0,0
2348,538,264,576,348,53,19,4,38,84,0,25,0,0
2349,535,256,575,344,53,19,4,40,88,1,25,0,0
2350,535,255,575,344,53,19,4,40,89,2,25,0,0
2351,533,257,571,342,53,19,4,38,85,3,25,0,0
2352,537,262,574,346,53,19,4,37,84,4,25,0,0
2353,534,258,573,346,53,19,4,39,88,5,25,0,0
2354,535,259,574,347,53,19,4,39,88,6,25,0,0
2355,535,258,573,345,53,19,4,38,87,7,25,0,0
2358,535,242,578,340,53,19,4,43,98,0,25,0,0
2359,537,250,577,341,53,19,4,40,91,1,25,0,0
2361,540,264,578,348,53,19,4,38,84,0,25,0,0
2362,537,258,579,350,53,19,4,42,92,1,25,0,0
2363,540,263,580,351,53,19,4,40,88,2,25,0,0
2364,542,272,577,349,53,19,4,35,77,3,25,0,0
2365,542,272,578,349,53,19,4,36,77,4,25,0,0
2366,536,256,577,345,53,19,4,41,89,5,25,0,0
2367,535,255,577,347,53,19,4,42,92,6,25,0,0
2368,535,253,577,346,53,19,4,42,93,7,25,0,0
2369,534,257,572,342,53,19,4,38,85,8,25,0,0
2370,534,256,570,338,53,19,4,36,82,9,25,0,0
2374,540,269,575,346,53,19,4,35,77,0,25,0,0
2375,540,268,577,347,53,19,4,37,79,1,25,0,0
2376,539,264,577,348,53,19,4,38,84,2,25,0,0
2377,539,263,578,347,53,19,4,39,84,3,25,0,0
2378,538,261,579,349,53,19,4,41,88,4,25,0,0
2379,538,264,578,349,53,19,4,40,85,5,25,0,0
2380,538,266,578,350,53,19,4,40,84,6,25,0,0
2381,538,264,577,347,53,19,4,39,83,7,25,0,0
2382,537,262,577,346,53,19,4,40,84,8,25,0,0
2383,535,259,575,344,53,19,4,40,85,9,25,0,0
2384,534,256,577,348,53,19,4,43,92,10,25,0,0
2385,532,253,576,347,53,19,4,44,94,11,25,0,0
2386,535,258,576,346,53,19,4,41,88,12,25,0,0
2387,536,262,575,345,53,19,4,39,83,13,25,0,0
2388,536,262,575,345,53,19,4,39,83,14,25,0,0
2392,536,261,575,344,53,19,4,39,83,0,25,0,0
2393,535,260,574,343,53,19,4,39,83,1,25,0,0
2394,535,259,575,345,53,19,4,40,86,2,25,0,0
2395,535,260,578,350,53,19,4,43,90,3,25,0,0
2396,532,245,582,353,53,19,4,50,108,4,25,0,0
2397,531,242,582,353,53,19,4,51,111,5,25,0,0
2398,532,248,580,354,53,19,4,48,106,6,25,0,0
2399,532,247,580,355,53,19,4,48,108,7,25,0,0
2402,538,262,576,345,53,19,4,38,83,0,25,0,0
2403,537,259,577,345,53,19,4,40,86,1,25,0,0
2404,539,261,578,347,53,19,4,39,86,2,25,0,0
2405,539,261,578,348,53,19,4,39,87,3,25,0,0
2406,536,261,572,341,53,19,4,36,80,4,25,0,0
2410,535,257,572,342,53,19,4,37,85,0,25,0,0
2411,538,263,575,346,53,19,4,37,83,1,25,0,0
2412,540,266,576,346,53,19,4,36,80,2,25,0,0
2413,540,268,576,348,53,19,4,36,80,3,25,0,0
2414,537,259,577,346,53,19,4,40,87,4,25,0,0
2415,537,258,577,346,53,19,4,40,88,5,25,0,0
2416,534,256,573,342,53,19,4,39,86,6,25,0,0
2417,535,261,572,341,53,19,4,37,80,7,25,0,0
2418,535,261,570,340,53,19,4,35,79,8,25,0,0
2419,535,260,573,344,53,19,4,38,84,9,25,0,0
2420,535,258,573,344,53,19,4,38,86,10,25,0,0
2421,534,258,573,344,53,19,4,39,86,11,25,0,0
2425,538,264,576,346,53,19,4,38,82,0,25,0,0
2426,537,259,579,349,53,19,4,42,90,1,25,0,0
2427,536,255,580,350,53,19,4,44,95,2,25,0,0
2428,536,256,578,347,53,19,4,42,91,3,25,0,0
2429,534,250,578,345,53,19,4,44,95,4,25,0,0
2430,536,256,579,347,53,19,4,43,91,5,25,0,0
2431,536,255,579,347,53,19,4,43,92,6,25,0,0
2438,535,257,578,348,53,19,4,43,91,0,25,0,0
2439,531,239,580,348,53,19,4,49,109,1,25,0,0
2440,531,240,580,348,53,19,4,49,108,2,25,0,0
2441,531,238,580,349,53,19,4,49,111,3,25,0,0
2442,532,244,579,349,53,19,4,47,105,4,25,0,0
2443,532,243,579,349,53,19,4,47,106,5,25,0,0
2444,532,236,579,344,53,19,4,47,108,6,25,0,0
2445,531,234,579,344,53,19,4,48,110,7,25,0,0
2446,536,254,575,342,53,19,4,39,88,8,25,0,0
2447,536,254,575,343,53,19,4,39,89,9,25,0,0
2448,536,258,573,341,53,19,4,37,83,10,25,0,0
2449,536,261,572,342,53,19,4,36,81,11,25,0,0
2450,538,264,573,341,53,19,4,35,77,12,25,0,0
2453,538,265,573,342,53,19,4,35,77,0,25,0,0
2456,537,260,576,347,53,19,4,39,87,0,25,0,0
2457,535,257,577,349,53,19,4,42,92,1,25,0,0
2458,535,256,578,349,53,19,4,43,93,2,25,0,0
2459,535,256,577,349,53,19,4,42,93,3,25,0,0
2460,535,255,576,346,53,19,4,41,91,4,25,0,0
2461,536,252,579,348,53,19,4,43,96,5,25,0,0
2462,536,250,581,351,53,19,4,45,101,6,25,0,0
2463,535,251,579,349,53,19,4,44,98,7,25,0,0
2464,534,250,578,349,53,19,4,44,99,8,25,0,0
2465,535,255,575,347,53,19,4,40,92,9,25,0,0
2466,536,263,571,342,53,19,4,35,79,10,25,0,0
2481,538,258,578,348,53,19,4,40,90,0,25,0,0
2482,538,254,581,352,53,19,4,43,98,1,25,0,0
2483,538,253,581,352,53,19,4,43,99,2,25,0,0
2486,541,269,576,348,53,19,4,35,79,0,25,0,0
2487,541,269,576,348,53,19,4,35,79,1,25,0,0
2492,538,261,577,349,53,19,4,39,88,0,25,0,1
2493,538,262,577,348,53,19,4,39,86,1,25,0,0
2494,538,261,577,347,53,19,4,39,86,2,25,0,0
2495,538,260,574,341,53,19,4,36,81,3,25,0,0
2496,539,259,578,349,53,19,4,39,90,4,25,0,0
2497,537,255,580,351,53,19,4,43,96,5,25,0,0
2498,537,254,580,352,53,19,4,43,98,6,25,0,0
2499,539,265,577,350,53,19,4,38,85,7,25,0,0
2500,539,265,577,350,53,19,4,38,85,8,25,0,0
2501,536,252,575,342,53,19,4,39,90,9,25,0,0
2502,535,247,578,345,53,19,4,43,98,10,25,0,0
2503,535,245,578,343,53,19,4,43,98,11,25,0,0
2504,533,244,575,341,53,19,4,42,97,12,25,0,0
2505,537,252,576,344,53,19,4,39,92,13,25,0,0
2506,536,257,574,344,53,19,4,38,87,14,25,0,0
2507,535,257,575,346,53,19,4,40,89,15,25,0,0
2508,535,256,577,349,53,19,4,42,93,16,25,0,0
2509,535,255,578,350,53,19,4,43,95,17,25,0,0
2510,534,256,578,353,53,19,4,44,97,18,25,0,0
2511,534,258,576,350,53,19,4,42,92,19,25,0,0
2512,538,267,576,349,53,19,4,38,82,20,25,0,0
2513,539,268,576,347,53,19,4,37,79,21,25,0,0
2514,537,263,576,347,53,19,4,39,84,22,25,0,0
2515,537,260,577,347,53,19,4,40,87,23,25,0,0
2516,539,266,575,345,53,19,4,36,79,24,25,0,0
2517,539,266,575,345,53,19,4,36,79,25,25,1,0
2523,539,270,576,349,53,19,4,37,79,0,25,0,0
2524,539,271,577,349,53,19,4,38,78,1,25,0,0
2525,536,264,575,348,53,19,4,39,84,2,25,0,0
2527,536,265,573,344,53,19,4,37,79,0,25,0,0
2528,537,266,572,343,53,19,4,35,77,1,25,0,0
2529,536,265,572,343,53,19,4,36,78,2,25,0,0
2530,535,256,576,343,53,19,4,41,87,3,25,0,0
2531,537,262,578,348,53,19,4,41,86,4,25,0,0
2532,539,263,579,351,53,19,4,40,88,5,25,0,0
2533,539,269,576,349,53,19,4,37,80,6,25,0,0
2534,538,269,576,349,53,19,4,38,80,7,25,0,0
2535,537,268,574,347,53,19,4,37,79,8,25,0,0
2536,535,258,576,345,53,19,4,41,87,9,25,0,0
2537,534,256,576,344,53,19,4,42,88,10,25,0,0
2538,533,252,575,343,53,19,4,42,91,11,25,0,0
2539,534,252,576,343,53,19,4,42,91,12,25,0,0
2540,534,251,576,343,53,19,4,42,92,13,25,0,0
2541,536,260,573,341,53,19,4,37,81,14,25,0,0
2542,535,260,570,339,53,19,4,35,79,15,25,0,0
2543,537,262,572,339,53,19,4,35,77,16,25,0,0
2544,537,262,572,339,53,19,4,35,77,17,25,0,0
2546,535,251,576,343,53,19,4,41,92,0,25,0,0
2547,535,253,577,344,53,19,4,42,91,1,25,0,0
2548,534,252,575,342,53,19,4,41,90,2,25,0,0
2549,536,255,576,345,53,19,4,40,90,3,25,0,0
2550,532,233,581,343,53,19,4,49,110,4,25,0,0
2551,531,230,581,344,53,19,4,50,114,5,25,0,0
2556,534,253,576,347,53,19,4,42,94,0,25,0,0
2557,533,252,575,345,53,19,4,42,93,1,25,0,0
2558,532,249,572,343,53,19,4,40,94,2,25,0,0
2559,534,253,572,342,53,19,4,38,89,3,25,0,0
2560,534,254,573,343,53,19,4,39,89,4,25,0,0
2561,535,254,574,342,53,19,4,39,88,5,25,0,0
2562,536,257,574,344,53,19,4,38,87,6,25,0,0
2563,537,262,574,346,53,19,4,37,84,7,25,0,0
2564,538,263,576,348,53,19,4,38,85,8,25,0,0
2565,537,264,575,348,53,19,4,38,84,9,25,0,0
2566,538,266,575,348,53,19,4,37,82,10,25,0,0
2569,536,263,573,345,53,19,4,37,82,0,25,0,0
2570,532,241,580,347,53,19,4,48,106,1,25,0,0
2571,532,239,581,348,53,19,4,49,109,2,25,0,0
2591,535,251,579,349,53,19,4,44,98,0,25,0,0
2592,534,248,580,349,53,19,4,46,101,1,25,0,0
2597,537,256,576,343,53,19,4,39,87,0,25,0,0
2598,537,254,576,342,53,19,4,39,88,1,25,0,0
2601,536,255,576,342,53,19,4,40,87,0,25,0,0
2602,536,256,575,343,53,19,4,39,87,1,25,0,0
2603,538,260,576,343,53,19,4,38,83,2,25,0,0
2604,540,263,578,346,53,19,4,38,83,3,25,0,0
2605,537,255,577,343,53,19,4,40,88,4,25,0,0
2606,538,265,576,347,53,19,4,38,82,5,25,0,0
2607,534,254,577,346,53,19,4,43,92,6,25,0,0
2608,536,260,576,348,53,19,4,40,88,7,25,0,0
2609,538,267,576,350,53,19,4,38,83,8,25,0,0
2610,538,269,577,352,53,19,4,39,83,9,25,0,0
2611,540,270,578,350,53,19,4,38,80,10,25,0,0
2612,540,271,578,350,53,19,4,38,79,11,25,0,0
2613,537,263,577,347,53,19,4,40,84,12,25,0,0
2614,538,264,576,345,53,19,4,38,81,13,25,0,0
2615,533,251,575,341,53,19,4,42,90,14,25,0,0
2616,533,249,575,340,53,19,4,42,91,15,25,0,0
2620,538,261,576,346,53,19,4,38,85,0,25,0,0
2621,534,249,580,348,53,19,4,46,99,1,25,0,0
2622,534,252,577,348,53,19,4,43,96,2,25,0,0
2623,536,259,577,347,53,19,4,41,88,3,25,0,0
2624,536,254,577,345,53,19,4,41,91,4,25,0,0
2637,530,237,579,349,53,19,4,49,112,0,25,0,0
2638,529,234,580,350,53,19,4,51,116,1,25,0,0
2643,534,251,573,341,53,19,4,39,90,0,25,0,0
2644,533,250,572,341,53,19,4,39,91,1,25,0,0
2645,535,250,576,344,53,19,4,41,94,2,25,0,0
2646,539,263,577,350,53,19,4,38,87,3,25,0,0
2647,539,263,578,350,53,19,4,39,87,4,25,0,0
2648,539,264,578,351,53,19,4,39,87,5,25,0,0
2649,540,266,578,352,53,19,4,38,86,6,25,0,0
2650,539,265,576,348,53,19,4,37,83,7,25,0,0
2651,541,272,576,349,53,19,4,35,77,8,25,0,0
2653,538,269,575,348,53,19,4,37,79,0,25,0,0
2654,539,271,576,350,53,19,4,37,79,1,25,0,0
2655,540,272,576,349,53,19,4,36,77,2,25,0,0
2656,540,273,576,350,53,19,4,36,77,3,25,0,0
2658,541,272,577,348,53,19,4,36,76,0,25,0,0
2661,539,268,574,343,53,19,4,35,75,0,25,0,0
2662,537,265,574,343,53,19,4,37,78,1,25,0,0
2663,536,263,574,343,53,19,4,38,80,2,25,0,0
2664,537,263,574,343,53,19,4,37,80,3,25,0,0
2665,537,264,575,344,53,19,4,38,80,4,25,0,0
2666,537,263,575,344,53,19,4,38,81,5,25,0,0
2667,536,263,576,347,53,19,4,40,84,6,25,0,0
2668,536,263,576,348,53,19,4,40,85,7,25,0,0
2672,533,248,580,348,53,19,4,47,100,0,25,0,0
2673,535,256,577,346,53,19,4,42,90,1,25,0,0
2674,534,255,577,346,53,19,4,43,91,2,25,0,0
2676,536,256,577,344,53,19,4,41,88,0,25,0,0
2677,538,261,578,346,53,19,4,40,85,1,25,0,0
2678,540,270,577,349,53,19,4,37,79,2,25,0,0
2679,537,265,579,351,53,19,4,42,86,3,25,0,0
2680,537,261,579,350,53,19,4,42,89,4,25,0,0
2681,537,261,579,350,53,19,4,42,89,5,25,0,0
2683,533,249,577,342,53,19,4,44,93,0,25,0,0
2684,533,247,577,342,53,19,4,44,95,1,25,0,0
2685,537,259,578,348,53,19,4,41,89,2,25,0,0
2686,534,249,574,339,53,19,4,40,90,3,25,0,0
2687,533,248,574,338,53,19,4,41,90,4,25,0,0
2688,533,240,578,341,53,19,4,45,101,5,25,0,0
2689,533,240,578,340,53,19,4,45,100,6,25,0,0
2690,536,251,577,341,53,19,4,41,90,7,25,0,0
2691,532,233,581,344,53,19,4,49,111,8,25,0,0
2692,533,243,579,347,53,19,4,46,104,9,25,0,0
2693,533,242,579,348,53,19,4,46,106,10,25,0,0
2695,532,213,585,335,53,19,4,53,122,0,25,0,0
2696,535,242,578,340,53,19,4,43,98,1,25,0,0
2697,537,257,575,342,53,19,4,38,85,2,25,0,0
2698,532,228,581,341,53,19,4,49,113,3,25,0,0
2699,531,225,582,341,53,19,4,51,116,4,25,0,0
2705,533,228,582,339,53,19,4,49,111,0,25,0,0
2706,535,251,576,347,53,19,4,41,96,1,25,0,0
2707,535,257,575,350,53,19,4,40,93,2,25,0,0
2708,536,258,574,350,53,19,4,38,92,3,25,0,0
2709,535,255,575,350,53,19,4,40,95,4,25,0,0
2710,535,256,575,350,53,19,4,40,94,5,25,0,0
2711,536,243,580,346,53,19,4,44,103,6,25,0,0
2712,536,242,580,346,53,19,4,44,104,7,25,0,0
2720,541,261,576,340,53,19,4,35,79,0,25,0,0
2721,541,262,576,339,53,19,4,35,77,1,25,0,0
2723,538,267,578,354,53,19,4,40,87,0,25,0,0
2724,538,269,578,355,53,19,4,40,86,1,25,0,0
2726,533,248,579,351,53,19,4,46,103,0,25,0,0
2727,532,246,579,351,53,19,4,47,105,1,25,0,0
2728,533,251,574,346,53,19,4,41,95,2,25,0,0
2729,532,251,574,346,53,19,4,42,95,3,25,0,0
2733,534,255,574,345,53,19,4,40,90,0,25,0,0
2734,534,255,574,345,53,19,4,40,90,1,25,0,0
2736,537,256,577,346,53,19,4,40,90,0,25,0,0
2737,537,259,575,345,53,19,4,38,86,1,25,0,0
2738,536,254,576,344,53,19,4,40,90,2,25,0,0
2739,540,262,575,340,53,19,4,35,78,3,25,0,0
2741,536,258,575,346,53,19,4,39,88,0,25,0,0
2742,536,256,576,347,53,19,4,40,91,1,25,0,0
2743,535,254,576,347,53,19,4,41,93,2,25,0,0
2744,534,251,575,346,53,19,4,41,95,3,25,0,0
2745,535,253,575,345,53,19,4,40,92,4,25,0,0
2746,535,253,575,345,53,19,4,40,92,5,25,0,0
2747,535,253,575,344,53,19,4,40,91,6,25,0,0
2748,536,259,574,345,53,19,4,38,86,7,25,0,0
2749,537,261,574,345,53,19,4,37,84,8,25,0,0
2750,537,261,574,346,53,19,4,37,85,9,25,0,0
2757,536,264,573,347,53,19,4,37,83,0,25,0,0
2759,536,259,574,347,53,19,4,38,88,0,25,0,0
2760,537,261,573,345,53,19,4,36,84,1,25,0,0
2761,538,261,576,349,53,19,4,38,88,2,25,0,0
2762,538,262,576,347,53,19,4,38,85,3,25,0,0
2763,538,264,576,348,53,19,4,38,84,4,25,0,0
2764,539,265,576,348,53,19,4,37,83,5,25,0,0
2765,540,270,579,353,53,19,4,39,83,6,25,0,0
2766,541,271,579,354,53,19,4,38,83,7,25,0,0
2767,538,263,578,350,53,19,4,40,87,8,25,0,0
2768,539,266,576,348,53,19,4,37,82,9,25,0,0
2769,539,266,577,348,53,19,4,38,82,10,25,0,0
2770,538,263,577,348,53,19,4,39,85,11,25,0,0
2771,535,257,576,349,53,19,4,41,92,12,25,0,0
2772,534,256,576,349,53,19,4,42,93,13,25,0,0
2784,534,249,581,355,53,19,4,47,106,0,25,0,0
2785,534,249,581,356,53,19,4,47,107,1,25,0,0
2791,531,229,581,344,53,19,4,50,115,0,25,0,0
2792,530,227,581,344,53,19,4,51,117,1,25,0,0
2793,533,236,578,347,53,19,4,45,111,2,25,0,0
2794,540,255,577,342,53,19,4,37,87,3,25,0,0
2796,539,263,577,350,53,19,4,38,87,0,25,0,0
2797,539,264,577,350,53,19,4,38,86,1,25,0,0
2800,536,258,575,346,53,19,4,39,88,0,25,0,0
2801,536,257,575,346,53,19,4,39,89,1,25,0,0
2804,538,253,579,345,53,19,4,41,92,0,25,0,0
2805,536,251,576,340,53,19,4,40,89,1,25,0,0
2806,536,250,576,339,53,19,4,40,89,2,25,0,0
2811,536,257,573,341,53,19,4,37,84,0,25,0,0
2812,536,257,573,341,53,19,4,37,84,1,25,0,0
2813,535,258,573,344,53,19,4,38,86,2,25,0,0
2814,536,261,572,343,53,19,4,36,82,3,25,0,0
2816,537,259,575,346,53,19,4,38,87,0,25,0,0
2817,537,260,576,347,53,19,4,39,87,1,25,0,0
2818,537,260,576,347,53,19,4,39,87,2,25,0,0
2819,538,260,577,348,53,19,4,39,88,3,25,0,0
2820,536,251,580,350,53,19,4,44,99,4,25,0,0
2821,536,250,580,351,53,19,4,44,101,5,25,0,0
2822,532,229,583,346,53,19,4,51,117,6,25,0,0
2823,532,227,583,346,53,19,4,51,119,7,25,0,0
2825,529,215,584,346,53,19,4,55,131,0,25,0,0
2826,529,212,585,346,53,19,4,56,134,1,25,0,0
2836,533,254,569,341,53,19,4,36,87,0,25,0,0
2837,533,255,572,348,53,19,4,39,93,1,25,0,0
2838,536,258,573,348,53,19,4,37,90,2,25,0,0
2839,538,265,574,351,53,19,4,36,86,3,25,0,0
2840,539,265,575,351,53,19,4,36,86,4,25,0,0
2841,538,259,577,353,53,19,4,39,94,5,25,0,0
2842,537,252,579,352,53,19,4,42,100,6,25,0,0
2843,537,252,580,353,53,19,4,43,101,7,25,0,0
2844,538,262,575,347,53,19,4,37,85,8,25,0,0
2848,536,257,571,337,53,19,4,35,80,0,25,0,0
2849,536,255,572,340,53,19,4,36,85,1,25,0,0
2850,536,255,575,345,53,19,4,39,90,2,25,0,0
2851,539,266,574,346,53,19,4,35,80,3,25,0,0
2856,539,268,575,344,53,19,4,36,76,0,25,0,0
2857,539,267,576,346,53,19,4,37,79,1,25,0,0
2858,538,266,576,346,53,19,4,38,80,2,25,0,0
2859,538,264,577,346,53,19,4,39,82,3,25,0,0
2860,538,265,577,346,53,19,4,39,81,4,25,0,0
2861,540,271,576,347,53,19,4,36,76,5,25,0,0
2862,541,275,576,348,53,19,4,35,73,6,25,0,0
2863,541,275,576,348,53,19,4,35,73,7,25,0,0
2875,538,255,580,343,53,19,4,42,88,0,25,0,0
2876,533,241,580,346,53,19,4,47,105,1,25,0,0
2877,532,239,581,346,53,19,4,49,107,2,25,0,0
2885,535,249,576,340,53,19,4,41,91,0,25,0,0
2886,535,249,576,340,53,19,4,41,91,1,25,0,0
2888,531,241,578,350,53,19,4,47,109,0,25,0,0
2889,530,240,578,351,53,19,4,48,111,1,25,0,0
2891,534,252,581,358,53,19,4,47,106,0,25,0,0
2892,533,250,579,355,53,19,4,46,105,1,25,0,0
2893,534,254,577,354,53,19,4,43,100,2,25,0,0
2894,534,255,577,355,53,19,4,43,100,3,25,0,0
2896,535,254,576,349,53,19,4,41,95,0,25,0,0
2897,535,254,576,349,53,19,4,41,95,1,25,0,0
2899,537,256,578,351,53,19,4,41,95,0,25,0,0
2900,537,257,577,349,53,19,4,40,92,1,25,0,0
2901,534,243,576,342,53,19,4,42,99,2,25,0,0
2902,535,249,574,341,53,19,4,39,92,3,25,0,0
2903,535,248,574,339,53,19,4,39,91,4,25,0,0
2904,536,254,573,338,53,19,4,37,84,5,25,0,0
2905,539,259,574,340,53,19,4,35,81,6,25,0,0
2906,536,257,571,337,53,19,4,35,80,7,25,0,0
2907,537,260,573,343,53,19,4,36,83,8,25,0,0
2908,537,260,573,343,53,19,4,36,83,9,25,0,0
2911,536,261,573,347,53,19,4,37,86,0,25,0,0
2912,536,261,573,347,53,19,4,37,86,1,25,0,0
2916,538,259,575,345,53,19,4,37,86,0,25,0,0
2917,537,257,577,346,53,19,4,40,89,1,25,0,0
2918,537,257,577,348,53,19,4,40,91,2,25,0,0
2919,537,254,576,343,53,19,4,39,89,3,25,0,0
2921,533,233,579,340,53,19,4,46,107,0,25,0,0
2922,535,246,575,341,53,19,4,40,95,1,25,0,0
2923,535,244,576,341,53,19,4,41,97,2,25,0,0
2929,536,220,585,339,53,19,4,49,119,0,25,0,0
2930,539,252,579,347,53,19,4,40,95,1,25,0,0
2931,539,252,580,348,53,19,4,41,96,2,25,0,0
2940,531,211,587,348,53,19,4,56,137,0,25,0,0
2941,530,208,587,348,53,19,4,57,140,1,25,0,0
2948,540,254,579,346,53,19,4,39,92,0,25,0,0
2949,541,256,578,346,53,19,4,37,90,1,25,0,0
2950,539,257,577,343,53,19,4,38,86,2,25,0,0
2951,536,258,576,348,53,19,4,40,90,3,25,0,0
2952,540,271,575,348,53,19,4,35,77,4,25,0,0
2960,536,252,574,337,53,19,4,38,85,0,25,0,0
2961,535,252,574,337,53,19,4,39,85,1,25,0,0
2962,535,250,576,341,53,19,4,41,91,2,25,0,0
2963,538,257,577,344,53,19,4,39,87,3,25,0,0
2965,539,263,575,342,53,19,4,36,79,0,25,0,0
2966,535,254,576,346,53,19,4,41,92,1,25,0,0
2967,534,251,577,349,53,19,4,43,98,2,25,0,0
2968,534,245,579,349,53,19,4,45,104,3,25,0,0
2969,531,220,587,349,53,19,4,56,129,4,25,0,0
2970,534,236,584,350,53,19,4,50,114,5,25,0,0
2971,539,255,580,348,53,19,4,41,93,6,25,0,0
2972,540,261,578,348,53,19,4,38,87,7,25,0,0
2973,541,267,577,348,53,19,4,36,81,8,25,0,0
2974,541,269,576,348,53,19,4,35,79,9,25,0,0
2976,538,261,576,347,53,19,4,38,86,0,25,0,0
2977,537,260,576,347,53,19,4,39,87,1,25,0,0
2978,537,261,574,346,53,19,4,37,85,2,25,0,0
2979,536,257,575,346,53,19,4,39,89,3,25,0,0
2980,537,260,575,346,53,19,4,38,86,4,25,0,0
2981,537,259,575,346,53,19,4,38,87,5,25,0,0
2984,535,251,577,348,53,19,4,42,97,0,25,0,0
2985,537,252,581,351,53,19,4,44,99,1,25,0,0
2986,535,253,578,351,53,19,4,43,98,2,25,0,0
2987,536,255,579,354,53,19,4,43,99,3,25,0,0
2988,533,242,582,354,53,19,4,49,112,4,25,0,0
2989,533,240,582,354,53,19,4,49,114,5,25,0,0
2990,534,250,575,346,53,19,4,41,96,6,25,0,0
2991,536,257,574,344,53,19,4,38,87,7,25,0,0
2992,537,260,574,344,53,19,4,37,84,8,25,0,0
2993,537,260,572,342,53,19,4,35,82,9,25,0,0
2994,535,257,571,341,53,19,4,36,84,10,25,0,0
2995,535,256,571,340,53,19,4,36,84,11,25,0,0
2999,535,255,577,352,53,19,4,42,97,0,25,0,0
3000,535,254,577,353,53,19,4,42,99,1,25,0,0
3001,536,254,577,352,53,19,4,41,98,2,25,0,0
3002,535,255,578,355,53,19,4,43,100,3,25,0,0
3003,535,255,579,356,53,19,4,44,101,4,25,0,0
3010,535,249,579,349,53,19,4,44,100,0,25,0,0
3011,535,248,579,349,53,19,4,44,101,1,25,0,0
2075,1773,456,1920,1080,54,19,4,147,624,0,29,0,1
2076,1734,462,1879,1070,54,19,4,145,608,1,29,0,0
2077,1720,462,1868,1068,54,19,4,148,606,2,29,0,0
2078,1723,464,1874,1074,54,19,4,151,610,3,29,0,0
2079,1723,465,1876,1069,54,19,4,153,604,4,29,0,0
2080,1738,467,1895,1076,54,19,4,157,609,5,29,0,0
2081,1736,471,1894,1076,54,19,4,158,605,6,29,0,0
2082,1730,473,1892,1075,54,19,4,162,602,7,29,0,0
2083,1722,466,1891,1077,54,19,4,169,611,8,29,0,0
2084,1711,461,1886,1076,54,19,4,175,615,9,29,0,0
2085,1706,460,1886,1076,54,19,4,180,616,10,29,0,0
2086,1704,465,1886,1077,54,19,4,182,612,11,29,0,0
2087,1687,468,1875,1073,54,19,4,188,605,12,29,0,0
2088,1692,469,1882,1071,54,19,4,190,602,13,29,0,0
2089,1691,469,1885,1071,54,19,4,194,602,14,29,0,0
2090,1689,470,1887,1070,54,19,4,198,600,15,29,0,0
2091,1684,467,1887,1071,54,19,4,203,604,16,29,0,0
2092,1686,469,1890,1072,54,19,4,204,603,17,29,0,0
2093,1684,466,1892,1070,54,19,4,208,604,18,29,0,0
2094,1681,466,1892,1070,54,19,4,211,604,19,29,0,0
2095,1682,467,1896,1069,54,19,4,214,602,20,29,0,0
2096,1681,467,1897,1071,54,19,4,216,604,21,29,0,0
2097,1681,468,1898,1071,54,19,4,217,603,22,29,0,0
2098,1682,469,1901,1074,54,19,4,219,605,23,29,0,0
2099,1684,469,1904,1074,54,19,4,220,605,24,29,0,0
2100,1681,471,1903,1071,54,19,4,222,600,25,29,0,0
2101,1677,467,1901,1070,54,19,4,224,603,26,29,0,0
2102,1682,474,1906,1073,54,19,4,224,599,27,29,0,0
2103,1687,480,1909,1071,54,19,4,222,591,28,29,0,0
2104,1688,482,1909,1071,54,19,4,221,589,29,29,1,0
2108,418,352,459,453,55,19,4,41,101,0,1,0,0
2109,418,352,459,453,55,19,4,41,101,1,1,0,0
2115,533,197,586,356,57,19,4,53,159,0,0,0,0
2121,421,354,461,452,58,19,4,40,98,0,4,0,0
2122,419,353,460,452,58,19,4,41,99,1,4,0,0
2123,420,354,460,452,58,19,4,40,98,2,4,0,0
2124,420,353,460,452,58,19,4,40,99,3,4,0,0
2125,419,353,460,452,58,19,4,41,99,4,4,0,0
2134,416,354,456,450,58,19,4,40,96,0,4,0,0
2135,416,355,456,449,58,19,4,40,94,1,4,0,0
2145,536,228,583,343,59,19,4,47,115,0,0,0,0
2192,727,212,787,340,60,19,4,60,128,0,0,0,0
2195,421,342,462,452,61,19,4,41,110,0,0,0,0
2225,418,348,458,450,62,19,4,40,102,0,0,0,0
2226,735,229,778,342,63,19,4,43,113,0,1,0,0
2227,735,227,778,342,63,19,4,43,115,1,1,0,0
2370,418,350,461,453,65,19,4,43,103,0,0,0,0
2452,419,353,461,451,69,19,4,42,98,0,0,0,0
2521,536,257,576,352,70,19,4,40,95,0,0,0,0
2536,745,218,795,330,71,19,4,50,112,0,3,0,0
2537,742,218,791,328,71,19,4,49,110,1,3,0,0
2538,742,218,791,330,71,19,4,49,112,2,3,0,0
2539,741,219,791,330,71,19,4,50,111,3,3,0,0
2631,534,246,578,349,74,19,4,44,103,0,3,0,0
2632,534,244,578,349,74,19,4,44,105,1,3,0,0
2633,533,242,579,349,74,19,4,46,107,2,3,0,0
2634,533,241,579,349,74,19,4,46,108,3,3,0,0
2874,534,232,577,338,79,19,4,43,106,0,0,0,0
2913,534,220,581,344,80,19,4,47,124,0,1,0,0
2914,533,213,581,343,80,19,4,48,130,1,1,0,0
2958,538,248,577,345,83,19,4,39,97,0,0,0,0
3017,536,232,578,341,85,19,4,42,109,0,1,0,0
3018,535,236,577,344,85,19,4,42,108,1,1,0,0
3034,534,258,575,341,86,19,4,41,83,0,1,0,0
3035,533,259,575,344,86,19,4,42,85,1,1,0,0
3037,536,242,579,349,87,19,4,43,107,0,30,0,0
3038,537,250,575,344,87,19,4,38,94,1,30,0,0
3039,536,243,577,346,87,19,4,41,103,2,30,0,0
3040,536,250,576,349,87,19,4,40,99,3,30,0,0
3041,537,252,576,350,87,19,4,39,98,4,30,0,0
3046,529,201,589,351,87,19,4,60,150,0,30,0,0
3047,531,204,589,351,87,19,4,58,147,1,30,0,0
3048,529,196,590,351,87,19,4,61,155,2,30,0,0
3049,531,217,582,349,87,19,4,51,132,3,30,0,0
3050,532,215,585,351,87,19,4,53,136,4,30,0,0
3051,532,212,586,351,87,19,4,54,139,5,30,0,0
3067,530,215,580,348,87,19,4,50,133,0,30,0,0
3068,530,215,580,348,87,19,4,50,133,1,30,0,0
3071,534,237,576,346,87,19,4,42,109,0,30,0,1
3072,534,239,575,345,87,19,4,41,106,1,30,0,0
3073,535,244,575,345,87,19,4,40,101,2,30,0,0
3074,533,218,583,347,87,19,4,50,129,3,30,0,0
3075,533,216,584,347,87,19,4,51,131,4,30,0,0
3076,535,223,585,348,87,19,4,50,125,5,30,0,0
3077,535,214,587,345,87,19,4,52,131,6,30,0,0
3078,534,203,590,344,87,19,4,56,141,7,30,0,0
3079,531,199,589,345,87,19,4,58,146,8,30,0,0
3080,531,200,589,347,87,19,4,58,147,9,30,0,0
3081,532,219,582,347,87,19,4,50,128,10,30,0,0
3082,533,230,580,347,87,19,4,47,117,11,30,0,0
3083,534,235,579,348,87,19,4,45,113,12,30,0,0
3084,533,239,576,346,87,19,4,43,107,13,30,0,0
3085,532,227,579,346,87,19,4,47,119,14,30,0,0
3086,532,227,579,346,87,19,4,47,119,15,30,0,0
3087,536,254,574,349,87,19,4,38,95,16,30,0,0
3088,535,259,576,363,87,19,4,41,104,17,30,0,0
3089,536,258,574,353,87,19,4,38,95,18,30,0,0
3090,535,257,574,355,87,19,4,39,98,19,30,0,0
3091,534,245,575,346,87,19,4,41,101,20,30,0,0
3092,537,251,573,342,87,19,4,36,91,21,30,0,0
3093,537,251,573,341,87,19,4,36,90,22,30,0,0
3094,536,247,574,342,87,19,4,38,95,23,30,0,0
3095,536,247,574,341,87,19,4,38,94,24,30,0,0
3096,534,247,573,343,87,19,4,39,96,25,30,0,0
3097,534,252,571,342,87,19,4,37,90,26,30,0,0
3098,535,250,573,344,87,19,4,38,94,27,30,0,0
3099,535,253,573,346,87,19,4,38,93,28,30,0,0
3100,538,255,576,348,87,19,4,38,93,29,30,0,0
3101,538,256,576,348,87,19,4,38,92,30,30,1,0
3108,543,264,578,349,87,19,4,35,85,0,30,0,0
3111,540,267,575,347,87,19,4,35,80,0,30,0,0
3112,537,261,575,351,87,19,4,38,90,1,30,0,0
3113,536,259,576,351,87,19,4,40,92,2,30,0,0
3114,536,257,576,350,87,19,4,40,93,3,30,0,0
3115,536,258,576,349,87,19,4,40,91,4,30,0,0
3116,536,258,576,349,87,19,4,40,91,5,30,0,0
3117,537,258,576,348,87,19,4,39,90,6,30,0,0
3118,533,236,580,348,87,19,4,47,112,7,30,0,0
3119,538,251,579,347,87,19,4,41,96,8,30,0,0
3121,536,225,587,348,87,19,4,51,123,0,30,0,0
3122,535,228,585,350,87,19,4,50,122,1,30,0,0
3123,535,238,583,355,87,19,4,48,117,2,30,0,0
3124,535,235,584,355,87,19,4,49,120,3,30,0,0
3129,536,250,579,354,87,19,4,43,104,0,30,0,0
3130,535,249,578,354,87,19,4,43,105,1,30,0,0
3131,535,253,577,354,87,19,4,42,101,2,30,0,0
3132,533,248,577,355,87,19,4,44,107,3,30,0,0
3133,533,251,576,354,87,19,4,43,103,4,30,0,0
3134,534,246,578,350,87,19,4,44,104,5,30,0,0
3135,539,259,578,350,87,19,4,39,91,6,30,0,0
3136,540,259,578,349,87,19,4,38,90,7,30,0,0
3141,535,234,581,344,87,19,4,46,110,0,30,0,0
3142,535,234,580,343,87,19,4,45,109,1,30,0,0
3143,534,232,580,343,87,19,4,46,111,2,30,0,0
3164,531,209,583,341,87,19,4,52,132,0,30,0,0
3165,531,208,583,341,87,19,4,52,133,1,30,0,0
3167,530,203,586,350,87,19,4,56,147,0,30,0,0
3168,529,202,587,351,87,19,4,58,149,1,30,0,0
3170,538,246,585,369,87,19,4,47,123,0,30,0,0
3171,538,249,585,371,87,19,4,47,122,1,30,0,0
3172,538,252,576,350,87,19,4,38,98,2,30,0,0
3173,541,251,579,348,87,19,4,38,97,3,30,0,0
3174,541,253,578,347,87,19,4,37,94,4,30,0,0
3176,538,249,574,338,87,19,4,36,89,0,30,0,0
3181,535,237,577,343,87,19,4,42,106,0,30,0,0
3182,535,236,577,342,87,19,4,42,106,1,30,0,0
3186,534,238,579,350,87,19,4,45,112,0,30,0,1
3187,536,251,576,350,87,19,4,40,99,1,30,0,0
3188,535,234,581,348,87,19,4,46,114,2,30,0,0
3189,535,232,581,348,87,19,4,46,116,3,30,0,0
3190,535,229,581,344,87,19,4,46,115,4,30,0,0
3191,537,247,575,342,87,19,4,38,95,5,30,0,0
3192,538,253,574,343,87,19,4,36,90,6,30,0,0
3193,536,251,575,345,87,19,4,39,94,7,30,0,0
3194,540,258,577,346,87,19,4,37,88,8,30,0,0
3195,541,260,577,346,87,19,4,36,86,9,30,0,0
3196,535,248,576,348,87,19,4,41,100,10,30,0,0
3197,536,252,578,352,87,19,4,42,100,11,30,0,0
3198,535,252,578,353,87,19,4,43,101,12,30,0,0
3199,534,247,576,346,87,19,4,42,99,13,30,0,0
3200,532,240,576,346,87,19,4,44,106,14,30,0,0
3201,536,251,574,345,87,19,4,38,94,15,30,0,0
3202,535,252,574,344,87,19,4,39,92,16,30,0,0
3203,537,258,573,344,87,19,4,36,86,17,30,0,0
3204,537,257,574,347,87,19,4,37,90,18,30,0,0
3205,536,254,576,350,87,19,4,40,96,19,30,0,0
3206,533,245,577,354,87,19,4,44,109,20,30,0,0
3207,533,248,576,356,87,19,4,43,108,21,30,0,0
3208,532,248,577,357,87,19,4,45,109,22,30,0,0
3210,529,224,580,351,87,19,4,51,127,0,30,0,0
3211,534,240,578,351,87,19,4,44,111,1,30,0,0
3212,536,251,574,347,87,19,4,38,96,2,30,0,0
3213,540,257,577,350,87,19,4,37,93,3,30,0,0
3214,541,258,578,350,87,19,4,37,92,4,30,0,0
3215,541,257,579,351,87,19,4,38,94,5,30,0,0
3216,539,248,580,350,87,19,4,41,102,6,30,0,0
3217,539,247,581,350,87,19,4,42,103,7,30,0,0
3218,536,247,577,350,87,19,4,41,103,8,30,0,0
3219,537,249,579,353,87,19,4,42,104,9,30,0,0
3220,535,243,578,351,87,19,4,43,108,10,30,0,0
3221,535,247,574,343,87,19,4,39,96,11,30,0,0
3222,535,249,572,340,87,19,4,37,91,12,30,0,0
3225,537,252,575,348,87,19,4,38,96,0,30,0,0
3226,535,237,578,342,87,19,4,43,105,1,30,0,0
3227,534,223,584,348,87,19,4,50,125,2,30,0,0
3228,533,220,583,345,87,19,4,50,125,3,30,0,0
3229,532,217,584,345,87,19,4,52,128,4,30,0,0
3231,534,220,584,344,87,19,4,50,124,0,30,0,0
3232,532,218,583,343,87,19,4,51,125,1,30,0,0
3233,532,215,583,343,87,19,4,51,128,2,30,0,0
3236,534,241,581,356,87,19,4,47,115,0,30,0,0
3237,534,246,580,362,87,19,4,46,116,1,30,0,0
3238,534,246,581,366,87,19,4,47,120,2,30,0,0
3239,534,247,582,367,87,19,4,48,120,3,30,0,0
3240,537,248,581,358,87,19,4,44,110,4,30,0,0
3241,538,249,581,358,87,19,4,43,109,5,30,0,0
3242,538,247,582,356,87,19,4,44,109,6,30,0,0
3243,539,248,582,356,87,19,4,43,108,7,30,0,0
3245,542,262,578,351,87,19,4,36,89,0,30,0,0
3246,538,259,575,349,87,19,4,37,90,1,30,0,0
3247,537,256,575,348,87,19,4,38,92,2,30,0,0
3248,537,256,574,347,87,19,4,37,91,3,30,0,0
3249,539,257,574,342,87,19,4,35,85,4,30,0,0
3261,531,219,583,348,87,19,4,52,129,0,30,0,0
3262,531,213,585,350,87,19,4,54,137,1,30,0,0
3263,531,212,586,351,87,19,4,55,139,2,30,0,0
3264,533,235,578,352,87,19,4,45,117,3,30,0,0
3265,533,233,579,352,87,19,4,46,119,4,30,0,0
3266,535,241,576,345,87,19,4,41,104,5,30,0,0
3267,536,249,575,347,87,19,4,39,98,6,30,0,0
3268,536,248,575,347,87,19,4,39,99,7,30,0,0
3102,536,221,584,342,90,19,4,48,121,0,0,0,0
3126,537,260,575,342,91,19,4,38,82,0,0,0,0
3178,537,223,580,348,93,19,4,43,125,0,0,0,0
3254,1658,106,1718,311,94,19,4,60,205,0,0,0,0
3305,537,255,579,351,96,19,4,42,96,0,12,0,0
3306,534,248,579,353,96,19,4,45,105,1,12,0,0
3307,534,235,582,345,96,19,4,48,110,2,12,0,0
3308,537,249,578,343,96,19,4,41,94,3,12,0,0
3309,538,257,577,345,96,19,4,39,88,4,12,0,0
3310,536,241,584,351,96,19,4,48,110,5,12,0,0
3311,536,238,585,352,96,19,4,49,114,6,12,0,0
3313,536,252,579,349,96,19,4,43,97,0,12,0,0
3314,536,254,581,355,96,19,4,45,101,1,12,0,0
3315,536,254,581,356,96,19,4,45,102,2,12,0,0
3321,536,256,578,351,96,19,4,42,95,0,12,0,0
3322,539,263,578,351,96,19,4,39,88,1,12,0,0
3323,539,264,578,351,96,19,4,39,87,2,12,0,0
3324,535,256,577,351,96,19,4,42,95,3,12,0,0
3325,536,255,579,351,96,19,4,43,96,4,12,0,0
3326,537,257,578,349,96,19,4,41,92,5,12,0,0
3327,537,257,578,349,96,19,4,41,92,6,12,0,0
3328,537,255,578,348,96,19,4,41,93,7,12,0,0
3329,536,254,578,347,96,19,4,42,93,8,12,0,0
3330,537,256,578,346,96,19,4,41,90,9,12,0,0
3331,533,233,586,352,96,19,4,53,119,10,12,0,0
3332,533,235,585,353,96,19,4,52,118,11,12,0,0
3333,533,233,586,353,96,19,4,53,120,12,12,0,0
3335,533,233,586,354,96,19,4,53,121,0,12,0,0
3336,536,248,582,352,96,19,4,46,104,1,12,0,0
3337,537,254,580,353,96,19,4,43,99,2,12,0,0
3338,535,255,577,351,96,19,4,42,96,3,12,0,0
3339,535,256,577,351,96,19,4,42,95,4,12,0,0
3341,535,251,577,348,96,19,4,42,97,0,12,0,0
3342,533,245,578,347,96,19,4,45,102,1,12,0,0
3343,533,244,578,346,96,19,4,45,102,2,12,0,0
3344,534,250,579,354,96,19,4,45,104,3,12,0,0
3345,534,250,579,354,96,19,4,45,104,4,12,0,0
3347,535,251,577,348,96,19,4,42,97,0,12,0,0
3348,535,251,577,348,96,19,4,42,97,1,12,0,0
3350,538,260,575,343,96,19,4,37,83,0,12,0,0
3351,534,231,582,342,96,19,4,48,111,1,12,0,0
3352,534,229,583,341,96,19,4,49,112,2,12,0,0
3353,535,243,578,343,96,19,4,43,100,3,12,0,0
3354,533,243,579,348,96,19,4,46,105,4,12,0,0
3355,534,240,579,346,96,19,4,45,106,5,12,0,0
3356,533,239,579,346,96,19,4,46,107,6,12,0,0
3361,534,235,581,343,96,19,4,47,108,0,12,0,0
3362,535,239,580,344,96,19,4,45,105,1,12,0,0
3363,535,238,581,344,96,19,4,46,106,2,12,0,0
3371,529,222,587,363,96,19,4,58,141,0,12,0,0
3372,529,220,588,364,96,19,4,59,144,1,12,0,0
3376,534,237,580,348,96,19,4,46,111,0,12,0,0
3377,537,244,581,349,96,19,4,44,105,1,12,0,0
3378,538,244,581,349,96,19,4,43,105,2,12,0,0
3386,540,266,576,350,96,19,4,36,84,0,12,0,0
3396,536,249,579,349,96,19,4,43,100,0,12,0,0
3397,535,248,579,349,96,19,4,44,101,1,12,0,0
3421,535,215,587,342,96,19,4,52,127,0,12,0,0
3422,535,214,587,341,96,19,4,52,127,1,12,0,0
3423,535,226,583,344,96,19,4,48,118,2,12,0,0
3424,535,226,583,344,96,19,4,48,118,3,12,0,0
3340,533,226,582,349,97,19,4,49,123,0,0,0,0
3368,1658,105,1721,311,98,19,4,63,206,0,0,0,0
3385,1611,104,1712,316,100,19,4,101,212,0,0,0,0
3388,1652,101,1715,314,101,19,4,63,213,0,0,0,0
3470,541,272,582,347,104,19,4,41,75,0,0,0,0
3475,542,259,581,353,105,19,4,39,94,0,0,0,0
3488,542,262,580,359,107,19,4,38,97,0,0,0,0
3491,532,247,583,348,109,19,4,51,101,0,1,0,0
3492,532,246,584,349,109,19,4,52,103,1,1,0,0
3495,532,245,580,354,111,19,4,48,109,0,0,0,0
3528,539,262,575,343,112,19,4,36,81,0,0,0,0
3538,532,253,574,359,114,19,4,42,106,0,0,0,0
3553,1658,102,1720,302,115,19,4,62,200,0,0,0,0
3591,1657,110,1720,343,116,19,4,63,233,0,5,0,0
3592,1657,103,1717,323,116,19,4,60,220,1,5,0,0
3593,1658,103,1720,335,116,19,4,62,232,2,5,0,0
3594,1658,102,1720,334,116,19,4,62,232,3,5,0,0
3595,1660,102,1723,337,116,19,4,63,235,4,5,0,0
3596,1660,101,1725,339,116,19,4,65,238,5,5,0,0
3616,1600,110,1665,346,116,19,4,65,236,0,5,0,0
3617,1594,110,1663,345,116,19,4,69,235,1,5,0,0
3618,1591,110,1660,345,116,19,4,69,235,2,5,0,0
3619,1596,129,1662,349,116,19,4,66,220,3,5,0,0
3620,1593,124,1661,350,116,19,4,68,226,4,5,0,0
3621,1591,126,1659,351,116,19,4,68,225,5,5,0,0
3591,1601,132,1667,338,117,19,4,66,206,0,5,0,0
3592,1594,117,1664,337,117,19,4,70,220,1,5,0,0
3593,1597,119,1665,330,117,19,4,68,211,2,5,0,0
3594,1595,108,1668,335,117,19,4,73,227,3,5,0,0
3595,1598,118,1666,331,117,19,4,68,213,4,5,0,0
3596,1598,117,1666,330,117,19,4,68,213,5,5,0,0
3619,1662,106,1719,446,119,19,4,57,340,0,1,0,0
3620,1665,107,1709,369,119,19,4,44,262,1,1,0,0
3651,532,201,592,346,120,19,4,60,145,0,4,0,0
3652,534,207,590,344,120,19,4,56,137,1,4,0,0
3653,533,202,591,344,120,19,4,58,142,2,4,0,0
3654,532,199,592,344,120,19,4,60,145,3,4,0,0
3655,532,197,593,344,120,19,4,61,147,4,4,0,0
3668,538,234,587,353,120,19,4,49,119,0,4,0,0
3669,538,236,587,354,120,19,4,49,118,1,4,0,0
3676,540,252,578,343,120,19,4,38,91,0,4,0,0
3677,540,253,578,339,120,19,4,38,86,1,4,0,0
3678,538,253,577,343,120,19,4,39,90,2,4,0,0
3679,537,254,576,342,120,19,4,39,88,3,4,0,0
3682,537,254,574,341,120,19,4,37,87,0,4,0,0
3683,537,255,573,340,120,19,4,36,85,1,4,0,0
3685,538,260,573,340,120,19,4,35,80,0,4,0,0
3686,538,261,573,340,120,19,4,35,79,1,4,0,0
3693,536,253,577,349,120,19,4,41,96,0,4,0,0
3694,536,253,578,350,120,19,4,42,97,1,4,0,0
3703,531,200,589,341,120,19,4,58,141,0,4,0,0
3704,529,191,591,346,120,19,4,62,155,1,4,0,0
3705,532,197,590,344,120,19,4,58,147,2,4,0,0
3706,531,194,591,344,120,19,4,60,150,3,4,0,0
3728,1658,112,1719,309,121,19,4,61,197,0,0,0,0
3739,538,257,580,355,122,19,4,42,98,0,0,0,0
3776,1597,96,1709,340,124,19,4,112,244,0,0,0,0
3801,540,262,578,347,127,19,4,38,85,0,1,0,0
3802,540,264,577,346,127,19,4,37,82,1,1,0,0
3821,543,278,579,385,129,19,4,36,107,0,0,0,0
3844,534,224,582,357,132,19,4,48,133,0,1,0,0
3845,541,251,579,356,132,19,4,38,105,1,1,0,0
3859,537,242,583,364,133,19,4,46,122,0,0,0,0
3863,540,252,582,358,134,19,4,42,106,0,0,0,0
3932,539,257,583,356,135,19,4,44,99,0,0,0,0
3978,538,253,578,356,137,19,4,40,103,0,0,0,0
4069,145,180,188,297,139,19,4,43,117,0,0,0,0
4069,1657,108,1722,384,140,19,4,65,276,0,0,0,0
4071,1606,95,1716,370,141,19,4,110,275,0,1,0,0
4072,1610,91,1722,372,141,19,4,112,281,1,1,0,0
4087,146,180,186,273,142,19,4,40,93,0,0,0,0
4310,1664,95,1720,312,147,19,4,56,217,0,0,0,0
4311,145,177,197,297,148,19,4,52,120,0,0,0,0
4313,145,179,195,296,149,19,4,50,117,0,0,0,0
4674,1597,103,1670,348,155,19,4,73,245,0,0,0,0
4746,146,181,192,293,156,19,4,46,112,0,0,0,0
4820,145,180,194,301,157,19,4,49,121,0,0,0,0
4836,146,182,190,292,158,19,4,44,110,0,6,0,0
4837,146,182,189,292,158,19,4,43,110,1,6,0,0
4838,146,180,192,296,158,19,4,46,116,2,6,0,0
4839,145,180,192,295,158,19,4,47,115,3,6,0,0
4840,144,180,192,299,158,19,4,48,119,4,6,0,0
4841,145,180,193,297,158,19,4,48,117,5,6,0,0
4842,145,180,193,298,158,19,4,48,118,6,6,0,0
4850,144,179,190,295,158,19,4,46,116,0,6,0,0
4851,144,179,190,295,158,19,4,46,116,1,6,0,0
4852,145,181,188,290,158,19,4,43,109,2,6,0,0
4853,145,181,188,289,158,19,4,43,108,3,6,0,0
4854,145,181,188,289,158,19,4,43,108,4,6,0,0
4855,145,182,188,288,158,19,4,43,106,5,6,0,0
4838,176,168,218,299,159,19,4,42,131,0,3,0,0
4839,177,171,217,295,159,19,4,40,124,1,3,0,0
4840,180,174,219,294,159,19,4,39,120,2,3,0,0
4841,182,176,219,294,159,19,4,37,118,3,3,0,0
4900,1649,104,1718,317,161,19,4,69,213,0,0,0,0
4931,145,181,191,294,162,19,4,46,113,0,0,0,0
5066,146,180,197,305,164,19,4,51,125,0,0,0,0
5081,146,178,189,290,166,19,4,43,112,0,1,0,0
5082,144,178,189,293,166,19,4,45,115,1,1,0,0
5085,145,178,193,285,167,19,4,48,107,0,0,0,0
5086,370,88,429,198,168,19,4,59,110,0,0,0,0
5171,146,182,188,298,169,19,4,42,116,0,0,0,0
5178,144,180,189,301,171,19,4,45,121,0,0,0,0
5370,1650,105,1720,414,173,19,4,70,309,0,0,0,0
5416,146,181,190,294,175,19,4,44,113,0,0,0,0
5421,145,181,193,300,176,19,4,48,119,0,1,0,0
5422,145,181,194,302,176,19,4,49,121,1,1,0,0
5437,146,177,190,293,177,19,4,44,116,0,0,0,0
5500,146,180,189,297,178,19,4,43,117,0,0,0,0
5500,176,175,217,295,179,19,4,41,120,0,0,0,0
5504,1524,80,1607,187,180,19,4,83,107,0,0,0,0
5506,145,178,188,294,182,19,4,43,116,0,0,0,0
5546,1661,116,1720,363,183,19,4,59,247,0,0,0,0
5549,1664,112,1723,406,184,19,4,59,294,0,0,0,0
5554,1605,97,1709,362,185,19,4,104,265,0,0,0,0
5639,147,181,185,283,186,19,4,38,102,0,0,0,0
5661,147,183,189,298,187,19,4,42,115,0,0,0,0
5663,145,180,190,294,188,19,4,45,114,0,1,0,0
5664,145,180,191,296,188,19,4,46,116,1,1,0,0
5691,146,181,189,301,189,19,4,43,120,0,1,0,0
5692,146,180,189,301,189,19,4,43,121,1,1,0,0
5692,185,168,220,293,190,19,4,35,125,0,0,0,0
5712,182,175,217,291,191,19,4,35,116,0,0,0,0
5712,147,180,189,295,192,19,4,42,115,0,0,0,0
5751,1623,106,1715,361,193,19,4,92,255,0,0,0,0
5755,1613,114,1703,356,194,19,4,90,242,0,0,0,0
5778,176,168,219,299,195,19,4,43,131,0,0,0,0
5778,144,178,196,302,196,19,4,52,124,0,0,0,0
5796,1655,110,1714,316,197,19,4,59,206,0,0,0,0
5798,184,177,219,292,198,19,4,35,115,0,0,0,0
5798,147,178,188,291,199,19,4,41,113,0,0,0,0
5831,147,181,190,292,200,19,4,43,111,0,0,0,0
5833,172,171,218,294,201,19,4,46,123,0,0,0,0
5852,1592,83,1703,347,202,19,4,111,264,0,0,0,0
5863,1637,99,1716,336,203,19,4,79,237,0,0,0,0
5865,1659,108,1722,324,204,19,4,63,216,0,0,0,0
5867,1659,119,1712,390,205,19,4,53,271,0,1,0,0
5868,1658,119,1713,401,205,19,4,55,282,1,1,0,0
5891,145,181,193,299,206,19,4,48,118,0,0,0,0
5893,146,182,192,297,207,19,4,46,115,0,0,0,0
5911,146,180,193,299,208,19,4,47,119,0,1,0,0
5912,145,179,192,296,208,19,4,47,117,1,1,0,0
5915,144,173,191,296,210,19,4,47,123,0,0,0,0
5943,1514,138,1620,343,211,19,4,106,205,0,0,0,0
36,2,643,104,1074,1,19,5,102,431,0,1,0,0
37,14,568,135,1076,1,19,5,121,508,1,1,0,0
38,57,559,319,1074,2,19,5,262,515,0,36,0,1
39,171,546,440,1072,2,19,5,269,526,1,36,0,0
40,269,490,564,1064,2,19,5,295,574,2,36,0,0
41,346,461,654,1063,2,19,5,308,602,3,36,0,0
42,435,461,741,1066,2,19,5,306,605,4,36,0,0
43,533,447,838,1050,2,19,5,305,603,5,36,0,0
44,654,449,962,1060,2,19,5,308,611,6,36,0,0
45,773,449,1042,977,2,19,5,269,528,7,36,0,0
46,816,431,1120,1038,2,19,5,304,607,8,36,0,0
47,887,426,1186,1031,2,19,5,299,605,9,36,0,0
48,961,429,1253,1019,2,19,5,292,590,10,36,0,0
49,1042,416,1339,1018,2,19,5,297,602,11,36,0,0
50,1081,415,1385,1021,2,19,5,304,606,12,36,0,0
51,1176,399,1453,957,2,19,5,277,558,13,36,0,0
52,1235,382,1507,930,2,19,5,272,548,14,36,0,0
53,1278,374,1549,910,2,19,5,271,536,15,36,0,0
54,1349,376,1610,895,2,19,5,261,519,16,36,0,0
55,1404,374,1666,890,2,19,5,262,516,17,36,0,0
56,1445,369,1702,873,2,19,5,257,504,18,36,0,0
57,1495,363,1737,844,2,19,5,242,481,19,36,0,0
58,1524,360,1762,826,2,19,5,238,466,20,36,0,0
59,1564,359,1796,812,2,19,5,232,453,21,36,0,0
60,1610,355,1838,803,2,19,5,228,448,22,36,0,0
61,1644,343,1872,791,2,19,5,228,448,23,36,0,0
62,1673,340,1886,765,2,19,5,213,425,24,36,0,0
63,1685,339,1890,748,2,19,5,205,409,25,36,0,0
64,1722,343,1912,727,2,19,5,190,384,26,36,0,0
65,1747,335,1920,724,2,19,5,173,389,27,36,0,0
66,1762,335,1920,720,2,19,5,158,385,28,36,0,0
67,1778,334,1920,692,2,19,5,142,358,29,36,0,0
68,1786,340,1920,677,2,19,5,134,337,30,36,0,0
69,1793,352,1920,662,2,19,5,127,310,31,36,0,0
70,1810,350,1920,650,2,19,5,110,300,32,36,0,0
71,1835,349,1920,636,2,19,5,85,287,33,36,0,0
72,1832,343,1920,613,2,19,5,88,270,34,36,0,0
73,1836,346,1920,608,2,19,5,84,262,35,36,0,0
74,1853,346,1920,594,2,19,5,67,248,36,36,1,0
1117,1813,497,1920,783,3,19,5,107,286,0,20,0,1
1118,1799,464,1920,798,3,19,5,121,334,1,20,0,0
1119,1785,414,1920,810,3,19,5,135,396,2,20,0,0
1120,1760,379,1920,839,3,19,5,160,460,3,20,0,0
1121,1744,393,1917,861,3,19,5,173,468,4,20,0,0
1122,1733,376,1917,872,3,19,5,184,496,5,20,0,0
1123,1688,392,1876,883,3,19,5,188,491,6,20,0,0
1124,1648,395,1848,900,3,19,5,200,505,7,20,0,0
1125,1625,404,1829,912,3,19,5,204,508,8,20,0,0
1126,1588,410,1809,949,3,19,5,221,539,9,20,0,0
1127,1551,431,1785,986,3,19,5,234,555,10,20,0,0
1128,1525,438,1765,998,3,19,5,240,560,11,20,0,0
1129,1473,456,1721,1016,3,19,5,248,560,12,20,0,0
1130,1434,478,1688,1035,3,19,5,254,557,13,20,0,0
1131,1386,496,1656,1063,3,19,5,270,567,14,20,0,0
1132,1336,522,1618,1072,3,19,5,282,550,15,20,0,0
1133,1331,588,1598,1067,3,19,5,267,479,16,20,0,0
1134,1363,640,1621,1075,3,19,5,258,435,17,20,0,0
1135,1392,717,1621,1073,3,19,5,229,356,18,20,0,0
1136,1411,828,1591,1072,3,19,5,180,244,19,20,0,0
1137,1410,868,1567,1080,3,19,5,157,212,20,20,1,0
2289,1719,307,1793,465,5,19,5,74,158,0,0,0,0
4425,1740,287,1808,450,6,19,5,68,163,0,6,0,0
4426,1738,288,1806,450,6,19,5,68,162,1,6,0,0
4427,1738,288,1806,451,6,19,5,68,163,2,6,0,0
4428,1737,288,1805,451,6,19,5,68,163,3,6,0,0
4429,1739,288,1807,451,6,19,5,68,163,4,6,0,0
4430,1740,289,1807,449,6,19,5,67,160,5,6,0,0
4431,1741,289,1807,448,6,19,5,66,159,6,6,0,0
4457,1735,287,1803,451,6,19,5,68,164,0,6,0,0
4458,1736,286,1804,450,6,19,5,68,164,1,6,0,0
4459,1736,286,1804,450,6,19,5,68,164,2,6,0,0
4460,1736,285,1804,450,6,19,5,68,165,3,6,0,0
4482,1740,291,1805,449,6,19,5,65,158,0,6,0,0
4483,1740,292,1805,448,6,19,5,65,156,1,6,0,0
4511,1738,290,1807,451,6,19,5,69,161,0,6,0,0
4512,1738,289,1807,452,6,19,5,69,163,1,6,0,0
4672,1738,288,1806,451,7,19,5,68,163,0,0,0,0
4785,1741,289,1805,447,8,19,5,64,158,0,0,0,0
4821,1743,289,1806,446,9,19,5,63,157,0,1,0,0
4822,1741,289,1805,447,9,19,5,64,158,1,1,0,0
4824,1746,291,1807,449,10,19,5,61,158,0,0,0,0
4971,1734,286,1802,455,11,19,5,68,169,0,1,0,0
4972,1736,286,1803,452,11,19,5,67,166,1,1,0,0
4976,1733,282,1803,454,12,19,5,70,172,0,5,0,0
4977,1742,288,1807,448,12,19,5,65,160,1,5,0,0
4978,1744,282,1810,446,12,19,5,66,164,2,5,0,0
4979,1746,284,1810,444,12,19,5,64,160,3,5,0,0
4980,1747,287,1809,441,12,19,5,62,154,4,5,0,0
4981,1748,288,1809,439,12,19,5,61,151,5,5,0,0
5010,0,705,157,1069,13,19,5,157,364,0,0,0,0
5011,1,448,353,1072,14,19,5,352,624,0,20,0,1
5012,131,436,486,1064,14,19,5,355,628,1,20,0,0
5013,243,399,606,1044,14,19,5,363,645,2,20,0,0
5014,397,398,765,1052,14,19,5,368,654,3,20,0,0
5015,579,388,892,947,14,19,5,313,559,4,20,0,0
5016,739,361,1113,1027,14,19,5,374,666,5,20,0,0
5017,886,352,1270,1038,14,19,5,384,686,6,20,0,0
5018,1003,349,1381,1038,14,19,5,378,689,7,20,0,0
5019,1077,337,1456,1031,14,19,5,379,694,8,20,0,0
5020,1190,341,1538,972,14,19,5,348,631,9,20,0,0
5021,1292,323,1632,948,14,19,5,340,625,10,20,0,0
5022,1357,333,1684,930,14,19,5,327,597,11,20,0,0
5023,1454,325,1746,866,14,19,5,292,541,12,20,0,0
5024,1507,337,1778,841,14,19,5,271,504,13,20,0,0
5025,1560,329,1821,815,14,19,5,261,486,14,20,0,0
5026,1626,319,1874,787,14,19,5,248,468,15,20,0,0
5027,1662,306,1909,777,14,19,5,247,471,16,20,0,0
5028,1713,302,1920,741,14,19,5,207,439,17,20,0,0
5029,1739,304,1920,721,14,19,5,181,417,18,20,0,0
5030,1767,327,1920,688,14,19,5,153,361,19,20,0,0
5031,1829,325,1920,664,14,19,5,91,339,20,20,1,0
5032,1837,324,1918,698,15,19,5,81,374,0,1,0,0
5033,1861,362,1920,638,15,19,5,59,276,1,1,0,0
5086,1643,192,1752,388,16,19,5,109,196,0,0,0,0
5089,1743,295,1798,452,17,19,5,55,157,0,3,0,0
5090,1737,289,1795,456,17,19,5,58,167,1,3,0,0
5091,1738,287,1796,452,17,19,5,58,165,2,3,0,0
5092,1738,285,1797,451,17,19,5,59,166,3,3,0,0
5096,1739,286,1798,451,17,19,5,59,165,0,3,0,0
5097,1739,287,1798,451,17,19,5,59,164,1,3,0,0
5098,1739,287,1798,450,17,19,5,59,163,2,3,0,0
5118,1749,291,1805,444,17,19,5,56,153,0,3,0,0
5119,1750,292,1805,444,17,19,5,55,152,1,3,0,0
5120,1750,290,1806,444,17,19,5,56,154,2,3,0,0
5121,1750,290,1807,443,17,19,5,57,153,3,3,0,0
5321,1731,285,1805,453,18,19,5,74,168,0,3,0,0
5322,1729,283,1804,453,18,19,5,75,170,1,3,0,0
5323,1730,284,1805,453,18,19,5,75,169,2,3,0,0
5324,1731,284,1805,453,18,19,5,74,169,3,3,0,0
5408,1752,291,1807,444,19,19,5,55,153,0,0,0,0
5436,1753,288,1803,443,20,19,5,50,155,0,0,0,0
5438,1732,287,1804,452,21,19,5,72,165,0,0,0,0
5440,1736,284,1805,454,22,19,5,69,170,0,0,0,0
5443,1749,290,1806,450,23,19,5,57,160,0,0,0,0
5461,1745,289,1805,446,24,19,5,60,157,0,1,0,0
5462,1744,289,1804,446,24,19,5,60,157,1,1,0,0
5464,1744,290,1805,447,25,19,5,61,157,0,0,0,0
5471,1739,286,1803,449,26,19,5,64,163,0,1,0,0
5472,1742,288,1804,445,26,19,5,62,157,1,1,0,0
5474,1746,289,1806,442,27,19,5,60,153,0,0,0,0
5511,1747,289,1806,443,28,19,5,59,154,0,4,0,0
5512,1747,289,1806,443,28,19,5,59,154,1,4,0,0
5513,1746,289,1805,444,28,19,5,59,155,2,4,0,0
5514,1746,289,1805,443,28,19,5,59,154,3,4,0,0
5515,1746,289,1805,443,28,19,5,59,154,4,4,0,0
5532,1747,294,1806,447,28,19,5,59,153,0,4,0,0
5533,1747,295,1806,448,28,19,5,59,153,1,4,0,0
5540,1737,284,1802,450,28,19,5,65,166,0,4,0,0
5541,1737,283,1802,451,28,19,5,65,168,1,4,0,0
5906,1866,322,1918,549,29,19,5,52,227,0,28,0,0
5907,1860,326,1914,562,29,19,5,54,236,1,28,0,0
5908,1852,322,1910,571,29,19,5,58,249,2,28,0,0
5909,1830,228,1916,598,29,19,5,86,370,3,28,0,0
5910,1821,196,1917,610,29,19,5,96,414,4,28,0,0
5911,1824,174,1920,603,29,19,5,96,429,5,28,0,0
5912,1816,144,1920,613,29,19,5,104,469,6,28,0,0
5915,1780,146,1898,636,29,19,5,118,490,0,28,0,1
5916,1775,221,1883,638,29,19,5,108,417,1,28,0,0
5917,1766,243,1874,636,29,19,5,108,393,2,28,0,0
5918,1750,255,1864,653,29,19,5,114,398,3,28,0,0
5919,1721,265,1843,669,29,19,5,122,404,4,28,0,0
5920,1702,253,1833,676,29,19,5,131,423,5,28,0,0
5921,1667,262,1805,681,29,19,5,138,419,6,28,0,0
5922,1635,260,1782,688,29,19,5,147,428,7,28,0,0
5923,1615,267,1768,698,29,19,5,153,431,8,28,0,0
5924,1590,270,1755,725,29,19,5,165,455,9,28,0,0
5925,1550,281,1721,741,29,19,5,171,460,10,28,0,0
5926,1523,275,1702,749,29,19,5,179,474,11,28,0,0
5927,1477,277,1669,765,29,19,5,192,488,12,28,0,0
5928,1434,282,1639,788,29,19,5,205,506,13,28,0,0
5929,1401,282,1616,806,29,19,5,215,524,14,28,0,0
5930,1377,293,1599,836,29,19,5,222,543,15,28,0,0
5931,1333,310,1569,883,29,19,5,236,573,16,28,0,0
5932,1301,324,1544,907,29,19,5,243,583,17,28,0,0
5933,1238,343,1506,973,29,19,5,268,630,18,28,0,0
5934,1205,348,1484,1000,29,19,5,279,652,19,28,0,0
5935,1166,344,1465,1044,29,19,5,299,700,20,28,0,0
5936,1135,382,1429,1067,29,19,5,294,685,21,28,0,0
5937,1108,423,1395,1077,29,19,5,287,654,22,28,0,0
5938,1082,444,1372,1080,29,19,5,290,636,23,28,0,0
5939,1025,462,1322,1080,29,19,5,297,618,24,28,0,0
5940,997,537,1278,1080,29,19,5,281,543,25,28,0,0
5941,992,613,1252,1077,29,19,5,260,464,26,28,0,0
5942,1021,749,1236,1079,29,19,5,215,330,27,28,0,0
5943,1007,791,1203,1080,29,19,5,196,289,28,28,1,0
5915,1727,288,1803,460,30,19,5,76,172,0,0,0,0
5920,1845,483,1919,723,31,19,5,74,240,0,23,0,1
5921,1826,437,1920,762,31,19,5,94,325,1,23,0,0
5922,1818,430,1920,772,31,19,5,102,342,2,23,0,0
5923,1803,428,1911,776,31,19,5,108,348,3,23,0,0
5924,1768,412,1884,777,31,19,5,116,365,4,23,0,0
5925,1753,408,1876,782,31,19,5,123,374,5,23,0,0
5926,1731,371,1876,804,31,19,5,145,433,6,23,0,0
5927,1709,382,1864,831,31,19,5,155,449,7,23,0,0
5928,1684,397,1843,846,31,19,5,159,449,8,23,0,0
5929,1631,409,1797,849,31,19,5,166,440,9,23,0,0
5930,1589,419,1766,866,31,19,5,177,447,10,23,0,0
5931,1562,424,1751,894,31,19,5,189,470,11,23,0,0
5932,1548,442,1741,916,31,19,5,193,474,12,23,0,0
5933,1529,460,1729,939,31,19,5,200,479,13,23,0,0
5934,1508,485,1711,961,31,19,5,203,476,14,23,0,0
5935,1463,500,1683,1001,31,19,5,220,501,15,23,0,0
5936,1436,512,1671,1040,31,19,5,235,528,16,23,0,0
5937,1424,536,1660,1053,31,19,5,236,517,17,23,0,0
5938,1417,568,1656,1070,31,19,5,239,502,18,23,0,0
5939,1414,603,1652,1078,31,19,5,238,475,19,23,0,0
5940,1409,654,1640,1080,31,19,5,231,426,20,23,0,0
5941,1411,702,1635,1080,31,19,5,224,378,21,23,0,0
5942,1442,770,1647,1080,31,19,5,205,310,22,23,0,0
5943,1438,797,1633,1080,31,19,5,195,283,23,23,1,0
5941,1749,268,1808,451,32,19,5,59,183,0,0,0,0
1,452,204,580,508,1,19,6,128,304,0,34,0,1
2,455,204,586,514,1,19,6,131,310,1,34,0,0
3,462,213,594,529,1,19,6,132,316,2,34,0,0
4,476,219,611,538,1,19,6,135,319,3,34,0,0
5,482,223,622,554,1,19,6,140,331,4,34,0,0
6,496,232,638,571,1,19,6,142,339,5,34,0,0
7,512,233,658,581,1,19,6,146,348,6,34,0,0
8,526,239,677,604,1,19,6,151,365,7,34,0,0
9,543,248,695,618,1,19,6,152,370,8,34,0,0
10,557,254,711,628,1,19,6,154,374,9,34,0,0
11,577,265,735,652,1,19,6,158,387,10,34,0,0
12,600,270,760,663,1,19,6,160,393,11,34,0,0
13,614,279,784,696,1,19,6,170,417,12,34,0,0
14,633,291,808,722,1,19,6,175,431,13,34,0,0
15,652,300,828,733,1,19,6,176,433,14,34,0,0
16,673,311,853,758,1,19,6,180,447,15,34,0,0
17,696,320,881,779,1,19,6,185,459,16,34,0,0
18,712,324,908,805,1,19,6,196,481,17,34,0,0
19,725,351,932,859,1,19,6,207,508,18,34,0,0
20,747,366,957,878,1,19,6,210,512,19,34,0,0
21,775,386,988,906,1,19,6,213,520,20,34,0,0
22,804,408,1025,946,1,19,6,221,538,21,34,0,0
23,842,420,1071,971,1,19,6,229,551,22,34,0,0
24,867,450,1115,1046,1,19,6,248,596,23,34,0,0
25,906,482,1154,1072,1,19,6,248,590,24,34,0,0
26,953,513,1194,1080,1,19,6,241,567,25,34,0,0
27,1000,554,1232,1080,1,19,6,232,526,26,34,0,0
28,1065,580,1293,1078,1,19,6,228,498,27,34,0,0
29,1121,635,1342,1079,1,19,6,221,444,28,34,0,0
30,1188,702,1393,1080,1,19,6,205,378,29,34,0,0
31,1275,754,1465,1077,1,19,6,190,323,30,34,0,0
32,1370,816,1541,1080,1,19,6,171,264,31,34,0,0
33,1493,875,1644,1080,1,19,6,151,205,32,34,0,0
34,1630,941,1749,1079,1,19,6,119,138,33,34,0,0
35,1728,990,1810,1080,1,19,6,82,90,34,34,1,0
3737,274,110,309,182,2,19,6,35,72,0,0,0,0
3738,284,110,320,261,3,19,6,36,151,0,27,0,0
3742,326,106,361,247,3,19,6,35,141,0,27,0,1
3743,332,104,369,249,3,19,6,37,145,1,27,0,0
3744,337,106,375,254,3,19,6,38,148,2,27,0,0
3745,339,108,378,257,3,19,6,39,149,3,27,0,0
3746,344,111,383,260,3,19,6,39,149,4,27,0,0
3747,346,112,387,265,3,19,6,41,153,5,27,0,0
3748,347,112,390,269,3,19,6,43,157,6,27,0,0
3749,346,114,391,273,3,19,6,45,159,7,27,0,0
3750,344,113,389,271,3,19,6,45,158,8,27,0,0
3751,344,114,389,275,3,19,6,45,161,9,27,0,0
3752,343,116,391,285,3,19,6,48,169,10,27,0,0
3753,343,115,393,287,3,19,6,50,172,11,27,0,0
3754,342,116,394,295,3,19,6,52,179,12,27,0,0
3755,338,118,391,300,3,19,6,53,182,13,27,0,0
3756,336,119,390,304,3,19,6,54,185,14,27,0,0
3757,333,121,389,311,3,19,6,56,190,15,27,0,0
3758,332,122,389,317,3,19,6,57,195,16,27,0,0
3759,330,123,389,323,3,19,6,59,200,17,27,0,0
3760,328,125,388,327,3,19,6,60,202,18,27,0,0
3761,321,126,382,332,3,19,6,61,206,19,27,0,0
3762,316,128,378,337,3,19,6,62,209,20,27,0,0
3763,311,132,375,349,3,19,6,64,217,21,27,0,0
3764,304,134,370,357,3,19,6,66,223,22,27,0,0
3765,296,140,362,363,3,19,6,66,223,23,27,0,0
3766,282,144,350,368,3,19,6,68,224,24,27,0,0
3767,265,148,333,372,3,19,6,68,224,25,27,0,0
3768,248,148,315,374,3,19,6,67,226,26,27,0,0
3769,242,150,310,379,3,19,6,68,229,27,27,1,0
4965,277,129,317,233,4,19,6,40,104,0,0,0,0
4966,291,122,342,322,5,19,6,51,200,0,39,0,1
4967,306,124,358,328,5,19,6,52,204,1,39,0,0
4968,317,122,373,339,5,19,6,56,217,2,39,0,0
4969,334,120,390,339,5,19,6,56,219,3,39,0,0
4970,349,123,406,345,5,19,6,57,222,4,39,0,0
4971,362,122,423,361,5,19,6,61,239,5,39,0,0
4972,377,124,439,365,5,19,6,62,241,6,39,0,0
4973,393,129,457,369,5,19,6,64,240,7,39,0,0
4974,399,129,466,375,5,19,6,67,246,8,39,0,0
4975,405,133,476,393,5,19,6,71,260,9,39,0,0
4976,415,137,486,397,5,19,6,71,260,10,39,0,0
4977,428,139,501,407,5,19,6,73,268,11,39,0,0
4978,439,152,514,425,5,19,6,75,273,12,39,0,0
4979,449,157,526,432,5,19,6,77,275,13,39,0,0
4980,455,158,535,448,5,19,6,80,290,14,39,0,0
4981,464,162,547,460,5,19,6,83,298,15,39,0,0
4982,478,164,565,468,5,19,6,87,304,16,39,0,0
4983,495,174,588,494,5,19,6,93,320,17,39,0,0
4984,507,177,606,514,5,19,6,99,337,18,39,0,0
4985,519,182,622,530,5,19,6,103,348,19,39,0,0
4986,538,190,645,554,5,19,6,107,364,20,39,0,0
4987,563,195,672,564,5,19,6,109,369,21,39,0,0
4988,587,208,707,608,5,19,6,120,400,22,39,0,0
4989,607,215,731,627,5,19,6,124,412,23,39,0,0
4990,624,221,753,653,5,19,6,129,432,24,39,0,0
4991,642,235,778,692,5,19,6,136,457,25,39,0,0
4992,674,246,813,715,5,19,6,139,469,26,39,0,0
4993,695,267,854,786,5,19,6,159,519,27,39,0,0
4994,724,278,894,821,5,19,6,170,543,28,39,0,0
4995,754,298,935,879,5,19,6,181,581,29,39,0,0
4996,787,325,979,942,5,19,6,192,617,30,39,0,0
4997,839,340,1037,974,5,19,6,198,634,31,39,0,0
4998,867,379,1084,1045,5,19,6,217,666,32,39,0,0
4999,942,418,1159,1067,5,19,6,217,649,33,39,0,0
5000,1014,461,1230,1079,5,19,6,216,618,34,39,0,0
5001,1115,533,1321,1080,5,19,6,206,547,35,39,0,0
5002,1242,591,1442,1080,5,19,6,200,489,36,39,0,0
5003,1368,671,1558,1080,5,19,6,190,409,37,39,0,0
5004,1513,769,1685,1079,5,19,6,172,310,38,39,0,0
5005,1590,812,1748,1080,5,19,6,158,268,39,39,1,0
5005,1785,897,1920,1078,6,19,6,135,181,0,0,0,0
33,1798,789,1920,1074,1,19,7,122,285,0,1,0,0
34,1710,764,1844,1072,1,19,7,134,308,1,1,0,0
35,1530,748,1766,1071,2,19,7,236,323,0,0,0,0
36,1386,741,1643,1078,3,19,7,257,337,0,30,0,1
37,1261,705,1540,1071,3,19,7,279,366,1,30,0,0
38,1132,707,1409,1069,3,19,7,277,362,2,30,0,0
39,979,644,1305,1073,3,19,7,326,429,3,30,0,0
40,845,619,1184,1069,3,19,7,339,450,4,30,0,0
41,719,606,1068,1072,3,19,7,349,466,5,30,0,0
42,626,595,985,1073,3,19,7,359,478,6,30,0,0
43,547,574,920,1071,3,19,7,373,497,7,30,0,0
44,454,542,843,1072,3,19,7,389,530,8,30,0,0
45,398,532,792,1074,3,19,7,394,542,9,30,0,0
46,328,513,732,1076,3,19,7,404,563,10,30,0,0
47,255,483,667,1066,3,19,7,412,583,11,30,0,0
48,197,463,611,1064,3,19,7,414,601,12,30,0,0
49,173,445,548,998,3,19,7,375,553,13,30,0,0
50,140,429,507,987,3,19,7,367,558,14,30,0,0
51,128,424,481,969,3,19,7,353,545,15,30,0,0
52,105,414,439,936,3,19,7,334,522,16,30,0,0
53,73,398,397,917,3,19,7,324,519,17,30,0,0
54,59,388,369,896,3,19,7,310,508,18,30,0,0
55,47,375,332,853,3,19,7,285,478,19,30,0,0
56,44,368,312,825,3,19,7,268,457,20,30,0,0
57,28,368,277,796,3,19,7,249,428,21,30,0,0
58,1,360,238,777,3,19,7,237,417,22,30,0,0
59,0,352,224,775,3,19,7,224,423,23,30,0,0
60,0,345,196,748,3,19,7,196,403,24,30,0,0
61,0,347,180,726,3,19,7,180,379,25,30,0,0
62,0,351,172,713,3,19,7,172,362,26,30,0,0
63,0,372,140,702,3,19,7,140,330,27,30,0,0
64,0,377,126,704,3,19,7,126,327,28,30,0,0
65,0,383,109,681,3,19,7,109,298,29,30,0,0
66,0,382,83,666,3,19,7,83,284,30,30,1,0
1095,2,310,45,510,4,19,7,43,200,0,0,0,0
1097,0,270,87,520,5,19,7,87,250,0,94,0,1
1098,2,270,89,520,5,19,7,87,250,1,94,0,0
1099,2,267,92,524,5,19,7,90,257,2,94,0,0
1100,4,268,97,534,5,19,7,93,266,3,94,0,0
1101,4,270,103,552,5,19,7,99,282,4,94,0,0
1102,9,268,111,558,5,19,7,102,290,5,94,0,0
1103,24,272,130,563,5,19,7,106,291,6,94,0,0
1104,36,272,145,569,5,19,7,109,297,7,94,0,0
1105,39,271,151,578,5,19,7,112,307,8,94,0,0
1106,45,276,163,595,5,19,7,118,319,9,94,0,0
1107,50,279,175,614,5,19,7,125,335,10,94,0,0
1108,63,279,192,622,5,19,7,129,343,11,94,0,0
1109,88,284,223,635,5,19,7,135,351,12,94,0,0
1110,105,288,243,643,5,19,7,138,355,13,94,0,0
1111,112,288,255,654,5,19,7,143,366,14,94,0,0
1112,118,289,274,688,5,19,7,156,399,15,94,0,0
1113,132,297,293,708,5,19,7,161,411,16,94,0,0
1114,147,295,313,716,5,19,7,166,421,17,94,0,0
1115,174,303,347,728,5,19,7,173,425,18,94,0,0
1116,198,308,377,745,5,19,7,179,437,19,94,0,0
1117,209,310,393,760,5,19,7,184,450,20,94,0,0
1118,221,313,420,797,5,19,7,199,484,21,94,0,0
1119,244,324,450,824,5,19,7,206,500,22,94,0,0
1120,271,332,477,831,5,19,7,206,499,23,94,0,0
1121,327,333,550,852,5,19,7,223,519,24,94,0,0
1122,377,345,610,877,5,19,7,233,532,25,94,0,0
1123,415,344,652,889,5,19,7,237,545,26,94,0,0
1124,469,350,720,920,5,19,7,251,570,27,94,0,0
1125,535,360,798,952,5,19,7,263,592,28,94,0,0
1126,597,361,860,966,5,19,7,263,605,29,94,0,0
1127,689,359,957,969,5,19,7,268,610,30,94,0,0
1128,753,350,1033,968,5,19,7,280,618,31,94,0,0
1129,843,346,1103,932,5,19,7,260,586,32,94,0,0
1130,938,348,1197,925,5,19,7,259,577,33,94,0,0
1131,1005,348,1268,927,5,19,7,263,579,34,94,0,0
1132,1099,336,1360,927,5,19,7,261,591,35,94,0,0
1133,1161,325,1421,926,5,19,7,260,601,36,94,0,0
1134,1228,319,1479,890,5,19,7,251,571,37,94,0,0
1135,1279,303,1509,834,5,19,7,230,531,38,94,0,0
1136,1326,289,1550,798,5,19,7,224,509,39,94,0,0
1137,1351,279,1556,755,5,19,7,205,476,40,94,0,0
1138,1377,271,1576,740,5,19,7,199,469,41,94,0,0
1139,1399,264,1592,722,5,19,7,193,458,42,94,0,0
1140,1409,255,1595,709,5,19,7,186,454,43,94,0,0
1141,1418,237,1589,663,5,19,7,171,426,44,94,0,0
1142,1422,227,1587,645,5,19,7,165,418,45,94,0,0
1143,1427,224,1584,629,5,19,7,157,405,46,94,0,0
1144,1442,212,1591,600,5,19,7,149,388,47,94,0,0
1145,1454,201,1598,581,5,19,7,144,380,48,94,0,0
1146,1456,198,1593,561,5,19,7,137,363,49,94,0,0
1147,1453,188,1582,533,5,19,7,129,345,50,94,0,0
1148,1452,179,1575,514,5,19,7,123,335,51,94,0,0
1149,1455,177,1570,493,5,19,7,115,316,52,94,0,0
1150,1455,170,1566,476,5,19,7,111,306,53,94,0,0
1151,1449,165,1562,476,5,19,7,113,311,54,94,0,0
1152,1444,160,1551,459,5,19,7,107,299,55,94,0,0
1153,1436,148,1543,448,5,19,7,107,300,56,94,0,0
1154,1435,141,1539,436,5,19,7,104,295,57,94,0,0
1155,1436,140,1537,431,5,19,7,101,291,58,94,0,0
1156,1437,138,1533,415,5,19,7,96,277,59,94,0,0
1157,1439,135,1531,403,5,19,7,92,268,60,94,0,0
1158,1441,136,1529,396,5,19,7,88,260,61,94,0,0
1159,1444,132,1527,380,5,19,7,83,248,62,94,0,0
1160,1447,128,1530,377,5,19,7,83,249,63,94,0,0
1161,1452,126,1533,369,5,19,7,81,243,64,94,0,0
1162,1461,121,1540,362,5,19,7,79,241,65,94,0,0
1163,1467,119,1542,353,5,19,7,75,234,66,94,0,0
1164,1470,117,1542,345,5,19,7,72,228,67,94,0,0
1165,1473,115,1542,333,5,19,7,69,218,68,94,0,0
1166,1474,113,1542,331,5,19,7,68,218,69,94,0,0
1167,1477,112,1543,328,5,19,7,66,216,70,94,0,0
1168,1484,110,1549,319,5,19,7,65,209,71,94,0,0
1169,1488,109,1551,315,5,19,7,63,206,72,94,0,0
1170,1489,108,1551,309,5,19,7,62,201,73,94,0,0
1171,1491,107,1550,299,5,19,7,59,192,74,94,0,0
1172,1494,111,1549,291,5,19,7,55,180,75,94,0,0
1173,1497,111,1552,290,5,19,7,55,179,76,94,0,0
1174,1505,110,1558,282,5,19,7,53,172,77,94,0,0
1175,1510,104,1564,279,5,19,7,54,175,78,94,0,0
1176,1513,106,1566,281,5,19,7,53,175,79,94,0,0
1177,1516,103,1569,276,5,19,7,53,173,80,94,0,0
1178,1520,99,1574,274,5,19,7,54,175,81,94,0,0
1179,1525,99,1577,273,5,19,7,52,174,82,94,0,0
1180,1531,101,1584,277,5,19,7,53,176,83,94,0,0
1181,1536,99,1587,269,5,19,7,51,170,84,94,0,0
1182,1539,100,1588,264,5,19,7,49,164,85,94,0,0
1183,1540,98,1588,260,5,19,7,48,162,86,94,0,0
1184,1539,95,1588,258,5,19,7,49,163,87,94,0,0
1185,1542,95,1589,256,5,19,7,47,161,88,94,0,0
1186,1545,96,1591,253,5,19,7,46,157,89,94,0,0
1187,1548,92,1593,245,5,19,7,45,153,90,94,0,0
1188,1549,92,1593,245,5,19,7,44,153,91,94,0,0
1189,1549,91,1593,240,5,19,7,44,149,92,94,0,0
1190,1549,90,1593,239,5,19,7,44,149,93,94,0,0
1191,1551,89,1594,236,5,19,7,43,147,94,94,1,0
1193,1556,89,1597,227,5,19,7,41,138,0,94,0,0
1194,1559,91,1598,222,5,19,7,39,131,1,94,0,0
1195,1559,90,1597,216,5,19,7,38,126,2,94,0,0
1196,1561,90,1598,212,5,19,7,37,122,3,94,0,0
1210,1604,79,1641,199,5,19,7,37,120,0,94,0,0
1211,1606,78,1644,197,5,19,7,38,119,1,94,0,0
1212,1610,71,1651,196,5,19,7,41,125,2,94,0,0
1213,1611,70,1653,194,5,19,7,42,124,3,94,0,0
1214,1610,68,1651,193,5,19,7,41,125,4,94,0,0
1215,1611,69,1652,192,5,19,7,41,123,5,94,0,0
1216,1612,70,1652,191,5,19,7,40,121,6,94,0,0
1217,1612,70,1652,191,5,19,7,40,121,7,94,0,0
1218,1611,71,1651,190,5,19,7,40,119,8,94,0,0
1219,1611,70,1650,189,5,19,7,39,119,9,94,0,0
1220,1611,67,1650,188,5,19,7,39,121,10,94,0,0
1221,1610,71,1647,187,5,19,7,37,116,11,94,0,0
1222,1609,74,1644,183,5,19,7,35,109,12,94,0,0
1127,628,373,704,612,6,19,7,76,239,0,0,0,0
2065,293,338,351,492,7,19,7,58,154,0,0,0,0
2119,294,339,349,491,8,19,7,55,152,0,0,0,0
2213,296,327,356,494,9,19,7,60,167,0,8,0,0
2214,296,326,356,493,9,19,7,60,167,1,8,0,0
2215,295,332,353,492,9,19,7,58,160,2,8,0,0
2216,293,328,350,488,9,19,7,57,160,3,8,0,0
2217,292,326,350,486,9,19,7,58,160,4,8,0,0
2218,291,326,350,487,9,19,7,59,161,5,8,0,0
2219,291,326,351,490,9,19,7,60,164,6,8,0,0
2220,292,326,351,488,9,19,7,59,162,7,8,0,0
2221,291,326,350,488,9,19,7,59,162,8,8,0,0
2284,288,346,350,491,10,19,7,62,145,0,0,0,0
2291,297,354,351,488,11,19,7,54,134,0,5,0,0
2292,295,348,352,488,11,19,7,57,140,1,5,0,0
2293,299,357,352,488,11,19,7,53,131,2,5,0,0
2294,300,359,352,488,11,19,7,52,129,3,5,0,0
2295,294,343,352,489,11,19,7,58,146,4,5,0,0
2296,293,340,353,490,11,19,7,60,150,5,5,0,0
2414,291,325,352,494,12,19,7,61,169,0,1,0,0
2415,294,335,350,490,12,19,7,56,155,1,1,0,0
2615,277,316,352,486,13,19,7,75,170,0,0,0,0
2696,280,332,350,487,14,19,7,70,155,0,10,0,0
2697,280,332,349,487,14,19,7,69,155,1,10,0,0
2698,280,331,349,485,14,19,7,69,154,2,10,0,0
2699,280,330,350,485,14,19,7,70,155,3,10,0,0
2700,280,329,350,485,14,19,7,70,156,4,10,0,0
2701,280,331,349,485,14,19,7,69,154,5,10,0,0
2702,280,330,350,485,14,19,7,70,155,6,10,0,0
2703,279,331,349,485,14,19,7,70,154,7,10,0,0
2704,280,333,349,485,14,19,7,69,152,8,10,0,0
2705,280,332,349,485,14,19,7,69,153,9,10,0,0
2706,280,332,349,485,14,19,7,69,153,10,10,0,0
2722,278,327,350,484,14,19,7,72,157,0,10,0,0
2723,278,326,349,484,14,19,7,71,158,1,10,0,0
2724,279,328,349,485,14,19,7,70,157,2,10,0,0
2725,279,328,349,485,14,19,7,70,157,3,10,0,0
2773,284,326,350,492,15,19,7,66,166,0,0,0,0
2786,286,321,349,493,16,19,7,63,172,0,0,0,0
2790,286,320,350,494,17,19,7,64,174,0,5,0,0
2791,287,328,347,492,17,19,7,60,164,1,5,0,0
2792,285,330,344,488,17,19,7,59,158,2,5,0,0
2793,284,331,342,487,17,19,7,58,156,3,5,0,0
2803,287,332,346,486,17,19,7,59,154,0,5,0,0
2804,287,332,346,486,17,19,7,59,154,1,5,0,0
2811,283,325,346,487,17,19,7,63,162,0,5,0,0
2812,283,325,346,487,17,19,7,63,162,1,5,0,0
2813,284,324,349,491,17,19,7,65,167,2,5,0,0
2814,284,324,349,491,17,19,7,65,167,3,5,0,0
2821,286,329,350,491,17,19,7,64,162,0,5,0,0
2822,286,331,348,488,17,19,7,62,157,1,5,0,0
2823,286,329,350,489,17,19,7,64,160,2,5,0,0
2824,285,328,350,490,17,19,7,65,162,3,5,0,0
2825,285,330,348,487,17,19,7,63,157,4,5,0,0
2826,285,330,348,487,17,19,7,63,157,5,5,0,0
2849,287,338,350,491,17,19,7,63,153,0,5,0,0
2850,287,339,350,492,17,19,7,63,153,1,5,0,0
2851,282,317,352,491,17,19,7,70,174,2,5,0,0
2852,282,315,352,491,17,19,7,70,176,3,5,0,0
2857,175,217,279,458,18,19,7,104,241,0,0,0,0
2883,285,331,350,493,19,19,7,65,162,0,0,0,0
2907,287,335,353,493,20,19,7,66,158,0,1,0,0
2908,287,335,353,493,20,19,7,66,158,1,1,0,0
2922,288,334,352,494,21,19,7,64,160,0,1,0,0
2923,288,335,351,493,21,19,7,63,158,1,1,0,0
2925,287,322,350,494,22,19,7,63,172,0,0,0,0
2939,287,335,352,493,23,19,7,65,158,0,0,0,0
2941,287,319,349,493,24,19,7,62,174,0,0,0,0
2943,287,331,351,491,25,19,7,64,160,0,0,0,0
2946,287,322,351,492,26,19,7,64,170,0,5,0,0
2947,286,317,351,492,26,19,7,65,175,1,5,0,0
2948,285,319,350,493,26,19,7,65,174,2,5,0,0
2949,286,325,349,493,26,19,7,63,168,3,5,0,0
2950,285,322,350,493,26,19,7,65,171,4,5,0,0
2951,285,323,349,493,26,19,7,64,170,5,5,0,0
2964,285,319,350,494,26,19,7,65,175,0,5,0,0
2965,285,318,350,494,26,19,7,65,176,1,5,0,0
2987,285,316,350,493,26,19,7,65,177,0,5,0,0
2988,285,317,351,492,26,19,7,66,175,1,5,0,0
2989,286,320,351,492,26,19,7,65,172,2,5,0,0
2990,286,324,350,492,26,19,7,64,168,3,5,0,0
2991,287,325,350,492,26,19,7,63,167,4,5,0,0
3046,288,326,354,495,27,19,7,66,169,0,40,0,0
3047,287,320,354,495,27,19,7,67,175,1,40,0,0
3048,286,319,355,495,27,19,7,69,176,2,40,0,0
3049,286,317,355,495,27,19,7,69,178,3,40,0,0
3050,286,317,355,495,27,19,7,69,178,4,40,0,0
3051,286,316,355,496,27,19,7,69,180,5,40,0,0
3071,282,311,353,495,27,19,7,71,184,0,40,0,0
3072,283,313,352,494,27,19,7,69,181,1,40,0,0
3073,284,314,352,494,27,19,7,68,180,2,40,0,0
3074,286,320,352,494,27,19,7,66,174,3,40,0,0
3075,286,321,351,494,27,19,7,65,173,4,40,0,0
3086,286,317,354,495,27,19,7,68,178,0,40,0,0
3087,286,316,354,495,27,19,7,68,179,1,40,0,0
3088,286,318,355,494,27,19,7,69,176,2,40,0,0
3089,286,315,357,495,27,19,7,71,180,3,40,0,0
3090,287,318,356,495,27,19,7,69,177,4,40,0,0
3091,288,319,357,495,27,19,7,69,176,5,40,0,0
3093,286,319,354,493,27,19,7,68,174,0,40,0,0
3094,287,320,354,493,27,19,7,67,173,1,40,0,0
3096,286,315,356,494,27,19,7,70,179,0,40,0,0
3097,287,316,356,494,27,19,7,69,178,1,40,0,0
3098,287,314,356,494,27,19,7,69,180,2,40,0,0
3099,286,314,356,495,27,19,7,70,181,3,40,0,0
3100,287,315,356,495,27,19,7,69,180,4,40,0,0
3101,286,314,354,493,27,19,7,68,179,5,40,0,0
3102,285,312,355,495,27,19,7,70,183,6,40,0,0
3103,285,318,352,494,27,19,7,67,176,7,40,0,0
3104,286,315,354,495,27,19,7,68,180,8,40,0,0
3105,286,315,354,495,27,19,7,68,180,9,40,0,0
3106,286,315,354,495,27,19,7,68,180,10,40,0,0
3111,289,322,354,495,27,19,7,65,173,0,40,0,1
3112,289,322,354,495,27,19,7,65,173,1,40,0,0
3113,289,324,353,495,27,19,7,64,171,2,40,0,0
3114,288,323,353,494,27,19,7,65,171,3,40,0,0
3115,289,321,354,494,27,19,7,65,173,4,40,0,0
3116,286,316,354,495,27,19,7,68,179,5,40,0,0
3117,287,319,353,495,27,19,7,66,176,6,40,0,0
3118,285,315,353,495,27,19,7,68,180,7,40,0,0
3119,284,312,353,495,27,19,7,69,183,8,40,0,0
3120,285,312,354,496,27,19,7,69,184,9,40,0,0
3121,285,305,355,495,27,19,7,70,190,10,40,0,0
3122,285,306,355,495,27,19,7,70,189,11,40,0,0
3123,285,305,355,495,27,19,7,70,190,12,40,0,0
3124,284,296,356,494,27,19,7,72,198,13,40,0,0
3125,280,287,356,494,27,19,7,76,207,14,40,0,0
3126,282,299,354,492,27,19,7,72,193,15,40,0,0
3127,284,306,354,490,27,19,7,70,184,16,40,0,0
3128,284,306,355,493,27,19,7,71,187,17,40,0,0
3129,285,309,354,491,27,19,7,69,182,18,40,0,0
3130,285,308,355,490,27,19,7,70,182,19,40,0,0
3131,285,303,358,494,27,19,7,73,191,20,40,0,0
3132,285,302,358,496,27,19,7,73,194,21,40,0,0
3133,285,308,356,493,27,19,7,71,185,22,40,0,0
3134,286,309,357,496,27,19,7,71,187,23,40,0,0
3135,286,307,357,496,27,19,7,71,189,24,40,0,0
3136,288,321,354,496,27,19,7,66,175,25,40,0,0
3137,287,321,354,496,27,19,7,67,175,26,40,0,0
3138,287,321,353,497,27,19,7,66,176,27,40,0,0
3139,288,324,352,493,27,19,7,64,169,28,40,0,0
3140,288,327,351,492,27,19,7,63,165,29,40,0,0
3141,285,314,353,492,27,19,7,68,178,30,40,0,0
3142,285,306,355,493,27,19,7,70,187,31,40,0,0
3143,284,305,355,493,27,19,7,71,188,32,40,0,0
3144,284,306,354,492,27,19,7,70,186,33,40,0,0
3145,285,307,354,493,27,19,7,69,186,34,40,0,0
3146,286,311,353,494,27,19,7,67,183,35,40,0,0
3147,287,314,353,495,27,19,7,66,181,36,40,0,0
3148,287,315,353,495,27,19,7,66,180,37,40,0,0
3149,288,319,353,495,27,19,7,65,176,38,40,0,0
3150,289,321,352,495,27,19,7,63,174,39,40,0,0
3151,289,322,352,495,27,19,7,63,173,40,40,1,0
3153,289,324,353,496,27,19,7,64,172,0,40,0,0
3154,289,325,353,496,27,19,7,64,171,1,40,0,0
3155,288,321,354,496,27,19,7,66,175,2,40,0,0
3156,288,321,354,496,27,19,7,66,175,3,40,0,0
3166,288,316,352,491,27,19,7,64,175,0,40,0,0
3167,287,315,352,490,27,19,7,65,175,1,40,0,0
3168,288,318,352,490,27,19,7,64,172,2,40,0,0
3169,288,318,352,490,27,19,7,64,172,3,40,0,0
3170,287,319,350,490,27,19,7,63,171,4,40,0,0
3171,287,319,350,490,27,19,7,63,171,5,40,0,0
3189,288,316,353,492,27,19,7,65,176,0,40,0,0
3190,287,317,353,492,27,19,7,66,175,1,40,0,0
3191,287,317,353,492,27,19,7,66,175,2,40,0,0
3192,287,317,353,493,27,19,7,66,176,3,40,0,0
3193,287,317,353,493,27,19,7,66,176,4,40,0,0
3206,291,330,353,496,27,19,7,62,166,0,40,0,0
3207,290,331,353,496,27,19,7,63,165,1,40,0,0
3208,290,331,353,496,27,19,7,63,165,2,40,0,0
3209,288,330,352,494,27,19,7,64,164,3,40,0,0
3210,289,331,352,494,27,19,7,63,163,4,40,0,0
3220,287,323,353,494,27,19,7,66,171,0,40,0,0
3221,286,316,354,494,27,19,7,68,178,1,40,0,0
3222,286,315,354,494,27,19,7,68,179,2,40,0,0
3239,285,314,353,493,27,19,7,68,179,0,40,0,0
3240,285,314,353,493,27,19,7,68,179,1,40,0,0
3241,285,313,353,493,27,19,7,68,180,2,40,0,0
3251,287,323,352,493,27,19,7,65,170,0,40,0,0
3252,286,321,353,492,27,19,7,67,171,1,40,0,0
3253,286,320,354,492,27,19,7,68,172,2,40,0,0
3254,285,320,353,493,27,19,7,68,173,3,40,0,0
3255,286,324,354,493,27,19,7,68,169,4,40,0,0
3256,286,324,354,493,27,19,7,68,169,5,40,0,0
3264,288,329,354,494,27,19,7,66,165,0,40,0,0
3265,289,330,354,494,27,19,7,65,164,1,40,0,0
3081,174,216,276,449,28,19,7,102,233,0,20,0,0
3082,171,216,272,449,28,19,7,101,233,1,20,0,0
3083,172,221,272,451,28,19,7,100,230,2,20,0,0
3084,170,215,272,449,28,19,7,102,234,3,20,0,0
3085,170,215,271,449,28,19,7,101,234,4,20,0,0
3086,169,215,271,449,28,19,7,102,234,5,20,0,0
3087,164,214,264,444,28,19,7,100,230,6,20,0,0
3088,162,213,262,444,28,19,7,100,231,7,20,0,0
3090,166,218,263,445,28,19,7,97,227,0,20,0,0
3091,162,204,265,447,28,19,7,103,243,1,20,0,0
3092,161,200,265,446,28,19,7,104,246,2,20,0,0
3093,160,204,263,446,28,19,7,103,242,3,20,0,0
3094,160,202,265,447,28,19,7,105,245,4,20,0,0
3095,161,200,265,448,28,19,7,104,248,5,20,0,0
3096,163,213,263,447,28,19,7,100,234,6,20,0,0
3097,164,221,263,447,28,19,7,99,226,7,20,0,0
3098,164,222,263,447,28,19,7,99,225,8,20,0,0
3100,164,223,264,447,28,19,7,100,224,0,20,0,0
3101,165,224,264,446,28,19,7,99,222,1,20,0,0
3116,170,215,273,451,28,19,7,103,236,0,20,0,1
3117,167,213,269,449,28,19,7,102,236,1,20,0,0
3118,165,210,270,450,28,19,7,105,240,2,20,0,0
3119,167,209,273,454,28,19,7,106,245,3,20,0,0
3120,167,211,271,453,28,19,7,104,242,4,20,0,0
3121,164,211,267,451,28,19,7,103,240,5,20,0,0
3122,162,206,269,452,28,19,7,107,246,6,20,0,0
3123,162,208,267,451,28,19,7,105,243,7,20,0,0
3124,159,205,265,451,28,19,7,106,246,8,20,0,0
3125,158,204,265,451,28,19,7,107,247,9,20,0,0
3126,162,203,269,447,28,19,7,107,244,10,20,0,0
3127,160,202,269,449,28,19,7,109,247,11,20,0,0
3128,161,205,269,449,28,19,7,108,244,12,20,0,0
3129,161,205,269,449,28,19,7,108,244,13,20,0,0
3130,167,211,272,451,28,19,7,105,240,14,20,0,0
3131,167,213,269,450,28,19,7,102,237,15,20,0,0
3132,167,213,268,449,28,19,7,101,236,16,20,0,0
3133,166,218,266,447,28,19,7,100,229,17,20,0,0
3134,168,211,273,453,28,19,7,105,242,18,20,0,0
3135,170,214,272,453,28,19,7,102,239,19,20,0,0
3136,171,214,273,453,28,19,7,102,239,20,20,1,0
3141,172,216,273,448,28,19,7,101,232,0,20,0,0
3142,173,221,273,449,28,19,7,100,228,1,20,0,0
3143,172,217,273,446,28,19,7,101,229,2,20,0,0
3144,167,213,270,447,28,19,7,103,234,3,20,0,0
3145,166,212,269,447,28,19,7,103,235,4,20,0,0
3146,165,212,269,447,28,19,7,104,235,5,20,0,0
3151,171,218,272,451,28,19,7,101,233,0,20,0,0
3152,172,218,271,450,28,19,7,99,232,1,20,0,0
3153,171,216,271,450,28,19,7,100,234,2,20,0,0
3154,165,221,263,445,28,19,7,98,224,3,20,0,0
3155,166,217,265,447,28,19,7,99,230,4,20,0,0
3156,170,212,270,444,28,19,7,100,232,5,20,0,0
3157,172,213,272,448,28,19,7,100,235,6,20,0,0
3158,172,209,273,446,28,19,7,101,237,7,20,0,0
3159,168,218,266,445,28,19,7,98,227,8,20,0,0
3160,171,211,272,445,28,19,7,101,234,9,20,0,0
3161,169,202,274,448,28,19,7,105,246,10,20,0,0
3162,168,199,275,453,28,19,7,107,254,11,20,0,0
3163,168,207,271,450,28,19,7,103,243,12,20,0,0
3164,170,202,273,449,28,19,7,103,247,13,20,0,0
3165,171,203,273,449,28,19,7,102,246,14,20,0,0
3166,171,202,274,449,28,19,7,103,247,15,20,0,0
3176,173,211,272,453,28,19,7,99,242,0,20,0,0
3177,173,211,272,454,28,19,7,99,243,1,20,0,0
3178,171,226,266,454,28,19,7,95,228,2,20,0,0
3179,171,216,269,454,28,19,7,98,238,3,20,0,0
3180,170,210,271,455,28,19,7,101,245,4,20,0,0
3181,167,218,264,449,28,19,7,97,231,5,20,0,0
3182,165,221,262,446,28,19,7,97,225,6,20,0,0
3183,167,218,268,449,28,19,7,101,231,7,20,0,0
3184,167,214,271,451,28,19,7,104,237,8,20,0,0
3185,164,218,266,447,28,19,7,102,229,9,20,0,0
3186,164,218,266,446,28,19,7,102,228,10,20,0,0
3221,163,225,274,452,29,19,7,111,227,0,0,0,0
3225,164,220,273,454,30,19,7,109,234,0,0,0,0
3252,167,209,261,449,31,19,7,94,240,0,5,0,0
3253,167,209,261,449,31,19,7,94,240,1,5,0,0
3254,165,206,260,448,31,19,7,95,242,2,5,0,0
3255,165,204,260,447,31,19,7,95,243,3,5,0,0
3261,169,212,261,448,31,19,7,92,236,0,5,0,0
3262,169,215,260,447,31,19,7,91,232,1,5,0,0
3263,169,212,261,448,31,19,7,92,236,2,5,0,0
3264,170,212,261,448,31,19,7,91,236,3,5,0,0
3265,170,212,261,448,31,19,7,91,236,4,5,0,0
3266,170,212,261,448,31,19,7,91,236,5,5,0,0
3271,176,228,263,448,31,19,7,87,220,0,5,0,0
3272,180,239,261,446,31,19,7,81,207,1,5,0,0
3273,177,232,264,448,31,19,7,87,216,2,5,0,0
3274,178,233,264,448,31,19,7,86,215,3,5,0,0
3281,175,209,269,444,31,19,7,94,235,0,5,0,0
3282,174,209,269,443,31,19,7,95,234,1,5,0,0
3283,174,208,270,442,31,19,7,96,234,2,5,0,0
3310,178,216,272,452,31,19,7,94,236,0,5,0,0
3311,178,217,272,453,31,19,7,94,236,1,5,0,0
3336,165,222,263,445,31,19,7,98,223,0,5,0,0
3337,165,222,262,444,31,19,7,97,222,1,5,0,0
3338,170,217,271,447,31,19,7,101,230,2,5,0,0
3339,171,218,270,449,31,19,7,99,231,3,5,0,0
3340,171,218,271,449,31,19,7,100,231,4,5,0,0
3301,287,313,353,495,32,19,7,66,182,0,0,0,0
3368,286,316,352,494,33,19,7,66,178,0,0,0,0
3376,174,225,270,447,34,19,7,96,222,0,0,0,0
3381,285,320,351,493,35,19,7,66,173,0,0,0,0
3384,279,323,353,492,36,19,7,74,169,0,1,0,0
3385,278,315,356,493,36,19,7,78,178,1,1,0,0
3390,176,219,267,454,37,19,7,91,235,0,0,0,0
3461,185,239,265,449,38,19,7,80,210,0,1,0,0
3462,185,231,270,453,38,19,7,85,222,1,1,0,0
3476,185,228,270,453,39,19,7,85,225,0,0,0,0
3506,290,309,351,494,40,19,7,61,185,0,0,0,0
3506,176,210,267,445,41,19,7,91,235,0,1,0,0
3507,180,216,269,444,41,19,7,89,228,1,1,0,0
3510,157,218,266,446,42,19,7,109,228,0,27,0,0
3511,159,207,274,449,42,19,7,115,242,1,27,0,0
3512,158,202,275,448,42,19,7,117,246,2,27,0,0
3513,159,196,277,448,42,19,7,118,252,3,27,0,0
3514,161,202,275,449,42,19,7,114,247,4,27,0,0
3515,161,201,276,449,42,19,7,115,248,5,27,0,0
3518,165,222,270,447,42,19,7,105,225,0,27,0,0
3519,166,209,277,450,42,19,7,111,241,1,27,0,0
3520,168,219,274,451,42,19,7,106,232,2,27,0,0
3521,169,220,275,451,42,19,7,106,231,3,27,0,0
3531,168,215,272,446,42,19,7,104,231,0,27,0,1
3532,165,219,268,445,42,19,7,103,226,1,27,0,0
3533,165,220,268,445,42,19,7,103,225,2,27,0,0
3534,166,218,268,448,42,19,7,102,230,3,27,0,0
3535,166,218,268,448,42,19,7,102,230,4,27,0,0
3536,167,201,275,448,42,19,7,108,247,5,27,0,0
3537,166,201,272,448,42,19,7,106,247,6,27,0,0
3538,167,206,269,448,42,19,7,102,242,7,27,0,0
3539,169,199,274,449,42,19,7,105,250,8,27,0,0
3540,168,205,269,448,42,19,7,101,243,9,27,0,0
3541,168,214,265,448,42,19,7,97,234,10,27,0,0
3542,168,217,264,448,42,19,7,96,231,11,27,0,0
3543,170,219,264,448,42,19,7,94,229,12,27,0,0
3544,168,218,263,448,42,19,7,95,230,13,27,0,0
3545,168,221,264,450,42,19,7,96,229,14,27,0,0
3546,166,211,265,446,42,19,7,99,235,15,27,0,0
3547,165,210,265,446,42,19,7,100,236,16,27,0,0
3548,161,202,264,446,42,19,7,103,244,17,27,0,0
3549,160,201,264,446,42,19,7,104,245,18,27,0,0
3550,164,209,265,446,42,19,7,101,237,19,27,0,0
3551,171,218,270,451,42,19,7,99,233,20,27,0,0
3552,174,222,272,451,42,19,7,98,229,21,27,0,0
3553,173,220,271,449,42,19,7,98,229,22,27,0,0
3554,174,219,271,449,42,19,7,97,230,23,27,0,0
3555,172,217,272,453,42,19,7,100,236,24,27,0,0
3556,173,217,272,453,42,19,7,99,236,25,27,0,0
3557,169,208,268,447,42,19,7,99,239,26,27,0,0
3558,169,207,268,446,42,19,7,99,239,27,27,1,0
3561,159,205,258,445,42,19,7,99,240,0,27,0,0
3562,158,205,257,445,42,19,7,99,240,1,27,0,0
3563,160,206,261,447,42,19,7,101,241,2,27,0,0
3564,158,214,257,443,42,19,7,99,229,3,27,0,0
3565,155,216,253,439,42,19,7,98,223,4,27,0,0
3566,159,212,262,445,42,19,7,103,233,5,27,0,0
3567,160,210,265,447,42,19,7,105,237,6,27,0,0
3568,161,210,266,447,42,19,7,105,237,7,27,0,0
3569,161,208,266,448,42,19,7,105,240,8,27,0,0
3570,161,211,265,448,42,19,7,104,237,9,27,0,0
3571,161,211,265,448,42,19,7,104,237,10,27,0,0
3573,168,217,272,449,42,19,7,104,232,0,27,0,0
3574,169,218,272,450,42,19,7,103,232,1,27,0,0
3576,168,214,273,448,42,19,7,105,234,0,27,0,0
3577,169,214,274,448,42,19,7,105,234,1,27,0,0
3512,280,241,364,488,43,19,7,84,247,0,0,0,0
3516,285,310,354,496,44,19,7,69,186,0,1,0,0
3517,285,311,353,495,44,19,7,68,184,1,1,0,0
3520,284,310,353,495,45,19,7,69,185,0,0,0,0
3535,289,323,357,496,46,19,7,68,173,0,11,0,0
3536,285,313,357,496,46,19,7,72,183,1,11,0,0
3537,283,310,356,497,46,19,7,73,187,2,11,0,0
3538,282,307,356,497,46,19,7,74,190,3,11,0,0
3539,279,287,359,491,46,19,7,80,204,4,11,0,0
3540,283,303,357,494,46,19,7,74,191,5,11,0,0
3541,283,305,357,495,46,19,7,74,190,6,11,0,0
3542,285,310,356,495,46,19,7,71,185,7,11,0,0
3543,283,309,355,496,46,19,7,72,187,8,11,0,0
3544,276,264,363,492,46,19,7,87,228,9,11,0,0
3545,279,285,359,495,46,19,7,80,210,10,11,0,0
3546,278,281,359,495,46,19,7,81,214,11,11,0,0
3567,284,302,355,494,46,19,7,71,192,0,11,0,0
3568,284,303,355,494,46,19,7,71,191,1,11,0,0
3617,163,228,272,448,47,19,7,109,220,0,0,0,0
3621,171,219,263,446,48,19,7,92,227,0,0,0,0
3626,175,208,267,446,49,19,7,92,238,0,15,0,0
3627,174,207,268,450,49,19,7,94,243,1,15,0,0
3628,174,209,267,448,49,19,7,93,239,2,15,0,0
3629,174,210,267,448,49,19,7,93,238,3,15,0,0
3631,174,215,266,449,49,19,7,92,234,0,15,0,0
3632,177,225,265,450,49,19,7,88,225,1,15,0,0
3633,179,227,267,450,49,19,7,88,223,2,15,0,0
3634,179,221,269,448,49,19,7,90,227,3,15,0,0
3635,179,220,271,453,49,19,7,92,233,4,15,0,0
3636,179,223,270,450,49,19,7,91,227,5,15,0,0
3637,180,225,270,450,49,19,7,90,225,6,15,0,0
3639,176,214,270,446,49,19,7,94,232,0,15,0,0
3640,176,214,270,446,49,19,7,94,232,1,15,0,0
3658,181,228,269,450,49,19,7,88,222,0,15,0,0
3659,181,229,269,451,49,19,7,88,222,1,15,0,0
3661,173,225,265,445,49,19,7,92,220,0,15,0,0
3662,172,219,269,445,49,19,7,97,226,1,15,0,0
3663,168,214,267,446,49,19,7,99,232,2,15,0,0
3664,169,209,270,445,49,19,7,101,236,3,15,0,0
3665,169,206,273,446,49,19,7,104,240,4,15,0,0
3666,169,205,273,446,49,19,7,104,241,5,15,0,0
3667,177,232,272,448,49,19,7,95,216,6,15,0,0
3668,178,233,272,448,49,19,7,94,215,7,15,0,0
3676,170,214,271,449,49,19,7,101,235,0,15,0,0
3677,170,213,271,450,49,19,7,101,237,1,15,0,0
3700,180,230,272,450,49,19,7,92,220,0,15,0,0
3701,176,224,270,445,49,19,7,94,221,1,15,0,0
3702,175,226,270,448,49,19,7,95,222,2,15,0,0
3703,178,226,271,449,49,19,7,93,223,3,15,0,0
3704,177,224,271,445,49,19,7,94,221,4,15,0,0
3705,174,223,271,444,49,19,7,97,221,5,15,0,0
3706,174,223,271,443,49,19,7,97,220,6,15,0,0
3717,164,227,262,444,49,19,7,98,217,0,15,0,0
3718,164,228,261,444,49,19,7,97,216,1,15,0,0
3719,166,220,268,445,49,19,7,102,225,2,15,0,0
3720,165,220,268,445,49,19,7,103,225,3,15,0,0
3731,172,216,275,451,49,19,7,103,235,0,15,0,0
3732,172,216,275,452,49,19,7,103,236,1,15,0,0
3733,169,212,275,450,49,19,7,106,238,2,15,0,0
3734,169,222,272,448,49,19,7,103,226,3,15,0,0
3735,169,222,272,448,49,19,7,103,226,4,15,0,0
3746,173,226,273,450,49,19,7,100,224,0,15,0,0
3747,173,226,273,451,49,19,7,100,225,1,15,0,0
3748,170,219,269,447,49,19,7,99,228,2,15,0,0
3749,169,219,268,447,49,19,7,99,228,3,15,0,0
3758,167,203,268,446,49,19,7,101,243,0,15,0,0
3759,168,204,267,446,49,19,7,99,242,1,15,0,0
3760,169,203,266,446,49,19,7,97,243,2,15,0,0
3761,169,202,266,446,49,19,7,97,244,3,15,0,0
3767,172,203,270,446,49,19,7,98,243,0,15,0,0
3768,172,203,271,445,49,19,7,99,242,1,15,0,0
3776,165,210,262,446,49,19,7,97,236,0,15,0,0
3777,168,210,265,446,49,19,7,97,236,1,15,0,0
3778,166,211,264,447,49,19,7,98,236,2,15,0,0
3779,161,216,260,444,49,19,7,99,228,3,15,0,0
3780,163,213,263,446,49,19,7,100,233,4,15,0,0
3781,169,216,269,447,49,19,7,100,231,5,15,0,0
3782,172,217,271,448,49,19,7,99,231,6,15,0,0
3783,176,223,272,450,49,19,7,96,227,7,15,0,0
3784,178,226,273,452,49,19,7,95,226,8,15,0,0
3785,176,219,273,454,49,19,7,97,235,9,15,0,0
3786,169,201,271,450,49,19,7,102,249,10,15,0,0
3787,163,206,265,448,49,19,7,102,242,11,15,0,0
3788,161,209,263,447,49,19,7,102,238,12,15,0,0
3789,160,209,263,447,49,19,7,103,238,13,15,0,0
3790,158,213,259,443,49,19,7,101,230,14,15,0,0
3791,158,213,258,442,49,19,7,100,229,15,15,0,0
3803,268,222,381,490,49,19,7,113,268,0,15,0,0
3804,275,223,389,492,49,19,7,114,269,1,15,0,0
3816,188,230,279,454,49,19,7,91,224,0,15,0,0
3817,184,230,275,452,49,19,7,91,222,1,15,0,0
3733,274,228,374,492,50,19,7,100,264,0,1,0,0
3734,274,230,372,490,50,19,7,98,260,1,1,0,0
3769,284,306,354,494,51,19,7,70,188,0,0,0,0
3778,1631,23,1726,240,52,19,7,95,217,0,0,0,0
3780,1632,24,1725,250,53,19,7,93,226,0,0,0,0
3781,287,295,354,495,54,19,7,67,200,0,0,0,0
3783,287,300,354,496,55,19,7,67,196,0,9,0,0
3784,288,305,352,494,55,19,7,64,189,1,9,0,0
3785,286,296,354,494,55,19,7,68,198,2,9,0,0
3786,278,239,364,490,55,19,7,86,251,3,9,0,0
3787,275,217,368,488,55,19,7,93,271,4,9,0,0
3788,276,224,366,488,55,19,7,90,264,5,9,0,0
3789,273,207,369,487,55,19,7,96,280,6,9,0,0
3806,289,305,355,492,55,19,7,66,187,0,9,0,0
3807,288,311,354,493,55,19,7,66,182,1,9,0,0
3808,289,314,353,494,55,19,7,64,180,2,9,0,0
3809,287,312,353,493,55,19,7,66,181,3,9,0,0
3810,287,316,353,493,55,19,7,66,177,4,9,0,0
3811,287,318,352,492,55,19,7,65,174,5,9,0,0
3816,285,304,356,494,55,19,7,71,190,0,9,0,0
3817,285,304,356,495,55,19,7,71,191,1,9,0,0
3820,286,307,355,494,55,19,7,69,187,0,9,0,0
3821,285,307,355,494,55,19,7,70,187,1,9,0,0
3825,286,312,353,494,55,19,7,67,182,0,9,0,0
3826,285,312,352,494,55,19,7,67,182,1,9,0,0
3831,282,316,350,493,55,19,7,68,177,0,9,0,0
3832,282,317,350,492,55,19,7,68,175,1,9,0,0
3833,284,314,354,493,55,19,7,70,179,2,9,0,0
3834,284,315,354,495,55,19,7,70,180,3,9,0,0
3835,284,314,355,495,55,19,7,71,181,4,9,0,0
3836,284,314,355,495,55,19,7,71,181,5,9,0,0
3851,286,310,358,495,55,19,7,72,185,0,9,0,0
3852,286,309,358,495,55,19,7,72,186,1,9,0,0
3856,284,310,355,495,55,19,7,71,185,0,9,0,0
3857,282,307,354,495,55,19,7,72,188,1,9,0,0
3858,282,309,353,495,55,19,7,71,186,2,9,0,0
3859,283,309,353,494,55,19,7,70,185,3,9,0,0
3860,282,307,353,494,55,19,7,71,187,4,9,0,0
3861,280,262,365,491,55,19,7,85,229,5,9,0,0
3862,283,285,360,494,55,19,7,77,209,6,9,0,0
3863,283,282,361,494,55,19,7,78,212,7,9,0,0
3864,278,248,367,490,55,19,7,89,242,8,9,0,0
3865,277,242,368,490,55,19,7,91,248,9,9,0,0
3876,284,302,354,494,55,19,7,70,192,0,9,0,0
3877,285,306,353,495,55,19,7,68,189,1,9,0,0
3878,286,308,352,495,55,19,7,66,187,2,9,0,0
3879,286,308,352,495,55,19,7,66,187,3,9,0,0
3880,286,310,352,496,55,19,7,66,186,4,9,0,0
3889,190,230,270,453,55,19,7,80,223,0,9,0,0
3890,183,225,263,450,55,19,7,80,225,1,9,0,0
3916,172,210,262,450,55,19,7,90,240,0,9,0,0
3917,167,210,262,449,55,19,7,95,239,1,9,0,0
3918,162,209,262,447,55,19,7,100,238,2,9,0,0
3919,166,214,262,446,55,19,7,96,232,3,9,0,0
3920,166,215,263,447,55,19,7,97,232,4,9,0,0
3921,166,215,263,447,55,19,7,97,232,5,9,0,0
3936,177,226,270,450,55,19,7,93,224,0,9,0,0
3937,170,226,264,445,55,19,7,94,219,1,9,0,0
3938,172,217,271,449,55,19,7,99,232,2,9,0,0
3939,166,218,266,445,55,19,7,100,227,3,9,0,0
3940,171,222,270,449,55,19,7,99,227,4,9,0,0
3941,171,222,270,449,55,19,7,99,227,5,9,0,0
3791,1630,21,1728,238,56,19,7,98,217,0,0,0,0
3805,1630,22,1727,242,57,19,7,97,220,0,0,0,0
3851,161,227,271,448,58,19,7,110,221,0,1,0,0
3852,172,230,282,453,58,19,7,110,223,1,1,0,0
3864,168,210,266,449,59,19,7,98,239,0,0,0,0
3976,159,218,271,445,60,19,7,112,227,0,0,0,0
3996,167,214,271,450,61,19,7,104,236,0,1,0,0
3997,168,216,271,450,61,19,7,103,234,1,1,0,0
3999,171,211,271,452,62,19,7,100,241,0,1,0,0
4000,171,213,270,451,62,19,7,99,238,1,1,0,0
4016,170,216,257,445,63,19,7,87,229,0,1,0,0
4017,168,222,251,442,63,19,7,83,220,1,1,0,0
4054,174,218,268,451,64,19,7,94,233,0,1,0,0
4055,177,222,269,451,64,19,7,92,229,1,1,0,0
4058,162,216,267,448,65,19,7,105,232,0,0,0,0
4060,155,220,270,444,66,19,7,115,224,0,0,0,0
4068,177,219,268,448,67,19,7,91,229,0,1,0,0
4069,174,218,264,443,67,19,7,90,225,1,1,0,0
4088,172,210,263,444,68,19,7,91,234,0,0,0,0
4091,178,221,266,450,69,19,7,88,229,0,5,0,0
4092,176,220,261,441,69,19,7,85,221,1,5,0,0
4093,177,219,265,446,69,19,7,88,227,2,5,0,0
4094,176,217,265,449,69,19,7,89,232,3,5,0,0
4095,176,216,266,450,69,19,7,90,234,4,5,0,0
4096,176,216,267,451,69,19,7,91,235,5,5,0,0
4111,172,210,265,442,69,19,7,93,232,0,5,0,0
4112,170,212,265,444,69,19,7,95,232,1,5,0,0
4113,165,201,265,446,69,19,7,100,245,2,5,0,0
4114,164,199,265,446,69,19,7,101,247,3,5,0,0
4137,169,218,268,447,69,19,7,99,229,0,5,0,0
4138,170,222,267,445,69,19,7,97,223,1,5,0,0
4139,171,223,267,445,69,19,7,96,222,2,5,0,0
4145,166,208,265,444,69,19,7,99,236,0,5,0,0
4146,162,217,261,442,69,19,7,99,225,1,5,0,0
4147,161,217,260,441,69,19,7,99,224,2,5,0,0
4156,174,222,271,450,69,19,7,97,228,0,5,0,0
4157,174,223,272,451,69,19,7,98,228,1,5,0,0
4116,286,310,352,491,70,19,7,66,181,0,0,0,0
4123,286,310,356,495,71,19,7,70,185,0,0,0,0
4190,168,207,263,446,72,19,7,95,239,0,0,0,0
4191,284,233,370,489,73,19,7,86,256,0,0,0,0
4206,164,214,262,447,74,19,7,98,233,0,5,0,0
4207,160,214,257,444,74,19,7,97,230,1,5,0,0
4208,161,206,262,447,74,19,7,101,241,2,5,0,0
4209,161,206,264,448,74,19,7,103,242,3,5,0,0
4210,160,201,264,449,74,19,7,104,248,4,5,0,0
4211,159,198,266,450,74,19,7,107,252,5,5,0,0
4222,176,222,272,452,74,19,7,96,230,0,5,0,0
4223,177,224,272,452,74,19,7,95,228,1,5,0,0
4236,170,209,268,448,74,19,7,98,239,0,5,0,0
4237,169,208,268,447,74,19,7,99,239,1,5,0,0
4238,166,207,267,447,74,19,7,101,240,2,5,0,0
4239,167,211,267,446,74,19,7,100,235,3,5,0,0
4240,166,210,267,446,74,19,7,101,236,4,5,0,0
4212,288,306,355,496,75,19,7,67,190,0,1,0,0
4213,287,304,354,495,75,19,7,67,191,1,1,0,0
4276,165,217,262,447,76,19,7,97,230,0,21,0,0
4277,165,216,262,447,76,19,7,97,231,1,21,0,0
4278,166,216,263,447,76,19,7,97,231,2,21,0,0
4279,166,216,263,448,76,19,7,97,232,3,21,0,0
4301,172,219,267,447,76,19,7,95,228,0,21,0,0
4302,173,220,267,446,76,19,7,94,226,1,21,0,0
4317,156,212,259,444,76,19,7,103,232,0,21,0,0
4318,160,213,262,446,76,19,7,102,233,1,21,0,0
4319,160,212,262,446,76,19,7,102,234,2,21,0,0
4320,160,212,263,446,76,19,7,103,234,3,21,0,0
4321,159,212,263,446,76,19,7,104,234,4,21,0,0
4326,159,193,267,446,76,19,7,108,253,0,21,0,0
4327,158,191,267,446,76,19,7,109,255,1,21,0,0
4337,165,206,265,445,76,19,7,100,239,0,21,0,0
4338,165,207,265,444,76,19,7,100,237,1,21,0,0
4348,165,211,264,447,76,19,7,99,236,0,21,0,1
4349,165,211,264,448,76,19,7,99,237,1,21,0,0
4350,167,209,265,448,76,19,7,98,239,2,21,0,0
4351,167,212,263,447,76,19,7,96,235,3,21,0,0
4352,167,213,263,447,76,19,7,96,234,4,21,0,0
4353,168,215,262,447,76,19,7,94,232,5,21,0,0
4354,168,216,262,447,76,19,7,94,231,6,21,0,0
4355,170,210,266,447,76,19,7,96,237,7,21,0,0
4356,169,214,262,446,76,19,7,93,232,8,21,0,0
4357,169,218,261,446,76,19,7,92,228,9,21,0,0
4358,168,217,260,446,76,19,7,92,229,10,21,0,0
4359,168,218,260,445,76,19,7,92,227,11,21,0,0
4360,167,217,261,446,76,19,7,94,229,12,21,0,0
4361,167,217,260,446,76,19,7,93,229,13,21,0,0
4362,169,218,262,446,76,19,7,93,228,14,21,0,0
4363,166,213,261,446,76,19,7,95,233,15,21,0,0
4364,169,215,265,449,76,19,7,96,234,16,21,0,0
4365,170,215,266,449,76,19,7,96,234,17,21,0,0
4366,170,215,264,445,76,19,7,94,230,18,21,0,0
4367,170,215,264,445,76,19,7,94,230,19,21,0,0
4368,170,213,264,443,76,19,7,94,230,20,21,0,0
4369,170,213,264,443,76,19,7,94,230,21,21,1,0
4371,165,197,265,444,76,19,7,100,247,0,21,0,0
4372,165,202,263,444,76,19,7,98,242,1,21,0,0
4373,165,203,263,445,76,19,7,98,242,2,21,0,0
4374,164,203,263,446,76,19,7,99,243,3,21,0,0
4400,167,218,258,433,76,19,7,91,215,0,21,0,0
4401,167,219,258,432,76,19,7,91,213,1,21,0,0
4406,170,216,270,446,76,19,7,100,230,0,21,0,0
4407,171,217,270,446,76,19,7,99,229,1,21,0,0
4408,171,217,269,447,76,19,7,98,230,2,21,0,0
4409,169,219,267,447,76,19,7,98,228,3,21,0,0
4410,169,219,268,447,76,19,7,99,228,4,21,0,0
4411,169,220,268,448,76,19,7,99,228,5,21,0,0
4422,160,203,264,443,76,19,7,104,240,0,21,0,0
4423,160,202,264,443,76,19,7,104,241,1,21,0,0
4425,171,207,273,449,76,19,7,102,242,0,21,0,0
4426,171,207,274,450,76,19,7,103,243,1,21,0,0
4456,1626,30,1711,222,77,19,7,85,192,0,0,0,0
4459,1626,30,1711,222,78,19,7,85,192,0,1,0,0
4460,1625,28,1710,222,78,19,7,85,194,1,1,0,0
4481,166,211,267,445,79,19,7,101,234,0,6,0,0
4482,165,209,267,445,79,19,7,102,236,1,6,0,0
4483,168,211,269,446,79,19,7,101,235,2,6,0,0
4484,171,219,268,445,79,19,7,97,226,3,6,0,0
4485,170,216,270,446,79,19,7,100,230,4,6,0,0
4486,168,212,268,444,79,19,7,100,232,5,6,0,0
4487,168,212,268,443,79,19,7,100,231,6,6,0,0
4496,167,213,267,446,79,19,7,100,233,0,6,0,0
4497,166,213,266,446,79,19,7,100,233,1,6,0,0
4511,172,220,266,444,79,19,7,94,224,0,6,0,0
4512,172,217,265,444,79,19,7,93,227,1,6,0,0
4513,172,217,265,444,79,19,7,93,227,2,6,0,0
4516,164,204,265,447,79,19,7,101,243,0,6,0,0
4517,165,208,263,446,79,19,7,98,238,1,6,0,0
4518,165,204,265,447,79,19,7,100,243,2,6,0,0
4519,164,203,265,447,79,19,7,101,244,3,6,0,0
4520,165,201,266,447,79,19,7,101,246,4,6,0,0
4521,164,200,266,447,79,19,7,102,247,5,6,0,0
4531,163,208,262,448,79,19,7,99,240,0,6,0,0
4532,163,208,262,448,79,19,7,99,240,1,6,0,0
4533,163,214,259,441,79,19,7,96,227,2,6,0,0
4534,165,213,263,445,79,19,7,98,232,3,6,0,0
4535,167,213,264,447,79,19,7,97,234,4,6,0,0
4536,167,214,265,447,79,19,7,98,233,5,6,0,0
4541,163,213,261,446,79,19,7,98,233,0,6,0,0
4542,163,213,261,446,79,19,7,98,233,1,6,0,0
4551,167,215,264,447,79,19,7,97,232,0,6,0,0
4552,168,213,265,448,79,19,7,97,235,1,6,0,0
4553,165,211,261,445,79,19,7,96,234,2,6,0,0
4554,166,209,263,446,79,19,7,97,237,3,6,0,0
4555,161,208,257,443,79,19,7,96,235,4,6,0,0
4556,160,208,257,443,79,19,7,97,235,5,6,0,0
4571,161,218,257,440,79,19,7,96,222,0,6,0,0
4572,161,219,257,440,79,19,7,96,221,1,6,0,0
4573,164,213,263,445,79,19,7,99,232,2,6,0,0
4574,162,209,261,444,79,19,7,99,235,3,6,0,0
4575,162,209,261,444,79,19,7,99,235,4,6,0,0
4578,165,213,266,450,79,19,7,101,237,0,6,0,0
4579,166,213,266,451,79,19,7,100,238,1,6,0,0
4592,155,192,260,442,79,19,7,105,250,0,6,0,0
4593,155,191,260,441,79,19,7,105,250,1,6,0,0
4594,153,186,259,441,79,19,7,106,255,2,6,0,0
4595,152,185,259,440,79,19,7,107,255,3,6,0,0
4600,169,212,265,443,79,19,7,96,231,0,6,0,0
4601,170,213,265,443,79,19,7,95,230,1,6,0,0
4607,174,219,268,447,79,19,7,94,228,0,6,0,0
4608,169,213,267,445,79,19,7,98,232,1,6,0,0
4609,166,212,267,446,79,19,7,101,234,2,6,0,0
4610,166,212,267,446,79,19,7,101,234,3,6,0,0
4534,285,237,370,494,80,19,7,85,257,0,1,0,0
4535,281,214,373,491,80,19,7,92,277,1,1,0,0
4578,289,308,357,495,81,19,7,68,187,0,1,0,0
4579,289,307,357,495,81,19,7,68,188,1,1,0,0
4646,163,203,262,446,82,19,7,99,243,0,7,0,0
4647,164,206,262,447,82,19,7,98,241,1,7,0,0
4648,163,202,264,449,82,19,7,101,247,2,7,0,0
4649,164,203,264,448,82,19,7,100,245,3,7,0,0
4650,164,204,264,449,82,19,7,100,245,4,7,0,0
4651,164,204,265,450,82,19,7,101,246,5,7,0,0
4652,170,213,266,445,82,19,7,96,232,6,7,0,0
4653,171,214,266,444,82,19,7,95,230,7,7,0,0
4660,164,202,264,446,82,19,7,100,244,0,7,0,0
4661,164,202,264,446,82,19,7,100,244,1,7,0,0
4696,173,219,262,442,83,19,7,89,223,0,1,0,0
4697,172,220,260,441,83,19,7,88,221,1,1,0,0
4710,168,207,266,446,84,19,7,98,239,0,0,0,0
4713,174,214,263,446,85,19,7,89,232,0,3,0,0
4714,171,210,261,446,85,19,7,90,236,1,3,0,0
4715,167,199,262,446,85,19,7,95,247,2,3,0,0
4716,166,195,262,446,85,19,7,96,251,3,3,0,0
4762,178,220,270,450,86,19,7,92,230,0,0,0,0
4779,147,220,265,443,87,19,7,118,223,0,0,0,0
4783,156,227,267,441,88,19,7,111,214,0,0,0,0
4791,146,222,270,444,89,19,7,124,222,0,5,0,0
4792,154,219,275,436,89,19,7,121,217,1,5,0,0
4793,155,219,270,426,89,19,7,115,207,2,5,0,0
4794,156,219,269,422,89,19,7,113,203,3,5,0,0
4795,154,219,278,442,89,19,7,124,223,4,5,0,0
4796,155,218,280,444,89,19,7,125,226,5,5,0,0
4800,163,222,286,450,89,19,7,123,228,0,5,0,0
4801,164,222,288,451,89,19,7,124,229,1,5,0,0
4852,154,225,269,443,90,19,7,115,218,0,0,0,0
4856,153,220,268,444,91,19,7,115,224,0,0,0,0
4881,176,222,267,444,92,19,7,91,222,0,1,0,0
4882,174,217,267,444,92,19,7,93,227,1,1,0,0
4885,175,221,268,445,93,19,7,93,224,0,0,0,0
4894,164,217,276,443,94,19,7,112,226,0,0,0,0
4910,166,219,266,443,95,19,7,100,224,0,0,0,0
4925,162,212,276,442,96,19,7,114,230,0,0,0,0
4931,155,214,272,442,97,19,7,117,228,0,1,0,0
4932,160,214,276,442,97,19,7,116,228,1,1,0,0
4935,176,219,270,449,98,19,7,94,230,0,0,0,0
4956,149,219,271,444,99,19,7,122,225,0,1,0,0
4957,151,225,268,443,99,19,7,117,218,1,1,0,0
4966,163,211,265,446,100,19,7,102,235,0,5,0,0
4967,163,211,265,445,100,19,7,102,234,1,5,0,0
4968,166,219,263,442,100,19,7,97,223,2,5,0,0
4969,168,215,267,442,100,19,7,99,227,3,5,0,0
4970,169,212,270,442,100,19,7,101,230,4,5,0,0
4971,171,212,271,442,100,19,7,100,230,5,5,0,0
4973,166,212,268,447,100,19,7,102,235,0,5,0,0
4974,165,212,268,448,100,19,7,103,236,1,5,0,0
4975,164,212,267,449,100,19,7,103,237,2,5,0,0
4976,164,211,267,449,100,19,7,103,238,3,5,0,0
4991,159,206,264,446,100,19,7,105,240,0,5,0,0
4992,159,205,264,446,100,19,7,105,241,1,5,0,0
5005,1712,643,1918,1065,101,19,7,206,422,0,0,0,0
5006,1427,593,1803,1060,102,19,7,376,467,0,1,0,0
5007,1313,561,1716,1065,102,19,7,403,504,1,1,0,0
5008,1020,551,1426,1080,103,19,7,406,529,0,19,0,1
5009,892,491,1338,1076,103,19,7,446,585,1,19,0,0
5010,750,457,1215,1073,103,19,7,465,616,2,19,0,0
5011,619,477,1064,1076,103,19,7,445,599,3,19,0,0
5012,460,432,926,1073,103,19,7,466,641,4,19,0,0
5013,361,418,832,1071,103,19,7,471,653,5,19,0,0
5014,279,396,737,1046,103,19,7,458,650,6,19,0,0
5015,213,381,649,1014,103,19,7,436,633,7,19,0,0
5016,158,356,587,990,103,19,7,429,634,8,19,0,0
5017,109,338,497,928,103,19,7,388,590,9,19,0,0
5018,75,333,442,905,103,19,7,367,572,10,19,0,0
5019,55,337,368,839,103,19,7,313,502,11,19,0,0
5020,38,337,321,805,103,19,7,283,468,12,19,0,0
5021,31,349,290,786,103,19,7,259,437,13,19,0,0
5022,4,336,237,735,103,19,7,233,399,14,19,0,0
5023,0,327,172,705,103,19,7,172,378,15,19,0,0
5024,0,313,172,681,103,19,7,172,368,16,19,0,0
5025,0,298,156,672,103,19,7,156,374,17,19,0,0
5026,0,327,139,670,103,19,7,139,343,18,19,0,0
5027,0,322,97,648,103,19,7,97,326,19,19,0,0
5087,168,192,271,444,104,19,7,103,252,0,1,0,0
5088,174,208,273,449,104,19,7,99,241,1,1,0,0
5090,166,178,276,444,105,19,7,110,266,0,11,0,0
5091,163,193,267,444,105,19,7,104,251,1,11,0,0
5092,160,200,262,445,105,19,7,102,245,2,11,0,0
5093,155,191,260,443,105,19,7,105,252,3,11,0,0
5094,157,187,266,446,105,19,7,109,259,4,11,0,0
5095,159,186,268,445,105,19,7,109,259,5,11,0,0
5096,164,194,271,446,105,19,7,107,252,6,11,0,0
5097,164,194,270,447,105,19,7,106,253,7,11,0,0
5098,164,199,267,445,105,19,7,103,246,8,11,0,0
5099,164,200,267,445,105,19,7,103,245,9,11,0,0
5100,166,210,264,443,105,19,7,98,233,10,11,0,0
5101,167,213,264,443,105,19,7,97,230,11,11,0,0
5106,161,212,261,445,105,19,7,100,233,0,11,0,0
5107,160,209,263,447,105,19,7,103,238,1,11,0,0
5108,160,208,264,446,105,19,7,104,238,2,11,0,0
5109,160,211,264,445,105,19,7,104,234,3,11,0,0
5110,163,215,265,443,105,19,7,102,228,4,11,0,0
5111,164,216,265,442,105,19,7,101,226,5,11,0,0
5125,168,221,266,441,105,19,7,98,220,0,11,0,0
5126,160,220,263,441,105,19,7,103,221,1,11,0,0
5127,160,220,263,441,105,19,7,103,221,2,11,0,0
5137,159,191,272,442,105,19,7,113,251,0,11,0,0
5138,160,193,270,442,105,19,7,110,249,1,11,0,0
5139,162,198,269,442,105,19,7,107,244,2,11,0,0
5140,162,196,269,442,105,19,7,107,246,3,11,0,0
5141,162,195,270,442,105,19,7,108,247,4,11,0,0
5145,174,219,273,449,105,19,7,99,230,0,11,0,0
5146,175,220,274,449,105,19,7,99,229,1,11,0,0
5161,171,214,272,449,105,19,7,101,235,0,11,0,0
5162,172,214,272,449,105,19,7,100,235,1,11,0,0
5163,173,215,272,449,105,19,7,99,234,2,11,0,0
5164,174,216,272,449,105,19,7,98,233,3,11,0,0
5181,177,225,271,449,105,19,7,94,224,0,11,0,0
5182,177,226,271,450,105,19,7,94,224,1,11,0,0
5186,177,219,272,450,105,19,7,95,231,0,11,0,0
5187,174,217,270,449,105,19,7,96,232,1,11,0,0
5188,176,218,271,449,105,19,7,95,231,2,11,0,0
5189,176,218,272,449,105,19,7,96,231,3,11,0,0
5196,169,216,263,444,105,19,7,94,228,0,11,0,0
5197,164,207,264,444,105,19,7,100,237,1,11,0,0
5198,166,205,267,444,105,19,7,101,239,2,11,0,0
5199,168,214,265,443,105,19,7,97,229,3,11,0,0
5200,168,214,265,443,105,19,7,97,229,4,11,0,0
5090,282,202,378,489,106,19,7,96,287,0,0,0,0
5244,167,206,267,443,107,19,7,100,237,0,0,0,0
5302,172,212,273,445,108,19,7,101,233,0,0,0,0
5308,167,219,264,441,109,19,7,97,222,0,7,0,0
5309,165,216,264,441,109,19,7,99,225,1,7,0,0
5310,167,219,264,441,109,19,7,97,222,2,7,0,0
5311,167,219,264,442,109,19,7,97,223,3,7,0,0
5312,167,214,268,444,109,19,7,101,230,4,7,0,0
5313,168,213,269,445,109,19,7,101,232,5,7,0,0
5315,168,220,266,442,109,19,7,98,222,0,7,0,0
5316,168,220,266,442,109,19,7,98,222,1,7,0,0
5327,169,212,271,444,109,19,7,102,232,0,7,0,0
5328,169,211,271,445,109,19,7,102,234,1,7,0,0
5331,171,217,272,448,109,19,7,101,231,0,7,0,0
5332,172,220,271,449,109,19,7,99,229,1,7,0,0
5333,173,218,272,450,109,19,7,99,232,2,7,0,0
5334,173,218,272,451,109,19,7,99,233,3,7,0,0
5335,174,220,271,450,109,19,7,97,230,4,7,0,0
5336,175,220,271,450,109,19,7,96,230,5,7,0,0
5351,166,216,261,441,109,19,7,95,225,0,7,0,0
5352,166,215,261,440,109,19,7,95,225,1,7,0,0
5353,167,215,264,440,109,19,7,97,225,2,7,0,0
5354,160,210,259,440,109,19,7,99,230,3,7,0,0
5355,159,209,259,440,109,19,7,100,231,4,7,0,0
5356,163,208,265,438,109,19,7,102,230,5,7,0,0
5357,162,207,265,437,109,19,7,103,230,6,7,0,0
5359,166,216,267,442,109,19,7,101,226,0,7,0,0
5360,169,216,271,447,109,19,7,102,231,1,7,0,0
5361,170,215,271,444,109,19,7,101,229,2,7,0,0
5362,169,215,269,444,109,19,7,100,229,3,7,0,0
5363,169,215,270,444,109,19,7,101,229,4,7,0,0
5374,162,215,262,443,109,19,7,100,228,0,7,0,0
5375,161,215,261,443,109,19,7,100,228,1,7,0,0
5384,169,215,270,445,109,19,7,101,230,0,7,0,0
5385,169,216,270,446,109,19,7,101,230,1,7,0,0
5386,165,208,269,446,109,19,7,104,238,2,7,0,0
5387,165,207,269,446,109,19,7,104,239,3,7,0,0
5389,159,203,264,444,109,19,7,105,241,0,7,0,0
5390,157,195,265,445,109,19,7,108,250,1,7,0,0
5391,159,207,263,442,109,19,7,104,235,2,7,0,0
5392,166,215,268,446,109,19,7,102,231,3,7,0,0
5393,169,221,269,446,109,19,7,100,225,4,7,0,0
5394,170,218,271,447,109,19,7,101,229,5,7,0,0
5395,169,219,270,447,109,19,7,101,228,6,7,0,0
5396,169,220,270,447,109,19,7,101,227,7,7,0,0
5406,160,208,268,448,109,19,7,108,240,0,7,0,0
5407,167,212,273,448,109,19,7,106,236,1,7,0,0
5408,168,214,273,449,109,19,7,105,235,2,7,0,0
5409,169,214,273,449,109,19,7,104,235,3,7,0,0
5410,166,210,270,443,109,19,7,104,233,4,7,0,0
5411,166,210,270,442,109,19,7,104,232,5,7,0,0
5416,160,195,269,442,109,19,7,109,247,0,7,0,0
5417,160,196,267,442,109,19,7,107,246,1,7,0,0
5418,164,201,267,439,109,19,7,103,238,2,7,0,0
5419,164,201,267,438,109,19,7,103,237,3,7,0,0
5441,164,212,266,447,109,19,7,102,235,0,7,0,0
5442,160,212,264,445,109,19,7,104,233,1,7,0,0
5443,165,218,267,445,109,19,7,102,227,2,7,0,0
5444,165,220,267,445,109,19,7,102,225,3,7,0,0
5445,170,219,272,449,109,19,7,102,230,4,7,0,0
5446,171,220,273,450,109,19,7,102,230,5,7,0,0
5451,174,226,272,444,109,19,7,98,218,0,7,0,0
5452,176,223,276,448,109,19,7,100,225,1,7,0,0
5453,177,224,276,448,109,19,7,99,224,2,7,0,0
5461,169,217,267,442,109,19,7,98,225,0,7,0,0
5462,169,217,267,441,109,19,7,98,224,1,7,0,0
5472,165,219,267,441,109,19,7,102,222,0,7,0,0
5473,165,219,266,441,109,19,7,101,222,1,7,0,0
5476,160,224,264,441,109,19,7,104,217,0,7,0,0
5477,160,224,264,440,109,19,7,104,216,1,7,0,0
5478,159,221,266,440,109,19,7,107,219,2,7,0,0
5479,159,222,266,439,109,19,7,107,217,3,7,0,0
5501,161,216,270,447,109,19,7,109,231,0,7,0,0
5502,161,215,271,448,109,19,7,110,233,1,7,0,0
5522,156,212,263,440,109,19,7,107,228,0,7,0,0
5523,156,212,262,439,109,19,7,106,227,1,7,0,0
5525,160,212,267,445,109,19,7,107,233,0,7,0,0
5526,160,212,267,446,109,19,7,107,234,1,7,0,0
5557,161,213,269,448,110,19,7,108,235,0,23,0,0
5558,161,220,263,442,110,19,7,102,222,1,23,0,0
5559,160,213,268,447,110,19,7,108,234,2,23,0,0
5560,162,215,268,442,110,19,7,106,227,3,23,0,0
5561,164,214,271,444,110,19,7,107,230,4,23,0,0
5562,161,211,270,446,110,19,7,109,235,5,23,0,0
5563,165,217,270,442,110,19,7,105,225,6,23,0,0
5564,163,217,269,441,110,19,7,106,224,7,23,0,0
5565,162,215,270,445,110,19,7,108,230,8,23,0,0
5566,162,214,270,445,110,19,7,108,231,9,23,0,0
5591,167,216,272,446,110,19,7,105,230,0,23,0,0
5592,167,215,270,446,110,19,7,103,231,1,23,0,0
5593,166,215,269,446,110,19,7,103,231,2,23,0,0
5594,165,216,267,446,110,19,7,102,230,3,23,0,0
5595,164,217,267,446,110,19,7,103,229,4,23,0,0
5596,169,219,270,447,110,19,7,101,228,5,23,0,0
5597,169,220,268,443,110,19,7,99,223,6,23,0,0
5598,163,214,264,441,110,19,7,101,227,7,23,0,0
5599,165,210,270,445,110,19,7,105,235,8,23,0,0
5600,169,214,272,447,110,19,7,103,233,9,23,0,0
5601,163,214,264,443,110,19,7,101,229,10,23,0,0
5602,165,213,267,445,110,19,7,102,232,11,23,0,0
5603,167,214,269,446,110,19,7,102,232,12,23,0,0
5604,165,212,267,446,110,19,7,102,234,13,23,0,0
5605,165,212,267,446,110,19,7,102,234,14,23,0,0
5616,164,211,265,442,110,19,7,101,231,0,23,0,0
5617,159,209,264,442,110,19,7,105,233,1,23,0,0
5618,162,213,265,442,110,19,7,103,229,2,23,0,0
5619,162,211,266,441,110,19,7,104,230,3,23,0,0
5620,162,211,266,441,110,19,7,104,230,4,23,0,0
5633,157,206,263,440,110,19,7,106,234,0,23,0,0
5634,159,209,263,440,110,19,7,104,231,1,23,0,0
5635,159,209,263,440,110,19,7,104,231,2,23,0,0
5642,161,211,266,446,110,19,7,105,235,0,23,0,0
5643,161,212,265,446,110,19,7,104,234,1,23,0,0
5644,159,217,263,443,110,19,7,104,226,2,23,0,0
5645,159,218,262,443,110,19,7,103,225,3,23,0,0
5646,164,211,268,439,110,19,7,104,228,4,23,0,0
5647,163,210,268,442,110,19,7,105,232,5,23,0,0
5648,163,204,269,441,110,19,7,106,237,6,23,0,0
5649,163,203,270,441,110,19,7,107,238,7,23,0,0
5661,168,215,269,440,110,19,7,101,225,0,23,0,0
5662,168,216,271,447,110,19,7,103,231,1,23,0,0
5663,162,215,263,442,110,19,7,101,227,2,23,0,0
5664,162,215,262,442,110,19,7,100,227,3,23,0,0
5672,166,216,265,442,110,19,7,99,226,0,23,0,0
5673,166,216,265,441,110,19,7,99,225,1,23,0,0
5678,171,218,271,448,110,19,7,100,230,0,23,0,1
5679,169,214,270,445,110,19,7,101,231,1,23,0,0
5680,163,212,265,443,110,19,7,102,231,2,23,0,0
5681,161,212,265,445,110,19,7,104,233,3,23,0,0
5682,160,211,265,445,110,19,7,105,234,4,23,0,0
5683,160,213,265,445,110,19,7,105,232,5,23,0,0
5684,160,213,265,446,110,19,7,105,233,6,23,0,0
5685,161,213,265,446,110,19,7,104,233,7,23,0,0
5686,158,215,264,444,110,19,7,106,229,8,23,0,0
5687,157,215,262,442,110,19,7,105,227,9,23,0,0
5688,157,215,261,441,110,19,7,104,226,10,23,0,0
5689,154,203,263,442,110,19,7,109,239,11,23,0,0
5690,157,204,267,444,110,19,7,110,240,12,23,0,0
5691,160,206,268,442,110,19,7,108,236,13,23,0,0
5692,157,208,264,442,110,19,7,107,234,14,23,0,0
5693,161,211,267,441,110,19,7,106,230,15,23,0,0
5694,158,207,265,441,110,19,7,107,234,16,23,0,0
5695,158,206,265,441,110,19,7,107,235,17,23,0,0
5696,166,212,272,448,110,19,7,106,236,18,23,0,0
5697,168,212,273,446,110,19,7,105,234,19,23,0,0
5698,168,212,273,449,110,19,7,105,237,20,23,0,0
5699,170,214,274,449,110,19,7,104,235,21,23,0,0
5700,169,210,272,445,110,19,7,103,235,22,23,0,0
5701,169,210,273,446,110,19,7,104,236,23,23,1,0
5713,171,213,273,449,110,19,7,102,236,0,23,0,0
5714,171,214,274,450,110,19,7,103,236,1,23,0,0
5716,164,209,268,449,110,19,7,104,240,0,23,0,0
5717,163,209,268,449,110,19,7,105,240,1,23,0,0
5718,168,211,271,449,110,19,7,103,238,2,23,0,0
5719,160,210,266,445,110,19,7,106,235,3,23,0,0
5720,164,216,266,442,110,19,7,102,226,4,23,0,0
5721,166,215,268,442,110,19,7,102,227,5,23,0,0
5722,168,215,269,442,110,19,7,101,227,6,23,0,0
5723,168,215,269,442,110,19,7,101,227,7,23,0,0
5724,168,212,270,442,110,19,7,102,230,8,23,0,0
5725,172,218,272,447,110,19,7,100,229,9,23,0,0
5726,168,213,268,441,110,19,7,100,228,10,23,0,0
5727,163,211,264,441,110,19,7,101,230,11,23,0,0
5728,160,207,262,442,110,19,7,102,235,12,23,0,0
5729,158,203,260,442,110,19,7,102,239,13,23,0,0
5730,163,210,262,435,110,19,7,99,225,14,23,0,0
5731,163,210,261,434,110,19,7,98,224,15,23,0,0
5736,171,217,271,448,110,19,7,100,231,0,23,0,0
5737,171,217,272,449,110,19,7,101,232,1,23,0,0
5741,173,217,273,450,110,19,7,100,233,0,23,0,0
5742,171,217,272,450,110,19,7,101,233,1,23,0,0
5743,171,218,272,450,110,19,7,101,232,2,23,0,0
5744,163,225,261,443,110,19,7,98,218,3,23,0,0
5745,166,224,266,447,110,19,7,100,223,4,23,0,0
5746,166,224,266,447,110,19,7,100,223,5,23,0,0
5747,166,214,269,443,110,19,7,103,229,6,23,0,0
5748,166,213,269,443,110,19,7,103,230,7,23,0,0
5761,158,190,271,445,110,19,7,113,255,0,23,0,0
5762,159,197,268,443,110,19,7,109,246,1,23,0,0
5763,160,202,267,443,110,19,7,107,241,2,23,0,0
5764,158,193,268,444,110,19,7,110,251,3,23,0,0
5765,159,198,267,443,110,19,7,108,245,4,23,0,0
5766,159,197,267,443,110,19,7,108,246,5,23,0,0
5784,160,220,262,441,110,19,7,102,221,0,23,0,0
5785,160,221,262,440,110,19,7,102,219,1,23,0,0
5786,164,210,272,445,110,19,7,108,235,2,23,0,0
5787,167,212,272,442,110,19,7,105,230,3,23,0,0
5788,169,213,274,447,110,19,7,105,234,4,23,0,0
5789,170,213,275,448,110,19,7,105,235,5,23,0,0
5790,169,213,271,442,110,19,7,102,229,6,23,0,0
5791,169,214,272,442,110,19,7,103,228,7,23,0,0
5816,161,213,265,445,110,19,7,104,232,0,23,0,0
5817,161,212,265,446,110,19,7,104,234,1,23,0,0
5818,160,210,265,446,110,19,7,105,236,2,23,0,0
5819,161,211,266,447,110,19,7,105,236,3,23,0,0
5820,161,211,265,447,110,19,7,104,236,4,23,0,0
5821,158,210,260,443,110,19,7,102,233,5,23,0,0
5822,160,212,262,441,110,19,7,102,229,6,23,0,0
5823,160,212,261,441,110,19,7,101,229,7,23,0,0
5835,172,215,275,449,110,19,7,103,234,0,23,0,0
5836,172,216,275,450,110,19,7,103,234,1,23,0,0
5839,173,219,273,451,110,19,7,100,232,0,23,0,0
5840,173,220,273,451,110,19,7,100,231,1,23,0,0
5847,176,220,274,451,110,19,7,98,231,0,23,0,0
5848,174,221,269,444,110,19,7,95,223,1,23,0,0
5849,174,218,271,447,110,19,7,97,229,2,23,0,0
5850,174,215,272,448,110,19,7,98,233,3,23,0,0
5851,172,210,270,443,110,19,7,98,233,4,23,0,0
5852,172,209,270,442,110,19,7,98,233,5,23,0,0
5854,169,205,269,442,110,19,7,100,237,0,23,0,0
5855,168,204,269,442,110,19,7,101,238,1,23,0,0
5857,159,201,260,439,110,19,7,101,238,0,23,0,0
5858,160,207,259,438,110,19,7,99,231,1,23,0,0
5859,159,207,258,438,110,19,7,99,231,2,23,0,0
5878,162,213,262,428,110,19,7,100,215,0,23,0,0
5879,163,214,268,440,110,19,7,105,226,1,23,0,0
5880,156,212,262,439,110,19,7,106,227,2,23,0,0
5881,158,208,266,442,110,19,7,108,234,3,23,0,0
5882,156,198,268,442,110,19,7,112,244,4,23,0,0
5883,158,198,269,443,110,19,7,111,245,5,23,0,0
5884,163,202,270,443,110,19,7,107,241,6,23,0,0
5885,163,201,271,443,110,19,7,108,242,7,23,0,0
5889,170,217,273,449,110,19,7,103,232,0,23,0,0
5890,171,217,274,450,110,19,7,103,233,1,23,0,0
5899,166,206,270,443,110,19,7,104,237,0,23,0,0
5900,164,203,269,444,110,19,7,105,241,1,23,0,0
5901,155,192,263,442,110,19,7,108,250,2,23,0,0
5902,153,190,261,441,110,19,7,108,251,3,23,0,0
5903,152,190,260,442,110,19,7,108,252,4,23,0,0
5904,151,186,259,443,110,19,7,108,257,5,23,0,0
5905,152,189,258,445,110,19,7,106,256,6,23,0,0
5906,161,199,263,443,110,19,7,102,244,7,23,0,0
5907,163,203,263,444,110,19,7,100,241,8,23,0,0
5908,164,205,263,444,110,19,7,99,239,9,23,0,0
5909,165,198,267,448,110,19,7,102,250,10,23,0,0
5910,164,192,267,448,110,19,7,103,256,11,23,0,0
5911,163,190,267,448,110,19,7,104,258,12,23,0,0
5912,163,199,263,445,110,19,7,100,246,13,23,0,0
5913,165,201,263,445,110,19,7,98,244,14,23,0,0
5914,164,196,266,447,110,19,7,102,251,15,23,0,0
5915,164,196,266,448,110,19,7,102,252,16,23,0,0
5924,169,207,268,448,110,19,7,99,241,0,23,0,0
5925,170,208,268,448,110,19,7,98,240,1,23,0,0
5595,283,225,377,483,111,19,7,94,258,0,0,0,0
5764,285,219,381,486,112,19,7,96,267,0,0,0,0
5899,12,293,49,523,113,19,7,37,230,0,24,0,1
5900,12,293,50,533,113,19,7,38,240,1,24,0,0
5901,12,292,54,545,113,19,7,42,253,2,24,0,0
5902,13,291,57,550,113,19,7,44,259,3,24,0,0
5903,20,291,67,553,113,19,7,47,262,4,24,0,0
5904,26,295,77,558,113,19,7,51,263,5,24,0,0
5905,27,295,83,564,113,19,7,56,269,6,24,0,0
5906,27,294,89,579,113,19,7,62,285,7,24,0,0
5907,28,296,95,589,113,19,7,67,293,8,24,0,0
5908,35,301,106,594,113,19,7,71,293,9,24,0,0
5909,45,305,122,603,113,19,7,77,298,10,24,0,0
5910,57,308,141,614,113,19,7,84,306,11,24,0,0
5911,59,308,151,637,113,19,7,92,329,12,24,0,0
5912,60,316,158,660,113,19,7,98,344,13,24,0,0
5913,65,326,165,667,113,19,7,100,341,14,24,0,0
5914,85,328,192,673,113,19,7,107,345,15,24,0,0
5915,104,337,219,687,113,19,7,115,350,16,24,0,0
5916,116,336,237,696,113,19,7,121,360,17,24,0,0
5917,122,334,259,738,113,19,7,137,404,18,24,0,0
5918,123,333,269,766,113,19,7,146,433,19,24,0,0
5919,141,342,288,765,113,19,7,147,423,20,24,0,0
5920,168,361,324,791,113,19,7,156,430,21,24,0,0
5921,182,370,344,807,113,19,7,162,437,22,24,0,0
5922,205,382,381,853,113,19,7,176,471,23,24,0,0
5923,216,386,397,871,113,19,7,181,485,24,24,1,0
5929,495,414,651,838,113,19,7,156,424,0,24,0,0
5930,521,418,679,846,113,19,7,158,428,1,24,0,0
5911,0,356,82,727,114,19,7,82,371,0,1,0,0
5912,1,371,87,760,114,19,7,86,389,1,1,0,0
5914,3,388,88,759,115,19,7,85,371,0,0,0,0
5918,0,350,185,878,116,19,7,185,528,0,87,0,1
5919,4,348,170,820,116,19,7,166,472,1,87,0,0
5920,16,358,208,903,116,19,7,192,545,2,87,0,0
5921,47,365,255,951,116,19,7,208,586,3,87,0,0
5922,79,375,294,977,116,19,7,215,602,4,87,0,0
5923,161,377,376,977,116,19,7,215,600,5,87,0,0
5924,221,388,447,1010,116,19,7,226,622,6,87,0,0
5925,269,389,511,1038,116,19,7,242,649,7,87,0,0
5926,343,403,593,1062,116,19,7,250,659,8,87,0,0
5927,406,387,671,1074,116,19,7,265,687,9,87,0,0
5928,470,391,736,1080,116,19,7,266,689,10,87,0,0
5929,603,386,884,1080,116,19,7,281,694,11,87,0,0
5930,695,367,990,1080,116,19,7,295,713,12,87,0,0
5931,785,348,1080,1071,116,19,7,295,723,13,87,0,0
5932,918,432,1192,1071,116,19,7,274,639,14,87,0,0
5933,991,385,1284,1067,116,19,7,293,682,15,87,0,0
5934,1103,354,1405,1058,116,19,7,302,704,16,87,0,0
5935,1165,351,1468,1051,116,19,7,303,700,17,87,0,0
5936,1238,323,1537,1027,116,19,7,299,704,18,87,0,0
5937,1309,296,1594,986,116,19,7,285,690,19,87,0,0
5938,1363,310,1630,962,116,19,7,267,652,20,87,0,0
5939,1423,308,1663,897,116,19,7,240,589,21,87,0,0
5940,1451,289,1685,866,116,19,7,234,577,22,87,0,0
5941,1469,274,1701,854,116,19,7,232,580,23,87,0,0
5942,1497,260,1709,800,116,19,7,212,540,24,87,0,0
5943,1517,256,1711,756,116,19,7,194,500,25,87,0,0
5944,1530,244,1716,732,116,19,7,186,488,26,87,0,0
5945,1542,215,1721,694,116,19,7,179,479,27,87,0,0
5946,1547,201,1720,672,116,19,7,173,471,28,87,0,0
5947,1550,194,1719,666,116,19,7,169,472,29,87,0,0
5948,1559,190,1715,632,116,19,7,156,442,30,87,0,0
5949,1564,187,1713,613,116,19,7,149,426,31,87,0,0
5950,1569,184,1715,606,116,19,7,146,422,32,87,0,0
5951,1580,174,1716,577,116,19,7,136,403,33,87,0,0
5952,1584,164,1718,565,116,19,7,134,401,34,87,0,0
5953,1584,161,1713,555,116,19,7,129,394,35,87,0,0
5954,1584,166,1701,527,116,19,7,117,361,36,87,0,0
5955,1583,163,1695,509,116,19,7,112,346,37,87,0,0
5956,1585,159,1696,503,116,19,7,111,344,38,87,0,0
5957,1591,154,1696,480,116,19,7,105,326,39,87,0,0
5958,1596,146,1699,471,116,19,7,103,325,40,87,0,0
5959,1602,150,1702,469,116,19,7,100,319,41,87,0,0
5960,1610,150,1704,452,116,19,7,94,302,42,87,0,0
5961,1614,146,1705,441,116,19,7,91,295,43,87,0,0
5962,1620,147,1709,435,116,19,7,89,288,44,87,0,0
5963,1623,144,1709,426,116,19,7,86,282,45,87,0,0
5964,1623,140,1708,421,116,19,7,85,281,46,87,0,0
5965,1621,135,1706,420,116,19,7,85,285,47,87,0,0
5966,1621,133,1700,402,116,19,7,79,269,48,87,0,0
5967,1620,131,1697,393,116,19,7,77,262,49,87,0,0
5968,1620,131,1693,382,116,19,7,73,251,50,87,0,0
5969,1626,130,1695,368,116,19,7,69,238,51,87,0,0
5970,1638,127,1687,286,116,19,7,49,159,52,87,0,0
5971,1629,128,1694,344,116,19,7,65,216,53,87,0,0
5972,1627,126,1695,353,116,19,7,68,227,54,87,0,0
5973,1632,124,1693,329,116,19,7,61,205,55,87,0,0
5974,1631,124,1695,339,116,19,7,64,215,56,87,0,0
5975,1637,124,1697,325,116,19,7,60,201,57,87,0,0
5976,1641,120,1701,324,116,19,7,60,204,58,87,0,0
5977,1642,125,1701,323,116,19,7,59,198,59,87,0,0
5978,1639,119,1696,313,116,19,7,57,194,60,87,0,0
5979,1637,116,1694,313,116,19,7,57,197,61,87,0,0
5980,1637,116,1694,308,116,19,7,57,192,62,87,0,0
5981,1639,119,1694,308,116,19,7,55,189,63,87,0,0
5982,1641,122,1696,309,116,19,7,55,187,64,87,0,0
5983,1639,118,1695,312,116,19,7,56,194,65,87,0,0
5984,1636,117,1692,312,116,19,7,56,195,66,87,0,0
5985,1634,114,1690,311,116,19,7,56,197,67,87,0,0
5986,1634,113,1689,304,116,19,7,55,191,68,87,0,0
5987,1636,112,1690,302,116,19,7,54,190,69,87,0,0
5988,1639,115,1690,290,116,19,7,51,175,70,87,0,0
5989,1643,115,1687,266,116,19,7,44,151,71,87,0,0
5990,1641,113,1684,257,116,19,7,43,144,72,87,0,0
5991,1635,115,1684,280,116,19,7,49,165,73,87,0,0
5992,1632,114,1680,278,116,19,7,48,164,74,87,0,0
5993,1633,114,1678,263,116,19,7,45,149,75,87,0,0
5994,1633,112,1680,263,116,19,7,47,151,76,87,0,0
5995,1632,108,1682,269,116,19,7,50,161,77,87,0,0
5996,1634,109,1681,259,116,19,7,47,150,78,87,0,0
5997,1635,111,1681,257,116,19,7,46,146,79,87,0,0
5998,1636,109,1681,252,116,19,7,45,143,80,87,0,0
5999,1636,109,1682,255,116,19,7,46,146,81,87,0,0
6000,1637,108,1681,246,116,19,7,44,138,82,87,0,0
6001,1637,107,1682,247,116,19,7,45,140,83,87,0,0
6002,1636,102,1683,250,116,19,7,47,148,84,87,0,0
6003,1637,107,1683,252,116,19,7,46,145,85,87,0,0
6004,1638,106,1678,233,116,19,7,40,127,86,87,0,0
6005,1634,98,1679,240,116,19,7,45,142,87,87,1,0
5918,2,366,83,599,117,19,7,81,233,0,0,0,0
5924,289,400,441,694,118,19,7,152,294,0,0,0,0
5930,584,404,794,935,119,19,7,210,531,0,59,0,1
5931,643,390,851,916,119,19,7,208,526,1,59,0,0
5932,707,389,912,909,119,19,7,205,520,2,59,0,0
5933,790,389,999,915,119,19,7,209,526,3,59,0,0
5934,857,388,1052,884,119,19,7,195,496,4,59,0,0
5935,908,370,1106,874,119,19,7,198,504,5,59,0,0
5936,953,367,1163,903,119,19,7,210,536,6,59,0,0
5937,1020,355,1220,873,119,19,7,200,518,7,59,0,0
5938,1071,342,1265,844,119,19,7,194,502,8,59,0,0
5939,1101,334,1291,823,119,19,7,190,489,9,59,0,0
5940,1154,322,1335,788,119,19,7,181,466,10,59,0,0
5941,1196,313,1370,761,119,19,7,174,448,11,59,0,0
5942,1208,303,1386,760,119,19,7,178,457,12,59,0,0
5943,1245,288,1401,684,119,19,7,156,396,13,59,0,0
5944,1270,280,1428,681,119,19,7,158,401,14,59,0,0
5945,1285,272,1445,676,119,19,7,160,404,15,59,0,0
5946,1320,259,1475,654,119,19,7,155,395,16,59,0,0
5947,1338,250,1493,644,119,19,7,155,394,17,59,0,0
5948,1350,240,1504,634,119,19,7,154,394,18,59,0,0
5949,1369,231,1513,604,119,19,7,144,373,19,59,0,0
5950,1382,228,1518,584,119,19,7,136,356,20,59,0,0
5951,1398,218,1531,564,119,19,7,133,346,21,59,0,0
5952,1411,214,1540,550,119,19,7,129,336,22,59,0,0
5953,1419,211,1546,541,119,19,7,127,330,23,59,0,0
5954,1427,203,1545,513,119,19,7,118,310,24,59,0,0
5955,1430,198,1544,500,119,19,7,114,302,25,59,0,0
5956,1436,196,1545,489,119,19,7,109,293,26,59,0,0
5957,1443,193,1550,479,119,19,7,107,286,27,59,0,0
5958,1453,193,1556,467,119,19,7,103,274,28,59,0,0
5959,1456,188,1557,458,119,19,7,101,270,29,59,0,0
5960,1453,179,1549,440,119,19,7,96,261,30,59,0,0
5961,1455,180,1546,428,119,19,7,91,248,31,59,0,0
5962,1463,173,1553,422,119,19,7,90,249,32,59,0,0
5963,1474,164,1564,413,119,19,7,90,249,33,59,0,0
5964,1483,160,1572,409,119,19,7,89,249,34,59,0,0
5965,1486,156,1571,396,119,19,7,85,240,35,59,0,0
5966,1487,154,1570,389,119,19,7,83,235,36,59,0,0
5967,1493,150,1575,386,119,19,7,82,236,37,59,0,0
5968,1507,145,1589,381,119,19,7,82,236,38,59,0,0
5969,1520,144,1599,375,119,19,7,79,231,39,59,0,0
5970,1525,150,1601,373,119,19,7,76,223,40,59,0,0
5971,1531,156,1599,360,119,19,7,68,204,41,59,0,0
5972,1531,140,1602,355,119,19,7,71,215,42,59,0,0
5973,1537,129,1610,350,119,19,7,73,221,43,59,0,0
5974,1547,130,1617,342,119,19,7,70,212,44,59,0,0
5975,1550,138,1615,336,119,19,7,65,198,45,59,0,0
5976,1547,125,1616,333,119,19,7,69,208,46,59,0,0
5977,1543,134,1608,331,119,19,7,65,197,47,59,0,0
5978,1542,141,1603,325,119,19,7,61,184,48,59,0,0
5979,1546,143,1604,317,119,19,7,58,174,49,59,0,0
5980,1549,142,1607,310,119,19,7,58,168,50,59,0,0
5981,1544,142,1604,311,119,19,7,60,169,51,59,0,0
5982,1543,145,1602,311,119,19,7,59,166,52,59,0,0
5983,1549,153,1605,308,119,19,7,56,155,53,59,0,0
5984,1551,153,1607,303,119,19,7,56,150,54,59,0,0
5985,1550,141,1609,300,119,19,7,59,159,55,59,0,0
5986,1546,148,1600,297,119,19,7,54,149,56,59,0,0
5987,1548,152,1599,294,119,19,7,51,142,57,59,0,0
5988,1542,135,1599,297,119,19,7,57,162,58,59,0,0
5989,1542,133,1598,293,119,19,7,56,160,59,59,1,0
5991,1535,128,1590,283,119,19,7,55,155,0,59,0,0
5992,1533,126,1588,284,119,19,7,55,158,1,59,0,0
5993,1536,124,1589,277,119,19,7,53,153,2,59,0,0
5994,1538,122,1591,276,119,19,7,53,154,3,59,0,0
5995,1542,133,1589,270,119,19,7,47,137,4,59,0,0
5996,1544,132,1590,269,119,19,7,46,137,5,59,0,0
5997,1548,135,1591,264,119,19,7,43,129,6,59,0,0
5998,1554,148,1593,263,119,19,7,39,115,7,59,0,0
5999,1562,132,1604,258,119,19,7,42,126,8,59,0,0
6000,1563,126,1606,257,119,19,7,43,131,9,59,0,0
6001,1565,126,1607,253,119,19,7,42,127,10,59,0,0
6002,1565,118,1610,252,119,19,7,45,134,11,59,0,0
6003,1570,120,1614,249,119,19,7,44,129,12,59,0,0
6004,1573,112,1618,244,119,19,7,45,132,13,59,0,0
6005,1576,110,1622,243,119,19,7,46,133,14,59,0,0
5988,171,187,278,445,120,19,7,107,258,0,1,0,0
5989,172,193,276,442,120,19,7,104,249,1,1,0,0
5989,1543,123,1582,198,121,19,7,39,75,0,0,0,0
3675,492,100,540,248,22,19,9,48,148,0,70,0,1
3676,491,98,538,250,22,19,9,47,152,1,70,0,0
3677,489,102,536,254,22,19,9,47,152,2,70,0,0
3678,488,102,536,257,22,19,9,48,155,3,70,0,0
3679,481,99,526,246,22,19,9,45,147,4,70,0,0
3680,482,108,525,249,22,19,9,43,141,5,70,0,0
3681,480,112,523,255,22,19,9,43,143,6,70,0,0
3682,480,115,523,257,22,19,9,43,142,7,70,0,0
3683,478,115,521,259,22,19,9,43,144,8,70,0,0
3684,476,114,519,259,22,19,9,43,145,9,70,0,0
3685,475,114,520,264,22,19,9,45,150,10,70,0,0
3686,477,122,521,270,22,19,9,44,148,11,70,0,0
3687,478,124,522,271,22,19,9,44,147,12,70,0,0
3688,477,119,523,273,22,19,9,46,154,13,70,0,0
3689,477,118,523,274,22,19,9,46,156,14,70,0,0
3690,475,115,522,276,22,19,9,47,161,15,70,0,0
3691,476,130,521,282,22,19,9,45,152,16,70,0,0
3692,476,132,521,285,22,19,9,45,153,17,70,0,0
3693,480,133,526,287,22,19,9,46,154,18,70,0,0
3694,480,124,532,295,22,19,9,52,171,19,70,0,0
3695,480,121,532,297,22,19,9,52,176,20,70,0,0
3696,480,126,531,300,22,19,9,51,174,21,70,0,0
3697,481,132,534,308,22,19,9,53,176,22,70,0,0
3698,484,139,536,312,22,19,9,52,173,23,70,0,0
3699,485,139,538,316,22,19,9,53,177,24,70,0,0
3700,484,140,540,325,22,19,9,56,185,25,70,0,0
3701,482,140,539,327,22,19,9,57,187,26,70,0,0
3702,480,139,540,335,22,19,9,60,196,27,70,0,0
3703,482,148,541,339,22,19,9,59,191,28,70,0,0
3704,483,143,546,344,22,19,9,63,201,29,70,0,0
3705,483,142,550,355,22,19,9,67,213,30,70,0,0
3706,482,143,552,363,22,19,9,70,220,31,70,0,0
3707,483,145,554,367,22,19,9,71,222,32,70,0,0
3708,485,149,557,373,22,19,9,72,224,33,70,0,0
3709,490,154,563,380,22,19,9,73,226,34,70,0,0
3710,493,156,566,385,22,19,9,73,229,35,70,0,0
3711,492,160,568,400,22,19,9,76,240,36,70,0,0
3712,490,161,569,408,22,19,9,79,247,37,70,0,0
3713,489,162,568,410,22,19,9,79,248,38,70,0,0
3714,488,164,570,423,22,19,9,82,259,39,70,0,0
3715,486,167,572,435,22,19,9,86,268,40,70,0,0
3716,484,167,574,448,22,19,9,90,281,41,70,0,0
3717,482,176,574,463,22,19,9,92,287,42,70,0,0
3718,476,182,570,469,22,19,9,94,287,43,70,0,0
3719,473,184,570,481,22,19,9,97,297,44,70,0,0
3720,474,190,574,497,22,19,9,100,307,45,70,0,0
3721,474,188,579,512,22,19,9,105,324,46,70,0,0
3722,472,193,582,531,22,19,9,110,338,47,70,0,0
3723,468,203,580,547,22,19,9,112,344,48,70,0,0
3724,467,208,581,559,22,19,9,114,351,49,70,0,0
3725,467,216,585,581,22,19,9,118,365,50,70,0,0
3726,473,223,597,607,22,19,9,124,384,51,70,0,0
3727,477,225,605,620,22,19,9,128,395,52,70,0,0
3728,474,232,611,651,22,19,9,137,419,53,70,0,0
3729,474,242,615,677,22,19,9,141,435,54,70,0,0
3730,477,247,622,691,22,19,9,145,444,55,70,0,0
3731,484,262,632,718,22,19,9,148,456,56,70,0,0
3732,490,269,647,751,22,19,9,157,482,57,70,0,0
3733,485,274,654,788,22,19,9,169,514,58,70,0,0
3734,471,296,653,848,22,19,9,182,552,59,70,0,0
3735,462,306,650,875,22,19,9,188,569,60,70,0,0
3736,451,321,652,930,22,19,9,201,609,61,70,0,0
3737,438,349,649,988,22,19,9,211,639,62,70,0,0
3738,423,364,636,1006,22,19,9,213,642,63,70,0,0
3739,395,392,616,1053,22,19,9,221,661,64,70,0,0
3740,359,429,585,1073,22,19,9,226,644,65,70,0,0
3741,274,444,505,1080,22,19,9,231,636,66,70,0,0
3742,203,475,438,1080,22,19,9,235,605,67,70,0,0
3743,105,506,338,1080,22,19,9,233,574,68,70,0,0
3744,21,521,248,1080,22,19,9,227,559,69,70,0,0
3745,0,538,216,1080,22,19,9,216,542,70,70,1,0
4887,1491,733,1538,808,33,19,9,47,75,0,0,0,0
4890,1506,726,1563,822,34,19,9,57,96,0,3,0,0
4891,1511,724,1570,822,34,19,9,59,98,1,3,0,0
4892,1521,724,1576,817,34,19,9,55,93,2,3,0,0
4893,1525,724,1579,815,34,19,9,54,91,3,3,0,0
4946,1561,679,1599,752,34,19,9,38,73,0,3,0,0
4947,1559,676,1596,750,34,19,9,37,74,1,3,0,0
4948,1556,677,1592,748,34,19,9,36,71,2,3,0,0
4970,1195,444,1249,567,39,19,9,54,123,0,0,0,0
5105,1615,685,1650,764,40,19,9,35,79,0,0,0,0
162,1262,167,1321,344,1,9,1,59,177,0,18,0,0
163,1268,162,1326,337,1,9,1,58,175,1,18,0,0
164,1292,158,1351,335,1,9,1,59,177,2,18,0,0
165,1315,158,1374,333,1,9,1,59,175,3,18,0,0
166,1341,155,1399,330,1,9,1,58,175,4,18,0,0
167,1371,157,1433,339,1,9,1,62,182,5,18,0,0
168,1390,158,1452,337,1,9,1,62,179,6,18,0,0
169,1407,158,1468,337,1,9,1,61,179,7,18,0,0
170,1423,154,1484,329,1,9,1,61,175,8,18,0,0
171,1430,151,1492,326,1,9,1,62,175,9,18,0,0
172,1435,150,1495,322,1,9,1,60,172,10,18,0,0
173,1438,150,1497,320,1,9,1,59,170,11,18,0,0
174,1444,150,1501,315,1,9,1,57,165,12,18,0,0
175,1447,148,1503,311,1,9,1,56,163,13,18,0,0
176,1442,147,1498,307,1,9,1,56,160,14,18,0,0
177,1437,145,1492,300,1,9,1,55,155,15,18,0,0
178,1430,144,1484,298,1,9,1,54,154,16,18,0,0
179,1424,144,1478,298,1,9,1,54,154,17,18,0,0
180,1428,144,1482,295,1,9,1,54,151,18,18,0,0
998,1262,212,1338,444,2,9,1,76,232,0,33,0,1
999,1274,220,1346,442,2,9,1,72,222,1,33,0,0
1000,1290,219,1364,445,2,9,1,74,226,2,33,0,0
1001,1299,224,1376,455,2,9,1,77,231,3,33,0,0
1002,1317,232,1396,471,2,9,1,79,239,4,33,0,0
1003,1331,240,1413,485,2,9,1,82,245,5,33,0,0
1004,1340,240,1428,503,2,9,1,88,263,6,33,0,0
1005,1349,239,1441,516,2,9,1,92,277,7,33,0,0
1006,1353,245,1448,530,2,9,1,95,285,8,33,0,0
1007,1352,250,1450,543,2,9,1,98,293,9,33,0,0
1008,1349,259,1447,553,2,9,1,98,294,10,33,0,0
1009,1344,265,1449,579,2,9,1,105,314,11,33,0,0
1010,1338,267,1444,587,2,9,1,106,320,12,33,0,0
1011,1323,280,1433,611,2,9,1,110,331,13,33,0,0
1012,1304,287,1418,627,2,9,1,114,340,14,33,0,0
1013,1283,294,1406,664,2,9,1,123,370,15,33,0,0
1014,1265,304,1393,685,2,9,1,128,381,16,33,0,0
1015,1245,314,1373,692,2,9,1,128,378,17,33,0,0
1016,1217,328,1354,730,2,9,1,137,402,18,33,0,0
1017,1190,337,1331,746,2,9,1,141,409,19,33,0,0
1018,1158,349,1314,803,2,9,1,156,454,20,33,0,0
1019,1137,366,1299,835,2,9,1,162,469,21,33,0,0
1020,1114,381,1279,857,2,9,1,165,476,22,33,0,0
1021,1081,407,1253,896,2,9,1,172,489,23,33,0,0
1022,1047,422,1227,930,2,9,1,180,508,24,33,0,0
1023,1012,452,1211,1012,2,9,1,199,560,25,33,0,0
1024,979,480,1186,1057,2,9,1,207,577,26,33,0,0
1025,954,514,1156,1068,2,9,1,202,554,27,33,0,0
1026,917,558,1113,1080,2,9,1,196,522,28,33,0,0
1027,867,593,1063,1080,2,9,1,196,487,29,33,0,0
1028,817,648,1006,1080,2,9,1,189,432,30,33,0,0
1029,780,711,957,1080,2,9,1,177,369,31,33,0,0
1030,759,787,916,1080,2,9,1,157,293,32,33,0,0
1031,736,823,883,1080,2,9,1,147,257,33,33,1,0
1643,1263,173,1303,353,4,9,1,40,180,0,0,0,0
1644,1281,170,1337,332,5,9,1,56,162,0,22,0,1
1645,1303,171,1360,334,5,9,1,57,163,1,22,0,0
1646,1325,170,1382,334,5,9,1,57,164,2,22,0,0
1647,1348,168,1408,341,5,9,1,60,173,3,22,0,0
1648,1374,169,1434,341,5,9,1,60,172,4,22,0,0
1649,1396,168,1455,340,5,9,1,59,172,5,22,0,0
1650,1418,174,1474,336,5,9,1,56,162,6,22,0,0
1651,1432,172,1488,333,5,9,1,56,161,7,22,0,0
1652,1442,165,1499,330,5,9,1,57,165,8,22,0,0
1653,1452,165,1508,324,5,9,1,56,159,9,22,0,0
1654,1468,162,1524,322,5,9,1,56,160,10,22,0,0
1655,1485,162,1539,314,5,9,1,54,152,11,22,0,0
1656,1498,164,1549,310,5,9,1,51,146,12,22,0,0
1657,1510,158,1562,306,5,9,1,52,148,13,22,0,0
1658,1520,156,1571,303,5,9,1,51,147,14,22,0,0
1659,1532,156,1582,300,5,9,1,50,144,15,22,0,0
1660,1548,155,1597,295,5,9,1,49,140,16,22,0,0
1661,1559,157,1607,293,5,9,1,48,136,17,22,0,0
1662,1573,154,1622,295,5,9,1,49,141,18,22,0,0
1663,1583,154,1632,292,5,9,1,49,138,19,22,0,0
1664,1598,154,1644,287,5,9,1,46,133,20,22,0,0
1665,1617,154,1660,280,5,9,1,43,126,21,22,0,0
1666,1632,158,1668,266,5,9,1,36,108,22,22,1,0
1733,1261,210,1313,442,6,9,1,52,232,0,39,0,1
1734,1270,195,1326,444,6,9,1,56,249,1,39,0,0
1735,1281,195,1339,444,6,9,1,58,249,2,39,0,0
1736,1288,199,1347,447,6,9,1,59,248,3,39,0,0
1737,1300,199,1362,455,6,9,1,62,256,4,39,0,0
1738,1307,203,1373,465,6,9,1,66,262,5,39,0,0
1739,1314,208,1385,479,6,9,1,71,271,6,39,0,0
1740,1330,211,1403,483,6,9,1,73,272,7,39,0,0
1741,1340,215,1417,498,6,9,1,77,283,8,39,0,0
1742,1349,218,1431,513,6,9,1,82,295,9,39,0,0
1743,1351,221,1437,522,6,9,1,86,301,10,39,0,0
1744,1351,225,1443,537,6,9,1,92,312,11,39,0,0
1745,1352,230,1448,548,6,9,1,96,318,12,39,0,0
1746,1356,236,1455,557,6,9,1,99,321,13,39,0,0
1747,1355,241,1462,582,6,9,1,107,341,14,39,0,0
1748,1357,244,1469,598,6,9,1,112,354,15,39,0,0
1749,1354,248,1470,605,6,9,1,116,357,16,39,0,0
1750,1345,259,1470,635,6,9,1,125,376,17,39,0,0
1751,1340,269,1468,651,6,9,1,128,382,18,39,0,0
1752,1335,275,1469,669,6,9,1,134,394,19,39,0,0
1753,1325,291,1467,703,6,9,1,142,412,20,39,0,0
1754,1311,298,1461,721,6,9,1,150,423,21,39,0,0
1755,1298,309,1455,742,6,9,1,157,433,22,39,0,0
1756,1283,317,1454,781,6,9,1,171,464,23,39,0,0
1757,1270,330,1444,793,6,9,1,174,463,24,39,0,0
1758,1255,342,1444,840,6,9,1,189,498,25,39,0,0
1759,1243,365,1439,875,6,9,1,196,510,26,39,0,0
1760,1224,375,1432,905,6,9,1,208,530,27,39,0,0
1761,1202,396,1430,972,6,9,1,228,576,28,39,0,0
1762,1181,419,1421,1021,6,9,1,240,602,29,39,0,0
1763,1165,440,1405,1030,6,9,1,240,590,30,39,0,0
1764,1143,475,1390,1069,6,9,1,247,594,31,39,0,0
1765,1121,503,1371,1080,6,9,1,250,577,32,39,0,0
1766,1106,537,1354,1080,6,9,1,248,543,33,39,0,0
1767,1089,597,1321,1080,6,9,1,232,483,34,39,0,0
1768,1044,652,1267,1080,6,9,1,223,428,35,39,0,0
1769,989,712,1200,1080,6,9,1,211,368,36,39,0,0
1770,950,796,1134,1079,6,9,1,184,283,37,39,0,0
1771,894,888,1033,1078,6,9,1,139,190,38,39,0,0
1772,871,939,981,1080,6,9,1,110,141,39,39,1,0
2118,1012,502,1234,1055,8,9,1,222,553,0,119,0,1
2119,1036,501,1252,1038,8,9,1,216,537,1,119,0,0
2120,1063,476,1261,967,8,9,1,198,491,2,119,0,0
2121,1075,437,1275,935,8,9,1,200,498,3,119,0,0
2122,1102,431,1298,919,8,9,1,196,488,4,119,0,0
2123,1136,409,1323,872,8,9,1,187,463,5,119,0,0
2124,1165,412,1334,830,8,9,1,169,418,6,119,0,0
2125,1184,386,1362,824,8,9,1,178,438,7,119,0,0
2126,1206,367,1373,778,8,9,1,167,411,8,119,0,0
2127,1219,348,1386,761,8,9,1,167,413,9,119,0,0
2128,1236,342,1399,750,8,9,1,163,408,10,119,0,0
2129,1259,331,1414,721,8,9,1,155,390,11,119,0,0
2130,1271,323,1424,708,8,9,1,153,385,12,119,0,0
2131,1281,320,1431,698,8,9,1,150,378,13,119,0,0
2132,1293,310,1431,660,8,9,1,138,350,14,119,0,0
2133,1302,304,1438,648,8,9,1,136,344,15,119,0,0
2134,1318,297,1451,639,8,9,1,133,342,16,119,0,0
2135,1333,289,1459,612,8,9,1,126,323,17,119,0,0
2136,1344,284,1466,602,8,9,1,122,318,18,119,0,0
2137,1359,275,1477,581,8,9,1,118,306,19,119,0,0
2138,1362,266,1478,569,8,9,1,116,303,20,119,0,0
2139,1376,257,1488,550,8,9,1,112,293,21,119,0,0
2140,1381,256,1494,548,8,9,1,113,292,22,119,0,0
2141,1393,252,1501,529,8,9,1,108,277,23,119,0,0
2142,1401,250,1508,529,8,9,1,107,279,24,119,0,0
2143,1407,244,1512,516,8,9,1,105,272,25,119,0,0
2144,1418,245,1517,502,8,9,1,99,257,26,119,0,0
2145,1428,241,1528,503,8,9,1,100,262,27,119,0,0
2146,1435,240,1537,509,8,9,1,102,269,28,119,0,0
2147,1446,237,1540,484,8,9,1,94,247,29,119,0,0
2148,1459,237,1542,455,8,9,1,83,218,30,119,0,0
2149,1466,230,1550,447,8,9,1,84,217,31,119,0,0
2150,1470,225,1562,468,8,9,1,92,243,32,119,0,0
2151,1474,221,1561,454,8,9,1,87,233,33,119,0,0
2152,1483,218,1567,442,8,9,1,84,224,34,119,0,0
2153,1488,220,1569,437,8,9,1,81,217,35,119,0,0
2154,1487,214,1571,441,8,9,1,84,227,36,119,0,0
2155,1490,211,1569,424,8,9,1,79,213,37,119,0,0
2156,1495,209,1571,415,8,9,1,76,206,38,119,0,0
2157,1499,202,1576,412,8,9,1,77,210,39,119,0,0
2158,1500,196,1574,399,8,9,1,74,203,40,119,0,0
2159,1501,197,1573,395,8,9,1,72,198,41,119,0,0
2160,1500,196,1571,393,8,9,1,71,197,42,119,0,0
2161,1500,194,1569,386,8,9,1,69,192,43,119,0,0
2162,1502,194,1566,375,8,9,1,64,181,44,119,0,0
2163,1499,190,1564,373,8,9,1,65,183,45,119,0,0
2164,1498,189,1561,365,8,9,1,63,176,46,119,0,0
2165,1496,189,1557,357,8,9,1,61,168,47,119,0,0
2166,1493,186,1554,354,8,9,1,61,168,48,119,0,0
2167,1491,186,1550,349,8,9,1,59,163,49,119,0,0
2168,1493,187,1549,341,8,9,1,56,154,50,119,0,0
2169,1492,185,1549,338,8,9,1,57,153,51,119,0,0
2170,1491,183,1549,339,8,9,1,58,156,52,119,0,0
2171,1490,182,1548,337,8,9,1,58,155,53,119,0,0
2172,1489,178,1547,336,8,9,1,58,158,54,119,0,0
2173,1489,176,1547,334,8,9,1,58,158,55,119,0,0
2174,1489,177,1545,327,8,9,1,56,150,56,119,0,0
2175,1487,176,1541,319,8,9,1,54,143,57,119,0,0
2176,1477,175,1532,319,8,9,1,55,144,58,119,0,0
2177,1469,173,1525,315,8,9,1,56,142,59,119,0,0
2178,1462,171,1519,313,8,9,1,57,142,60,119,0,0
2179,1456,171,1514,315,8,9,1,58,144,61,119,0,0
2180,1454,170,1512,313,8,9,1,58,143,62,119,0,0
2181,1452,168,1509,308,8,9,1,57,140,63,119,0,0
2182,1451,167,1507,303,8,9,1,56,136,64,119,0,0
2183,1449,166,1504,300,8,9,1,55,134,65,119,0,0
2184,1448,163,1504,297,8,9,1,56,134,66,119,0,0
2185,1450,164,1507,296,8,9,1,57,132,67,119,0,0
2186,1452,162,1509,297,8,9,1,57,135,68,119,0,0
2187,1452,161,1510,297,8,9,1,58,136,69,119,0,0
2188,1451,161,1509,296,8,9,1,58,135,70,119,0,0
2189,1451,161,1510,295,8,9,1,59,134,71,119,0,0
2190,1451,160,1510,295,8,9,1,59,135,72,119,0,0
2191,1451,161,1510,296,8,9,1,59,135,73,119,0,0
2192,1451,162,1510,297,8,9,1,59,135,74,119,0,0
2193,1452,162,1511,298,8,9,1,59,136,75,119,0,0
2194,1453,163,1510,295,8,9,1,57,132,76,119,0,0
2195,1449,162,1505,295,8,9,1,56,133,77,119,0,0
2196,1444,162,1501,296,8,9,1,57,134,78,119,0,0
2197,1439,161,1497,297,8,9,1,58,136,79,119,0,0
2198,1436,160,1493,296,8,9,1,57,136,80,119,0,0
2199,1434,161,1490,297,8,9,1,56,136,81,119,0,0
2200,1434,161,1488,296,8,9,1,54,135,82,119,0,0
2201,1432,158,1486,295,8,9,1,54,137,83,119,0,0
2202,1429,158,1482,292,8,9,1,53,134,84,119,0,0
2203,1426,157,1479,292,8,9,1,53,135,85,119,0,0
2204,1423,156,1475,291,8,9,1,52,135,86,119,0,0
2205,1421,157,1472,290,8,9,1,51,133,87,119,0,0
2206,1420,158,1469,290,8,9,1,49,132,88,119,0,0
2207,1419,159,1467,290,8,9,1,48,131,89,119,0,0
2208,1421,165,1466,289,8,9,1,45,124,90,119,0,0
2209,1422,168,1465,289,8,9,1,43,121,91,119,0,0
2210,1423,171,1466,291,8,9,1,43,120,92,119,0,0
2211,1423,170,1467,292,8,9,1,44,122,93,119,0,0
2212,1423,170,1466,292,8,9,1,43,122,94,119,0,0
2213,1424,173,1466,293,8,9,1,42,120,95,119,0,0
2214,1424,174,1465,293,8,9,1,41,119,96,119,0,0
2215,1423,170,1464,293,8,9,1,41,123,97,119,0,0
2216,1424,168,1464,291,8,9,1,40,123,98,119,0,0
2217,1423,160,1465,289,8,9,1,42,129,99,119,0,0
2218,1426,157,1469,288,8,9,1,43,131,100,119,0,0
2219,1431,156,1475,288,8,9,1,44,132,101,119,0,0
2220,1436,159,1480,289,8,9,1,44,130,102,119,0,0
2221,1442,159,1485,289,8,9,1,43,130,103,119,0,0
2222,1449,160,1492,288,8,9,1,43,128,104,119,0,0
2223,1455,159,1499,289,8,9,1,44,130,105,119,0,0
2224,1461,159,1505,285,8,9,1,44,126,106,119,0,0
2225,1466,158,1510,285,8,9,1,44,127,107,119,0,0
2226,1470,159,1514,285,8,9,1,44,126,108,119,0,0
2227,1473,160,1517,283,8,9,1,44,123,109,119,0,0
2228,1474,160,1518,283,8,9,1,44,123,110,119,0,0
2229,1473,158,1518,281,8,9,1,45,123,111,119,0,0
2230,1473,156,1517,278,8,9,1,44,122,112,119,0,0
2231,1473,156,1517,275,8,9,1,44,119,113,119,0,0
2232,1475,154,1519,273,8,9,1,44,119,114,119,0,0
2233,1478,152,1522,273,8,9,1,44,121,115,119,0,0
2234,1482,153,1525,271,8,9,1,43,118,116,119,0,0
2235,1486,155,1526,268,8,9,1,40,113,117,119,0,0
2236,1487,152,1528,267,8,9,1,41,115,118,119,0,0
2237,1489,152,1530,266,8,9,1,41,114,119,119,1,0
2246,1515,160,1562,290,8,9,1,47,130,0,119,0,0
2247,1514,161,1562,293,8,9,1,48,132,1,119,0,0
2248,1517,161,1564,294,8,9,1,47,133,2,119,0,0
2249,1513,160,1562,297,8,9,1,49,137,3,119,0,0
2250,1515,160,1564,299,8,9,1,49,139,4,119,0,0
2267,1516,183,1554,285,8,9,1,38,102,0,119,0,0
2268,1515,186,1557,297,8,9,1,42,111,1,119,0,0
2269,1514,188,1558,299,8,9,1,44,111,2,119,0,0
2270,1513,188,1557,300,8,9,1,44,112,3,119,0,0
2271,1513,187,1557,297,8,9,1,44,110,4,119,0,0
2272,1513,186,1557,297,8,9,1,44,111,5,119,0,0
2273,1513,187,1557,297,8,9,1,44,110,6,119,0,0
2275,1513,185,1558,297,8,9,1,45,112,0,119,0,0
2276,1512,185,1558,297,8,9,1,46,112,1,119,0,0
2277,1512,186,1558,297,8,9,1,46,111,2,119,0,0
2278,1513,186,1559,297,8,9,1,46,111,3,119,0,0
2279,1512,185,1558,297,8,9,1,46,112,4,119,0,0
2280,1512,185,1558,297,8,9,1,46,112,5,119,0,0
2282,1513,187,1559,297,8,9,1,46,110,0,119,0,0
2283,1513,188,1559,298,8,9,1,46,110,1,119,0,0
2285,1513,187,1559,298,8,9,1,46,111,0,119,0,1
2286,1513,186,1559,298,8,9,1,46,112,1,119,0,0
2287,1512,186,1559,298,8,9,1,47,112,2,119,0,0
2288,1512,187,1559,299,8,9,1,47,112,3,119,0,0
2289,1511,187,1558,299,8,9,1,47,112,4,119,0,0
2290,1512,186,1559,299,8,9,1,47,113,5,119,0,0
2291,1512,187,1559,300,8,9,1,47,113,6,119,0,0
2292,1512,187,1558,299,8,9,1,46,112,7,119,0,0
2293,1512,187,1559,299,8,9,1,47,112,8,119,0,0
2294,1512,187,1559,299,8,9,1,47,112,9,119,0,0
2295,1512,187,1559,299,8,9,1,47,112,10,119,0,0
2296,1512,188,1559,300,8,9,1,47,112,11,119,0,0
2297,1512,188,1559,300,8,9,1,47,112,12,119,0,0
2298,1512,187,1559,302,8,9,1,47,115,13,119,0,0
2299,1512,189,1560,303,8,9,1,48,114,14,119,0,0
2300,1512,189,1560,306,8,9,1,48,117,15,119,0,0
2301,1512,189,1559,304,8,9,1,47,115,16,119,0,0
2302,1512,189,1559,303,8,9,1,47,114,17,119,0,0
2303,1512,188,1559,301,8,9,1,47,113,18,119,0,0
2304,1512,187,1559,302,8,9,1,47,115,19,119,0,0
2305,1512,187,1559,301,8,9,1,47,114,20,119,0,0
2306,1511,188,1561,307,8,9,1,50,119,21,119,0,0
2307,1511,189,1560,307,8,9,1,49,118,22,119,0,0
2308,1511,189,1559,306,8,9,1,48,117,23,119,0,0
2309,1511,190,1559,305,8,9,1,48,115,24,119,0,0
2310,1512,190,1559,305,8,9,1,47,115,25,119,0,0
2311,1511,188,1560,307,8,9,1,49,119,26,119,0,0
2312,1511,189,1561,311,8,9,1,50,122,27,119,0,0
2313,1511,189,1561,312,8,9,1,50,123,28,119,0,0
2314,1511,190,1560,311,8,9,1,49,121,29,119,0,0
2315,1511,190,1561,312,8,9,1,50,122,30,119,0,0
2316,1512,191,1561,311,8,9,1,49,120,31,119,0,0
2317,1512,191,1560,308,8,9,1,48,117,32,119,0,0
2318,1513,193,1559,304,8,9,1,46,111,33,119,0,0
2319,1512,193,1560,308,8,9,1,48,115,34,119,0,0
2320,1511,189,1559,309,8,9,1,48,120,35,119,0,0
2321,1512,193,1558,305,8,9,1,46,112,36,119,0,0
2322,1513,194,1558,306,8,9,1,45,112,37,119,0,0
2323,1514,196,1557,300,8,9,1,43,104,38,119,0,0
2324,1515,196,1559,304,8,9,1,44,108,39,119,0,0
2325,1513,195,1558,305,8,9,1,45,110,40,119,0,0
2326,1513,194,1557,302,8,9,1,44,108,41,119,0,0
2327,1513,194,1557,300,8,9,1,44,106,42,119,0,0
2328,1513,190,1557,298,8,9,1,44,108,43,119,0,0
2329,1513,193,1557,301,8,9,1,44,108,44,119,0,0
2330,1513,193,1557,300,8,9,1,44,107,45,119,0,0
2331,1513,193,1557,299,8,9,1,44,106,46,119,0,0
2332,1512,189,1557,297,8,9,1,45,108,47,119,0,0
2333,1512,188,1557,298,8,9,1,45,110,48,119,0,0
2334,1512,187,1557,297,8,9,1,45,110,49,119,0,0
2179,1499,198,1543,312,9,9,1,44,114,0,16,0,0
2180,1498,193,1542,308,9,9,1,44,115,1,16,0,0
2181,1496,193,1547,327,9,9,1,51,134,2,16,0,0
2182,1498,193,1547,318,9,9,1,49,125,3,16,0,0
2183,1498,189,1547,315,9,9,1,49,126,4,16,0,0
2184,1497,190,1548,322,9,9,1,51,132,5,16,0,0
2185,1499,194,1548,322,9,9,1,49,128,6,16,0,0
2186,1496,193,1548,329,9,9,1,52,136,7,16,0,0
2187,1497,189,1549,327,9,9,1,52,138,8,16,0,0
2188,1498,192,1551,334,9,9,1,53,142,9,16,0,0
2189,1498,193,1552,337,9,9,1,54,144,10,16,0,0
2190,1498,193,1551,334,9,9,1,53,141,11,16,0,0
2191,1498,193,1550,332,9,9,1,52,139,12,16,0,0
2192,1497,189,1550,331,9,9,1,53,142,13,16,0,0
2193,1497,186,1549,330,9,9,1,52,144,14,16,0,0
2194,1498,185,1547,316,9,9,1,49,131,15,16,0,0
2195,1498,184,1547,316,9,9,1,49,132,16,16,0,0
2206,1501,198,1549,329,9,9,1,48,131,0,16,0,0
2207,1501,199,1549,330,9,9,1,48,131,1,16,0,0
2226,1501,185,1541,296,9,9,1,40,111,0,16,0,0
2227,1501,184,1541,294,9,9,1,40,110,1,16,0,0
2282,1610,164,1647,285,10,9,1,37,121,0,86,0,1
2283,1611,164,1649,288,10,9,1,38,124,1,86,0,0
2284,1610,164,1649,290,10,9,1,39,126,2,86,0,0
2285,1609,166,1647,290,10,9,1,38,124,3,86,0,0
2286,1608,165,1646,289,10,9,1,38,124,4,86,0,0
2287,1606,165,1643,286,10,9,1,37,121,5,86,0,0
2288,1604,167,1641,282,10,9,1,37,115,6,86,0,0
2289,1602,167,1640,283,10,9,1,38,116,7,86,0,0
2290,1603,169,1643,290,10,9,1,40,121,8,86,0,0
2291,1604,170,1645,293,10,9,1,41,123,9,86,0,0
2292,1601,170,1644,294,10,9,1,43,124,10,86,0,0
2293,1599,172,1643,297,10,9,1,44,125,11,86,0,0
2294,1594,171,1640,299,10,9,1,46,128,12,86,0,0
2295,1591,171,1639,303,10,9,1,48,132,13,86,0,0
2296,1591,173,1640,309,10,9,1,49,136,14,86,0,0
2297,1592,174,1642,311,10,9,1,50,137,15,86,0,0
2298,1592,174,1643,315,10,9,1,51,141,16,86,0,0
2299,1590,176,1643,320,10,9,1,53,144,17,86,0,0
2300,1587,177,1641,320,10,9,1,54,143,18,86,0,0
2301,1586,177,1642,322,10,9,1,56,145,19,86,0,0
2302,1587,181,1642,325,10,9,1,55,144,20,86,0,0
2303,1590,182,1645,327,10,9,1,55,145,21,86,0,0
2304,1591,181,1648,330,10,9,1,57,149,22,86,0,0
2305,1589,183,1648,335,10,9,1,59,152,23,86,0,0
2306,1585,183,1645,335,10,9,1,60,152,24,86,0,0
2307,1584,182,1646,338,10,9,1,62,156,25,86,0,0
2308,1586,185,1649,346,10,9,1,63,161,26,86,0,0
2309,1588,186,1653,349,10,9,1,65,163,27,86,0,0
2310,1588,187,1655,353,10,9,1,67,166,28,86,0,0
2311,1586,191,1654,360,10,9,1,68,169,29,86,0,0
2312,1580,192,1650,363,10,9,1,70,171,30,86,0,0
2313,1578,195,1649,366,10,9,1,71,171,31,86,0,0
2314,1580,200,1650,370,10,9,1,70,170,32,86,0,0
2315,1579,201,1650,372,10,9,1,71,171,33,86,0,0
2316,1574,202,1650,383,10,9,1,76,181,34,86,0,0
2317,1569,205,1647,391,10,9,1,78,186,35,86,0,0
2318,1559,205,1641,396,10,9,1,82,191,36,86,0,0
2319,1558,206,1641,400,10,9,1,83,194,37,86,0,0
2320,1562,212,1643,404,10,9,1,81,192,38,86,0,0
2321,1558,212,1644,412,10,9,1,86,200,39,86,0,0
2322,1555,214,1643,419,10,9,1,88,205,40,86,0,0
2323,1551,219,1642,427,10,9,1,91,208,41,86,0,0
2324,1547,220,1641,432,10,9,1,94,212,42,86,0,0
2325,1549,223,1647,447,10,9,1,98,224,43,86,0,0
2326,1552,228,1651,457,10,9,1,99,229,44,86,0,0
2327,1548,229,1650,462,10,9,1,102,233,45,86,0,0
2328,1546,234,1649,469,10,9,1,103,235,46,86,0,0
2329,1542,235,1647,476,10,9,1,105,241,47,86,0,0
2330,1541,237,1646,479,10,9,1,105,242,48,86,0,0
2331,1543,244,1651,494,10,9,1,108,250,49,86,0,0
2332,1542,249,1652,505,10,9,1,110,256,50,86,0,0
2333,1538,252,1652,518,10,9,1,114,266,51,86,0,0
2334,1531,259,1650,535,10,9,1,119,276,52,86,0,0
2335,1525,260,1644,535,10,9,1,119,275,53,86,0,0
2336,1524,265,1648,558,10,9,1,124,293,54,86,0,0
2337,1525,271,1650,572,10,9,1,125,301,55,86,0,0
2338,1521,274,1648,579,10,9,1,127,305,56,86,0,0
2339,1514,285,1645,601,10,9,1,131,316,57,86,0,0
2340,1506,292,1637,608,10,9,1,131,316,58,86,0,0
2341,1500,296,1634,617,10,9,1,134,321,59,86,0,0
2342,1500,306,1641,647,10,9,1,141,341,60,86,0,0
2343,1499,311,1643,662,10,9,1,144,351,61,86,0,0
2344,1492,317,1638,671,10,9,1,146,354,62,86,0,0
2345,1484,332,1636,699,10,9,1,152,367,63,86,0,0
2346,1474,338,1631,711,10,9,1,157,373,64,86,0,0
2347,1473,349,1634,731,10,9,1,161,382,65,86,0,0
2348,1475,361,1643,760,10,9,1,168,399,66,86,0,0
2349,1472,366,1642,770,10,9,1,170,404,67,86,0,0
2350,1462,379,1643,803,10,9,1,181,424,68,86,0,0
2351,1448,397,1631,825,10,9,1,183,428,69,86,0,0
2352,1430,401,1622,844,10,9,1,192,443,70,86,0,0
2353,1418,412,1625,888,10,9,1,207,476,71,86,0,0
2354,1408,429,1624,923,10,9,1,216,494,72,86,0,0
2355,1388,443,1616,960,10,9,1,228,517,73,86,0,0
2356,1370,466,1604,994,10,9,1,234,528,74,86,0,0
2357,1343,482,1585,1020,10,9,1,242,538,75,86,0,0
2358,1310,498,1566,1057,10,9,1,256,559,76,86,0,0
2359,1303,528,1555,1068,10,9,1,252,540,77,86,0,0
2360,1302,558,1552,1075,10,9,1,250,517,78,86,0,0
2361,1293,593,1539,1080,10,9,1,246,487,79,86,0,0
2362,1282,641,1518,1080,10,9,1,236,439,80,86,0,0
2363,1251,683,1482,1080,10,9,1,231,397,81,86,0,0
2364,1228,716,1460,1080,10,9,1,232,364,82,86,0,0
2365,1228,773,1440,1080,10,9,1,212,307,83,86,0,0
2366,1259,840,1444,1077,10,9,1,185,237,84,86,0,0
2367,1226,902,1376,1078,10,9,1,150,176,85,86,0,0
2368,1224,944,1344,1080,10,9,1,120,136,86,86,1,0
2385,0,914,136,1058,11,9,1,136,144,0,0,0,0
2394,298,646,717,1073,12,9,1,419,427,0,230,0,1
2395,354,622,783,1073,12,9,1,429,451,1,230,0,0
2396,398,592,836,1069,12,9,1,438,477,2,230,0,0
2397,441,572,873,1063,12,9,1,432,491,3,230,0,0
2398,476,557,902,1061,12,9,1,426,504,4,230,0,0
2399,507,527,935,1058,12,9,1,428,531,5,230,0,0
2400,566,508,981,1038,12,9,1,415,530,6,230,0,0
2401,614,492,1008,1014,12,9,1,394,522,7,230,0,0
2402,655,470,1022,977,12,9,1,367,507,8,230,0,0
2403,690,457,1030,943,12,9,1,340,486,9,230,0,0
2404,717,446,1047,936,12,9,1,330,490,10,230,0,0
2405,754,429,1061,903,12,9,1,307,474,11,230,0,0
2406,798,412,1079,857,12,9,1,281,445,12,230,0,0
2407,836,402,1103,839,12,9,1,267,437,13,230,0,0
2408,875,385,1122,804,12,9,1,247,419,14,230,0,0
2409,908,371,1144,785,12,9,1,236,414,15,230,0,0
2410,929,362,1160,781,12,9,1,231,419,16,230,0,0
2411,951,350,1168,756,12,9,1,217,406,17,230,0,0
2412,980,340,1182,723,12,9,1,202,383,18,230,0,0
2413,1007,332,1200,707,12,9,1,193,375,19,230,0,0
2414,1036,322,1217,682,12,9,1,181,360,20,230,0,0
2415,1058,315,1229,665,12,9,1,171,350,21,230,0,0
2416,1071,313,1237,663,12,9,1,166,350,22,230,0,0
2417,1082,303,1241,643,12,9,1,159,340,23,230,0,0
2418,1096,294,1249,627,12,9,1,153,333,24,230,0,0
2419,1114,293,1260,615,12,9,1,146,322,25,230,0,0
2420,1137,285,1277,599,12,9,1,140,314,26,230,0,0
2421,1153,276,1289,587,12,9,1,136,311,27,230,0,0
2422,1166,276,1298,584,12,9,1,132,308,28,230,0,0
2423,1174,270,1304,578,12,9,1,130,308,29,230,0,0
2424,1187,264,1311,562,12,9,1,124,298,30,230,0,0
2425,1204,261,1324,550,12,9,1,120,289,31,230,0,0
2426,1218,258,1336,545,12,9,1,118,287,32,230,0,0
2427,1235,253,1350,532,12,9,1,115,279,33,230,0,0
2428,1247,247,1360,525,12,9,1,113,278,34,230,0,0
2429,1254,247,1364,522,12,9,1,110,275,35,230,0,0
2430,1261,243,1369,518,12,9,1,108,275,36,230,0,0
2431,1271,243,1376,510,12,9,1,105,267,37,230,0,0
2432,1281,244,1385,506,12,9,1,104,262,38,230,0,0
2433,1289,244,1393,503,12,9,1,104,259,39,230,0,0
2434,1295,239,1400,503,12,9,1,105,264,40,230,0,0
2435,1297,243,1401,504,12,9,1,104,261,41,230,0,0
2436,1300,245,1402,500,12,9,1,102,255,42,230,0,0
2437,1301,243,1404,502,12,9,1,103,259,43,230,0,0
2438,1300,245,1402,501,12,9,1,102,256,44,230,0,0
2439,1298,244,1400,501,12,9,1,102,257,45,230,0,0
2440,1297,241,1400,502,12,9,1,103,261,46,230,0,0
2441,1298,236,1402,499,12,9,1,104,263,47,230,0,0
2442,1297,201,1410,496,12,9,1,113,295,48,230,0,0
2443,1302,218,1409,496,12,9,1,107,278,49,230,0,0
2444,1311,232,1409,486,12,9,1,98,254,50,230,0,0
2445,1313,230,1409,478,12,9,1,96,248,51,230,0,0
2446,1319,228,1414,474,12,9,1,95,246,52,230,0,0
2447,1320,225,1413,467,12,9,1,93,242,53,230,0,0
2448,1329,222,1419,453,12,9,1,90,231,54,230,0,0
2449,1338,223,1427,445,12,9,1,89,222,55,230,0,0
2450,1346,218,1436,438,12,9,1,90,220,56,230,0,0
2451,1353,214,1444,434,12,9,1,91,220,57,230,0,0
2452,1354,211,1447,435,12,9,1,93,224,58,230,0,0
2453,1358,207,1451,430,12,9,1,93,223,59,230,0,0
2454,1365,206,1456,424,12,9,1,91,218,60,230,0,0
2455,1374,205,1465,421,12,9,1,91,216,61,230,0,0
2456,1384,202,1474,414,12,9,1,90,212,62,230,0,0
2457,1386,200,1474,408,12,9,1,88,208,63,230,0,0
2458,1389,200,1476,407,12,9,1,87,207,64,230,0,0
2459,1388,194,1477,400,12,9,1,89,206,65,230,0,0
2460,1393,193,1479,392,12,9,1,86,199,66,230,0,0
2461,1399,193,1483,387,12,9,1,84,194,67,230,0,0
2462,1404,190,1486,381,12,9,1,82,191,68,230,0,0
2463,1407,190,1486,374,12,9,1,79,184,69,230,0,0
2464,1406,189,1482,368,12,9,1,76,179,70,230,0,0
2465,1406,185,1481,360,12,9,1,75,175,71,230,0,0
2466,1408,183,1482,356,12,9,1,74,173,72,230,0,0
2467,1410,183,1483,353,12,9,1,73,170,73,230,0,0
2468,1413,181,1486,351,12,9,1,73,170,74,230,0,0
2469,1414,179,1486,348,12,9,1,72,169,75,230,0,0
2470,1414,180,1483,344,12,9,1,69,164,76,230,0,0
2471,1414,177,1482,340,12,9,1,68,163,77,230,0,0
2472,1415,177,1482,333,12,9,1,67,156,78,230,0,0
2473,1421,177,1486,331,12,9,1,65,154,79,230,0,0
2474,1428,176,1493,330,12,9,1,65,154,80,230,0,0
2475,1432,174,1496,326,12,9,1,64,152,81,230,0,0
2476,1436,175,1499,325,12,9,1,63,150,82,230,0,0
2477,1437,173,1500,322,12,9,1,63,149,83,230,0,0
2478,1440,171,1502,319,12,9,1,62,148,84,230,0,0
2479,1443,170,1505,318,12,9,1,62,148,85,230,0,0
2480,1448,169,1509,316,12,9,1,61,147,86,230,0,0
2481,1452,168,1513,311,12,9,1,61,143,87,230,0,0
2482,1453,169,1511,308,12,9,1,58,139,88,230,0,0
2483,1449,167,1508,305,12,9,1,59,138,89,230,0,0
2484,1450,166,1508,301,12,9,1,58,135,90,230,0,0
2485,1449,166,1508,302,12,9,1,59,136,91,230,0,0
2486,1453,167,1511,299,12,9,1,58,132,92,230,0,0
2487,1455,165,1511,294,12,9,1,56,129,93,230,0,0
2488,1453,165,1509,290,12,9,1,56,125,94,230,0,0
2489,1450,162,1506,290,12,9,1,56,128,95,230,0,0
2490,1447,158,1504,289,12,9,1,57,131,96,230,0,0
2491,1447,158,1502,285,12,9,1,55,127,97,230,0,0
2492,1448,159,1501,282,12,9,1,53,123,98,230,0,0
2493,1450,158,1501,282,12,9,1,51,124,99,230,0,0
2494,1450,163,1499,283,12,9,1,49,120,100,230,0,0
2495,1450,163,1497,281,12,9,1,47,118,101,230,0,0
2496,1449,163,1496,281,12,9,1,47,118,102,230,0,0
2497,1450,161,1496,279,12,9,1,46,118,103,230,0,0
2498,1449,158,1496,280,12,9,1,47,122,104,230,0,0
2499,1449,156,1497,281,12,9,1,48,125,105,230,0,0
2500,1449,155,1497,282,12,9,1,48,127,106,230,0,0
2501,1448,158,1495,283,12,9,1,47,125,107,230,0,0
2502,1447,158,1495,286,12,9,1,48,128,108,230,0,0
2503,1448,159,1495,285,12,9,1,47,126,109,230,0,0
2504,1448,163,1496,290,12,9,1,48,127,110,230,0,0
2505,1448,164,1497,293,12,9,1,49,129,111,230,0,0
2506,1450,166,1499,293,12,9,1,49,127,112,230,0,0
2507,1450,167,1498,292,12,9,1,48,125,113,230,0,0
2508,1452,169,1499,291,12,9,1,47,122,114,230,0,0
2509,1453,168,1499,293,12,9,1,46,125,115,230,0,0
2510,1452,166,1498,294,12,9,1,46,128,116,230,0,0
2511,1454,168,1499,296,12,9,1,45,128,117,230,0,0
2512,1457,170,1502,300,12,9,1,45,130,118,230,0,0
2513,1457,172,1501,301,12,9,1,44,129,119,230,0,0
2514,1458,173,1502,302,12,9,1,44,129,120,230,0,0
2515,1457,175,1500,302,12,9,1,43,127,121,230,0,0
2516,1456,176,1498,301,12,9,1,42,125,122,230,0,0
2517,1456,177,1497,299,12,9,1,41,122,123,230,0,0
2518,1457,178,1497,297,12,9,1,40,119,124,230,0,0
2519,1457,179,1498,298,12,9,1,41,119,125,230,0,0
2520,1458,180,1499,298,12,9,1,41,118,126,230,0,0
2521,1458,181,1499,300,12,9,1,41,119,127,230,0,0
2522,1460,179,1502,299,12,9,1,42,120,128,230,0,0
2523,1461,175,1503,299,12,9,1,42,124,129,230,0,0
2524,1461,169,1505,299,12,9,1,44,130,130,230,0,0
2525,1461,165,1507,299,12,9,1,46,134,131,230,0,0
2526,1461,161,1510,303,12,9,1,49,142,132,230,0,0
2527,1461,161,1511,303,12,9,1,50,142,133,230,0,0
2528,1463,160,1514,305,12,9,1,51,145,134,230,0,0
2529,1466,161,1515,297,12,9,1,49,136,135,230,0,0
2530,1468,162,1514,289,12,9,1,46,127,136,230,0,0
2531,1466,163,1512,287,12,9,1,46,124,137,230,0,0
2532,1461,160,1508,283,12,9,1,47,123,138,230,0,0
2533,1457,158,1506,285,12,9,1,49,127,139,230,0,0
2534,1455,157,1504,286,12,9,1,49,129,140,230,0,0
2535,1455,157,1505,286,12,9,1,50,129,141,230,0,0
2536,1454,157,1505,288,12,9,1,51,131,142,230,0,0
2537,1453,157,1505,290,12,9,1,52,133,143,230,0,0
2538,1452,158,1503,290,12,9,1,51,132,144,230,0,0
2539,1451,158,1502,290,12,9,1,51,132,145,230,0,0
2540,1451,159,1503,292,12,9,1,52,133,146,230,0,0
2541,1451,159,1504,292,12,9,1,53,133,147,230,0,0
2542,1449,159,1504,298,12,9,1,55,139,148,230,0,0
2543,1447,161,1501,297,12,9,1,54,136,149,230,0,0
2544,1445,162,1499,295,12,9,1,54,133,150,230,0,0
2545,1446,162,1499,294,12,9,1,53,132,151,230,0,0
2546,1447,162,1501,296,12,9,1,54,134,152,230,0,0
2547,1451,164,1505,297,12,9,1,54,133,153,230,0,0
2548,1455,165,1509,297,12,9,1,54,132,154,230,0,0
2549,1455,166,1511,303,12,9,1,56,137,155,230,0,0
2550,1456,165,1514,307,12,9,1,58,142,156,230,0,0
2551,1458,165,1516,309,12,9,1,58,144,157,230,0,0
2552,1459,165,1516,309,12,9,1,57,144,158,230,0,0
2553,1458,165,1516,310,12,9,1,58,145,159,230,0,0
2554,1455,164,1511,308,12,9,1,56,144,160,230,0,0
2555,1452,164,1508,311,12,9,1,56,147,161,230,0,0
2556,1450,164,1505,312,12,9,1,55,148,162,230,0,0
2557,1449,164,1503,311,12,9,1,54,147,163,230,0,0
2558,1449,164,1501,309,12,9,1,52,145,164,230,0,0
2559,1449,165,1500,307,12,9,1,51,142,165,230,0,0
2560,1449,165,1499,305,12,9,1,50,140,166,230,0,0
2561,1449,165,1499,307,12,9,1,50,142,167,230,0,0
2562,1449,164,1500,310,12,9,1,51,146,168,230,0,0
2563,1449,164,1500,311,12,9,1,51,147,169,230,0,0
2564,1449,164,1500,312,12,9,1,51,148,170,230,0,0
2565,1449,163,1499,311,12,9,1,50,148,171,230,0,0
2566,1449,163,1499,311,12,9,1,50,148,172,230,0,0
2567,1449,163,1499,312,12,9,1,50,149,173,230,0,0
2568,1450,162,1500,313,12,9,1,50,151,174,230,0,0
2569,1449,162,1500,314,12,9,1,51,152,175,230,0,0
2570,1449,162,1500,314,12,9,1,51,152,176,230,0,0
2571,1450,162,1500,314,12,9,1,50,152,177,230,0,0
2572,1450,162,1501,315,12,9,1,51,153,178,230,0,0
2573,1450,162,1501,315,12,9,1,51,153,179,230,0,0
2574,1450,162,1500,314,12,9,1,50,152,180,230,0,0
2575,1450,162,1500,313,12,9,1,50,151,181,230,0,0
2576,1451,164,1499,310,12,9,1,48,146,182,230,0,0
2577,1451,164,1498,308,12,9,1,47,144,183,230,0,0
2578,1452,164,1498,307,12,9,1,46,143,184,230,0,0
2579,1452,164,1498,308,12,9,1,46,144,185,230,0,0
2580,1452,164,1498,308,12,9,1,46,144,186,230,0,0
2581,1452,164,1499,310,12,9,1,47,146,187,230,0,0
2582,1452,164,1499,311,12,9,1,47,147,188,230,0,0
2583,1453,164,1498,309,12,9,1,45,145,189,230,0,0
2584,1453,164,1498,310,12,9,1,45,146,190,230,0,0
2585,1453,164,1498,308,12,9,1,45,144,191,230,0,0
2586,1453,164,1498,307,12,9,1,45,143,192,230,0,0
2587,1454,165,1498,307,12,9,1,44,142,193,230,0,0
2588,1455,165,1500,305,12,9,1,45,140,194,230,0,0
2589,1456,165,1499,302,12,9,1,43,137,195,230,0,0
2590,1456,165,1499,301,12,9,1,43,136,196,230,0,0
2591,1456,165,1500,304,12,9,1,44,139,197,230,0,0
2592,1458,164,1502,304,12,9,1,44,140,198,230,0,0
2593,1459,164,1503,302,12,9,1,44,138,199,230,0,0
2594,1459,163,1504,302,12,9,1,45,139,200,230,0,0
2595,1457,162,1503,303,12,9,1,46,141,201,230,0,0
2596,1456,162,1502,305,12,9,1,46,143,202,230,0,0
2597,1456,162,1501,304,12,9,1,45,142,203,230,0,0
2598,1456,162,1502,305,12,9,1,46,143,204,230,0,0
2599,1457,162,1502,303,12,9,1,45,141,205,230,0,0
2600,1457,163,1501,303,12,9,1,44,140,206,230,0,0
2601,1457,163,1502,306,12,9,1,45,143,207,230,0,0
2602,1456,163,1500,303,12,9,1,44,140,208,230,0,0
2603,1455,161,1500,305,12,9,1,45,144,209,230,0,0
2604,1455,161,1501,303,12,9,1,46,142,210,230,0,0
2605,1455,161,1501,303,12,9,1,46,142,211,230,0,0
2606,1458,164,1502,298,12,9,1,44,134,212,230,0,0
2607,1459,165,1503,297,12,9,1,44,132,213,230,0,0
2608,1455,164,1503,303,12,9,1,48,139,214,230,0,0
2609,1453,164,1499,298,12,9,1,46,134,215,230,0,0
2610,1452,165,1498,298,12,9,1,46,133,216,230,0,0
2611,1455,164,1503,299,12,9,1,48,135,217,230,0,0
2612,1456,163,1506,302,12,9,1,50,139,218,230,0,0
2613,1457,163,1508,304,12,9,1,51,141,219,230,0,0
2614,1456,163,1508,305,12,9,1,52,142,220,230,0,0
2615,1456,164,1508,307,12,9,1,52,143,221,230,0,0
2616,1454,165,1507,309,12,9,1,53,144,222,230,0,0
2617,1449,163,1502,304,12,9,1,53,141,223,230,0,0
2618,1446,162,1497,297,12,9,1,51,135,224,230,0,0
2619,1440,162,1490,292,12,9,1,50,130,225,230,0,0
2620,1433,161,1483,291,12,9,1,50,130,226,230,0,0
2621,1425,163,1474,293,12,9,1,49,130,227,230,0,0
2622,1420,168,1465,292,12,9,1,45,124,228,230,0,0
2623,1418,181,1456,291,12,9,1,38,110,229,230,0,0
2624,1414,183,1452,290,12,9,1,38,107,230,230,1,0
2426,1421,146,1460,293,13,9,1,39,147,0,15,0,0
2427,1430,145,1470,298,13,9,1,40,153,1,15,0,0
2428,1435,145,1476,300,13,9,1,41,155,2,15,0,0
2429,1443,146,1487,308,13,9,1,44,162,3,15,0,0
2430,1446,149,1491,312,13,9,1,45,163,4,15,0,0
2431,1445,150,1492,320,13,9,1,47,170,5,15,0,0
2432,1442,149,1491,324,13,9,1,49,175,6,15,0,0
2433,1440,152,1490,327,13,9,1,50,175,7,15,0,0
2434,1436,151,1486,327,13,9,1,50,176,8,15,0,0
2435,1428,151,1479,332,13,9,1,51,181,9,15,0,0
2436,1418,154,1471,337,13,9,1,53,183,10,15,0,0
2437,1407,155,1460,337,13,9,1,53,182,11,15,0,0
2438,1396,155,1449,340,13,9,1,53,185,12,15,0,0
2439,1384,157,1438,344,13,9,1,54,187,13,15,0,0
2440,1366,158,1418,340,13,9,1,52,182,14,15,0,0
2441,1360,159,1413,342,13,9,1,53,183,15,15,0,0
2444,1276,160,1329,340,13,9,1,53,180,0,15,0,0
2445,1265,166,1317,344,13,9,1,52,178,1,15,0,0
2446,1253,167,1305,346,13,9,1,52,179,2,15,0,0
2427,1513,187,1557,300,14,9,1,44,113,0,34,0,0
2428,1513,189,1556,300,14,9,1,43,111,1,34,0,0
2429,1513,192,1555,300,14,9,1,42,108,2,34,0,0
2430,1513,193,1555,300,14,9,1,42,107,3,34,0,0
2431,1513,191,1555,297,14,9,1,42,106,4,34,0,0
2432,1514,189,1554,293,14,9,1,40,104,5,34,0,0
2433,1514,187,1555,293,14,9,1,41,106,6,34,0,0
2434,1514,186,1555,292,14,9,1,41,106,7,34,0,0
2435,1513,186,1556,297,14,9,1,43,111,8,34,0,0
2436,1513,187,1557,299,14,9,1,44,112,9,34,0,0
2437,1513,186,1557,299,14,9,1,44,113,10,34,0,0
2457,1512,189,1556,301,14,9,1,44,112,0,34,0,0
2458,1513,187,1557,299,14,9,1,44,112,1,34,0,0
2459,1512,187,1558,299,14,9,1,46,112,2,34,0,0
2460,1512,187,1558,299,14,9,1,46,112,3,34,0,0
2462,1513,189,1558,300,14,9,1,45,111,0,34,0,1
2463,1513,190,1557,300,14,9,1,44,110,1,34,0,0
2464,1513,190,1557,300,14,9,1,44,110,2,34,0,0
2465,1512,188,1558,301,14,9,1,46,113,3,34,0,0
2466,1513,188,1557,299,14,9,1,44,111,4,34,0,0
2467,1513,188,1558,299,14,9,1,45,111,5,34,0,0
2468,1512,187,1557,299,14,9,1,45,112,6,34,0,0
2469,1512,187,1557,300,14,9,1,45,113,7,34,0,0
2470,1512,187,1557,300,14,9,1,45,113,8,34,0,0
2471,1511,186,1558,302,14,9,1,47,116,9,34,0,0
2472,1512,187,1557,300,14,9,1,45,113,10,34,0,0
2473,1511,187,1557,301,14,9,1,46,114,11,34,0,0
2474,1513,189,1558,302,14,9,1,45,113,12,34,0,0
2475,1513,190,1557,300,14,9,1,44,110,13,34,0,0
2476,1514,188,1556,298,14,9,1,42,110,14,34,0,0
2477,1514,188,1556,295,14,9,1,42,107,15,34,0,0
2478,1514,190,1555,296,14,9,1,41,106,16,34,0,0
2479,1513,188,1555,298,14,9,1,42,110,17,34,0,0
2480,1513,190,1555,300,14,9,1,42,110,18,34,0,0
2481,1514,191,1555,299,14,9,1,41,108,19,34,0,0
2482,1513,192,1554,297,14,9,1,41,105,20,34,0,0
2483,1514,193,1554,296,14,9,1,40,103,21,34,0,0
2484,1514,192,1555,296,14,9,1,41,104,22,34,0,0
2485,1514,192,1555,297,14,9,1,41,105,23,34,0,0
2486,1514,191,1556,298,14,9,1,42,107,24,34,0,0
2487,1515,191,1556,296,14,9,1,41,105,25,34,0,0
2488,1513,192,1555,297,14,9,1,42,105,26,34,0,0
2489,1513,192,1555,296,14,9,1,42,104,27,34,0,0
2490,1514,191,1555,294,14,9,1,41,103,28,34,0,0
2491,1514,189,1555,290,14,9,1,41,101,29,34,0,0
2492,1515,189,1555,287,14,9,1,40,98,30,34,0,0
2493,1514,188,1557,292,14,9,1,43,104,31,34,0,0
2494,1514,188,1557,293,14,9,1,43,105,32,34,0,0
2495,1514,188,1557,294,14,9,1,43,106,33,34,0,0
2496,1514,187,1558,294,14,9,1,44,107,34,34,1,0
2498,1514,187,1557,294,14,9,1,43,107,0,34,0,0
2499,1513,189,1556,293,14,9,1,43,104,1,34,0,0
2500,1514,189,1557,295,14,9,1,43,106,2,34,0,0
2501,1513,190,1556,297,14,9,1,43,107,3,34,0,0
2502,1513,190,1556,297,14,9,1,43,107,4,34,0,0
2503,1513,190,1557,296,14,9,1,44,106,5,34,0,0
2504,1515,192,1556,294,14,9,1,41,102,6,34,0,0
2505,1511,195,1552,295,14,9,1,41,100,7,34,0,0
2506,1510,194,1554,296,14,9,1,44,102,8,34,0,0
2507,1511,192,1554,295,14,9,1,43,103,9,34,0,0
2508,1512,191,1555,293,14,9,1,43,102,10,34,0,0
2509,1513,191,1556,293,14,9,1,43,102,11,34,0,0
2510,1513,191,1556,293,14,9,1,43,102,12,34,0,0
2441,1337,162,1390,289,15,9,1,53,127,0,0,0,0
2443,1299,167,1335,297,16,9,1,36,130,0,0,0,0
2712,1454,192,1490,287,18,9,1,36,95,0,83,0,1
2713,1452,189,1490,286,18,9,1,38,97,1,83,0,0
2714,1451,182,1492,282,18,9,1,41,100,2,83,0,0
2715,1449,173,1494,282,18,9,1,45,109,3,83,0,0
2716,1446,169,1493,284,18,9,1,47,115,4,83,0,0
2717,1441,163,1491,286,18,9,1,50,123,5,83,0,0
2718,1440,161,1490,286,18,9,1,50,125,6,83,0,0
2719,1438,159,1489,288,18,9,1,51,129,7,83,0,0
2720,1438,159,1489,287,18,9,1,51,128,8,83,0,0
2721,1439,159,1488,286,18,9,1,49,127,9,83,0,0
2722,1441,161,1489,286,18,9,1,48,125,10,83,0,0
2723,1443,163,1491,287,18,9,1,48,124,11,83,0,0
2724,1446,163,1495,288,18,9,1,49,125,12,83,0,0
2725,1449,164,1497,290,18,9,1,48,126,13,83,0,0
2726,1448,166,1498,294,18,9,1,50,128,14,83,0,0
2727,1448,169,1496,294,18,9,1,48,125,15,83,0,0
2728,1447,175,1492,291,18,9,1,45,116,16,83,0,0
2729,1447,179,1490,289,18,9,1,43,110,17,83,0,0
2730,1447,182,1489,289,18,9,1,42,107,18,83,0,0
2731,1447,179,1490,289,18,9,1,43,110,19,83,0,0
2732,1448,176,1493,289,18,9,1,45,113,20,83,0,0
2733,1449,175,1497,294,18,9,1,48,119,21,83,0,0
2734,1450,175,1499,297,18,9,1,49,122,22,83,0,0
2735,1452,176,1499,294,18,9,1,47,118,23,83,0,0
2736,1453,180,1499,294,18,9,1,46,114,24,83,0,0
2737,1454,183,1500,295,18,9,1,46,112,25,83,0,0
2738,1455,185,1500,294,18,9,1,45,109,26,83,0,0
2739,1455,184,1501,295,18,9,1,46,111,27,83,0,0
2740,1453,180,1501,295,18,9,1,48,115,28,83,0,0
2741,1452,180,1500,297,18,9,1,48,117,29,83,0,0
2742,1450,179,1498,296,18,9,1,48,117,30,83,0,0
2743,1449,180,1496,296,18,9,1,47,116,31,83,0,0
2744,1450,185,1494,294,18,9,1,44,109,32,83,0,0
2745,1450,187,1492,290,18,9,1,42,103,33,83,0,0
2746,1449,186,1493,292,18,9,1,44,106,34,83,0,0
2747,1451,186,1493,292,18,9,1,42,106,35,83,0,0
2748,1450,185,1494,292,18,9,1,44,107,36,83,0,0
2749,1450,180,1496,294,18,9,1,46,114,37,83,0,0
2750,1449,176,1498,297,18,9,1,49,121,38,83,0,0
2751,1450,176,1499,297,18,9,1,49,121,39,83,0,0
2752,1452,176,1500,295,18,9,1,48,119,40,83,0,0
2753,1453,179,1501,295,18,9,1,48,116,41,83,0,0
2754,1454,182,1500,296,18,9,1,46,114,42,83,0,0
2755,1453,184,1500,297,18,9,1,47,113,43,83,0,0
2756,1454,183,1501,298,18,9,1,47,115,44,83,0,0
2757,1455,182,1501,295,18,9,1,46,113,45,83,0,0
2758,1453,180,1500,295,18,9,1,47,115,46,83,0,0
2759,1452,180,1500,297,18,9,1,48,117,47,83,0,0
2760,1449,179,1497,297,18,9,1,48,118,48,83,0,0
2761,1448,180,1495,295,18,9,1,47,115,49,83,0,0
2762,1448,182,1493,292,18,9,1,45,110,50,83,0,0
2763,1449,185,1492,290,18,9,1,43,105,51,83,0,0
2764,1450,187,1492,290,18,9,1,42,103,52,83,0,0
2765,1450,187,1492,289,18,9,1,42,102,53,83,0,0
2766,1449,187,1492,291,18,9,1,43,104,54,83,0,0
2767,1450,187,1492,291,18,9,1,42,104,55,83,0,0
2768,1449,184,1493,291,18,9,1,44,107,56,83,0,0
2769,1448,186,1491,290,18,9,1,43,104,57,83,0,0
2770,1447,186,1490,289,18,9,1,43,103,58,83,0,0
2771,1446,182,1491,291,18,9,1,45,109,59,83,0,0
2772,1446,177,1493,290,18,9,1,47,113,60,83,0,0
2773,1447,175,1496,292,18,9,1,49,117,61,83,0,0
2774,1447,174,1497,293,18,9,1,50,119,62,83,0,0
2775,1447,173,1497,293,18,9,1,50,120,63,83,0,0
2776,1447,174,1497,294,18,9,1,50,120,64,83,0,0
2777,1446,175,1495,293,18,9,1,49,118,65,83,0,0
2778,1446,172,1497,294,18,9,1,51,122,66,83,0,0
2779,1447,168,1500,296,18,9,1,53,128,67,83,0,0
2780,1447,164,1501,297,18,9,1,54,133,68,83,0,0
2781,1447,162,1500,294,18,9,1,53,132,69,83,0,0
2782,1446,160,1498,292,18,9,1,52,132,70,83,0,0
2783,1443,160,1493,285,18,9,1,50,125,71,83,0,0
2784,1441,157,1490,282,18,9,1,49,125,72,83,0,0
2785,1443,158,1490,278,18,9,1,47,120,73,83,0,0
2786,1444,156,1492,280,18,9,1,48,124,74,83,0,0
2787,1446,155,1495,281,18,9,1,49,126,75,83,0,0
2788,1448,155,1496,281,18,9,1,48,126,76,83,0,0
2789,1450,156,1497,280,18,9,1,47,124,77,83,0,0
2790,1454,153,1498,269,18,9,1,44,116,78,83,0,0
2791,1458,153,1498,261,18,9,1,40,108,79,83,0,0
2792,1462,152,1504,263,18,9,1,42,111,80,83,0,0
2793,1467,153,1508,262,18,9,1,41,109,81,83,0,0
2794,1470,153,1509,256,18,9,1,39,103,82,83,0,0
2795,1472,153,1510,253,18,9,1,38,100,83,83,1,0
2854,1479,154,1518,273,20,9,1,39,119,0,1,0,0
2855,1481,156,1523,284,20,9,1,42,128,1,1,0,0
2858,1480,161,1525,279,21,9,1,45,118,0,1,0,0
2859,1473,160,1523,290,21,9,1,50,130,1,1,0,0
2862,1465,156,1505,274,22,9,1,40,118,0,40,0,1
2863,1461,155,1498,264,22,9,1,37,109,1,40,0,0
2864,1456,152,1493,263,22,9,1,37,111,2,40,0,0
2865,1453,153,1492,266,22,9,1,39,113,3,40,0,0
2866,1452,155,1489,265,22,9,1,37,110,4,40,0,0
2867,1450,155,1489,269,22,9,1,39,114,5,40,0,0
2868,1447,158,1488,274,22,9,1,41,116,6,40,0,0
2869,1443,159,1486,282,22,9,1,43,123,7,40,0,0
2870,1440,158,1485,284,22,9,1,45,126,8,40,0,0
2871,1439,159,1484,288,22,9,1,45,129,9,40,0,0
2872,1440,163,1484,289,22,9,1,44,126,10,40,0,0
2873,1442,165,1485,286,22,9,1,43,121,11,40,0,0
2874,1445,165,1488,287,22,9,1,43,122,12,40,0,0
2875,1446,168,1490,293,22,9,1,44,125,13,40,0,0
2876,1447,170,1491,296,22,9,1,44,126,14,40,0,0
2877,1447,172,1491,300,22,9,1,44,128,15,40,0,0
2878,1445,171,1488,298,22,9,1,43,127,16,40,0,0
2879,1441,172,1485,298,22,9,1,44,126,17,40,0,0
2880,1437,169,1479,290,22,9,1,42,121,18,40,0,0
2881,1431,167,1472,286,22,9,1,41,119,19,40,0,0
2882,1427,165,1469,288,22,9,1,42,123,20,40,0,0
2883,1425,164,1466,284,22,9,1,41,120,21,40,0,0
2884,1426,162,1469,285,22,9,1,43,123,22,40,0,0
2885,1426,160,1470,285,22,9,1,44,125,23,40,0,0
2886,1425,160,1470,287,22,9,1,45,127,24,40,0,0
2887,1425,160,1470,287,22,9,1,45,127,25,40,0,0
2888,1424,161,1470,291,22,9,1,46,130,26,40,0,0
2889,1425,161,1470,289,22,9,1,45,128,27,40,0,0
2890,1425,161,1471,289,22,9,1,46,128,28,40,0,0
2891,1425,162,1472,292,22,9,1,47,130,29,40,0,0
2892,1426,160,1472,290,22,9,1,46,130,30,40,0,0
2893,1426,160,1472,289,22,9,1,46,129,31,40,0,0
2894,1426,160,1473,289,22,9,1,47,129,32,40,0,0
2895,1425,160,1472,291,22,9,1,47,131,33,40,0,0
2896,1424,160,1471,293,22,9,1,47,133,34,40,0,0
2897,1424,160,1471,293,22,9,1,47,133,35,40,0,0
2898,1424,159,1471,293,22,9,1,47,134,36,40,0,0
2899,1425,161,1471,289,22,9,1,46,128,37,40,0,0
2900,1427,163,1473,290,22,9,1,46,127,38,40,0,0
2901,1423,162,1470,292,22,9,1,47,130,39,40,0,0
2902,1423,162,1469,292,22,9,1,46,130,40,40,1,0
3274,1446,161,1482,288,23,9,1,36,127,0,8,0,0
3275,1446,161,1483,290,23,9,1,37,129,1,8,0,0
3276,1443,161,1482,293,23,9,1,39,132,2,8,0,0
3277,1441,162,1480,293,23,9,1,39,131,3,8,0,0
3278,1440,161,1480,291,23,9,1,40,130,4,8,0,0
3279,1439,163,1478,290,23,9,1,39,127,5,8,0,0
3280,1436,163,1477,288,23,9,1,41,125,6,8,0,0
3281,1426,161,1468,288,23,9,1,42,127,7,8,0,0
3282,1426,161,1467,289,23,9,1,41,128,8,8,0,0
3273,1480,181,1529,301,24,9,1,49,120,0,0,0,0
3937,1262,189,1337,438,25,9,1,75,249,0,35,0,1
3938,1262,190,1334,431,25,9,1,72,241,1,35,0,0
3939,1279,191,1356,441,25,9,1,77,250,2,35,0,0
3940,1294,197,1374,452,25,9,1,80,255,3,35,0,0
3941,1300,200,1384,463,25,9,1,84,263,4,35,0,0
3942,1315,205,1399,467,25,9,1,84,262,5,35,0,0
3943,1329,214,1417,486,25,9,1,88,272,6,35,0,0
3944,1344,211,1437,497,25,9,1,93,286,7,35,0,0
3945,1347,215,1447,516,25,9,1,100,301,8,35,0,0
3946,1350,222,1454,529,25,9,1,104,307,9,35,0,0
3947,1356,224,1462,537,25,9,1,106,313,10,35,0,0
3948,1357,234,1467,553,25,9,1,110,319,11,35,0,0
3949,1360,242,1476,581,25,9,1,116,339,12,35,0,0
3950,1362,242,1484,595,25,9,1,122,353,13,35,0,0
3951,1363,254,1489,615,25,9,1,126,361,14,35,0,0
3952,1360,261,1490,637,25,9,1,130,376,15,35,0,0
3953,1352,266,1489,655,25,9,1,137,389,16,35,0,0
3954,1345,281,1491,691,25,9,1,146,410,17,35,0,0
3955,1341,291,1493,715,25,9,1,152,424,18,35,0,0
3956,1341,299,1496,730,25,9,1,155,431,19,35,0,0
3957,1332,314,1497,775,25,9,1,165,461,20,35,0,0
3958,1322,323,1492,798,25,9,1,170,475,21,35,0,0
3959,1307,330,1490,835,25,9,1,183,505,22,35,0,0
3960,1294,347,1493,895,25,9,1,199,548,23,35,0,0
3961,1296,355,1502,921,25,9,1,206,566,24,35,0,0
3962,1294,374,1517,985,25,9,1,223,611,25,35,0,0
3963,1283,399,1518,1044,25,9,1,235,645,26,35,0,0
3964,1262,413,1502,1067,25,9,1,240,654,27,35,0,0
3965,1241,443,1480,1079,25,9,1,239,636,28,35,0,0
3966,1230,487,1463,1080,25,9,1,233,593,29,35,0,0
3967,1219,512,1452,1080,25,9,1,233,568,30,35,0,0
3968,1195,564,1420,1080,25,9,1,225,516,31,35,0,0
3969,1148,626,1356,1076,25,9,1,208,450,32,35,0,0
3970,1072,677,1276,1079,25,9,1,204,402,33,35,0,0
3971,1022,775,1203,1079,25,9,1,181,304,34,35,0,0
3972,1002,815,1167,1080,25,9,1,165,265,35,35,1,0
4305,1585,157,1620,277,28,9,1,35,120,0,10,0,0
4306,1577,158,1614,288,28,9,1,37,130,1,10,0,0
4307,1569,161,1608,296,28,9,1,39,135,2,10,0,0
4308,1562,161,1601,297,28,9,1,39,136,3,10,0,0
4309,1554,163,1594,301,28,9,1,40,138,4,10,0,0
4310,1545,165,1586,304,28,9,1,41,139,5,10,0,0
4311,1535,167,1577,312,28,9,1,42,145,6,10,0,0
4312,1524,168,1568,316,28,9,1,44,148,7,10,0,0
4313,1515,168,1559,319,28,9,1,44,151,8,10,0,0
4314,1503,173,1547,322,28,9,1,44,149,9,10,0,0
4315,1494,175,1539,326,28,9,1,45,151,10,10,0,0
4312,1471,198,1527,317,29,9,1,56,119,0,13,0,0
4313,1470,201,1527,322,29,9,1,57,121,1,13,0,0
4314,1463,198,1524,329,29,9,1,61,131,2,13,0,0
4315,1465,179,1535,330,29,9,1,70,151,3,13,0,0
4316,1458,176,1531,337,29,9,1,73,161,4,13,0,0
4317,1446,174,1520,339,29,9,1,74,165,5,13,0,0
4318,1426,173,1502,342,29,9,1,76,169,6,13,0,0
4319,1410,178,1486,347,29,9,1,76,169,7,13,0,0
4320,1385,175,1463,352,29,9,1,78,177,8,13,0,0
4321,1364,176,1442,355,29,9,1,78,179,9,13,0,0
4322,1338,177,1413,350,29,9,1,75,173,10,13,0,0
4323,1309,178,1383,352,29,9,1,74,174,11,13,0,0
4324,1281,181,1355,355,29,9,1,74,174,12,13,0,0
4325,1264,180,1340,357,29,9,1,76,177,13,13,0,0
265,1828,915,1920,1079,1,9,10,92,164,0,0,0,0
267,1521,864,1719,1075,3,9,10,198,211,0,0,0,0
268,1298,812,1553,1075,4,9,10,255,263,0,0,0,0
269,1140,759,1407,1065,5,9,10,267,306,0,0,0,0
270,948,709,1219,1067,6,9,10,271,358,0,0,0,0
271,756,632,1073,1066,7,9,10,317,434,0,19,0,1
272,641,616,972,1069,7,9,10,331,453,1,19,0,0
273,536,574,900,1076,7,9,10,364,502,2,19,0,0
274,433,528,827,1077,7,9,10,394,549,3,19,0,0
275,355,501,757,1073,7,9,10,402,572,4,19,0,0
276,293,461,714,1075,7,9,10,421,614,5,19,0,0
277,262,448,665,1052,7,9,10,403,604,6,19,0,0
278,247,420,603,968,7,9,10,356,548,7,19,0,0
279,227,401,559,930,7,9,10,332,529,8,19,0,0
280,210,380,515,882,7,9,10,305,502,9,19,0,0
281,192,362,476,848,7,9,10,284,486,10,19,0,0
282,179,353,443,821,7,9,10,264,468,11,19,0,0
283,166,336,403,771,7,9,10,237,435,12,19,0,0
284,146,332,368,754,7,9,10,222,422,13,19,0,0
285,120,324,324,721,7,9,10,204,397,14,19,0,0
286,93,314,283,698,7,9,10,190,384,15,19,0,0
287,69,315,240,669,7,9,10,171,354,16,19,0,0
288,35,304,197,649,7,9,10,162,345,17,19,0,0
289,15,309,165,637,7,9,10,150,328,18,19,0,0
290,0,299,127,613,7,9,10,127,314,19,19,0,0
406,930,373,996,660,8,9,10,66,287,0,88,0,1
407,909,375,990,725,8,9,10,81,350,1,88,0,0
408,886,378,977,765,8,9,10,91,387,2,88,0,0
409,858,381,953,782,8,9,10,95,401,3,88,0,0
410,818,372,915,770,8,9,10,97,398,4,88,0,0
411,843,396,941,798,8,9,10,98,402,5,88,0,0
412,764,380,866,787,8,9,10,102,407,6,88,0,0
413,774,389,880,815,8,9,10,106,426,7,88,0,0
414,745,395,854,822,8,9,10,109,427,8,88,0,0
415,700,395,818,828,8,9,10,118,433,9,88,0,0
416,659,384,779,818,8,9,10,120,434,10,88,0,0
417,625,377,743,801,8,9,10,118,424,11,88,0,0
418,572,375,696,798,8,9,10,124,423,12,88,0,0
419,538,373,665,795,8,9,10,127,422,13,88,0,0
420,492,361,621,780,8,9,10,129,419,14,88,0,0
421,460,367,588,775,8,9,10,128,408,15,88,0,0
422,417,355,549,763,8,9,10,132,408,16,88,0,0
423,397,345,523,731,8,9,10,126,386,17,88,0,0
424,370,341,497,721,8,9,10,127,380,18,88,0,0
425,347,338,473,710,8,9,10,126,372,19,88,0,0
426,330,335,451,682,8,9,10,121,347,20,88,0,0
427,319,329,437,669,8,9,10,118,340,21,88,0,0
428,302,320,422,664,8,9,10,120,344,22,88,0,0
429,291,310,408,644,8,9,10,117,334,23,88,0,0
430,284,309,398,638,8,9,10,114,329,24,88,0,0
431,272,306,385,631,8,9,10,113,325,25,88,0,0
432,266,299,373,608,8,9,10,107,309,26,88,0,0
433,267,298,365,584,8,9,10,98,286,27,88,0,0
434,261,292,360,579,8,9,10,99,287,28,88,0,0
435,256,282,352,562,8,9,10,96,280,29,88,0,0
436,251,281,347,558,8,9,10,96,277,30,88,0,0
437,245,278,340,554,8,9,10,95,276,31,88,0,0
438,240,273,332,537,8,9,10,92,264,32,88,0,0
439,235,271,326,530,8,9,10,91,259,33,88,0,0
440,235,265,323,513,8,9,10,88,248,34,88,0,0
441,237,265,322,504,8,9,10,85,239,35,88,0,0
442,232,267,314,498,8,9,10,82,231,36,88,0,0
443,219,264,299,481,8,9,10,80,217,37,88,0,0
444,217,262,297,482,8,9,10,80,220,38,88,0,0
445,213,259,294,485,8,9,10,81,226,39,88,0,0
446,205,254,286,476,8,9,10,81,222,40,88,0,0
447,205,253,280,461,8,9,10,75,208,41,88,0,0
448,198,253,271,456,8,9,10,73,203,42,88,0,0
449,188,244,262,448,8,9,10,74,204,43,88,0,0
450,186,243,262,454,8,9,10,76,211,44,88,0,0
451,185,236,258,441,8,9,10,73,205,45,88,0,0
452,184,235,254,432,8,9,10,70,197,46,88,0,0
453,182,238,250,428,8,9,10,68,190,47,88,0,0
454,178,236,242,417,8,9,10,64,181,48,88,0,0
455,177,235,239,410,8,9,10,62,175,49,88,0,0
456,178,236,238,405,8,9,10,60,169,50,88,0,0
457,178,234,236,400,8,9,10,58,166,51,88,0,0
458,177,233,237,400,8,9,10,60,167,52,88,0,0
459,176,236,232,395,8,9,10,56,159,53,88,0,0
460,173,232,230,389,8,9,10,57,157,54,88,0,0
461,174,233,229,387,8,9,10,55,154,55,88,0,0
462,174,231,228,382,8,9,10,54,151,56,88,0,0
463,174,230,227,378,8,9,10,53,148,57,88,0,0
464,173,232,225,375,8,9,10,52,143,58,88,0,0
465,171,229,222,371,8,9,10,51,142,59,88,0,0
466,169,225,220,367,8,9,10,51,142,60,88,0,0
467,169,227,219,367,8,9,10,50,140,61,88,0,0
468,168,224,218,362,8,9,10,50,138,62,88,0,0
469,169,223,218,360,8,9,10,49,137,63,88,0,0
470,167,222,217,361,8,9,10,50,139,64,88,0,0
471,166,216,216,358,8,9,10,50,142,65,88,0,0
472,167,219,214,353,8,9,10,47,134,66,88,0,0
473,168,215,214,348,8,9,10,46,133,67,88,0,0
474,168,210,216,346,8,9,10,48,136,68,88,0,0
475,167,212,214,345,8,9,10,47,133,69,88,0,0
476,165,211,211,342,8,9,10,46,131,70,88,0,0
477,165,210,210,340,8,9,10,45,130,71,88,0,0
478,166,212,210,339,8,9,10,44,127,72,88,0,0
479,165,209,210,337,8,9,10,45,128,73,88,0,0
480,165,208,209,335,8,9,10,44,127,74,88,0,0
481,162,208,206,330,8,9,10,44,122,75,88,0,0
482,160,207,204,327,8,9,10,44,120,76,88,0,0
483,160,208,202,326,8,9,10,42,118,77,88,0,0
484,160,208,201,322,8,9,10,41,114,78,88,0,0
485,158,207,199,317,8,9,10,41,110,79,88,0,0
486,157,208,196,313,8,9,10,39,105,80,88,0,0
487,152,208,191,312,8,9,10,39,104,81,88,0,0
488,151,209,188,309,8,9,10,37,100,82,88,0,0
489,150,209,187,308,8,9,10,37,99,83,88,0,0
490,148,207,185,306,8,9,10,37,99,84,88,0,0
491,146,207,183,305,8,9,10,37,98,85,88,0,0
492,141,206,179,303,8,9,10,38,97,86,88,0,0
493,140,205,176,298,8,9,10,36,93,87,88,0,0
494,138,206,173,296,8,9,10,35,90,88,88,1,0
409,906,413,1010,788,9,9,10,104,375,0,1,0,0
410,896,409,1000,787,9,9,10,104,378,1,1,0,0
411,716,388,889,764,10,9,10,173,376,0,1,0,0
412,766,405,951,809,10,9,10,185,404,1,1,0,0
413,673,365,796,749,11,9,10,123,384,0,67,0,1
414,617,362,744,755,11,9,10,127,393,1,67,0,0
415,584,357,709,745,11,9,10,125,388,2,67,0,0
416,542,351,669,742,11,9,10,127,391,3,67,0,0
417,499,344,622,721,11,9,10,123,377,4,67,0,0
418,464,334,588,715,11,9,10,124,381,5,67,0,0
419,434,330,555,700,11,9,10,121,370,6,67,0,0
420,407,324,521,671,11,9,10,114,347,7,67,0,0
421,377,314,490,661,11,9,10,113,347,8,67,0,0
422,352,312,460,642,11,9,10,108,330,9,67,0,0
423,333,306,439,635,11,9,10,106,329,10,67,0,0
424,313,299,415,617,11,9,10,102,318,11,67,0,0
425,290,301,383,591,11,9,10,93,290,12,67,0,0
426,269,295,364,596,11,9,10,95,301,13,67,0,0
427,254,290,347,592,11,9,10,93,302,14,67,0,0
428,242,290,333,582,11,9,10,91,292,15,67,0,0
429,237,282,323,558,11,9,10,86,276,16,67,0,0
430,227,276,315,557,11,9,10,88,281,17,67,0,0
431,216,277,300,547,11,9,10,84,270,18,67,0,0
432,208,273,290,534,11,9,10,82,261,19,67,0,0
433,203,271,284,531,11,9,10,81,260,20,67,0,0
434,199,270,278,523,11,9,10,79,253,21,67,0,0
435,195,264,273,511,11,9,10,78,247,22,67,0,0
436,188,259,264,499,11,9,10,76,240,23,67,0,0
437,183,258,259,496,11,9,10,76,238,24,67,0,0
438,175,256,250,491,11,9,10,75,235,25,67,0,0
439,169,258,243,488,11,9,10,74,230,26,67,0,0
440,165,256,236,476,11,9,10,71,220,27,67,0,0
441,159,256,228,466,11,9,10,69,210,28,67,0,0
442,152,257,219,463,11,9,10,67,206,29,67,0,0
443,146,250,213,457,11,9,10,67,207,30,67,0,0
444,141,247,209,456,11,9,10,68,209,31,67,0,0
445,137,247,202,448,11,9,10,65,201,32,67,0,0
446,133,243,196,440,11,9,10,63,197,33,67,0,0
447,130,240,193,437,11,9,10,63,197,34,67,0,0
448,127,239,190,438,11,9,10,63,199,35,67,0,0
449,126,232,189,430,11,9,10,63,198,36,67,0,0
450,126,233,187,427,11,9,10,61,194,37,67,0,0
451,127,233,186,419,11,9,10,59,186,38,67,0,0
452,127,231,186,415,11,9,10,59,184,39,67,0,0
453,128,233,185,413,11,9,10,57,180,40,67,0,0
454,128,233,182,405,11,9,10,54,172,41,67,0,0
455,128,232,180,397,11,9,10,52,165,42,67,0,0
456,129,233,180,395,11,9,10,51,162,43,67,0,0
457,129,229,180,392,11,9,10,51,163,44,67,0,0
458,129,229,179,389,11,9,10,50,160,45,67,0,0
459,128,229,177,387,11,9,10,49,158,46,67,0,0
460,125,228,173,382,11,9,10,48,154,47,67,0,0
461,124,231,170,381,11,9,10,46,150,48,67,0,0
462,124,228,170,375,11,9,10,46,147,49,67,0,0
463,125,229,169,368,11,9,10,44,139,50,67,0,0
464,124,231,168,366,11,9,10,44,135,51,67,0,0
465,124,232,166,361,11,9,10,42,129,52,67,0,0
466,124,230,165,356,11,9,10,41,126,53,67,0,0
467,125,230,167,358,11,9,10,42,128,54,67,0,0
468,126,226,169,355,11,9,10,43,129,55,67,0,0
469,128,226,169,352,11,9,10,41,126,56,67,0,0
470,129,230,167,348,11,9,10,38,118,57,67,0,0
471,128,225,168,347,11,9,10,40,122,58,67,0,0
472,128,224,167,345,11,9,10,39,121,59,67,0,0
473,128,220,166,338,11,9,10,38,118,60,67,0,0
474,129,215,166,331,11,9,10,37,116,61,67,0,0
475,127,218,163,329,11,9,10,36,111,62,67,0,0
476,124,214,160,326,11,9,10,36,112,63,67,0,0
477,121,212,158,327,11,9,10,37,115,64,67,0,0
478,120,210,157,328,11,9,10,37,118,65,67,0,0
479,120,209,155,322,11,9,10,35,113,66,67,0,0
480,118,210,153,319,11,9,10,35,109,67,67,1,0
500,111,199,147,286,11,9,10,36,87,0,67,0,0
501,111,198,148,283,11,9,10,37,85,1,67,0,0
502,102,199,137,279,11,9,10,35,80,2,67,0,0
3837,247,242,287,333,13,9,10,40,91,0,34,0,1
3838,231,222,281,336,13,9,10,50,114,1,34,0,0
3839,217,222,268,337,13,9,10,51,115,2,34,0,0
3840,210,227,259,338,13,9,10,49,111,3,34,0,0
3841,201,225,248,333,13,9,10,47,108,4,34,0,0
3842,185,224,234,335,13,9,10,49,111,5,34,0,0
3843,174,219,225,337,13,9,10,51,118,6,34,0,0
3844,165,218,215,331,13,9,10,50,113,7,34,0,0
3845,157,217,208,332,13,9,10,51,115,8,34,0,0
3846,150,216,200,332,13,9,10,50,116,9,34,0,0
3847,142,218,191,332,13,9,10,49,114,10,34,0,0
3848,136,219,183,331,13,9,10,47,112,11,34,0,0
3849,130,219,177,331,13,9,10,47,112,12,34,0,0
3850,124,218,170,327,13,9,10,46,109,13,34,0,0
3851,117,218,163,326,13,9,10,46,108,14,34,0,0
3852,111,217,157,325,13,9,10,46,108,15,34,0,0
3853,106,214,152,323,13,9,10,46,109,16,34,0,0
3854,102,214,146,319,13,9,10,44,105,17,34,0,0
3855,100,216,141,317,13,9,10,41,101,18,34,0,0
3856,98,213,139,313,13,9,10,41,100,19,34,0,0
3857,96,213,138,313,13,9,10,42,100,20,34,0,0
3858,95,214,136,312,13,9,10,41,98,21,34,0,0
3859,95,212,135,310,13,9,10,40,98,22,34,0,0
3860,95,211,135,309,13,9,10,40,98,23,34,0,0
3861,96,212,136,309,13,9,10,40,97,24,34,0,0
3862,98,211,136,304,13,9,10,38,93,25,34,0,0
3863,99,207,138,300,13,9,10,39,93,26,34,0,0
3864,101,205,139,299,13,9,10,38,94,27,34,0,0
3865,102,203,141,297,13,9,10,39,94,28,34,0,0
3866,105,202,142,295,13,9,10,37,93,29,34,0,0
3867,106,200,144,294,13,9,10,38,94,30,34,0,0
3868,108,195,147,292,13,9,10,39,97,31,34,0,0
3869,111,191,150,290,13,9,10,39,99,32,34,0,0
3870,114,192,151,287,13,9,10,37,95,33,34,0,0
3871,117,193,152,285,13,9,10,35,92,34,34,1,0
4467,252,223,287,332,14,9,10,35,109,0,44,0,1
4468,244,223,279,332,14,9,10,35,109,1,44,0,0
4469,233,222,269,332,14,9,10,36,110,2,44,0,0
4470,220,221,257,334,14,9,10,37,113,3,44,0,0
4471,213,224,251,335,14,9,10,38,111,4,44,0,0
4472,206,223,245,334,14,9,10,39,111,5,44,0,0
4473,195,221,235,331,14,9,10,40,110,6,44,0,0
4474,185,218,224,329,14,9,10,39,111,7,44,0,0
4475,178,217,218,326,14,9,10,40,109,8,44,0,0
4476,176,215,215,322,14,9,10,39,107,9,44,0,0
4477,172,212,213,325,14,9,10,41,113,10,44,0,0
4478,168,209,209,322,14,9,10,41,113,11,44,0,0
4479,164,208,206,319,14,9,10,42,111,12,44,0,0
4480,163,209,204,316,14,9,10,41,107,13,44,0,0
4481,163,208,202,313,14,9,10,39,105,14,44,0,0
4482,161,208,199,311,14,9,10,38,103,15,44,0,0
4483,160,207,198,310,14,9,10,38,103,16,44,0,0
4484,159,205,197,307,14,9,10,38,102,17,44,0,0
4485,157,204,195,303,14,9,10,38,99,18,44,0,0
4486,157,203,193,298,14,9,10,36,95,19,44,0,0
4487,157,202,193,297,14,9,10,36,95,20,44,0,0
4488,157,201,192,296,14,9,10,35,95,21,44,0,0
4549,122,213,158,305,14,9,10,36,92,0,44,0,1
4550,122,214,159,310,14,9,10,37,96,1,44,0,0
4551,121,212,160,318,14,9,10,39,106,2,44,0,0
4552,122,215,162,326,14,9,10,40,111,3,44,0,0
4553,125,214,166,327,14,9,10,41,113,4,44,0,0
4554,127,214,169,326,14,9,10,42,112,5,44,0,0
4555,128,213,173,335,14,9,10,45,122,6,44,0,0
4556,128,212,176,345,14,9,10,48,133,7,44,0,0
4557,130,217,178,354,14,9,10,48,137,8,44,0,0
4558,133,219,181,356,14,9,10,48,137,9,44,0,0
4559,135,218,184,359,14,9,10,49,141,10,44,0,0
4560,136,218,185,359,14,9,10,49,141,11,44,0,0
4561,134,216,184,361,14,9,10,50,145,12,44,0,0
4562,133,219,183,366,14,9,10,50,147,13,44,0,0
4563,133,220,182,364,14,9,10,49,144,14,44,0,0
4564,132,219,182,369,14,9,10,50,150,15,44,0,0
4565,130,220,182,376,14,9,10,52,156,16,44,0,0
4566,129,222,180,377,14,9,10,51,155,17,44,0,0
4567,128,224,180,382,14,9,10,52,158,18,44,0,0
4568,126,227,179,391,14,9,10,53,164,19,44,0,0
4569,125,226,179,391,14,9,10,54,165,20,44,0,0
4570,125,226,181,395,14,9,10,56,169,21,44,0,0
4571,124,229,180,398,14,9,10,56,169,22,44,0,0
4572,123,230,179,400,14,9,10,56,170,23,44,0,0
4573,122,232,179,411,14,9,10,57,179,24,44,0,0
4574,122,233,181,417,14,9,10,59,184,25,44,0,0
4575,127,231,186,416,14,9,10,59,185,26,44,0,0
4576,127,234,188,423,14,9,10,61,189,27,44,0,0
4577,124,234,187,431,14,9,10,63,197,28,44,0,0
4578,121,234,186,441,14,9,10,65,207,29,44,0,0
4579,120,239,185,447,14,9,10,65,208,30,44,0,0
4580,120,237,187,450,14,9,10,67,213,31,44,0,0
4581,118,241,187,460,14,9,10,69,219,32,44,0,0
4582,114,244,183,465,14,9,10,69,221,33,44,0,0
4583,107,245,176,469,14,9,10,69,224,34,44,0,0
4584,101,250,171,476,14,9,10,70,226,35,44,0,0
4585,97,251,164,469,14,9,10,67,218,36,44,0,0
4586,89,252,162,486,14,9,10,73,234,37,44,0,0
4587,79,257,153,497,14,9,10,74,240,38,44,0,0
4588,68,256,144,502,14,9,10,76,246,39,44,0,0
4589,56,257,133,511,14,9,10,77,254,40,44,0,0
4590,46,260,125,523,14,9,10,79,263,41,44,0,0
4591,34,260,115,536,14,9,10,81,276,42,44,0,0
4592,35,267,96,469,14,9,10,61,202,43,44,0,0
4593,30,269,90,470,14,9,10,60,201,44,44,1,0
4474,208,222,248,331,15,9,10,40,109,0,0,0,0
4532,101,180,138,281,16,9,10,37,101,0,17,0,0
4533,103,180,138,275,16,9,10,35,95,1,17,0,0
4534,101,179,138,280,16,9,10,37,101,2,17,0,0
4535,100,179,138,284,16,9,10,38,105,3,17,0,0
4536,100,179,138,284,16,9,10,38,105,4,17,0,0
4537,100,178,139,286,16,9,10,39,108,5,17,0,0
4538,100,177,140,286,16,9,10,40,109,6,17,0,0
4539,102,180,139,279,16,9,10,37,99,7,17,0,0
4540,100,176,141,292,16,9,10,41,116,8,17,0,0
4541,99,179,143,305,16,9,10,44,126,9,17,0,0
4542,98,176,144,310,16,9,10,46,134,10,17,0,0
4543,101,177,145,307,16,9,10,44,130,11,17,0,0
4544,102,176,147,311,16,9,10,45,135,12,17,0,0
4545,101,169,148,310,16,9,10,47,141,13,17,0,0
4546,103,174,150,318,16,9,10,47,144,14,17,0,0
4547,107,179,153,323,16,9,10,46,144,15,17,0,0
4548,112,185,154,318,16,9,10,42,133,16,17,0,0
4549,112,185,155,321,16,9,10,43,136,17,17,0,0
5822,25,328,109,560,17,9,10,84,232,0,63,0,1
5823,15,313,109,574,17,9,10,94,261,1,63,0,0
5824,25,309,120,572,17,9,10,95,263,2,63,0,0
5825,44,305,136,561,17,9,10,92,256,3,63,0,0
5826,63,302,153,552,17,9,10,90,250,4,63,0,0
5827,75,299,163,540,17,9,10,88,241,5,63,0,0
5828,79,294,166,533,17,9,10,87,239,6,63,0,0
5829,82,292,167,529,17,9,10,85,237,7,63,0,0
5830,90,287,172,517,17,9,10,82,230,8,63,0,0
5831,97,284,176,509,17,9,10,79,225,9,63,0,0
5832,99,285,177,508,17,9,10,78,223,10,63,0,0
5833,101,281,177,502,17,9,10,76,221,11,63,0,0
5834,106,282,179,492,17,9,10,73,210,12,63,0,0
5835,109,278,184,494,17,9,10,75,216,13,63,0,0
5836,113,271,185,484,17,9,10,72,213,14,63,0,0
5837,117,269,186,480,17,9,10,69,211,15,63,0,0
5838,119,266,186,471,17,9,10,67,205,16,63,0,0
5839,124,263,189,465,17,9,10,65,202,17,63,0,0
5840,125,265,191,467,17,9,10,66,202,18,63,0,0
5841,125,260,191,461,17,9,10,66,201,19,63,0,0
5842,127,262,188,453,17,9,10,61,191,20,63,0,0
5843,128,261,184,441,17,9,10,56,180,21,63,0,0
5844,130,257,186,433,17,9,10,56,176,22,63,0,0
5845,130,257,186,433,17,9,10,56,176,23,63,0,0
5846,131,251,188,431,17,9,10,57,180,24,63,0,0
5847,131,248,187,426,17,9,10,56,178,25,63,0,0
5848,130,248,186,427,17,9,10,56,179,26,63,0,0
5849,133,243,185,413,17,9,10,52,170,27,63,0,0
5850,134,242,185,407,17,9,10,51,165,28,63,0,0
5851,137,240,187,401,17,9,10,50,161,29,63,0,0
5852,139,240,189,395,17,9,10,50,155,30,63,0,0
5853,141,241,191,395,17,9,10,50,154,31,63,0,0
5854,144,241,192,388,17,9,10,48,147,32,63,0,0
5855,146,240,195,388,17,9,10,49,148,33,63,0,0
5856,147,241,197,388,17,9,10,50,147,34,63,0,0
5857,150,239,198,380,17,9,10,48,141,35,63,0,0
5858,151,236,200,382,17,9,10,49,146,36,63,0,0
5859,151,234,200,378,17,9,10,49,144,37,63,0,0
5860,152,234,200,370,17,9,10,48,136,38,63,0,0
5861,152,234,200,368,17,9,10,48,134,39,63,0,0
5862,153,232,200,361,17,9,10,47,129,40,63,0,0
5863,153,231,202,362,17,9,10,49,131,41,63,0,0
5864,153,231,201,358,17,9,10,48,127,42,63,0,0
5865,153,227,200,351,17,9,10,47,124,43,63,0,0
5866,150,225,199,353,17,9,10,49,128,44,63,0,0
5867,150,222,199,349,17,9,10,49,127,45,63,0,0
5868,150,221,198,345,17,9,10,48,124,46,63,0,0
5869,148,226,194,341,17,9,10,46,115,47,63,0,0
5870,147,226,191,338,17,9,10,44,112,48,63,0,0
5871,145,227,190,338,17,9,10,45,111,49,63,0,0
5872,143,226,188,335,17,9,10,45,109,50,63,0,0
5873,141,223,185,330,17,9,10,44,107,51,63,0,0
5874,138,223,182,328,17,9,10,44,105,52,63,0,0
5875,136,219,179,325,17,9,10,43,106,53,63,0,0
5876,133,218,177,325,17,9,10,44,107,54,63,0,0
5877,133,217,176,323,17,9,10,43,106,55,63,0,0
5878,134,216,177,321,17,9,10,43,105,56,63,0,0
5879,133,218,174,318,17,9,10,41,100,57,63,0,0
5880,130,215,171,315,17,9,10,41,100,58,63,0,0
5881,128,214,168,313,17,9,10,40,99,59,63,0,0
5882,127,214,165,312,17,9,10,38,98,60,63,0,0
5883,126,210,164,307,17,9,10,38,97,61,63,0,0
5884,126,208,163,304,17,9,10,37,96,62,63,0,0
5885,124,209,160,303,17,9,10,36,94,63,63,1,0
269,1793,773,1920,1073,2,9,11,127,300,0,0,0,0
31,315,121,351,238,1,9,12,36,117,0,64,0,1
32,316,122,351,239,1,9,12,35,117,1,64,0,0
33,316,121,353,243,1,9,12,37,122,2,64,0,0
34,317,121,354,247,1,9,12,37,126,3,64,0,0
35,319,121,357,250,1,9,12,38,129,4,64,0,0
36,318,121,357,252,1,9,12,39,131,5,64,0,0
37,318,124,356,254,1,9,12,38,130,6,64,0,0
38,318,124,356,255,1,9,12,38,131,7,64,0,0
39,318,127,356,259,1,9,12,38,132,8,64,0,0
40,321,129,358,259,1,9,12,37,130,9,64,0,0
41,319,126,358,265,1,9,12,39,139,10,64,0,0
42,319,129,359,269,1,9,12,40,140,11,64,0,0
43,319,128,360,272,1,9,12,41,144,12,64,0,0
44,320,136,360,276,1,9,12,40,140,13,64,0,0
45,321,135,361,279,1,9,12,40,144,14,64,0,0
46,320,136,361,283,1,9,12,41,147,15,64,0,0
47,320,134,362,286,1,9,12,42,152,16,64,0,0
48,319,134,363,293,1,9,12,44,159,17,64,0,0
49,321,142,364,297,1,9,12,43,155,18,64,0,0
50,321,139,366,299,1,9,12,45,160,19,64,0,0
51,321,137,368,304,1,9,12,47,167,20,64,0,0
52,323,142,370,306,1,9,12,47,164,21,64,0,0
53,324,145,372,312,1,9,12,48,167,22,64,0,0
54,327,149,376,319,1,9,12,49,170,23,64,0,0
55,327,143,379,326,1,9,12,52,183,24,64,0,0
56,328,144,381,334,1,9,12,53,190,25,64,0,0
57,329,145,384,337,1,9,12,55,192,26,64,0,0
58,330,145,386,342,1,9,12,56,197,27,64,0,0
59,334,154,389,350,1,9,12,55,196,28,64,0,0
60,335,152,394,359,1,9,12,59,207,29,64,0,0
61,336,157,395,366,1,9,12,59,209,30,64,0,0
62,340,164,399,371,1,9,12,59,207,31,64,0,0
63,342,168,404,382,1,9,12,62,214,32,64,0,0
64,344,170,407,389,1,9,12,63,219,33,64,0,0
65,344,171,410,400,1,9,12,66,229,34,64,0,0
66,344,177,411,406,1,9,12,67,229,35,64,0,0
67,345,178,414,412,1,9,12,69,234,36,64,0,0
68,347,180,419,425,1,9,12,72,245,37,64,0,0
69,348,179,423,432,1,9,12,75,253,38,64,0,0
70,346,180,427,449,1,9,12,81,269,39,64,0,0
71,346,183,431,461,1,9,12,85,278,40,64,0,0
72,350,185,439,477,1,9,12,89,292,41,64,0,0
73,358,195,450,491,1,9,12,92,296,42,64,0,0
74,362,194,458,503,1,9,12,96,309,43,64,0,0
75,367,206,464,516,1,9,12,97,310,44,64,0,0
76,372,211,474,535,1,9,12,102,324,45,64,0,0
77,383,225,488,555,1,9,12,105,330,46,64,0,0
78,391,231,502,578,1,9,12,111,347,47,64,0,0
79,393,232,515,610,1,9,12,122,378,48,64,0,0
80,394,244,524,647,1,9,12,130,403,49,64,0,0
81,402,249,536,665,1,9,12,134,416,50,64,0,0
82,412,265,551,698,1,9,12,139,433,51,64,0,0
83,425,276,569,726,1,9,12,144,450,52,64,0,0
84,429,284,585,776,1,9,12,156,492,53,64,0,0
85,444,310,607,822,1,9,12,163,512,54,64,0,0
86,462,320,636,862,1,9,12,174,542,55,64,0,0
87,486,347,674,930,1,9,12,188,583,56,64,0,0
88,512,362,707,967,1,9,12,195,605,57,64,0,0
89,539,397,750,1044,1,9,12,211,647,58,64,0,0
90,579,430,792,1076,1,9,12,213,646,59,64,0,0
91,624,465,836,1080,1,9,12,212,615,60,64,0,0
92,695,524,898,1080,1,9,12,203,556,61,64,0,0
93,769,572,969,1080,1,9,12,200,508,62,64,0,0
94,873,668,1059,1080,1,9,12,186,412,63,64,0,0
95,911,698,1092,1080,1,9,12,181,382,64,64,1,0
1775,296,118,332,201,6,9,12,36,83,0,94,0,0
1776,299,118,334,200,6,9,12,35,82,1,94,0,0
1777,300,118,335,200,6,9,12,35,82,2,94,0,0
1780,301,118,336,202,6,9,12,35,84,0,94,0,1
1781,302,118,337,203,6,9,12,35,85,1,94,0,0
1782,302,118,338,203,6,9,12,36,85,2,94,0,0
1783,304,120,339,203,6,9,12,35,83,3,94,0,0
1784,301,120,337,204,6,9,12,36,84,4,94,0,0
1785,301,119,336,205,6,9,12,35,86,5,94,0,0
1786,300,120,335,205,6,9,12,35,85,6,94,0,0
1787,301,119,337,205,6,9,12,36,86,7,94,0,0
1788,302,122,337,206,6,9,12,35,84,8,94,0,0
1789,300,121,337,210,6,9,12,37,89,9,94,0,0
1790,300,125,336,214,6,9,12,36,89,10,94,0,0
1791,301,124,338,215,6,9,12,37,91,11,94,0,0
1792,302,123,339,214,6,9,12,37,91,12,94,0,0
1793,302,124,339,217,6,9,12,37,93,13,94,0,0
1794,301,123,337,218,6,9,12,36,95,14,94,0,0
1795,300,122,338,221,6,9,12,38,99,15,94,0,0
1796,300,126,338,223,6,9,12,38,97,16,94,0,0
1797,301,124,339,224,6,9,12,38,100,17,94,0,0
1798,302,128,339,225,6,9,12,37,97,18,94,0,0
1799,303,129,339,228,6,9,12,36,99,19,94,0,0
1800,304,130,340,229,6,9,12,36,99,20,94,0,0
1801,304,131,341,231,6,9,12,37,100,21,94,0,0
1802,306,129,343,232,6,9,12,37,103,22,94,0,0
1803,307,132,344,236,6,9,12,37,104,23,94,0,0
1804,309,130,346,236,6,9,12,37,106,24,94,0,0
1805,309,132,346,238,6,9,12,37,106,25,94,0,0
1806,310,126,350,241,6,9,12,40,115,26,94,0,0
1807,312,121,353,241,6,9,12,41,120,27,94,0,0
1808,313,120,355,245,6,9,12,42,125,28,94,0,0
1809,314,119,356,246,6,9,12,42,127,29,94,0,0
1810,314,118,357,248,6,9,12,43,130,30,94,0,0
1811,314,117,358,252,6,9,12,44,135,31,94,0,0
1812,316,117,360,254,6,9,12,44,137,32,94,0,0
1813,319,120,363,257,6,9,12,44,137,33,94,0,0
1814,319,119,363,258,6,9,12,44,139,34,94,0,0
1815,318,118,363,260,6,9,12,45,142,35,94,0,0
1816,318,118,364,265,6,9,12,46,147,36,94,0,0
1817,321,126,366,267,6,9,12,45,141,37,94,0,0
1818,325,134,368,271,6,9,12,43,137,38,94,0,0
1819,325,139,368,273,6,9,12,43,134,39,94,0,0
1820,324,133,369,275,6,9,12,45,142,40,94,0,0
1821,326,139,370,279,6,9,12,44,140,41,94,0,0
1822,328,139,373,281,6,9,12,45,142,42,94,0,0
1823,328,134,376,287,6,9,12,48,153,43,94,0,0
1824,327,132,377,290,6,9,12,50,158,44,94,0,0
1825,328,132,379,293,6,9,12,51,161,45,94,0,0
1826,330,138,381,301,6,9,12,51,163,46,94,0,0
1827,334,147,383,302,6,9,12,49,155,47,94,0,0
1828,337,148,386,305,6,9,12,49,157,48,94,0,0
1829,338,152,389,312,6,9,12,51,160,49,94,0,0
1830,339,150,391,315,6,9,12,52,165,50,94,0,0
1831,340,157,391,320,6,9,12,51,163,51,94,0,0
1832,345,161,395,321,6,9,12,50,160,52,94,0,0
1833,348,158,402,328,6,9,12,54,170,53,94,0,0
1834,349,160,404,333,6,9,12,55,173,54,94,0,0
1835,352,160,407,336,6,9,12,55,176,55,94,0,0
1836,353,166,409,344,6,9,12,56,178,56,94,0,0
1837,358,170,414,348,6,9,12,56,178,57,94,0,0
1838,364,167,422,353,6,9,12,58,186,58,94,0,0
1839,363,172,424,363,6,9,12,61,191,59,94,0,0
1840,362,172,426,366,6,9,12,64,194,60,94,0,0
1841,364,175,430,374,6,9,12,66,199,61,94,0,0
1842,366,180,433,382,6,9,12,67,202,62,94,0,0
1843,370,183,438,387,6,9,12,68,204,63,94,0,0
1844,370,186,442,397,6,9,12,72,211,64,94,0,0
1845,372,189,445,400,6,9,12,73,211,65,94,0,0
1846,369,189,445,409,6,9,12,76,220,66,94,0,0
1847,374,198,450,420,6,9,12,76,222,67,94,0,0
1848,383,199,461,425,6,9,12,78,226,68,94,0,0
1849,385,203,467,439,6,9,12,82,236,69,94,0,0
1850,385,205,471,451,6,9,12,86,246,70,94,0,0
1851,383,206,473,463,6,9,12,90,257,71,94,0,0
1852,387,212,479,480,6,9,12,92,268,72,94,0,0
1853,396,214,491,488,6,9,12,95,274,73,94,0,0
1854,405,218,504,503,6,9,12,99,285,74,94,0,0
1855,410,224,516,526,6,9,12,106,302,75,94,0,0
1856,415,227,525,538,6,9,12,110,311,76,94,0,0
1857,420,238,534,557,6,9,12,114,319,77,94,0,0
1858,430,240,548,574,6,9,12,118,334,78,94,0,0
1859,437,244,564,603,6,9,12,127,359,79,94,0,0
1860,444,254,577,630,6,9,12,133,376,80,94,0,0
1861,449,259,584,640,6,9,12,135,381,81,94,0,0
1862,450,277,588,668,6,9,12,138,391,82,94,0,0
1863,453,287,596,695,6,9,12,143,408,83,94,0,0
1864,456,297,607,725,6,9,12,151,428,84,94,0,0
1865,449,315,609,769,6,9,12,160,454,85,94,0,0
1866,437,325,603,793,6,9,12,166,468,86,94,0,0
1867,414,339,594,851,6,9,12,180,512,87,94,0,0
1868,396,361,589,906,6,9,12,193,545,88,94,0,0
1869,367,378,567,938,6,9,12,200,560,89,94,0,0
1870,331,402,542,995,6,9,12,211,593,90,94,0,0
1871,283,426,505,1037,6,9,12,222,611,91,94,0,0
1872,217,450,448,1069,6,9,12,231,619,92,94,0,0
1873,150,492,381,1070,6,9,12,231,578,93,94,0,0
1874,133,507,369,1080,6,9,12,236,573,94,94,1,0
1874,13,535,247,1070,7,9,12,234,535,0,0,0,0
4088,62,624,265,1059,8,9,12,203,435,0,58,0,1
4089,111,580,338,1066,8,9,12,227,486,1,58,0,0
4090,189,537,439,1072,8,9,12,250,535,2,58,0,0
4091,255,489,526,1071,8,9,12,271,582,3,58,0,0
4092,316,461,597,1069,8,9,12,281,608,4,58,0,0
4093,362,427,629,1010,8,9,12,267,583,5,58,0,0
4094,391,404,651,981,8,9,12,260,577,6,58,0,0
4095,415,385,663,947,8,9,12,248,562,7,58,0,0
4096,441,359,666,875,8,9,12,225,516,8,58,0,0
4097,450,348,658,839,8,9,12,208,491,9,58,0,0
4098,452,327,640,775,8,9,12,188,448,10,58,0,0
4099,457,323,627,734,8,9,12,170,411,11,58,0,0
4100,443,309,600,694,8,9,12,157,385,12,58,0,0
4101,425,292,581,680,8,9,12,156,388,13,58,0,0
4102,413,283,560,658,8,9,12,147,375,14,58,0,0
4103,402,274,536,622,8,9,12,134,348,15,58,0,0
4104,395,273,521,604,8,9,12,126,331,16,58,0,0
4105,371,261,490,579,8,9,12,119,318,17,58,0,0
4106,349,256,463,560,8,9,12,114,304,18,58,0,0
4107,339,248,449,546,8,9,12,110,298,19,58,0,0
4108,330,241,433,524,8,9,12,103,283,20,58,0,0
4109,322,238,420,511,8,9,12,98,273,21,58,0,0
4110,314,232,406,493,8,9,12,92,261,22,58,0,0
4111,310,234,396,483,8,9,12,86,249,23,58,0,0
4112,306,229,386,461,8,9,12,80,232,24,58,0,0
4113,300,224,379,458,8,9,12,79,234,25,58,0,0
4114,294,218,373,453,8,9,12,79,235,26,58,0,0
4115,294,219,365,434,8,9,12,71,215,27,58,0,0
4116,295,216,363,425,8,9,12,68,209,28,58,0,0
4117,295,209,362,414,8,9,12,67,205,29,58,0,0
4118,293,203,360,412,8,9,12,67,209,30,58,0,0
4119,293,199,357,398,8,9,12,64,199,31,58,0,0
4120,294,197,354,386,8,9,12,60,189,32,58,0,0
4121,296,195,355,380,8,9,12,59,185,33,58,0,0
4122,297,188,355,373,8,9,12,58,185,34,58,0,0
4123,297,186,353,364,8,9,12,56,178,35,58,0,0
4124,294,184,349,362,8,9,12,55,178,36,58,0,0
4125,294,184,347,354,8,9,12,53,170,37,58,0,0
4126,295,182,348,350,8,9,12,53,168,38,58,0,0
4127,297,182,347,343,8,9,12,50,161,39,58,0,0
4128,298,184,345,335,8,9,12,47,151,40,58,0,0
4129,298,181,345,329,8,9,12,47,148,41,58,0,0
4130,299,181,345,325,8,9,12,46,144,42,58,0,0
4131,302,174,348,321,8,9,12,46,147,43,58,0,0
4132,304,172,349,319,8,9,12,45,147,44,58,0,0
4133,304,168,349,315,8,9,12,45,147,45,58,0,0
4134,305,164,349,310,8,9,12,44,146,46,58,0,0
4135,309,163,352,304,8,9,12,43,141,47,58,0,0
4136,312,154,354,297,8,9,12,42,143,48,58,0,0
4137,312,146,356,295,8,9,12,44,149,49,58,0,0
4138,311,132,357,291,8,9,12,46,159,50,58,0,0
4139,312,126,358,287,8,9,12,46,161,51,58,0,0
4140,313,125,358,283,8,9,12,45,158,52,58,0,0
4141,316,128,358,278,8,9,12,42,150,53,58,0,0
4142,317,128,357,273,8,9,12,40,145,54,58,0,0
4143,316,136,354,271,8,9,12,38,135,55,58,0,0
4144,314,123,355,271,8,9,12,41,148,56,58,0,0
4145,315,120,355,266,8,9,12,40,146,57,58,0,0
4146,315,138,350,265,8,9,12,35,127,58,58,1,0
5595,316,115,351,215,9,9,12,35,100,0,66,0,1
5596,318,114,353,217,9,9,12,35,103,1,66,0,0
5597,317,113,355,221,9,9,12,38,108,2,66,0,0
5598,318,113,356,221,9,9,12,38,108,3,66,0,0
5599,319,113,358,224,9,9,12,39,111,4,66,0,0
5600,321,115,361,227,9,9,12,40,112,5,66,0,0
5601,325,117,364,227,9,9,12,39,110,6,66,0,0
5602,327,118,367,230,9,9,12,40,112,7,66,0,0
5603,328,118,369,232,9,9,12,41,114,8,66,0,0
5604,328,118,370,235,9,9,12,42,117,9,66,0,0
5605,329,118,373,237,9,9,12,44,119,10,66,0,0
5606,334,116,380,240,9,9,12,46,124,11,66,0,0
5607,337,118,383,242,9,9,12,46,124,12,66,0,0
5608,338,119,385,244,9,9,12,47,125,13,66,0,0
5609,341,119,388,248,9,9,12,47,129,14,66,0,0
5610,343,120,391,251,9,9,12,48,131,15,66,0,0
5611,344,119,393,254,9,9,12,49,135,16,66,0,0
5612,345,121,395,260,9,9,12,50,139,17,66,0,0
5613,343,120,393,261,9,9,12,50,141,18,66,0,0
5614,342,121,393,268,9,9,12,51,147,19,66,0,0
5615,343,120,395,270,9,9,12,52,150,20,66,0,0
5616,346,128,396,274,9,9,12,50,146,21,66,0,0
5617,348,132,396,275,9,9,12,48,143,22,66,0,0
5618,346,127,396,278,9,9,12,50,151,23,66,0,0
5619,348,131,398,284,9,9,12,50,153,24,66,0,0
5620,351,132,402,289,9,9,12,51,157,25,66,0,0
5621,352,134,405,295,9,9,12,53,161,26,66,0,0
5622,355,137,408,299,9,9,12,53,162,27,66,0,0
5623,356,136,411,305,9,9,12,55,169,28,66,0,0
5624,360,141,415,309,9,9,12,55,168,29,66,0,0
5625,365,139,422,315,9,9,12,57,176,30,66,0,0
5626,369,142,426,319,9,9,12,57,177,31,66,0,0
5627,372,144,429,320,9,9,12,57,176,32,66,0,0
5628,375,145,435,331,9,9,12,60,186,33,66,0,0
5629,379,148,441,342,9,9,12,62,194,34,66,0,0
5630,383,146,448,349,9,9,12,65,203,35,66,0,0
5631,387,149,454,359,9,9,12,67,210,36,66,0,0
5632,390,148,458,365,9,9,12,68,217,37,66,0,0
5633,393,152,464,377,9,9,12,71,225,38,66,0,0
5634,399,155,470,383,9,9,12,71,228,39,66,0,0
5635,400,155,474,394,9,9,12,74,239,40,66,0,0
5636,401,162,477,404,9,9,12,76,242,41,66,0,0
5637,406,158,484,411,9,9,12,78,253,42,66,0,0
5638,414,170,494,424,9,9,12,80,254,43,66,0,0
5639,420,171,502,433,9,9,12,82,262,44,66,0,0
5640,425,176,511,449,9,9,12,86,273,45,66,0,0
5641,426,185,514,468,9,9,12,88,283,46,66,0,0
5642,429,184,520,476,9,9,12,91,292,47,66,0,0
5643,434,194,529,494,9,9,12,95,300,48,66,0,0
5644,437,195,538,512,9,9,12,101,317,49,66,0,0
5645,443,200,549,535,9,9,12,106,335,50,66,0,0
5646,443,207,555,560,9,9,12,112,353,51,66,0,0
5647,447,209,566,582,9,9,12,119,373,52,66,0,0
5648,459,221,581,603,9,9,12,122,382,53,66,0,0
5649,463,221,594,627,9,9,12,131,406,54,66,0,0
5650,461,225,605,672,9,9,12,144,447,55,66,0,0
5651,456,240,609,706,9,9,12,153,466,56,66,0,0
5652,443,248,606,745,9,9,12,163,497,57,66,0,0
5653,426,269,606,813,9,9,12,180,544,58,66,0,0
5654,408,277,595,841,9,9,12,187,564,59,66,0,0
5655,379,307,581,910,9,9,12,202,603,60,66,0,0
5656,339,329,551,954,9,9,12,212,625,61,66,0,0
5657,280,348,512,1033,9,9,12,232,685,62,66,0,0
5658,231,392,464,1068,9,9,12,233,676,63,66,0,0
5659,156,416,395,1080,9,9,12,239,664,64,66,0,0
5660,97,472,330,1080,9,9,12,233,608,65,66,0,0
5661,78,488,315,1080,9,9,12,237,592,66,66,1,0
75,384,141,419,252,1,9,13,35,111,0,62,0,1
76,397,140,435,255,1,9,13,38,115,1,62,0,0
77,398,141,438,258,1,9,13,40,117,2,62,0,0
78,407,142,446,257,1,9,13,39,115,3,62,0,0
79,416,145,453,254,1,9,13,37,109,4,62,0,0
80,424,149,461,252,1,9,13,37,103,5,62,0,0
81,435,148,474,257,1,9,13,39,109,6,62,0,0
82,442,150,483,262,1,9,13,41,112,7,62,0,0
83,449,151,492,268,1,9,13,43,117,8,62,0,0
84,455,151,500,273,1,9,13,45,122,9,62,0,0
85,464,153,509,277,1,9,13,45,124,10,62,0,0
86,470,154,516,280,1,9,13,46,126,11,62,0,0
87,477,153,524,279,1,9,13,47,126,12,62,0,0
88,482,155,529,275,1,9,13,47,120,13,62,0,0
89,485,156,535,284,1,9,13,50,128,14,62,0,0
90,490,156,543,288,1,9,13,53,132,15,62,0,0
91,500,161,552,292,1,9,13,52,131,16,62,0,0
92,509,160,562,295,1,9,13,53,135,17,62,0,0
93,514,161,570,300,1,9,13,56,139,18,62,0,0
94,521,163,577,304,1,9,13,56,141,19,62,0,0
95,523,163,582,311,1,9,13,59,148,20,62,0,0
96,530,165,588,313,1,9,13,58,148,21,62,0,0
97,537,168,593,311,1,9,13,56,143,22,62,0,0
98,546,169,602,312,1,9,13,56,143,23,62,0,0
99,554,170,611,313,1,9,13,57,143,24,62,0,0
100,565,175,624,321,1,9,13,59,146,25,62,0,0
101,567,182,629,330,1,9,13,62,148,26,62,0,0
102,569,189,631,330,1,9,13,62,141,27,62,0,0
103,567,193,630,331,1,9,13,63,138,28,62,0,0
104,566,197,629,329,1,9,13,63,132,29,62,0,0
105,563,198,629,331,1,9,13,66,133,30,62,0,0
106,560,197,630,332,1,9,13,70,135,31,62,0,0
107,555,189,632,337,1,9,13,77,148,32,62,0,0
108,551,185,629,335,1,9,13,78,150,33,62,0,0
109,545,180,619,330,1,9,13,74,150,34,62,0,0
110,542,176,614,325,1,9,13,72,149,35,62,0,0
111,540,176,609,322,1,9,13,69,146,36,62,0,0
112,540,171,608,322,1,9,13,68,151,37,62,0,0
113,541,171,606,320,1,9,13,65,149,38,62,0,0
114,541,170,604,319,1,9,13,63,149,39,62,0,0
115,542,171,603,316,1,9,13,61,145,40,62,0,0
116,540,172,600,317,1,9,13,60,145,41,62,0,0
117,540,171,599,319,1,9,13,59,148,42,62,0,0
118,539,173,597,319,1,9,13,58,146,43,62,0,0
119,536,174,593,319,1,9,13,57,145,44,62,0,0
120,531,171,589,317,1,9,13,58,146,45,62,0,0
121,527,169,584,317,1,9,13,57,148,46,62,0,0
122,524,165,582,316,1,9,13,58,151,47,62,0,0
123,524,162,582,314,1,9,13,58,152,48,62,0,0
124,525,163,581,312,1,9,13,56,149,49,62,0,0
125,526,162,582,312,1,9,13,56,150,50,62,0,0
126,532,164,586,309,1,9,13,54,145,51,62,0,0
127,536,166,589,307,1,9,13,53,141,52,62,0,0
128,538,168,590,307,1,9,13,52,139,53,62,0,0
129,538,164,590,305,1,9,13,52,141,54,62,0,0
130,540,164,590,298,1,9,13,50,134,55,62,0,0
131,546,163,595,296,1,9,13,49,133,56,62,0,0
132,552,160,601,294,1,9,13,49,134,57,62,0,0
133,553,159,603,293,1,9,13,50,134,58,62,0,0
134,562,158,610,291,1,9,13,48,133,59,62,0,0
135,564,157,612,289,1,9,13,48,132,60,62,0,0
136,572,160,616,284,1,9,13,44,124,61,62,0,0
137,575,159,618,282,1,9,13,43,123,62,62,1,0
79,474,171,517,256,4,9,13,43,85,0,4,0,0
80,466,171,510,258,4,9,13,44,87,1,4,0,0
81,467,178,506,258,4,9,13,39,80,2,4,0,0
82,468,173,510,257,4,9,13,42,84,3,4,0,0
83,468,174,509,257,4,9,13,41,83,4,4,0,0
91,534,176,584,281,4,9,13,50,105,0,4,0,0
92,540,177,591,283,4,9,13,51,106,1,4,0,0
109,595,232,635,355,8,9,13,40,123,0,12,0,0
110,593,221,636,354,8,9,13,43,133,1,12,0,0
111,592,217,637,354,8,9,13,45,137,2,12,0,0
112,591,216,637,356,8,9,13,46,140,3,12,0,0
113,592,211,639,354,8,9,13,47,143,4,12,0,0
114,591,211,636,351,8,9,13,45,140,5,12,0,0
115,590,210,635,352,8,9,13,45,142,6,12,0,0
116,587,209,633,352,8,9,13,46,143,7,12,0,0
117,588,210,633,351,8,9,13,45,141,8,12,0,0
118,584,207,630,354,8,9,13,46,147,9,12,0,0
119,584,203,632,354,8,9,13,48,151,10,12,0,0
120,588,206,634,352,8,9,13,46,146,11,12,0,0
121,587,205,634,351,8,9,13,47,146,12,12,0,0
201,571,157,609,281,13,9,13,38,124,0,32,0,0
202,562,156,602,287,13,9,13,40,131,1,32,0,0
203,554,150,597,288,13,9,13,43,138,2,32,0,0
204,548,153,590,285,13,9,13,42,132,3,32,0,0
205,543,152,584,282,13,9,13,41,130,4,32,0,0
206,537,155,578,285,13,9,13,41,130,5,32,0,0
207,532,157,573,284,13,9,13,41,127,6,32,0,0
208,525,154,568,288,13,9,13,43,134,7,32,0,0
209,516,154,560,287,13,9,13,44,133,8,32,0,0
210,509,149,554,285,13,9,13,45,136,9,32,0,0
211,502,151,547,282,13,9,13,45,131,10,32,0,0
212,495,151,540,279,13,9,13,45,128,11,32,0,0
213,490,152,533,269,13,9,13,43,117,12,32,0,0
214,484,152,527,267,13,9,13,43,115,13,32,0,0
217,477,147,524,268,13,9,13,47,121,0,32,0,1
218,476,148,522,265,13,9,13,46,117,1,32,0,0
219,468,150,514,265,13,9,13,46,115,2,32,0,0
220,464,150,509,262,13,9,13,45,112,3,32,0,0
221,464,152,507,262,13,9,13,43,110,4,32,0,0
222,465,153,508,261,13,9,13,43,108,5,32,0,0
223,471,155,513,260,13,9,13,42,105,6,32,0,0
224,476,152,519,260,13,9,13,43,108,7,32,0,0
225,477,149,522,260,13,9,13,45,111,8,32,0,0
226,476,145,521,259,13,9,13,45,114,9,32,0,0
227,476,146,520,258,13,9,13,44,112,10,32,0,0
228,473,146,518,262,13,9,13,45,116,11,32,0,0
229,471,146,516,263,13,9,13,45,117,12,32,0,0
230,469,147,514,263,13,9,13,45,116,13,32,0,0
231,467,149,510,263,13,9,13,43,114,14,32,0,0
232,467,149,509,262,13,9,13,42,113,15,32,0,0
233,467,148,511,263,13,9,13,44,115,16,32,0,0
234,472,149,515,264,13,9,13,43,115,17,32,0,0
235,478,148,521,262,13,9,13,43,114,18,32,0,0
236,483,148,527,261,13,9,13,44,113,19,32,0,0
237,486,151,531,263,13,9,13,45,112,20,32,0,0
238,488,151,535,269,13,9,13,47,118,21,32,0,0
239,490,151,539,274,13,9,13,49,123,22,32,0,0
240,497,154,546,276,13,9,13,49,122,23,32,0,0
241,506,153,557,278,13,9,13,51,125,24,32,0,0
242,513,153,567,286,13,9,13,54,133,25,32,0,0
243,523,154,577,286,13,9,13,54,132,26,32,0,0
244,534,157,584,283,13,9,13,50,126,27,32,0,0
245,544,157,593,283,13,9,13,49,126,28,32,0,0
246,552,159,603,290,13,9,13,51,131,29,32,0,0
247,562,163,610,287,13,9,13,48,124,30,32,0,0
248,571,159,617,279,13,9,13,46,120,31,32,0,0
249,577,159,623,279,13,9,13,46,120,32,32,1,0
318,561,154,597,291,17,9,13,36,137,0,64,0,1
319,553,153,588,285,17,9,13,35,132,1,64,0,0
320,543,155,578,285,17,9,13,35,130,2,64,0,0
321,536,155,571,284,17,9,13,35,129,3,64,0,0
322,528,155,565,287,17,9,13,37,132,4,64,0,0
323,518,155,556,284,17,9,13,38,129,5,64,0,0
324,508,155,546,282,17,9,13,38,127,6,64,0,0
325,498,152,537,278,17,9,13,39,126,7,64,0,0
326,492,150,530,271,17,9,13,38,121,8,64,0,0
327,488,149,527,269,17,9,13,39,120,9,64,0,0
328,486,149,525,265,17,9,13,39,116,10,64,0,0
329,484,149,525,267,17,9,13,41,118,11,64,0,0
330,483,148,524,265,17,9,13,41,117,12,64,0,0
331,479,150,520,263,17,9,13,41,113,13,64,0,0
332,475,149,517,262,17,9,13,42,113,14,64,0,0
333,475,149,517,263,17,9,13,42,114,15,64,0,0
334,478,148,521,263,17,9,13,43,115,16,64,0,0
335,482,147,525,263,17,9,13,43,116,17,64,0,0
336,486,147,531,262,17,9,13,45,115,18,64,0,0
337,487,147,533,262,17,9,13,46,115,19,64,0,0
338,488,148,535,262,17,9,13,47,114,20,64,0,0
339,489,148,536,262,17,9,13,47,114,21,64,0,0
340,489,147,537,262,17,9,13,48,115,22,64,0,0
341,488,147,538,263,17,9,13,50,116,23,64,0,0
342,487,146,538,263,17,9,13,51,117,24,64,0,0
343,487,147,539,263,17,9,13,52,116,25,64,0,0
344,487,147,539,263,17,9,13,52,116,26,64,0,0
345,486,147,538,263,17,9,13,52,116,27,64,0,0
346,486,146,539,262,17,9,13,53,116,28,64,0,0
347,483,145,536,262,17,9,13,53,117,29,64,0,0
348,482,145,533,260,17,9,13,51,115,30,64,0,0
349,484,144,532,255,17,9,13,48,111,31,64,0,0
350,479,148,527,258,17,9,13,48,110,32,64,0,0
351,472,147,522,261,17,9,13,50,114,33,64,0,0
352,469,149,517,262,17,9,13,48,113,34,64,0,0
353,466,149,514,263,17,9,13,48,114,35,64,0,0
354,465,150,513,264,17,9,13,48,114,36,64,0,0
355,466,151,514,264,17,9,13,48,113,37,64,0,0
356,473,151,518,261,17,9,13,45,110,38,64,0,0
357,477,151,524,263,17,9,13,47,112,39,64,0,0
358,480,149,528,261,17,9,13,48,112,40,64,0,0
359,480,152,528,265,17,9,13,48,113,41,64,0,0
360,479,152,532,271,17,9,13,53,119,42,64,0,0
361,480,153,535,278,17,9,13,55,125,43,64,0,0
362,483,153,539,281,17,9,13,56,128,44,64,0,0
363,484,154,542,284,17,9,13,58,130,45,64,0,0
364,485,155,544,288,17,9,13,59,133,46,64,0,0
365,484,158,543,290,17,9,13,59,132,47,64,0,0
366,484,158,544,292,17,9,13,60,134,48,64,0,0
367,487,159,547,295,17,9,13,60,136,49,64,0,0
368,491,162,551,297,17,9,13,60,135,50,64,0,0
369,492,163,552,300,17,9,13,60,137,51,64,0,0
370,492,168,554,307,17,9,13,62,139,52,64,0,0
371,495,170,557,310,17,9,13,62,140,53,64,0,0
372,501,169,563,311,17,9,13,62,142,54,64,0,0
373,506,171,570,317,17,9,13,64,146,55,64,0,0
374,512,170,579,321,17,9,13,67,151,56,64,0,0
375,519,171,584,321,17,9,13,65,150,57,64,0,0
376,526,176,588,322,17,9,13,62,146,58,64,0,0
377,531,177,593,323,17,9,13,62,146,59,64,0,0
378,536,178,598,327,17,9,13,62,149,60,64,0,0
379,542,183,605,334,17,9,13,63,151,61,64,0,0
380,550,191,613,337,17,9,13,63,146,62,64,0,0
381,555,200,619,343,17,9,13,64,143,63,64,0,0
382,559,203,624,346,17,9,13,65,143,64,64,1,0
384,561,210,628,350,17,9,13,67,140,0,64,0,0
385,560,210,630,350,17,9,13,70,140,1,64,0,0
386,560,207,631,345,17,9,13,71,138,2,64,0,0
387,556,197,632,345,17,9,13,76,148,3,64,0,0
388,552,188,631,344,17,9,13,79,156,4,64,0,0
389,553,184,633,347,17,9,13,80,163,5,64,0,0
390,554,182,634,346,17,9,13,80,164,6,64,0,0
391,564,179,648,345,17,9,13,84,166,7,64,0,0
392,568,178,655,342,17,9,13,87,164,8,64,0,0
393,569,178,659,347,17,9,13,90,169,9,64,0,0
394,559,177,647,346,17,9,13,88,169,10,64,0,0
395,553,178,638,347,17,9,13,85,169,11,64,0,0
396,548,185,628,348,17,9,13,80,163,12,64,0,0
397,544,185,622,349,17,9,13,78,164,13,64,0,0
398,543,185,621,350,17,9,13,78,165,14,64,0,0
320,481,182,517,259,18,9,13,36,77,0,0,0,0
599,553,178,599,345,21,9,13,46,167,0,78,0,1
600,548,175,595,345,21,9,13,47,170,1,78,0,0
601,541,176,588,345,21,9,13,47,169,2,78,0,0
602,531,176,575,335,21,9,13,44,159,3,78,0,0
603,520,175,564,331,21,9,13,44,156,4,78,0,0
604,508,176,553,331,21,9,13,45,155,5,78,0,0
605,494,174,541,331,21,9,13,47,157,6,78,0,0
606,482,171,530,326,21,9,13,48,155,7,78,0,0
607,474,171,523,323,21,9,13,49,152,8,78,0,0
608,468,170,518,322,21,9,13,50,152,9,78,0,0
609,463,169,514,320,21,9,13,51,151,10,78,0,0
610,458,171,509,318,21,9,13,51,147,11,78,0,0
611,452,171,504,317,21,9,13,52,146,12,78,0,0
612,446,171,497,315,21,9,13,51,144,13,78,0,0
613,440,170,491,312,21,9,13,51,142,14,78,0,0
614,434,168,485,309,21,9,13,51,141,15,78,0,0
615,428,168,479,309,21,9,13,51,141,16,78,0,0
616,423,164,477,310,21,9,13,54,146,17,78,0,0
617,419,161,474,311,21,9,13,55,150,18,78,0,0
618,411,162,468,313,21,9,13,57,151,19,78,0,0
619,403,156,460,306,21,9,13,57,150,20,78,0,0
620,395,154,453,302,21,9,13,58,148,21,78,0,0
621,390,155,449,300,21,9,13,59,145,22,78,0,0
622,387,153,444,293,21,9,13,57,140,23,78,0,0
623,385,152,442,290,21,9,13,57,138,24,78,0,0
624,382,152,439,289,21,9,13,57,137,25,78,0,0
625,377,151,435,288,21,9,13,58,137,26,78,0,0
626,372,147,435,298,21,9,13,63,151,27,78,0,0
627,375,149,433,289,21,9,13,58,140,28,78,0,0
628,377,149,435,286,21,9,13,58,137,29,78,0,0
629,380,148,437,282,21,9,13,57,134,30,78,0,0
630,382,151,436,279,21,9,13,54,128,31,78,0,0
631,381,149,435,276,21,9,13,54,127,32,78,0,0
632,382,148,434,271,21,9,13,52,123,33,78,0,0
633,385,149,435,267,21,9,13,50,118,34,78,0,0
634,388,148,438,265,21,9,13,50,117,35,78,0,0
635,391,147,441,264,21,9,13,50,117,36,78,0,0
636,391,146,441,263,21,9,13,50,117,37,78,0,0
637,390,145,442,267,21,9,13,52,122,38,78,0,0
638,390,145,440,263,21,9,13,50,118,39,78,0,0
639,390,146,439,261,21,9,13,49,115,40,78,0,0
640,390,147,439,260,21,9,13,49,113,41,78,0,0
641,389,147,438,259,21,9,13,49,112,42,78,0,0
642,389,148,437,260,21,9,13,48,112,43,78,0,0
643,389,151,437,261,21,9,13,48,110,44,78,0,0
644,389,151,437,261,21,9,13,48,110,45,78,0,0
645,390,154,437,261,21,9,13,47,107,46,78,0,0
646,391,155,439,262,21,9,13,48,107,47,78,0,0
647,392,156,440,262,21,9,13,48,106,48,78,0,0
648,392,156,440,262,21,9,13,48,106,49,78,0,0
649,391,155,441,262,21,9,13,50,107,50,78,0,0
650,392,155,442,262,21,9,13,50,107,51,78,0,0
651,391,154,442,263,21,9,13,51,109,52,78,0,0
652,390,153,441,263,21,9,13,51,110,53,78,0,0
653,390,153,441,263,21,9,13,51,110,54,78,0,0
654,390,150,442,263,21,9,13,52,113,55,78,0,0
655,390,148,443,262,21,9,13,53,114,56,78,0,0
656,391,147,443,260,21,9,13,52,113,57,78,0,0
657,394,146,446,260,21,9,13,52,114,58,78,0,0
658,398,143,452,260,21,9,13,54,117,59,78,0,0
659,405,143,458,261,21,9,13,53,118,60,78,0,0
660,412,144,464,259,21,9,13,52,115,61,78,0,0
661,419,144,470,258,21,9,13,51,114,62,78,0,0
662,424,146,474,258,21,9,13,50,112,63,78,0,0
663,432,147,478,251,21,9,13,46,104,64,78,0,0
664,436,146,484,255,21,9,13,48,109,65,78,0,0
665,439,147,487,256,21,9,13,48,109,66,78,0,0
666,444,149,491,255,21,9,13,47,106,67,78,0,0
667,445,147,493,256,21,9,13,48,109,68,78,0,0
668,449,146,498,256,21,9,13,49,110,69,78,0,0
669,457,146,507,256,21,9,13,50,110,70,78,0,0
670,468,148,517,255,21,9,13,49,107,71,78,0,0
671,475,148,527,256,21,9,13,52,108,72,78,0,0
672,490,146,541,253,21,9,13,51,107,73,78,0,0
673,498,148,552,258,21,9,13,54,110,74,78,0,0
674,505,150,558,257,21,9,13,53,107,75,78,0,0
675,520,150,577,266,21,9,13,57,116,76,78,0,0
676,530,150,585,264,21,9,13,55,114,77,78,0,0
677,537,150,593,265,21,9,13,56,115,78,78,1,0
1268,542,159,583,278,24,9,13,41,119,0,40,0,1
1269,539,152,578,264,24,9,13,39,112,1,40,0,0
1270,525,147,560,248,24,9,13,35,101,2,40,0,0
1271,511,148,547,249,24,9,13,36,101,3,40,0,0
1272,495,146,534,255,24,9,13,39,109,4,40,0,0
1273,483,148,526,266,24,9,13,43,118,5,40,0,0
1274,475,150,520,272,24,9,13,45,122,6,40,0,0
1275,470,152,515,273,24,9,13,45,121,7,40,0,0
1276,463,152,511,281,24,9,13,48,129,8,40,0,0
1277,460,153,508,283,24,9,13,48,130,9,40,0,0
1278,459,154,508,290,24,9,13,49,136,10,40,0,0
1279,460,154,510,294,24,9,13,50,140,11,40,0,0
1280,463,154,514,296,24,9,13,51,142,12,40,0,0
1281,465,158,515,298,24,9,13,50,140,13,40,0,0
1282,469,158,519,300,24,9,13,50,142,14,40,0,0
1283,474,161,525,307,24,9,13,51,146,15,40,0,0
1284,482,164,533,308,24,9,13,51,144,16,40,0,0
1285,487,165,539,313,24,9,13,52,148,17,40,0,0
1286,491,168,543,316,24,9,13,52,148,18,40,0,0
1287,497,169,550,321,24,9,13,53,152,19,40,0,0
1288,504,172,558,327,24,9,13,54,155,20,40,0,0
1289,512,172,568,332,24,9,13,56,160,21,40,0,0
1290,520,176,579,345,24,9,13,59,169,22,40,0,0
1291,526,180,585,350,24,9,13,59,170,23,40,0,0
1292,536,184,594,353,24,9,13,58,169,24,40,0,0
1293,545,188,605,363,24,9,13,60,175,25,40,0,0
1294,562,194,622,366,24,9,13,60,172,26,40,0,0
1295,574,196,635,375,24,9,13,61,179,27,40,0,0
1296,587,193,652,380,24,9,13,65,187,28,40,0,0
1297,602,197,665,377,24,9,13,63,180,29,40,0,0
1298,616,199,685,389,24,9,13,69,190,30,40,0,0
1299,642,201,711,395,24,9,13,69,194,31,40,0,0
1300,663,205,733,402,24,9,13,70,197,32,40,0,0
1301,693,207,764,409,24,9,13,71,202,33,40,0,0
1302,713,211,786,413,24,9,13,73,202,34,40,0,0
1303,741,213,816,421,24,9,13,75,208,35,40,0,0
1304,773,217,847,426,24,9,13,74,209,36,40,0,0
1305,800,227,874,430,24,9,13,74,203,37,40,0,0
1306,835,228,911,440,24,9,13,76,212,38,40,0,0
1307,858,232,934,440,24,9,13,76,208,39,40,0,0
1308,878,235,954,446,24,9,13,76,211,40,40,1,0
1879,1235,783,1519,1068,26,9,13,284,285,0,0,0,0
1880,1068,699,1370,1070,27,9,13,302,371,0,0,0,0
1885,466,483,1032,1065,28,9,13,566,582,0,99,0,1
1886,364,446,947,1063,28,9,13,583,617,1,99,0,0
1887,296,426,869,1047,28,9,13,573,621,2,99,0,0
1888,255,403,787,995,28,9,13,532,592,3,99,0,0
1889,232,380,734,949,28,9,13,502,569,4,99,0,0
1890,219,365,695,917,28,9,13,476,552,5,99,0,0
1891,213,352,654,875,28,9,13,441,523,6,99,0,0
1892,213,344,628,848,28,9,13,415,504,7,99,0,0
1893,217,337,622,844,28,9,13,405,507,8,99,0,0
1894,232,331,625,837,28,9,13,393,506,9,99,0,0
1895,239,328,622,835,28,9,13,383,507,10,99,0,0
1896,256,329,613,812,28,9,13,357,483,11,99,0,0
1897,258,326,602,800,28,9,13,344,474,12,99,0,0
1898,273,330,602,793,28,9,13,329,463,13,99,0,0
1899,274,328,601,795,28,9,13,327,467,14,99,0,0
1900,276,330,598,798,28,9,13,322,468,15,99,0,0
1901,275,332,591,800,28,9,13,316,468,16,99,0,0
1902,278,333,589,799,28,9,13,311,466,17,99,0,0
1903,279,333,586,800,28,9,13,307,467,18,99,0,0
1904,280,332,583,801,28,9,13,303,469,19,99,0,0
1905,282,333,581,801,28,9,13,299,468,20,99,0,0
1906,285,332,581,802,28,9,13,296,470,21,99,0,0
1907,285,333,579,805,28,9,13,294,472,22,99,0,0
1908,287,333,578,806,28,9,13,291,473,23,99,0,0
1909,291,330,582,805,28,9,13,291,475,24,99,0,0
1910,296,328,584,803,28,9,13,288,475,25,99,0,0
1911,301,327,590,800,28,9,13,289,473,26,99,0,0
1912,308,322,599,795,28,9,13,291,473,27,99,0,0
1913,314,319,606,790,28,9,13,292,471,28,99,0,0
1914,308,318,602,790,28,9,13,294,472,29,99,0,0
1915,304,317,600,790,28,9,13,296,473,30,99,0,0
1916,304,314,604,791,28,9,13,300,477,31,99,0,0
1917,304,314,605,791,28,9,13,301,477,32,99,0,0
1918,305,313,607,791,28,9,13,302,478,33,99,0,0
1919,307,317,609,795,28,9,13,302,478,34,99,0,0
1920,306,318,609,796,28,9,13,303,478,35,99,0,0
1921,306,317,610,794,28,9,13,304,477,36,99,0,0
1922,301,322,603,795,28,9,13,302,473,37,99,0,0
1923,306,330,604,798,28,9,13,298,468,38,99,0,0
1924,302,333,600,802,28,9,13,298,469,39,99,0,0
1925,294,335,592,804,28,9,13,298,469,40,99,0,0
1926,292,330,595,806,28,9,13,303,476,41,99,0,0
1927,290,329,594,807,28,9,13,304,478,42,99,0,0
1928,288,329,590,807,28,9,13,302,478,43,99,0,0
1929,291,329,593,807,28,9,13,302,478,44,99,0,0
1930,293,330,594,805,28,9,13,301,475,45,99,0,0
1931,297,328,596,800,28,9,13,299,472,46,99,0,0
1932,296,328,597,802,28,9,13,301,474,47,99,0,0
1933,297,329,597,801,28,9,13,300,472,48,99,0,0
1934,294,327,602,812,28,9,13,308,485,49,99,0,0
1935,296,328,607,816,28,9,13,311,488,50,99,0,0
1936,315,328,629,830,28,9,13,314,502,51,99,0,0
1937,377,330,672,831,28,9,13,295,501,52,99,0,0
1938,414,337,692,832,28,9,13,278,495,53,99,0,0
1939,449,337,719,829,28,9,13,270,492,54,99,0,0
1940,449,348,705,832,28,9,13,256,484,55,99,0,0
1941,437,350,688,841,28,9,13,251,491,56,99,0,0
1942,428,352,674,849,28,9,13,246,497,57,99,0,0
1943,411,351,657,864,28,9,13,246,513,58,99,0,0
1944,398,356,640,879,28,9,13,242,523,59,99,0,0
1945,394,361,630,891,28,9,13,236,530,60,99,0,0
1946,383,360,620,905,28,9,13,237,545,61,99,0,0
1947,353,365,595,918,28,9,13,242,553,62,99,0,0
1948,334,372,582,924,28,9,13,248,552,63,99,0,0
1949,333,371,593,928,28,9,13,260,557,64,99,0,0
1950,345,373,619,931,28,9,13,274,558,65,99,0,0
1951,343,372,631,934,28,9,13,288,562,66,99,0,0
1952,341,374,640,936,28,9,13,299,562,67,99,0,0
1953,336,375,646,939,28,9,13,310,564,68,99,0,0
1954,332,377,650,940,28,9,13,318,563,69,99,0,0
1955,325,377,651,939,28,9,13,326,562,70,99,0,0
1956,321,376,654,942,28,9,13,333,566,71,99,0,0
1957,317,376,657,943,28,9,13,340,567,72,99,0,0
1958,315,377,660,943,28,9,13,345,566,73,99,0,0
1959,314,377,663,943,28,9,13,349,566,74,99,0,0
1960,313,378,665,943,28,9,13,352,565,75,99,0,0
1961,310,376,667,943,28,9,13,357,567,76,99,0,0
1962,308,375,669,943,28,9,13,361,568,77,99,0,0
1963,306,377,670,943,28,9,13,364,566,78,99,0,0
1964,305,378,671,943,28,9,13,366,565,79,99,0,0
1965,303,377,672,943,28,9,13,369,566,80,99,0,0
1966,303,377,673,943,28,9,13,370,566,81,99,0,0
1967,302,377,675,942,28,9,13,373,565,82,99,0,0
1968,300,377,676,942,28,9,13,376,565,83,99,0,0
1969,300,377,677,942,28,9,13,377,565,84,99,0,0
1970,300,378,677,942,28,9,13,377,564,85,99,0,0
1971,298,378,677,942,28,9,13,379,564,86,99,0,0
1972,297,378,678,942,28,9,13,381,564,87,99,0,0
1973,296,378,677,941,28,9,13,381,563,88,99,0,0
1974,294,379,676,941,28,9,13,382,562,89,99,0,0
1975,294,379,676,941,28,9,13,382,562,90,99,0,0
1976,294,379,677,941,28,9,13,383,562,91,99,0,0
1977,293,380,679,945,28,9,13,386,565,92,99,0,0
1978,309,390,682,948,28,9,13,373,558,93,99,0,0
1979,321,410,669,953,28,9,13,348,543,94,99,0,0
1980,305,417,642,967,28,9,13,337,550,95,99,0,0
1981,254,412,593,993,28,9,13,339,581,96,99,0,0
1982,225,432,542,996,28,9,13,317,564,97,99,0,0
1983,216,486,490,991,28,9,13,274,505,98,99,0,0
1984,204,496,475,996,28,9,13,271,500,99,99,1,0
1925,487,347,613,689,29,9,13,126,342,0,0,0,0
2032,534,132,584,275,30,9,13,50,143,0,43,0,1
2033,521,133,567,266,30,9,13,46,133,1,43,0,0
2034,503,138,548,264,30,9,13,45,126,2,43,0,0
2035,494,136,539,261,30,9,13,45,125,3,43,0,0
2036,484,137,528,259,30,9,13,44,122,4,43,0,0
2037,471,140,516,264,30,9,13,45,124,5,43,0,0
2038,461,137,506,261,30,9,13,45,124,6,43,0,0
2039,443,138,491,264,30,9,13,48,126,7,43,0,0
2040,433,139,480,265,30,9,13,47,126,8,43,0,0
2041,423,140,469,263,30,9,13,46,123,9,43,0,0
2042,407,138,457,267,30,9,13,50,129,10,43,0,0
2043,393,137,445,269,30,9,13,52,132,11,43,0,0
2044,384,136,436,268,30,9,13,52,132,12,43,0,0
2045,374,137,426,268,30,9,13,52,131,13,43,0,0
2046,361,142,414,275,30,9,13,53,133,14,43,0,0
2047,353,147,406,277,30,9,13,53,130,15,43,0,0
2048,351,149,404,277,30,9,13,53,128,16,43,0,0
2049,349,154,399,273,30,9,13,50,119,17,43,0,0
2050,349,156,398,271,30,9,13,49,115,18,43,0,0
2051,350,158,400,274,30,9,13,50,116,19,43,0,0
2052,352,158,401,272,30,9,13,49,114,20,43,0,0
2053,353,156,403,273,30,9,13,50,117,21,43,0,0
2054,348,157,398,273,30,9,13,50,116,22,43,0,0
2055,356,155,409,277,30,9,13,53,122,23,43,0,0
2056,361,149,416,275,30,9,13,55,126,24,43,0,0
2057,364,143,422,275,30,9,13,58,132,25,43,0,0
2058,374,138,431,272,30,9,13,57,134,26,43,0,0
2059,381,138,439,273,30,9,13,58,135,27,43,0,0
2060,391,139,448,275,30,9,13,57,136,28,43,0,0
2061,400,138,459,277,30,9,13,59,139,29,43,0,0
2062,410,137,471,278,30,9,13,61,141,30,43,0,0
2063,417,138,478,279,30,9,13,61,141,31,43,0,0
2064,425,142,487,285,30,9,13,62,143,32,43,0,0
2065,438,142,499,287,30,9,13,61,145,33,43,0,0
2066,454,142,514,286,30,9,13,60,144,34,43,0,0
2067,467,142,530,288,30,9,13,63,146,35,43,0,0
2068,488,140,553,288,30,9,13,65,148,36,43,0,0
2069,505,141,570,287,30,9,13,65,146,37,43,0,0
2070,519,140,588,291,30,9,13,69,151,38,43,0,0
2071,528,145,596,291,30,9,13,68,146,39,43,0,0
2072,537,147,601,289,30,9,13,64,142,40,43,0,0
2073,545,147,610,293,30,9,13,65,146,41,43,0,0
2074,548,149,614,299,30,9,13,66,150,42,43,0,0
2075,557,150,623,300,30,9,13,66,150,43,43,1,0
2626,568,152,603,288,31,9,13,35,136,0,41,0,1
2627,564,149,601,290,31,9,13,37,141,1,41,0,0
2628,556,146,594,288,31,9,13,38,142,2,41,0,0
2629,541,145,581,292,31,9,13,40,147,3,41,0,0
2630,528,145,570,293,31,9,13,42,148,4,41,0,0
2631,517,146,559,289,31,9,13,42,143,5,41,0,0
2632,506,145,549,288,31,9,13,43,143,6,41,0,0
2633,487,145,533,291,31,9,13,46,146,7,41,0,0
2634,473,146,522,292,31,9,13,49,146,8,41,0,0
2635,465,145,513,288,31,9,13,48,143,9,41,0,0
2636,452,147,501,288,31,9,13,49,141,10,41,0,0
2637,433,146,485,290,31,9,13,52,144,11,41,0,0
2638,421,144,476,292,31,9,13,55,148,12,41,0,0
2639,416,145,470,289,31,9,13,54,144,13,41,0,0
2640,410,145,464,285,31,9,13,54,140,14,41,0,0
2641,402,144,455,283,31,9,13,53,139,15,41,0,0
2642,394,144,447,283,31,9,13,53,139,16,41,0,0
2643,387,142,442,283,31,9,13,55,141,17,41,0,0
2644,378,137,434,281,31,9,13,56,144,18,41,0,0
2645,369,131,431,290,31,9,13,62,159,19,41,0,0
2646,366,132,426,287,31,9,13,60,155,20,41,0,0
2647,364,138,420,285,31,9,13,56,147,21,41,0,0
2648,362,141,417,287,31,9,13,55,146,22,41,0,0
2649,361,140,417,288,31,9,13,56,148,23,41,0,0
2650,359,140,415,289,31,9,13,56,149,24,41,0,0
2651,359,140,415,289,31,9,13,56,149,25,41,0,0
2652,360,141,415,289,31,9,13,55,148,26,41,0,0
2653,362,139,419,289,31,9,13,57,150,27,41,0,0
2654,362,134,420,291,31,9,13,58,157,28,41,0,0
2655,364,134,422,291,31,9,13,58,157,29,41,0,0
2656,366,135,423,291,31,9,13,57,156,30,41,0,0
2657,369,137,426,292,31,9,13,57,155,31,41,0,0
2658,371,138,425,288,31,9,13,54,150,32,41,0,0
2659,369,134,425,290,31,9,13,56,156,33,41,0,0
2660,372,137,429,292,31,9,13,57,155,34,41,0,0
2661,370,139,425,288,31,9,13,55,149,35,41,0,0
2662,368,139,423,289,31,9,13,55,150,36,41,0,0
2663,362,140,418,292,31,9,13,56,152,37,41,0,0
2664,356,144,411,292,31,9,13,55,148,38,41,0,0
2665,352,148,407,296,31,9,13,55,148,39,41,0,0
2666,348,155,404,301,31,9,13,56,146,40,41,0,0
2667,345,156,401,302,31,9,13,56,146,41,41,1,0
2730,356,156,410,288,32,9,13,54,132,0,414,0,1
2731,358,149,416,290,32,9,13,58,141,1,414,0,0
2732,367,147,425,289,32,9,13,58,142,2,414,0,0
2733,374,139,433,286,32,9,13,59,147,3,414,0,0
2734,382,137,444,287,32,9,13,62,150,4,414,0,0
2735,391,136,453,287,32,9,13,62,151,5,414,0,0
2736,396,136,456,286,32,9,13,60,150,6,414,0,0
2737,401,136,460,282,32,9,13,59,146,7,414,0,0
2738,411,137,467,278,32,9,13,56,141,8,414,0,0
2739,418,137,474,279,32,9,13,56,142,9,414,0,0
2740,426,137,481,277,32,9,13,55,140,10,414,0,0
2741,428,137,486,282,32,9,13,58,145,11,414,0,0
2742,441,136,499,279,32,9,13,58,143,12,414,0,0
2743,455,135,510,276,32,9,13,55,141,13,414,0,0
2744,463,137,518,276,32,9,13,55,139,14,414,0,0
2745,472,136,527,275,32,9,13,55,139,15,414,0,0
2746,486,137,539,276,32,9,13,53,139,16,414,0,0
2747,496,139,549,277,32,9,13,53,138,17,414,0,0
2748,505,141,558,279,32,9,13,53,138,18,414,0,0
2749,510,141,564,278,32,9,13,54,137,19,414,0,0
2750,517,139,571,279,32,9,13,54,140,20,414,0,0
2751,520,138,574,279,32,9,13,54,141,21,414,0,0
2752,521,138,576,280,32,9,13,55,142,22,414,0,0
2753,521,139,576,281,32,9,13,55,142,23,414,0,0
2754,522,140,576,281,32,9,13,54,141,24,414,0,0
2755,521,140,575,282,32,9,13,54,142,25,414,0,0
2756,520,140,575,282,32,9,13,55,142,26,414,0,0
2757,520,139,575,283,32,9,13,55,144,27,414,0,0
2758,519,139,575,282,32,9,13,56,143,28,414,0,0
2759,519,138,575,282,32,9,13,56,144,29,414,0,0
2760,519,138,574,282,32,9,13,55,144,30,414,0,0
2761,520,139,575,283,32,9,13,55,144,31,414,0,0
2762,520,139,575,283,32,9,13,55,144,32,414,0,0
2763,520,139,575,284,32,9,13,55,145,33,414,0,0
2764,519,139,574,284,32,9,13,55,145,34,414,0,0
2765,519,139,574,284,32,9,13,55,145,35,414,0,0
2766,518,139,574,284,32,9,13,56,145,36,414,0,0
2767,518,139,573,284,32,9,13,55,145,37,414,0,0
2768,518,139,573,284,32,9,13,55,145,38,414,0,0
2769,518,140,573,284,32,9,13,55,144,39,414,0,0
2770,518,140,573,284,32,9,13,55,144,40,414,0,0
2771,517,139,573,284,32,9,13,56,145,41,414,0,0
2772,517,139,573,284,32,9,13,56,145,42,414,0,0
2773,517,139,573,284,32,9,13,56,145,43,414,0,0
2774,517,138,573,284,32,9,13,56,146,44,414,0,0
2775,516,138,573,284,32,9,13,57,146,45,414,0,0
2776,516,138,573,284,32,9,13,57,146,46,414,0,0
2777,516,138,573,284,32,9,13,57,146,47,414,0,0
2778,516,138,573,284,32,9,13,57,146,48,414,0,0
2779,516,138,573,284,32,9,13,57,146,49,414,0,0
2780,516,138,573,284,32,9,13,57,146,50,414,0,0
2781,516,138,573,283,32,9,13,57,145,51,414,0,0
2782,516,138,573,283,32,9,13,57,145,52,414,0,0
2783,516,138,573,283,32,9,13,57,145,53,414,0,0
2784,516,138,573,282,32,9,13,57,144,54,414,0,0
2785,516,138,573,282,32,9,13,57,144,55,414,0,0
2786,516,138,574,283,32,9,13,58,145,56,414,0,0
2787,517,138,574,283,32,9,13,57,145,57,414,0,0
2788,517,138,574,283,32,9,13,57,145,58,414,0,0
2789,517,138,574,284,32,9,13,57,146,59,414,0,0
2790,517,138,575,284,32,9,13,58,146,60,414,0,0
2791,516,138,574,283,32,9,13,58,145,61,414,0,0
2792,516,137,574,283,32,9,13,58,146,62,414,0,0
2793,516,138,574,283,32,9,13,58,145,63,414,0,0
2794,517,138,573,282,32,9,13,56,144,64,414,0,0
2795,517,138,573,282,32,9,13,56,144,65,414,0,0
2796,516,137,573,282,32,9,13,57,145,66,414,0,0
2797,515,136,572,283,32,9,13,57,147,67,414,0,0
2798,515,136,572,283,32,9,13,57,147,68,414,0,0
2799,515,137,572,283,32,9,13,57,146,69,414,0,0
2800,515,137,572,283,32,9,13,57,146,70,414,0,0
2801,515,137,571,283,32,9,13,56,146,71,414,0,0
2802,515,137,571,282,32,9,13,56,145,72,414,0,0
2803,515,137,571,282,32,9,13,56,145,73,414,0,0
2804,515,136,572,282,32,9,13,57,146,74,414,0,0
2805,515,136,572,283,32,9,13,57,147,75,414,0,0
2806,515,137,573,283,32,9,13,58,146,76,414,0,0
2807,515,137,573,283,32,9,13,58,146,77,414,0,0
2808,517,137,573,282,32,9,13,56,145,78,414,0,0
2809,518,139,571,279,32,9,13,53,140,79,414,0,0
2810,515,139,566,279,32,9,13,51,140,80,414,0,0
2811,514,139,563,278,32,9,13,49,139,81,414,0,0
2812,513,137,562,280,32,9,13,49,143,82,414,0,0
2813,512,138,560,281,32,9,13,48,143,83,414,0,0
2814,515,138,564,283,32,9,13,49,145,84,414,0,0
2815,518,138,567,284,32,9,13,49,146,85,414,0,0
2816,521,138,569,285,32,9,13,48,147,86,414,0,0
2817,522,138,571,285,32,9,13,49,147,87,414,0,0
2818,523,140,572,286,32,9,13,49,146,88,414,0,0
2819,523,141,571,285,32,9,13,48,144,89,414,0,0
2820,522,141,571,285,32,9,13,49,144,90,414,0,0
2821,522,142,572,285,32,9,13,50,143,91,414,0,0
2822,522,142,572,285,32,9,13,50,143,92,414,0,0
2823,522,142,572,285,32,9,13,50,143,93,414,0,0
2824,522,142,573,286,32,9,13,51,144,94,414,0,0
2825,522,142,573,285,32,9,13,51,143,95,414,0,0
2826,522,142,573,284,32,9,13,51,142,96,414,0,0
2827,522,143,573,284,32,9,13,51,141,97,414,0,0
2828,522,143,573,284,32,9,13,51,141,98,414,0,0
2829,522,143,574,283,32,9,13,52,140,99,414,0,0
2830,522,143,574,283,32,9,13,52,140,100,414,0,0
2831,522,143,575,283,32,9,13,53,140,101,414,0,0
2832,522,143,575,283,32,9,13,53,140,102,414,0,0
2833,522,143,576,283,32,9,13,54,140,103,414,0,0
2834,521,143,576,283,32,9,13,55,140,104,414,0,0
2835,521,143,576,283,32,9,13,55,140,105,414,0,0
2836,521,143,576,282,32,9,13,55,139,106,414,0,0
2837,522,143,575,282,32,9,13,53,139,107,414,0,0
2838,522,144,576,281,32,9,13,54,137,108,414,0,0
2839,522,144,576,281,32,9,13,54,137,109,414,0,0
2840,522,144,576,281,32,9,13,54,137,110,414,0,0
2841,521,144,575,283,32,9,13,54,139,111,414,0,0
2842,521,144,575,283,32,9,13,54,139,112,414,0,0
2843,521,145,575,283,32,9,13,54,138,113,414,0,0
2844,521,145,575,283,32,9,13,54,138,114,414,0,0
2845,521,145,575,283,32,9,13,54,138,115,414,0,0
2846,521,145,575,283,32,9,13,54,138,116,414,0,0
2847,521,145,575,282,32,9,13,54,137,117,414,0,0
2848,520,145,575,282,32,9,13,55,137,118,414,0,0
2849,520,145,575,282,32,9,13,55,137,119,414,0,0
2850,521,145,575,282,32,9,13,54,137,120,414,0,0
2851,521,145,575,282,32,9,13,54,137,121,414,0,0
2852,521,145,574,282,32,9,13,53,137,122,414,0,0
2853,521,146,574,281,32,9,13,53,135,123,414,0,0
2854,521,146,574,281,32,9,13,53,135,124,414,0,0
2855,522,146,575,281,32,9,13,53,135,125,414,0,0
2856,520,145,574,283,32,9,13,54,138,126,414,0,0
2857,520,145,574,284,32,9,13,54,139,127,414,0,0
2858,520,145,574,284,32,9,13,54,139,128,414,0,0
2859,520,145,574,285,32,9,13,54,140,129,414,0,0
2860,520,144,574,285,32,9,13,54,141,130,414,0,0
2861,521,144,574,283,32,9,13,53,139,131,414,0,0
2862,521,144,574,283,32,9,13,53,139,132,414,0,0
2863,521,144,574,283,32,9,13,53,139,133,414,0,0
2864,521,144,574,283,32,9,13,53,139,134,414,0,0
2865,521,144,574,282,32,9,13,53,138,135,414,0,0
2866,521,145,574,282,32,9,13,53,137,136,414,0,0
2867,522,145,574,282,32,9,13,52,137,137,414,0,0
2868,522,145,575,282,32,9,13,53,137,138,414,0,0
2869,521,144,575,282,32,9,13,54,138,139,414,0,0
2870,522,144,576,282,32,9,13,54,138,140,414,0,0
2871,521,143,576,283,32,9,13,55,140,141,414,0,0
2872,522,143,576,283,32,9,13,54,140,142,414,0,0
2873,522,141,576,281,32,9,13,54,140,143,414,0,0
2874,520,139,574,281,32,9,13,54,142,144,414,0,0
2875,521,137,574,279,32,9,13,53,142,145,414,0,0
2876,518,137,569,276,32,9,13,51,139,146,414,0,0
2877,516,138,565,275,32,9,13,49,137,147,414,0,0
2878,516,139,563,275,32,9,13,47,136,148,414,0,0
2879,516,139,561,274,32,9,13,45,135,149,414,0,0
2880,516,140,560,273,32,9,13,44,133,150,414,0,0
2881,516,140,559,272,32,9,13,43,132,151,414,0,0
2882,517,139,560,272,32,9,13,43,133,152,414,0,0
2883,519,139,561,272,32,9,13,42,133,153,414,0,0
2884,520,139,561,272,32,9,13,41,133,154,414,0,0
2885,519,139,561,272,32,9,13,42,133,155,414,0,0
2886,520,139,560,272,32,9,13,40,133,156,414,0,0
2887,520,139,560,271,32,9,13,40,132,157,414,0,0
2888,520,139,560,271,32,9,13,40,132,158,414,0,0
2889,520,139,560,271,32,9,13,40,132,159,414,0,0
2890,520,139,559,271,32,9,13,39,132,160,414,0,0
2891,520,139,559,271,32,9,13,39,132,161,414,0,0
2892,519,139,558,270,32,9,13,39,131,162,414,0,0
2893,519,139,557,270,32,9,13,38,131,163,414,0,0
2894,519,139,557,270,32,9,13,38,131,164,414,0,0
2895,519,139,557,270,32,9,13,38,131,165,414,0,0
2896,519,139,557,272,32,9,13,38,133,166,414,0,0
2897,519,139,557,272,32,9,13,38,133,167,414,0,0
2898,520,139,557,272,32,9,13,37,133,168,414,0,0
2899,520,139,557,272,32,9,13,37,133,169,414,0,0
2900,520,139,557,272,32,9,13,37,133,170,414,0,0
2901,521,139,558,272,32,9,13,37,133,171,414,0,0
2902,521,139,558,272,32,9,13,37,133,172,414,0,0
2903,521,139,558,272,32,9,13,37,133,173,414,0,0
2904,521,139,559,272,32,9,13,38,133,174,414,0,0
2905,521,138,559,272,32,9,13,38,134,175,414,0,0
2906,522,138,560,271,32,9,13,38,133,176,414,0,0
2907,523,138,562,272,32,9,13,39,134,177,414,0,0
2908,521,139,560,272,32,9,13,39,133,178,414,0,0
2909,519,139,557,272,32,9,13,38,133,179,414,0,0
2910,519,139,557,272,32,9,13,38,133,180,414,0,0
2911,519,139,558,273,32,9,13,39,134,181,414,0,0
2912,519,138,558,274,32,9,13,39,136,182,414,0,0
2913,520,138,559,274,32,9,13,39,136,183,414,0,0
2914,520,138,559,274,32,9,13,39,136,184,414,0,0
2915,521,137,560,275,32,9,13,39,138,185,414,0,0
2916,518,139,559,279,32,9,13,41,140,186,414,0,0
2917,512,141,553,279,32,9,13,41,138,187,414,0,0
2918,504,141,547,279,32,9,13,43,138,188,414,0,0
2919,498,140,543,280,32,9,13,45,140,189,414,0,0
2920,494,138,540,279,32,9,13,46,141,190,414,0,0
2921,491,138,538,279,32,9,13,47,141,191,414,0,0
2922,489,138,537,281,32,9,13,48,143,192,414,0,0
2923,489,137,537,280,32,9,13,48,143,193,414,0,0
2924,490,137,537,279,32,9,13,47,142,194,414,0,0
2925,490,137,538,279,32,9,13,48,142,195,414,0,0
2926,490,138,539,281,32,9,13,49,143,196,414,0,0
2927,490,138,539,282,32,9,13,49,144,197,414,0,0
2928,491,139,540,283,32,9,13,49,144,198,414,0,0
2929,492,139,541,283,32,9,13,49,144,199,414,0,0
2930,492,139,542,283,32,9,13,50,144,200,414,0,0
2931,492,139,543,282,32,9,13,51,143,201,414,0,0
2932,492,139,543,282,32,9,13,51,143,202,414,0,0
2933,493,139,544,282,32,9,13,51,143,203,414,0,0
2934,493,140,544,282,32,9,13,51,142,204,414,0,0
2935,493,139,545,281,32,9,13,52,142,205,414,0,0
2936,497,140,549,279,32,9,13,52,139,206,414,0,0
2937,500,142,554,279,32,9,13,54,137,207,414,0,0
2938,502,146,556,279,32,9,13,54,133,208,414,0,0
2939,506,147,560,278,32,9,13,54,131,209,414,0,0
2940,506,147,562,278,32,9,13,56,131,210,414,0,0
2941,506,146,563,278,32,9,13,57,132,211,414,0,0
2942,506,145,564,277,32,9,13,58,132,212,414,0,0
2943,505,141,565,277,32,9,13,60,136,213,414,0,0
2944,502,140,562,277,32,9,13,60,137,214,414,0,0
2945,501,140,560,278,32,9,13,59,138,215,414,0,0
2946,500,141,558,277,32,9,13,58,136,216,414,0,0
2947,500,142,557,277,32,9,13,57,135,217,414,0,0
2948,501,143,557,277,32,9,13,56,134,218,414,0,0
2949,501,143,558,277,32,9,13,57,134,219,414,0,0
2950,500,143,556,277,32,9,13,56,134,220,414,0,0
2951,500,141,557,279,32,9,13,57,138,221,414,0,0
2952,501,141,558,280,32,9,13,57,139,222,414,0,0
2953,500,143,556,280,32,9,13,56,137,223,414,0,0
2954,500,143,555,280,32,9,13,55,137,224,414,0,0
2955,500,143,555,280,32,9,13,55,137,225,414,0,0
2956,499,143,554,281,32,9,13,55,138,226,414,0,0
2957,499,144,553,281,32,9,13,54,137,227,414,0,0
2958,499,142,553,281,32,9,13,54,139,228,414,0,0
2959,498,141,553,281,32,9,13,55,140,229,414,0,0
2960,499,139,553,280,32,9,13,54,141,230,414,0,0
2961,499,139,553,280,32,9,13,54,141,231,414,0,0
2962,500,139,553,281,32,9,13,53,142,232,414,0,0
2963,499,140,552,281,32,9,13,53,141,233,414,0,0
2964,500,140,552,281,32,9,13,52,141,234,414,0,0
2965,500,140,552,281,32,9,13,52,141,235,414,0,0
2966,500,140,551,279,32,9,13,51,139,236,414,0,0
2967,499,139,551,279,32,9,13,52,140,237,414,0,0
2968,499,139,551,279,32,9,13,52,140,238,414,0,0
2969,499,139,550,278,32,9,13,51,139,239,414,0,0
2970,498,140,550,278,32,9,13,52,138,240,414,0,0
2971,498,142,549,278,32,9,13,51,136,241,414,0,0
2972,498,142,548,278,32,9,13,50,136,242,414,0,0
2973,497,140,549,278,32,9,13,52,138,243,414,0,0
2974,498,139,550,278,32,9,13,52,139,244,414,0,0
2975,498,139,551,278,32,9,13,53,139,245,414,0,0
2976,499,138,553,278,32,9,13,54,140,246,414,0,0
2977,499,138,553,278,32,9,13,54,140,247,414,0,0
2978,500,137,553,278,32,9,13,53,141,248,414,0,0
2979,500,136,554,278,32,9,13,54,142,249,414,0,0
2980,500,134,554,278,32,9,13,54,144,250,414,0,0
2981,500,130,556,278,32,9,13,56,148,251,414,0,0
2982,500,128,557,278,32,9,13,57,150,252,414,0,0
2983,500,127,557,277,32,9,13,57,150,253,414,0,0
2984,499,126,558,277,32,9,13,59,151,254,414,0,0
2985,499,127,557,277,32,9,13,58,150,255,414,0,0
2986,499,129,557,277,32,9,13,58,148,256,414,0,0
2987,499,130,556,277,32,9,13,57,147,257,414,0,0
2988,499,131,556,277,32,9,13,57,146,258,414,0,0
2989,499,133,556,277,32,9,13,57,144,259,414,0,0
2990,499,132,556,277,32,9,13,57,145,260,414,0,0
2991,499,132,556,277,32,9,13,57,145,261,414,0,0
2992,499,132,556,277,32,9,13,57,145,262,414,0,0
2993,498,133,554,277,32,9,13,56,144,263,414,0,0
2994,497,132,554,278,32,9,13,57,146,264,414,0,0
2995,495,133,552,277,32,9,13,57,144,265,414,0,0
2996,493,131,551,279,32,9,13,58,148,266,414,0,0
2997,492,130,550,279,32,9,13,58,149,267,414,0,0
2998,491,130,549,279,32,9,13,58,149,268,414,0,0
2999,491,129,549,280,32,9,13,58,151,269,414,0,0
3000,491,129,548,280,32,9,13,57,151,270,414,0,0
3001,491,130,548,279,32,9,13,57,149,271,414,0,0
3002,491,130,547,279,32,9,13,56,149,272,414,0,0
3003,492,131,547,279,32,9,13,55,148,273,414,0,0
3004,492,131,547,279,32,9,13,55,148,274,414,0,0
3005,493,130,548,279,32,9,13,55,149,275,414,0,0
3006,494,128,550,281,32,9,13,56,153,276,414,0,0
3007,494,128,551,281,32,9,13,57,153,277,414,0,0
3008,495,128,551,280,32,9,13,56,152,278,414,0,0
3009,496,128,552,278,32,9,13,56,150,279,414,0,0
3010,496,129,552,277,32,9,13,56,148,280,414,0,0
3011,497,131,551,277,32,9,13,54,146,281,414,0,0
3012,497,131,552,277,32,9,13,55,146,282,414,0,0
3013,497,131,551,277,32,9,13,54,146,283,414,0,0
3014,497,132,552,277,32,9,13,55,145,284,414,0,0
3015,497,132,551,277,32,9,13,54,145,285,414,0,0
3016,497,132,550,277,32,9,13,53,145,286,414,0,0
3017,497,132,550,276,32,9,13,53,144,287,414,0,0
3018,496,131,550,276,32,9,13,54,145,288,414,0,0
3019,496,131,550,276,32,9,13,54,145,289,414,0,0
3020,496,130,550,276,32,9,13,54,146,290,414,0,0
3021,495,128,551,277,32,9,13,56,149,291,414,0,0
3022,495,127,551,279,32,9,13,56,152,292,414,0,0
3023,495,128,551,279,32,9,13,56,151,293,414,0,0
3024,495,129,551,279,32,9,13,56,150,294,414,0,0
3025,495,129,550,280,32,9,13,55,151,295,414,0,0
3026,494,129,550,281,32,9,13,56,152,296,414,0,0
3027,494,129,550,281,32,9,13,56,152,297,414,0,0
3028,494,130,550,282,32,9,13,56,152,298,414,0,0
3029,494,132,549,281,32,9,13,55,149,299,414,0,0
3030,494,133,548,279,32,9,13,54,146,300,414,0,0
3031,495,134,548,278,32,9,13,53,144,301,414,0,0
3032,495,132,549,278,32,9,13,54,146,302,414,0,0
3033,495,134,548,279,32,9,13,53,145,303,414,0,0
3034,494,137,547,279,32,9,13,53,142,304,414,0,0
3035,493,140,545,279,32,9,13,52,139,305,414,0,0
3036,495,141,545,276,32,9,13,50,135,306,414,0,0
3037,495,141,547,278,32,9,13,52,137,307,414,0,0
3038,500,142,552,279,32,9,13,52,137,308,414,0,0
3039,502,139,556,281,32,9,13,54,142,309,414,0,0
3040,503,141,558,280,32,9,13,55,139,310,414,0,0
3041,511,141,562,276,32,9,13,51,135,311,414,0,0
3042,513,140,566,278,32,9,13,53,138,312,414,0,0
3043,514,139,567,280,32,9,13,53,141,313,414,0,0
3044,516,139,569,280,32,9,13,53,141,314,414,0,0
3045,517,138,571,281,32,9,13,54,143,315,414,0,0
3046,517,138,571,281,32,9,13,54,143,316,414,0,0
3047,517,138,571,281,32,9,13,54,143,317,414,0,0
3048,518,139,572,281,32,9,13,54,142,318,414,0,0
3049,518,139,572,281,32,9,13,54,142,319,414,0,0
3050,518,139,572,281,32,9,13,54,142,320,414,0,0
3051,519,139,574,281,32,9,13,55,142,321,414,0,0
3052,520,139,576,281,32,9,13,56,142,322,414,0,0
3053,520,139,577,281,32,9,13,57,142,323,414,0,0
3054,519,139,577,281,32,9,13,58,142,324,414,0,0
3055,519,140,577,280,32,9,13,58,140,325,414,0,0
3056,518,140,577,280,32,9,13,59,140,326,414,0,0
3057,518,141,577,280,32,9,13,59,139,327,414,0,0
3058,518,140,577,280,32,9,13,59,140,328,414,0,0
3059,518,140,578,281,32,9,13,60,141,329,414,0,0
3060,518,140,578,280,32,9,13,60,140,330,414,0,0
3061,518,141,577,279,32,9,13,59,138,331,414,0,0
3062,518,141,577,279,32,9,13,59,138,332,414,0,0
3063,518,142,577,278,32,9,13,59,136,333,414,0,0
3064,518,142,578,278,32,9,13,60,136,334,414,0,0
3065,518,142,578,278,32,9,13,60,136,335,414,0,0
3066,518,142,578,278,32,9,13,60,136,336,414,0,0
3067,518,142,578,278,32,9,13,60,136,337,414,0,0
3068,518,142,578,278,32,9,13,60,136,338,414,0,0
3069,518,142,578,278,32,9,13,60,136,339,414,0,0
3070,518,142,578,278,32,9,13,60,136,340,414,0,0
3071,516,142,577,279,32,9,13,61,137,341,414,0,0
3072,515,142,576,279,32,9,13,61,137,342,414,0,0
3073,514,141,575,279,32,9,13,61,138,343,414,0,0
3074,514,141,574,280,32,9,13,60,139,344,414,0,0
3075,514,141,574,280,32,9,13,60,139,345,414,0,0
3076,516,141,575,279,32,9,13,59,138,346,414,0,0
3077,516,142,576,279,32,9,13,60,137,347,414,0,0
3078,517,142,576,279,32,9,13,59,137,348,414,0,0
3079,517,142,576,278,32,9,13,59,136,349,414,0,0
3080,517,141,577,278,32,9,13,60,137,350,414,0,0
3081,517,141,577,278,32,9,13,60,137,351,414,0,0
3082,517,141,577,278,32,9,13,60,137,352,414,0,0
3083,517,140,577,278,32,9,13,60,138,353,414,0,0
3084,517,140,577,278,32,9,13,60,138,354,414,0,0
3085,517,140,576,278,32,9,13,59,138,355,414,0,0
3086,516,140,576,280,32,9,13,60,140,356,414,0,0
3087,515,140,576,281,32,9,13,61,141,357,414,0,0
3088,515,139,576,281,32,9,13,61,142,358,414,0,0
3089,515,139,576,282,32,9,13,61,143,359,414,0,0
3090,515,140,576,282,32,9,13,61,142,360,414,0,0
3091,516,140,576,280,32,9,13,60,140,361,414,0,0
3092,516,140,576,280,32,9,13,60,140,362,414,0,0
3093,516,140,576,280,32,9,13,60,140,363,414,0,0
3094,516,140,577,280,32,9,13,61,140,364,414,0,0
3095,516,141,576,279,32,9,13,60,138,365,414,0,0
3096,515,140,575,279,32,9,13,60,139,366,414,0,0
3097,515,140,574,279,32,9,13,59,139,367,414,0,0
3098,515,140,574,278,32,9,13,59,138,368,414,0,0
3099,515,139,574,278,32,9,13,59,139,369,414,0,0
3100,515,139,573,279,32,9,13,58,140,370,414,0,0
3101,515,140,573,279,32,9,13,58,139,371,414,0,0
3102,515,140,573,279,32,9,13,58,139,372,414,0,0
3103,515,140,573,278,32,9,13,58,138,373,414,0,0
3104,516,141,573,279,32,9,13,57,138,374,414,0,0
3105,515,140,573,279,32,9,13,58,139,375,414,0,0
3106,513,140,569,279,32,9,13,56,139,376,414,0,0
3107,513,139,568,276,32,9,13,55,137,377,414,0,0
3108,512,140,564,275,32,9,13,52,135,378,414,0,0
3109,511,138,562,275,32,9,13,51,137,379,414,0,0
3110,509,136,561,276,32,9,13,52,140,380,414,0,0
3111,510,138,561,276,32,9,13,51,138,381,414,0,0
3112,510,138,560,276,32,9,13,50,138,382,414,0,0
3113,510,138,559,276,32,9,13,49,138,383,414,0,0
3114,509,138,559,277,32,9,13,50,139,384,414,0,0
3115,510,139,558,277,32,9,13,48,138,385,414,0,0
3116,510,139,558,277,32,9,13,48,138,386,414,0,0
3117,511,139,558,277,32,9,13,47,138,387,414,0,0
3118,511,139,557,276,32,9,13,46,137,388,414,0,0
3119,511,139,556,276,32,9,13,45,137,389,414,0,0
3120,512,140,556,275,32,9,13,44,135,390,414,0,0
3121,512,140,556,276,32,9,13,44,136,391,414,0,0
3122,512,140,556,277,32,9,13,44,137,392,414,0,0
3123,511,140,555,279,32,9,13,44,139,393,414,0,0
3124,511,140,555,279,32,9,13,44,139,394,414,0,0
3125,511,141,556,280,32,9,13,45,139,395,414,0,0
3126,511,139,557,280,32,9,13,46,141,396,414,0,0
3127,512,139,557,280,32,9,13,45,141,397,414,0,0
3128,513,139,559,280,32,9,13,46,141,398,414,0,0
3129,511,139,558,279,32,9,13,47,140,399,414,0,0
3130,506,141,554,277,32,9,13,48,136,400,414,0,0
3131,499,140,549,279,32,9,13,50,139,401,414,0,0
3132,493,140,543,280,32,9,13,50,140,402,414,0,0
3133,487,138,536,279,32,9,13,49,141,403,414,0,0
3134,477,139,525,278,32,9,13,48,139,404,414,0,0
3135,460,139,510,282,32,9,13,50,143,405,414,0,0
3136,451,136,504,283,32,9,13,53,147,406,414,0,0
3137,439,133,491,279,32,9,13,52,146,407,414,0,0
3138,422,134,475,281,32,9,13,53,147,408,414,0,0
3139,409,140,461,282,32,9,13,52,142,409,414,0,0
3140,397,136,449,281,32,9,13,52,145,410,414,0,0
3141,382,137,434,281,32,9,13,52,144,411,414,0,0
3142,372,139,425,284,32,9,13,53,145,412,414,0,0
3143,364,145,413,283,32,9,13,49,138,413,414,0,0
3144,355,146,404,283,32,9,13,49,137,414,414,1,0
2881,539,139,574,275,38,9,13,35,136,0,8,0,0
2883,540,142,575,276,38,9,13,35,134,0,8,0,0
2897,540,144,575,273,38,9,13,35,129,0,8,0,0
2898,540,144,575,274,38,9,13,35,130,1,8,0,0
2899,540,144,575,271,38,9,13,35,127,2,8,0,0
2900,540,143,575,270,38,9,13,35,127,3,8,0,0
2901,541,144,576,273,38,9,13,35,129,4,8,0,0
2902,542,144,577,274,38,9,13,35,130,5,8,0,0
2903,542,144,577,274,38,9,13,35,130,6,8,0,0
2904,542,145,578,275,38,9,13,36,130,7,8,0,0
2905,542,145,578,275,38,9,13,36,130,8,8,0,0
2909,540,143,575,268,38,9,13,35,125,0,8,0,0
2910,540,145,575,271,38,9,13,35,126,1,8,0,0
2911,540,145,575,271,38,9,13,35,126,2,8,0,0
2912,542,146,577,273,38,9,13,35,127,3,8,0,0
2944,541,150,577,275,38,9,13,36,125,0,8,0,0
2945,541,148,576,272,38,9,13,35,124,1,8,0,0
2946,540,147,576,272,38,9,13,36,125,2,8,0,0
2951,542,149,577,271,38,9,13,35,122,0,8,0,0
2952,542,149,577,271,38,9,13,35,122,1,8,0,0
3037,540,157,581,278,39,9,13,41,121,0,5,0,0
3038,535,145,579,276,39,9,13,44,131,1,5,0,0
3039,536,143,579,272,39,9,13,43,129,2,5,0,0
3040,538,142,579,267,39,9,13,41,125,3,5,0,0
3041,538,140,580,267,39,9,13,42,127,4,5,0,0
3042,538,138,580,265,39,9,13,42,127,5,5,0,0
3109,539,140,574,265,42,9,13,35,125,0,6,0,0
3110,538,139,575,272,42,9,13,37,133,1,6,0,0
3111,540,144,575,275,42,9,13,35,131,2,6,0,0
3112,540,146,576,275,42,9,13,36,129,3,6,0,0
3113,540,140,577,276,42,9,13,37,136,4,6,0,0
3114,539,140,575,272,42,9,13,36,132,5,6,0,0
3115,539,141,574,269,42,9,13,35,128,6,6,0,0
3124,537,142,573,274,42,9,13,36,132,0,6,0,0
3126,540,145,575,273,42,9,13,35,128,0,6,0,0
3127,540,143,576,276,42,9,13,36,133,1,6,0,0
3128,541,148,576,276,42,9,13,35,128,2,6,0,0
3209,360,150,402,288,46,9,13,42,138,0,168,0,1
3210,356,142,401,289,46,9,13,45,147,1,168,0,0
3211,358,140,402,284,46,9,13,44,144,2,168,0,0
3212,359,139,402,282,46,9,13,43,143,3,168,0,0
3213,359,137,403,283,46,9,13,44,146,4,168,0,0
3214,360,138,403,284,46,9,13,43,146,5,168,0,0
3215,359,138,401,283,46,9,13,42,145,6,168,0,0
3216,360,138,401,280,46,9,13,41,142,7,168,0,0
3217,360,139,401,281,46,9,13,41,142,8,168,0,0
3218,359,136,402,288,46,9,13,43,152,9,168,0,0
3219,360,138,401,285,46,9,13,41,147,10,168,0,0
3220,362,140,401,282,46,9,13,39,142,11,168,0,0
3221,363,139,401,277,46,9,13,38,138,12,168,0,0
3222,363,136,402,280,46,9,13,39,144,13,168,0,0
3223,362,136,402,283,46,9,13,40,147,14,168,0,0
3224,363,138,403,281,46,9,13,40,143,15,168,0,0
3225,365,137,404,274,46,9,13,39,137,16,168,0,0
3226,364,137,404,280,46,9,13,40,143,17,168,0,0
3227,366,138,403,272,46,9,13,37,134,18,168,0,0
3228,365,138,404,278,46,9,13,39,140,19,168,0,0
3229,365,138,405,280,46,9,13,40,142,20,168,0,0
3230,365,138,405,282,46,9,13,40,144,21,168,0,0
3231,364,135,406,287,46,9,13,42,152,22,168,0,0
3232,366,136,405,277,46,9,13,39,141,23,168,0,0
3233,365,136,405,281,46,9,13,40,145,24,168,0,0
3234,365,136,405,281,46,9,13,40,145,25,168,0,0
3235,364,136,405,283,46,9,13,41,147,26,168,0,0
3236,363,135,406,291,46,9,13,43,156,27,168,0,0
3237,364,135,407,292,46,9,13,43,157,28,168,0,0
3238,364,135,406,287,46,9,13,42,152,29,168,0,0
3239,365,136,406,286,46,9,13,41,150,30,168,0,0
3240,365,136,405,285,46,9,13,40,149,31,168,0,0
3241,364,136,404,283,46,9,13,40,147,32,168,0,0
3242,364,136,404,282,46,9,13,40,146,33,168,0,0
3243,364,138,403,281,46,9,13,39,143,34,168,0,0
3244,364,138,403,283,46,9,13,39,145,35,168,0,0
3245,366,140,403,275,46,9,13,37,135,36,168,0,0
3246,365,143,403,279,46,9,13,38,136,37,168,0,0
3247,365,143,403,281,46,9,13,38,138,38,168,0,0
3248,365,144,403,282,46,9,13,38,138,39,168,0,0
3249,365,144,403,282,46,9,13,38,138,40,168,0,0
3250,364,144,402,281,46,9,13,38,137,41,168,0,0
3251,362,139,404,289,46,9,13,42,150,42,168,0,0
3252,363,143,402,285,46,9,13,39,142,43,168,0,0
3253,363,144,402,284,46,9,13,39,140,44,168,0,0
3254,363,144,402,284,46,9,13,39,140,45,168,0,0
3255,363,144,402,284,46,9,13,39,140,46,168,0,0
3256,362,140,404,290,46,9,13,42,150,47,168,0,0
3257,362,138,404,293,46,9,13,42,155,48,168,0,0
3258,361,138,404,294,46,9,13,43,156,49,168,0,0
3259,362,137,404,294,46,9,13,42,157,50,168,0,0
3260,362,137,405,295,46,9,13,43,158,51,168,0,0
3261,364,142,404,286,46,9,13,40,144,52,168,0,0
3262,363,139,405,288,46,9,13,42,149,53,168,0,0
3263,363,139,405,289,46,9,13,42,150,54,168,0,0
3264,365,142,404,283,46,9,13,39,141,55,168,0,0
3265,363,139,405,287,46,9,13,42,148,56,168,0,0
3266,363,138,405,290,46,9,13,42,152,57,168,0,0
3267,363,136,405,291,46,9,13,42,155,58,168,0,0
3268,362,135,405,294,46,9,13,43,159,59,168,0,0
3269,363,135,406,294,46,9,13,43,159,60,168,0,0
3270,363,135,406,294,46,9,13,43,159,61,168,0,0
3271,364,137,406,292,46,9,13,42,155,62,168,0,0
3272,365,140,404,286,46,9,13,39,146,63,168,0,0
3273,364,139,405,291,46,9,13,41,152,64,168,0,0
3274,364,138,405,291,46,9,13,41,153,65,168,0,0
3275,362,137,403,292,46,9,13,41,155,66,168,0,0
3276,361,135,403,293,46,9,13,42,158,67,168,0,0
3277,362,140,400,286,46,9,13,38,146,68,168,0,0
3278,362,140,400,286,46,9,13,38,146,69,168,0,0
3279,361,137,401,290,46,9,13,40,153,70,168,0,0
3280,361,135,402,293,46,9,13,41,158,71,168,0,0
3281,362,137,402,292,46,9,13,40,155,72,168,0,0
3282,363,136,402,291,46,9,13,39,155,73,168,0,0
3283,362,136,402,292,46,9,13,40,156,74,168,0,0
3284,362,136,402,292,46,9,13,40,156,75,168,0,0
3285,362,136,402,292,46,9,13,40,156,76,168,0,0
3286,362,136,401,291,46,9,13,39,155,77,168,0,0
3287,363,136,401,290,46,9,13,38,154,78,168,0,0
3288,363,136,401,290,46,9,13,38,154,79,168,0,0
3289,363,137,401,290,46,9,13,38,153,80,168,0,0
3290,362,137,400,290,46,9,13,38,153,81,168,0,0
3291,362,137,400,292,46,9,13,38,155,82,168,0,0
3292,362,136,401,292,46,9,13,39,156,83,168,0,0
3293,362,136,400,292,46,9,13,38,156,84,168,0,0
3294,363,139,399,286,46,9,13,36,147,85,168,0,0
3295,364,141,399,285,46,9,13,35,144,86,168,0,0
3296,363,141,399,285,46,9,13,36,144,87,168,0,0
3297,363,140,399,285,46,9,13,36,145,88,168,0,0
3298,363,140,399,285,46,9,13,36,145,89,168,0,0
3299,364,140,399,284,46,9,13,35,144,90,168,0,0
3300,364,140,399,283,46,9,13,35,143,91,168,0,0
3301,363,140,399,284,46,9,13,36,144,92,168,0,0
3302,363,141,399,285,46,9,13,36,144,93,168,0,0
3303,363,141,400,285,46,9,13,37,144,94,168,0,0
3304,363,141,400,285,46,9,13,37,144,95,168,0,0
3305,363,141,400,285,46,9,13,37,144,96,168,0,0
3306,362,137,401,292,46,9,13,39,155,97,168,0,0
3307,362,136,401,295,46,9,13,39,159,98,168,0,0
3308,362,136,401,295,46,9,13,39,159,99,168,0,0
3309,362,135,401,296,46,9,13,39,161,100,168,0,0
3310,362,135,401,296,46,9,13,39,161,101,168,0,0
3311,363,139,400,288,46,9,13,37,149,102,168,0,0
3312,363,140,400,285,46,9,13,37,145,103,168,0,0
3313,363,141,400,284,46,9,13,37,143,104,168,0,0
3314,363,141,400,283,46,9,13,37,142,105,168,0,0
3315,363,142,400,283,46,9,13,37,141,106,168,0,0
3316,364,142,400,284,46,9,13,36,142,107,168,0,0
3317,364,142,400,284,46,9,13,36,142,108,168,0,0
3318,363,142,400,284,46,9,13,37,142,109,168,0,0
3319,363,142,400,284,46,9,13,37,142,110,168,0,0
3320,363,142,400,284,46,9,13,37,142,111,168,0,0
3321,364,142,400,283,46,9,13,36,141,112,168,0,0
3322,364,142,400,283,46,9,13,36,141,113,168,0,0
3323,364,142,400,282,46,9,13,36,140,114,168,0,0
3324,364,142,400,282,46,9,13,36,140,115,168,0,0
3325,364,142,400,282,46,9,13,36,140,116,168,0,0
3326,364,142,400,282,46,9,13,36,140,117,168,0,0
3327,364,142,400,282,46,9,13,36,140,118,168,0,0
3328,363,143,400,283,46,9,13,37,140,119,168,0,0
3329,363,142,400,283,46,9,13,37,141,120,168,0,0
3330,363,142,400,283,46,9,13,37,141,121,168,0,0
3331,364,142,400,283,46,9,13,36,141,122,168,0,0
3332,363,142,400,284,46,9,13,37,142,123,168,0,0
3333,363,141,400,285,46,9,13,37,144,124,168,0,0
3334,363,141,401,285,46,9,13,38,144,125,168,0,0
3335,363,141,400,286,46,9,13,37,145,126,168,0,0
3336,363,141,400,286,46,9,13,37,145,127,168,0,0
3337,363,141,400,286,46,9,13,37,145,128,168,0,0
3338,363,141,400,286,46,9,13,37,145,129,168,0,0
3339,363,141,400,286,46,9,13,37,145,130,168,0,0
3340,363,142,400,286,46,9,13,37,144,131,168,0,0
3341,362,140,400,283,46,9,13,38,143,132,168,0,0
3342,362,140,400,282,46,9,13,38,142,133,168,0,0
3343,363,140,400,282,46,9,13,37,142,134,168,0,0
3344,363,139,401,281,46,9,13,38,142,135,168,0,0
3345,363,139,400,281,46,9,13,37,142,136,168,0,0
3346,363,141,401,285,46,9,13,38,144,137,168,0,0
3347,363,141,401,287,46,9,13,38,146,138,168,0,0
3348,363,141,401,287,46,9,13,38,146,139,168,0,0
3349,363,142,401,288,46,9,13,38,146,140,168,0,0
3350,362,142,401,287,46,9,13,39,145,141,168,0,0
3351,363,142,401,285,46,9,13,38,143,142,168,0,0
3352,363,143,400,285,46,9,13,37,142,143,168,0,0
3353,362,143,400,284,46,9,13,38,141,144,168,0,0
3354,360,139,400,289,46,9,13,40,150,145,168,0,0
3355,362,141,400,285,46,9,13,38,144,146,168,0,0
3356,362,139,400,283,46,9,13,38,144,147,168,0,0
3357,362,138,400,282,46,9,13,38,144,148,168,0,0
3358,362,137,400,281,46,9,13,38,144,149,168,0,0
3359,362,137,400,281,46,9,13,38,144,150,168,0,0
3360,362,138,400,281,46,9,13,38,143,151,168,0,0
3361,362,138,400,284,46,9,13,38,146,152,168,0,0
3362,363,137,401,285,46,9,13,38,148,153,168,0,0
3363,363,137,401,285,46,9,13,38,148,154,168,0,0
3364,363,137,401,286,46,9,13,38,149,155,168,0,0
3365,363,137,400,286,46,9,13,37,149,156,168,0,0
3366,361,137,400,289,46,9,13,39,152,157,168,0,0
3367,361,137,400,290,46,9,13,39,153,158,168,0,0
3368,360,136,400,291,46,9,13,40,155,159,168,0,0
3369,360,136,400,291,46,9,13,40,155,160,168,0,0
3370,360,136,400,291,46,9,13,40,155,161,168,0,0
3371,361,136,400,291,46,9,13,39,155,162,168,0,0
3372,361,136,400,291,46,9,13,39,155,163,168,0,0
3373,361,136,400,291,46,9,13,39,155,164,168,0,0
3374,362,140,399,286,46,9,13,37,146,165,168,0,0
3375,362,138,400,290,46,9,13,38,152,166,168,0,0
3376,364,141,400,282,46,9,13,36,141,167,168,0,0
3377,364,142,399,279,46,9,13,35,137,168,168,1,0
3380,365,143,400,277,46,9,13,35,134,0,168,0,1
3381,362,139,401,289,46,9,13,39,150,1,168,0,0
3382,361,138,401,293,46,9,13,40,155,2,168,0,0
3383,360,138,401,295,46,9,13,41,157,3,168,0,0
3384,360,137,401,296,46,9,13,41,159,4,168,0,0
3385,360,137,401,296,46,9,13,41,159,5,168,0,0
3386,360,137,401,295,46,9,13,41,158,6,168,0,0
3387,361,137,401,295,46,9,13,40,158,7,168,0,0
3388,361,137,401,295,46,9,13,40,158,8,168,0,0
3389,361,137,401,295,46,9,13,40,158,9,168,0,0
3390,361,137,401,294,46,9,13,40,157,10,168,0,0
3391,361,137,401,294,46,9,13,40,157,11,168,0,0
3392,361,137,401,294,46,9,13,40,157,12,168,0,0
3393,361,136,401,294,46,9,13,40,158,13,168,0,0
3394,361,136,401,294,46,9,13,40,158,14,168,0,0
3395,361,136,401,294,46,9,13,40,158,15,168,0,0
3396,362,136,400,290,46,9,13,38,154,16,168,0,0
3397,362,136,400,289,46,9,13,38,153,17,168,0,0
3398,363,140,399,283,46,9,13,36,143,18,168,0,0
3399,364,141,399,279,46,9,13,35,138,19,168,0,0
3400,364,141,399,279,46,9,13,35,138,20,168,0,0
3401,363,138,400,285,46,9,13,37,147,21,168,0,0
3402,362,137,401,287,46,9,13,39,150,22,168,0,0
3403,362,137,401,289,46,9,13,39,152,23,168,0,0
3404,362,137,401,290,46,9,13,39,153,24,168,0,0
3405,362,138,401,291,46,9,13,39,153,25,168,0,0
3406,363,141,400,286,46,9,13,37,145,26,168,0,0
3407,364,142,400,284,46,9,13,36,142,27,168,0,0
3408,364,142,400,284,46,9,13,36,142,28,168,0,0
3409,363,143,400,284,46,9,13,37,141,29,168,0,0
3410,363,143,401,286,46,9,13,38,143,30,168,0,0
3411,362,143,401,289,46,9,13,39,146,31,168,0,0
3412,362,144,401,289,46,9,13,39,145,32,168,0,0
3413,363,144,401,288,46,9,13,38,144,33,168,0,0
3414,363,144,401,288,46,9,13,38,144,34,168,0,0
3415,361,140,401,293,46,9,13,40,153,35,168,0,0
3416,362,142,400,285,46,9,13,38,143,36,168,0,0
3417,363,143,400,282,46,9,13,37,139,37,168,0,0
3418,363,143,400,280,46,9,13,37,137,38,168,0,0
3419,363,143,400,279,46,9,13,37,136,39,168,0,0
3420,363,143,400,280,46,9,13,37,137,40,168,0,0
3421,361,139,401,287,46,9,13,40,148,41,168,0,0
3422,362,141,401,286,46,9,13,39,145,42,168,0,0
3423,361,138,401,290,46,9,13,40,152,43,168,0,0
3424,362,141,401,286,46,9,13,39,145,44,168,0,0
3425,362,142,401,285,46,9,13,39,143,45,168,0,0
3426,363,143,400,284,46,9,13,37,141,46,168,0,0
3427,363,143,400,284,46,9,13,37,141,47,168,0,0
3428,363,144,400,284,46,9,13,37,140,48,168,0,0
3429,363,144,400,284,46,9,13,37,140,49,168,0,0
3430,363,144,400,283,46,9,13,37,139,50,168,0,0
3431,362,139,401,288,46,9,13,39,149,51,168,0,0
3432,361,137,402,290,46,9,13,41,153,52,168,0,0
3433,361,137,402,290,46,9,13,41,153,53,168,0,0
3434,361,136,402,291,46,9,13,41,155,54,168,0,0
3435,361,136,402,291,46,9,13,41,155,55,168,0,0
3436,361,137,402,291,46,9,13,41,154,56,168,0,0
3437,361,137,402,292,46,9,13,41,155,57,168,0,0
3438,361,137,401,292,46,9,13,40,155,58,168,0,0
3439,361,137,401,291,46,9,13,40,154,59,168,0,0
3440,361,137,401,291,46,9,13,40,154,60,168,0,0
3441,361,137,401,290,46,9,13,40,153,61,168,0,0
3442,362,138,400,284,46,9,13,38,146,62,168,0,0
3443,362,139,400,282,46,9,13,38,143,63,168,0,0
3444,362,138,400,283,46,9,13,38,145,64,168,0,0
3445,362,139,400,282,46,9,13,38,143,65,168,0,0
3446,363,138,399,276,46,9,13,36,138,66,168,0,0
3448,363,139,399,277,46,9,13,36,138,0,168,0,1
3449,361,137,399,283,46,9,13,38,146,1,168,0,0
3450,360,136,399,284,46,9,13,39,148,2,168,0,0
3451,361,139,398,280,46,9,13,37,141,3,168,0,0
3452,361,140,397,278,46,9,13,36,138,4,168,0,0
3453,362,140,398,279,46,9,13,36,139,5,168,0,0
3454,361,137,399,285,46,9,13,38,148,6,168,0,0
3455,361,136,400,289,46,9,13,39,153,7,168,0,0
3456,361,136,401,292,46,9,13,40,156,8,168,0,0
3457,361,135,401,294,46,9,13,40,159,9,168,0,0
3458,360,135,401,295,46,9,13,41,160,10,168,0,0
3459,361,135,401,295,46,9,13,40,160,11,168,0,0
3460,361,135,400,295,46,9,13,39,160,12,168,0,0
3461,361,136,400,292,46,9,13,39,156,13,168,0,0
3462,362,136,400,290,46,9,13,38,154,14,168,0,0
3463,362,136,400,290,46,9,13,38,154,15,168,0,0
3464,362,136,400,290,46,9,13,38,154,16,168,0,0
3465,362,136,400,290,46,9,13,38,154,17,168,0,0
3466,363,138,399,283,46,9,13,36,145,18,168,0,0
3467,363,139,398,280,46,9,13,35,141,19,168,0,0
3470,364,140,399,279,46,9,13,35,139,0,168,0,0
3471,364,140,399,280,46,9,13,35,140,1,168,0,0
3472,364,140,399,280,46,9,13,35,140,2,168,0,0
3473,363,140,399,280,46,9,13,36,140,3,168,0,0
3475,363,140,399,280,46,9,13,36,140,0,168,0,1
3476,363,140,398,283,46,9,13,35,143,1,168,0,0
3477,363,140,398,284,46,9,13,35,144,2,168,0,0
3478,363,141,399,284,46,9,13,36,143,3,168,0,0
3479,363,141,399,284,46,9,13,36,143,4,168,0,0
3480,363,141,399,284,46,9,13,36,143,5,168,0,0
3481,364,141,399,280,46,9,13,35,139,6,168,0,0
3482,364,141,399,278,46,9,13,35,137,7,168,0,0
3483,364,142,399,278,46,9,13,35,136,8,168,0,0
3484,364,142,399,277,46,9,13,35,135,9,168,0,0
3485,364,142,399,278,46,9,13,35,136,10,168,0,0
3486,363,139,400,286,46,9,13,37,147,11,168,0,0
3487,362,137,401,289,46,9,13,39,152,12,168,0,0
3488,363,140,400,285,46,9,13,37,145,13,168,0,0
3489,361,138,400,288,46,9,13,39,150,14,168,0,0
3490,363,140,400,285,46,9,13,37,145,15,168,0,0
3491,364,141,400,282,46,9,13,36,141,16,168,0,0
3492,364,141,400,282,46,9,13,36,141,17,168,0,0
3493,362,139,400,288,46,9,13,38,149,18,168,0,0
3494,362,138,401,290,46,9,13,39,152,19,168,0,0
3495,362,138,400,290,46,9,13,38,152,20,168,0,0
3496,363,141,400,289,46,9,13,37,148,21,168,0,0
3497,362,139,401,293,46,9,13,39,154,22,168,0,0
3498,361,137,401,294,46,9,13,40,157,23,168,0,0
3499,361,137,401,295,46,9,13,40,158,24,168,0,0
3500,360,139,399,292,46,9,13,39,153,25,168,0,0
3501,359,144,397,293,46,9,13,38,149,26,168,0,0
3502,358,144,397,294,46,9,13,39,150,27,168,0,0
3528,361,147,401,288,46,9,13,40,141,0,168,0,1
3529,361,139,405,292,46,9,13,44,153,1,168,0,0
3530,360,139,406,296,46,9,13,46,157,2,168,0,0
3531,362,138,409,295,46,9,13,47,157,3,168,0,0
3532,364,137,410,294,46,9,13,46,157,4,168,0,0
3533,363,137,410,294,46,9,13,47,157,5,168,0,0
3534,364,133,413,294,46,9,13,49,161,6,168,0,0
3535,365,130,414,292,46,9,13,49,162,7,168,0,0
3536,364,127,416,295,46,9,13,52,168,8,168,0,0
3537,365,122,418,296,46,9,13,53,174,9,168,0,0
3538,367,126,417,290,46,9,13,50,164,10,168,0,0
3539,371,127,420,286,46,9,13,49,159,11,168,0,0
3540,372,128,422,287,46,9,13,50,159,12,168,0,0
3541,372,128,422,286,46,9,13,50,158,13,168,0,0
3542,372,127,423,285,46,9,13,51,158,14,168,0,0
3543,372,127,423,285,46,9,13,51,158,15,168,0,0
3544,372,127,423,285,46,9,13,51,158,16,168,0,0
3545,371,127,423,285,46,9,13,52,158,17,168,0,0
3546,370,126,422,284,46,9,13,52,158,18,168,0,0
3547,368,117,423,285,46,9,13,55,168,19,168,0,0
3548,368,120,421,284,46,9,13,53,164,20,168,0,0
3549,368,123,419,283,46,9,13,51,160,21,168,0,0
3550,368,125,418,281,46,9,13,50,156,22,168,0,0
3551,366,119,419,282,46,9,13,53,163,23,168,0,0
3552,364,123,417,282,46,9,13,53,159,24,168,0,0
3553,363,122,418,288,46,9,13,55,166,25,168,0,0
3554,372,125,425,280,46,9,13,53,155,26,168,0,0
3555,382,134,434,279,46,9,13,52,145,27,168,0,0
3556,373,132,428,287,46,9,13,55,155,28,168,0,0
3557,371,135,425,289,46,9,13,54,154,29,168,0,0
3558,365,128,423,293,46,9,13,58,165,30,168,0,0
3559,366,138,421,296,46,9,13,55,158,31,168,0,0
3560,365,142,419,297,46,9,13,54,155,32,168,0,0
3561,364,146,416,295,46,9,13,52,149,33,168,0,0
3562,362,148,413,294,46,9,13,51,146,34,168,0,0
3563,360,149,410,292,46,9,13,50,143,35,168,0,0
3564,355,151,406,294,46,9,13,51,143,36,168,0,0
3565,354,155,404,294,46,9,13,50,139,37,168,0,0
3566,352,158,400,291,46,9,13,48,133,38,168,0,0
3567,352,158,399,289,46,9,13,47,131,39,168,0,0
3568,351,158,397,286,46,9,13,46,128,40,168,0,0
3569,352,160,399,290,46,9,13,47,130,41,168,0,0
3570,353,158,401,288,46,9,13,48,130,42,168,0,0
3571,354,154,403,284,46,9,13,49,130,43,168,0,0
3572,358,151,407,280,46,9,13,49,129,44,168,0,0
3573,359,146,408,277,46,9,13,49,131,45,168,0,0
3574,357,140,406,274,46,9,13,49,134,46,168,0,0
3575,354,139,402,271,46,9,13,48,132,47,168,0,0
3576,351,138,398,269,46,9,13,47,131,48,168,0,0
3577,348,136,394,267,46,9,13,46,131,49,168,0,0
3578,346,137,390,262,46,9,13,44,125,50,168,0,0
3579,344,142,385,258,46,9,13,41,116,51,168,0,0
3580,341,145,379,254,46,9,13,38,109,52,168,0,0
3581,340,145,376,252,46,9,13,36,107,53,168,0,0
3447,333,172,372,285,47,9,13,39,113,0,0,0,0
3556,427,130,471,273,49,9,13,44,143,0,112,0,1
3557,443,132,486,270,49,9,13,43,138,1,112,0,0
3558,458,135,501,273,49,9,13,43,138,2,112,0,0
3559,478,131,523,274,49,9,13,45,143,3,112,0,0
3560,498,131,543,276,49,9,13,45,145,4,112,0,0
3561,511,135,557,280,49,9,13,46,145,5,112,0,0
3562,525,134,572,280,49,9,13,47,146,6,112,0,0
3563,530,134,578,280,49,9,13,48,146,7,112,0,0
3564,531,134,580,280,49,9,13,49,146,8,112,0,0
3565,530,134,579,279,49,9,13,49,145,9,112,0,0
3566,529,133,579,281,49,9,13,50,148,10,112,0,0
3567,527,132,577,282,49,9,13,50,150,11,112,0,0
3568,526,130,577,282,49,9,13,51,152,12,112,0,0
3569,527,132,577,278,49,9,13,50,146,13,112,0,0
3570,526,133,577,278,49,9,13,51,145,14,112,0,0
3571,525,133,578,282,49,9,13,53,149,15,112,0,0
3572,524,133,578,283,49,9,13,54,150,16,112,0,0
3573,524,133,578,283,49,9,13,54,150,17,112,0,0
3574,523,133,578,284,49,9,13,55,151,18,112,0,0
3575,524,133,579,284,49,9,13,55,151,19,112,0,0
3576,524,133,579,282,49,9,13,55,149,20,112,0,0
3577,524,133,579,282,49,9,13,55,149,21,112,0,0
3578,524,134,578,280,49,9,13,54,146,22,112,0,0
3579,524,134,579,279,49,9,13,55,145,23,112,0,0
3580,523,135,578,281,49,9,13,55,146,24,112,0,0
3581,523,135,579,281,49,9,13,56,146,25,112,0,0
3582,523,135,578,282,49,9,13,55,147,26,112,0,0
3583,522,136,578,282,49,9,13,56,146,27,112,0,0
3584,522,138,576,279,49,9,13,54,141,28,112,0,0
3585,522,138,576,278,49,9,13,54,140,29,112,0,0
3586,522,137,577,280,49,9,13,55,143,30,112,0,0
3587,521,137,577,281,49,9,13,56,144,31,112,0,0
3588,521,137,577,281,49,9,13,56,144,32,112,0,0
3589,521,137,577,282,49,9,13,56,145,33,112,0,0
3590,521,137,577,282,49,9,13,56,145,34,112,0,0
3591,521,136,578,282,49,9,13,57,146,35,112,0,0
3592,521,136,578,282,49,9,13,57,146,36,112,0,0
3593,521,136,578,282,49,9,13,57,146,37,112,0,0
3594,521,136,578,282,49,9,13,57,146,38,112,0,0
3595,521,135,578,282,49,9,13,57,147,39,112,0,0
3596,521,136,578,282,49,9,13,57,146,40,112,0,0
3597,521,136,578,282,49,9,13,57,146,41,112,0,0
3598,521,136,578,282,49,9,13,57,146,42,112,0,0
3599,521,137,578,282,49,9,13,57,145,43,112,0,0
3600,521,137,578,282,49,9,13,57,145,44,112,0,0
3601,521,136,578,280,49,9,13,57,144,45,112,0,0
3602,521,136,578,279,49,9,13,57,143,46,112,0,0
3603,521,136,578,279,49,9,13,57,143,47,112,0,0
3604,521,135,578,280,49,9,13,57,145,48,112,0,0
3605,520,135,578,281,49,9,13,58,146,49,112,0,0
3606,521,136,578,281,49,9,13,57,145,50,112,0,0
3607,520,136,578,281,49,9,13,58,145,51,112,0,0
3608,520,136,578,282,49,9,13,58,146,52,112,0,0
3609,520,137,578,282,49,9,13,58,145,53,112,0,0
3610,520,137,578,282,49,9,13,58,145,54,112,0,0
3611,520,137,578,282,49,9,13,58,145,55,112,0,0
3612,521,137,578,282,49,9,13,57,145,56,112,0,0
3613,521,137,578,283,49,9,13,57,146,57,112,0,0
3614,520,137,578,283,49,9,13,58,146,58,112,0,0
3615,520,137,578,283,49,9,13,58,146,59,112,0,0
3616,521,136,578,281,49,9,13,57,145,60,112,0,0
3617,521,136,578,281,49,9,13,57,145,61,112,0,0
3618,521,136,578,281,49,9,13,57,145,62,112,0,0
3619,521,135,578,280,49,9,13,57,145,63,112,0,0
3620,521,135,578,280,49,9,13,57,145,64,112,0,0
3621,521,136,579,280,49,9,13,58,144,65,112,0,0
3622,521,136,579,280,49,9,13,58,144,66,112,0,0
3623,521,136,579,280,49,9,13,58,144,67,112,0,0
3624,521,137,579,280,49,9,13,58,143,68,112,0,0
3625,521,137,579,280,49,9,13,58,143,69,112,0,0
3626,521,137,579,281,49,9,13,58,144,70,112,0,0
3627,520,137,579,281,49,9,13,59,144,71,112,0,0
3628,520,137,579,281,49,9,13,59,144,72,112,0,0
3629,520,137,579,282,49,9,13,59,145,73,112,0,0
3630,520,137,579,282,49,9,13,59,145,74,112,0,0
3631,521,136,579,281,49,9,13,58,145,75,112,0,0
3632,521,136,579,281,49,9,13,58,145,76,112,0,0
3633,521,136,579,281,49,9,13,58,145,77,112,0,0
3634,521,135,579,280,49,9,13,58,145,78,112,0,0
3635,521,135,579,280,49,9,13,58,145,79,112,0,0
3636,521,136,579,280,49,9,13,58,144,80,112,0,0
3637,520,136,579,280,49,9,13,59,144,81,112,0,0
3638,520,136,579,280,49,9,13,59,144,82,112,0,0
3639,520,137,579,280,49,9,13,59,143,83,112,0,0
3640,520,137,579,281,49,9,13,59,144,84,112,0,0
3641,520,138,578,281,49,9,13,58,143,85,112,0,0
3642,521,138,578,281,49,9,13,57,143,86,112,0,0
3643,521,139,577,281,49,9,13,56,142,87,112,0,0
3644,521,139,577,280,49,9,13,56,141,88,112,0,0
3645,521,139,577,280,49,9,13,56,141,89,112,0,0
3646,520,137,577,280,49,9,13,57,143,90,112,0,0
3647,520,137,577,280,49,9,13,57,143,91,112,0,0
3648,520,137,577,280,49,9,13,57,143,92,112,0,0
3649,520,137,578,280,49,9,13,58,143,93,112,0,0
3650,520,136,578,280,49,9,13,58,144,94,112,0,0
3651,520,136,578,282,49,9,13,58,146,95,112,0,0
3652,520,136,578,283,49,9,13,58,147,96,112,0,0
3653,520,136,578,283,49,9,13,58,147,97,112,0,0
3654,520,136,578,283,49,9,13,58,147,98,112,0,0
3655,517,136,576,285,49,9,13,59,149,99,112,0,0
3656,511,136,570,283,49,9,13,59,147,100,112,0,0
3657,500,135,557,280,49,9,13,57,145,101,112,0,0
3658,488,131,546,276,49,9,13,58,145,102,112,0,0
3659,477,130,533,274,49,9,13,56,144,103,112,0,0
3660,459,133,516,279,49,9,13,57,146,104,112,0,0
3661,454,132,511,279,49,9,13,57,147,105,112,0,0
3662,424,135,476,270,49,9,13,52,135,106,112,0,0
3663,401,137,454,271,49,9,13,53,134,107,112,0,0
3664,381,131,435,266,49,9,13,54,135,108,112,0,0
3665,366,126,420,264,49,9,13,54,138,109,112,0,0
3666,352,128,404,264,49,9,13,52,136,110,112,0,0
3667,335,125,384,259,49,9,13,49,134,111,112,0,0
3668,322,124,371,258,49,9,13,49,134,112,112,1,0
3561,541,145,579,278,50,9,13,38,133,0,0,0,0
3661,447,133,485,203,51,9,13,38,70,0,0,0,0
3813,340,133,381,262,52,9,13,41,129,0,1,0,0
3814,351,139,387,253,52,9,13,36,114,1,1,0,0
3815,370,127,414,268,53,9,13,44,141,0,97,0,1
3816,387,129,431,267,53,9,13,44,138,1,97,0,0
3817,403,133,446,268,53,9,13,43,135,2,97,0,0
3818,420,128,467,276,53,9,13,47,148,3,97,0,0
3819,437,133,483,277,53,9,13,46,144,4,97,0,0
3820,459,140,502,275,53,9,13,43,135,5,97,0,0
3821,478,134,524,279,53,9,13,46,145,6,97,0,0
3822,493,133,540,279,53,9,13,47,146,7,97,0,0
3823,511,135,558,281,53,9,13,47,146,8,97,0,0
3824,525,134,575,285,53,9,13,50,151,9,97,0,0
3825,531,134,581,285,53,9,13,50,151,10,97,0,0
3826,533,133,584,285,53,9,13,51,152,11,97,0,0
3827,535,135,585,283,53,9,13,50,148,12,97,0,0
3828,534,136,584,282,53,9,13,50,146,13,97,0,0
3829,534,137,584,281,53,9,13,50,144,14,97,0,0
3830,533,137,584,281,53,9,13,51,144,15,97,0,0
3831,532,135,584,284,53,9,13,52,149,16,97,0,0
3832,531,136,584,285,53,9,13,53,149,17,97,0,0
3833,531,135,584,286,53,9,13,53,151,18,97,0,0
3834,530,135,584,286,53,9,13,54,151,19,97,0,0
3835,530,135,584,286,53,9,13,54,151,20,97,0,0
3836,530,137,583,284,53,9,13,53,147,21,97,0,0
3837,530,137,583,283,53,9,13,53,146,22,97,0,0
3838,530,138,582,283,53,9,13,52,145,23,97,0,0
3839,530,138,582,283,53,9,13,52,145,24,97,0,0
3840,530,138,582,283,53,9,13,52,145,25,97,0,0
3841,529,138,581,281,53,9,13,52,143,26,97,0,0
3842,529,138,581,281,53,9,13,52,143,27,97,0,0
3843,529,138,581,281,53,9,13,52,143,28,97,0,0
3844,529,138,581,280,53,9,13,52,142,29,97,0,0
3845,528,138,581,280,53,9,13,53,142,30,97,0,0
3846,528,138,581,282,53,9,13,53,144,31,97,0,0
3847,528,138,581,282,53,9,13,53,144,32,97,0,0
3848,527,139,580,282,53,9,13,53,143,33,97,0,0
3849,527,139,580,283,53,9,13,53,144,34,97,0,0
3850,527,139,580,283,53,9,13,53,144,35,97,0,0
3851,527,137,581,282,53,9,13,54,145,36,97,0,0
3852,528,137,581,282,53,9,13,53,145,37,97,0,0
3853,528,137,581,282,53,9,13,53,145,38,97,0,0
3854,528,136,581,282,53,9,13,53,146,39,97,0,0
3855,528,136,581,281,53,9,13,53,145,40,97,0,0
3856,528,138,581,281,53,9,13,53,143,41,97,0,0
3857,528,138,580,281,53,9,13,52,143,42,97,0,0
3858,528,138,580,280,53,9,13,52,142,43,97,0,0
3859,528,139,580,280,53,9,13,52,141,44,97,0,0
3860,528,138,580,280,53,9,13,52,142,45,97,0,0
3861,527,137,580,280,53,9,13,53,143,46,97,0,0
3862,527,137,580,280,53,9,13,53,143,47,97,0,0
3863,527,137,580,280,53,9,13,53,143,48,97,0,0
3864,527,136,580,279,53,9,13,53,143,49,97,0,0
3865,527,136,580,279,53,9,13,53,143,50,97,0,0
3866,527,136,581,280,53,9,13,54,144,51,97,0,0
3867,527,136,581,280,53,9,13,54,144,52,97,0,0
3868,527,136,581,280,53,9,13,54,144,53,97,0,0
3869,527,136,581,280,53,9,13,54,144,54,97,0,0
3870,527,136,581,280,53,9,13,54,144,55,97,0,0
3871,527,136,581,282,53,9,13,54,146,56,97,0,0
3872,527,136,582,282,53,9,13,55,146,57,97,0,0
3873,527,135,582,282,53,9,13,55,147,58,97,0,0
3874,527,135,582,282,53,9,13,55,147,59,97,0,0
3875,527,135,582,283,53,9,13,55,148,60,97,0,0
3876,527,137,581,282,53,9,13,54,145,61,97,0,0
3877,527,137,581,282,53,9,13,54,145,62,97,0,0
3878,527,137,581,282,53,9,13,54,145,63,97,0,0
3879,527,138,581,282,53,9,13,54,144,64,97,0,0
3880,527,138,581,282,53,9,13,54,144,65,97,0,0
3881,528,137,580,280,53,9,13,52,143,66,97,0,0
3882,528,137,580,279,53,9,13,52,142,67,97,0,0
3883,528,137,580,279,53,9,13,52,142,68,97,0,0
3884,527,135,581,280,53,9,13,54,145,69,97,0,0
3885,528,136,580,279,53,9,13,52,143,70,97,0,0
3886,527,136,581,280,53,9,13,54,144,71,97,0,0
3887,527,136,581,280,53,9,13,54,144,72,97,0,0
3888,527,136,581,280,53,9,13,54,144,73,97,0,0
3889,527,136,581,280,53,9,13,54,144,74,97,0,0
3890,527,136,581,280,53,9,13,54,144,75,97,0,0
3891,527,136,581,283,53,9,13,54,147,76,97,0,0
3892,526,136,581,284,53,9,13,55,148,77,97,0,0
3893,526,136,581,285,53,9,13,55,149,78,97,0,0
3894,526,135,581,285,53,9,13,55,150,79,97,0,0
3895,526,135,581,285,53,9,13,55,150,80,97,0,0
3896,527,137,581,283,53,9,13,54,146,81,97,0,0
3897,527,137,581,283,53,9,13,54,146,82,97,0,0
3898,527,137,580,282,53,9,13,53,145,83,97,0,0
3899,524,135,579,283,53,9,13,55,148,84,97,0,0
3900,519,136,574,283,53,9,13,55,147,85,97,0,0
3901,505,134,560,281,53,9,13,55,147,86,97,0,0
3902,494,131,548,280,53,9,13,54,149,87,97,0,0
3903,477,133,531,279,53,9,13,54,146,88,97,0,0
3904,460,137,513,279,53,9,13,53,142,89,97,0,0
3905,440,134,491,272,53,9,13,51,138,90,97,0,0
3906,412,136,465,272,53,9,13,53,136,91,97,0,0
3907,392,134,447,271,53,9,13,55,137,92,97,0,0
3908,376,128,431,268,53,9,13,55,140,93,97,0,0
3909,361,130,415,271,53,9,13,54,141,94,97,0,0
3910,348,134,398,268,53,9,13,50,134,95,97,0,0
3911,334,130,383,266,53,9,13,49,136,96,97,0,0
3912,322,130,371,265,53,9,13,49,135,97,97,1,0
3823,541,147,580,281,54,9,13,39,134,0,0,0,0
3901,541,146,579,282,55,9,13,38,136,0,0,0,0
4074,262,512,369,1005,56,9,13,107,493,0,8,0,0
4075,314,511,433,1050,56,9,13,119,539,1,8,0,0
4076,360,508,488,1071,56,9,13,128,563,2,8,0,0
4077,414,510,545,1075,56,9,13,131,565,3,8,0,0
4078,486,538,617,1074,56,9,13,131,536,4,8,0,0
4079,588,568,719,1074,56,9,13,131,506,5,8,0,0
4080,675,612,809,1070,56,9,13,134,458,6,8,0,0
4081,769,647,904,1069,56,9,13,135,422,7,8,0,0
4082,842,669,972,1072,56,9,13,130,403,8,8,0,0
4216,550,132,590,274,58,9,13,40,142,0,8,0,0
4217,544,137,582,271,58,9,13,38,134,1,8,0,0
4222,459,141,495,255,58,9,13,36,114,0,8,0,0
4223,443,140,480,256,58,9,13,37,116,1,8,0,0
4224,425,140,462,253,58,9,13,37,113,2,8,0,0
4225,406,140,445,251,58,9,13,39,111,3,8,0,0
4226,386,132,429,253,58,9,13,43,121,4,8,0,0
4227,364,131,409,254,58,9,13,45,123,5,8,0,0
4228,349,134,393,254,58,9,13,44,120,6,8,0,0
4229,336,137,380,254,58,9,13,44,117,7,8,0,0
4230,320,137,363,254,58,9,13,43,117,8,8,0,0
4219,498,150,554,252,59,9,13,56,102,0,0,0,0
5661,1751,821,1917,1074,60,9,13,166,253,0,0,0,0
5663,1344,715,1620,1066,62,9,13,276,351,0,0,0,0
5664,1163,609,1469,1065,63,9,13,306,456,0,0,0,0
5665,954,574,1318,1070,64,9,13,364,496,0,22,0,1
5666,856,496,1274,1070,64,9,13,418,574,1,22,0,0
5667,757,455,1199,1064,64,9,13,442,609,2,22,0,0
5668,681,425,1133,1059,64,9,13,452,634,3,22,0,0
5669,631,378,1079,1018,64,9,13,448,640,4,22,0,0
5670,590,356,1029,997,64,9,13,439,641,5,22,0,0
5671,588,321,979,906,64,9,13,391,585,6,22,0,0
5672,590,306,946,853,64,9,13,356,547,7,22,0,0
5673,587,291,907,798,64,9,13,320,507,8,22,0,0
5674,596,269,887,747,64,9,13,291,478,9,22,0,0
5675,610,265,880,724,64,9,13,270,459,10,22,0,0
5676,628,245,873,675,64,9,13,245,430,11,22,0,0
5677,634,239,867,657,64,9,13,233,418,12,22,0,0
5678,647,231,854,616,64,9,13,207,385,13,22,0,0
5679,670,226,859,588,64,9,13,189,362,14,22,0,0
5680,684,227,864,579,64,9,13,180,352,15,22,0,0
5681,720,219,890,556,64,9,13,170,337,16,22,0,0
5682,750,220,911,550,64,9,13,161,330,17,22,0,0
5683,778,222,923,527,64,9,13,145,305,18,22,0,0
5684,794,216,933,517,64,9,13,139,301,19,22,0,0
5685,808,225,939,512,64,9,13,131,287,20,22,0,0
5686,832,222,955,497,64,9,13,123,275,21,22,0,0
5687,845,218,961,478,64,9,13,116,260,22,22,1,0
86,781,815,1017,1072,2,9,14,236,257,0,56,0,1
87,827,695,1168,1066,2,9,14,341,371,1,56,0,0
88,872,642,1262,1069,2,9,14,390,427,2,56,0,0
89,907,565,1364,1072,2,9,14,457,507,3,56,0,0
90,951,516,1444,1071,2,9,14,493,555,4,56,0,0
91,1002,485,1510,1070,2,9,14,508,585,5,56,0,0
92,1030,438,1564,1073,2,9,14,534,635,6,56,0,0
93,1069,410,1589,1052,2,9,14,520,642,7,56,0,0
94,1123,372,1595,976,2,9,14,472,604,8,56,0,0
95,1171,359,1604,934,2,9,14,433,575,9,56,0,0
96,1226,344,1603,862,2,9,14,377,518,10,56,0,0
97,1257,324,1608,827,2,9,14,351,503,11,56,0,0
98,1287,313,1608,794,2,9,14,321,481,12,56,0,0
99,1319,296,1603,738,2,9,14,284,442,13,56,0,0
100,1347,292,1604,707,2,9,14,257,415,14,56,0,0
101,1371,274,1608,671,2,9,14,237,397,15,56,0,0
102,1390,269,1611,656,2,9,14,221,387,16,56,0,0
103,1407,260,1609,629,2,9,14,202,369,17,56,0,0
104,1423,250,1608,600,2,9,14,185,350,18,56,0,0
105,1438,246,1611,584,2,9,14,173,338,19,56,0,0
106,1451,235,1611,557,2,9,14,160,322,20,56,0,0
107,1459,237,1608,546,2,9,14,149,309,21,56,0,0
108,1466,226,1605,522,2,9,14,139,296,22,56,0,0
109,1477,227,1603,505,2,9,14,126,278,23,56,0,0
110,1486,225,1603,489,2,9,14,117,264,24,56,0,0
111,1494,221,1604,474,2,9,14,110,253,25,56,0,0
112,1497,221,1603,472,2,9,14,106,251,26,56,0,0
113,1502,214,1602,457,2,9,14,100,243,27,56,0,0
114,1506,216,1600,448,2,9,14,94,232,28,56,0,0
115,1514,208,1602,434,2,9,14,88,226,29,56,0,0
116,1518,203,1603,426,2,9,14,85,223,30,56,0,0
117,1521,203,1601,418,2,9,14,80,215,31,56,0,0
118,1523,201,1598,406,2,9,14,75,205,32,56,0,0
119,1525,202,1597,400,2,9,14,72,198,33,56,0,0
120,1528,200,1597,395,2,9,14,69,195,34,56,0,0
121,1531,198,1597,389,2,9,14,66,191,35,56,0,0
122,1532,197,1595,380,2,9,14,63,183,36,56,0,0
123,1534,196,1594,372,2,9,14,60,176,37,56,0,0
124,1537,197,1595,368,2,9,14,58,171,38,56,0,0
125,1540,190,1597,361,2,9,14,57,171,39,56,0,0
126,1544,193,1598,357,2,9,14,54,164,40,56,0,0
127,1546,186,1598,349,2,9,14,52,163,41,56,0,0
128,1550,185,1601,345,2,9,14,51,160,42,56,0,0
129,1554,185,1603,340,2,9,14,49,155,43,56,0,0
130,1558,183,1606,335,2,9,14,48,152,44,56,0,0
131,1561,184,1607,332,2,9,14,46,148,45,56,0,0
132,1564,182,1608,324,2,9,14,44,142,46,56,0,0
133,1566,183,1608,320,2,9,14,42,137,47,56,0,0
134,1569,181,1611,317,2,9,14,42,136,48,56,0,0
135,1570,180,1611,314,2,9,14,41,134,49,56,0,0
136,1571,180,1611,310,2,9,14,40,130,50,56,0,0
137,1572,176,1612,308,2,9,14,40,132,51,56,0,0
138,1573,178,1612,304,2,9,14,39,126,52,56,0,0
139,1575,177,1613,300,2,9,14,38,123,53,56,0,0
140,1576,176,1613,295,2,9,14,37,119,54,56,0,0
141,1578,175,1613,291,2,9,14,35,116,55,56,0,0
142,1578,174,1613,287,2,9,14,35,113,56,56,1,0
144,1580,172,1615,284,2,9,14,35,112,0,56,0,0
149,1584,162,1619,275,2,9,14,35,113,0,56,0,0
163,1305,331,1433,841,1,9,15,128,510,0,14,0,0
164,1244,345,1378,869,1,9,15,134,524,1,14,0,0
165,1212,352,1355,903,1,9,15,143,551,2,14,0,0
166,1176,355,1326,921,1,9,15,150,566,3,14,0,0
167,1109,380,1287,1023,1,9,15,178,643,4,14,0,0
168,1078,399,1270,1070,1,9,15,192,671,5,14,0,0
169,1062,420,1257,1080,1,9,15,195,660,6,14,0,0
170,1046,463,1238,1080,1,9,15,192,617,7,14,0,0
171,1017,497,1208,1080,1,9,15,191,583,8,14,0,0
172,1002,528,1203,1080,1,9,15,201,552,9,14,0,0
173,1048,586,1254,1080,1,9,15,206,494,10,14,0,0
174,1101,642,1308,1080,1,9,15,207,438,11,14,0,0
175,1131,696,1331,1076,1,9,15,200,380,12,14,0,0
176,1228,755,1414,1076,1,9,15,186,321,13,14,0,0
177,1255,795,1424,1080,1,9,15,169,285,14,14,0,0
994,1369,253,1431,477,3,9,15,62,224,0,43,0,1
995,1333,239,1402,482,3,9,15,69,243,1,43,0,0
996,1310,231,1380,478,3,9,15,70,247,2,43,0,0
997,1291,221,1362,471,3,9,15,71,250,3,43,0,0
998,1269,217,1338,455,3,9,15,69,238,4,43,0,0
999,1246,207,1318,451,3,9,15,72,244,5,43,0,0
1000,1228,206,1298,443,3,9,15,70,237,6,43,0,0
1001,1211,194,1281,426,3,9,15,70,232,7,43,0,0
1002,1205,192,1276,419,3,9,15,71,227,8,43,0,0
1003,1208,193,1274,398,3,9,15,66,205,9,43,0,0
1004,1200,188,1267,395,3,9,15,67,207,10,43,0,0
1005,1197,187,1263,390,3,9,15,66,203,11,43,0,0
1006,1197,178,1263,384,3,9,15,66,206,12,43,0,0
1007,1200,177,1265,379,3,9,15,65,202,13,43,0,0
1008,1207,177,1271,371,3,9,15,64,194,14,43,0,0
1009,1215,174,1277,366,3,9,15,62,192,15,43,0,0
1010,1221,172,1281,357,3,9,15,60,185,16,43,0,0
1011,1228,169,1288,354,3,9,15,60,185,17,43,0,0
1012,1232,169,1292,352,3,9,15,60,183,18,43,0,0
1013,1238,164,1298,347,3,9,15,60,183,19,43,0,0
1014,1243,157,1302,339,3,9,15,59,182,20,43,0,0
1015,1246,160,1303,335,3,9,15,57,175,21,43,0,0
1016,1247,152,1305,330,3,9,15,58,178,22,43,0,0
1017,1249,147,1307,326,3,9,15,58,179,23,43,0,0
1018,1252,146,1309,320,3,9,15,57,174,24,43,0,0
1019,1253,147,1308,310,3,9,15,55,163,25,43,0,0
1020,1251,148,1303,305,3,9,15,52,157,26,43,0,0
1021,1249,147,1302,304,3,9,15,53,157,27,43,0,0
1022,1249,145,1303,304,3,9,15,54,159,28,43,0,0
1023,1250,144,1302,297,3,9,15,52,153,29,43,0,0
1024,1250,143,1300,290,3,9,15,50,147,30,43,0,0
1025,1247,143,1295,282,3,9,15,48,139,31,43,0,0
1026,1242,139,1292,281,3,9,15,50,142,32,43,0,0
1027,1240,137,1290,277,3,9,15,50,140,33,43,0,0
1028,1239,137,1286,270,3,9,15,47,133,34,43,0,0
1029,1235,139,1278,257,3,9,15,43,118,35,43,0,0
1030,1228,140,1270,257,3,9,15,42,117,36,43,0,0
1031,1216,134,1262,264,3,9,15,46,130,37,43,0,0
1032,1208,134,1253,258,3,9,15,45,124,38,43,0,0
1033,1200,133,1244,259,3,9,15,44,126,39,43,0,0
1034,1191,134,1230,245,3,9,15,39,111,40,43,0,0
1035,1180,134,1218,240,3,9,15,38,106,41,43,0,0
1036,1169,129,1208,240,3,9,15,39,111,42,43,0,0
1037,1163,128,1200,236,3,9,15,37,108,43,43,1,0
1643,1355,397,1433,700,4,9,15,78,303,0,0,0,0
1644,1248,361,1430,846,5,9,15,182,485,0,10,0,0
1645,1223,361,1409,857,5,9,15,186,496,1,10,0,0
1646,1149,371,1347,892,5,9,15,198,521,2,10,0,0
1647,1100,392,1305,932,5,9,15,205,540,3,10,0,0
1648,1047,401,1265,976,5,9,15,218,575,4,10,0,0
1649,1009,436,1245,1049,5,9,15,236,613,5,10,0,0
1650,940,466,1180,1078,5,9,15,240,612,6,10,0,0
1651,840,492,1074,1080,5,9,15,234,588,7,10,0,0
1652,747,544,967,1080,5,9,15,220,536,8,10,0,0
1653,639,584,846,1080,5,9,15,207,496,9,10,0,0
1654,574,609,780,1080,5,9,15,206,471,10,10,0,0
1655,266,745,588,1075,6,9,15,322,330,0,4,0,0
1656,154,769,449,1071,6,9,15,295,302,1,4,0,0
1657,54,832,291,1071,6,9,15,237,239,2,4,0,0
1658,0,904,157,1074,6,9,15,157,170,3,4,0,0
1659,0,952,50,1075,6,9,15,50,123,4,4,0,0
1730,1369,215,1440,518,7,9,15,71,303,0,48,0,1
1731,1353,215,1423,512,7,9,15,70,297,1,48,0,0
1732,1334,217,1401,494,7,9,15,67,277,2,48,0,0
1733,1313,210,1382,490,7,9,15,69,280,3,48,0,0
1734,1291,203,1361,482,7,9,15,70,279,4,48,0,0
1735,1272,202,1342,477,7,9,15,70,275,5,48,0,0
1736,1252,200,1323,469,7,9,15,71,269,6,48,0,0
1737,1237,197,1308,458,7,9,15,71,261,7,48,0,0
1738,1223,195,1293,448,7,9,15,70,253,8,48,0,0
1739,1209,187,1281,440,7,9,15,72,253,9,48,0,0
1740,1201,183,1274,435,7,9,15,73,252,10,48,0,0
1741,1195,181,1271,436,7,9,15,76,255,11,48,0,0
1742,1191,183,1262,416,7,9,15,71,233,12,48,0,0
1743,1187,173,1258,405,7,9,15,71,232,13,48,0,0
1744,1184,173,1254,401,7,9,15,70,228,14,48,0,0
1745,1180,167,1250,394,7,9,15,70,227,15,48,0,0
1746,1180,166,1248,384,7,9,15,68,218,16,48,0,0
1747,1180,165,1250,383,7,9,15,70,218,17,48,0,0
1748,1184,164,1250,372,7,9,15,66,208,18,48,0,0
1749,1186,161,1250,365,7,9,15,64,204,19,48,0,0
1750,1185,156,1250,364,7,9,15,65,208,20,48,0,0
1751,1186,153,1249,360,7,9,15,63,207,21,48,0,0
1752,1187,151,1249,352,7,9,15,62,201,22,48,0,0
1753,1192,151,1251,342,7,9,15,59,191,23,48,0,0
1754,1197,151,1253,333,7,9,15,56,182,24,48,0,0
1755,1199,151,1254,330,7,9,15,55,179,25,48,0,0
1756,1199,150,1253,327,7,9,15,54,177,26,48,0,0
1757,1196,148,1250,325,7,9,15,54,177,27,48,0,0
1758,1195,147,1249,322,7,9,15,54,175,28,48,0,0
1759,1197,149,1249,318,7,9,15,52,169,29,48,0,0
1760,1199,149,1250,314,7,9,15,51,165,30,48,0,0
1761,1200,148,1252,316,7,9,15,52,168,31,48,0,0
1762,1200,141,1252,309,7,9,15,52,168,32,48,0,0
1763,1202,139,1252,303,7,9,15,50,164,33,48,0,0
1764,1204,137,1252,298,7,9,15,48,161,34,48,0,0
1765,1206,135,1254,293,7,9,15,48,158,35,48,0,0
1766,1208,134,1255,290,7,9,15,47,156,36,48,0,0
1767,1208,137,1256,291,7,9,15,48,154,37,48,0,0
1768,1208,135,1255,288,7,9,15,47,153,38,48,0,0
1769,1208,131,1254,284,7,9,15,46,153,39,48,0,0
1770,1207,129,1253,284,7,9,15,46,155,40,48,0,0
1771,1206,132,1252,282,7,9,15,46,150,41,48,0,0
1772,1205,132,1249,277,7,9,15,44,145,42,48,0,0
1773,1199,126,1245,277,7,9,15,46,151,43,48,0,0
1774,1194,125,1240,274,7,9,15,46,149,44,48,0,0
1775,1191,124,1235,268,7,9,15,44,144,45,48,0,0
1776,1183,124,1226,263,7,9,15,43,139,46,48,0,0
1777,1175,119,1217,255,7,9,15,42,136,47,48,0,0
1778,1173,117,1214,251,7,9,15,41,134,48,48,1,0
1872,1175,134,1226,255,9,9,15,51,121,0,0,0,0
1877,1174,133,1216,254,10,9,15,42,121,0,0,0,0
2094,1176,146,1238,254,11,9,15,62,108,0,4,0,0
2095,1180,142,1242,250,11,9,15,62,108,1,4,0,0
2096,1182,138,1247,253,11,9,15,65,115,2,4,0,0
2097,1187,135,1252,251,11,9,15,65,116,3,4,0,0
2098,1190,133,1255,250,11,9,15,65,117,4,4,0,0
2115,1238,155,1305,284,12,9,15,67,129,0,39,0,0
2116,1242,154,1300,267,12,9,15,58,113,1,39,0,0
2117,1238,153,1301,275,12,9,15,63,122,2,39,0,0
2118,1237,159,1298,275,12,9,15,61,116,3,39,0,0
2119,1236,161,1295,276,12,9,15,59,115,4,39,0,0
2120,1235,163,1293,276,12,9,15,58,113,5,39,0,0
2121,1233,169,1292,283,12,9,15,59,114,6,39,0,0
2122,1229,171,1289,290,12,9,15,60,119,7,39,0,0
2123,1227,173,1286,286,12,9,15,59,113,8,39,0,0
2124,1218,174,1283,300,12,9,15,65,126,9,39,0,0
2125,1215,175,1276,294,12,9,15,61,119,10,39,0,0
2126,1210,174,1276,301,12,9,15,66,127,11,39,0,0
2127,1206,177,1274,309,12,9,15,68,132,12,39,0,0
2128,1203,177,1273,314,12,9,15,70,137,13,39,0,0
2129,1201,181,1269,316,12,9,15,68,135,14,39,0,0
2130,1198,183,1267,320,12,9,15,69,137,15,39,0,0
2134,1178,186,1262,354,12,9,15,84,168,0,39,0,0
2135,1169,186,1257,365,12,9,15,88,179,1,39,0,0
2136,1164,190,1245,357,12,9,15,81,167,2,39,0,0
2137,1162,193,1241,359,12,9,15,79,166,3,39,0,0
2138,1151,196,1227,355,12,9,15,76,159,4,39,0,0
2139,1146,198,1223,359,12,9,15,77,161,5,39,0,0
2144,1116,228,1198,405,12,9,15,82,177,0,39,0,1
2145,1103,223,1190,410,12,9,15,87,187,1,39,0,0
2146,1091,222,1170,389,12,9,15,79,167,2,39,0,0
2147,1080,229,1155,384,12,9,15,75,155,3,39,0,0
2148,1058,232,1144,409,12,9,15,86,177,4,39,0,0
2149,1049,238,1119,372,12,9,15,70,134,5,39,0,0
2150,1042,241,1111,364,12,9,15,69,123,6,39,0,0
2151,1035,246,1109,375,12,9,15,74,129,7,39,0,0
2152,1021,253,1102,388,12,9,15,81,135,8,39,0,0
2153,1008,257,1093,395,12,9,15,85,138,9,39,0,0
2154,980,263,1103,465,12,9,15,123,202,10,39,0,0
2155,973,273,1096,471,12,9,15,123,198,11,39,0,0
2156,971,276,1090,461,12,9,15,119,185,12,39,0,0
2157,970,283,1090,465,12,9,15,120,182,13,39,0,0
2158,963,291,1084,470,12,9,15,121,179,14,39,0,0
2159,950,298,1083,493,12,9,15,133,195,15,39,0,0
2160,936,307,1088,527,12,9,15,152,220,16,39,0,0
2161,932,323,1082,539,12,9,15,150,216,17,39,0,0
2162,933,328,1081,541,12,9,15,148,213,18,39,0,0
2163,923,342,1087,579,12,9,15,164,237,19,39,0,0
2164,911,354,1077,595,12,9,15,166,241,20,39,0,0
2165,886,361,1072,633,12,9,15,186,272,21,39,0,0
2166,861,377,1098,735,12,9,15,237,358,22,39,0,0
2167,815,391,1124,875,12,9,15,309,484,23,39,0,0
2168,796,405,1123,934,12,9,15,327,529,24,39,0,0
2169,784,421,1101,944,12,9,15,317,523,25,39,0,0
2170,768,438,1096,990,12,9,15,328,552,26,39,0,0
2171,767,456,1098,1022,12,9,15,331,566,27,39,0,0
2172,776,479,1114,1061,12,9,15,338,582,28,39,0,0
2173,806,495,1145,1072,12,9,15,339,577,29,39,0,0
2174,825,513,1164,1080,12,9,15,339,567,30,39,0,0
2175,823,548,1152,1080,12,9,15,329,532,31,39,0,0
2176,817,573,1141,1080,12,9,15,324,507,32,39,0,0
2177,807,602,1132,1080,12,9,15,325,478,33,39,0,0
2178,823,644,1138,1080,12,9,15,315,436,34,39,0,0
2179,841,681,1143,1080,12,9,15,302,399,35,39,0,0
2180,827,710,1127,1080,12,9,15,300,370,36,39,0,0
2181,815,733,1114,1080,12,9,15,299,347,37,39,0,0
2182,793,751,1092,1077,12,9,15,299,326,38,39,0,0
2183,780,769,1078,1077,12,9,15,298,308,39,39,1,0
2121,1225,173,1261,258,13,9,15,36,85,0,0,0,0
2171,625,759,727,1074,14,9,15,102,315,0,0,0,0
2288,1,742,171,1075,17,9,15,170,333,0,95,0,1
2289,33,715,213,1065,17,9,15,180,350,1,95,0,0
2290,80,684,282,1073,17,9,15,202,389,2,95,0,0
2291,143,651,368,1076,17,9,15,225,425,3,95,0,0
2292,169,624,410,1076,17,9,15,241,452,4,95,0,0
2293,205,584,469,1074,17,9,15,264,490,5,95,0,0
2294,238,551,518,1073,17,9,15,280,522,6,95,0,0
2295,293,530,585,1070,17,9,15,292,540,7,95,0,0
2296,330,507,628,1065,17,9,15,298,558,8,95,0,0
2297,369,481,663,1033,17,9,15,294,552,9,95,0,0
2298,397,464,693,1023,17,9,15,296,559,10,95,0,0
2299,424,444,712,992,17,9,15,288,548,11,95,0,0
2300,465,423,733,930,17,9,15,268,507,12,95,0,0
2301,504,412,757,896,17,9,15,253,484,13,95,0,0
2302,535,392,785,877,17,9,15,250,485,14,95,0,0
2303,576,377,810,833,17,9,15,234,456,15,95,0,0
2304,602,372,828,815,17,9,15,226,443,16,95,0,0
2305,624,357,845,792,17,9,15,221,435,17,95,0,0
2306,650,342,859,756,17,9,15,209,414,18,95,0,0
2307,672,334,873,738,17,9,15,201,404,19,95,0,0
2308,704,317,898,712,17,9,15,194,395,20,95,0,0
2309,738,309,926,691,17,9,15,188,382,21,95,0,0
2310,752,302,938,683,17,9,15,186,381,22,95,0,0
2311,771,292,952,667,17,9,15,181,375,23,95,0,0
2312,795,285,966,640,17,9,15,171,355,24,95,0,0
2313,813,282,976,626,17,9,15,163,344,25,95,0,0
2314,842,272,999,603,17,9,15,157,331,26,95,0,0
2315,863,266,1018,590,17,9,15,155,324,27,95,0,0
2316,870,261,1021,584,17,9,15,151,323,28,95,0,0
2317,882,252,1031,568,17,9,15,149,316,29,95,0,0
2318,893,247,1037,554,17,9,15,144,307,30,95,0,0
2319,907,244,1046,542,17,9,15,139,298,31,95,0,0
2320,929,236,1064,522,17,9,15,135,286,32,95,0,0
2321,939,233,1070,512,17,9,15,131,279,33,95,0,0
2322,940,231,1068,503,17,9,15,128,272,34,95,0,0
2323,947,226,1070,487,17,9,15,123,261,35,95,0,0
2324,955,220,1078,481,17,9,15,123,261,36,95,0,0
2325,968,214,1090,472,17,9,15,122,258,37,95,0,0
2326,984,210,1101,457,17,9,15,117,247,38,95,0,0
2327,990,210,1104,452,17,9,15,114,242,39,95,0,0
2328,995,207,1107,445,17,9,15,112,238,40,95,0,0
2329,1002,202,1109,431,17,9,15,107,229,41,95,0,0
2330,1010,200,1116,427,17,9,15,106,227,42,95,0,0
2331,1025,197,1127,418,17,9,15,102,221,43,95,0,0
2332,1034,194,1135,415,17,9,15,101,221,44,95,0,0
2333,1037,194,1135,411,17,9,15,98,217,45,95,0,0
2334,1044,187,1139,398,17,9,15,95,211,46,95,0,0
2335,1050,184,1144,394,17,9,15,94,210,47,95,0,0
2336,1059,183,1152,389,17,9,15,93,206,48,95,0,0
2337,1069,179,1160,385,17,9,15,91,206,49,95,0,0
2338,1076,178,1162,375,17,9,15,86,197,50,95,0,0
2339,1081,177,1164,369,17,9,15,83,192,51,95,0,0
2340,1086,176,1166,361,17,9,15,80,185,52,95,0,0
2341,1091,175,1169,357,17,9,15,78,182,53,95,0,0
2342,1099,173,1176,353,17,9,15,77,180,54,95,0,0
2343,1103,170,1180,349,17,9,15,77,179,55,95,0,0
2344,1106,171,1179,343,17,9,15,73,172,56,95,0,0
2345,1107,168,1181,345,17,9,15,74,177,57,95,0,0
2346,1110,166,1185,343,17,9,15,75,177,58,95,0,0
2347,1114,167,1188,341,17,9,15,74,174,59,95,0,0
2348,1124,162,1197,334,17,9,15,73,172,60,95,0,0
2349,1132,159,1202,325,17,9,15,70,166,61,95,0,0
2350,1135,158,1203,322,17,9,15,68,164,62,95,0,0
2351,1137,154,1206,320,17,9,15,69,166,63,95,0,0
2352,1141,151,1210,320,17,9,15,69,169,64,95,0,0
2353,1149,150,1217,318,17,9,15,68,168,65,95,0,0
2354,1156,148,1223,312,17,9,15,67,164,66,95,0,0
2355,1161,149,1224,306,17,9,15,63,157,67,95,0,0
2356,1161,149,1223,305,17,9,15,62,156,68,95,0,0
2357,1161,147,1222,302,17,9,15,61,155,69,95,0,0
2358,1162,146,1223,300,17,9,15,61,154,70,95,0,0
2359,1165,146,1226,300,17,9,15,61,154,71,95,0,0
2360,1169,144,1229,297,17,9,15,60,153,72,95,0,0
2361,1169,143,1229,294,17,9,15,60,151,73,95,0,0
2362,1170,144,1228,293,17,9,15,58,149,74,95,0,0
2363,1170,143,1229,294,17,9,15,59,151,75,95,0,0
2364,1170,144,1226,289,17,9,15,56,145,76,95,0,0
2365,1172,141,1229,287,17,9,15,57,146,77,95,0,0
2366,1180,142,1234,284,17,9,15,54,142,78,95,0,0
2367,1186,139,1240,284,17,9,15,54,145,79,95,0,0
2368,1191,138,1244,282,17,9,15,53,144,80,95,0,0
2369,1199,137,1249,278,17,9,15,50,141,81,95,0,0
2370,1209,143,1256,275,17,9,15,47,132,82,95,0,0
2371,1213,142,1260,272,17,9,15,47,130,83,95,0,0
2372,1230,140,1276,269,17,9,15,46,129,84,95,0,0
2373,1236,139,1281,266,17,9,15,45,127,85,95,0,0
2374,1258,135,1309,277,17,9,15,51,142,86,95,0,0
2375,1266,134,1317,276,17,9,15,51,142,87,95,0,0
2377,1285,143,1334,278,17,9,15,49,135,0,95,0,0
2378,1298,146,1344,272,17,9,15,46,126,1,95,0,0
2379,1307,150,1351,272,17,9,15,44,122,2,95,0,0
2380,1315,151,1359,271,17,9,15,44,120,3,95,0,0
2381,1320,153,1364,270,17,9,15,44,117,4,95,0,0
2382,1324,150,1368,268,17,9,15,44,118,5,95,0,0
2383,1332,150,1375,267,17,9,15,43,117,6,95,0,0
2384,1329,141,1380,278,17,9,15,51,137,7,95,0,0
2385,1329,144,1381,282,17,9,15,52,138,8,95,0,0
2386,1335,143,1387,282,17,9,15,52,139,9,95,0,0
2388,1334,145,1392,299,17,9,15,58,154,0,95,0,1
2389,1335,149,1393,303,17,9,15,58,154,1,95,0,0
2390,1335,151,1393,307,17,9,15,58,156,2,95,0,0
2391,1333,151,1393,310,17,9,15,60,159,3,95,0,0
2392,1332,157,1390,311,17,9,15,58,154,4,95,0,0
2393,1330,155,1391,314,17,9,15,61,159,5,95,0,0
2394,1329,150,1392,318,17,9,15,63,168,6,95,0,0
2395,1330,159,1391,321,17,9,15,61,162,7,95,0,0
2396,1329,155,1393,325,17,9,15,64,170,8,95,0,0
2397,1328,152,1393,330,17,9,15,65,178,9,95,0,0
2398,1326,152,1392,333,17,9,15,66,181,10,95,0,0
2399,1324,151,1391,336,17,9,15,67,185,11,95,0,0
2400,1325,159,1389,336,17,9,15,64,177,12,95,0,0
2401,1328,164,1392,342,17,9,15,64,178,13,95,0,0
2402,1329,168,1391,342,17,9,15,62,174,14,95,0,0
2403,1328,173,1391,349,17,9,15,63,176,15,95,0,0
2404,1325,173,1389,352,17,9,15,64,179,16,95,0,0
2405,1323,173,1387,356,17,9,15,64,183,17,95,0,0
2406,1322,178,1385,357,17,9,15,63,179,18,95,0,0
2407,1324,178,1387,359,17,9,15,63,181,19,95,0,0
2408,1323,179,1388,362,17,9,15,65,183,20,95,0,0
2409,1318,179,1386,377,17,9,15,68,198,21,95,0,0
2410,1317,179,1384,375,17,9,15,67,196,22,95,0,0
2411,1314,181,1380,374,17,9,15,66,193,23,95,0,0
2412,1315,184,1382,382,17,9,15,67,198,24,95,0,0
2413,1318,188,1384,382,17,9,15,66,194,25,95,0,0
2414,1318,189,1384,383,17,9,15,66,194,26,95,0,0
2415,1317,193,1385,392,17,9,15,68,199,27,95,0,0
2416,1314,193,1381,391,17,9,15,67,198,28,95,0,0
2417,1308,192,1376,390,17,9,15,68,198,29,95,0,0
2418,1303,195,1374,403,17,9,15,71,208,30,95,0,0
2419,1302,200,1374,408,17,9,15,72,208,31,95,0,0
2420,1301,202,1372,404,17,9,15,71,202,32,95,0,0
2421,1297,202,1370,409,17,9,15,73,207,33,95,0,0
2422,1292,204,1368,420,17,9,15,76,216,34,95,0,0
2423,1285,202,1363,423,17,9,15,78,221,35,95,0,0
2424,1279,202,1358,427,17,9,15,79,225,36,95,0,0
2425,1277,207,1355,430,17,9,15,78,223,37,95,0,0
2426,1276,209,1354,431,17,9,15,78,222,38,95,0,0
2427,1274,212,1352,432,17,9,15,78,220,39,95,0,0
2428,1267,215,1348,438,17,9,15,81,223,40,95,0,0
2429,1262,215,1348,445,17,9,15,86,230,41,95,0,0
2430,1254,217,1341,451,17,9,15,87,234,42,95,0,0
2431,1248,219,1333,441,17,9,15,85,222,43,95,0,0
2432,1249,217,1325,410,17,9,15,76,193,44,95,0,0
2433,1241,214,1323,425,17,9,15,82,211,45,95,0,0
2434,1245,217,1322,415,17,9,15,77,198,46,95,0,0
2435,1244,218,1329,434,17,9,15,85,216,47,95,0,0
2436,1245,215,1334,442,17,9,15,89,227,48,95,0,0
2437,1246,217,1337,449,17,9,15,91,232,49,95,0,0
2438,1246,218,1338,453,17,9,15,92,235,50,95,0,0
2439,1245,218,1339,458,17,9,15,94,240,51,95,0,0
2440,1241,221,1333,456,17,9,15,92,235,52,95,0,0
2441,1236,222,1330,461,17,9,15,94,239,53,95,0,0
2442,1234,223,1330,470,17,9,15,96,247,54,95,0,0
2443,1236,227,1335,475,17,9,15,99,248,55,95,0,0
2444,1231,228,1333,481,17,9,15,102,253,56,95,0,0
2445,1222,232,1334,509,17,9,15,112,277,57,95,0,0
2446,1213,236,1334,538,17,9,15,121,302,58,95,0,0
2447,1206,237,1328,535,17,9,15,122,298,59,95,0,0
2448,1204,241,1324,535,17,9,15,120,294,60,95,0,0
2449,1200,243,1323,543,17,9,15,123,300,61,95,0,0
2450,1190,248,1321,567,17,9,15,131,319,62,95,0,0
2451,1179,256,1313,584,17,9,15,134,328,63,95,0,0
2452,1168,258,1300,578,17,9,15,132,320,64,95,0,0
2453,1159,263,1298,601,17,9,15,139,338,65,95,0,0
2454,1158,273,1298,613,17,9,15,140,340,66,95,0,0
2455,1154,277,1297,618,17,9,15,143,341,67,95,0,0
2456,1147,284,1296,638,17,9,15,149,354,68,95,0,0
2457,1139,291,1295,659,17,9,15,156,368,69,95,0,0
2458,1129,295,1290,669,17,9,15,161,374,70,95,0,0
2459,1131,307,1298,684,17,9,15,167,377,71,95,0,0
2460,1137,321,1310,707,17,9,15,173,386,72,95,0,0
2461,1139,328,1312,706,17,9,15,173,378,73,95,0,0
2462,1128,334,1322,755,17,9,15,194,421,74,95,0,0
2463,1119,345,1320,779,17,9,15,201,434,75,95,0,0
2464,1107,353,1312,790,17,9,15,205,437,76,95,0,0
2465,1104,366,1311,807,17,9,15,207,441,77,95,0,0
2466,1105,382,1319,841,17,9,15,214,459,78,95,0,0
2467,1106,392,1324,853,17,9,15,218,461,79,95,0,0
2468,1097,397,1326,876,17,9,15,229,479,80,95,0,0
2469,1081,416,1321,918,17,9,15,240,502,81,95,0,0
2470,1060,432,1307,947,17,9,15,247,515,82,95,0,0
2471,1034,445,1293,980,17,9,15,259,535,83,95,0,0
2472,1016,464,1297,1042,17,9,15,281,578,84,95,0,0
2473,1008,485,1294,1068,17,9,15,286,583,85,95,0,0
2474,995,503,1282,1080,17,9,15,287,577,86,95,0,0
2475,983,533,1263,1080,17,9,15,280,547,87,95,0,0
2476,954,561,1230,1080,17,9,15,276,519,88,95,0,0
2477,923,594,1197,1080,17,9,15,274,486,89,95,0,0
2478,916,643,1180,1080,17,9,15,264,437,90,95,0,0
2479,930,688,1191,1080,17,9,15,261,392,91,95,0,0
2480,916,729,1168,1080,17,9,15,252,351,92,95,0,0
2481,898,797,1119,1079,17,9,15,221,282,93,95,0,0
2482,866,861,1056,1080,17,9,15,190,219,94,95,0,0
2483,860,901,1022,1080,17,9,15,162,179,95,95,1,0
2421,1376,767,1591,1070,18,9,15,215,303,0,16,0,0
2422,1305,727,1546,1066,18,9,15,241,339,1,16,0,0
2423,1222,695,1487,1064,18,9,15,265,369,2,16,0,0
2424,1073,646,1379,1065,18,9,15,306,419,3,16,0,0
2425,938,595,1289,1069,18,9,15,351,474,4,16,0,0
2426,880,554,1263,1070,18,9,15,383,516,5,16,0,0
2427,876,508,1284,1064,18,9,15,408,556,6,16,0,0
2428,876,464,1311,1066,18,9,15,435,602,7,16,0,0
2429,886,439,1329,1066,18,9,15,443,627,8,16,0,0
2430,898,400,1354,1066,18,9,15,456,666,9,16,0,0
2431,946,371,1381,1031,18,9,15,435,660,10,16,0,0
2432,986,359,1401,1012,18,9,15,415,653,11,16,0,0
2433,1035,347,1416,965,18,9,15,381,618,12,16,0,0
2434,1098,332,1445,918,18,9,15,347,586,13,16,0,0
2435,1144,330,1465,891,18,9,15,321,561,14,16,0,0
2436,1196,312,1490,851,18,9,15,294,539,15,16,0,0
2437,1190,287,1489,833,18,9,15,299,546,16,16,0,0
2437,1338,381,1430,798,19,9,15,92,417,0,0,0,0
2898,1292,909,1455,1078,24,9,15,163,169,0,0,0,0
3933,1330,199,1440,504,28,9,15,110,305,0,44,0,1
3934,1331,203,1437,497,28,9,15,106,294,1,44,0,0
3935,1300,200,1406,494,28,9,15,106,294,2,44,0,0
3936,1272,200,1379,490,28,9,15,107,290,3,44,0,0
3937,1264,193,1367,473,28,9,15,103,280,4,44,0,0
3938,1236,188,1340,469,28,9,15,104,281,5,44,0,0
3939,1220,190,1319,460,28,9,15,99,270,6,44,0,0
3940,1205,183,1300,439,28,9,15,95,256,7,44,0,0
3941,1192,180,1288,435,28,9,15,96,255,8,44,0,0
3942,1186,180,1278,419,28,9,15,92,239,9,44,0,0
3943,1180,176,1268,407,28,9,15,88,231,10,44,0,0
3944,1174,173,1261,401,28,9,15,87,228,11,44,0,0
3945,1170,170,1255,395,28,9,15,85,225,12,44,0,0
3946,1166,163,1250,383,28,9,15,84,220,13,44,0,0
3947,1167,163,1249,378,28,9,15,82,215,14,44,0,0
3948,1167,159,1249,374,28,9,15,82,215,15,44,0,0
3949,1168,154,1248,367,28,9,15,80,213,16,44,0,0
3950,1169,156,1248,365,28,9,15,79,209,17,44,0,0
3951,1167,153,1244,358,28,9,15,77,205,18,44,0,0
3952,1167,147,1240,345,28,9,15,73,198,19,44,0,0
3953,1167,147,1239,343,28,9,15,72,196,20,44,0,0
3954,1171,149,1239,336,28,9,15,68,187,21,44,0,0
3955,1173,144,1241,330,28,9,15,68,186,22,44,0,0
3956,1173,141,1240,327,28,9,15,67,186,23,44,0,0
3957,1171,141,1236,319,28,9,15,65,178,24,44,0,0
3958,1170,141,1231,310,28,9,15,61,169,25,44,0,0
3959,1169,141,1230,308,28,9,15,61,167,26,44,0,0
3960,1172,139,1232,304,28,9,15,60,165,27,44,0,0
3961,1175,137,1235,300,28,9,15,60,163,28,44,0,0
3962,1176,137,1235,299,28,9,15,59,162,29,44,0,0
3963,1177,136,1237,298,28,9,15,60,162,30,44,0,0
3964,1179,133,1238,293,28,9,15,59,160,31,44,0,0
3965,1182,130,1242,293,28,9,15,60,163,32,44,0,0
3966,1188,127,1246,287,28,9,15,58,160,33,44,0,0
3967,1190,127,1247,280,28,9,15,57,153,34,44,0,0
3968,1192,127,1247,278,28,9,15,55,151,35,44,0,0
3969,1191,122,1247,274,28,9,15,56,152,36,44,0,0
3970,1190,121,1246,273,28,9,15,56,152,37,44,0,0
3971,1190,121,1245,275,28,9,15,55,154,38,44,0,0
3972,1187,121,1242,272,28,9,15,55,151,39,44,0,0
3973,1185,122,1237,265,28,9,15,52,143,40,44,0,0
3974,1178,120,1229,260,28,9,15,51,140,41,44,0,0
3975,1172,119,1220,253,28,9,15,48,134,42,44,0,0
3976,1168,125,1211,249,28,9,15,43,124,43,44,0,0
3977,1166,125,1208,245,28,9,15,42,120,44,44,1,0
4301,33,764,264,1077,29,9,15,231,313,0,17,0,0
4302,94,722,354,1077,29,9,15,260,355,1,17,0,0
4303,184,664,480,1069,29,9,15,296,405,2,17,0,0
4304,296,619,621,1067,29,9,15,325,448,3,17,0,0
4305,382,564,739,1065,29,9,15,357,501,4,17,0,0
4306,473,511,860,1065,29,9,15,387,554,5,17,0,0
4307,546,472,949,1061,29,9,15,403,589,6,17,0,0
4308,639,434,1031,1025,29,9,15,392,591,7,17,0,0
4309,735,421,1099,983,29,9,15,364,562,8,17,0,0
4310,823,388,1166,939,29,9,15,343,551,9,17,0,0
4311,888,370,1219,914,29,9,15,331,544,10,17,0,0
4312,960,347,1263,855,29,9,15,303,508,11,17,0,0
4313,1043,336,1318,810,29,9,15,275,474,12,17,0,0
4314,1103,340,1361,791,29,9,15,258,451,13,17,0,0
4315,1181,327,1423,762,29,9,15,242,435,14,17,0,0
4316,1229,323,1462,750,29,9,15,233,427,15,17,0,0
4317,1287,319,1495,722,29,9,15,208,403,16,17,0,0
4318,1353,300,1559,700,29,9,15,206,400,17,17,0,0
16,384,204,419,334,1,9,2,35,130,0,9,0,0
17,390,202,425,329,1,9,2,35,127,1,9,0,0
21,380,212,419,347,1,9,2,39,135,0,9,0,0
22,380,212,424,367,1,9,2,44,155,1,9,0,0
23,383,214,429,375,1,9,2,46,161,2,9,0,0
24,385,215,431,381,1,9,2,46,166,3,9,0,0
25,386,216,437,400,1,9,2,51,184,4,9,0,0
26,387,222,438,408,1,9,2,51,186,5,9,0,0
27,389,222,439,407,1,9,2,50,185,6,9,0,0
28,391,227,441,412,1,9,2,50,185,7,9,0,0
29,395,232,442,411,1,9,2,47,179,8,9,0,0
30,397,234,445,417,1,9,2,48,183,9,9,0,0
22,407,215,446,331,4,9,2,39,116,0,58,0,1
23,408,215,447,331,4,9,2,39,116,1,58,0,0
24,407,210,449,334,4,9,2,42,124,2,58,0,0
25,409,213,452,341,4,9,2,43,128,3,58,0,0
26,411,219,453,344,4,9,2,42,125,4,58,0,0
27,414,221,457,347,4,9,2,43,126,5,58,0,0
28,416,223,459,351,4,9,2,43,128,6,58,0,0
29,419,223,467,362,4,9,2,48,139,7,58,0,0
30,422,222,475,373,4,9,2,53,151,8,58,0,0
31,431,222,488,375,4,9,2,57,153,9,58,0,0
32,425,227,482,375,4,9,2,57,148,10,58,0,0
33,426,228,489,387,4,9,2,63,159,11,58,0,0
34,428,230,494,395,4,9,2,66,165,12,58,0,0
35,431,233,496,391,4,9,2,65,158,13,58,0,0
36,436,235,498,383,4,9,2,62,148,14,58,0,0
37,441,240,504,386,4,9,2,63,146,15,58,0,0
38,444,244,513,403,4,9,2,69,159,16,58,0,0
39,443,246,516,410,4,9,2,73,164,17,58,0,0
40,447,249,518,406,4,9,2,71,157,18,58,0,0
41,450,256,524,417,4,9,2,74,161,19,58,0,0
42,453,259,533,430,4,9,2,80,171,20,58,0,0
43,452,260,539,446,4,9,2,87,186,21,58,0,0
44,450,265,540,458,4,9,2,90,193,22,58,0,0
45,451,267,544,464,4,9,2,93,197,23,58,0,0
46,454,271,547,467,4,9,2,93,196,24,58,0,0
47,454,276,550,479,4,9,2,96,203,25,58,0,0
48,462,279,564,493,4,9,2,102,214,26,58,0,0
49,470,286,570,491,4,9,2,100,205,27,58,0,0
50,464,294,570,513,4,9,2,106,219,28,58,0,0
51,461,296,575,537,4,9,2,114,241,29,58,0,0
52,463,302,587,562,4,9,2,124,260,30,58,0,0
53,468,310,594,576,4,9,2,126,266,31,58,0,0
54,474,316,609,602,4,9,2,135,286,32,58,0,0
55,477,323,611,608,4,9,2,134,285,33,58,0,0
56,471,329,615,639,4,9,2,144,310,34,58,0,0
57,472,337,621,658,4,9,2,149,321,35,58,0,0
58,476,349,633,688,4,9,2,157,339,36,58,0,0
59,479,357,642,709,4,9,2,163,352,37,58,0,0
60,491,364,649,707,4,9,2,158,343,38,58,0,0
61,495,380,656,728,4,9,2,161,348,39,58,0,0
62,497,392,653,719,4,9,2,156,327,40,58,0,0
63,490,400,685,812,4,9,2,195,412,41,58,0,0
64,492,419,691,838,4,9,2,199,419,42,58,0,0
65,512,439,707,846,4,9,2,195,407,43,58,0,0
66,519,462,721,884,4,9,2,202,422,44,58,0,0
67,515,482,738,949,4,9,2,223,467,45,58,0,0
68,511,492,759,1013,4,9,2,248,521,46,58,0,0
69,514,505,776,1049,4,9,2,262,544,47,58,0,0
70,516,516,788,1071,4,9,2,272,555,48,58,0,0
71,510,536,790,1075,4,9,2,280,539,49,58,0,0
72,504,554,797,1078,4,9,2,293,524,50,58,0,0
73,483,585,773,1077,4,9,2,290,492,51,58,0,0
74,423,608,713,1079,4,9,2,290,471,52,58,0,0
75,373,635,664,1079,4,9,2,291,444,53,58,0,0
76,331,678,614,1080,4,9,2,283,402,54,58,0,0
77,258,720,517,1080,4,9,2,259,360,55,58,0,0
78,181,774,405,1075,4,9,2,224,301,56,58,0,0
79,87,824,286,1079,4,9,2,199,255,57,58,0,0
80,49,855,231,1080,4,9,2,182,225,58,58,1,0
57,552,448,666,671,5,9,2,114,223,0,0,0,0
61,824,360,876,475,6,9,2,52,115,0,0,0,0
64,827,360,875,472,7,9,2,48,112,0,0,0,0
221,821,354,880,480,11,9,2,59,126,0,5,0,0
222,820,353,881,481,11,9,2,61,128,1,5,0,0
223,821,354,879,478,11,9,2,58,124,2,5,0,0
224,821,354,879,478,11,9,2,58,124,3,5,0,0
225,820,353,880,480,11,9,2,60,127,4,5,0,0
226,820,353,880,480,11,9,2,60,127,5,5,0,0
331,822,357,877,476,17,9,2,55,119,0,1,0,0
332,822,357,876,476,17,9,2,54,119,1,1,0,0
625,0,677,149,1076,21,9,2,149,399,0,39,0,1
626,20,652,180,1079,21,9,2,160,427,1,39,0,0
627,42,634,210,1075,21,9,2,168,441,2,39,0,0
628,85,633,255,1073,21,9,2,170,440,3,39,0,0
629,129,637,302,1074,21,9,2,173,437,4,39,0,0
630,193,633,371,1072,21,9,2,178,439,5,39,0,0
631,243,630,424,1067,21,9,2,181,437,6,39,0,0
632,281,615,471,1070,21,9,2,190,455,7,39,0,0
633,312,606,509,1071,21,9,2,197,465,8,39,0,0
634,331,604,530,1068,21,9,2,199,464,9,39,0,0
635,341,611,541,1073,21,9,2,200,462,10,39,0,0
636,345,621,548,1076,21,9,2,203,455,11,39,0,0
637,360,636,563,1074,21,9,2,203,438,12,39,0,0
638,362,650,567,1072,21,9,2,205,422,13,39,0,0
639,359,660,569,1074,21,9,2,210,414,14,39,0,0
640,356,672,569,1073,21,9,2,213,401,15,39,0,0
641,353,678,571,1071,21,9,2,218,393,16,39,0,0
642,347,680,574,1075,21,9,2,227,395,17,39,0,0
643,344,681,576,1072,21,9,2,232,391,18,39,0,0
644,338,678,579,1074,21,9,2,241,396,19,39,0,0
645,331,674,580,1074,21,9,2,249,400,20,39,0,0
646,323,668,581,1075,21,9,2,258,407,21,39,0,0
647,319,660,585,1076,21,9,2,266,416,22,39,0,0
648,316,654,586,1074,21,9,2,270,420,23,39,0,0
649,313,651,587,1074,21,9,2,274,423,24,39,0,0
650,314,638,593,1071,21,9,2,279,433,25,39,0,0
651,310,626,595,1075,21,9,2,285,449,26,39,0,0
652,322,621,608,1078,21,9,2,286,457,27,39,0,0
653,347,621,624,1073,21,9,2,277,452,28,39,0,0
654,390,634,655,1072,21,9,2,265,438,29,39,0,0
655,445,649,701,1069,21,9,2,256,420,30,39,0,0
656,493,666,742,1069,21,9,2,249,403,31,39,0,0
657,566,683,812,1070,21,9,2,246,387,32,39,0,0
658,657,697,902,1064,21,9,2,245,367,33,39,0,0
659,733,720,981,1068,21,9,2,248,348,34,39,0,0
660,760,732,1014,1072,21,9,2,254,340,35,39,0,0
661,776,752,1028,1073,21,9,2,252,321,36,39,0,0
662,799,771,1049,1073,21,9,2,250,302,37,39,0,0
663,822,797,1065,1074,21,9,2,243,277,38,39,0,0
664,847,839,1073,1077,21,9,2,226,238,39,39,1,0
1411,1540,458,1688,617,22,9,2,148,159,0,5,0,0
1412,1540,457,1687,616,22,9,2,147,159,1,5,0,0
1413,1541,456,1686,612,22,9,2,145,156,2,5,0,0
1414,1541,457,1687,614,22,9,2,146,157,3,5,0,0
1415,1541,456,1688,615,22,9,2,147,159,4,5,0,0
1416,1541,456,1689,615,22,9,2,148,159,5,5,0,0
1879,1542,442,1686,643,23,9,2,144,201,0,1,0,0
1880,1543,440,1690,645,23,9,2,147,205,1,1,0,0
1888,1537,452,1690,634,24,9,2,153,182,0,3,0,0
1889,1534,449,1692,638,24,9,2,158,189,1,3,0,0
1890,1530,452,1690,643,24,9,2,160,191,2,3,0,0
1891,1528,453,1689,646,24,9,2,161,193,3,3,0,0
2040,0,524,519,1073,26,9,2,519,549,0,9,0,0
2041,0,519,489,1074,26,9,2,489,555,1,9,0,0
2042,0,527,448,1074,26,9,2,448,547,2,9,0,0
2043,0,547,417,1078,26,9,2,417,531,3,9,0,0
2044,0,560,414,1073,26,9,2,414,513,4,9,0,0
2045,0,576,405,1076,26,9,2,405,500,5,9,0,0
2046,0,584,409,1073,26,9,2,409,489,6,9,0,0
2047,0,578,419,1074,26,9,2,419,496,7,9,0,0
2048,0,579,419,1074,26,9,2,419,495,8,9,0,0
2049,0,566,401,1074,26,9,2,401,508,9,9,0,0
2052,5,573,248,1070,27,9,2,243,497,0,3,0,0
2053,4,569,248,1068,27,9,2,244,499,1,3,0,0
2054,0,561,244,1072,27,9,2,244,511,2,3,0,0
2055,0,558,243,1074,27,9,2,243,516,3,3,0,0
2663,0,810,95,1074,28,9,2,95,264,0,9,0,0
2664,0,695,120,1077,28,9,2,120,382,1,9,0,0
2665,0,690,118,1072,28,9,2,118,382,2,9,0,0
2666,0,693,120,1069,28,9,2,120,376,3,9,0,0
2667,0,691,120,1072,28,9,2,120,381,4,9,0,0
2668,2,696,98,967,28,9,2,96,271,5,9,0,0
2669,0,706,105,1020,28,9,2,105,314,6,9,0,0
2670,0,702,105,1015,28,9,2,105,313,7,9,0,0
2671,0,717,93,995,28,9,2,93,278,8,9,0,0
2672,0,716,91,988,28,9,2,91,272,9,9,0,0
2711,823,349,883,483,29,9,2,60,134,0,1,0,0
2712,823,351,883,484,29,9,2,60,133,1,1,0,0
2714,822,350,880,481,30,9,2,58,131,0,1,0,0
2715,822,350,879,480,30,9,2,57,130,1,1,0,0
3133,3,848,135,1080,31,9,2,132,232,0,0,0,0
3275,0,758,143,1080,32,9,2,143,322,0,3,0,0
3276,0,751,143,1080,32,9,2,143,329,1,3,0,0
3277,0,736,146,1080,32,9,2,146,344,2,3,0,0
3278,0,729,147,1080,32,9,2,147,351,3,3,0,0
3326,3,664,157,1080,33,9,2,154,416,0,41,0,1
3327,2,659,157,1080,33,9,2,155,421,1,41,0,0
3328,1,648,160,1080,33,9,2,159,432,2,41,0,0
3329,0,640,160,1080,33,9,2,160,440,3,41,0,0
3330,0,639,160,1080,33,9,2,160,441,4,41,0,0
3331,0,636,160,1080,33,9,2,160,444,5,41,0,0
3332,0,639,160,1080,33,9,2,160,441,6,41,0,0
3333,0,638,161,1080,33,9,2,161,442,7,41,0,0
3334,0,637,161,1080,33,9,2,161,443,8,41,0,0
3335,0,638,160,1080,33,9,2,160,442,9,41,0,0
3336,2,644,161,1080,33,9,2,159,436,10,41,0,0
3337,3,647,161,1080,33,9,2,158,433,11,41,0,0
3338,3,647,161,1080,33,9,2,158,433,12,41,0,0
3339,4,649,161,1079,33,9,2,157,430,13,41,0,0
3340,3,649,161,1079,33,9,2,158,430,14,41,0,0
3341,0,641,158,1078,33,9,2,158,437,15,41,0,0
3342,0,639,157,1078,33,9,2,157,439,16,41,0,0
3343,0,637,156,1078,33,9,2,156,441,17,41,0,0
3344,0,634,157,1078,33,9,2,157,444,18,41,0,0
3345,0,634,156,1078,33,9,2,156,444,19,41,0,0
3346,0,635,155,1079,33,9,2,155,444,20,41,0,0
3347,0,635,155,1079,33,9,2,155,444,21,41,0,0
3348,0,634,154,1079,33,9,2,154,445,22,41,0,0
3349,0,634,154,1080,33,9,2,154,446,23,41,0,0
3350,0,634,153,1080,33,9,2,153,446,24,41,0,0
3351,1,637,156,1080,33,9,2,155,443,25,41,0,0
3352,1,636,156,1080,33,9,2,155,444,26,41,0,0
3356,2,638,154,1078,33,9,2,152,440,0,41,0,1
3357,1,637,153,1079,33,9,2,152,442,1,41,0,0
3358,0,640,141,1079,33,9,2,141,439,2,41,0,0
3359,0,640,134,1074,33,9,2,134,434,3,41,0,0
3360,0,641,132,1078,33,9,2,132,437,4,41,0,0
3361,0,635,144,1079,33,9,2,144,444,5,41,0,0
3362,3,634,149,1079,33,9,2,146,445,6,41,0,0
3363,3,633,151,1079,33,9,2,148,446,7,41,0,0
3364,4,633,152,1080,33,9,2,148,447,8,41,0,0
3365,4,633,152,1080,33,9,2,148,447,9,41,0,0
3366,0,636,145,1080,33,9,2,145,444,10,41,0,0
3367,3,637,151,1079,33,9,2,148,442,11,41,0,0
3368,0,638,144,1079,33,9,2,144,441,12,41,0,0
3369,0,638,142,1079,33,9,2,142,441,13,41,0,0
3370,3,637,150,1079,33,9,2,147,442,14,41,0,0
3371,7,643,153,1078,33,9,2,146,435,15,41,0,0
3372,8,644,155,1078,33,9,2,147,434,16,41,0,0
3373,7,643,156,1078,33,9,2,149,435,17,41,0,0
3374,8,644,158,1078,33,9,2,150,434,18,41,0,0
3375,7,644,158,1078,33,9,2,151,434,19,41,0,0
3376,5,644,157,1079,33,9,2,152,435,20,41,0,0
3377,4,645,156,1079,33,9,2,152,434,21,41,0,0
3378,3,645,156,1079,33,9,2,153,434,22,41,0,0
3379,3,644,156,1080,33,9,2,153,436,23,41,0,0
3380,3,645,156,1080,33,9,2,153,435,24,41,0,0
3381,2,647,153,1079,33,9,2,151,432,25,41,0,0
3382,1,648,153,1079,33,9,2,152,431,26,41,0,0
3383,1,649,152,1079,33,9,2,151,430,27,41,0,0
3384,0,648,152,1079,33,9,2,152,431,28,41,0,0
3385,0,646,152,1078,33,9,2,152,432,29,41,0,0
3386,3,641,157,1078,33,9,2,154,437,30,41,0,0
3387,4,639,160,1078,33,9,2,156,439,31,41,0,0
3388,4,639,160,1079,33,9,2,156,440,32,41,0,0
3389,4,638,161,1079,33,9,2,157,441,33,41,0,0
3390,3,638,160,1079,33,9,2,157,441,34,41,0,0
3391,0,654,143,1079,33,9,2,143,425,35,41,0,0
3392,0,659,136,1079,33,9,2,136,420,36,41,0,0
3393,0,645,146,1079,33,9,2,146,434,37,41,0,0
3394,0,640,150,1079,33,9,2,150,439,38,41,0,0
3395,0,637,152,1079,33,9,2,152,442,39,41,0,0
3396,3,638,156,1080,33,9,2,153,442,40,41,0,0
3397,3,638,156,1080,33,9,2,153,442,41,41,1,0
3400,4,643,157,1080,33,9,2,153,437,0,41,0,0
3401,5,643,157,1080,33,9,2,152,437,1,41,0,0
3402,7,646,159,1080,33,9,2,152,434,2,41,0,0
3403,7,647,160,1080,33,9,2,153,433,3,41,0,0
3407,2,645,156,1080,33,9,2,154,435,0,41,0,1
3408,2,645,155,1080,33,9,2,153,435,1,41,0,0
3409,1,642,155,1080,33,9,2,154,438,2,41,0,0
3410,0,640,154,1080,33,9,2,154,440,3,41,0,0
3411,1,639,155,1080,33,9,2,154,441,4,41,0,0
3412,1,639,154,1080,33,9,2,153,441,5,41,0,0
3413,1,638,155,1080,33,9,2,154,442,6,41,0,0
3414,1,638,155,1080,33,9,2,154,442,7,41,0,0
3415,1,638,155,1080,33,9,2,154,442,8,41,0,0
3416,3,645,155,1079,33,9,2,152,434,9,41,0,0
3417,4,648,155,1079,33,9,2,151,431,10,41,0,0
3418,4,644,157,1079,33,9,2,153,435,11,41,0,0
3419,3,647,157,1078,33,9,2,154,431,12,41,0,0
3420,3,647,156,1078,33,9,2,153,431,13,41,0,0
3421,1,642,157,1079,33,9,2,156,437,14,41,0,0
3422,1,640,157,1079,33,9,2,156,439,15,41,0,0
3423,0,639,157,1079,33,9,2,157,440,16,41,0,0
3424,0,638,157,1080,33,9,2,157,442,17,41,0,0
3425,0,638,156,1080,33,9,2,156,442,18,41,0,0
3426,0,641,154,1080,33,9,2,154,439,19,41,0,0
3427,0,651,140,1080,33,9,2,140,429,20,41,0,0
3428,0,657,135,1080,33,9,2,135,423,21,41,0,0
3429,0,658,133,1080,33,9,2,133,422,22,41,0,0
3430,0,660,131,1080,33,9,2,131,420,23,41,0,0
3431,0,649,141,1080,33,9,2,141,431,24,41,0,0
3432,2,650,145,1080,33,9,2,143,430,25,41,0,0
3433,2,650,145,1080,33,9,2,143,430,26,41,0,0
3497,2,589,168,1080,34,9,2,166,491,0,117,0,0
3498,0,648,133,1066,34,9,2,133,418,1,117,0,0
3499,0,690,122,1072,34,9,2,122,382,2,117,0,0
3500,0,726,104,1048,34,9,2,104,322,3,117,0,0
3501,0,757,91,1039,34,9,2,91,282,4,117,0,0
3509,24,739,144,1079,34,9,2,120,340,0,117,0,0
3510,15,739,127,1052,34,9,2,112,313,1,117,0,0
3511,10,738,121,1045,34,9,2,111,307,2,117,0,0
3512,13,741,123,1045,34,9,2,110,304,3,117,0,0
3527,0,642,146,1055,34,9,2,146,413,0,117,0,0
3528,0,664,121,1053,34,9,2,121,389,1,117,0,0
3529,0,642,118,1070,34,9,2,118,428,2,117,0,0
3530,0,611,117,1076,34,9,2,117,465,3,117,0,0
3531,0,604,118,1078,34,9,2,118,474,4,117,0,0
3533,0,572,120,1080,34,9,2,120,508,0,117,0,0
3534,0,579,114,1080,34,9,2,114,501,1,117,0,0
3535,0,572,114,1080,34,9,2,114,508,2,117,0,0
3557,0,555,120,1063,34,9,2,120,508,0,117,0,1
3558,0,564,113,1039,34,9,2,113,475,1,117,0,0
3559,11,568,130,1026,34,9,2,119,458,2,117,0,0
3560,17,589,134,1016,34,9,2,117,427,3,117,0,0
3561,36,621,153,1003,34,9,2,117,382,4,117,0,0
3562,63,628,185,1009,34,9,2,122,381,5,117,0,0
3563,50,623,195,1050,34,9,2,145,427,6,117,0,0
3564,48,638,201,1064,34,9,2,153,426,7,117,0,0
3565,53,648,210,1064,34,9,2,157,416,8,117,0,0
3566,46,633,217,1066,34,9,2,171,433,9,117,0,0
3567,33,595,227,1076,34,9,2,194,481,10,117,0,0
3568,61,555,264,1075,34,9,2,203,520,11,117,0,0
3569,83,530,300,1076,34,9,2,217,546,12,117,0,0
3570,102,493,332,1077,34,9,2,230,584,13,117,0,0
3571,124,470,361,1072,34,9,2,237,602,14,117,0,0
3572,174,467,417,1065,34,9,2,243,598,15,117,0,0
3573,209,453,457,1063,34,9,2,248,610,16,117,0,0
3574,262,438,511,1045,34,9,2,249,607,17,117,0,0
3575,305,423,558,1042,34,9,2,253,619,18,117,0,0
3576,341,406,594,1030,34,9,2,253,624,19,117,0,0
3577,381,393,609,953,34,9,2,228,560,20,117,0,0
3578,410,386,631,926,34,9,2,221,540,21,117,0,0
3579,433,377,647,893,34,9,2,214,516,22,117,0,0
3580,440,360,650,867,34,9,2,210,507,23,117,0,0
3581,445,344,644,826,34,9,2,199,482,24,117,0,0
3582,448,338,645,821,34,9,2,197,483,25,117,0,0
3583,451,332,640,803,34,9,2,189,471,26,117,0,0
3584,457,322,635,768,34,9,2,178,446,27,117,0,0
3585,456,315,630,750,34,9,2,174,435,28,117,0,0
3586,454,305,625,738,34,9,2,171,433,29,117,0,0
3587,454,295,612,697,34,9,2,158,402,30,117,0,0
3588,451,288,601,673,34,9,2,150,385,31,117,0,0
3589,448,283,594,658,34,9,2,146,375,32,117,0,0
3590,451,269,592,625,34,9,2,141,356,33,117,0,0
3591,452,266,589,608,34,9,2,137,342,34,117,0,0
3592,447,265,583,602,34,9,2,136,337,35,117,0,0
3593,442,255,573,581,34,9,2,131,326,36,117,0,0
3594,440,250,566,566,34,9,2,126,316,37,117,0,0
3595,435,243,561,563,34,9,2,126,320,38,117,0,0
3596,438,238,558,544,34,9,2,120,306,39,117,0,0
3597,442,237,556,527,34,9,2,114,290,40,117,0,0
3598,442,231,555,519,34,9,2,113,288,41,117,0,0
3599,442,226,551,506,34,9,2,109,280,42,117,0,0
3600,442,224,546,495,34,9,2,104,271,43,117,0,0
3601,444,222,545,490,34,9,2,101,268,44,117,0,0
3602,445,217,543,481,34,9,2,98,264,45,117,0,0
3603,447,220,540,476,34,9,2,93,256,46,117,0,0
3604,447,228,532,465,34,9,2,85,237,47,117,0,0
3605,447,222,532,456,34,9,2,85,234,48,117,0,0
3606,451,219,532,445,34,9,2,81,226,49,117,0,0
3607,452,228,525,438,34,9,2,73,210,50,117,0,0
3608,448,222,519,430,34,9,2,71,208,51,117,0,0
3609,439,210,513,429,34,9,2,74,219,52,117,0,0
3610,435,211,508,430,34,9,2,73,219,53,117,0,0
3611,435,209,505,419,34,9,2,70,210,54,117,0,0
3612,436,210,500,403,34,9,2,64,193,55,117,0,0
3613,431,203,496,400,34,9,2,65,197,56,117,0,0
3614,427,196,494,401,34,9,2,67,205,57,117,0,0
3615,423,199,486,395,34,9,2,63,196,58,117,0,0
3616,423,204,482,390,34,9,2,59,186,59,117,0,0
3617,422,206,477,379,34,9,2,55,173,60,117,0,0
3618,418,205,473,375,34,9,2,55,170,61,117,0,0
3619,415,198,472,378,34,9,2,57,180,62,117,0,0
3620,412,190,469,372,34,9,2,57,182,63,117,0,0
3621,407,186,463,367,34,9,2,56,181,64,117,0,0
3622,405,181,463,367,34,9,2,58,186,65,117,0,0
3623,403,182,459,360,34,9,2,56,178,66,117,0,0
3624,403,182,457,355,34,9,2,54,173,67,117,0,0
3625,402,182,455,354,34,9,2,53,172,68,117,0,0
3626,401,179,453,349,34,9,2,52,170,69,117,0,0
3627,399,177,451,350,34,9,2,52,173,70,117,0,0
3628,397,179,449,350,34,9,2,52,171,71,117,0,0
3629,397,172,450,345,34,9,2,53,173,72,117,0,0
3630,399,174,449,336,34,9,2,50,162,73,117,0,0
3631,397,176,445,334,34,9,2,48,158,74,117,0,0
3632,396,175,443,331,34,9,2,47,156,75,117,0,0
3633,394,174,440,326,34,9,2,46,152,76,117,0,0
3634,392,175,437,322,34,9,2,45,147,77,117,0,0
3635,390,172,435,320,34,9,2,45,148,78,117,0,0
3636,388,173,432,317,34,9,2,44,144,79,117,0,0
3637,385,174,429,317,34,9,2,44,143,80,117,0,0
3638,384,172,427,315,34,9,2,43,143,81,117,0,0
3639,382,170,425,314,34,9,2,43,144,82,117,0,0
3640,380,171,422,313,34,9,2,42,142,83,117,0,0
3641,380,169,421,305,34,9,2,41,136,84,117,0,0
3642,378,170,418,302,34,9,2,40,132,85,117,0,0
3643,376,171,414,299,34,9,2,38,128,86,117,0,0
3644,374,167,414,300,34,9,2,40,133,87,117,0,0
3645,369,160,410,295,34,9,2,41,135,88,117,0,0
3646,366,163,405,290,34,9,2,39,127,89,117,0,0
3647,364,161,403,287,34,9,2,39,126,90,117,0,0
3648,361,155,403,288,34,9,2,42,133,91,117,0,0
3649,360,156,401,286,34,9,2,41,130,92,117,0,0
3650,359,155,399,283,34,9,2,40,128,93,117,0,0
3651,357,152,398,280,34,9,2,41,128,94,117,0,0
3652,357,150,397,277,34,9,2,40,127,95,117,0,0
3653,356,149,397,278,34,9,2,41,129,96,117,0,0
3654,356,147,398,278,34,9,2,42,131,97,117,0,0
3655,355,150,396,276,34,9,2,41,126,98,117,0,0
3656,354,149,395,274,34,9,2,41,125,99,117,0,0
3657,352,149,392,272,34,9,2,40,123,100,117,0,0
3658,351,148,391,268,34,9,2,40,120,101,117,0,0
3659,351,149,391,267,34,9,2,40,118,102,117,0,0
3660,350,148,390,266,34,9,2,40,118,103,117,0,0
3661,349,150,388,266,34,9,2,39,116,104,117,0,0
3662,347,150,386,265,34,9,2,39,115,105,117,0,0
3663,345,147,385,263,34,9,2,40,116,106,117,0,0
3664,343,147,382,257,34,9,2,39,110,107,117,0,0
3665,340,149,378,251,34,9,2,38,102,108,117,0,0
3666,339,151,375,249,34,9,2,36,98,109,117,0,0
3667,335,152,372,252,34,9,2,37,100,110,117,0,0
3668,331,146,369,252,34,9,2,38,106,111,117,0,0
3669,328,146,366,250,34,9,2,38,104,112,117,0,0
3670,327,143,366,251,34,9,2,39,108,113,117,0,0
3671,325,144,363,250,34,9,2,38,106,114,117,0,0
3672,325,139,364,249,34,9,2,39,110,115,117,0,0
3673,325,140,364,248,34,9,2,39,108,116,117,0,0
3674,328,141,365,245,34,9,2,37,104,117,117,1,0
3526,259,197,308,475,35,9,2,49,278,0,27,0,1
3527,263,216,311,485,35,9,2,48,269,1,27,0,0
3528,272,216,321,491,35,9,2,49,275,2,27,0,0
3529,289,218,342,503,35,9,2,53,285,3,27,0,0
3530,297,220,355,518,35,9,2,58,298,4,27,0,0
3531,300,223,362,526,35,9,2,62,303,5,27,0,0
3532,305,231,371,543,35,9,2,66,312,6,27,0,0
3533,313,233,385,557,35,9,2,72,324,7,27,0,0
3534,317,236,398,586,35,9,2,81,350,8,27,0,0
3535,323,245,411,612,35,9,2,88,367,9,27,0,0
3536,326,249,420,625,35,9,2,94,376,10,27,0,0
3537,331,258,432,652,35,9,2,101,394,11,27,0,0
3538,340,267,449,677,35,9,2,109,410,12,27,0,0
3539,352,272,474,717,35,9,2,122,445,13,27,0,0
3540,357,285,490,761,35,9,2,133,476,14,27,0,0
3541,355,294,495,781,35,9,2,140,487,15,27,0,0
3542,352,307,502,811,35,9,2,150,504,16,27,0,0
3543,353,325,513,848,35,9,2,160,523,17,27,0,0
3544,349,332,522,883,35,9,2,173,551,18,27,0,0
3545,334,354,520,938,35,9,2,186,584,19,27,0,0
3546,308,379,502,987,35,9,2,194,608,20,27,0,0
3547,274,395,483,1047,35,9,2,209,652,21,27,0,0
3548,245,427,455,1074,35,9,2,210,647,22,27,0,0
3549,212,457,418,1075,35,9,2,206,618,23,27,0,0
3550,173,493,377,1079,35,9,2,204,586,24,27,0,0
3551,113,558,308,1080,35,9,2,195,522,25,27,0,0
3552,59,614,240,1080,35,9,2,181,466,26,27,0,0
3553,41,639,221,1080,35,9,2,180,441,27,27,1,0
3588,821,352,880,482,36,9,2,59,130,0,3,0,0
3589,819,351,879,482,36,9,2,60,131,1,3,0,0
3590,820,352,879,481,36,9,2,59,129,2,3,0,0
3591,820,352,878,480,36,9,2,58,128,3,3,0,0
3657,8,615,222,1070,38,9,2,214,455,0,35,0,1
3658,56,560,298,1071,38,9,2,242,511,1,35,0,0
3659,87,518,350,1067,38,9,2,263,549,2,35,0,0
3660,105,463,394,1069,38,9,2,289,606,3,35,0,0
3661,163,431,459,1055,38,9,2,296,624,4,35,0,0
3662,209,402,516,1057,38,9,2,307,655,5,35,0,0
3663,265,370,563,1008,38,9,2,298,638,6,35,0,0
3664,295,348,596,995,38,9,2,301,647,7,35,0,0
3665,311,327,586,925,38,9,2,275,598,8,35,0,0
3666,307,311,560,870,38,9,2,253,559,9,35,0,0
3667,307,300,546,839,38,9,2,239,539,10,35,0,0
3668,327,287,540,775,38,9,2,213,488,11,35,0,0
3669,326,276,525,740,38,9,2,199,464,12,35,0,0
3670,323,271,503,695,38,9,2,180,424,13,35,0,0
3671,314,259,487,672,38,9,2,173,413,14,35,0,0
3672,301,252,469,664,38,9,2,168,412,15,35,0,0
3673,300,245,453,624,38,9,2,153,379,16,35,0,0
3674,297,235,441,599,38,9,2,144,364,17,35,0,0
3675,286,231,423,583,38,9,2,137,352,18,35,0,0
3676,274,224,406,569,38,9,2,132,345,19,35,0,0
3677,266,222,393,561,38,9,2,127,339,20,35,0,0
3678,264,223,383,544,38,9,2,119,321,21,35,0,0
3679,263,215,374,519,38,9,2,111,304,22,35,0,0
3680,255,215,356,497,38,9,2,101,282,23,35,0,0
3681,248,215,345,493,38,9,2,97,278,24,35,0,0
3682,239,212,330,483,38,9,2,91,271,25,35,0,0
3683,237,219,319,478,38,9,2,82,259,26,35,0,0
3684,237,222,313,476,38,9,2,76,254,27,35,0,0
3685,240,226,310,473,38,9,2,70,247,28,35,0,0
3686,242,221,310,475,38,9,2,68,254,29,35,0,0
3687,243,211,311,473,38,9,2,68,262,30,35,0,0
3688,244,211,309,474,38,9,2,65,263,31,35,0,0
3689,247,218,308,474,38,9,2,61,256,32,35,0,0
3690,250,229,307,475,38,9,2,57,246,33,35,0,0
3691,251,237,304,469,38,9,2,53,232,34,35,0,0
3692,250,238,300,463,38,9,2,50,225,35,35,1,0
3790,261,218,321,481,43,9,2,60,263,0,24,0,1
3791,268,218,332,499,43,9,2,64,281,1,24,0,0
3792,275,215,342,502,43,9,2,67,287,2,24,0,0
3793,280,217,352,526,43,9,2,72,309,3,24,0,0
3794,286,225,363,548,43,9,2,77,323,4,24,0,0
3795,294,230,374,556,43,9,2,80,326,5,24,0,0
3796,301,237,386,575,43,9,2,85,338,6,24,0,0
3797,309,238,400,590,43,9,2,91,352,7,24,0,0
3798,312,244,410,619,43,9,2,98,375,8,24,0,0
3799,313,257,416,650,43,9,2,103,393,9,24,0,0
3800,312,261,422,668,43,9,2,110,407,10,24,0,0
3801,315,271,429,681,43,9,2,114,410,11,24,0,0
3802,322,279,447,722,43,9,2,125,443,12,24,0,0
3803,322,284,460,768,43,9,2,138,484,13,24,0,0
3804,323,301,468,808,43,9,2,145,507,14,24,0,0
3805,320,311,473,837,43,9,2,153,526,15,24,0,0
3806,314,327,479,883,43,9,2,165,556,16,24,0,0
3807,302,347,479,940,43,9,2,177,593,17,24,0,0
3808,294,365,477,973,43,9,2,183,608,18,24,0,0
3809,265,394,467,1047,43,9,2,202,653,19,24,0,0
3810,220,426,428,1074,43,9,2,208,648,20,24,0,0
3811,158,454,366,1080,43,9,2,208,626,21,24,0,0
3812,112,509,314,1080,43,9,2,202,571,22,24,0,0
3813,53,560,245,1080,43,9,2,192,520,23,24,0,0
3814,37,580,230,1080,43,9,2,193,500,24,24,1,0
3901,5,610,241,1071,44,9,2,236,461,0,35,0,1
3902,13,568,271,1073,44,9,2,258,505,1,35,0,0
3903,16,522,297,1071,44,9,2,281,549,2,35,0,0
3904,66,473,371,1071,44,9,2,305,598,3,35,0,0
3905,134,444,451,1065,44,9,2,317,621,4,35,0,0
3906,191,409,509,1040,44,9,2,318,631,5,35,0,0
3907,244,378,569,1030,44,9,2,325,652,6,35,0,0
3908,276,350,592,993,44,9,2,316,643,7,35,0,0
3909,299,327,587,920,44,9,2,288,593,8,35,0,0
3910,308,317,580,891,44,9,2,272,574,9,35,0,0
3911,334,306,577,829,44,9,2,243,523,10,35,0,0
3912,346,290,572,784,44,9,2,226,494,11,35,0,0
3913,344,280,557,758,44,9,2,213,478,12,35,0,0
3914,340,270,534,711,44,9,2,194,441,13,35,0,0
3915,328,262,512,691,44,9,2,184,429,14,35,0,0
3916,325,258,498,673,44,9,2,173,415,15,35,0,0
3917,329,248,486,630,44,9,2,157,382,16,35,0,0
3918,321,242,469,610,44,9,2,148,368,17,35,0,0
3919,313,240,450,584,44,9,2,137,344,18,35,0,0
3920,298,231,430,569,44,9,2,132,338,19,35,0,0
3921,290,231,415,558,44,9,2,125,327,20,35,0,0
3922,283,226,400,535,44,9,2,117,309,21,35,0,0
3923,271,220,381,513,44,9,2,110,293,22,35,0,0
3924,261,217,369,509,44,9,2,108,292,23,35,0,0
3925,248,216,348,492,44,9,2,100,276,24,35,0,0
3926,240,215,334,486,44,9,2,94,271,25,35,0,0
3927,237,225,323,486,44,9,2,86,261,26,35,0,0
3928,240,230,316,475,44,9,2,76,245,27,35,0,0
3929,239,228,313,478,44,9,2,74,250,28,35,0,0
3930,241,229,311,473,44,9,2,70,244,29,35,0,0
3931,244,229,310,471,44,9,2,66,242,30,35,0,0
3932,245,223,309,468,44,9,2,64,245,31,35,0,0
3933,246,223,308,467,44,9,2,62,244,32,35,0,0
3934,249,227,308,469,44,9,2,59,242,33,35,0,0
3935,250,234,304,467,44,9,2,54,233,34,35,0,0
3936,248,234,301,460,44,9,2,53,226,35,35,1,0
4048,820,362,878,480,45,9,2,58,118,0,0,0,0
4216,1009,714,1273,1066,48,9,2,264,352,0,90,0,1
4217,922,674,1219,1072,48,9,2,297,398,1,90,0,0
4218,813,635,1137,1071,48,9,2,324,436,2,90,0,0
4219,707,578,1074,1075,48,9,2,367,497,3,90,0,0
4220,638,533,1030,1070,48,9,2,392,537,4,90,0,0
4221,591,497,1001,1068,48,9,2,410,571,5,90,0,0
4222,531,462,959,1075,48,9,2,428,613,6,90,0,0
4223,499,446,920,1070,48,9,2,421,624,7,90,0,0
4224,470,415,873,1031,48,9,2,403,616,8,90,0,0
4225,454,386,838,992,48,9,2,384,606,9,90,0,0
4226,449,381,814,969,48,9,2,365,588,10,90,0,0
4227,445,371,769,912,48,9,2,324,541,11,90,0,0
4228,441,335,745,864,48,9,2,304,529,12,90,0,0
4229,435,329,715,833,48,9,2,280,504,13,90,0,0
4230,429,313,686,793,48,9,2,257,480,14,90,0,0
4231,422,304,663,769,48,9,2,241,465,15,90,0,0
4232,415,296,646,756,48,9,2,231,460,16,90,0,0
4233,412,284,623,717,48,9,2,211,433,17,90,0,0
4234,411,278,601,682,48,9,2,190,404,18,90,0,0
4235,407,279,586,669,48,9,2,179,390,19,90,0,0
4236,396,273,562,640,48,9,2,166,367,20,90,0,0
4237,388,269,547,629,48,9,2,159,360,21,90,0,0
4238,385,270,538,620,48,9,2,153,350,22,90,0,0
4239,381,258,524,591,48,9,2,143,333,23,90,0,0
4240,376,248,516,583,48,9,2,140,335,24,90,0,0
4241,370,242,505,572,48,9,2,135,330,25,90,0,0
4242,370,238,497,552,48,9,2,127,314,26,90,0,0
4243,371,236,493,541,48,9,2,122,305,27,90,0,0
4244,373,230,491,530,48,9,2,118,300,28,90,0,0
4245,375,223,485,508,48,9,2,110,285,29,90,0,0
4246,377,223,482,498,48,9,2,105,275,30,90,0,0
4247,377,223,475,484,48,9,2,98,261,31,90,0,0
4248,374,216,469,471,48,9,2,95,255,32,90,0,0
4249,374,215,468,466,48,9,2,94,251,33,90,0,0
4250,379,215,469,456,48,9,2,90,241,34,90,0,0
4251,380,208,469,446,48,9,2,89,238,35,90,0,0
4252,383,207,469,441,48,9,2,86,234,36,90,0,0
4253,380,205,464,435,48,9,2,84,230,37,90,0,0
4254,378,199,461,427,48,9,2,83,228,38,90,0,0
4255,376,197,458,424,48,9,2,82,227,39,90,0,0
4256,378,196,457,417,48,9,2,79,221,40,90,0,0
4257,381,193,457,408,48,9,2,76,215,41,90,0,0
4258,383,196,454,400,48,9,2,71,204,42,90,0,0
4259,379,195,449,396,48,9,2,70,201,43,90,0,0
4260,376,190,446,391,48,9,2,70,201,44,90,0,0
4261,374,189,443,389,48,9,2,69,200,45,90,0,0
4262,376,186,443,383,48,9,2,67,197,46,90,0,0
4263,377,182,441,374,48,9,2,64,192,47,90,0,0
4264,378,184,439,367,48,9,2,61,183,48,90,0,0
4265,375,184,435,364,48,9,2,60,180,49,90,0,0
4266,372,178,433,360,48,9,2,61,182,50,90,0,0
4267,371,177,431,359,48,9,2,60,182,51,90,0,0
4268,373,175,431,352,48,9,2,58,177,52,90,0,0
4269,374,173,430,345,48,9,2,56,172,53,90,0,0
4270,375,175,429,343,48,9,2,54,168,54,90,0,0
4271,375,173,428,338,48,9,2,53,165,55,90,0,0
4272,375,174,429,338,48,9,2,54,164,56,90,0,0
4273,376,175,430,334,48,9,2,54,159,57,90,0,0
4274,378,173,431,330,48,9,2,53,157,58,90,0,0
4275,381,172,432,325,48,9,2,51,153,59,90,0,0
4276,382,171,433,322,48,9,2,51,151,60,90,0,0
4277,382,172,432,319,48,9,2,50,147,61,90,0,0
4278,382,175,431,317,48,9,2,49,142,62,90,0,0
4279,382,176,430,315,48,9,2,48,139,63,90,0,0
4280,381,172,430,316,48,9,2,49,144,64,90,0,0
4281,382,169,430,307,48,9,2,48,138,65,90,0,0
4282,383,170,430,306,48,9,2,47,136,66,90,0,0
4283,382,166,428,302,48,9,2,46,136,67,90,0,0
4284,380,159,427,297,48,9,2,47,138,68,90,0,0
4285,379,159,425,296,48,9,2,46,137,69,90,0,0
4286,376,158,423,295,48,9,2,47,137,70,90,0,0
4287,375,155,422,292,48,9,2,47,137,71,90,0,0
4288,375,156,421,291,48,9,2,46,135,72,90,0,0
4289,373,155,420,292,48,9,2,47,137,73,90,0,0
4290,373,153,419,289,48,9,2,46,136,74,90,0,0
4291,372,154,417,286,48,9,2,45,132,75,90,0,0
4292,372,153,416,283,48,9,2,44,130,76,90,0,0
4293,371,152,415,281,48,9,2,44,129,77,90,0,0
4294,369,153,413,281,48,9,2,44,128,78,90,0,0
4295,367,153,410,278,48,9,2,43,125,79,90,0,0
4296,366,150,408,272,48,9,2,42,122,80,90,0,0
4297,365,151,404,265,48,9,2,39,114,81,90,0,0
4298,363,149,403,266,48,9,2,40,117,82,90,0,0
4299,362,150,401,263,48,9,2,39,113,83,90,0,0
4300,362,151,399,261,48,9,2,37,110,84,90,0,0
4301,360,151,397,261,48,9,2,37,110,85,90,0,0
4302,359,151,395,257,48,9,2,36,106,86,90,0,0
4303,357,151,393,256,48,9,2,36,105,87,90,0,0
4304,358,151,394,255,48,9,2,36,104,88,90,0,0
4305,360,151,395,253,48,9,2,35,102,89,90,0,0
4306,360,151,396,255,48,9,2,36,104,90,90,1,0
4308,359,149,394,250,48,9,2,35,101,0,90,0,0
4309,358,149,393,249,48,9,2,35,100,1,90,0,0
4310,359,149,394,249,48,9,2,35,100,2,90,0,0
4311,357,148,393,250,48,9,2,36,102,3,90,0,0
4312,355,148,391,251,48,9,2,36,103,4,90,0,0
4313,353,147,388,248,48,9,2,35,101,5,90,0,0
4314,353,146,388,249,48,9,2,35,103,6,90,0,0
98,80,504,642,1071,1,9,3,562,567,0,32,0,1
99,118,535,632,1066,1,9,3,514,531,1,32,0,0
100,141,542,643,1071,1,9,3,502,529,2,32,0,0
101,152,541,647,1073,1,9,3,495,532,3,32,0,0
102,151,528,641,1067,1,9,3,490,539,4,32,0,0
103,164,509,648,1061,1,9,3,484,552,5,32,0,0
104,183,499,656,1062,1,9,3,473,563,6,32,0,0
105,204,494,661,1062,1,9,3,457,568,7,32,0,0
106,213,495,653,1062,1,9,3,440,567,8,32,0,0
107,221,501,645,1064,1,9,3,424,563,9,32,0,0
108,235,506,642,1065,1,9,3,407,559,10,32,0,0
109,235,509,631,1066,1,9,3,396,557,11,32,0,0
110,243,512,627,1065,1,9,3,384,553,12,32,0,0
111,268,511,641,1068,1,9,3,373,557,13,32,0,0
112,268,508,632,1065,1,9,3,364,557,14,32,0,0
113,278,504,636,1063,1,9,3,358,559,15,32,0,0
114,286,502,642,1067,1,9,3,356,565,16,32,0,0
115,314,500,662,1069,1,9,3,348,569,17,32,0,0
116,347,507,681,1071,1,9,3,334,564,18,32,0,0
117,369,518,689,1071,1,9,3,320,553,19,32,0,0
118,392,527,701,1075,1,9,3,309,548,20,32,0,0
119,420,546,711,1069,1,9,3,291,523,21,32,0,0
120,428,564,707,1073,1,9,3,279,509,22,32,0,0
121,425,593,687,1071,1,9,3,262,478,23,32,0,0
122,412,618,664,1067,1,9,3,252,449,24,32,0,0
123,409,644,643,1042,1,9,3,234,398,25,32,0,0
124,419,683,651,1058,1,9,3,232,375,26,32,0,0
125,430,711,664,1071,1,9,3,234,360,27,32,0,0
126,432,754,653,1077,1,9,3,221,323,28,32,0,0
127,398,804,600,1077,1,9,3,202,273,29,32,0,0
128,362,846,548,1075,1,9,3,186,229,30,32,0,0
129,332,911,483,1076,1,9,3,151,165,31,32,0,0
130,328,948,446,1078,1,9,3,118,130,32,32,1,0
86,306,149,341,267,2,9,3,35,118,0,0,0,0
87,327,145,367,274,3,9,3,40,129,0,1,0,0
88,342,151,380,274,3,9,3,38,123,1,1,0,0
90,384,149,433,275,5,9,3,49,126,0,0,0,0
92,434,145,472,269,7,9,3,38,124,0,0,0,0
93,455,152,501,272,8,9,3,46,120,0,1,0,0
94,469,150,513,265,8,9,3,44,115,1,1,0,0
309,151,928,288,1073,10,9,3,137,145,0,0,0,0
371,263,472,813,1043,11,9,3,550,571,0,31,0,1
372,267,462,788,1026,11,9,3,521,564,1,31,0,0
373,254,445,739,995,11,9,3,485,550,2,31,0,0
374,257,435,691,951,11,9,3,434,516,3,31,0,0
375,256,439,651,927,11,9,3,395,488,4,31,0,0
376,254,454,617,914,11,9,3,363,460,5,31,0,0
377,250,471,590,910,11,9,3,340,439,6,31,0,0
378,245,478,573,908,11,9,3,328,430,7,31,0,0
379,246,486,562,904,11,9,3,316,418,8,31,0,0
380,255,487,560,891,11,9,3,305,404,9,31,0,0
381,255,487,551,879,11,9,3,296,392,10,31,0,0
382,251,473,547,873,11,9,3,296,400,11,31,0,0
383,255,440,559,866,11,9,3,304,426,12,31,0,0
384,266,414,565,848,11,9,3,299,434,13,31,0,0
385,264,400,561,844,11,9,3,297,444,14,31,0,0
386,241,392,532,834,11,9,3,291,442,15,31,0,0
387,230,393,510,820,11,9,3,280,427,16,31,0,0
388,226,390,498,807,11,9,3,272,417,17,31,0,0
389,221,380,505,825,11,9,3,284,445,18,31,0,0
390,239,376,521,831,11,9,3,282,455,19,31,0,0
391,270,379,538,831,11,9,3,268,452,20,31,0,0
392,287,372,548,833,11,9,3,261,461,21,31,0,0
393,296,369,544,822,11,9,3,248,453,22,31,0,0
394,297,367,531,805,11,9,3,234,438,23,31,0,0
395,280,368,506,793,11,9,3,226,425,24,31,0,0
396,263,369,483,782,11,9,3,220,413,25,31,0,0
397,238,362,451,775,11,9,3,213,413,26,31,0,0
398,222,364,425,771,11,9,3,203,407,27,31,0,0
399,212,362,413,772,11,9,3,201,410,28,31,0,0
400,194,364,375,752,11,9,3,181,388,29,31,0,0
401,195,402,346,742,11,9,3,151,340,30,31,0,0
402,185,404,331,734,11,9,3,146,330,31,31,1,0
382,291,466,359,542,13,9,3,68,76,0,0,0,0
586,233,400,278,532,14,9,3,45,132,0,0,0,0
587,232,397,302,696,15,9,3,70,299,0,40,0,1
588,231,379,306,698,15,9,3,75,319,1,40,0,0
589,238,378,320,729,15,9,3,82,351,2,40,0,0
590,255,372,356,794,15,9,3,101,422,3,40,0,0
591,266,368,375,815,15,9,3,109,447,4,40,0,0
592,277,375,386,813,15,9,3,109,438,5,40,0,0
593,306,386,413,808,15,9,3,107,422,6,40,0,0
594,342,392,458,820,15,9,3,116,428,7,40,0,0
595,361,394,485,840,15,9,3,124,446,8,40,0,0
596,394,394,522,846,15,9,3,128,452,9,40,0,0
597,432,401,570,872,15,9,3,138,471,10,40,0,0
598,455,408,598,882,15,9,3,143,474,11,40,0,0
599,492,414,636,885,15,9,3,144,471,12,40,0,0
600,539,429,690,897,15,9,3,151,468,13,40,0,0
601,568,436,722,903,15,9,3,154,467,14,40,0,0
602,601,435,769,932,15,9,3,168,497,15,40,0,0
603,628,451,816,979,15,9,3,188,528,16,40,0,0
604,656,466,847,987,15,9,3,191,521,17,40,0,0
605,686,479,877,993,15,9,3,191,514,18,40,0,0
606,719,503,910,1007,15,9,3,191,504,19,40,0,0
607,751,515,948,1023,15,9,3,197,508,20,40,0,0
608,791,527,996,1038,15,9,3,205,511,21,40,0,0
609,817,537,1035,1069,15,9,3,218,532,22,40,0,0
610,844,553,1060,1067,15,9,3,216,514,23,40,0,0
611,877,563,1097,1073,15,9,3,220,510,24,40,0,0
612,924,575,1141,1075,15,9,3,217,500,25,40,0,0
613,962,590,1182,1080,15,9,3,220,490,26,40,0,0
614,1021,602,1240,1075,15,9,3,219,473,27,40,0,0
615,1079,607,1300,1075,15,9,3,221,468,28,40,0,0
616,1125,621,1347,1070,15,9,3,222,449,29,40,0,0
617,1174,652,1392,1069,15,9,3,218,417,30,40,0,0
618,1245,675,1460,1074,15,9,3,215,399,31,40,0,0
619,1312,693,1524,1073,15,9,3,212,380,32,40,0,0
620,1386,719,1590,1073,15,9,3,204,354,33,40,0,0
621,1454,745,1651,1071,15,9,3,197,326,34,40,0,0
622,1495,777,1687,1067,15,9,3,192,290,35,40,0,0
623,1562,821,1741,1074,15,9,3,179,253,36,40,0,0
624,1640,861,1802,1077,15,9,3,162,216,37,40,0,0
625,1715,905,1853,1073,15,9,3,138,168,38,40,0,0
626,1779,938,1898,1079,15,9,3,119,141,39,40,0,0
627,1847,969,1920,1080,15,9,3,73,111,40,40,1,0
1280,648,489,845,1042,19,9,3,197,553,0,18,0,0
1281,618,464,817,1022,19,9,3,199,558,1,18,0,0
1282,594,448,791,1000,19,9,3,197,552,2,18,0,0
1283,556,420,735,921,19,9,3,179,501,3,18,0,0
1284,514,396,690,887,19,9,3,176,491,4,18,0,0
1285,482,380,645,837,19,9,3,163,457,5,18,0,0
1286,459,367,619,814,19,9,3,160,447,6,18,0,0
1287,440,353,597,792,19,9,3,157,439,7,18,0,0
1288,415,336,559,740,19,9,3,144,404,8,18,0,0
1289,390,330,530,725,19,9,3,140,395,9,18,0,0
1290,363,318,494,690,19,9,3,131,372,10,18,0,0
1291,343,312,471,675,19,9,3,128,363,11,18,0,0
1292,329,301,455,660,19,9,3,126,359,12,18,0,0
1293,306,293,424,628,19,9,3,118,335,13,18,0,0
1294,287,294,398,606,19,9,3,111,312,14,18,0,0
1295,258,282,364,582,19,9,3,106,300,15,18,0,0
1296,237,279,342,579,19,9,3,105,300,16,18,0,0
1297,222,272,313,541,19,9,3,91,269,17,18,0,0
1298,200,264,285,516,19,9,3,85,252,18,18,0,0
1869,281,164,317,272,21,9,3,36,108,0,112,0,1
1870,290,165,333,291,21,9,3,43,126,1,112,0,0
1871,297,163,341,295,21,9,3,44,132,2,112,0,0
1872,312,161,357,297,21,9,3,45,136,3,112,0,0
1873,324,164,370,300,21,9,3,46,136,4,112,0,0
1874,337,164,383,301,21,9,3,46,137,5,112,0,0
1875,346,163,393,304,21,9,3,47,141,6,112,0,0
1876,358,168,405,307,21,9,3,47,139,7,112,0,0
1877,372,165,421,309,21,9,3,49,144,8,112,0,0
1878,388,167,438,313,21,9,3,50,146,9,112,0,0
1879,399,170,450,315,21,9,3,51,145,10,112,0,0
1880,403,169,456,318,21,9,3,53,149,11,112,0,0
1881,411,172,464,323,21,9,3,53,151,12,112,0,0
1882,423,173,476,325,21,9,3,53,152,13,112,0,0
1883,437,172,493,329,21,9,3,56,157,14,112,0,0
1884,450,175,508,334,21,9,3,58,159,15,112,0,0
1885,462,176,523,336,21,9,3,61,160,16,112,0,0
1886,468,177,534,343,21,9,3,66,166,17,112,0,0
1887,479,178,547,342,21,9,3,68,164,18,112,0,0
1888,484,177,557,347,21,9,3,73,170,19,112,0,0
1889,486,176,562,350,21,9,3,76,174,20,112,0,0
1890,487,178,565,354,21,9,3,78,176,21,112,0,0
1891,482,178,559,356,21,9,3,77,178,22,112,0,0
1892,485,180,564,356,21,9,3,79,176,23,112,0,0
1893,488,181,571,358,21,9,3,83,177,24,112,0,0
1894,488,181,573,359,21,9,3,85,178,25,112,0,0
1895,487,181,574,359,21,9,3,87,178,26,112,0,0
1896,487,181,576,360,21,9,3,89,179,27,112,0,0
1897,486,182,575,357,21,9,3,89,175,28,112,0,0
1898,485,182,576,359,21,9,3,91,177,29,112,0,0
1899,484,183,576,359,21,9,3,92,176,30,112,0,0
1900,483,183,577,359,21,9,3,94,176,31,112,0,0
1901,483,183,577,359,21,9,3,94,176,32,112,0,0
1902,482,183,578,359,21,9,3,96,176,33,112,0,0
1903,482,183,578,359,21,9,3,96,176,34,112,0,0
1904,481,184,578,359,21,9,3,97,175,35,112,0,0
1905,481,184,578,358,21,9,3,97,174,36,112,0,0
1906,479,180,577,359,21,9,3,98,179,37,112,0,0
1907,477,180,574,357,21,9,3,97,177,38,112,0,0
1908,467,180,561,356,21,9,3,94,176,39,112,0,0
1909,467,174,564,356,21,9,3,97,182,40,112,0,0
1910,466,169,566,357,21,9,3,100,188,41,112,0,0
1911,471,167,573,357,21,9,3,102,190,42,112,0,0
1912,473,167,577,360,21,9,3,104,193,43,112,0,0
1913,474,166,579,360,21,9,3,105,194,44,112,0,0
1914,475,168,579,358,21,9,3,104,190,45,112,0,0
1915,473,167,580,360,21,9,3,107,193,46,112,0,0
1916,472,166,580,361,21,9,3,108,195,47,112,0,0
1917,470,165,579,360,21,9,3,109,195,48,112,0,0
1918,469,165,579,361,21,9,3,110,196,49,112,0,0
1919,468,167,577,360,21,9,3,109,193,50,112,0,0
1920,469,171,577,360,21,9,3,108,189,51,112,0,0
1921,470,174,577,361,21,9,3,107,187,52,112,0,0
1922,471,175,575,359,21,9,3,104,184,53,112,0,0
1923,472,176,575,357,21,9,3,103,181,54,112,0,0
1924,472,176,574,357,21,9,3,102,181,55,112,0,0
1925,472,177,574,357,21,9,3,102,180,56,112,0,0
1926,472,178,574,359,21,9,3,102,181,57,112,0,0
1927,472,178,575,359,21,9,3,103,181,58,112,0,0
1928,472,178,575,359,21,9,3,103,181,59,112,0,0
1929,472,178,575,360,21,9,3,103,182,60,112,0,0
1930,473,178,577,358,21,9,3,104,180,61,112,0,0
1931,474,179,574,353,21,9,3,100,174,62,112,0,0
1932,457,179,553,352,21,9,3,96,173,63,112,0,0
1933,454,178,551,356,21,9,3,97,178,64,112,0,0
1934,445,178,538,357,21,9,3,93,179,65,112,0,0
1935,439,179,528,357,21,9,3,89,178,66,112,0,0
1936,438,179,524,356,21,9,3,86,177,67,112,0,0
1937,443,180,524,352,21,9,3,81,172,68,112,0,0
1938,447,180,524,350,21,9,3,77,170,69,112,0,0
1939,452,178,527,348,21,9,3,75,170,70,112,0,0
1940,457,176,532,349,21,9,3,75,173,71,112,0,0
1941,463,176,536,349,21,9,3,73,173,72,112,0,0
1942,468,175,538,346,21,9,3,70,171,73,112,0,0
1943,472,175,540,345,21,9,3,68,170,74,112,0,0
1944,480,177,548,345,21,9,3,68,168,75,112,0,0
1945,483,175,555,344,21,9,3,72,169,76,112,0,0
1946,475,169,553,344,21,9,3,78,175,77,112,0,0
1947,470,170,552,343,21,9,3,82,173,78,112,0,0
1948,466,172,550,340,21,9,3,84,168,79,112,0,0
1949,463,172,549,337,21,9,3,86,165,80,112,0,0
1950,460,172,550,336,21,9,3,90,164,81,112,0,0
1951,460,172,552,335,21,9,3,92,163,82,112,0,0
1952,457,169,555,336,21,9,3,98,167,83,112,0,0
1953,456,167,558,337,21,9,3,102,170,84,112,0,0
1954,455,167,559,337,21,9,3,104,170,85,112,0,0
1955,454,167,560,337,21,9,3,106,170,86,112,0,0
1956,453,167,561,337,21,9,3,108,170,87,112,0,0
1957,453,167,562,336,21,9,3,109,169,88,112,0,0
1958,452,167,562,336,21,9,3,110,169,89,112,0,0
1959,451,167,563,337,21,9,3,112,170,90,112,0,0
1960,451,167,564,337,21,9,3,113,170,91,112,0,0
1961,450,167,566,338,21,9,3,116,171,92,112,0,0
1962,450,166,567,338,21,9,3,117,172,93,112,0,0
1963,450,166,568,338,21,9,3,118,172,94,112,0,0
1964,449,166,568,338,21,9,3,119,172,95,112,0,0
1965,448,166,568,338,21,9,3,120,172,96,112,0,0
1966,448,166,568,338,21,9,3,120,172,97,112,0,0
1967,448,166,568,338,21,9,3,120,172,98,112,0,0
1968,447,166,568,337,21,9,3,121,171,99,112,0,0
1969,447,166,568,337,21,9,3,121,171,100,112,0,0
1970,447,166,569,337,21,9,3,122,171,101,112,0,0
1971,449,170,568,336,21,9,3,119,166,102,112,0,0
1972,448,168,570,338,21,9,3,122,170,103,112,0,0
1973,449,170,569,336,21,9,3,120,166,104,112,0,0
1974,449,169,569,338,21,9,3,120,169,105,112,0,0
1975,446,174,559,339,21,9,3,113,165,106,112,0,0
1976,453,176,560,339,21,9,3,107,163,107,112,0,0
1977,459,175,562,340,21,9,3,103,165,108,112,0,0
1978,476,175,572,335,21,9,3,96,160,109,112,0,0
1979,486,174,578,336,21,9,3,92,162,110,112,0,0
1980,499,180,580,332,21,9,3,81,152,111,112,0,0
1981,502,181,582,331,21,9,3,80,150,112,112,1,0
2046,1852,921,1920,1074,22,9,3,68,153,0,1,0,0
2047,1839,905,1914,1073,22,9,3,75,168,1,1,0,0
2051,1830,888,1919,1075,23,9,3,89,187,0,9,0,0
2052,1823,866,1920,1078,23,9,3,97,212,1,9,0,0
2053,1817,862,1920,1078,23,9,3,103,216,2,9,0,0
2054,1819,866,1919,1077,23,9,3,100,211,3,9,0,0
2055,1821,871,1918,1075,23,9,3,97,204,4,9,0,0
2056,1811,866,1911,1075,23,9,3,100,209,5,9,0,0
2057,1790,880,1887,1073,23,9,3,97,193,6,9,0,0
2058,1753,883,1855,1072,23,9,3,102,189,7,9,0,0
2059,1696,903,1797,1074,23,9,3,101,171,8,9,0,0
2060,1678,908,1776,1074,23,9,3,98,166,9,9,0,0
2644,1612,748,1920,1079,34,9,3,308,331,0,4,0,0
2645,1628,753,1920,1079,34,9,3,292,326,1,4,0,0
2646,1611,741,1920,1080,34,9,3,309,339,2,4,0,0
2647,1618,750,1920,1080,34,9,3,302,330,3,4,0,0
2648,1606,751,1920,1080,34,9,3,314,329,4,4,0,0
3209,1584,729,1920,1078,40,9,3,336,349,0,224,0,1
3210,1586,725,1920,1078,40,9,3,334,353,1,224,0,0
3211,1588,724,1920,1078,40,9,3,332,354,2,224,0,0
3212,1592,725,1920,1078,40,9,3,328,353,3,224,0,0
3213,1595,724,1920,1075,40,9,3,325,351,4,224,0,0
3214,1595,726,1920,1076,40,9,3,325,350,5,224,0,0
3215,1596,723,1920,1076,40,9,3,324,353,6,224,0,0
3216,1597,717,1920,1074,40,9,3,323,357,7,224,0,0
3217,1598,720,1920,1076,40,9,3,322,356,8,224,0,0
3218,1601,720,1920,1077,40,9,3,319,357,9,224,0,0
3219,1598,715,1920,1079,40,9,3,322,364,10,224,0,0
3220,1595,714,1919,1079,40,9,3,324,365,11,224,0,0
3221,1601,714,1917,1078,40,9,3,316,364,12,224,0,0
3222,1606,714,1916,1078,40,9,3,310,364,13,224,0,0
3223,1610,714,1914,1077,40,9,3,304,363,14,224,0,0
3224,1611,714,1910,1078,40,9,3,299,364,15,224,0,0
3225,1616,716,1909,1078,40,9,3,293,362,16,224,0,0
3226,1619,719,1905,1078,40,9,3,286,359,17,224,0,0
3227,1626,726,1904,1079,40,9,3,278,353,18,224,0,0
3228,1626,727,1900,1078,40,9,3,274,351,19,224,0,0
3229,1625,727,1896,1078,40,9,3,271,351,20,224,0,0
3230,1623,723,1895,1078,40,9,3,272,355,21,224,0,0
3231,1626,726,1894,1079,40,9,3,268,353,22,224,0,0
3232,1625,724,1893,1079,40,9,3,268,355,23,224,0,0
3233,1628,728,1890,1078,40,9,3,262,350,24,224,0,0
3234,1628,726,1892,1079,40,9,3,264,353,25,224,0,0
3235,1629,724,1893,1079,40,9,3,264,355,26,224,0,0
3236,1633,727,1892,1078,40,9,3,259,351,27,224,0,0
3237,1635,729,1893,1078,40,9,3,258,349,28,224,0,0
3238,1638,731,1894,1077,40,9,3,256,346,29,224,0,0
3239,1643,736,1896,1079,40,9,3,253,343,30,224,0,0
3240,1646,745,1894,1079,40,9,3,248,334,31,224,0,0
3241,1644,755,1888,1079,40,9,3,244,324,32,224,0,0
3242,1642,769,1883,1079,40,9,3,241,310,33,224,0,0
3243,1636,784,1870,1074,40,9,3,234,290,34,224,0,0
3244,1628,790,1865,1073,40,9,3,237,283,35,224,0,0
3245,1623,793,1867,1074,40,9,3,244,281,36,224,0,0
3246,1616,791,1869,1075,40,9,3,253,284,37,224,0,0
3247,1617,792,1875,1076,40,9,3,258,284,38,224,0,0
3248,1613,792,1876,1075,40,9,3,263,283,39,224,0,0
3249,1612,788,1883,1076,40,9,3,271,288,40,224,0,0
3250,1603,782,1882,1078,40,9,3,279,296,41,224,0,0
3251,1603,782,1882,1075,40,9,3,279,293,42,224,0,0
3252,1604,784,1884,1074,40,9,3,280,290,43,224,0,0
3253,1604,783,1887,1075,40,9,3,283,292,44,224,0,0
3254,1605,784,1889,1074,40,9,3,284,290,45,224,0,0
3255,1606,787,1888,1074,40,9,3,282,287,46,224,0,0
3256,1606,789,1889,1073,40,9,3,283,284,47,224,0,0
3275,1564,745,1892,1076,40,9,3,328,331,0,224,0,1
3276,1567,739,1896,1076,40,9,3,329,337,1,224,0,0
3277,1572,735,1901,1078,40,9,3,329,343,2,224,0,0
3278,1581,733,1903,1074,40,9,3,322,341,3,224,0,0
3279,1590,737,1905,1075,40,9,3,315,338,4,224,0,0
3280,1590,733,1907,1078,40,9,3,317,345,5,224,0,0
3281,1594,734,1906,1078,40,9,3,312,344,6,224,0,0
3282,1591,728,1905,1079,40,9,3,314,351,7,224,0,0
3283,1590,724,1904,1079,40,9,3,314,355,8,224,0,0
3284,1594,727,1900,1078,40,9,3,306,351,9,224,0,0
3285,1592,723,1897,1079,40,9,3,305,356,10,224,0,0
3286,1591,721,1895,1079,40,9,3,304,358,11,224,0,0
3287,1593,721,1894,1080,40,9,3,301,359,12,224,0,0
3288,1595,720,1893,1080,40,9,3,298,360,13,224,0,0
3289,1597,720,1891,1080,40,9,3,294,360,14,224,0,0
3290,1602,724,1889,1078,40,9,3,287,354,15,224,0,0
3291,1601,722,1888,1079,40,9,3,287,357,16,224,0,0
3292,1601,720,1887,1079,40,9,3,286,359,17,224,0,0
3293,1601,720,1886,1080,40,9,3,285,360,18,224,0,0
3294,1606,725,1884,1078,40,9,3,278,353,19,224,0,0
3295,1607,727,1883,1077,40,9,3,276,350,20,224,0,0
3296,1608,726,1883,1077,40,9,3,275,351,21,224,0,0
3297,1611,728,1881,1074,40,9,3,270,346,22,224,0,0
3298,1612,730,1880,1073,40,9,3,268,343,23,224,0,0
3299,1606,725,1880,1077,40,9,3,274,352,24,224,0,0
3300,1605,724,1880,1079,40,9,3,275,355,25,224,0,0
3301,1608,727,1878,1078,40,9,3,270,351,26,224,0,0
3302,1607,730,1876,1078,40,9,3,269,348,27,224,0,0
3303,1607,730,1875,1078,40,9,3,268,348,28,224,0,0
3304,1609,728,1875,1073,40,9,3,266,345,29,224,0,0
3305,1610,727,1875,1072,40,9,3,265,345,30,224,0,0
3306,1605,725,1875,1077,40,9,3,270,352,31,224,0,0
3307,1604,725,1875,1079,40,9,3,271,354,32,224,0,0
3308,1604,724,1875,1079,40,9,3,271,355,33,224,0,0
3309,1609,726,1873,1074,40,9,3,264,348,34,224,0,0
3310,1605,724,1874,1077,40,9,3,269,353,35,224,0,0
3311,1610,727,1872,1072,40,9,3,262,345,36,224,0,0
3312,1610,728,1871,1071,40,9,3,261,343,37,224,0,0
3313,1606,726,1872,1076,40,9,3,266,350,38,224,0,0
3314,1604,724,1872,1078,40,9,3,268,354,39,224,0,0
3315,1603,725,1871,1079,40,9,3,268,354,40,224,0,0
3316,1606,727,1870,1076,40,9,3,264,349,41,224,0,0
3317,1606,728,1870,1078,40,9,3,264,350,42,224,0,0
3318,1606,730,1870,1078,40,9,3,264,348,43,224,0,0
3319,1607,731,1870,1078,40,9,3,263,347,44,224,0,0
3320,1607,732,1868,1078,40,9,3,261,346,45,224,0,0
3321,1608,734,1868,1076,40,9,3,260,342,46,224,0,0
3322,1609,731,1872,1078,40,9,3,263,347,47,224,0,0
3323,1618,733,1879,1079,40,9,3,261,346,48,224,0,0
3324,1631,744,1885,1078,40,9,3,254,334,49,224,0,0
3325,1641,749,1891,1074,40,9,3,250,325,50,224,0,0
3326,1653,755,1899,1073,40,9,3,246,318,51,224,0,0
3327,1668,768,1906,1073,40,9,3,238,305,52,224,0,0
3328,1679,774,1912,1072,40,9,3,233,298,53,224,0,0
3329,1681,774,1915,1070,40,9,3,234,296,54,224,0,0
3330,1678,778,1913,1074,40,9,3,235,296,55,224,0,0
3331,1680,779,1913,1070,40,9,3,233,291,56,224,0,0
3332,1675,773,1914,1072,40,9,3,239,299,57,224,0,0
3333,1672,771,1912,1069,40,9,3,240,298,58,224,0,0
3334,1670,773,1912,1071,40,9,3,242,298,59,224,0,0
3335,1674,783,1910,1070,40,9,3,236,287,60,224,0,0
3336,1676,788,1910,1070,40,9,3,234,282,61,224,0,0
3337,1675,788,1910,1070,40,9,3,235,282,62,224,0,0
3338,1675,789,1912,1070,40,9,3,237,281,63,224,0,0
3339,1676,789,1913,1069,40,9,3,237,280,64,224,0,0
3340,1673,783,1915,1068,40,9,3,242,285,65,224,0,0
3341,1672,781,1916,1067,40,9,3,244,286,66,224,0,0
3342,1673,781,1917,1067,40,9,3,244,286,67,224,0,0
3343,1672,780,1918,1067,40,9,3,246,287,68,224,0,0
3344,1672,780,1918,1067,40,9,3,246,287,69,224,0,0
3345,1672,782,1917,1067,40,9,3,245,285,70,224,0,0
3346,1668,775,1920,1069,40,9,3,252,294,71,224,0,0
3347,1667,772,1920,1070,40,9,3,253,298,72,224,0,0
3348,1672,777,1919,1065,40,9,3,247,288,73,224,0,0
3349,1668,779,1919,1071,40,9,3,251,292,74,224,0,0
3350,1666,773,1920,1070,40,9,3,254,297,75,224,0,0
3351,1666,774,1920,1071,40,9,3,254,297,76,224,0,0
3352,1665,774,1920,1073,40,9,3,255,299,77,224,0,0
3353,1666,775,1920,1074,40,9,3,254,299,78,224,0,0
3354,1666,775,1920,1074,40,9,3,254,299,79,224,0,0
3355,1666,775,1920,1075,40,9,3,254,300,80,224,0,0
3356,1670,777,1919,1068,40,9,3,249,291,81,224,0,0
3357,1668,773,1920,1069,40,9,3,252,296,82,224,0,0
3358,1670,780,1916,1067,40,9,3,246,287,83,224,0,0
3359,1672,780,1917,1066,40,9,3,245,286,84,224,0,0
3360,1670,774,1920,1066,40,9,3,250,292,85,224,0,0
3361,1670,778,1918,1066,40,9,3,248,288,86,224,0,0
3362,1666,773,1920,1069,40,9,3,254,296,87,224,0,0
3363,1669,780,1916,1067,40,9,3,247,287,88,224,0,0
3364,1665,772,1920,1069,40,9,3,255,297,89,224,0,0
3365,1665,773,1919,1069,40,9,3,254,296,90,224,0,0
3366,1665,776,1920,1073,40,9,3,255,297,91,224,0,0
3367,1666,778,1920,1075,40,9,3,254,297,92,224,0,0
3368,1666,777,1920,1072,40,9,3,254,295,93,224,0,0
3369,1666,779,1919,1072,40,9,3,253,293,94,224,0,0
3370,1669,780,1917,1069,40,9,3,248,289,95,224,0,0
3371,1669,780,1917,1068,40,9,3,248,288,96,224,0,0
3372,1665,775,1920,1070,40,9,3,255,295,97,224,0,0
3373,1666,776,1920,1074,40,9,3,254,298,98,224,0,0
3374,1663,773,1920,1073,40,9,3,257,300,99,224,0,0
3375,1662,771,1920,1071,40,9,3,258,300,100,224,0,0
3376,1663,772,1919,1071,40,9,3,256,299,101,224,0,0
3377,1664,773,1919,1071,40,9,3,255,298,102,224,0,0
3378,1664,773,1919,1071,40,9,3,255,298,103,224,0,0
3379,1664,773,1919,1071,40,9,3,255,298,104,224,0,0
3380,1663,771,1919,1071,40,9,3,256,300,105,224,0,0
3381,1663,771,1920,1072,40,9,3,257,301,106,224,0,0
3382,1667,778,1917,1070,40,9,3,250,292,107,224,0,0
3383,1668,779,1917,1069,40,9,3,249,290,108,224,0,0
3384,1669,782,1917,1070,40,9,3,248,288,109,224,0,0
3385,1665,775,1920,1071,40,9,3,255,296,110,224,0,0
3386,1665,772,1920,1070,40,9,3,255,298,111,224,0,0
3387,1663,767,1920,1068,40,9,3,257,301,112,224,0,0
3388,1663,766,1920,1068,40,9,3,257,302,113,224,0,0
3389,1667,774,1920,1071,40,9,3,253,297,114,224,0,0
3390,1665,772,1920,1073,40,9,3,255,301,115,224,0,0
3391,1665,768,1920,1069,40,9,3,255,301,116,224,0,0
3392,1665,769,1920,1070,40,9,3,255,301,117,224,0,0
3393,1664,767,1920,1069,40,9,3,256,302,118,224,0,0
3394,1665,769,1920,1069,40,9,3,255,300,119,224,0,0
3395,1671,776,1917,1065,40,9,3,246,289,120,224,0,0
3396,1672,781,1916,1066,40,9,3,244,285,121,224,0,0
3397,1668,776,1918,1070,40,9,3,250,294,122,224,0,0
3398,1666,775,1919,1071,40,9,3,253,296,123,224,0,0
3399,1664,773,1919,1070,40,9,3,255,297,124,224,0,0
3400,1665,781,1916,1073,40,9,3,251,292,125,224,0,0
3401,1663,781,1916,1074,40,9,3,253,293,126,224,0,0
3402,1663,784,1915,1075,40,9,3,252,291,127,224,0,0
3403,1664,788,1914,1075,40,9,3,250,287,128,224,0,0
3404,1667,786,1914,1069,40,9,3,247,283,129,224,0,0
3405,1665,784,1915,1070,40,9,3,250,286,130,224,0,0
3406,1666,785,1914,1068,40,9,3,248,283,131,224,0,0
3407,1664,788,1913,1071,40,9,3,249,283,132,224,0,0
3408,1663,783,1916,1070,40,9,3,253,287,133,224,0,0
3409,1662,786,1915,1072,40,9,3,253,286,134,224,0,0
3410,1662,787,1916,1073,40,9,3,254,286,135,224,0,0
3411,1662,781,1918,1071,40,9,3,256,290,136,224,0,0
3412,1662,780,1920,1073,40,9,3,258,293,137,224,0,0
3413,1662,776,1920,1071,40,9,3,258,295,138,224,0,0
3414,1665,777,1920,1068,40,9,3,255,291,139,224,0,0
3415,1666,777,1920,1067,40,9,3,254,290,140,224,0,0
3416,1663,772,1920,1068,40,9,3,257,296,141,224,0,0
3417,1662,770,1920,1068,40,9,3,258,298,142,224,0,0
3418,1662,770,1920,1068,40,9,3,258,298,143,224,0,0
3419,1663,771,1920,1069,40,9,3,257,298,144,224,0,0
3420,1663,771,1920,1069,40,9,3,257,298,145,224,0,0
3421,1668,778,1919,1067,40,9,3,251,289,146,224,0,0
3422,1666,775,1920,1068,40,9,3,254,293,147,224,0,0
3423,1664,773,1920,1069,40,9,3,256,296,148,224,0,0
3424,1664,774,1920,1070,40,9,3,256,296,149,224,0,0
3425,1664,773,1920,1070,40,9,3,256,297,150,224,0,0
3426,1664,778,1919,1072,40,9,3,255,294,151,224,0,0
3427,1663,779,1918,1073,40,9,3,255,294,152,224,0,0
3428,1665,776,1919,1070,40,9,3,254,294,153,224,0,0
3429,1663,776,1920,1073,40,9,3,257,297,154,224,0,0
3430,1663,778,1919,1074,40,9,3,256,296,155,224,0,0
3431,1664,780,1919,1074,40,9,3,255,294,156,224,0,0
3432,1664,781,1919,1074,40,9,3,255,293,157,224,0,0
3433,1662,778,1920,1075,40,9,3,258,297,158,224,0,0
3434,1660,776,1920,1075,40,9,3,260,299,159,224,0,0
3435,1654,771,1918,1077,40,9,3,264,306,160,224,0,0
3436,1646,763,1914,1075,40,9,3,268,312,161,224,0,0
3437,1634,758,1907,1075,40,9,3,273,317,162,224,0,0
3438,1611,737,1899,1078,40,9,3,288,341,163,224,0,0
3439,1597,731,1888,1077,40,9,3,291,346,164,224,0,0
3440,1593,722,1888,1072,40,9,3,295,350,165,224,0,0
3441,1579,685,1898,1071,40,9,3,319,386,166,224,0,0
3442,1576,686,1892,1071,40,9,3,316,385,167,224,0,0
3443,1578,688,1892,1075,40,9,3,314,387,168,224,0,0
3444,1590,701,1892,1075,40,9,3,302,374,169,224,0,0
3445,1599,709,1895,1077,40,9,3,296,368,170,224,0,0
3446,1596,711,1886,1076,40,9,3,290,365,171,224,0,0
3447,1599,712,1884,1076,40,9,3,285,364,172,224,0,0
3448,1606,714,1885,1076,40,9,3,279,362,173,224,0,0
3449,1612,717,1885,1074,40,9,3,273,357,174,224,0,0
3450,1612,720,1883,1076,40,9,3,271,356,175,224,0,0
3451,1612,721,1881,1076,40,9,3,269,355,176,224,0,0
3452,1613,723,1880,1078,40,9,3,267,355,177,224,0,0
3453,1612,726,1876,1078,40,9,3,264,352,178,224,0,0
3454,1610,725,1873,1076,40,9,3,263,351,179,224,0,0
3455,1609,725,1871,1075,40,9,3,262,350,180,224,0,0
3456,1609,725,1872,1077,40,9,3,263,352,181,224,0,0
3457,1609,726,1873,1079,40,9,3,264,353,182,224,0,0
3458,1609,726,1874,1079,40,9,3,265,353,183,224,0,0
3459,1609,725,1874,1080,40,9,3,265,355,184,224,0,0
3460,1609,725,1874,1080,40,9,3,265,355,185,224,0,0
3461,1610,725,1873,1078,40,9,3,263,353,186,224,0,0
3462,1610,723,1873,1078,40,9,3,263,355,187,224,0,0
3463,1610,721,1872,1075,40,9,3,262,354,188,224,0,0
3464,1610,721,1871,1073,40,9,3,261,352,189,224,0,0
3465,1613,723,1871,1072,40,9,3,258,349,190,224,0,0
3466,1613,724,1872,1074,40,9,3,259,350,191,224,0,0
3467,1613,725,1872,1076,40,9,3,259,351,192,224,0,0
3468,1612,725,1872,1077,40,9,3,260,352,193,224,0,0
3469,1614,728,1871,1077,40,9,3,257,349,194,224,0,0
3470,1614,728,1871,1077,40,9,3,257,349,195,224,0,0
3471,1614,727,1873,1079,40,9,3,259,352,196,224,0,0
3472,1613,725,1872,1076,40,9,3,259,351,197,224,0,0
3473,1612,727,1872,1078,40,9,3,260,351,198,224,0,0
3474,1611,727,1871,1079,40,9,3,260,352,199,224,0,0
3475,1613,725,1871,1075,40,9,3,258,350,200,224,0,0
3476,1614,727,1870,1073,40,9,3,256,346,201,224,0,0
3477,1612,727,1871,1077,40,9,3,259,350,202,224,0,0
3478,1611,727,1871,1079,40,9,3,260,352,203,224,0,0
3479,1611,728,1871,1079,40,9,3,260,351,204,224,0,0
3480,1611,724,1871,1076,40,9,3,260,352,205,224,0,0
3481,1611,726,1871,1078,40,9,3,260,352,206,224,0,0
3482,1606,724,1868,1079,40,9,3,262,355,207,224,0,0
3483,1605,725,1864,1079,40,9,3,259,354,208,224,0,0
3484,1600,724,1859,1079,40,9,3,259,355,209,224,0,0
3485,1597,719,1859,1079,40,9,3,262,360,210,224,0,0
3486,1593,716,1855,1079,40,9,3,262,363,211,224,0,0
3487,1587,716,1848,1076,40,9,3,261,360,212,224,0,0
3488,1579,715,1841,1076,40,9,3,262,361,213,224,0,0
3489,1576,716,1837,1076,40,9,3,261,360,214,224,0,0
3490,1572,713,1833,1072,40,9,3,261,359,215,224,0,0
3491,1573,714,1834,1073,40,9,3,261,359,216,224,0,0
3492,1577,717,1836,1073,40,9,3,259,356,217,224,0,0
3493,1581,718,1838,1072,40,9,3,257,354,218,224,0,0
3494,1588,723,1842,1073,40,9,3,254,350,219,224,0,0
3495,1596,729,1848,1074,40,9,3,252,345,220,224,0,0
3496,1605,732,1854,1070,40,9,3,249,338,221,224,0,0
3497,1628,741,1875,1074,40,9,3,247,333,222,224,0,0
3498,1666,772,1895,1074,40,9,3,229,302,223,224,0,0
3499,1675,777,1899,1074,40,9,3,224,297,224,224,1,0
3523,1616,825,1816,1077,40,9,3,200,252,0,224,0,0
3524,1622,820,1830,1076,40,9,3,208,256,1,224,0,0
3525,1627,794,1860,1076,40,9,3,233,282,2,224,0,0
3526,1641,775,1890,1076,40,9,3,249,301,3,224,0,0
3527,1655,769,1907,1074,40,9,3,252,305,4,224,0,0
3528,1666,773,1915,1072,40,9,3,249,299,5,224,0,0
3529,1668,767,1919,1071,40,9,3,251,304,6,224,0,0
3530,1677,772,1920,1071,40,9,3,243,299,7,224,0,0
3531,1675,778,1920,1074,40,9,3,245,296,8,224,0,0
3532,1678,777,1920,1072,40,9,3,242,295,9,224,0,0
3533,1671,766,1920,1076,40,9,3,249,310,10,224,0,0
3534,1661,756,1920,1078,40,9,3,259,322,11,224,0,0
3535,1652,724,1920,1079,40,9,3,268,355,12,224,0,0
3536,1643,693,1920,1080,40,9,3,277,387,13,224,0,0
3537,1633,680,1920,1073,40,9,3,287,393,14,224,0,0
3538,1630,666,1920,1068,40,9,3,290,402,15,224,0,0
3539,1628,657,1920,1068,40,9,3,292,411,16,224,0,0
3540,1614,648,1920,1073,40,9,3,306,425,17,224,0,0
3541,1610,638,1920,1073,40,9,3,310,435,18,224,0,0
3544,1604,598,1920,1071,40,9,3,316,473,0,224,0,0
3545,1600,588,1920,1071,40,9,3,320,483,1,224,0,0
3546,1606,604,1920,1076,40,9,3,314,472,2,224,0,0
3547,1610,600,1920,1071,40,9,3,310,471,3,224,0,0
3548,1607,592,1920,1071,40,9,3,313,479,4,224,0,0
3549,1616,577,1920,1058,40,9,3,304,481,5,224,0,0
3550,1617,573,1920,1060,40,9,3,303,487,6,224,0,0
3551,1605,557,1920,1065,40,9,3,315,508,7,224,0,0
3552,1602,548,1920,1064,40,9,3,318,516,8,224,0,0
3348,1858,782,1916,886,41,9,3,58,104,0,1,0,0
3349,1858,782,1916,886,41,9,3,58,104,1,1,0,0
3381,1855,782,1917,886,42,9,3,62,104,0,5,0,0
3382,1855,782,1916,885,42,9,3,61,103,1,5,0,0
3383,1855,782,1916,885,42,9,3,61,103,2,5,0,0
3384,1855,783,1916,885,42,9,3,61,102,3,5,0,0
3385,1855,783,1917,886,42,9,3,62,103,4,5,0,0
3386,1855,783,1917,886,42,9,3,62,103,5,5,0,0
3498,1868,787,1920,891,43,9,3,52,104,0,0,0,0
3815,1813,938,1920,1075,49,9,3,107,137,0,0,0,0
4080,424,171,459,314,54,9,3,35,143,0,2,0,0
4081,411,170,446,310,54,9,3,35,140,1,2,0,0
4084,377,167,412,301,54,9,3,35,134,0,2,0,0
4085,363,166,398,297,54,9,3,35,131,1,2,0,0
4086,351,166,386,296,54,9,3,35,130,2,2,0,0
4088,326,146,364,289,54,9,3,38,143,0,2,0,0
4089,313,128,356,290,54,9,3,43,162,1,2,0,0
4090,305,123,347,281,54,9,3,42,158,2,2,0,0
5657,291,154,328,286,55,9,3,37,132,0,27,0,1
5658,301,144,341,287,55,9,3,40,143,1,27,0,0
5659,312,145,354,291,55,9,3,42,146,2,27,0,0
5660,325,146,367,296,55,9,3,42,150,3,27,0,0
5661,338,146,382,298,55,9,3,44,152,4,27,0,0
5662,350,149,394,301,55,9,3,44,152,5,27,0,0
5663,359,148,406,306,55,9,3,47,158,6,27,0,0
5664,367,151,414,314,55,9,3,47,163,7,27,0,0
5665,374,150,422,314,55,9,3,48,164,8,27,0,0
5666,378,151,429,320,55,9,3,51,169,9,27,0,0
5667,384,153,436,325,55,9,3,52,172,10,27,0,0
5668,389,153,444,333,55,9,3,55,180,11,27,0,0
5669,392,161,446,339,55,9,3,54,178,12,27,0,0
5670,390,161,448,350,55,9,3,58,189,13,27,0,0
5671,389,165,448,360,55,9,3,59,195,14,27,0,0
5672,388,167,449,364,55,9,3,61,197,15,27,0,0
5673,383,167,445,371,55,9,3,62,204,16,27,0,0
5674,376,168,442,382,55,9,3,66,214,17,27,0,0
5675,368,169,435,384,55,9,3,67,215,18,27,0,0
5676,361,174,430,392,55,9,3,69,218,19,27,0,0
5677,346,176,418,405,55,9,3,72,229,20,27,0,0
5678,326,178,401,417,55,9,3,75,239,21,27,0,0
5679,307,183,384,424,55,9,3,77,241,22,27,0,0
5680,284,181,361,428,55,9,3,77,247,23,27,0,0
5681,265,188,342,435,55,9,3,77,247,24,27,0,0
5682,240,189,315,435,55,9,3,75,246,25,27,0,0
5683,228,227,290,436,55,9,3,62,209,26,27,0,0
5684,219,233,281,442,55,9,3,62,209,27,27,1,0
74,1243,841,1410,1077,4,9,4,167,236,0,1,0,0
75,1328,890,1460,1073,4,9,4,132,183,1,1,0,0
81,1706,823,1917,1077,6,9,4,211,254,0,1,0,0
82,1725,831,1920,1077,6,9,4,195,246,1,1,0,0
213,1735,698,1918,1080,7,9,4,183,382,0,22,0,1
214,1705,671,1899,1074,7,9,4,194,403,1,22,0,0
215,1675,671,1870,1070,7,9,4,195,399,2,22,0,0
216,1623,674,1816,1066,7,9,4,193,392,3,22,0,0
217,1573,666,1773,1069,7,9,4,200,403,4,22,0,0
218,1521,661,1727,1071,7,9,4,206,410,5,22,0,0
219,1459,641,1678,1070,7,9,4,219,429,6,22,0,0
220,1406,630,1631,1065,7,9,4,225,435,7,22,0,0
221,1353,608,1592,1064,7,9,4,239,456,8,22,0,0
222,1300,597,1552,1066,7,9,4,252,469,9,22,0,0
223,1259,588,1522,1063,7,9,4,263,475,10,22,0,0
224,1236,578,1512,1066,7,9,4,276,488,11,22,0,0
225,1233,578,1517,1069,7,9,4,284,491,12,22,0,0
226,1248,588,1533,1068,7,9,4,285,480,13,22,0,0
227,1277,592,1566,1069,7,9,4,289,477,14,22,0,0
228,1312,603,1598,1070,7,9,4,286,467,15,22,0,0
229,1350,627,1625,1069,7,9,4,275,442,16,22,0,0
230,1412,655,1673,1073,7,9,4,261,418,17,22,0,0
231,1475,643,1739,1074,7,9,4,264,431,18,22,0,0
232,1532,637,1800,1076,7,9,4,268,439,19,22,0,0
233,1586,635,1853,1077,7,9,4,267,442,20,22,0,0
234,1647,633,1911,1072,7,9,4,264,439,21,22,0,0
235,1669,632,1920,1072,7,9,4,251,440,22,22,1,0
323,1768,711,1920,1080,8,9,4,152,369,0,33,0,1
324,1733,697,1892,1080,8,9,4,159,383,1,33,0,0
325,1688,669,1860,1077,8,9,4,172,408,2,33,0,0
326,1626,646,1810,1077,8,9,4,184,431,3,33,0,0
327,1563,639,1751,1071,8,9,4,188,432,4,33,0,0
328,1476,634,1671,1068,8,9,4,195,434,5,33,0,0
329,1407,623,1616,1070,8,9,4,209,447,6,33,0,0
330,1352,613,1574,1068,8,9,4,222,455,7,33,0,0
331,1313,598,1549,1067,8,9,4,236,469,8,33,0,0
332,1282,581,1531,1066,8,9,4,249,485,9,33,0,0
333,1254,557,1516,1066,8,9,4,262,509,10,33,0,0
334,1238,541,1508,1068,8,9,4,270,527,11,33,0,0
335,1228,542,1498,1069,8,9,4,270,527,12,33,0,0
336,1229,543,1495,1063,8,9,4,266,520,13,33,0,0
337,1228,543,1496,1068,8,9,4,268,525,14,33,0,0
338,1229,543,1497,1069,8,9,4,268,526,15,33,0,0
339,1231,543,1498,1070,8,9,4,267,527,16,33,0,0
340,1233,541,1501,1070,8,9,4,268,529,17,33,0,0
341,1248,543,1508,1043,8,9,4,260,500,18,33,0,0
342,1246,544,1513,1051,8,9,4,267,507,19,33,0,0
343,1249,547,1523,1062,8,9,4,274,515,20,33,0,0
344,1248,561,1524,1068,8,9,4,276,507,21,33,0,0
345,1249,574,1524,1068,8,9,4,275,494,22,33,0,0
346,1248,578,1527,1067,8,9,4,279,489,23,33,0,0
347,1277,588,1555,1066,8,9,4,278,478,24,33,0,0
348,1316,611,1589,1070,8,9,4,273,459,25,33,0,0
349,1368,641,1633,1073,8,9,4,265,432,26,33,0,0
350,1439,657,1697,1076,8,9,4,258,419,27,33,0,0
351,1500,672,1751,1076,8,9,4,251,404,28,33,0,0
352,1561,678,1809,1077,8,9,4,248,399,29,33,0,0
353,1589,686,1832,1078,8,9,4,243,392,30,33,0,0
354,1670,666,1920,1074,8,9,4,250,408,31,33,0,0
355,1722,703,1920,1078,8,9,4,198,375,32,33,0,0
356,1758,711,1920,1079,8,9,4,162,368,33,33,1,0
336,1272,600,1377,795,9,9,4,105,195,0,0,0,0
338,1281,644,1366,792,10,9,4,85,148,0,1,0,0
339,1281,627,1372,787,10,9,4,91,160,1,1,0,0
353,1746,656,1898,1072,11,9,4,152,416,0,0,0,0
667,992,550,1494,1059,12,9,4,502,509,0,47,0,1
668,997,532,1498,1065,12,9,4,501,533,1,47,0,0
669,1020,516,1509,1061,12,9,4,489,545,2,47,0,0
670,1043,499,1523,1059,12,9,4,480,560,3,47,0,0
671,1081,482,1539,1039,12,9,4,458,557,4,47,0,0
672,1110,464,1550,1026,12,9,4,440,562,5,47,0,0
673,1131,449,1557,1019,12,9,4,426,570,6,47,0,0
674,1156,436,1547,985,12,9,4,391,549,7,47,0,0
675,1180,420,1534,939,12,9,4,354,519,8,47,0,0
676,1202,414,1534,920,12,9,4,332,506,9,47,0,0
677,1220,404,1536,902,12,9,4,316,498,10,47,0,0
678,1246,388,1535,862,12,9,4,289,474,11,47,0,0
679,1266,379,1539,844,12,9,4,273,465,12,47,0,0
680,1276,373,1533,828,12,9,4,257,455,13,47,0,0
681,1286,357,1523,791,12,9,4,237,434,14,47,0,0
682,1300,350,1517,756,12,9,4,217,406,15,47,0,0
683,1313,345,1524,754,12,9,4,211,409,16,47,0,0
684,1334,337,1528,721,12,9,4,194,384,17,47,0,0
685,1351,327,1540,710,12,9,4,189,383,18,47,0,0
686,1359,324,1543,706,12,9,4,184,382,19,47,0,0
687,1370,318,1535,669,12,9,4,165,351,20,47,0,0
688,1379,311,1535,649,12,9,4,156,338,21,47,0,0
689,1385,304,1540,643,12,9,4,155,339,22,47,0,0
690,1395,295,1547,634,12,9,4,152,339,23,47,0,0
691,1407,290,1550,615,12,9,4,143,325,24,47,0,0
692,1415,280,1556,604,12,9,4,141,324,25,47,0,0
693,1416,272,1553,592,12,9,4,137,320,26,47,0,0
694,1419,271,1551,584,12,9,4,132,313,27,47,0,0
695,1423,274,1551,582,12,9,4,128,308,28,47,0,0
696,1428,266,1552,567,12,9,4,124,301,29,47,0,0
697,1426,253,1552,562,12,9,4,126,309,30,47,0,0
698,1416,262,1537,558,12,9,4,121,296,31,47,0,0
699,1409,262,1528,548,12,9,4,119,286,32,47,0,0
700,1404,254,1522,538,12,9,4,118,284,33,47,0,0
701,1408,246,1530,532,12,9,4,122,286,34,47,0,0
702,1407,247,1530,528,12,9,4,123,281,35,47,0,0
703,1394,248,1511,515,12,9,4,117,267,36,47,0,0
704,1390,247,1506,509,12,9,4,116,262,37,47,0,0
705,1388,248,1503,506,12,9,4,115,258,38,47,0,0
706,1388,244,1496,491,12,9,4,108,247,39,47,0,0
707,1387,243,1490,482,12,9,4,103,239,40,47,0,0
708,1391,246,1486,475,12,9,4,95,229,41,47,0,0
709,1398,244,1493,473,12,9,4,95,229,42,47,0,0
710,1407,235,1501,461,12,9,4,94,226,43,47,0,0
711,1410,234,1505,463,12,9,4,95,229,44,47,0,0
712,1430,230,1523,454,12,9,4,93,224,45,47,0,0
713,1439,229,1529,445,12,9,4,90,216,46,47,0,0
714,1443,226,1532,437,12,9,4,89,211,47,47,1,0
665,1351,661,1454,889,13,9,4,103,228,0,0,0,0
670,1388,529,1489,818,14,9,4,101,289,0,0,0,0
703,1487,241,1538,334,15,9,4,51,93,0,0,0,0
718,1454,246,1595,503,16,9,4,141,257,0,1,0,0
719,1458,241,1594,489,16,9,4,136,248,1,1,0,0
721,1453,251,1587,504,17,9,4,134,253,0,1,0,0
722,1457,253,1589,501,17,9,4,132,248,1,1,0,0
722,1502,255,1577,348,19,9,4,75,93,0,0,0,0
729,1526,268,1569,344,20,9,4,43,76,0,2,0,0
730,1520,271,1564,347,20,9,4,44,76,1,2,0,0
731,1515,271,1561,350,20,9,4,46,79,2,2,0,0
730,1479,265,1593,462,21,9,4,114,197,0,0,0,0
730,1585,309,1631,398,22,9,4,46,89,0,0,0,0
733,1568,290,1625,446,23,9,4,57,156,0,0,0,0
739,1525,266,1566,348,24,9,4,41,82,0,0,0,0
739,1466,259,1590,471,25,9,4,124,212,0,1,0,0
740,1452,250,1595,497,25,9,4,143,247,1,1,0,0
740,1546,258,1593,338,26,9,4,47,80,0,7,0,0
741,1542,251,1583,321,26,9,4,41,70,1,7,0,0
742,1533,250,1582,332,26,9,4,49,82,2,7,0,0
743,1528,247,1582,338,26,9,4,54,91,3,7,0,0
744,1528,246,1584,339,26,9,4,56,93,4,7,0,0
745,1519,243,1579,340,26,9,4,60,97,5,7,0,0
746,1526,243,1577,327,26,9,4,51,84,6,7,0,0
747,1524,242,1576,327,26,9,4,52,85,7,7,0,0
752,1517,248,1576,341,26,9,4,59,93,0,7,0,0
753,1531,249,1586,339,26,9,4,55,90,1,7,0,0
754,1522,251,1580,341,26,9,4,58,90,2,7,0,0
755,1521,252,1580,342,26,9,4,59,90,3,7,0,0
759,1527,250,1579,327,26,9,4,52,77,0,7,0,0
760,1527,250,1579,326,26,9,4,52,76,1,7,0,0
742,1472,243,1597,476,27,9,4,125,233,0,188,0,0
743,1464,243,1592,482,27,9,4,128,239,1,188,0,0
744,1464,238,1595,483,27,9,4,131,245,2,188,0,0
745,1471,236,1605,487,27,9,4,134,251,3,188,0,0
746,1474,236,1609,492,27,9,4,135,256,4,188,0,0
747,1474,238,1608,495,27,9,4,134,257,5,188,0,0
748,1475,231,1605,483,27,9,4,130,252,6,188,0,0
749,1462,234,1597,496,27,9,4,135,262,7,188,0,0
750,1457,233,1595,502,27,9,4,138,269,8,188,0,0
751,1460,235,1597,501,27,9,4,137,266,9,188,0,0
752,1463,235,1598,501,27,9,4,135,266,10,188,0,0
753,1466,240,1591,487,27,9,4,125,247,11,188,0,0
754,1470,242,1596,494,27,9,4,126,252,12,188,0,0
755,1501,248,1607,464,27,9,4,106,216,13,188,0,0
756,1505,249,1609,461,27,9,4,104,212,14,188,0,0
758,1487,250,1599,482,27,9,4,112,232,0,188,0,1
759,1482,248,1597,488,27,9,4,115,240,1,188,0,0
760,1472,241,1595,496,27,9,4,123,255,2,188,0,0
761,1471,241,1595,498,27,9,4,124,257,3,188,0,0
762,1457,223,1578,483,27,9,4,121,260,4,188,0,0
763,1448,225,1564,481,27,9,4,116,256,5,188,0,0
764,1448,230,1541,440,27,9,4,93,210,6,188,0,0
765,1439,236,1520,427,27,9,4,81,191,7,188,0,0
766,1428,236,1511,437,27,9,4,83,201,8,188,0,0
767,1415,236,1504,454,27,9,4,89,218,9,188,0,0
768,1407,241,1497,463,27,9,4,90,222,10,188,0,0
769,1396,241,1488,472,27,9,4,92,231,11,188,0,0
770,1392,247,1484,481,27,9,4,92,234,12,188,0,0
771,1387,252,1481,491,27,9,4,94,239,13,188,0,0
772,1382,252,1478,496,27,9,4,96,244,14,188,0,0
773,1377,256,1475,504,27,9,4,98,248,15,188,0,0
774,1370,258,1468,507,27,9,4,98,249,16,188,0,0
775,1364,263,1459,505,27,9,4,95,242,17,188,0,0
776,1357,269,1452,512,27,9,4,95,243,18,188,0,0
777,1356,271,1452,519,27,9,4,96,248,19,188,0,0
778,1355,270,1453,522,27,9,4,98,252,20,188,0,0
779,1356,271,1457,528,27,9,4,101,257,21,188,0,0
780,1355,273,1454,525,27,9,4,99,252,22,188,0,0
781,1355,275,1457,535,27,9,4,102,260,23,188,0,0
782,1355,275,1459,539,27,9,4,104,264,24,188,0,0
783,1354,276,1459,541,27,9,4,105,265,25,188,0,0
784,1353,275,1460,541,27,9,4,107,266,26,188,0,0
785,1353,275,1461,541,27,9,4,108,266,27,188,0,0
786,1349,274,1459,540,27,9,4,110,266,28,188,0,0
787,1348,273,1459,539,27,9,4,111,266,29,188,0,0
788,1346,274,1457,538,27,9,4,111,264,30,188,0,0
789,1345,274,1457,538,27,9,4,112,264,31,188,0,0
790,1344,274,1457,538,27,9,4,113,264,32,188,0,0
791,1345,275,1458,537,27,9,4,113,262,33,188,0,0
792,1345,276,1458,537,27,9,4,113,261,34,188,0,0
793,1345,275,1459,537,27,9,4,114,262,35,188,0,0
794,1346,275,1461,537,27,9,4,115,262,36,188,0,0
795,1345,275,1461,538,27,9,4,116,263,37,188,0,0
796,1343,274,1460,537,27,9,4,117,263,38,188,0,0
797,1343,274,1460,537,27,9,4,117,263,39,188,0,0
798,1343,273,1461,538,27,9,4,118,265,40,188,0,0
799,1343,273,1462,538,27,9,4,119,265,41,188,0,0
800,1341,273,1461,539,27,9,4,120,266,42,188,0,0
801,1341,272,1461,538,27,9,4,120,266,43,188,0,0
802,1341,272,1461,538,27,9,4,120,266,44,188,0,0
803,1341,272,1462,538,27,9,4,121,266,45,188,0,0
804,1341,272,1462,538,27,9,4,121,266,46,188,0,0
805,1342,273,1463,538,27,9,4,121,265,47,188,0,0
806,1348,275,1467,536,27,9,4,119,261,48,188,0,0
807,1349,276,1467,535,27,9,4,118,259,49,188,0,0
808,1351,276,1467,535,27,9,4,116,259,50,188,0,0
809,1351,276,1467,536,27,9,4,116,260,51,188,0,0
810,1351,276,1466,536,27,9,4,115,260,52,188,0,0
811,1349,274,1466,537,27,9,4,117,263,53,188,0,0
812,1348,274,1465,537,27,9,4,117,263,54,188,0,0
813,1347,274,1465,537,27,9,4,118,263,55,188,0,0
814,1348,274,1465,537,27,9,4,117,263,56,188,0,0
815,1347,274,1465,537,27,9,4,118,263,57,188,0,0
816,1345,275,1463,536,27,9,4,118,261,58,188,0,0
817,1345,275,1464,536,27,9,4,119,261,59,188,0,0
818,1346,275,1465,536,27,9,4,119,261,60,188,0,0
819,1348,276,1466,536,27,9,4,118,260,61,188,0,0
820,1348,276,1467,537,27,9,4,119,261,62,188,0,0
821,1351,277,1469,535,27,9,4,118,258,63,188,0,0
822,1353,278,1469,534,27,9,4,116,256,64,188,0,0
823,1353,276,1468,534,27,9,4,115,258,65,188,0,0
824,1352,277,1467,534,27,9,4,115,257,66,188,0,0
825,1351,277,1466,534,27,9,4,115,257,67,188,0,0
826,1349,276,1464,533,27,9,4,115,257,68,188,0,0
827,1349,277,1464,533,27,9,4,115,256,69,188,0,0
828,1351,278,1465,532,27,9,4,114,254,70,188,0,0
829,1353,278,1467,531,27,9,4,114,253,71,188,0,0
830,1354,278,1467,532,27,9,4,113,254,72,188,0,0
831,1355,278,1468,533,27,9,4,113,255,73,188,0,0
832,1354,278,1468,533,27,9,4,114,255,74,188,0,0
833,1354,277,1468,534,27,9,4,114,257,75,188,0,0
834,1353,276,1468,535,27,9,4,115,259,76,188,0,0
835,1353,275,1468,535,27,9,4,115,260,77,188,0,0
836,1348,277,1461,532,27,9,4,113,255,78,188,0,0
837,1348,276,1457,524,27,9,4,109,248,79,188,0,0
838,1349,275,1453,510,27,9,4,104,235,80,188,0,0
839,1351,273,1457,513,27,9,4,106,240,81,188,0,0
840,1351,266,1457,513,27,9,4,106,247,82,188,0,0
841,1356,261,1459,507,27,9,4,103,246,83,188,0,0
842,1357,253,1461,512,27,9,4,104,259,84,188,0,0
843,1363,249,1461,503,27,9,4,98,254,85,188,0,0
844,1363,246,1458,499,27,9,4,95,253,86,188,0,0
845,1368,247,1460,497,27,9,4,92,250,87,188,0,0
846,1373,245,1462,491,27,9,4,89,246,88,188,0,0
847,1380,247,1465,485,27,9,4,85,238,89,188,0,0
848,1385,247,1469,484,27,9,4,84,237,90,188,0,0
849,1393,247,1477,484,27,9,4,84,237,91,188,0,0
850,1394,250,1479,489,27,9,4,85,239,92,188,0,0
851,1391,247,1477,495,27,9,4,86,248,93,188,0,0
852,1397,252,1484,500,27,9,4,87,248,94,188,0,0
853,1398,254,1482,496,27,9,4,84,242,95,188,0,0
854,1404,252,1492,504,27,9,4,88,252,96,188,0,0
855,1409,256,1498,503,27,9,4,89,247,97,188,0,0
856,1415,253,1510,507,27,9,4,95,254,98,188,0,0
857,1435,255,1534,516,27,9,4,99,261,99,188,0,0
858,1445,256,1547,522,27,9,4,102,266,100,188,0,0
859,1455,252,1559,522,27,9,4,104,270,101,188,0,0
860,1464,252,1570,527,27,9,4,106,275,102,188,0,0
861,1470,254,1578,529,27,9,4,108,275,103,188,0,0
862,1476,256,1583,527,27,9,4,107,271,104,188,0,0
863,1478,256,1583,522,27,9,4,105,266,105,188,0,0
864,1478,254,1584,523,27,9,4,106,269,106,188,0,0
865,1480,250,1584,515,27,9,4,104,265,107,188,0,0
866,1485,252,1585,512,27,9,4,100,260,108,188,0,0
867,1492,257,1587,502,27,9,4,95,245,109,188,0,0
868,1502,254,1592,480,27,9,4,90,226,110,188,0,0
869,1511,254,1598,474,27,9,4,87,220,111,188,0,0
870,1513,251,1602,475,27,9,4,89,224,112,188,0,0
871,1510,247,1599,469,27,9,4,89,222,113,188,0,0
872,1509,242,1598,466,27,9,4,89,224,114,188,0,0
873,1512,241,1600,459,27,9,4,88,218,115,188,0,0
874,1517,239,1601,449,27,9,4,84,210,116,188,0,0
875,1519,234,1603,442,27,9,4,84,208,117,188,0,0
876,1521,240,1600,437,27,9,4,79,197,118,188,0,0
877,1523,243,1599,432,27,9,4,76,189,119,188,0,0
878,1521,237,1596,422,27,9,4,75,185,120,188,0,0
879,1521,235,1594,414,27,9,4,73,179,121,188,0,0
880,1520,230,1594,413,27,9,4,74,183,122,188,0,0
881,1520,223,1594,404,27,9,4,74,181,123,188,0,0
882,1521,221,1594,401,27,9,4,73,180,124,188,0,0
883,1519,220,1592,402,27,9,4,73,182,125,188,0,0
884,1517,213,1591,395,27,9,4,74,182,126,188,0,0
885,1515,212,1589,392,27,9,4,74,180,127,188,0,0
886,1514,212,1587,390,27,9,4,73,178,128,188,0,0
887,1516,213,1585,381,27,9,4,69,168,129,188,0,0
888,1516,213,1584,380,27,9,4,68,167,130,188,0,0
889,1515,213,1583,377,27,9,4,68,164,131,188,0,0
890,1513,210,1580,373,27,9,4,67,163,132,188,0,0
891,1512,210,1577,366,27,9,4,65,156,133,188,0,0
892,1513,211,1577,364,27,9,4,64,153,134,188,0,0
893,1513,210,1575,360,27,9,4,62,150,135,188,0,0
894,1513,204,1577,356,27,9,4,64,152,136,188,0,0
895,1514,203,1576,352,27,9,4,62,149,137,188,0,0
896,1510,193,1575,350,27,9,4,65,157,138,188,0,0
897,1509,187,1575,348,27,9,4,66,161,139,188,0,0
898,1509,184,1577,347,27,9,4,68,163,140,188,0,0
899,1513,185,1577,338,27,9,4,64,153,141,188,0,0
900,1516,186,1578,336,27,9,4,62,150,142,188,0,0
901,1516,184,1579,335,27,9,4,63,151,143,188,0,0
902,1515,181,1576,330,27,9,4,61,149,144,188,0,0
903,1515,179,1574,329,27,9,4,59,150,145,188,0,0
904,1517,179,1575,327,27,9,4,58,148,146,188,0,0
905,1523,181,1579,323,27,9,4,56,142,147,188,0,0
906,1524,180,1578,317,27,9,4,54,137,148,188,0,0
907,1524,179,1578,318,27,9,4,54,139,149,188,0,0
908,1523,177,1575,315,27,9,4,52,138,150,188,0,0
909,1523,174,1574,313,27,9,4,51,139,151,188,0,0
910,1526,176,1576,311,27,9,4,50,135,152,188,0,0
911,1531,178,1579,308,27,9,4,48,130,153,188,0,0
912,1535,180,1582,308,27,9,4,47,128,154,188,0,0
913,1536,181,1582,307,27,9,4,46,126,155,188,0,0
914,1538,176,1584,303,27,9,4,46,127,156,188,0,0
915,1539,170,1587,303,27,9,4,48,133,157,188,0,0
916,1541,170,1589,302,27,9,4,48,132,158,188,0,0
917,1546,171,1592,300,27,9,4,46,129,159,188,0,0
918,1550,172,1595,297,27,9,4,45,125,160,188,0,0
919,1553,172,1597,295,27,9,4,44,123,161,188,0,0
920,1555,173,1597,291,27,9,4,42,118,162,188,0,0
921,1556,168,1599,293,27,9,4,43,125,163,188,0,0
922,1559,167,1601,290,27,9,4,42,123,164,188,0,0
923,1561,166,1603,290,27,9,4,42,124,165,188,0,0
924,1565,165,1607,288,27,9,4,42,123,166,188,0,0
925,1568,164,1610,288,27,9,4,42,124,167,188,0,0
926,1570,165,1612,286,27,9,4,42,121,168,188,0,0
927,1572,159,1613,280,27,9,4,41,121,169,188,0,0
928,1574,156,1617,280,27,9,4,43,124,170,188,0,0
929,1576,156,1619,282,27,9,4,43,126,171,188,0,0
930,1579,156,1622,278,27,9,4,43,122,172,188,0,0
931,1580,157,1623,279,27,9,4,43,122,173,188,0,0
932,1581,156,1623,276,27,9,4,42,120,174,188,0,0
933,1584,158,1623,272,27,9,4,39,114,175,188,0,0
934,1586,160,1624,270,27,9,4,38,110,176,188,0,0
935,1589,161,1626,269,27,9,4,37,108,177,188,0,0
936,1591,159,1628,267,27,9,4,37,108,178,188,0,0
937,1593,157,1630,266,27,9,4,37,109,179,188,0,0
938,1595,157,1632,264,27,9,4,37,107,180,188,0,0
939,1595,155,1631,258,27,9,4,36,103,181,188,0,0
940,1597,157,1633,261,27,9,4,36,104,182,188,0,0
941,1600,157,1636,260,27,9,4,36,103,183,188,0,0
942,1602,156,1637,258,27,9,4,35,102,184,188,0,0
943,1605,152,1642,258,27,9,4,37,106,185,188,0,0
944,1608,156,1644,257,27,9,4,36,101,186,188,0,0
945,1611,155,1648,254,27,9,4,37,99,187,188,0,0
946,1614,155,1650,253,27,9,4,36,98,188,188,1,0
756,1554,252,1596,345,28,9,4,42,93,0,4,0,0
757,1547,251,1600,368,28,9,4,53,117,1,4,0,0
758,1545,250,1602,378,28,9,4,57,128,2,4,0,0
759,1538,253,1605,403,28,9,4,67,150,3,4,0,0
760,1535,253,1607,415,28,9,4,72,162,4,4,0,0
798,729,226,768,330,29,9,4,39,104,0,3,0,0
799,729,226,767,330,29,9,4,38,104,1,3,0,0
800,729,227,767,329,29,9,4,38,102,2,3,0,0
801,730,228,767,328,29,9,4,37,100,3,3,0,0
846,1430,241,1541,503,30,9,4,111,262,0,0,0,0
863,1557,275,1601,461,31,9,4,44,186,0,0,0,0
1075,1604,154,1665,289,35,9,4,61,135,0,168,0,0
1076,1607,168,1660,286,35,9,4,53,118,1,168,0,0
1077,1610,176,1661,288,35,9,4,51,112,2,168,0,0
1078,1611,181,1660,288,35,9,4,49,107,3,168,0,0
1081,1589,173,1644,294,35,9,4,55,121,0,168,0,1
1082,1588,174,1642,296,35,9,4,54,122,1,168,0,0
1083,1588,170,1644,298,35,9,4,56,128,2,168,0,0
1084,1588,171,1644,299,35,9,4,56,128,3,168,0,0
1085,1589,176,1641,297,35,9,4,52,121,4,168,0,0
1086,1590,178,1645,303,35,9,4,55,125,5,168,0,0
1087,1583,181,1636,303,35,9,4,53,122,6,168,0,0
1088,1578,181,1632,304,35,9,4,54,123,7,168,0,0
1089,1577,181,1632,307,35,9,4,55,126,8,168,0,0
1090,1580,180,1634,308,35,9,4,54,128,9,168,0,0
1091,1582,180,1637,309,35,9,4,55,129,10,168,0,0
1092,1582,178,1639,314,35,9,4,57,136,11,168,0,0
1093,1584,181,1640,316,35,9,4,56,135,12,168,0,0
1094,1587,179,1642,316,35,9,4,55,137,13,168,0,0
1095,1590,177,1648,321,35,9,4,58,144,14,168,0,0
1096,1593,174,1653,325,35,9,4,60,151,15,168,0,0
1097,1600,177,1660,326,35,9,4,60,149,16,168,0,0
1098,1610,193,1665,330,35,9,4,55,137,17,168,0,0
1099,1615,195,1672,336,35,9,4,57,141,18,168,0,0
1100,1618,194,1677,341,35,9,4,59,147,19,168,0,0
1101,1618,191,1680,346,35,9,4,62,155,20,168,0,0
1102,1622,194,1683,349,35,9,4,61,155,21,168,0,0
1103,1624,197,1684,353,35,9,4,60,156,22,168,0,0
1104,1624,202,1685,358,35,9,4,61,156,23,168,0,0
1105,1622,204,1683,361,35,9,4,61,157,24,168,0,0
1106,1617,201,1681,364,35,9,4,64,163,25,168,0,0
1107,1619,206,1682,365,35,9,4,63,159,26,168,0,0
1108,1620,207,1683,367,35,9,4,63,160,27,168,0,0
1109,1619,208,1683,370,35,9,4,64,162,28,168,0,0
1110,1618,209,1684,378,35,9,4,66,169,29,168,0,0
1111,1615,209,1682,380,35,9,4,67,171,30,168,0,0
1112,1614,207,1683,385,35,9,4,69,178,31,168,0,0
1113,1614,211,1684,391,35,9,4,70,180,32,168,0,0
1114,1614,213,1684,393,35,9,4,70,180,33,168,0,0
1115,1613,215,1684,397,35,9,4,71,182,34,168,0,0
1116,1612,219,1684,404,35,9,4,72,185,35,168,0,0
1117,1607,217,1681,408,35,9,4,74,191,36,168,0,0
1118,1605,220,1682,418,35,9,4,77,198,37,168,0,0
1119,1604,223,1683,425,35,9,4,79,202,38,168,0,0
1120,1604,225,1683,427,35,9,4,79,202,39,168,0,0
1121,1604,229,1684,435,35,9,4,80,206,40,168,0,0
1122,1601,231,1683,442,35,9,4,82,211,41,168,0,0
1123,1597,231,1681,447,35,9,4,84,216,42,168,0,0
1124,1593,231,1681,455,35,9,4,88,224,43,168,0,0
1125,1590,236,1677,454,35,9,4,87,218,44,168,0,0
1126,1589,233,1679,456,35,9,4,90,223,45,168,0,0
1127,1588,238,1680,468,35,9,4,92,230,46,168,0,0
1128,1588,247,1678,471,35,9,4,90,224,47,168,0,0
1129,1584,247,1676,476,35,9,4,92,229,48,168,0,0
1130,1581,248,1678,490,35,9,4,97,242,49,168,0,0
1131,1580,259,1675,500,35,9,4,95,241,50,168,0,0
1132,1580,262,1674,504,35,9,4,94,242,51,168,0,0
1133,1580,261,1675,508,35,9,4,95,247,52,168,0,0
1134,1578,262,1675,518,35,9,4,97,256,53,168,0,0
1135,1581,267,1676,520,35,9,4,95,253,54,168,0,0
1136,1580,272,1672,518,35,9,4,92,246,55,168,0,0
1137,1572,275,1663,517,35,9,4,91,242,56,168,0,0
1138,1570,278,1659,515,35,9,4,89,237,57,168,0,0
1139,1563,283,1653,525,35,9,4,90,242,58,168,0,0
1140,1562,282,1650,520,35,9,4,88,238,59,168,0,0
1141,1559,286,1644,515,35,9,4,85,229,60,168,0,0
1142,1558,286,1643,514,35,9,4,85,228,61,168,0,0
1143,1557,282,1644,518,35,9,4,87,236,62,168,0,0
1144,1551,279,1650,549,35,9,4,99,270,63,168,0,0
1145,1553,277,1650,545,35,9,4,97,268,64,168,0,0
1146,1554,277,1650,535,35,9,4,96,258,65,168,0,0
1147,1558,277,1651,523,35,9,4,93,246,66,168,0,0
1148,1551,278,1644,519,35,9,4,93,241,67,168,0,0
1149,1552,276,1647,518,35,9,4,95,242,68,168,0,0
1150,1560,271,1655,517,35,9,4,95,246,69,168,0,0
1151,1566,265,1664,516,35,9,4,98,251,70,168,0,0
1152,1568,262,1665,518,35,9,4,97,256,71,168,0,0
1153,1572,259,1668,515,35,9,4,96,256,72,168,0,0
1154,1557,259,1654,513,35,9,4,97,254,73,168,0,0
1155,1557,258,1649,504,35,9,4,92,246,74,168,0,0
1156,1549,257,1641,501,35,9,4,92,244,75,168,0,0
1157,1551,258,1639,487,35,9,4,88,229,76,168,0,0
1158,1557,257,1645,486,35,9,4,88,229,77,168,0,0
1159,1562,254,1650,483,35,9,4,88,229,78,168,0,0
1160,1567,255,1649,473,35,9,4,82,218,79,168,0,0
1161,1569,252,1650,472,35,9,4,81,220,80,168,0,0
1162,1566,249,1650,476,35,9,4,84,227,81,168,0,0
1163,1561,247,1642,468,35,9,4,81,221,82,168,0,0
1164,1552,249,1632,466,35,9,4,80,217,83,168,0,0
1165,1548,249,1627,463,35,9,4,79,214,84,168,0,0
1166,1553,247,1632,462,35,9,4,79,215,85,168,0,0
1167,1563,248,1642,459,35,9,4,79,211,86,168,0,0
1168,1565,249,1642,458,35,9,4,77,209,87,168,0,0
1169,1574,249,1647,447,35,9,4,73,198,88,168,0,0
1170,1572,248,1643,446,35,9,4,71,198,89,168,0,0
1171,1567,242,1644,454,35,9,4,77,212,90,168,0,0
1172,1561,239,1638,451,35,9,4,77,212,91,168,0,0
1173,1554,236,1633,448,35,9,4,79,212,92,168,0,0
1174,1560,238,1635,440,35,9,4,75,202,93,168,0,0
1175,1566,239,1642,442,35,9,4,76,203,94,168,0,0
1176,1567,225,1647,447,35,9,4,80,222,95,168,0,0
1177,1573,200,1659,444,35,9,4,86,244,96,168,0,0
1178,1576,218,1651,434,35,9,4,75,216,97,168,0,0
1179,1573,226,1646,433,35,9,4,73,207,98,168,0,0
1180,1570,231,1641,430,35,9,4,71,199,99,168,0,0
1181,1565,229,1637,429,35,9,4,72,200,100,168,0,0
1182,1568,230,1640,427,35,9,4,72,197,101,168,0,0
1183,1573,230,1645,426,35,9,4,72,196,102,168,0,0
1184,1576,223,1650,430,35,9,4,74,207,103,168,0,0
1185,1580,218,1651,420,35,9,4,71,202,104,168,0,0
1186,1585,217,1653,410,35,9,4,68,193,105,168,0,0
1187,1583,217,1655,426,35,9,4,72,209,106,168,0,0
1188,1584,218,1653,419,35,9,4,69,201,107,168,0,0
1189,1576,221,1644,415,35,9,4,68,194,108,168,0,0
1190,1572,218,1641,413,35,9,4,69,195,109,168,0,0
1191,1570,216,1639,412,35,9,4,69,196,110,168,0,0
1192,1571,216,1639,409,35,9,4,68,193,111,168,0,0
1193,1575,215,1643,405,35,9,4,68,190,112,168,0,0
1194,1576,215,1645,409,35,9,4,69,194,113,168,0,0
1195,1580,214,1650,414,35,9,4,70,200,114,168,0,0
1196,1587,217,1653,407,35,9,4,66,190,115,168,0,0
1197,1588,218,1653,404,35,9,4,65,186,116,168,0,0
1198,1585,222,1650,412,35,9,4,65,190,117,168,0,0
1199,1582,216,1647,409,35,9,4,65,193,118,168,0,0
1200,1577,214,1642,404,35,9,4,65,190,119,168,0,0
1201,1575,214,1638,399,35,9,4,63,185,120,168,0,0
1202,1573,213,1638,400,35,9,4,65,187,121,168,0,0
1203,1568,215,1634,409,35,9,4,66,194,122,168,0,0
1204,1569,217,1632,403,35,9,4,63,186,123,168,0,0
1205,1570,219,1630,398,35,9,4,60,179,124,168,0,0
1206,1568,221,1626,394,35,9,4,58,173,125,168,0,0
1207,1563,219,1622,394,35,9,4,59,175,126,168,0,0
1208,1561,212,1621,393,35,9,4,60,181,127,168,0,0
1209,1558,209,1620,395,35,9,4,62,186,128,168,0,0
1210,1555,205,1618,393,35,9,4,63,188,129,168,0,0
1211,1547,200,1613,397,35,9,4,66,197,130,168,0,0
1212,1541,199,1607,395,35,9,4,66,196,131,168,0,0
1213,1541,201,1606,393,35,9,4,65,192,132,168,0,0
1214,1540,203,1604,392,35,9,4,64,189,133,168,0,0
1215,1544,202,1609,390,35,9,4,65,188,134,168,0,0
1216,1552,197,1620,393,35,9,4,68,196,135,168,0,0
1217,1563,200,1629,390,35,9,4,66,190,136,168,0,0
1218,1572,197,1639,388,35,9,4,67,191,137,168,0,0
1219,1585,199,1649,380,35,9,4,64,181,138,168,0,0
1220,1592,199,1655,377,35,9,4,63,178,139,168,0,0
1221,1600,202,1659,367,35,9,4,59,165,140,168,0,0
1222,1603,199,1665,369,35,9,4,62,170,141,168,0,0
1223,1608,197,1670,370,35,9,4,62,173,142,168,0,0
1224,1613,196,1675,366,35,9,4,62,170,143,168,0,0
1225,1615,197,1675,362,35,9,4,60,165,144,168,0,0
1226,1615,202,1672,357,35,9,4,57,155,145,168,0,0
1227,1612,196,1670,352,35,9,4,58,156,146,168,0,0
1228,1611,192,1669,351,35,9,4,58,159,147,168,0,0
1229,1611,191,1668,345,35,9,4,57,154,148,168,0,0
1230,1612,187,1667,338,35,9,4,55,151,149,168,0,0
1231,1610,185,1665,335,35,9,4,55,150,150,168,0,0
1232,1604,182,1659,333,35,9,4,55,151,151,168,0,0
1233,1601,181,1655,327,35,9,4,54,146,152,168,0,0
1234,1600,180,1654,326,35,9,4,54,146,153,168,0,0
1235,1601,180,1654,322,35,9,4,53,142,154,168,0,0
1236,1600,180,1651,317,35,9,4,51,137,155,168,0,0
1237,1599,179,1650,315,35,9,4,51,136,156,168,0,0
1238,1598,177,1648,313,35,9,4,50,136,157,168,0,0
1239,1598,175,1648,310,35,9,4,50,135,158,168,0,0
1240,1600,174,1649,309,35,9,4,49,135,159,168,0,0
1241,1601,173,1651,308,35,9,4,50,135,160,168,0,0
1242,1601,172,1650,305,35,9,4,49,133,161,168,0,0
1243,1603,174,1652,304,35,9,4,49,130,162,168,0,0
1244,1604,174,1651,301,35,9,4,47,127,163,168,0,0
1245,1607,174,1655,303,35,9,4,48,129,164,168,0,0
1246,1614,179,1658,301,35,9,4,44,122,165,168,0,0
1247,1619,179,1663,301,35,9,4,44,122,166,168,0,0
1248,1622,180,1665,301,35,9,4,43,121,167,168,0,0
1249,1624,180,1666,300,35,9,4,42,120,168,168,1,0
1254,1628,172,1669,290,35,9,4,41,118,0,168,0,0
1255,1629,171,1670,288,35,9,4,41,117,1,168,0,0
1216,1534,194,1575,285,37,9,4,41,91,0,52,0,1
1217,1535,191,1584,299,37,9,4,49,108,1,52,0,0
1218,1529,190,1581,307,37,9,4,52,117,2,52,0,0
1219,1527,187,1578,304,37,9,4,51,117,3,52,0,0
1220,1525,190,1576,307,37,9,4,51,117,4,52,0,0
1221,1523,189,1577,315,37,9,4,54,126,5,52,0,0
1222,1521,188,1577,320,37,9,4,56,132,6,52,0,0
1223,1517,187,1575,326,37,9,4,58,139,7,52,0,0
1224,1511,186,1571,331,37,9,4,60,145,8,52,0,0
1225,1507,187,1568,338,37,9,4,61,151,9,52,0,0
1226,1507,193,1567,345,37,9,4,60,152,10,52,0,0
1227,1507,194,1567,346,37,9,4,60,152,11,52,0,0
1228,1504,196,1565,352,37,9,4,61,156,12,52,0,0
1229,1503,196,1562,348,37,9,4,59,152,13,52,0,0
1230,1502,199,1561,354,37,9,4,59,155,14,52,0,0
1231,1503,204,1562,361,37,9,4,59,157,15,52,0,0
1232,1502,204,1562,365,37,9,4,60,161,16,52,0,0
1233,1500,205,1563,377,37,9,4,63,172,17,52,0,0
1234,1498,206,1562,383,37,9,4,64,177,18,52,0,0
1235,1495,206,1562,393,37,9,4,67,187,19,52,0,0
1236,1496,212,1563,401,37,9,4,67,189,20,52,0,0
1237,1495,218,1562,408,37,9,4,67,190,21,52,0,0
1238,1493,221,1560,416,37,9,4,67,195,22,52,0,0
1239,1487,219,1559,426,37,9,4,72,207,23,52,0,0
1240,1485,225,1558,433,37,9,4,73,208,24,52,0,0
1241,1482,220,1562,449,37,9,4,80,229,25,52,0,0
1242,1481,224,1563,461,37,9,4,82,237,26,52,0,0
1243,1475,228,1560,474,37,9,4,85,246,27,52,0,0
1244,1473,233,1559,480,37,9,4,86,247,28,52,0,0
1245,1473,240,1562,497,37,9,4,89,257,29,52,0,0
1246,1473,244,1565,506,37,9,4,92,262,30,52,0,0
1247,1470,250,1568,527,37,9,4,98,277,31,52,0,0
1248,1466,256,1566,542,37,9,4,100,286,32,52,0,0
1249,1462,259,1566,553,37,9,4,104,294,33,52,0,0
1250,1459,267,1568,578,37,9,4,109,311,34,52,0,0
1251,1460,280,1568,586,37,9,4,108,306,35,52,0,0
1252,1458,293,1571,612,37,9,4,113,319,36,52,0,0
1253,1452,298,1569,626,37,9,4,117,328,37,52,0,0
1254,1447,305,1572,657,37,9,4,125,352,38,52,0,0
1255,1446,316,1577,688,37,9,4,131,372,39,52,0,0
1256,1447,324,1579,700,37,9,4,132,376,40,52,0,0
1257,1444,338,1585,741,37,9,4,141,403,41,52,0,0
1258,1437,346,1582,760,37,9,4,145,414,42,52,0,0
1259,1429,360,1585,808,37,9,4,156,448,43,52,0,0
1260,1426,377,1589,841,37,9,4,163,464,44,52,0,0
1261,1424,397,1592,870,37,9,4,168,473,45,52,0,0
1262,1417,419,1597,925,37,9,4,180,506,46,52,0,0
1263,1408,441,1592,951,37,9,4,184,510,47,52,0,0
1264,1406,462,1609,1020,37,9,4,203,558,48,52,0,0
1265,1420,492,1627,1054,37,9,4,207,562,49,52,0,0
1266,1454,517,1664,1076,37,9,4,210,559,50,52,0,0
1267,1495,558,1702,1080,37,9,4,207,522,51,52,0,0
1268,1500,574,1710,1080,37,9,4,210,506,52,52,1,0
1268,1604,610,1837,1064,38,9,4,233,454,0,1,0,0
1269,1698,660,1910,1072,38,9,4,212,412,1,1,0,0
1416,1566,155,1601,247,39,9,4,35,92,0,0,0,0
1429,1602,157,1637,253,40,9,4,35,96,0,0,0,0
1938,1579,138,1614,238,42,9,4,35,100,0,67,0,0
1939,1577,141,1612,240,42,9,4,35,99,1,67,0,0
1940,1577,140,1613,239,42,9,4,36,99,2,67,0,0
1941,1576,142,1612,241,42,9,4,36,99,3,67,0,0
1942,1573,142,1610,244,42,9,4,37,102,4,67,0,0
1943,1571,145,1608,245,42,9,4,37,100,5,67,0,0
1944,1570,146,1607,246,42,9,4,37,100,6,67,0,0
1946,1567,151,1603,248,42,9,4,36,97,0,67,0,1
1947,1565,148,1603,252,42,9,4,38,104,1,67,0,0
1948,1562,147,1601,254,42,9,4,39,107,2,67,0,0
1949,1560,147,1599,254,42,9,4,39,107,3,67,0,0
1950,1558,148,1598,255,42,9,4,40,107,4,67,0,0
1951,1560,151,1599,257,42,9,4,39,106,5,67,0,0
1952,1557,149,1598,261,42,9,4,41,112,6,67,0,0
1953,1554,148,1597,265,42,9,4,43,117,7,67,0,0
1954,1554,150,1596,266,42,9,4,42,116,8,67,0,0
1955,1553,153,1595,267,42,9,4,42,114,9,67,0,0
1956,1552,153,1594,269,42,9,4,42,116,10,67,0,0
1957,1555,154,1597,269,42,9,4,42,115,11,67,0,0
1958,1555,155,1597,270,42,9,4,42,115,12,67,0,0
1959,1554,154,1597,272,42,9,4,43,118,13,67,0,0
1960,1551,153,1595,274,42,9,4,44,121,14,67,0,0
1961,1546,153,1592,278,42,9,4,46,125,15,67,0,0
1962,1545,156,1591,282,42,9,4,46,126,16,67,0,0
1963,1541,155,1587,283,42,9,4,46,128,17,67,0,0
1964,1538,152,1585,285,42,9,4,47,133,18,67,0,0
1965,1534,149,1583,287,42,9,4,49,138,19,67,0,0
1966,1530,150,1579,289,42,9,4,49,139,20,67,0,0
1967,1528,150,1578,291,42,9,4,50,141,21,67,0,0
1970,1524,171,1569,297,42,9,4,45,126,0,67,0,1
1971,1520,172,1565,298,42,9,4,45,126,1,67,0,0
1972,1517,171,1565,304,42,9,4,48,133,2,67,0,0
1973,1517,173,1566,310,42,9,4,49,137,3,67,0,0
1974,1516,174,1566,313,42,9,4,50,139,4,67,0,0
1975,1515,175,1565,315,42,9,4,50,140,5,67,0,0
1976,1510,173,1562,318,42,9,4,52,145,6,67,0,0
1977,1507,173,1559,320,42,9,4,52,147,7,67,0,0
1978,1503,171,1558,326,42,9,4,55,155,8,67,0,0
1979,1500,172,1557,331,42,9,4,57,159,9,67,0,0
1980,1498,167,1557,332,42,9,4,59,165,10,67,0,0
1981,1494,167,1555,336,42,9,4,61,169,11,67,0,0
1982,1490,172,1550,339,42,9,4,60,167,12,67,0,0
1983,1487,175,1549,347,42,9,4,62,172,13,67,0,0
1984,1483,179,1546,355,42,9,4,63,176,14,67,0,0
1985,1480,177,1544,357,42,9,4,64,180,15,67,0,0
1986,1478,176,1544,363,42,9,4,66,187,16,67,0,0
1987,1478,189,1541,366,42,9,4,63,177,17,67,0,0
1988,1476,188,1540,368,42,9,4,64,180,18,67,0,0
1989,1473,192,1539,377,42,9,4,66,185,19,67,0,0
1990,1472,193,1539,383,42,9,4,67,190,20,67,0,0
1991,1472,192,1540,387,42,9,4,68,195,21,67,0,0
1992,1471,195,1541,395,42,9,4,70,200,22,67,0,0
1993,1469,196,1541,402,42,9,4,72,206,23,67,0,0
1994,1469,199,1541,403,42,9,4,72,204,24,67,0,0
1995,1467,200,1543,416,42,9,4,76,216,25,67,0,0
1996,1466,200,1544,423,42,9,4,78,223,26,67,0,0
1997,1463,200,1543,427,42,9,4,80,227,27,67,0,0
1998,1461,205,1541,434,42,9,4,80,229,28,67,0,0
1999,1458,211,1539,440,42,9,4,81,229,29,67,0,0
2000,1454,215,1535,446,42,9,4,81,231,30,67,0,0
2001,1448,220,1531,459,42,9,4,83,239,31,67,0,0
2002,1442,218,1528,464,42,9,4,86,246,32,67,0,0
2003,1436,218,1524,468,42,9,4,88,250,33,67,0,0
2004,1428,223,1518,477,42,9,4,90,254,34,67,0,0
2005,1415,220,1511,486,42,9,4,96,266,35,67,0,0
2006,1406,222,1508,501,42,9,4,102,279,36,67,0,0
2007,1398,233,1503,517,42,9,4,105,284,37,67,0,0
2008,1387,238,1495,528,42,9,4,108,290,38,67,0,0
2009,1381,244,1490,534,42,9,4,109,290,39,67,0,0
2010,1369,247,1481,547,42,9,4,112,300,40,67,0,0
2011,1354,251,1470,559,42,9,4,116,308,41,67,0,0
2012,1334,255,1456,577,42,9,4,122,322,42,67,0,0
2013,1314,259,1442,592,42,9,4,128,333,43,67,0,0
2014,1297,257,1429,601,42,9,4,132,344,44,67,0,0
2015,1284,260,1420,617,42,9,4,136,357,45,67,0,0
2016,1274,271,1413,635,42,9,4,139,364,46,67,0,0
2017,1253,277,1395,645,42,9,4,142,368,47,67,0,0
2018,1233,283,1385,680,42,9,4,152,397,48,67,0,0
2019,1218,284,1378,703,42,9,4,160,419,49,67,0,0
2020,1206,291,1368,717,42,9,4,162,426,50,67,0,0
2021,1191,305,1361,751,42,9,4,170,446,51,67,0,0
2022,1173,320,1349,780,42,9,4,176,460,52,67,0,0
2023,1166,333,1346,800,42,9,4,180,467,53,67,0,0
2024,1163,355,1356,858,42,9,4,193,503,54,67,0,0
2025,1160,366,1359,883,42,9,4,199,517,55,67,0,0
2026,1152,389,1359,917,42,9,4,207,528,56,67,0,0
2027,1141,414,1365,979,42,9,4,224,565,57,67,0,0
2028,1153,432,1380,999,42,9,4,227,567,58,67,0,0
2029,1167,451,1407,1055,42,9,4,240,604,59,67,0,0
2030,1190,476,1428,1075,42,9,4,238,599,60,67,0,0
2031,1209,494,1447,1080,42,9,4,238,586,61,67,0,0
2032,1225,522,1461,1080,42,9,4,236,558,62,67,0,0
2033,1247,563,1479,1080,42,9,4,232,517,63,67,0,0
2034,1298,596,1523,1080,42,9,4,225,484,64,67,0,0
2035,1354,654,1564,1080,42,9,4,210,426,65,67,0,0
2036,1425,722,1615,1077,42,9,4,190,355,66,67,0,0
2037,1450,752,1631,1080,42,9,4,181,328,67,67,1,0
2737,1857,944,1919,1080,44,9,4,62,136,0,98,0,1
2738,1848,896,1920,1079,44,9,4,72,183,1,98,0,0
2739,1830,839,1920,1076,44,9,4,90,237,2,98,0,0
2740,1814,805,1920,1071,44,9,4,106,266,3,98,0,0
2741,1803,772,1920,1068,44,9,4,117,296,4,98,0,0
2742,1791,735,1920,1070,44,9,4,129,335,5,98,0,0
2743,1785,694,1920,1064,44,9,4,135,370,6,98,0,0
2744,1777,666,1920,1067,44,9,4,143,401,7,98,0,0
2745,1773,655,1920,1067,44,9,4,147,412,8,98,0,0
2746,1775,656,1920,1069,44,9,4,145,413,9,98,0,0
2747,1777,653,1920,1061,44,9,4,143,408,10,98,0,0
2748,1778,646,1920,1062,44,9,4,142,416,11,98,0,0
2749,1778,647,1920,1071,44,9,4,142,424,12,98,0,0
2750,1779,639,1920,1076,44,9,4,141,437,13,98,0,0
2751,1773,619,1920,1076,44,9,4,147,457,14,98,0,0
2752,1783,645,1920,1076,44,9,4,137,431,15,98,0,0
2753,1789,644,1920,1073,44,9,4,131,429,16,98,0,0
2754,1791,639,1920,1076,44,9,4,129,437,17,98,0,0
2755,1798,650,1920,1050,44,9,4,122,400,18,98,0,0
2756,1796,639,1920,1048,44,9,4,124,409,19,98,0,0
2758,1795,662,1920,1072,44,9,4,125,410,0,98,0,0
2759,1799,658,1920,1060,44,9,4,121,402,1,98,0,0
2760,1797,651,1920,1059,44,9,4,123,408,2,98,0,0
2769,1796,656,1920,1066,44,9,4,124,410,0,98,0,0
2770,1795,654,1920,1066,44,9,4,125,412,1,98,0,0
2771,1795,666,1920,1071,44,9,4,125,405,2,98,0,0
2772,1795,670,1920,1073,44,9,4,125,403,3,98,0,0
2773,1795,672,1920,1074,44,9,4,125,402,4,98,0,0
2774,1797,674,1920,1066,44,9,4,123,392,5,98,0,0
2775,1797,671,1920,1071,44,9,4,123,400,6,98,0,0
2776,1796,671,1920,1071,44,9,4,124,400,7,98,0,0
2781,1798,668,1920,1069,44,9,4,122,401,0,98,0,0
2782,1798,666,1920,1069,44,9,4,122,403,1,98,0,0
2783,1802,663,1920,1057,44,9,4,118,394,2,98,0,0
2784,1806,673,1920,1052,44,9,4,114,379,3,98,0,0
2785,1801,669,1920,1066,44,9,4,119,397,4,98,0,0
2786,1800,661,1920,1071,44,9,4,120,410,5,98,0,0
2787,1799,655,1920,1075,44,9,4,121,420,6,98,0,0
2788,1803,659,1920,1059,44,9,4,117,400,7,98,0,0
2789,1801,654,1920,1070,44,9,4,119,416,8,98,0,0
2790,1801,662,1920,1073,44,9,4,119,411,9,98,0,0
2791,1801,661,1920,1073,44,9,4,119,412,10,98,0,0
2801,1796,650,1920,1080,44,9,4,124,430,0,98,0,0
2802,1803,662,1917,1052,44,9,4,114,390,1,98,0,0
2803,1803,663,1917,1050,44,9,4,114,387,2,98,0,0
2804,1801,661,1920,1071,44,9,4,119,410,3,98,0,0
2805,1800,655,1920,1065,44,9,4,120,410,4,98,0,0
2806,1804,638,1920,1074,44,9,4,116,436,5,98,0,0
2807,1801,586,1920,1078,44,9,4,119,492,6,98,0,0
2808,1801,568,1920,1079,44,9,4,119,511,7,98,0,0
2809,1800,560,1920,1080,44,9,4,120,520,8,98,0,0
2810,1806,614,1920,1078,44,9,4,114,464,9,98,0,0
2811,1812,650,1920,1077,44,9,4,108,427,10,98,0,0
2812,1813,661,1920,1075,44,9,4,107,414,11,98,0,0
2813,1814,663,1920,1075,44,9,4,106,412,12,98,0,0
2821,1820,666,1920,1061,44,9,4,100,395,0,98,0,0
2822,1820,664,1920,1074,44,9,4,100,410,1,98,0,0
2823,1820,663,1920,1074,44,9,4,100,411,2,98,0,0
2824,1821,663,1920,1077,44,9,4,99,414,3,98,0,0
2825,1820,663,1920,1072,44,9,4,100,409,4,98,0,0
2826,1820,659,1920,1077,44,9,4,100,418,5,98,0,0
2827,1818,661,1920,1078,44,9,4,102,417,6,98,0,0
2828,1816,657,1919,1079,44,9,4,103,422,7,98,0,0
2829,1814,656,1918,1080,44,9,4,104,424,8,98,0,0
2830,1813,656,1918,1080,44,9,4,105,424,9,98,0,0
2840,1813,665,1916,1080,44,9,4,103,415,0,98,0,0
2841,1812,666,1916,1080,44,9,4,104,414,1,98,0,0
2846,1816,673,1918,1080,44,9,4,102,407,0,98,0,0
2847,1816,673,1919,1080,44,9,4,103,407,1,98,0,0
2848,1817,672,1919,1080,44,9,4,102,408,2,98,0,0
2849,1817,671,1919,1080,44,9,4,102,409,3,98,0,0
2850,1817,670,1920,1080,44,9,4,103,410,4,98,0,0
2851,1817,671,1920,1080,44,9,4,103,409,5,98,0,0
2855,1818,667,1920,1080,44,9,4,102,413,0,98,0,0
2856,1816,663,1920,1080,44,9,4,104,417,1,98,0,0
2857,1816,661,1920,1080,44,9,4,104,419,2,98,0,0
2858,1817,661,1920,1080,44,9,4,103,419,3,98,0,0
2859,1818,662,1920,1080,44,9,4,102,418,4,98,0,0
2860,1818,664,1920,1080,44,9,4,102,416,5,98,0,0
2861,1819,664,1920,1080,44,9,4,101,416,6,98,0,0
2862,1818,662,1920,1080,44,9,4,102,418,7,98,0,0
2863,1821,666,1920,1074,44,9,4,99,408,8,98,0,0
2864,1821,666,1920,1074,44,9,4,99,408,9,98,0,0
2869,1786,539,1914,1054,44,9,4,128,515,0,98,0,1
2870,1771,529,1909,1065,44,9,4,138,536,1,98,0,0
2871,1756,521,1901,1065,44,9,4,145,544,2,98,0,0
2872,1748,519,1900,1070,44,9,4,152,551,3,98,0,0
2873,1740,514,1898,1070,44,9,4,158,556,4,98,0,0
2874,1733,519,1897,1075,44,9,4,164,556,5,98,0,0
2875,1729,521,1897,1076,44,9,4,168,555,6,98,0,0
2876,1728,521,1898,1067,44,9,4,170,546,7,98,0,0
2877,1730,526,1900,1061,44,9,4,170,535,8,98,0,0
2878,1730,527,1903,1066,44,9,4,173,539,9,98,0,0
2879,1734,534,1908,1067,44,9,4,174,533,10,98,0,0
2880,1739,538,1912,1066,44,9,4,173,528,11,98,0,0
2881,1738,530,1912,1056,44,9,4,174,526,12,98,0,0
2882,1736,528,1912,1056,44,9,4,176,528,13,98,0,0
2883,1736,527,1913,1056,44,9,4,177,529,14,98,0,0
2884,1736,528,1914,1056,44,9,4,178,528,15,98,0,0
2885,1734,529,1914,1059,44,9,4,180,530,16,98,0,0
2886,1733,531,1915,1066,44,9,4,182,535,17,98,0,0
2887,1733,532,1916,1069,44,9,4,183,537,18,98,0,0
2888,1733,533,1917,1071,44,9,4,184,538,19,98,0,0
2889,1733,533,1916,1068,44,9,4,183,535,20,98,0,0
2890,1732,534,1915,1065,44,9,4,183,531,21,98,0,0
2891,1733,534,1915,1059,44,9,4,182,525,22,98,0,0
2892,1733,534,1915,1059,44,9,4,182,525,23,98,0,0
2893,1733,534,1915,1056,44,9,4,182,522,24,98,0,0
2894,1733,536,1916,1057,44,9,4,183,521,25,98,0,0
2895,1733,535,1917,1058,44,9,4,184,523,26,98,0,0
2896,1733,535,1918,1061,44,9,4,185,526,27,98,0,0
2897,1733,534,1918,1061,44,9,4,185,527,28,98,0,0
2898,1734,535,1919,1061,44,9,4,185,526,29,98,0,0
2899,1735,536,1920,1061,44,9,4,185,525,30,98,0,0
2900,1734,536,1919,1061,44,9,4,185,525,31,98,0,0
2901,1734,537,1919,1063,44,9,4,185,526,32,98,0,0
2902,1733,537,1918,1062,44,9,4,185,525,33,98,0,0
2903,1727,539,1914,1065,44,9,4,187,526,34,98,0,0
2904,1727,537,1915,1065,44,9,4,188,528,35,98,0,0
2905,1726,536,1917,1072,44,9,4,191,536,36,98,0,0
2906,1724,532,1917,1074,44,9,4,193,542,37,98,0,0
2907,1723,529,1917,1072,44,9,4,194,543,38,98,0,0
2908,1733,530,1920,1068,44,9,4,187,538,39,98,0,0
2909,1744,541,1920,1067,44,9,4,176,526,40,98,0,0
2910,1768,606,1920,1047,44,9,4,152,441,41,98,0,0
2911,1781,628,1920,1050,44,9,4,139,422,42,98,0,0
2912,1785,654,1920,1055,44,9,4,135,401,43,98,0,0
2913,1785,657,1920,1064,44,9,4,135,407,44,98,0,0
2914,1788,668,1920,1065,44,9,4,132,397,45,98,0,0
2923,1795,641,1920,1076,44,9,4,125,435,0,98,0,0
2924,1797,642,1920,1078,44,9,4,123,436,1,98,0,0
2925,1800,664,1920,1076,44,9,4,120,412,2,98,0,0
2926,1802,682,1920,1074,44,9,4,118,392,3,98,0,0
2927,1803,686,1920,1075,44,9,4,117,389,4,98,0,0
2929,1801,677,1920,1077,44,9,4,119,400,0,98,0,0
2930,1804,683,1920,1066,44,9,4,116,383,1,98,0,0
2931,1799,658,1920,1066,44,9,4,121,408,2,98,0,0
2932,1793,641,1920,1071,44,9,4,127,430,3,98,0,0
2933,1786,646,1917,1075,44,9,4,131,429,4,98,0,0
2934,1780,649,1912,1077,44,9,4,132,428,5,98,0,0
2935,1778,614,1920,1079,44,9,4,142,465,6,98,0,0
2936,1777,609,1920,1080,44,9,4,143,471,7,98,0,0
2937,1770,570,1920,1080,44,9,4,150,510,8,98,0,0
2938,1771,556,1920,1080,44,9,4,149,524,9,98,0,0
2939,1778,586,1920,1077,44,9,4,142,491,10,98,0,0
2940,1777,581,1920,1077,44,9,4,143,496,11,98,0,0
2945,1770,623,1908,1072,44,9,4,138,449,0,98,0,0
2946,1769,623,1907,1072,44,9,4,138,449,1,98,0,0
2952,1780,631,1917,1076,44,9,4,137,445,0,98,0,0
2953,1779,627,1917,1068,44,9,4,138,441,1,98,0,0
2954,1780,627,1917,1068,44,9,4,137,441,2,98,0,0
2955,1775,617,1915,1064,44,9,4,140,447,3,98,0,0
2956,1778,590,1920,1069,44,9,4,142,479,4,98,0,0
2957,1780,595,1920,1064,44,9,4,140,469,5,98,0,0
2958,1780,592,1920,1063,44,9,4,140,471,6,98,0,0
2963,1797,626,1920,1047,44,9,4,123,421,0,98,0,0
2964,1800,629,1920,1053,44,9,4,120,424,1,98,0,0
2965,1798,638,1920,1066,44,9,4,122,428,2,98,0,0
2966,1799,641,1920,1066,44,9,4,121,425,3,98,0,0
2967,1801,651,1920,1071,44,9,4,119,420,4,98,0,0
2968,1801,638,1920,1070,44,9,4,119,432,5,98,0,0
2969,1802,625,1920,1068,44,9,4,118,443,6,98,0,0
2970,1803,625,1920,1069,44,9,4,117,444,7,98,0,0
2974,1797,565,1920,1071,44,9,4,123,506,0,98,0,0
2975,1796,560,1920,1072,44,9,4,124,512,1,98,0,0
2977,1800,574,1920,1066,44,9,4,120,492,0,98,0,0
2978,1801,582,1920,1069,44,9,4,119,487,1,98,0,0
2979,1801,583,1920,1073,44,9,4,119,490,2,98,0,0
2980,1801,581,1920,1074,44,9,4,119,493,3,98,0,0
3001,1807,564,1920,1063,44,9,4,113,499,0,98,0,1
3002,1808,569,1920,1067,44,9,4,112,498,1,98,0,0
3003,1808,568,1920,1067,44,9,4,112,499,2,98,0,0
3004,1806,552,1920,1067,44,9,4,114,515,3,98,0,0
3005,1805,556,1920,1071,44,9,4,115,515,4,98,0,0
3006,1811,559,1920,1044,44,9,4,109,485,5,98,0,0
3007,1809,557,1920,1061,44,9,4,111,504,6,98,0,0
3008,1808,558,1920,1069,44,9,4,112,511,7,98,0,0
3009,1808,559,1920,1070,44,9,4,112,511,8,98,0,0
3010,1809,559,1920,1073,44,9,4,111,514,9,98,0,0
3011,1810,557,1920,1066,44,9,4,110,509,10,98,0,0
3012,1810,558,1920,1069,44,9,4,110,511,11,98,0,0
3013,1810,554,1920,1076,44,9,4,110,522,12,98,0,0
3014,1811,559,1920,1072,44,9,4,109,513,13,98,0,0
3015,1811,560,1920,1072,44,9,4,109,512,14,98,0,0
3016,1811,568,1920,1077,44,9,4,109,509,15,98,0,0
3017,1811,569,1920,1078,44,9,4,109,509,16,98,0,0
3018,1816,581,1918,1055,44,9,4,102,474,17,98,0,0
3019,1820,588,1917,1036,44,9,4,97,448,18,98,0,0
3020,1819,591,1917,1042,44,9,4,98,451,19,98,0,0
3021,1820,594,1917,1040,44,9,4,97,446,20,98,0,0
3025,1820,628,1913,1051,44,9,4,93,423,0,98,0,0
3026,1821,644,1911,1049,44,9,4,90,405,1,98,0,0
3027,1821,662,1910,1053,44,9,4,89,391,2,98,0,0
3028,1822,669,1909,1053,44,9,4,87,384,3,98,0,0
3031,1807,592,1916,1070,44,9,4,109,478,0,98,0,1
3032,1806,580,1918,1072,44,9,4,112,492,1,98,0,0
3033,1806,618,1911,1059,44,9,4,105,441,2,98,0,0
3034,1805,647,1908,1069,44,9,4,103,422,3,98,0,0
3035,1802,656,1907,1071,44,9,4,105,415,4,98,0,0
3036,1792,655,1901,1066,44,9,4,109,411,5,98,0,0
3037,1777,655,1894,1069,44,9,4,117,414,6,98,0,0
3038,1776,651,1898,1068,44,9,4,122,417,7,98,0,0
3039,1788,651,1902,1033,44,9,4,114,382,8,98,0,0
3040,1791,642,1907,1023,44,9,4,116,381,9,98,0,0
3041,1783,646,1904,1035,44,9,4,121,389,10,98,0,0
3042,1769,648,1902,1062,44,9,4,133,414,11,98,0,0
3043,1770,654,1904,1063,44,9,4,134,409,12,98,0,0
3044,1766,656,1903,1068,44,9,4,137,412,13,98,0,0
3045,1768,657,1907,1066,44,9,4,139,409,14,98,0,0
3046,1767,654,1907,1060,44,9,4,140,406,15,98,0,0
3047,1767,650,1909,1058,44,9,4,142,408,16,98,0,0
3048,1766,645,1911,1056,44,9,4,145,411,17,98,0,0
3049,1766,619,1919,1058,44,9,4,153,439,18,98,0,0
3050,1765,626,1919,1064,44,9,4,154,438,19,98,0,0
3051,1764,631,1915,1061,44,9,4,151,430,20,98,0,0
3052,1761,645,1911,1065,44,9,4,150,420,21,98,0,0
3053,1758,646,1910,1066,44,9,4,152,420,22,98,0,0
3054,1758,653,1909,1064,44,9,4,151,411,23,98,0,0
3055,1763,650,1913,1057,44,9,4,150,407,24,98,0,0
3056,1759,650,1913,1068,44,9,4,154,418,25,98,0,0
3057,1757,649,1914,1071,44,9,4,157,422,26,98,0,0
3058,1757,650,1915,1072,44,9,4,158,422,27,98,0,0
3059,1758,651,1915,1070,44,9,4,157,419,28,98,0,0
3060,1758,651,1916,1071,44,9,4,158,420,29,98,0,0
3061,1760,654,1915,1066,44,9,4,155,412,30,98,0,0
3062,1760,654,1915,1065,44,9,4,155,411,31,98,0,0
3063,1760,654,1916,1064,44,9,4,156,410,32,98,0,0
3064,1760,653,1917,1064,44,9,4,157,411,33,98,0,0
3065,1759,652,1917,1064,44,9,4,158,412,34,98,0,0
3066,1758,648,1917,1064,44,9,4,159,416,35,98,0,0
3067,1759,645,1918,1062,44,9,4,159,417,36,98,0,0
3068,1758,646,1917,1062,44,9,4,159,416,37,98,0,0
3069,1756,652,1915,1064,44,9,4,159,412,38,98,0,0
3070,1756,654,1915,1065,44,9,4,159,411,39,98,0,0
3071,1754,649,1918,1073,44,9,4,164,424,40,98,0,0
3072,1753,648,1918,1075,44,9,4,165,427,41,98,0,0
3073,1758,644,1920,1064,44,9,4,162,420,42,98,0,0
3074,1757,646,1917,1060,44,9,4,160,414,43,98,0,0
3075,1755,647,1919,1071,44,9,4,164,424,44,98,0,0
3076,1755,650,1919,1075,44,9,4,164,425,45,98,0,0
3077,1755,652,1919,1077,44,9,4,164,425,46,98,0,0
3078,1755,651,1917,1069,44,9,4,162,418,47,98,0,0
3079,1755,649,1917,1065,44,9,4,162,416,48,98,0,0
3080,1755,649,1918,1071,44,9,4,163,422,49,98,0,0
3081,1757,651,1920,1071,44,9,4,163,420,50,98,0,0
3082,1759,651,1920,1071,44,9,4,161,420,51,98,0,0
3083,1758,652,1919,1072,44,9,4,161,420,52,98,0,0
3084,1759,654,1919,1072,44,9,4,160,418,53,98,0,0
3085,1760,657,1918,1070,44,9,4,158,413,54,98,0,0
3086,1758,656,1916,1070,44,9,4,158,414,55,98,0,0
3087,1756,656,1915,1070,44,9,4,159,414,56,98,0,0
3088,1755,657,1914,1070,44,9,4,159,413,57,98,0,0
3089,1755,657,1915,1071,44,9,4,160,414,58,98,0,0
3090,1759,657,1917,1066,44,9,4,158,409,59,98,0,0
3091,1756,657,1916,1070,44,9,4,160,413,60,98,0,0
3092,1756,657,1914,1066,44,9,4,158,409,61,98,0,0
3093,1762,657,1917,1057,44,9,4,155,400,62,98,0,0
3094,1763,657,1918,1056,44,9,4,155,399,63,98,0,0
3095,1766,653,1920,1053,44,9,4,154,400,64,98,0,0
3096,1763,656,1917,1052,44,9,4,154,396,65,98,0,0
3097,1762,657,1916,1051,44,9,4,154,394,66,98,0,0
3098,1761,656,1916,1052,44,9,4,155,396,67,98,0,0
3099,1760,656,1916,1054,44,9,4,156,398,68,98,0,0
3100,1759,656,1915,1054,44,9,4,156,398,69,98,0,0
3101,1750,645,1915,1065,44,9,4,165,420,70,98,0,0
3102,1746,583,1920,1052,44,9,4,174,469,71,98,0,0
3103,1742,554,1920,1061,44,9,4,178,507,72,98,0,0
3104,1732,541,1920,1073,44,9,4,188,532,73,98,0,0
3105,1726,535,1920,1077,44,9,4,194,542,74,98,0,0
3106,1720,535,1920,1073,44,9,4,200,538,75,98,0,0
3107,1713,533,1917,1076,44,9,4,204,543,76,98,0,0
3108,1713,540,1914,1075,44,9,4,201,535,77,98,0,0
3109,1708,533,1912,1069,44,9,4,204,536,78,98,0,0
3110,1706,530,1914,1073,44,9,4,208,543,79,98,0,0
3111,1706,530,1914,1075,44,9,4,208,545,80,98,0,0
3112,1714,535,1920,1074,44,9,4,206,539,81,98,0,0
3113,1718,530,1920,1074,44,9,4,202,544,82,98,0,0
3114,1719,533,1920,1075,44,9,4,201,542,83,98,0,0
3115,1712,537,1914,1072,44,9,4,202,535,84,98,0,0
3116,1718,537,1918,1072,44,9,4,200,535,85,98,0,0
3117,1712,535,1914,1071,44,9,4,202,536,86,98,0,0
3118,1712,535,1914,1068,44,9,4,202,533,87,98,0,0
3119,1712,537,1915,1074,44,9,4,203,537,88,98,0,0
3120,1713,537,1917,1075,44,9,4,204,538,89,98,0,0
3121,1721,540,1920,1075,44,9,4,199,535,90,98,0,0
3122,1730,541,1920,1061,44,9,4,190,520,91,98,0,0
3123,1745,540,1920,1068,44,9,4,175,528,92,98,0,0
3124,1742,543,1920,1073,44,9,4,178,530,93,98,0,0
3125,1762,550,1920,1060,44,9,4,158,510,94,98,0,0
3126,1782,609,1920,1073,44,9,4,138,464,95,98,0,0
3127,1800,657,1920,1071,44,9,4,120,414,96,98,0,0
3128,1811,705,1920,1068,44,9,4,109,363,97,98,0,0
3129,1818,723,1920,1068,44,9,4,102,345,98,98,1,0
3132,1822,826,1906,1072,44,9,4,84,246,0,98,0,0
3133,1827,850,1903,1073,44,9,4,76,223,1,98,0,0
3550,1657,825,1901,1070,47,9,4,244,245,0,1,0,0
3552,1611,745,1920,1075,47,9,4,309,330,0,1,0,0
3553,1606,724,1920,1076,47,9,4,314,352,1,1,0,0
3554,1760,740,1917,1080,48,9,4,157,340,0,7,0,0
3555,1761,705,1920,1077,48,9,4,159,372,1,7,0,0
3556,1760,685,1920,1079,48,9,4,160,394,2,7,0,0
3557,1775,690,1920,1072,48,9,4,145,382,3,7,0,0
3558,1779,682,1920,1070,48,9,4,141,388,4,7,0,0
3561,1801,718,1920,1064,48,9,4,119,346,0,7,0,0
3562,1790,681,1920,1072,48,9,4,130,391,1,7,0,0
3563,1796,678,1920,1068,48,9,4,124,390,2,7,0,0
3564,1795,650,1920,1071,48,9,4,125,421,3,7,0,0
3565,1802,670,1920,1072,48,9,4,118,402,4,7,0,0
3566,1809,685,1920,1075,48,9,4,111,390,5,7,0,0
3567,1828,776,1920,1078,48,9,4,92,302,6,7,0,0
3568,1832,785,1920,1079,48,9,4,88,294,7,7,0,0
3592,1839,844,1920,1075,48,9,4,81,231,0,7,0,0
3593,1840,846,1919,1074,48,9,4,79,228,1,7,0,0
3594,1840,845,1919,1074,48,9,4,79,229,2,7,0,0
3595,1840,847,1919,1074,48,9,4,79,227,3,7,0,0
3657,1713,741,1914,1080,49,9,4,201,339,0,3,0,0
3658,1684,786,1859,1079,49,9,4,175,293,1,3,0,0
3659,1698,862,1832,1078,49,9,4,134,216,2,3,0,0
3660,1703,902,1811,1077,49,9,4,108,175,3,3,0,0
3658,1811,835,1920,1080,50,9,4,109,245,0,0,0,0
3818,1840,901,1919,1077,51,9,4,79,176,0,0,0,0
3891,1868,864,1920,1080,52,9,4,52,216,0,1,0,0
3892,1868,864,1919,1079,52,9,4,51,215,1,1,0,0
4130,1549,141,1595,242,54,9,4,46,101,0,77,0,0
4131,1547,141,1594,243,54,9,4,47,102,1,77,0,0
4132,1548,140,1596,245,54,9,4,48,105,2,77,0,0
4133,1548,143,1596,246,54,9,4,48,103,3,77,0,0
4134,1545,141,1595,249,54,9,4,50,108,4,77,0,0
4135,1546,143,1594,248,54,9,4,48,105,5,77,0,0
4136,1543,141,1593,251,54,9,4,50,110,6,77,0,0
4137,1542,140,1593,253,54,9,4,51,113,7,77,0,0
4138,1544,144,1593,253,54,9,4,49,109,8,77,0,0
4139,1543,144,1593,254,54,9,4,50,110,9,77,0,0
4140,1542,146,1591,256,54,9,4,49,110,10,77,0,0
4141,1541,147,1590,257,54,9,4,49,110,11,77,0,0
4142,1537,145,1588,260,54,9,4,51,115,12,77,0,0
4143,1536,146,1588,262,54,9,4,52,116,13,77,0,0
4146,1536,151,1588,270,54,9,4,52,119,0,77,0,1
4147,1535,152,1587,272,54,9,4,52,120,1,77,0,0
4148,1528,149,1582,275,54,9,4,54,126,2,77,0,0
4149,1529,152,1582,277,54,9,4,53,125,3,77,0,0
4150,1527,151,1581,280,54,9,4,54,129,4,77,0,0
4151,1526,149,1581,283,54,9,4,55,134,5,77,0,0
4152,1521,148,1578,287,54,9,4,57,139,6,77,0,0
4153,1518,150,1575,290,54,9,4,57,140,7,77,0,0
4154,1515,147,1576,293,54,9,4,61,146,8,77,0,0
4155,1512,148,1574,295,54,9,4,62,147,9,77,0,0
4156,1510,147,1573,296,54,9,4,63,149,10,77,0,0
4157,1506,147,1569,297,54,9,4,63,150,11,77,0,0
4158,1503,152,1563,299,54,9,4,60,147,12,77,0,0
4159,1499,150,1562,304,54,9,4,63,154,13,77,0,0
4160,1497,153,1559,308,54,9,4,62,155,14,77,0,0
4161,1494,153,1557,311,54,9,4,63,158,15,77,0,0
4162,1491,151,1555,314,54,9,4,64,163,16,77,0,0
4163,1491,151,1555,318,54,9,4,64,167,17,77,0,0
4164,1491,160,1551,321,54,9,4,60,161,18,77,0,0
4165,1489,165,1549,326,54,9,4,60,161,19,77,0,0
4166,1488,166,1549,331,54,9,4,61,165,20,77,0,0
4167,1487,163,1551,334,54,9,4,64,171,21,77,0,0
4168,1488,164,1552,335,54,9,4,64,171,22,77,0,0
4169,1487,173,1549,340,54,9,4,62,167,23,77,0,0
4170,1485,179,1545,341,54,9,4,60,162,24,77,0,0
4171,1479,178,1544,352,54,9,4,65,174,25,77,0,0
4172,1476,176,1543,358,54,9,4,67,182,26,77,0,0
4173,1475,173,1543,360,54,9,4,68,187,27,77,0,0
4174,1472,174,1542,365,54,9,4,70,191,28,77,0,0
4175,1471,186,1538,369,54,9,4,67,183,29,77,0,0
4176,1468,181,1537,373,54,9,4,69,192,30,77,0,0
4177,1465,186,1535,379,54,9,4,70,193,31,77,0,0
4178,1466,193,1534,384,54,9,4,68,191,32,77,0,0
4179,1464,188,1535,390,54,9,4,71,202,33,77,0,0
4180,1463,195,1534,398,54,9,4,71,203,34,77,0,0
4181,1460,198,1533,405,54,9,4,73,207,35,77,0,0
4182,1454,199,1528,409,54,9,4,74,210,36,77,0,0
4183,1450,201,1525,417,54,9,4,75,216,37,77,0,0
4184,1446,200,1525,427,54,9,4,79,227,38,77,0,0
4185,1444,198,1525,431,54,9,4,81,233,39,77,0,0
4186,1441,202,1523,438,54,9,4,82,236,40,77,0,0
4187,1436,205,1520,446,54,9,4,84,241,41,77,0,0
4188,1429,203,1517,454,54,9,4,88,251,42,77,0,0
4189,1425,208,1513,463,54,9,4,88,255,43,77,0,0
4190,1422,210,1514,472,54,9,4,92,262,44,77,0,0
4191,1420,212,1514,480,54,9,4,94,268,45,77,0,0
4192,1416,220,1510,488,54,9,4,94,268,46,77,0,0
4193,1407,215,1507,499,54,9,4,100,284,47,77,0,0
4194,1401,219,1506,520,54,9,4,105,301,48,77,0,0
4195,1395,231,1504,540,54,9,4,109,309,49,77,0,0
4196,1396,239,1506,552,54,9,4,110,313,50,77,0,0
4197,1396,244,1508,562,54,9,4,112,318,51,77,0,0
4198,1391,251,1506,579,54,9,4,115,328,52,77,0,0
4199,1380,255,1497,589,54,9,4,117,334,53,77,0,0
4200,1367,260,1490,609,54,9,4,123,349,54,77,0,0
4201,1358,266,1486,627,54,9,4,128,361,55,77,0,0
4202,1353,268,1485,642,54,9,4,132,374,56,77,0,0
4203,1341,279,1477,661,54,9,4,136,382,57,77,0,0
4204,1324,288,1463,682,54,9,4,139,394,58,77,0,0
4205,1298,287,1446,703,54,9,4,148,416,59,77,0,0
4206,1271,297,1429,739,54,9,4,158,442,60,77,0,0
4207,1253,301,1421,769,54,9,4,168,468,61,77,0,0
4208,1248,311,1417,781,54,9,4,169,470,62,77,0,0
4209,1232,334,1408,824,54,9,4,176,490,63,77,0,0
4210,1213,352,1393,856,54,9,4,180,504,64,77,0,0
4211,1182,354,1372,880,54,9,4,190,526,65,77,0,0
4212,1151,378,1359,949,54,9,4,208,571,66,77,0,0
4213,1143,402,1357,984,54,9,4,214,582,67,77,0,0
4214,1132,410,1354,1012,54,9,4,222,602,68,77,0,0
4215,1113,447,1339,1055,54,9,4,226,608,69,77,0,0
4216,1076,475,1302,1073,54,9,4,226,598,70,77,0,0
4217,1030,503,1260,1080,54,9,4,230,577,71,77,0,0
4218,990,563,1210,1080,54,9,4,220,517,72,77,0,0
4219,964,621,1174,1080,54,9,4,210,459,73,77,0,0
4220,920,694,1114,1079,54,9,4,194,385,74,77,0,0
4221,820,788,998,1080,54,9,4,178,292,75,77,0,0
4222,699,840,871,1079,54,9,4,172,239,76,77,0,0
4223,655,883,804,1080,54,9,4,149,197,77,77,1,0
464,3,625,170,1058,1,9,5,167,433,0,0,0,0
465,9,453,441,1074,2,9,5,432,621,0,18,0,0
466,41,438,475,1067,2,9,5,434,629,1,18,0,0
467,144,414,593,1070,2,9,5,449,656,2,18,0,0
468,285,418,731,1077,2,9,5,446,659,3,18,0,0
469,397,410,835,1071,2,9,5,438,661,4,18,0,0
470,552,393,992,1066,2,9,5,440,673,5,18,0,0
471,651,390,1090,1066,2,9,5,439,676,6,18,0,0
472,776,381,1199,1055,2,9,5,423,674,7,18,0,0
473,869,372,1284,1044,2,9,5,415,672,8,18,0,0
474,989,380,1373,1021,2,9,5,384,641,9,18,0,0
475,1112,366,1475,991,2,9,5,363,625,10,18,0,0
476,1227,356,1540,910,2,9,5,313,554,11,18,0,0
477,1327,339,1576,789,2,9,5,249,450,12,18,0,0
478,1385,320,1605,726,2,9,5,220,406,13,18,0,0
479,1466,332,1622,613,2,9,5,156,281,14,18,0,0
480,1504,325,1659,596,2,9,5,155,271,15,18,0,0
481,1525,315,1690,599,2,9,5,165,284,16,18,0,0
482,1526,317,1729,664,2,9,5,203,347,17,18,0,0
483,1578,312,1778,652,2,9,5,200,340,18,18,0,0
486,1637,299,1845,664,2,9,5,208,365,0,18,0,0
487,1678,294,1885,657,2,9,5,207,363,1,18,0,0
490,1709,282,1920,685,2,9,5,211,403,0,18,0,0
491,1735,287,1920,652,2,9,5,185,365,1,18,0,0
492,1766,284,1920,647,2,9,5,154,363,2,18,0,0
493,1771,294,1920,673,2,9,5,149,379,3,18,0,0
494,1791,298,1920,695,2,9,5,129,397,4,18,0,0
495,1807,300,1920,690,2,9,5,113,390,5,18,0,0
496,1823,311,1920,641,2,9,5,97,330,6,18,0,0
497,1847,310,1920,637,2,9,5,73,327,7,18,0,0
468,9,678,350,1077,3,9,5,341,399,0,4,0,0
469,0,639,367,1079,3,9,5,367,440,1,4,0,0
470,68,612,461,1077,3,9,5,393,465,2,4,0,0
471,205,594,607,1071,3,9,5,402,477,3,4,0,0
472,266,578,680,1068,3,9,5,414,490,4,4,0,0
472,535,545,761,1066,4,9,5,226,521,0,0,0,0
473,679,550,1049,1068,5,9,5,370,518,0,17,0,0
474,805,561,1167,1069,5,9,5,362,508,1,17,0,0
475,862,523,1251,1073,5,9,5,389,550,2,17,0,0
476,912,518,1305,1069,5,9,5,393,551,3,17,0,0
477,1037,486,1449,1067,5,9,5,412,581,4,17,0,0
478,1132,456,1560,1068,5,9,5,428,612,5,17,0,0
479,1189,407,1646,1068,5,9,5,457,661,6,17,0,0
480,1296,442,1721,1064,5,9,5,425,622,7,17,0,0
481,1369,436,1787,1056,5,9,5,418,620,8,17,0,0
482,1431,443,1828,1044,5,9,5,397,601,9,17,0,0
483,1500,422,1867,990,5,9,5,367,568,10,17,0,0
484,1533,397,1889,958,5,9,5,356,561,11,17,0,0
485,1579,390,1907,911,5,9,5,328,521,12,17,0,0
486,1635,388,1920,891,5,9,5,285,503,13,17,0,0
487,1658,376,1920,887,5,9,5,262,511,14,17,0,0
488,1681,338,1920,830,5,9,5,239,492,15,17,0,0
489,1707,316,1920,795,5,9,5,213,479,16,17,0,0
490,1753,300,1920,772,5,9,5,167,472,17,17,0,0
491,1800,429,1916,762,6,9,5,116,333,0,1,0,0
492,1778,303,1920,748,6,9,5,142,445,1,1,0,0
497,1865,324,1920,563,7,9,5,55,239,0,0,0,0
737,1086,456,1221,611,8,9,5,135,155,0,0,0,0
3835,1799,926,1920,1080,9,9,5,121,154,0,34,0,1
3836,1729,844,1912,1076,9,9,5,183,232,1,34,0,0
3837,1646,786,1873,1076,9,9,5,227,290,2,34,0,0
3838,1534,723,1812,1075,9,9,5,278,352,3,34,0,0
3839,1412,655,1746,1075,9,9,5,334,420,4,34,0,0
3840,1327,595,1708,1073,9,9,5,381,478,5,34,0,0
3841,1280,552,1692,1070,9,9,5,412,518,6,34,0,0
3842,1250,513,1690,1071,9,9,5,440,558,7,34,0,0
3843,1232,478,1695,1070,9,9,5,463,592,8,34,0,0
3844,1242,457,1710,1069,9,9,5,468,612,9,34,0,0
3845,1247,430,1722,1069,9,9,5,475,639,10,34,0,0
3846,1271,393,1722,1017,9,9,5,451,624,11,34,0,0
3847,1298,375,1723,979,9,9,5,425,604,12,34,0,0
3848,1324,369,1725,951,9,9,5,401,582,13,34,0,0
3849,1363,358,1726,892,9,9,5,363,534,14,34,0,0
3850,1394,349,1740,870,9,9,5,346,521,15,34,0,0
3851,1417,334,1753,855,9,9,5,336,521,16,34,0,0
3852,1451,321,1757,809,9,9,5,306,488,17,34,0,0
3853,1474,317,1755,774,9,9,5,281,457,18,34,0,0
3854,1499,318,1760,746,9,9,5,261,428,19,34,0,0
3855,1532,319,1773,718,9,9,5,241,399,20,34,0,0
3856,1559,318,1792,709,9,9,5,233,391,21,34,0,0
3857,1580,315,1806,701,9,9,5,226,386,22,34,0,0
3858,1614,308,1826,678,9,9,5,212,370,23,34,0,0
3859,1643,310,1838,654,9,9,5,195,344,24,34,0,0
3860,1667,311,1855,642,9,9,5,188,331,25,34,0,0
3861,1700,311,1884,638,9,9,5,184,327,26,34,0,0
3862,1725,313,1903,633,9,9,5,178,320,27,34,0,0
3863,1752,319,1920,627,9,9,5,168,308,28,34,0,0
3864,1779,321,1920,624,9,9,5,141,303,29,34,0,0
3865,1793,328,1920,616,9,9,5,127,288,30,34,0,0
3866,1810,361,1920,612,9,9,5,110,251,31,34,0,0
3867,1839,390,1920,606,9,9,5,81,216,32,34,0,0
3868,1859,432,1920,604,9,9,5,61,172,33,34,0,0
3869,1878,445,1920,596,9,9,5,42,151,34,34,1,0
4466,1794,882,1919,1080,10,9,5,125,198,0,0,0,0
4467,1665,760,1920,1069,11,9,5,255,309,0,17,0,0
4468,1551,705,1859,1075,11,9,5,308,370,1,17,0,0
4469,1553,674,1888,1075,11,9,5,335,401,2,17,0,0
4470,1526,615,1907,1073,11,9,5,381,458,3,17,0,0
4471,1493,556,1920,1073,11,9,5,427,517,4,17,0,0
4472,1504,520,1920,1067,11,9,5,416,547,5,17,0,0
4473,1498,478,1920,1069,11,9,5,422,591,6,17,0,0
4474,1515,464,1920,1038,11,9,5,405,574,7,17,0,0
4475,1526,464,1920,1035,11,9,5,394,571,8,17,0,0
4476,1564,459,1920,984,11,9,5,356,525,9,17,0,0
4477,1614,441,1920,940,11,9,5,306,499,10,17,0,0
4478,1642,440,1920,923,11,9,5,278,483,11,17,0,0
4479,1688,436,1920,897,11,9,5,232,461,12,17,0,0
4480,1720,428,1920,856,11,9,5,200,428,13,17,0,0
4481,1740,446,1920,837,11,9,5,180,391,14,17,0,0
4482,1774,474,1920,802,11,9,5,146,328,15,17,0,0
4483,1799,456,1920,779,11,9,5,121,323,16,17,0,0
4484,1813,447,1920,758,11,9,5,107,311,17,17,0,0
4528,1882,377,1918,551,12,9,5,36,174,0,34,0,1
4529,1868,327,1917,564,12,9,5,49,237,1,34,0,0
4530,1858,307,1914,576,12,9,5,56,269,2,34,0,0
4531,1849,295,1909,579,12,9,5,60,284,3,34,0,0
4532,1827,286,1894,588,12,9,5,67,302,4,34,0,0
4533,1816,275,1889,592,12,9,5,73,317,5,34,0,0
4534,1802,259,1886,611,12,9,5,84,352,6,34,0,0
4535,1783,256,1874,623,12,9,5,91,367,7,34,0,0
4536,1765,250,1864,633,12,9,5,99,383,8,34,0,0
4537,1729,252,1837,643,12,9,5,108,391,9,34,0,0
4538,1705,258,1820,651,12,9,5,115,393,10,34,0,0
4539,1690,261,1812,666,12,9,5,122,405,11,34,0,0
4540,1659,263,1793,693,12,9,5,134,430,12,34,0,0
4541,1638,267,1778,708,12,9,5,140,441,13,34,0,0
4542,1597,270,1747,721,12,9,5,150,451,14,34,0,0
4543,1553,276,1718,751,12,9,5,165,475,15,34,0,0
4544,1526,276,1699,764,12,9,5,173,488,16,34,0,0
4545,1478,280,1670,813,12,9,5,192,533,17,34,0,0
4546,1437,287,1640,842,12,9,5,203,555,18,34,0,0
4547,1389,286,1602,854,12,9,5,213,568,19,34,0,0
4548,1309,301,1537,893,12,9,5,228,592,20,34,0,0
4549,1254,306,1489,910,12,9,5,235,604,21,34,0,0
4550,1154,311,1413,967,12,9,5,259,656,22,34,0,0
4551,1061,336,1329,1002,12,9,5,268,666,23,34,0,0
4552,972,331,1248,1021,12,9,5,276,690,24,34,0,0
4553,841,336,1136,1059,12,9,5,295,723,25,34,0,0
4554,749,344,1044,1078,12,9,5,295,734,26,34,0,0
4555,640,351,931,1080,12,9,5,291,729,27,34,0,0
4556,557,384,842,1080,12,9,5,285,696,28,34,0,0
4557,419,391,698,1080,12,9,5,279,689,29,34,0,0
4558,294,405,575,1080,12,9,5,281,675,30,34,0,0
4559,136,420,409,1080,12,9,5,273,660,31,34,0,0
4560,21,427,294,1080,12,9,5,273,653,32,34,0,0
4561,0,545,227,1080,12,9,5,227,535,33,34,0,0
4562,0,565,143,1080,12,9,5,143,515,34,34,1,0
4562,0,887,155,1080,13,9,5,155,193,0,0,0,0
5859,15,639,315,1077,14,9,5,300,438,0,31,0,1
5860,109,659,394,1074,14,9,5,285,415,1,31,0,0
5861,233,635,534,1073,14,9,5,301,438,2,31,0,0
5862,405,623,716,1068,14,9,5,311,445,3,31,0,0
5863,544,592,877,1068,14,9,5,333,476,4,31,0,0
5864,652,564,1003,1073,14,9,5,351,509,5,31,0,0
5865,767,562,1116,1073,14,9,5,349,511,6,31,0,0
5866,886,539,1246,1073,14,9,5,360,534,7,31,0,0
5867,1014,522,1384,1074,14,9,5,370,552,8,31,0,0
5868,1097,510,1471,1074,14,9,5,374,564,9,31,0,0
5869,1172,497,1543,1067,14,9,5,371,570,10,31,0,0
5870,1226,485,1596,1056,14,9,5,370,571,11,31,0,0
5871,1318,463,1668,1008,14,9,5,350,545,12,31,0,0
5872,1384,445,1723,983,14,9,5,339,538,13,31,0,0
5873,1427,439,1757,970,14,9,5,330,531,14,31,0,0
5874,1481,420,1784,913,14,9,5,303,493,15,31,0,0
5875,1510,411,1800,884,14,9,5,290,473,16,31,0,0
5876,1541,409,1815,856,14,9,5,274,447,17,31,0,0
5877,1583,386,1852,834,14,9,5,269,448,18,31,0,0
5878,1608,389,1869,828,14,9,5,261,439,19,31,0,0
5879,1643,375,1895,804,14,9,5,252,429,20,31,0,0
5880,1672,360,1909,767,14,9,5,237,407,21,31,0,0
5881,1684,358,1914,754,14,9,5,230,396,22,31,0,0
5882,1707,349,1920,734,14,9,5,213,385,23,31,0,0
5883,1732,346,1920,725,14,9,5,188,379,24,31,0,0
5884,1746,344,1920,718,14,9,5,174,374,25,31,0,0
5885,1766,338,1920,693,14,9,5,154,355,26,31,0,0
5886,1777,337,1920,674,14,9,5,143,337,27,31,0,0
5887,1795,358,1920,658,14,9,5,125,300,28,31,0,0
5888,1814,373,1920,647,14,9,5,106,274,29,31,0,0
5889,1823,379,1920,651,14,9,5,97,272,30,31,0,0
5890,1846,379,1920,638,14,9,5,74,259,31,31,1,0
267,317,109,356,224,1,9,6,39,115,0,25,0,1
268,327,106,366,224,1,9,6,39,118,1,25,0,0
269,336,110,377,233,1,9,6,41,123,2,25,0,0
270,347,107,391,238,1,9,6,44,131,3,25,0,0
271,357,110,402,241,1,9,6,45,131,4,25,0,0
272,367,113,413,245,1,9,6,46,132,5,25,0,0
273,375,111,424,252,1,9,6,49,141,6,25,0,0
274,380,113,431,262,1,9,6,51,149,7,25,0,0
275,386,113,438,264,1,9,6,52,151,8,25,0,0
276,391,118,445,273,1,9,6,54,155,9,25,0,0
277,399,116,454,276,1,9,6,55,160,10,25,0,0
278,403,116,461,283,1,9,6,58,167,11,25,0,0
279,406,118,466,290,1,9,6,60,172,12,25,0,0
280,410,117,472,295,1,9,6,62,178,13,25,0,0
281,416,121,479,302,1,9,6,63,181,14,25,0,0
282,425,120,489,306,1,9,6,64,186,15,25,0,0
283,433,124,498,313,1,9,6,65,189,16,25,0,0
284,442,127,508,320,1,9,6,66,193,17,25,0,0
285,454,126,521,325,1,9,6,67,199,18,25,0,0
286,467,133,536,334,1,9,6,69,201,19,25,0,0
287,489,132,561,340,1,9,6,72,208,20,25,0,0
288,508,136,582,347,1,9,6,74,211,21,25,0,0
289,532,138,607,354,1,9,6,75,216,22,25,0,0
290,552,139,629,358,1,9,6,77,219,23,25,0,0
291,579,142,655,362,1,9,6,76,220,24,25,0,0
292,592,144,670,367,1,9,6,78,223,25,25,1,0
292,639,141,704,363,2,9,6,65,222,0,1,0,0
293,661,157,723,367,2,9,6,62,210,1,1,0,0
294,697,155,789,369,3,9,6,92,214,0,3,0,0
295,720,162,808,367,3,9,6,88,205,1,3,0,0
296,748,172,826,355,3,9,6,78,183,2,3,0,0
297,762,177,837,350,3,9,6,75,173,3,3,0,0
415,262,132,322,328,4,9,6,60,196,0,51,0,1
416,265,130,326,327,4,9,6,61,197,1,51,0,0
417,273,128,337,335,4,9,6,64,207,2,51,0,0
418,287,131,352,339,4,9,6,65,208,3,51,0,0
419,298,131,363,338,4,9,6,65,207,4,51,0,0
420,307,134,375,349,4,9,6,68,215,5,51,0,0
421,320,135,390,351,4,9,6,70,216,6,51,0,0
422,328,136,401,357,4,9,6,73,221,7,51,0,0
423,339,136,416,367,4,9,6,77,231,8,51,0,0
424,348,137,428,375,4,9,6,80,238,9,51,0,0
425,353,138,436,380,4,9,6,83,242,10,51,0,0
426,365,142,450,382,4,9,6,85,240,11,51,0,0
427,374,141,464,396,4,9,6,90,255,12,51,0,0
428,383,144,477,404,4,9,6,94,260,13,51,0,0
429,390,150,484,403,4,9,6,94,253,14,51,0,0
430,397,154,485,384,4,9,6,88,230,15,51,0,0
431,406,155,507,416,4,9,6,101,261,16,51,0,0
432,399,160,494,407,4,9,6,95,247,17,51,0,0
433,401,158,496,404,4,9,6,95,246,18,51,0,0
434,399,163,496,416,4,9,6,97,253,19,51,0,0
435,396,168,493,422,4,9,6,97,254,20,51,0,0
436,396,166,497,433,4,9,6,101,267,21,51,0,0
437,400,170,501,438,4,9,6,101,268,22,51,0,0
438,405,176,510,450,4,9,6,105,274,23,51,0,0
439,411,175,523,463,4,9,6,112,288,24,51,0,0
440,408,183,527,489,4,9,6,119,306,25,51,0,0
441,413,188,535,501,4,9,6,122,313,26,51,0,0
442,413,189,537,509,4,9,6,124,320,27,51,0,0
443,415,200,538,518,4,9,6,123,318,28,51,0,0
444,432,200,563,529,4,9,6,131,329,29,51,0,0
445,443,208,580,545,4,9,6,137,337,30,51,0,0
446,450,221,590,560,4,9,6,140,339,31,51,0,0
447,463,223,616,588,4,9,6,153,365,32,51,0,0
448,465,231,627,620,4,9,6,162,389,33,51,0,0
449,471,241,636,640,4,9,6,165,399,34,51,0,0
450,493,242,668,655,4,9,6,175,413,35,51,0,0
451,511,250,696,681,4,9,6,185,431,36,51,0,0
452,527,267,715,698,4,9,6,188,431,37,51,0,0
453,537,274,732,721,4,9,6,195,447,38,51,0,0
454,540,293,750,779,4,9,6,210,486,39,51,0,0
455,564,313,781,812,4,9,6,217,499,40,51,0,0
456,603,321,846,866,4,9,6,243,545,41,51,0,0
457,629,349,897,942,4,9,6,268,593,42,51,0,0
458,651,366,929,976,4,9,6,278,610,43,51,0,0
459,662,391,949,1032,4,9,6,287,641,44,51,0,0
460,685,435,971,1066,4,9,6,286,631,45,51,0,0
461,763,464,1054,1074,4,9,6,291,610,46,51,0,0
462,842,511,1133,1079,4,9,6,291,568,47,51,0,0
463,916,573,1200,1080,4,9,6,284,507,48,51,0,0
464,956,626,1218,1080,4,9,6,262,454,49,51,0,0
465,1077,723,1301,1080,4,9,6,224,357,50,51,0,0
466,1124,758,1338,1080,4,9,6,214,322,51,51,1,0
430,459,166,507,291,5,9,6,48,125,0,0,0,0
431,380,170,450,391,6,9,6,70,221,0,0,0,0
432,424,166,537,448,7,9,6,113,282,0,33,0,1
433,446,168,559,451,7,9,6,113,283,1,33,0,0
434,455,168,568,454,7,9,6,113,286,2,33,0,0
435,462,176,585,487,7,9,6,123,311,3,33,0,0
436,469,177,595,498,7,9,6,126,321,4,33,0,0
437,478,179,604,504,7,9,6,126,325,5,33,0,0
438,489,184,619,524,7,9,6,130,340,6,33,0,0
439,503,187,636,538,7,9,6,133,351,7,33,0,0
440,514,196,650,554,7,9,6,136,358,8,33,0,0
441,530,204,673,583,7,9,6,143,379,9,33,0,0
442,550,207,691,585,7,9,6,141,378,10,33,0,0
443,572,219,713,603,7,9,6,141,384,11,33,0,0
444,596,223,738,615,7,9,6,142,392,12,33,0,0
445,620,233,766,638,7,9,6,146,405,13,33,0,0
446,644,243,793,663,7,9,6,149,420,14,33,0,0
447,676,247,828,677,7,9,6,152,430,15,33,0,0
448,701,256,855,698,7,9,6,154,442,16,33,0,0
449,720,271,881,736,7,9,6,161,465,17,33,0,0
450,746,278,911,754,7,9,6,165,476,18,33,0,0
451,766,294,949,820,7,9,6,183,526,19,33,0,0
452,791,312,983,857,7,9,6,192,545,20,33,0,0
453,822,321,1016,872,7,9,6,194,551,21,33,0,0
454,850,347,1052,923,7,9,6,202,576,22,33,0,0
455,878,370,1090,976,7,9,6,212,606,23,33,0,0
456,929,391,1151,1026,7,9,6,222,635,24,33,0,0
457,981,423,1209,1059,7,9,6,228,636,25,33,0,0
458,1035,452,1262,1078,7,9,6,227,626,26,33,0,0
459,1085,489,1307,1080,7,9,6,222,591,27,33,0,0
460,1165,545,1375,1080,7,9,6,210,535,28,33,0,0
461,1284,583,1485,1080,7,9,6,201,497,29,33,0,0
462,1382,647,1569,1080,7,9,6,187,433,30,33,0,0
463,1508,724,1674,1079,7,9,6,166,355,31,33,0,0
464,1651,786,1801,1080,7,9,6,150,294,32,33,0,0
465,1732,826,1868,1080,7,9,6,136,254,33,33,1,0
465,1787,918,1919,1080,8,9,6,132,162,0,0,0,0
4561,1697,811,1904,1075,11,9,6,207,264,0,0,0,0
4562,1524,728,1783,1070,12,9,6,259,342,0,41,0,1
4563,1396,650,1713,1070,12,9,6,317,420,1,41,0,0
4564,1257,604,1610,1069,12,9,6,353,465,2,41,0,0
4565,1146,554,1535,1070,12,9,6,389,516,3,41,0,0
4566,1057,496,1487,1074,12,9,6,430,578,4,41,0,0
4567,966,459,1416,1075,12,9,6,450,616,5,41,0,0
4568,909,415,1380,1078,12,9,6,471,663,6,41,0,0
4569,844,380,1323,1075,12,9,6,479,695,7,41,0,0
4570,795,354,1262,1054,12,9,6,467,700,8,41,0,0
4571,782,325,1198,971,12,9,6,416,646,9,41,0,0
4572,745,307,1134,931,12,9,6,389,624,10,41,0,0
4573,722,286,1078,881,12,9,6,356,595,11,41,0,0
4574,700,268,1025,832,12,9,6,325,564,12,41,0,0
4575,672,258,983,814,12,9,6,311,556,13,41,0,0
4576,668,243,949,764,12,9,6,281,521,14,41,0,0
4577,667,234,922,725,12,9,6,255,491,15,41,0,0
4578,660,230,897,704,12,9,6,237,474,16,41,0,0
4579,650,217,867,665,12,9,6,217,448,17,41,0,0
4580,638,212,844,647,12,9,6,206,435,18,41,0,0
4581,641,207,829,615,12,9,6,188,408,19,41,0,0
4582,647,194,824,589,12,9,6,177,395,20,41,0,0
4583,651,194,818,578,12,9,6,167,384,21,41,0,0
4584,654,191,802,540,12,9,6,148,349,22,41,0,0
4585,653,182,798,526,12,9,6,145,344,23,41,0,0
4586,651,181,793,523,12,9,6,142,342,24,41,0,0
4587,661,178,791,495,12,9,6,130,317,25,41,0,0
4588,668,174,794,484,12,9,6,126,310,26,41,0,0
4589,675,171,791,463,12,9,6,116,292,27,41,0,0
4590,676,165,789,451,12,9,6,113,286,28,41,0,0
4591,679,164,790,447,12,9,6,111,283,29,41,0,0
4592,689,159,793,426,12,9,6,104,267,30,41,0,0
4593,692,155,793,415,12,9,6,101,260,31,41,0,0
4594,699,155,794,403,12,9,6,95,248,32,41,0,0
4595,701,151,794,394,12,9,6,93,243,33,41,0,0
4596,701,147,793,388,12,9,6,92,241,34,41,0,0
4597,706,147,794,384,12,9,6,88,237,35,41,0,0
4598,709,144,795,376,12,9,6,86,232,36,41,0,0
4599,712,140,796,371,12,9,6,84,231,37,41,0,0
4600,713,140,794,363,12,9,6,81,223,38,41,0,0
4601,711,140,789,358,12,9,6,78,218,39,41,0,0
4602,709,141,785,356,12,9,6,76,215,40,41,0,0
4603,709,138,783,347,12,9,6,74,209,41,41,1,0
5793,747,182,794,301,15,9,6,47,119,0,66,0,1
5794,744,180,787,288,15,9,6,43,108,1,66,0,0
5795,742,171,794,301,15,9,6,52,130,2,66,0,0
5796,744,168,797,304,15,9,6,53,136,3,66,0,0
5797,748,166,803,305,15,9,6,55,139,4,66,0,0
5798,754,164,809,305,15,9,6,55,141,5,66,0,0
5799,757,160,813,305,15,9,6,56,145,6,66,0,0
5800,759,159,815,305,15,9,6,56,146,7,66,0,0
5801,758,157,815,309,15,9,6,57,152,8,66,0,0
5802,757,152,815,311,15,9,6,58,159,9,66,0,0
5803,757,148,813,307,15,9,6,56,159,10,66,0,0
5804,754,146,811,309,15,9,6,57,163,11,66,0,0
5805,750,147,808,315,15,9,6,58,168,12,66,0,0
5806,746,148,801,304,15,9,6,55,156,13,66,0,0
5807,737,148,795,314,15,9,6,58,166,14,66,0,0
5808,728,151,786,317,15,9,6,58,166,15,66,0,0
5809,723,153,782,321,15,9,6,59,168,16,66,0,0
5810,721,157,779,323,15,9,6,58,166,17,66,0,0
5811,722,157,780,325,15,9,6,58,168,18,66,0,0
5812,716,155,778,333,15,9,6,62,178,19,66,0,0
5813,709,156,774,343,15,9,6,65,187,20,66,0,0
5814,704,156,770,347,15,9,6,66,191,21,66,0,0
5815,697,154,769,358,15,9,6,72,204,22,66,0,0
5816,693,159,767,365,15,9,6,74,206,23,66,0,0
5817,689,162,764,368,15,9,6,75,206,24,66,0,0
5818,686,164,765,378,15,9,6,79,214,25,66,0,0
5819,679,166,760,385,15,9,6,81,219,26,66,0,0
5820,676,168,758,388,15,9,6,82,220,27,66,0,0
5821,669,172,752,397,15,9,6,83,225,28,66,0,0
5822,660,173,745,403,15,9,6,85,230,29,66,0,0
5823,652,178,738,408,15,9,6,86,230,30,66,0,0
5824,639,183,727,419,15,9,6,88,236,31,66,0,0
5825,630,181,719,423,15,9,6,89,242,32,66,0,0
5826,623,188,715,438,15,9,6,92,250,33,66,0,0
5827,622,192,718,451,15,9,6,96,259,34,66,0,0
5828,625,193,721,454,15,9,6,96,261,35,66,0,0
5829,624,199,724,471,15,9,6,100,272,36,66,0,0
5830,622,203,724,480,15,9,6,102,277,37,66,0,0
5831,625,208,728,491,15,9,6,103,283,38,66,0,0
5832,636,218,737,495,15,9,6,101,277,39,66,0,0
5833,639,220,747,515,15,9,6,108,295,40,66,0,0
5834,637,225,752,536,15,9,6,115,311,41,66,0,0
5835,636,235,754,555,15,9,6,118,320,42,66,0,0
5836,647,239,768,573,15,9,6,121,334,43,66,0,0
5837,659,246,783,595,15,9,6,124,349,44,66,0,0
5838,670,248,799,616,15,9,6,129,368,45,66,0,0
5839,676,255,812,643,15,9,6,136,388,46,66,0,0
5840,682,270,822,669,15,9,6,140,399,47,66,0,0
5841,704,278,844,680,15,9,6,140,402,48,66,0,0
5842,719,292,863,708,15,9,6,144,416,49,66,0,0
5843,745,305,896,736,15,9,6,151,431,50,66,0,0
5844,751,319,909,753,15,9,6,158,434,51,66,0,0
5845,755,334,934,813,15,9,6,179,479,52,66,0,0
5846,776,348,960,840,15,9,6,184,492,53,66,0,0
5847,808,364,1000,876,15,9,6,192,512,54,66,0,0
5848,837,388,1037,922,15,9,6,200,534,55,66,0,0
5849,862,405,1068,946,15,9,6,206,541,56,66,0,0
5850,862,437,1090,1019,15,9,6,228,582,57,66,0,0
5851,876,463,1118,1067,15,9,6,242,604,58,66,0,0
5852,935,494,1173,1080,15,9,6,238,586,59,66,0,0
5853,987,540,1215,1080,15,9,6,228,540,60,66,0,0
5854,1052,577,1273,1080,15,9,6,221,503,61,66,0,0
5855,1075,638,1289,1080,15,9,6,214,442,62,66,0,0
5856,1148,715,1348,1080,15,9,6,200,365,63,66,0,0
5857,1261,789,1433,1080,15,9,6,172,291,64,66,0,0
5858,1387,888,1518,1080,15,9,6,131,192,65,66,0,0
5859,1454,938,1559,1080,15,9,6,105,142,66,66,1,0
467,1645,753,1901,1080,1,9,7,256,327,0,0,0,0
468,1474,684,1726,1078,2,9,7,252,394,0,0,0,0
469,1289,647,1548,1078,3,9,7,259,431,0,0,0,0
469,1626,738,1920,1071,4,9,7,294,333,0,33,0,1
470,1565,600,1920,1074,4,9,7,355,474,1,33,0,0
471,1459,550,1914,1075,4,9,7,455,525,2,33,0,0
472,1345,533,1804,1067,4,9,7,459,534,3,33,0,0
473,1174,500,1654,1065,4,9,7,480,565,4,33,0,0
474,998,489,1487,1066,4,9,7,489,577,5,33,0,0
475,859,474,1358,1069,4,9,7,499,595,6,33,0,0
476,792,427,1312,1070,4,9,7,520,643,7,33,0,0
477,713,406,1232,1065,4,9,7,519,659,8,33,0,0
478,655,400,1153,1051,4,9,7,498,651,9,33,0,0
479,519,390,1020,1059,4,9,7,501,669,10,33,0,0
480,437,375,940,1057,4,9,7,503,682,11,33,0,0
481,387,346,850,996,4,9,7,463,650,12,33,0,0
482,383,343,787,930,4,9,7,404,587,13,33,0,0
483,359,349,731,896,4,9,7,372,547,14,33,0,0
484,282,336,632,863,4,9,7,350,527,15,33,0,0
485,223,332,564,851,4,9,7,341,519,16,33,0,0
486,191,320,520,832,4,9,7,329,512,17,33,0,0
487,174,309,475,795,4,9,7,301,486,18,33,0,0
488,164,310,441,764,4,9,7,277,454,19,33,0,0
489,138,311,396,740,4,9,7,258,429,20,33,0,0
490,85,306,338,732,4,9,7,253,426,21,33,0,0
491,60,310,306,728,4,9,7,246,418,22,33,0,0
492,38,302,267,698,4,9,7,229,396,23,33,0,0
493,38,299,253,679,4,9,7,215,380,24,33,0,0
494,31,316,226,661,4,9,7,195,345,25,33,0,0
495,0,310,186,646,4,9,7,186,336,26,33,0,0
496,0,304,165,648,4,9,7,165,344,27,33,0,0
497,0,301,149,646,4,9,7,149,345,28,33,0,0
498,0,291,130,631,4,9,7,130,340,29,33,0,0
499,0,312,113,617,4,9,7,113,305,30,33,0,0
500,0,336,96,595,4,9,7,96,259,31,33,0,0
501,0,321,80,589,4,9,7,80,268,32,33,0,0
502,0,320,55,576,4,9,7,55,256,33,33,1,0
470,1124,589,1393,1074,5,9,7,269,485,0,0,0,0
471,988,562,1245,1074,6,9,7,257,512,0,0,0,0
472,859,534,1080,1073,7,9,7,221,539,0,0,0,0
473,724,511,949,1071,8,9,7,225,560,0,19,0,1
474,620,473,860,1069,8,9,7,240,596,1,19,0,0
475,531,455,780,1072,8,9,7,249,617,2,19,0,0
476,449,425,708,1069,8,9,7,259,644,3,19,0,0
477,403,432,658,1057,8,9,7,255,625,4,19,0,0
478,344,418,605,1049,8,9,7,261,631,5,19,0,0
479,255,403,516,1033,8,9,7,261,630,6,19,0,0
480,207,401,468,1026,8,9,7,261,625,7,19,0,0
481,153,385,402,981,8,9,7,249,596,8,19,0,0
482,123,387,351,927,8,9,7,228,540,9,19,0,0
483,100,386,321,901,8,9,7,221,515,10,19,0,0
484,53,370,269,869,8,9,7,216,499,11,19,0,0
485,9,366,219,853,8,9,7,210,487,12,19,0,0
486,0,366,195,846,8,9,7,195,480,13,19,0,0
487,0,352,156,807,8,9,7,156,455,14,19,0,0
488,0,353,142,783,8,9,7,142,430,15,19,0,0
489,0,394,126,767,8,9,7,126,373,16,19,0,0
490,0,402,99,742,8,9,7,99,340,17,19,0,0
491,0,411,78,731,8,9,7,78,320,18,19,0,0
492,0,413,46,712,8,9,7,46,299,19,19,0,0
503,1,380,36,558,9,9,7,35,178,0,0,0,0
3727,1609,72,1645,160,11,9,7,36,88,0,140,0,1
3728,1607,71,1644,162,11,9,7,37,91,1,140,0,0
3729,1607,70,1645,163,11,9,7,38,93,2,140,0,0
3730,1606,68,1645,163,11,9,7,39,95,3,140,0,0
3731,1605,67,1644,163,11,9,7,39,96,4,140,0,0
3732,1606,68,1644,163,11,9,7,38,95,5,140,0,0
3733,1605,68,1644,164,11,9,7,39,96,6,140,0,0
3734,1605,68,1645,165,11,9,7,40,97,7,140,0,0
3735,1606,70,1644,166,11,9,7,38,96,8,140,0,0
3736,1605,74,1642,167,11,9,7,37,93,9,140,0,0
3737,1604,73,1643,168,11,9,7,39,95,10,140,0,0
3738,1605,76,1643,169,11,9,7,38,93,11,140,0,0
3739,1605,78,1642,169,11,9,7,37,91,12,140,0,0
3740,1605,79,1642,171,11,9,7,37,92,13,140,0,0
3741,1604,80,1641,173,11,9,7,37,93,14,140,0,0
3742,1603,78,1642,175,11,9,7,39,97,15,140,0,0
3743,1602,77,1641,174,11,9,7,39,97,16,140,0,0
3744,1601,81,1639,175,11,9,7,38,94,17,140,0,0
3745,1601,80,1639,175,11,9,7,38,95,18,140,0,0
3746,1599,76,1639,178,11,9,7,40,102,19,140,0,0
3747,1599,75,1640,180,11,9,7,41,105,20,140,0,0
3748,1599,75,1640,180,11,9,7,41,105,21,140,0,0
3749,1599,76,1639,181,11,9,7,40,105,22,140,0,0
3750,1597,78,1638,183,11,9,7,41,105,23,140,0,0
3751,1596,78,1637,183,11,9,7,41,105,24,140,0,0
3752,1594,77,1636,187,11,9,7,42,110,25,140,0,0
3753,1593,77,1635,188,11,9,7,42,111,26,140,0,0
3754,1591,76,1634,190,11,9,7,43,114,27,140,0,0
3755,1590,75,1633,190,11,9,7,43,115,28,140,0,0
3756,1590,80,1631,192,11,9,7,41,112,29,140,0,0
3757,1588,79,1630,193,11,9,7,42,114,30,140,0,0
3758,1588,81,1628,194,11,9,7,40,113,31,140,0,0
3759,1586,80,1627,198,11,9,7,41,118,32,140,0,0
3760,1586,82,1626,198,11,9,7,40,116,33,140,0,0
3761,1585,85,1626,199,11,9,7,41,114,34,140,0,0
3762,1584,85,1625,201,11,9,7,41,116,35,140,0,0
3763,1583,84,1625,203,11,9,7,42,119,36,140,0,0
3764,1582,87,1625,208,11,9,7,43,121,37,140,0,0
3765,1581,85,1626,211,11,9,7,45,126,38,140,0,0
3766,1581,87,1625,210,11,9,7,44,123,39,140,0,0
3767,1580,89,1623,210,11,9,7,43,121,40,140,0,0
3768,1580,89,1624,210,11,9,7,44,121,41,140,0,0
3769,1578,89,1624,216,11,9,7,46,127,42,140,0,0
3770,1577,90,1623,220,11,9,7,46,130,43,140,0,0
3771,1575,89,1623,223,11,9,7,48,134,44,140,0,0
3772,1575,90,1623,224,11,9,7,48,134,45,140,0,0
3773,1573,90,1621,226,11,9,7,48,136,46,140,0,0
3774,1571,95,1618,227,11,9,7,47,132,47,140,0,0
3775,1568,96,1616,230,11,9,7,48,134,48,140,0,0
3776,1566,93,1614,231,11,9,7,48,138,49,140,0,0
3777,1564,90,1614,232,11,9,7,50,142,50,140,0,0
3778,1561,88,1613,236,11,9,7,52,148,51,140,0,0
3779,1559,95,1610,240,11,9,7,51,145,52,140,0,0
3780,1557,97,1607,245,11,9,7,50,148,53,140,0,0
3781,1553,98,1604,249,11,9,7,51,151,54,140,0,0
3782,1551,99,1602,252,11,9,7,51,153,55,140,0,0
3783,1547,98,1600,256,11,9,7,53,158,56,140,0,0
3784,1546,100,1599,257,11,9,7,53,157,57,140,0,0
3785,1543,103,1595,259,11,9,7,52,156,58,140,0,0
3786,1540,100,1595,265,11,9,7,55,165,59,140,0,0
3787,1539,105,1594,268,11,9,7,55,163,60,140,0,0
3788,1538,106,1593,271,11,9,7,55,165,61,140,0,0
3789,1534,109,1589,276,11,9,7,55,167,62,140,0,0
3790,1530,111,1586,281,11,9,7,56,170,63,140,0,0
3791,1526,111,1583,282,11,9,7,57,171,64,140,0,0
3792,1522,110,1581,286,11,9,7,59,176,65,140,0,0
3793,1521,111,1580,289,11,9,7,59,178,66,140,0,0
3794,1518,111,1578,294,11,9,7,60,183,67,140,0,0
3795,1514,111,1576,297,11,9,7,62,186,68,140,0,0
3796,1508,110,1571,302,11,9,7,63,192,69,140,0,0
3797,1501,110,1567,308,11,9,7,66,198,70,140,0,0
3798,1497,111,1565,316,11,9,7,68,205,71,140,0,0
3799,1494,112,1563,319,11,9,7,69,207,72,140,0,0
3800,1491,112,1559,320,11,9,7,68,208,73,140,0,0
3801,1488,112,1557,322,11,9,7,69,210,74,140,0,0
3802,1484,115,1555,331,11,9,7,71,216,75,140,0,0
3803,1478,116,1550,337,11,9,7,72,221,76,140,0,0
3804,1474,118,1547,344,11,9,7,73,226,77,140,0,0
3805,1472,120,1546,348,11,9,7,74,228,78,140,0,0
3806,1471,121,1546,355,11,9,7,75,234,79,140,0,0
3807,1467,126,1543,360,11,9,7,76,234,80,140,0,0
3808,1463,129,1539,365,11,9,7,76,236,81,140,0,0
3809,1458,132,1536,374,11,9,7,78,242,82,140,0,0
3810,1453,134,1534,382,11,9,7,81,248,83,140,0,0
3811,1446,133,1532,396,11,9,7,86,263,84,140,0,0
3812,1440,136,1528,403,11,9,7,88,267,85,140,0,0
3813,1435,139,1525,411,11,9,7,90,272,86,140,0,0
3814,1430,143,1521,418,11,9,7,91,275,87,140,0,0
3815,1427,147,1520,423,11,9,7,93,276,88,140,0,0
3816,1418,148,1516,437,11,9,7,98,289,89,140,0,0
3817,1408,149,1512,452,11,9,7,104,303,90,140,0,0
3818,1403,153,1508,457,11,9,7,105,304,91,140,0,0
3819,1394,158,1503,471,11,9,7,109,313,92,140,0,0
3820,1381,160,1493,479,11,9,7,112,319,93,140,0,0
3821,1367,161,1483,489,11,9,7,116,328,94,140,0,0
3822,1353,167,1475,511,11,9,7,122,344,95,140,0,0
3823,1341,168,1469,527,11,9,7,128,359,96,140,0,0
3824,1331,171,1463,539,11,9,7,132,368,97,140,0,0
3825,1321,183,1455,556,11,9,7,134,373,98,140,0,0
3826,1304,186,1442,565,11,9,7,138,379,99,140,0,0
3827,1289,194,1439,604,11,9,7,150,410,100,140,0,0
3828,1277,205,1431,626,11,9,7,154,421,101,140,0,0
3829,1263,213,1421,636,11,9,7,158,423,102,140,0,0
3830,1238,221,1407,672,11,9,7,169,451,103,140,0,0
3831,1216,233,1389,692,11,9,7,173,459,104,140,0,0
3832,1195,245,1373,707,11,9,7,178,462,105,140,0,0
3833,1169,268,1358,755,11,9,7,189,487,106,140,0,0
3834,1150,284,1343,785,11,9,7,193,501,107,140,0,0
3835,1125,287,1320,791,11,9,7,195,504,108,140,0,0
3836,1080,306,1284,828,11,9,7,204,522,109,140,0,0
3837,1046,312,1255,850,11,9,7,209,538,110,140,0,0
3838,1000,321,1217,885,11,9,7,217,564,111,140,0,0
3839,939,328,1167,924,11,9,7,228,596,112,140,0,0
3840,886,340,1113,936,11,9,7,227,596,113,140,0,0
3841,831,352,1053,940,11,9,7,222,588,114,140,0,0
3842,770,367,992,938,11,9,7,222,571,115,140,0,0
3843,718,376,951,952,11,9,7,233,576,116,140,0,0
3844,630,374,860,947,11,9,7,230,573,117,140,0,0
3845,557,385,793,961,11,9,7,236,576,118,140,0,0
3846,506,396,747,961,11,9,7,241,565,119,140,0,0
3847,424,401,666,960,11,9,7,242,559,120,140,0,0
3848,355,405,594,952,11,9,7,239,547,121,140,0,0
3849,305,405,553,956,11,9,7,248,551,122,140,0,0
3850,236,408,472,938,11,9,7,236,530,123,140,0,0
3851,192,417,418,922,11,9,7,226,505,124,140,0,0
3852,153,422,379,913,11,9,7,226,491,125,140,0,0
3853,95,414,320,900,11,9,7,225,486,126,140,0,0
3854,40,417,256,888,11,9,7,216,471,127,140,0,0
3855,13,423,225,885,11,9,7,212,462,128,140,0,0
3856,0,408,175,860,11,9,7,175,452,129,140,0,0
3857,0,413,156,839,11,9,7,156,426,130,140,0,0
3858,0,433,144,832,11,9,7,144,399,131,140,0,0
3859,0,433,125,803,11,9,7,125,370,132,140,0,0
3860,0,434,100,798,11,9,7,100,364,133,140,0,0
3861,0,433,89,792,11,9,7,89,359,134,140,0,0
3862,0,425,72,750,11,9,7,72,325,135,140,0,0
3863,0,418,71,740,11,9,7,71,322,136,140,0,0
3864,0,409,66,721,11,9,7,66,312,137,140,0,0
3865,0,421,56,682,11,9,7,56,261,138,140,0,0
3866,0,412,51,674,11,9,7,51,262,139,140,0,0
3867,0,411,35,658,11,9,7,35,247,140,140,1,0
4364,1611,70,1646,158,12,9,7,35,88,0,138,0,1
4365,1609,69,1645,161,12,9,7,36,92,1,138,0,0
4366,1608,69,1645,162,12,9,7,37,93,2,138,0,0
4367,1608,69,1644,161,12,9,7,36,92,3,138,0,0
4368,1606,69,1643,162,12,9,7,37,93,4,138,0,0
4369,1607,70,1643,164,12,9,7,36,94,5,138,0,0
4370,1605,70,1642,165,12,9,7,37,95,6,138,0,0
4371,1601,68,1640,168,12,9,7,39,100,7,138,0,0
4372,1600,68,1639,169,12,9,7,39,101,8,138,0,0
4373,1601,71,1639,168,12,9,7,38,97,9,138,0,0
4374,1600,72,1639,170,12,9,7,39,98,10,138,0,0
4375,1599,72,1638,171,12,9,7,39,99,11,138,0,0
4376,1600,75,1637,172,12,9,7,37,97,12,138,0,0
4377,1599,70,1638,177,12,9,7,39,107,13,138,0,0
4378,1598,70,1638,178,12,9,7,40,108,14,138,0,0
4379,1598,71,1637,180,12,9,7,39,109,15,138,0,0
4380,1598,73,1636,179,12,9,7,38,106,16,138,0,0
4381,1597,74,1635,180,12,9,7,38,106,17,138,0,0
4382,1592,70,1632,181,12,9,7,40,111,18,138,0,0
4383,1590,73,1630,182,12,9,7,40,109,19,138,0,0
4384,1589,73,1629,183,12,9,7,40,110,20,138,0,0
4385,1585,73,1628,187,12,9,7,43,114,21,138,0,0
4386,1583,67,1629,190,12,9,7,46,123,22,138,0,0
4387,1581,67,1628,192,12,9,7,47,125,23,138,0,0
4388,1579,69,1625,192,12,9,7,46,123,24,138,0,0
4389,1577,69,1623,194,12,9,7,46,125,25,138,0,0
4390,1577,69,1624,197,12,9,7,47,128,26,138,0,0
4391,1577,72,1623,199,12,9,7,46,127,27,138,0,0
4392,1577,74,1623,200,12,9,7,46,126,28,138,0,0
4393,1577,74,1622,200,12,9,7,45,126,29,138,0,0
4394,1574,76,1620,203,12,9,7,46,127,30,138,0,0
4395,1574,79,1620,205,12,9,7,46,126,31,138,0,0
4396,1574,78,1621,207,12,9,7,47,129,32,138,0,0
4397,1573,77,1620,207,12,9,7,47,130,33,138,0,0
4398,1574,79,1621,209,12,9,7,47,130,34,138,0,0
4399,1574,81,1622,212,12,9,7,48,131,35,138,0,0
4400,1571,81,1619,213,12,9,7,48,132,36,138,0,0
4401,1569,83,1618,218,12,9,7,49,135,37,138,0,0
4402,1567,85,1617,222,12,9,7,50,137,38,138,0,0
4403,1567,86,1617,224,12,9,7,50,138,39,138,0,0
4404,1565,87,1616,226,12,9,7,51,139,40,138,0,0
4405,1563,88,1614,228,12,9,7,51,140,41,138,0,0
4406,1559,91,1610,230,12,9,7,51,139,42,138,0,0
4407,1557,93,1608,230,12,9,7,51,137,43,138,0,0
4408,1557,94,1609,232,12,9,7,52,138,44,138,0,0
4409,1555,93,1608,232,12,9,7,53,139,45,138,0,0
4410,1552,91,1607,236,12,9,7,55,145,46,138,0,0
4411,1550,92,1606,238,12,9,7,56,146,47,138,0,0
4412,1548,93,1605,241,12,9,7,57,148,48,138,0,0
4413,1545,92,1602,243,12,9,7,57,151,49,138,0,0
4414,1542,92,1601,247,12,9,7,59,155,50,138,0,0
4415,1541,91,1602,252,12,9,7,61,161,51,138,0,0
4416,1540,93,1601,253,12,9,7,61,160,52,138,0,0
4417,1538,96,1599,259,12,9,7,61,163,53,138,0,0
4418,1535,97,1595,259,12,9,7,60,162,54,138,0,0
4419,1532,100,1591,263,12,9,7,59,163,55,138,0,0
4420,1531,101,1591,267,12,9,7,60,166,56,138,0,0
4421,1530,102,1590,268,12,9,7,60,166,57,138,0,0
4422,1530,105,1589,271,12,9,7,59,166,58,138,0,0
4423,1528,108,1588,276,12,9,7,60,168,59,138,0,0
4424,1525,110,1586,279,12,9,7,61,169,60,138,0,0
4425,1520,109,1583,286,12,9,7,63,177,61,138,0,0
4426,1518,110,1582,290,12,9,7,64,180,62,138,0,0
4427,1517,109,1583,294,12,9,7,66,185,63,138,0,0
4428,1513,110,1578,293,12,9,7,65,183,64,138,0,0
4429,1508,109,1576,304,12,9,7,68,195,65,138,0,0
4430,1503,111,1572,307,12,9,7,69,196,66,138,0,0
4431,1497,108,1569,315,12,9,7,72,207,67,138,0,0
4432,1495,112,1567,317,12,9,7,72,205,68,138,0,0
4433,1494,113,1566,318,12,9,7,72,205,69,138,0,0
4434,1494,115,1566,322,12,9,7,72,207,70,138,0,0
4435,1490,114,1565,330,12,9,7,75,216,71,138,0,0
4436,1483,111,1562,339,12,9,7,79,228,72,138,0,0
4437,1480,113,1561,344,12,9,7,81,231,73,138,0,0
4438,1476,117,1557,349,12,9,7,81,232,74,138,0,0
4439,1472,115,1556,357,12,9,7,84,242,75,138,0,0
4440,1464,117,1549,361,12,9,7,85,244,76,138,0,0
4441,1457,126,1540,369,12,9,7,83,243,77,138,0,0
4442,1445,123,1532,376,12,9,7,87,253,78,138,0,0
4443,1441,123,1534,391,12,9,7,93,268,79,138,0,0
4444,1437,127,1535,405,12,9,7,98,278,80,138,0,0
4445,1429,131,1527,410,12,9,7,98,279,81,138,0,0
4446,1424,137,1523,418,12,9,7,99,281,82,138,0,0
4447,1415,147,1513,430,12,9,7,98,283,83,138,0,0
4448,1406,144,1509,440,12,9,7,103,296,84,138,0,0
4449,1395,141,1505,457,12,9,7,110,316,85,138,0,0
4450,1388,149,1498,467,12,9,7,110,318,86,138,0,0
4451,1380,150,1492,473,12,9,7,112,323,87,138,0,0
4452,1365,148,1483,489,12,9,7,118,341,88,138,0,0
4453,1354,153,1473,502,12,9,7,119,349,89,138,0,0
4454,1346,157,1466,510,12,9,7,120,353,90,138,0,0
4455,1330,161,1458,536,12,9,7,128,375,91,138,0,0
4456,1320,164,1454,559,12,9,7,134,395,92,138,0,0
4457,1308,162,1445,567,12,9,7,137,405,93,138,0,0
4458,1290,166,1435,589,12,9,7,145,423,94,138,0,0
4459,1270,174,1420,617,12,9,7,150,443,95,138,0,0
4460,1256,185,1406,626,12,9,7,150,441,96,138,0,0
4461,1228,187,1393,665,12,9,7,165,478,97,138,0,0
4462,1207,201,1376,688,12,9,7,169,487,98,138,0,0
4463,1174,207,1348,701,12,9,7,174,494,99,138,0,0
4464,1130,227,1314,740,12,9,7,184,513,100,138,0,0
4465,1076,246,1272,773,12,9,7,196,527,101,138,0,0
4466,1007,251,1220,795,12,9,7,213,544,102,138,0,0
4467,956,270,1188,834,12,9,7,232,564,103,138,0,0
4468,919,284,1156,851,12,9,7,237,567,104,138,0,0
4469,874,293,1111,864,12,9,7,237,571,105,138,0,0
4470,799,300,1047,868,12,9,7,248,568,106,138,0,0
4471,722,308,973,871,12,9,7,251,563,107,138,0,0
4472,665,300,920,882,12,9,7,255,582,108,138,0,0
4473,593,305,843,862,12,9,7,250,557,109,138,0,0
4474,531,310,778,847,12,9,7,247,537,110,138,0,0
4475,444,301,690,841,12,9,7,246,540,111,138,0,0
4476,401,308,638,834,12,9,7,237,526,112,138,0,0
4477,355,305,581,807,12,9,7,226,502,113,138,0,0
4478,304,298,517,780,12,9,7,213,482,114,138,0,0
4479,272,318,469,754,12,9,7,197,436,115,138,0,0
4480,249,313,440,728,12,9,7,191,415,116,138,0,0
4481,198,295,385,709,12,9,7,187,414,117,138,0,0
4482,171,298,355,704,12,9,7,184,406,118,138,0,0
4483,143,290,321,689,12,9,7,178,399,119,138,0,0
4484,117,287,284,667,12,9,7,167,380,120,138,0,0
4485,103,278,268,657,12,9,7,165,379,121,138,0,0
4486,94,285,249,639,12,9,7,155,354,122,138,0,0
4487,71,291,214,622,12,9,7,143,331,123,138,0,0
4488,56,295,194,615,12,9,7,138,320,124,138,0,0
4489,43,289,176,600,12,9,7,133,311,125,138,0,0
4490,33,279,162,586,12,9,7,129,307,126,138,0,0
4491,35,296,153,573,12,9,7,118,277,127,138,0,0
4492,21,284,138,558,12,9,7,117,274,128,138,0,0
4493,0,276,116,552,12,9,7,116,276,129,138,0,0
4494,0,277,106,550,12,9,7,106,273,130,138,0,0
4495,0,267,92,534,12,9,7,92,267,131,138,0,0
4496,0,262,85,524,12,9,7,85,262,132,138,0,0
4497,0,274,81,519,12,9,7,81,245,133,138,0,0
4498,0,277,68,511,12,9,7,68,234,134,138,0,0
4499,0,277,57,508,12,9,7,57,231,135,138,0,0
4500,0,285,50,506,12,9,7,50,221,136,138,0,0
4501,0,285,37,498,12,9,7,37,213,137,138,0,0
4502,0,289,41,489,12,9,7,41,200,138,138,1,0
4538,0,402,54,760,14,9,7,54,358,0,4,0,0
4539,9,407,63,765,14,9,7,54,358,1,4,0,0
4540,13,400,71,777,14,9,7,58,377,2,4,0,0
4541,38,410,101,795,14,9,7,63,385,3,4,0,0
4542,49,412,113,805,14,9,7,64,393,4,4,0,0
4542,3,317,168,830,15,9,7,165,513,0,20,0,1
4543,2,330,175,869,15,9,7,173,539,1,20,0,0
4544,31,353,207,897,15,9,7,176,544,2,20,0,0
4545,54,361,233,908,15,9,7,179,547,3,20,0,0
4546,119,367,307,925,15,9,7,188,558,4,20,0,0
4547,168,376,367,952,15,9,7,199,576,5,20,0,0
4548,190,373,404,989,15,9,7,214,616,6,20,0,0
4549,249,381,488,1047,15,9,7,239,666,7,20,0,0
4550,299,400,542,1068,15,9,7,243,668,8,20,0,0
4551,368,409,618,1078,15,9,7,250,669,9,20,0,0
4552,449,431,698,1080,15,9,7,249,649,10,20,0,0
4553,527,431,778,1080,15,9,7,251,649,11,20,0,0
4554,663,458,917,1077,15,9,7,254,619,12,20,0,0
4555,788,485,1039,1077,15,9,7,251,592,13,20,0,0
4556,923,495,1172,1077,15,9,7,249,582,14,20,0,0
4557,1079,532,1317,1077,15,9,7,238,545,15,20,0,0
4558,1259,534,1500,1073,15,9,7,241,539,16,20,0,0
4559,1434,573,1669,1071,15,9,7,235,498,17,20,0,0
4560,1613,632,1833,1078,15,9,7,220,446,18,20,0,0
4561,1745,709,1920,1080,15,9,7,175,371,19,20,0,0
4562,1868,740,1920,1080,15,9,7,52,340,20,20,1,0
5860,1717,721,1919,1075,16,9,7,202,354,0,1,0,0
5861,1630,694,1847,1071,16,9,7,217,377,1,1,0,0
5862,1410,626,1752,1068,17,9,7,342,442,0,30,0,1
5863,1262,592,1615,1046,17,9,7,353,454,1,30,0,0
5864,1118,577,1481,1043,17,9,7,363,466,2,30,0,0
5865,1008,566,1389,1062,17,9,7,381,496,3,30,0,0
5866,910,540,1314,1070,17,9,7,404,530,4,30,0,0
5867,765,496,1195,1075,17,9,7,430,579,5,30,0,0
5868,668,468,1103,1070,17,9,7,435,602,6,30,0,0
5869,599,464,1032,1072,17,9,7,433,608,7,30,0,0
5870,488,445,912,1061,17,9,7,424,616,8,30,0,0
5871,426,433,847,1059,17,9,7,421,626,9,30,0,0
5872,361,416,742,1001,17,9,7,381,585,10,30,0,0
5873,323,410,673,960,17,9,7,350,550,11,30,0,0
5874,285,410,617,933,17,9,7,332,523,12,30,0,0
5875,212,395,529,906,17,9,7,317,511,13,30,0,0
5876,175,388,483,899,17,9,7,308,511,14,30,0,0
5877,146,379,445,888,17,9,7,299,509,15,30,0,0
5878,120,369,394,852,17,9,7,274,483,16,30,0,0
5879,108,368,365,830,17,9,7,257,462,17,30,0,0
5880,89,369,330,807,17,9,7,241,438,18,30,0,0
5881,56,359,287,793,17,9,7,231,434,19,30,0,0
5882,39,358,263,786,17,9,7,224,428,20,30,0,0
5883,22,352,227,756,17,9,7,205,404,21,30,0,0
5884,15,351,203,731,17,9,7,188,380,22,30,0,0
5885,4,352,185,717,17,9,7,181,365,23,30,0,0
5886,0,350,155,701,17,9,7,155,351,24,30,0,0
5887,0,345,136,694,17,9,7,136,349,25,30,0,0
5888,0,340,125,690,17,9,7,125,350,26,30,0,0
5889,0,337,107,669,17,9,7,107,332,27,30,0,0
5890,0,306,106,662,17,9,7,106,356,28,30,0,0
5891,0,322,95,653,17,9,7,95,331,29,30,0,0
5892,0,316,73,639,17,9,7,73,323,30,30,1,0
5892,1,374,46,633,18,9,7,45,259,0,1,0,0
5893,0,396,41,634,18,9,7,41,238,1,1,0,0
206,473,91,508,207,2,9,9,35,116,0,64,0,1
207,474,92,509,210,2,9,9,35,118,1,64,0,0
208,475,92,510,212,2,9,9,35,120,2,64,0,0
209,473,90,509,214,2,9,9,36,124,3,64,0,0
210,473,89,509,216,2,9,9,36,127,4,64,0,0
211,472,89,509,217,2,9,9,37,128,5,64,0,0
212,473,90,509,219,2,9,9,36,129,6,64,0,0
213,471,91,508,223,2,9,9,37,132,7,64,0,0
214,470,98,507,228,2,9,9,37,130,8,64,0,0
215,470,100,505,228,2,9,9,35,128,9,64,0,0
216,469,98,506,232,2,9,9,37,134,10,64,0,0
217,469,96,507,235,2,9,9,38,139,11,64,0,0
218,468,96,506,237,2,9,9,38,141,12,64,0,0
219,468,99,506,241,2,9,9,38,142,13,64,0,0
220,470,104,506,238,2,9,9,36,134,14,64,0,0
221,470,106,507,244,2,9,9,37,138,15,64,0,0
222,471,105,509,249,2,9,9,38,144,16,64,0,0
223,471,103,511,253,2,9,9,40,150,17,64,0,0
224,472,107,512,258,2,9,9,40,151,18,64,0,0
225,473,112,513,261,2,9,9,40,149,19,64,0,0
226,478,121,515,260,2,9,9,37,139,20,64,0,0
227,479,121,520,268,2,9,9,41,147,21,64,0,0
228,480,122,523,277,2,9,9,43,155,22,64,0,0
229,483,123,526,280,2,9,9,43,157,23,64,0,0
230,483,115,530,287,2,9,9,47,172,24,64,0,0
231,489,133,532,288,2,9,9,43,155,25,64,0,0
232,491,128,537,293,2,9,9,46,165,26,64,0,0
233,490,130,539,306,2,9,9,49,176,27,64,0,0
234,494,136,541,307,2,9,9,47,171,28,64,0,0
235,497,139,545,310,2,9,9,48,171,29,64,0,0
236,499,141,550,319,2,9,9,51,178,30,64,0,0
237,498,140,553,326,2,9,9,55,186,31,64,0,0
238,497,143,554,336,2,9,9,57,193,32,64,0,0
239,494,143,553,341,2,9,9,59,198,33,64,0,0
240,491,143,552,344,2,9,9,61,201,34,64,0,0
241,489,147,553,351,2,9,9,64,204,35,64,0,0
242,486,145,554,363,2,9,9,68,218,36,64,0,0
243,484,154,552,369,2,9,9,68,215,37,64,0,0
244,485,153,554,369,2,9,9,69,216,38,64,0,0
245,486,165,555,377,2,9,9,69,212,39,64,0,0
246,485,165,559,396,2,9,9,74,231,40,64,0,0
247,486,167,565,409,2,9,9,79,242,41,64,0,0
248,490,175,572,423,2,9,9,82,248,42,64,0,0
249,496,174,581,434,2,9,9,85,260,43,64,0,0
250,501,183,590,453,2,9,9,89,270,44,64,0,0
251,509,184,602,467,2,9,9,93,283,45,64,0,0
252,516,189,615,491,2,9,9,99,302,46,64,0,0
253,520,195,623,510,2,9,9,103,315,47,64,0,0
254,523,198,630,525,2,9,9,107,327,48,64,0,0
255,533,207,645,548,2,9,9,112,341,49,64,0,0
256,544,209,658,559,2,9,9,114,350,50,64,0,0
257,559,222,678,585,2,9,9,119,363,51,64,0,0
258,569,230,697,624,2,9,9,128,394,52,64,0,0
259,584,236,721,656,2,9,9,137,420,53,64,0,0
260,599,254,743,695,2,9,9,144,441,54,64,0,0
261,606,261,758,722,2,9,9,152,461,55,64,0,0
262,608,283,769,775,2,9,9,161,492,56,64,0,0
263,602,295,772,810,2,9,9,170,515,57,64,0,0
264,586,312,773,880,2,9,9,187,568,58,64,0,0
265,569,335,766,933,2,9,9,197,598,59,64,0,0
266,532,340,749,1002,2,9,9,217,662,60,64,0,0
267,490,370,719,1057,2,9,9,229,687,61,64,0,0
268,419,389,655,1080,2,9,9,236,691,62,64,0,0
269,352,434,587,1080,2,9,9,235,646,63,64,0,0
270,341,448,582,1080,2,9,9,241,632,64,64,1,0
191,441,83,477,170,3,9,9,36,87,0,0,0,0
270,129,478,431,1080,4,9,9,302,602,0,1,0,0
271,49,501,340,1080,4,9,9,291,579,1,1,0,0
1393,1388,612,1456,716,7,9,9,68,104,0,0,0,0
1395,1421,624,1467,717,8,9,9,46,93,0,7,0,0
1396,1421,627,1473,730,8,9,9,52,103,1,7,0,0
1397,1432,638,1477,728,8,9,9,45,90,2,7,0,0
1398,1437,643,1478,726,8,9,9,41,83,3,7,0,0
1399,1435,640,1481,732,8,9,9,46,92,4,7,0,0
1400,1432,641,1476,729,8,9,9,44,88,5,7,0,0
1401,1438,644,1478,724,8,9,9,40,80,6,7,0,0
1402,1441,645,1479,718,8,9,9,38,73,7,7,0,0
1406,1450,663,1511,764,9,9,9,61,101,0,13,0,0
1407,1447,663,1508,764,9,9,9,61,101,1,13,0,0
1408,1444,665,1503,763,9,9,9,59,98,2,13,0,0
1409,1450,669,1505,760,9,9,9,55,91,3,13,0,0
1410,1455,671,1509,760,9,9,9,54,89,4,13,0,0
1411,1457,671,1511,762,9,9,9,54,91,5,13,0,0
1412,1458,673,1514,767,9,9,9,56,94,6,13,0,0
1413,1460,675,1515,769,9,9,9,55,94,7,13,0,0
1414,1462,678,1519,774,9,9,9,57,96,8,13,0,0
1415,1466,684,1519,774,9,9,9,53,90,9,13,0,0
1416,1469,688,1519,772,9,9,9,50,84,10,13,0,0
1417,1469,691,1519,775,9,9,9,50,84,11,13,0,0
1418,1471,699,1518,779,9,9,9,47,80,12,13,0,0
1419,1475,709,1518,781,9,9,9,43,72,13,13,0,0
1423,1487,727,1531,797,9,9,9,44,70,0,13,0,0
4327,1491,432,1528,544,15,9,9,37,112,0,0,0,0
5337,1494,432,1531,541,20,9,9,37,109,0,0,0,0
5718,1588,797,1636,867,21,9,9,48,70,0,4,0,0
5722,1579,768,1639,857,21,9,9,60,89,0,4,0,0
5723,1578,763,1640,855,21,9,9,62,92,1,4,0,0
5731,1567,730,1650,857,21,9,9,83,127,0,4,0,0
5732,1571,725,1655,859,21,9,9,84,134,1,4,0,0
5733,1570,721,1656,858,21,9,9,86,137,2,4,0,0
5739,1571,753,1632,848,21,9,9,61,95,0,4,0,0
5740,1570,752,1631,847,21,9,9,61,95,1,4,0,0
5742,1564,758,1623,848,21,9,9,59,90,0,4,0,0
5743,1563,756,1622,845,21,9,9,59,89,1,4,0,0
5744,1567,750,1631,847,21,9,9,64,97,2,4,0,0
5745,1579,747,1634,832,21,9,9,55,85,3,4,0,0
5746,1581,746,1634,830,21,9,9,53,84,4,4,0,0
5719,1584,775,1632,866,22,9,9,48,91,0,0,0,0
5745,1535,751,1582,823,23,9,9,47,72,0,3,0,0
5746,1535,747,1584,824,23,9,9,49,77,1,3,0,0
5747,1538,744,1586,822,23,9,9,48,78,2,3,0,0
5748,1541,741,1586,815,23,9,9,45,74,3,3,0,0
5827,1693,517,1730,596,25,9,9,37,79,0,43,0,0
5829,1695,521,1732,600,25,9,9,37,79,0,43,0,0
5830,1694,521,1734,606,25,9,9,40,85,1,43,0,0
5831,1690,522,1732,609,25,9,9,42,87,2,43,0,0
5832,1689,522,1733,610,25,9,9,44,88,3,43,0,0
5833,1689,521,1735,612,25,9,9,46,91,4,43,0,0
5840,1722,503,1757,574,25,9,9,35,71,0,43,0,1
5841,1704,500,1754,595,25,9,9,50,95,1,43,0,0
5842,1707,514,1750,596,25,9,9,43,82,2,43,0,0
5843,1702,513,1748,597,25,9,9,46,84,3,43,0,0
5844,1702,513,1749,598,25,9,9,47,85,4,43,0,0
5845,1718,504,1763,587,25,9,9,45,83,5,43,0,0
5846,1719,507,1764,592,25,9,9,45,85,6,43,0,0
5847,1720,509,1764,594,25,9,9,44,85,7,43,0,0
5848,1724,503,1768,588,25,9,9,44,85,8,43,0,0
5849,1723,502,1767,592,25,9,9,44,90,9,43,0,0
5850,1717,499,1764,593,25,9,9,47,94,10,43,0,0
5851,1718,500,1765,595,25,9,9,47,95,11,43,0,0
5852,1718,500,1766,597,25,9,9,48,97,12,43,0,0
5853,1715,499,1764,596,25,9,9,49,97,13,43,0,0
5854,1722,499,1767,592,25,9,9,45,93,14,43,0,0
5855,1723,498,1768,590,25,9,9,45,92,15,43,0,0
5856,1725,497,1768,586,25,9,9,43,89,16,43,0,0
5857,1725,495,1769,586,25,9,9,44,91,17,43,0,0
5858,1725,494,1768,583,25,9,9,43,89,18,43,0,0
5859,1726,492,1769,582,25,9,9,43,90,19,43,0,0
5860,1729,491,1771,580,25,9,9,42,89,20,43,0,0
5861,1733,490,1774,577,25,9,9,41,87,21,43,0,0
5862,1730,488,1771,576,25,9,9,41,88,22,43,0,0
5863,1729,489,1768,573,25,9,9,39,84,23,43,0,0
5864,1729,488,1769,572,25,9,9,40,84,24,43,0,0
5865,1729,485,1771,571,25,9,9,42,86,25,43,0,0
5866,1732,482,1774,570,25,9,9,42,88,26,43,0,0
5867,1735,479,1779,570,25,9,9,44,91,27,43,0,0
5868,1737,480,1780,570,25,9,9,43,90,28,43,0,0
5869,1738,478,1781,568,25,9,9,43,90,29,43,0,0
5870,1737,477,1780,567,25,9,9,43,90,30,43,0,0
5871,1736,476,1780,566,25,9,9,44,90,31,43,0,0
5872,1736,475,1779,565,25,9,9,43,90,32,43,0,0
5873,1737,473,1780,564,25,9,9,43,91,33,43,0,0
5874,1738,472,1781,563,25,9,9,43,91,34,43,0,0
5875,1740,472,1781,559,25,9,9,41,87,35,43,0,0
5876,1739,472,1781,558,25,9,9,42,86,36,43,0,0
5877,1741,471,1782,557,25,9,9,41,86,37,43,0,0
5878,1742,472,1781,554,25,9,9,39,82,38,43,0,0
5879,1744,471,1782,553,25,9,9,38,82,39,43,0,0
5880,1746,470,1784,551,25,9,9,38,81,40,43,0,0
5881,1750,470,1787,552,25,9,9,37,82,41,43,0,0
5882,1754,471,1789,551,25,9,9,35,80,42,43,0,0
5883,1756,469,1791,550,25,9,9,35,81,43,43,1,0
5745,1604,810,1653,882,26,9,9,49,72,0,18,0,0
5746,1603,801,1656,880,26,9,9,53,79,1,18,0,0
5747,1602,795,1657,879,26,9,9,55,84,2,18,0,0
5748,1602,791,1656,874,26,9,9,54,83,3,18,0,0
5749,1603,787,1656,870,26,9,9,53,83,4,18,0,0
5750,1601,779,1657,869,26,9,9,56,90,5,18,0,0
5751,1603,775,1654,859,26,9,9,51,84,6,18,0,0
5752,1604,773,1650,849,26,9,9,46,76,7,18,0,0
5753,1602,765,1650,846,26,9,9,48,81,8,18,0,0
5754,1602,760,1649,838,26,9,9,47,78,9,18,0,0
5755,1605,758,1648,829,26,9,9,43,71,10,18,0,0
5766,1605,698,1645,770,26,9,9,40,72,0,18,0,0
5767,1605,693,1646,768,26,9,9,41,75,1,18,0,0
5768,1608,694,1646,766,26,9,9,38,72,2,18,0,0
5769,1608,687,1648,763,26,9,9,40,76,3,18,0,0
5770,1607,678,1650,761,26,9,9,43,83,4,18,0,0
5771,1607,668,1653,759,26,9,9,46,91,5,18,0,0
5772,1608,665,1653,755,26,9,9,45,90,6,18,0,0
5773,1611,660,1655,748,26,9,9,44,88,7,18,0,0
5774,1613,665,1654,749,26,9,9,41,84,8,18,0,0
5775,1613,656,1658,749,26,9,9,45,93,9,18,0,0
5776,1613,650,1660,749,26,9,9,47,99,10,18,0,0
5777,1615,647,1661,746,26,9,9,46,99,11,18,0,0
5778,1620,643,1664,740,26,9,9,44,97,12,18,0,0
5779,1623,640,1666,735,26,9,9,43,95,13,18,0,0
5780,1626,641,1666,732,26,9,9,40,91,14,18,0,0
5781,1629,635,1666,721,26,9,9,37,86,15,18,0,0
5782,1630,633,1668,722,26,9,9,38,89,16,18,0,0
5783,1630,636,1666,720,26,9,9,36,84,17,18,0,0
5784,1631,631,1667,716,26,9,9,36,85,18,18,0,0
5757,1782,942,1825,1012,28,9,9,43,70,0,2,0,0
5758,1785,940,1829,1013,28,9,9,44,73,1,2,0,0
5759,1787,938,1833,1014,28,9,9,46,76,2,2,0,0
5773,1859,884,1902,954,28,9,9,43,70,0,2,0,0
5774,1865,880,1908,951,28,9,9,43,71,1,2,0,0
5775,1870,877,1913,948,28,9,9,43,71,2,2,0,0
5811,1640,539,1697,641,30,9,9,57,102,0,0,0,0
5813,1648,540,1697,636,31,9,9,49,96,0,0,0,0
5818,1670,530,1712,614,32,9,9,42,84,0,0,0,0
5832,1507,743,1560,815,33,9,9,53,72,0,16,0,0
5833,1508,739,1564,818,33,9,9,56,79,1,16,0,0
5834,1510,736,1566,817,33,9,9,56,81,2,16,0,0
5835,1512,731,1570,819,33,9,9,58,88,3,16,0,0
5836,1514,728,1574,821,33,9,9,60,93,4,16,0,0
5837,1518,725,1577,821,33,9,9,59,96,5,16,0,0
5838,1520,722,1579,821,33,9,9,59,99,6,16,0,0
5839,1523,720,1579,819,33,9,9,56,99,7,16,0,0
5840,1525,716,1580,816,33,9,9,55,100,8,16,0,0
5841,1526,712,1582,815,33,9,9,56,103,9,16,0,0
5842,1530,709,1584,811,33,9,9,54,102,10,16,0,0
5843,1534,706,1582,799,33,9,9,48,93,11,16,0,0
5844,1535,703,1581,791,33,9,9,46,88,12,16,0,0
5845,1538,701,1581,784,33,9,9,43,83,13,16,0,0
5846,1541,700,1582,779,33,9,9,41,79,14,16,0,0
5847,1542,696,1583,774,33,9,9,41,78,15,16,0,0
5848,1544,697,1582,767,33,9,9,38,70,16,16,0,0
5828,1547,773,1590,845,34,9,9,43,72,0,12,0,0
5829,1550,772,1593,845,34,9,9,43,73,1,12,0,0
5830,1553,765,1599,845,34,9,9,46,80,2,12,0,0
5831,1555,761,1602,845,34,9,9,47,84,3,12,0,0
5832,1558,756,1606,843,34,9,9,48,87,4,12,0,0
5833,1560,753,1609,844,34,9,9,49,91,5,12,0,0
5834,1563,750,1611,840,34,9,9,48,90,6,12,0,0
5835,1565,747,1612,838,34,9,9,47,91,7,12,0,0
5836,1569,744,1613,830,34,9,9,44,86,8,12,0,0
5837,1571,740,1615,827,34,9,9,44,87,9,12,0,0
5838,1576,736,1615,813,34,9,9,39,77,10,12,0,0
5839,1579,732,1615,802,34,9,9,36,70,11,12,0,0
5840,1579,728,1617,803,34,9,9,38,75,12,12,0,0
5840,1441,685,1490,757,35,9,9,49,72,0,3,0,0
5841,1445,678,1492,749,35,9,9,47,71,1,3,0,0
5842,1450,673,1495,743,35,9,9,45,70,2,3,0,0
5843,1454,671,1497,741,35,9,9,43,70,3,3,0,0
5841,1566,733,1619,839,39,9,9,53,106,0,0,0,0
5949,1741,479,1781,588,55,9,9,40,109,0,18,0,0
5950,1746,473,1785,579,55,9,9,39,106,1,18,0,0
5951,1746,472,1783,573,55,9,9,37,101,2,18,0,0
5952,1747,472,1783,573,55,9,9,36,101,3,18,0,0
5953,1746,472,1784,576,55,9,9,38,104,4,18,0,0
5954,1748,470,1785,572,55,9,9,37,102,5,18,0,0
5955,1751,469,1786,565,55,9,9,35,96,6,18,0,0
5956,1750,466,1789,574,55,9,9,39,108,7,18,0,0
5957,1751,465,1790,574,55,9,9,39,109,8,18,0,0
5958,1751,467,1789,574,55,9,9,38,107,9,18,0,0
5959,1750,467,1789,576,55,9,9,39,109,10,18,0,0
5960,1751,464,1790,572,55,9,9,39,108,11,18,0,0
5961,1754,465,1789,562,55,9,9,35,97,12,18,0,0
5962,1754,465,1790,564,55,9,9,36,99,13,18,0,0
5963,1753,462,1791,565,55,9,9,38,103,14,18,0,0
5964,1752,463,1789,564,55,9,9,37,101,15,18,0,0
5965,1752,463,1790,564,55,9,9,38,101,16,18,0,0
5966,1753,465,1791,563,55,9,9,38,98,17,18,0,0
5967,1754,466,1791,561,55,9,9,37,95,18,18,0,0
